Data	Data aligned
SQTILIQNI	SQTILIQNI
KLGEIVTTI	KLGEIVTTI
ALRALQDQV	ALRALQDQV
QQAAIPIQI	QQAAIPIQI
KLPEAQQRV	KLPEAQQRV
KMTPEQLAI	KMTPEQLAI
ALLGILQHV	ALLGILQHV
VQSGNINAAK	VQSGNINAA
SQLQEHQRI	SQLQEHQRI
HLTGHTLKI	HLTGHTLKI
VQIKDVNLEV	QIKDVNLEV
RVFPSPMRI	RVFPSPMRI
RQHPGHLL	RQHPGH-LL
RSSGYPLTI	RSSGYPLTI
RLIGQIVSSI	RLIGQISSI
SLLPQKQEV	SLLPQKQEV
QLASGLLLV	QLASGLLLV
VQHQDALQI	VQHQDALQI
VLAEIPQQV	VLAEIPQQV
PTSSQFLYPKV	SQFLYP-KV
AVSPYQQVI	AVSPYQQVI
RLKTQSELDRI	TQSELD-RI
AIFQIIQSI	AIFQIIQSI
KQTPKVLVV	KQTPKVLVV
GQFKTYAI	GQFKTY-AI
HLTPVTLEL	HLTPVTLEL
GQMDPSAQI	GQMDPSAQI
MQIRIHQI	MQIRIH-QI
ELAQQIQK	ELAQQI-QK
RLLEDKKITV	RLLEDKITV
KLITKAEKI	KLITKAEKI
RLRDPDSHIV	RLRDPDSHI
SQWSLQHEI	SQWSLQHEI
GQTSVIEQI	GQTSVIEQI
FLADIVQKL	FLADIVQKL
HLLQYNHRV	HLLQYNHRV
RQWEESWQQV	RQWEESQQV
RVSPVHLQI	RVSPVHLQI
TLFGKAILRI	TLFGKALRI
RQQAHIQVV	RQQAHIQVV
AQTLQQYRV	AQTLQQYRV
RQIAKAYARI	RQIAKAARI
SQKDIEQSI	SQKDIEQSI
QQSIERLLV	QQSIERLLV
RLFHPKLII	RLFHPKLII
HEGDIILKI	HEGDIILKI
RLVEIQYEL	RLVEIQYEL
RVGDQILRV	RVGDQILRV
GQYAMTRAQRV	YAMTRAQRV
FRVPTANVS	FRVPTANVS
SQAIHQLKV	SQAIHQLKV
RLKFLNDSEQV	FLNDSE-QV
AQIPSKVSV	AQIPSKVSV
RLLNVEVPQKV	RLLNVEQKV
RISDVHFSV	RISDVHFSV
HQLPLPHNV	HQLPLPHNV
DVNAAIATIK	DVNAAIATI
SQFPTPEAV	SQFPTPEAV
AQIHTPVAI	AQIHTPVAI
YQPWLDLKI	YQPWLDLKI
GLDPSTPAQVI	GLDPSTAQV
KQQQTMLRV	KQQQTMLRV
HLLETPLVV	HLLETPLVV
SQSLLPAI	SQSLLP-AI
RQYLPIFAV	RQYLPIFAV
LQVFLPQAI	LQVFLPQAI
KQQVQQLQV	KQQVQQLQV
RMDGHIQLI	RMDGHIQLI
TQMNHIVMEI	TQMNHIMEI
KQQENVTLLL	KQQENVTLL
AQHSIVLPL	AQHSIVLPL
SQTVPSPTI	SQTVPSPTI
KQAQVPLAA	KQAQVPLAA
AQSSLDLFL	AQSSLDLFL
VQRLEPVI	VQRLEP-VI
GQIKEVERI	GQIKEVERI
GQGSFGKVFLV	GSFGKVFLV
GQVIQKETV	GQVIQKETV
KLTEIRHEV	KLTEIRHEV
GQYVQPQGV	GQYVQPQGV
AQGKMKLLI	AQGKMKLLI
AQLGAVVAV	AQLGAVVAV
ILAPVVKEI	ILAPVVKEI
HSAELALNV	HSAELALNV
RVMELFFTV	RVMELFFTV
VVNKIRLKI	VVNKIRLKI
EQAQVKLLV	EQAQVKLLV
RQFAAQTV	RQFAAQ-TV
HIIENIVAV	HIIENIVAV
KQLQQELLLI	KQLQQELLI
GQTQVEIKV	GQTQVEIKV
RLPPEVNRI	RLPPEVNRI
KVVALVHAV	KVVALVHAV
VQFTVKLRL	VQFTVKLRL
QQNPLVQRV	QQNPLVQRV
FQQPKPLSV	FQQPKPLSV
LQLELAQVL	LQLELAQVL
AQFAARAII	AQFAARAII
AQRAVELFI	AQRAVELFI
AQQELKLLL	AQQELKLLL
AQVPIILAV	AQVPIILAV
DIRGKLLQV	DIRGKLLQV
LQYSFPLQL	LQYSFPLQL
RQHLQATGV	RQHLQATGV
AGFAGDDAPR	AGFAGDDAP
SQVNILSKI	SQVNILSKI
STLAVQQYI	STLAVQQYI
KQVLGQMVI	KQVLGQMVI
FMASQMLKV	FMASQMLKV
GQVERAVVI	GQVERAVVI
KLSELQLRV	KLSELQLRV
HQFQLDITV	HQFQLDITV
HLDTTQQMI	HLDTTQQMI
RTLAEIAKV	RTLAEIAKV
RQLPSSHAL	RQLPSSHAL
AQIHGIVLV	AQIHGIVLV
GQPSIINHI	GQPSIINHI
YQKKTQLEHI	YQKKTQEHI
KLVELPYTV	KLVELPYTV
HVSEVPVSV	HVSEVPVSV
RLLEQGIRV	RLLEQGIRV
SQANIAQVL	SQANIAQVL
KQAITQVVV	KQAITQVVV
EQGEIILKV	EQGEIILKV
YQFRLIVI	YQFRLI-VI
HLPKSIYSQI	HLPKSISQI
KISKIPFKV	KISKIPFKV
SQWSPALTI	SQWSPALTI
QMSDLPVKV	QMSDLPVKV
KLLKLFQGV	KLLKLFQGV
LLHNVSQNI	LLHNVSQNI
AVHAEVFTI	AVHAEVFTI
RQQEKHFEV	RQQEKHFEV
GQYYAIKKI	GQYYAIKKI
YQIIMTMI	YQIIMT-MI
SQFVPALKI	SQFVPALKI
SQIEADFRL	SQIEADFRL
RVKPIIDLV	RVKPIIDLV
LAEKHLFSTI	AEKHLFSTI
KLDSTPLKA	KLDSTPLKA
KLILLITQV	KLILLITQV
RQDAGGILHI	RQDAGGLHI
GLAFVPLQI	GLAFVPLQI
ELSKIIQKV	ELSKIIQKV
RQIFNGTFV	RQIFNGTFV
RLNLVEAFV	RLNLVEAFV
QALELPLRI	QALELPLRI
RQHEIVLKV	RQHEIVLKV
RASGIFLRL	RASGIFLRL
KLSETFLHI	KLSETFLHI
AQFFIHPLMI	AQFFIHLMI
RQAEVTRLLL	RQAEVTLLL
KVLSTKIEI	KVLSTKIEI
HLIAQHSAI	HLIAQHSAI
HIAEVSQEV	HIAEVSQEV
RLPQYYIVV	RLPQYYIVV
SQPSKTLFV	SQPSKTLFV
VQAGVTYLFV	VQAGVTLFV
RQLNEKLVQLI	RQLNEKQLI
HVPDPVISI	HVPDPVISI
RLFDEPQLA	RLFDEPQLA
YLNKHIQKV	YLNKHIQKV
IIAHLPLLI	IIAHLPLLI
ALKNLQDKI	ALKNLQDKI
SQLKQQIQSI	SQLKQQQSI
YTLGVKQLI	YTLGVKQLI
QQLGLKQQI	QQLGLKQQI
NAGAVIGK	NAGAVI-GK
RIFIGTFKA	RIFIGTFKA
HTQNVPLSV	HTQNVPLSV
RLDAVLQRI	RLDAVLQRI
KAYHEQLSV	KAYHEQLSV
SIATLLLRI	SIATLLLRI
RQMFVNKV	RQMFVN-KV
FASQVEQLI	FASQVEQLI
LQQSKILKV	LQQSKILKV
AQFEHTLLV	AQFEHTLLV
KQLSDTSIIAV	KQLSDTSII
QLSPVLLYL	QLSPVLLYL
RSIEEVLRI	RSIEEVLRI
KQNITTAEI	KQNITTAEI
RLFPGLAIKI	RLFPGLIKI
GQYDQPVLAV	GQYDQPLAV
LLAPEPLLV	LLAPEPLLV
ILKGFDPLL	ILKGFDPLL
ILAELLLRV	ILAELLLRV
LQRVIDYI	LQRVID-YI
TQVKTPVQV	TQVKTPVQV
ALNSGILTI	ALNSGILTI
GQISEVVVV	GQISEVVVV
TLTDIEQKV	TLTDIEQKV
RVIDYAVKI	RVIDYAVKI
RIFGESIMI	RIFGESIMI
MIDNVILLI	MIDNVILLI
LQKKAILK	LQKKAI-LK
RLNPLVLLL	RLNPLVLLL
AQKRVLLQA	AQKRVLLQA
TQNFLIQKI	TQNFLIQKI
RQIEYEYKL	RQIEYEYKL
RLPSVPFETI	RLPSVPETI
SQSSLIHLV	SQSSLIHLV
ALFNGAQKL	ALFNGAQKL
RLVSSDPEI	RLVSSDPEI
YVIELQHVV	YVIELQHVV
SQFIEPKI	SQFIEP-KI
AQLAVTKI	AQLAVT-KI
AQIRYLTQV	AQIRYLTQV
IDTIEIITDR	DTIEIITDR
RLYFGERNV	RLYFGERNV
RQHFIQEEQI	RQHFIQEQI
HQHNVSLQL	HQHNVSLQL
EGVNDNEEGFF	GVNDNEEGF
RQMSVNSSI	RQMSVNSSI
SSSAVFLII	SSSAVFLII
GQTPFYIRI	GQTPFYIRI
HVYDGKFLA	HVYDGKFLA
KQGPMTQAI	KQGPMTQAI
REFGVNVFIV	REFGVNVFI
HTANIQTLI	HTANIQTLI
SSTPEEVK	SSTPEE-VK
KVHHVLLHI	KVHHVLLHI
GLTSAIQAV	GLTSAIQAV
KVFNRYLEV	KVFNRYLEV
RTTDIVIRI	RTTDIVIRI
HLGDFPLAV	HLGDFPLAV
RQWADDWLV	RQWADDWLV
HVLSLPLRI	HVLSLPLRI
HQPDPAIGV	HQPDPAIGV
AALKLPLLV	AALKLPLLV
RVLQAIDSI	RVLQAIDSI
SLFRGSHRV	SLFRGSHRV
MLFGHPLLV	MLFGHPLLV
KMAPALRKV	KMAPALRKV
FLNEIQQSI	FLNEIQQSI
RQYESLPATHI	RQYESLPAT
ALFDAQAQV	ALFDAQAQV
AQSGLIVSI	AQSGLIVSI
RIAAQGFTV	RIAAQGFTV
AQAELQQHDV	AQAELQHDV
QGTEIDGR	QGTEID-GR
LETNVPLLV	LETNVPLLV
RQHEIILKA	RQHEIILKA
AQILGPLSI	AQILGPLSI
AQSGTIMAV	AQSGTIMAV
GQMLTRILVI	GQMLTRILV
VQNDTLLQV	VQNDTLLQV
GQFTGSTGVQV	GQFTGSTGV
LIMVAIPII	LIMVAIPII
RQFKEIAAVI	RQFKEIAAV
LVSFIPLNI	LVSFIPLNI
AQVPVFLAL	AQVPVFLAL
KLNPQQFEV	KLNPQQFEV
SQAAVPTQV	SQAAVPTQV
HISMVIQKI	HISMVIQKI
GQPNITKLII	GQPNITKLI
RQFPGSHRV	RQFPGSHRV
KQMLLFTHI	KQMLLFTHI
GQKEGEPRI	GQKEGEPRI
RAFGGKDIKV	RAFGGKIKV
KLIILPLII	KLIILPLII
RLHEKVNII	RLHEKVNII
RVLRVYSI	RVLRVY-SI
AQSAVEILL	AQSAVEILL
KLKEIFDKI	KLKEIFDKI
RQEDLIMKV	RQEDLIMKV
TLHAAVLQI	TLHAAVLQI
RLTQEKITV	RLTQEKITV
RLLENMTEVV	RLLENMTEV
HLFIEPRTI	HLFIEPRTI
KLLNPSLQKV	LLNPSLQKV
YQFDKVGILTL	YQFDKV-GI
SAFATPFLV	SAFATPFLV
HQIIVQNV	HQIIVQ-NV
RLIPNAIQV	RLIPNAIQV
KQSNVQILV	KQSNVQILV
EQYKFPVVI	EQYKFPVVI
HLYRDGEGRI	HLYRDGGRI
RQKEADMYRI	RQKEADYRI
YQPFKPLSI	YQPFKPLSI
KLDDIVQHI	KLDDIVQHI
KMFFLIEKI	KMFFLIEKI
YQKPGVGLDAI	YQKPGV-GL
KTLPVAFKV	KTLPVAFKV
HQTIVVQLL	HQTIVVQLL
TSSKVIQSV	TSSKVIQSV
KLMELLEEI	KLMELLEEI
AQLAAAAEI	AQLAAAAEI
GLFRVTPEI	GLFRVTPEI
IVNGHTLLV	IVNGHTLLV
RLSETDFKVM	RLSETDFKV
TIRYPDPLI	TIRYPDPLI
RLQKLHTSI	RLQKLHTSI
ALLAYTLGV	ALLAYTLGV
TQVVGILKI	TQVVGILKI
RQSISKALV	RQSISKALV
RQLLKSYKI	RQLLKSYKI
GQSKITFLL	GQSKITFLL
AQNRLHVSI	AQNRLHVSI
KQTERIQMI	KQTERIQMI
RQATINIGTI	RQATINGTI
KITGMLLEI	KITGMLLEI
HQRSFDIGI	HQRSFDIGI
AQVKSLTQKV	AQVKSLQKV
AQYENPPHI	AQYENPPHI
AQNKLFNKI	AQNKLFNKI
GQYTDLLRL	GQYTDLLRL
SLHAAAVLLL	SLHAAALLL
AQTVANFNI	AQTVANFNI
AIFSKVMVI	AIFSKVMVI
YLRIADLI	YLRIAD-LI
LSFKDPFVI	LSFKDPFVI
RQIYIYNEKI	RQIYIYEKI
RQATAASSVMV	RQATAASSV
RTVELFYDV	RTVELFYDV
RTYVYVLTV	RTYVYVLTV
VILDLPLVI	VILDLPLVI
RMAEAHARIHL	RMAEAHARI
QLTNVILHL	QLTNVILHL
KVADKIQLI	KVADKIQLI
DYNVTANSK	DYNVTANSK
VMDAALLLI	VMDAALLLI
RLKFSADKV	RLKFSADKV
IQFKKPIIVAV	IQFKKPIIV
IQYIRPVFV	IQYIRPVFV
QQIGKVVQV	QQIGKVVQV
GSYRNALKI	GSYRNALKI
KQPPIDNII	KQPPIDNII
NLIGLPLLI	NLIGLPLLI
RLPRPLPAV	RLPRPLPAV
AQAEAEKIRKI	AQAEAE-KI
AQIELLQLLV	AQIELLLLV
RQAPVLLQT	RQAPVLLQT
GQIKIWEV	GQIKIW-EV
RLVEVPMEL	RLVEVPMEL
AVIKHSLVHKV	AVIKHS-LV
RQVTGVTRV	RQVTGVTRV
QQVAFQPSI	QQVAFQPSI
RATGISFAI	RATGISFAI
SQNQKRLYI	SQNQKRLYI
KLVGEFLEV	KLVGEFLEV
KQVQQPSV	KQVQQP-SV
YLFTSPQRV	YLFTSPQRV
TLPYIKQEV	TLPYIKQEV
KQQDVIYELI	KQQDVIYEL
AQALVKQDL	AQALVKQDL
GQASGELLQQI	ASGELLQQI
NQVGIVLNV	NQVGIVLNV
VQALVSGKLAL	ALVSGKLAL
RLSNRVVRV	RLSNRVVRV
RQIKSFRV	RQIKSF-RV
GQFKKTQILV	GQFKKTILV
RALSILQNV	RALSILQNV
SQTFVNPHV	SQTFVNPHV
KQLKAEVI	KQLKAE-VI
QIRKIVDQI	QIRKIVDQI
RQYPWGVVQV	RQYPWGVQV
QEMQEVQSSR	EMQEVQSSR
RQWKKISAI	RQWKKISAI
TKTFTVTEKPE	KTFTVTEKP
KQENKTLLKV	KQENKTLKV
RQNTIVVKV	RQNTIVVKV
RLIAKEMNI	RLIAKEMNI
SQFVRPLIA	SQFVRPLIA
KQVELELQQI	KQVELEQQI
ERAGGALELLL	AGGALELLL
NVASVELKI	NVASVELKI
KIIYIVHDEV	IIYIVHDEV
LLSPVVPQI	LLSPVVPQI
TLFPVRLLV	TLFPVRLLV
HIGQVIMSI	HIGQVIMSI
GQFLTKRGV	GQFLTKRGV
HLFSVAQEL	HLFSVAQEL
RLQEPKKDLI	RLQEPKDLI
RQADFEAHNI	RQADFEHNI
IQVQQPQQV	IQVQQPQQV
RQHQQPFQV	RQHQQPFQV
RLQNIRNTI	RLQNIRNTI
YQIFQELI	YQIFQE-LI
TVTEKPEVID	TVTEKPEVI
FQNNVQVKV	FQNNVQVKV
FLRNLQDSI	FLRNLQDSI
GQFDHPNIIRL	GQFDHPNII
LLNKSIIRV	LLNKSIIRV
NTKITESLL	NTKITESLL
RQVVLKYTV	RQVVLKYTV
VVTAVKFTI	VVTAVKFTI
YQTQLIQRV	YQTQLIQRV
SQNGKQYII	SQNGKQYII
YVHMVTHFI	YVHMVTHFI
GQSPMAALILV	GQSPMAALI
HQPSVLLEL	HQPSVLLEL
RLAEALPKQSV	RLAEALQSV
QQQNQRLLV	QQQNQRLLV
TQQQLPQKV	TQQQLPQKV
STSSLLLRI	STSSLLLRI
ALASEPLKV	ALASEPLKV
RLAFPVEVV	RLAFPVEVV
RLLEKSQRV	RLLEKSQRV
RQYAKDIGFI	RQYAKDGFI
GQFGIHNGV	GQFGIHNGV
RLLPAFLKV	RLLPAFLKV
GQILPVPNV	GQILPVPNV
HLTDITLKV	HLTDITLKV
GVSDVELRV	GVSDVELRV
RLLKHKLKV	RLLKHKLKV
KIISVDEIFKI	ISVDEIFKI
KIAPYSVEI	KIAPYSVEI
WTTSRVLKV	WTTSRVLKV
ALSPITKLSV	ALSPITLSV
RMFDGKFVVA	RMFDGKFVV
HQILTPFLL	HQILTPFLL
KQSPLQKHLRV	KQSPLQKHL
RQTVAVGVI	RQTVAVGVI
GQLDTPGVHNV	GQLDTP-GV
KLWSRSLKL	KLWSRSLKL
RQYHENIKI	RQYHENIKI
KLVKSQISV	KLVKSQISV
SQPLGSFLI	SQPLGSFLI
RLALVTGGEI	RLALVTGEI
LQTVGIFRV	LQTVGIFRV
RVVRNNLRV	RVVRNNLRV
KLYSSEQLLI	KLYSSELLI
GLKKVIQKV	GLKKVIQKV
SSQFLYPKV	SSQFLYPKV
YLFDLPLKV	YLFDLPLKV
HTAAVKLLL	HTAAVKLLL
QQHVIETLI	QQHVIETLI
RQYTEAISV	RQYTEAISV
VNLGGSKSIS	NLGGSK-SI
RQDESIQRI	RQDESIQRI
RQNHSILKI	RQNHSILKI
RAQGVVLKV	RAQGVVLKV
GQTGVIRSV	GQTGVIRSV
ALSTLRQKI	ALSTLRQKI
KINEKPQVI	KINEKPQVI
RQNPLVTGI	RQNPLVTGI
RLLDSVRAI	RLLDSVRAI
GQTTVQVRV	GQTTVQVRV
KLLEQTQII	KLLEQTQII
RLPPPFPGL	RLPPPFPGL
VLPAVSLEV	VLPAVSLEV
VQFEDGQKIVV	VQFEDGQKI
SQPGIKFTI	SQPGIKFTI
AETAVQLFI	AETAVQLFI
RQYDGSRNPRI	RQYDGSPRI
AQDFRVLYV	AQDFRVLYV
SLVNLGGSK	SLVNLGGSK
HQVKDLLDLI	HQVKDLLDL
NQTPVTLQV	NQTPVTLQV
RLLKSKLYL	RLLKSKLYL
HVTPLKLMV	HVTPLKLMV
GQGRIILKA	GQGRIILKA
SMFGAGLTV	SMFGAGLTV
QAADFALKV	QAADFALKV
RQFSGARNQL	RQFSGANQL
HLANIVERV	HLANIVERV
RMAVLNEQV	RMAVLNEQV
RIAHAKQII	RIAHAKQII
KLTVVLEAV	KLTVVLEAV
KLVKIKQEI	KLVKIKQEI
HLTEEALKV	HLTEEALKV
HLLLEVEVI	HLLLEVEVI
RKYPTLLEV	RKYPTLLEV
ALPKIILAV	ALPKIILAV
AQLLLPVSI	AQLLLPVSI
LIYSGKLLL	LIYSGKLLL
GQLDVRELI	GQLDVRELI
RLLDYVATV	RLLDYVATV
RIAEALSKMKL	RIAEALSKM
RVMSGKLTV	RVMSGKLTV
KQSSVMQRL	KQSSVMQRL
GQLSEGAIAAI	QLSEGAAAI
KLQEIENAI	KLQEIENAI
RLADKSVLV	RLADKSVLV
KLHGKPIRI	KLHGKPIRI
GQTITISRV	GQTITISRV
RVIDREGVYEI	RVIDRE-GV
RVVKLNEVI	RVVKLNEVI
KQFVSQELV	KQFVSQELV
AQLPAHRV	AQLPAH-RV
RQPNISDQQV	RQPNISQQV
ALRWSVDSI	ALRWSVDSI
HLAEVSAEV	HLAEVSAEV
KQPAFTIHV	KQPAFTIHV
FVFKEPQQV	FVFKEPQQV
SQFPLPLAV	SQFPLPLAV
RLRSFTTTI	RLRSFTTTI
KQLIAKKI	KQLIAK-KI
ALKKAEIGI	ALKKAEIGI
RLIESLFTI	RLIESLFTI
ALTSIAQKI	ALTSIAQKI
AQYPSEHLI	AQYPSEHLI
KLLSPVVPQI	LLSPVVPQI
KQLEKTLLEI	KQLEKTLEI
KLLEPVLLL	KLLEPVLLL
AQAVTQLMV	AQAVTQLMV
RVAPEQQMI	RVAPEQQMI
RQAYVQFAL	RQAYVQFAL
RLFIGGKKV	RLFIGGKKV
RIVENVNVII	RIVENVNVI
RQVTGVTRVTI	RQVTGVTRV
LKKPDGVKI	LKKPDGVKI
KQMDAILKA	KQMDAILKA
GQWLAHAIQTV	WLAHAIQTV
RISSKSLKV	RISSKSLKV
RLYDGLFKVI	RLYDGLFKV
SLTSVVLTL	SLTSVVLTL
RQFESLPATHI	RQFESLPAT
RQQGPLRSI	RQQGPLRSI
SQQNGTPLKV	QQNGTPLKV
ALYGQPLLL	ALYGQPLLL
SVFPGARLLTI	SVFPGARLL
RLKENQISV	RLKENQISV
ATVVTQLLV	ATVVTQLLV
AQKEEQLKI	AQKEEQLKI
RLQKYPVRV	RLQKYPVRV
HQSALELIM	HQSALELIM
RLGKIVSKI	RLGKIVSKI
RQRVIIDEL	RQRVIIDEL
QQDRIQQEI	QQDRIQQEI
QIQSIQQSI	QIQSIQQSI
ALAKVLLSL	ALAKVLLSL
LLADPQQKI	LLADPQQKI
KLHYVVTEV	KLHYVVTEV
SIPEKNRPL	SIPEKNRPL
RQISLNKV	RQISLN-KV
RILSLEQRV	RILSLEQRV
LLFEGEKKI	LLFEGEKKI
RQLEKLKEV	RQLEKLKEV
SQIHDIVLV	SQIHDIVLV
FLLEKPFSV	FLLEKPFSV
RLPLVVSFI	RLPLVVSFI
RQIDQFLVV	RQIDQFLVV
GQSFSEQHI	GQSFSEQHI
RISPPATSV	RISPPATSV
RAATFPLQV	RAATFPLQV
RVFENIVAV	RVFENIVAV
RVEEAKLLV	RVEEAKLLV
KVVNIVPVI	KVVNIVPVI
TQLTIHQRV	TQLTIHQRV
AQFSKSIEV	AQFSKSIEV
RQWQIEGTGI	RQWQIETGI
RQLEAIVRI	RQLEAIVRI
SVFGTMPLKV	SVFGTMLKV
RLKELESQV	RLKELESQV
TIAPALVSK	TIAPALVSK
YQIDAAIVRI	YQIDAAVRI
RIADGLPVAV	RIADGLVAV
GQKKLVLIL	GQKKLVLIL
RLIEVNGVDLV	RLIEVN-GV
QQAPAVDVV	QQAPAVDVV
RQWNVNWDI	RQWNVNWDI
AQQIIQLNI	AQQIIQLNI
RQFLNRDDI	RQFLNRDDI
RINNINILV	RINNINILV
SLALIEQRI	SLALIEQRI
NQYRLIVNV	NQYRLIVNV
SQFSGKITV	SQFSGKITV
ALAKHLIKI	ALAKHLIKI
YQTIPLNKI	YQTIPLNKI
ISPTGHSL	ISPTGH-SL
SLASLPLRV	SLASLPLRV
KQLASGLLLV	QLASGLLLV
HQDQMVQKI	HQDQMVQKI
VAEIEHAEK	VAEIEHAEK
RLSSVNAEV	RLSSVNAEV
AQFEHTILL	AQFEHTILL
SQADLAVLVI	SQADLAVLV
AIINLFHLI	AIINLFHLI
RLQIHQLI	RLQIHQ-LI
YQLPEILRT	YQLPEILRT
SQYKTTILL	SQYKTTILL
YIFEEPFTI	YIFEEPFTI
AQWLIQRGV	AQWLIQRGV
AQIYAIRQSI	AQIYAIQSI
VQSQRVLLFV	VQSQRVLFV
KLPYEDVAI	KLPYEDVAI
RQIGQRTI	RQIGQR-TI
HQESYPLSV	HQESYPLSV
GGIGQPLSL	GGIGQPLSL
LLPDLIQKV	LLPDLIQKV
RLMNDMTAV	RLMNDMTAV
AQTLLTQDV	AQTLLTQDV
ILSEVQQAV	ILSEVQQAV
GQLTSNLLLI	QLTSNLLLI
GVLRQQLVV	GVLRQQLVV
RQSQALILKI	RQSQALLKI
RLKYALTGDEV	KYALTGDEV
FIGDVTQKI	FIGDVTQKI
VQVGETFKV	VQVGETFKV
ALPNVYEVI	ALPNVYEVI
HQVPAVSSV	HQVPAVSSV
FQNIRPLFI	FQNIRPLFI
AVTDASFKV	AVTDASFKV
RLLIPVRTV	RLLIPVRTV
VQLVLPLLV	VQLVLPLLV
FQVTRDLIV	FQVTRDLIV
RQVGKTLRIQ	RQVGKTLRI
YQTPLHLAV	YQTPLHLAV
RTVDARLKL	RTVDARLKL
AQYRLVTEI	AQYRLVTEI
REAEIYQTV	REAEIYQTV
AAHQIVQLI	AAHQIVQLI
RALDYALQI	RALDYALQI
RLPVIEPVSI	RLPVIEVSI
ILLKDILSV	ILLKDILSV
RQHVLTRI	RQHVLT-RI
QLSTVITQV	QLSTVITQV
RLPGEAQKI	RLPGEAQKI
KQLYLERV	KQLYLE-RV
KLWEMDNMLI	KLWEMDMLI
RQILEGVHFL	RQILEGHFL
IIHEIAVLEL	IIHEIALEL
GQTPLMLAI	GQTPLMLAI
SSVDQPLKI	SSVDQPLKI
KQINIDFRT	KQINIDFRT
GQMAYILQL	GQMAYILQL
AAYKEAFEI	AAYKEAFEI
HVASVPTAV	HVASVPTAV
AQNARALKI	AQNARALKI
GQMQDARAI	GQMQDARAI
KLIPNAIQI	KLIPNAIQI
HQTQVSQRL	HQTQVSQRL
RQLGSKVLL	RQLGSKVLL
ALYEQSLHI	ALYEQSLHI
VVSDILFKI	VVSDILFKI
SQIKYAAKV	SQIKYAAKV
SISGMLLKV	SISGMLLKV
AISSVRLYI	AISSVRLYI
FLLDKALLI	FLLDKALLI
AQIELLQLL	AQIELLQLL
YQHKFQLQM	YQHKFQLQM
SQFPKHLIV	SQFPKHLIV
RQFDHPHIVKL	RQFDHPHIV
AQIQVQHV	AQIQVQ-HV
RDYLHYHI	RDYLHY-HI
VQYNEPLKV	VQYNEPLKV
TVGVEPAADGK	GVEPAADGK
AQLTSTPAI	AQLTSTPAI
RQADKVWRL	RQADKVWRL
QMSGAQIKI	QMSGAQIKI
KQTDFEHRI	KQTDFEHRI
AQGKVKLVV	AQGKVKLVV
RVLQLFTRI	RVLQLFTRI
RQLGHALLV	RQLGHALLV
QQDQVDRNI	QQDQVDRNI
AQLLKALEV	AQLLKALEV
YLPPATQVV	YLPPATQVV
AVADILFLL	AVADILFLL
ILSPTVVSI	ILSPTVVSI
RLLPGNATI	RLLPGNATI
RLQARIAHRI	LQARIAHRI
SIIDTELKV	SIIDTELKV
HQHEYFFLI	HQHEYFFLI
SQSQLISQMGI	SQLISQMGI
ILAQQPLSV	ILAQQPLSV
GLNTIPLFV	GLNTIPLFV
GLFSKVTLI	GLFSKVTLI
HQQSIPAV	HQQSIP-AV
RGALDAELKA	GALDAELKA
RQLSRELRL	RQLSRELRL
RLKEIKEELL	RLKEIKEEL
AVFGVPLIV	AVFGVPLIV
KQLAFQQQL	KQLAFQQQL
VMFKTPVSI	VMFKTPVSI
KLAKLQAQV	KLAKLQAQV
AQNGVSQLI	AQNGVSQLI
GQLLVKPTI	GQLLVKPTI
RQHPLRFIL	RQHPLRFIL
TISKVLLSI	TISKVLLSI
YLLDQHILI	YLLDQHILI
RQSFVFIVT	RQSFVFIVT
HQFESSFEL	HQFESSFEL
SLPSVRQDV	SLPSVRQDV
HLYDIHVTV	HLYDIHVTV
RLPDVQLWL	RLPDVQLWL
RLASSGALRV	RLASSGLRV
KVLDILQHI	KVLDILQHI
ALLRVTPFI	ALLRVTPFI
AVAKHNLNI	AVAKHNLNI
SQLPQAQKV	SQLPQAQKV
FQTLKYLAI	FQTLKYLAI
GQIEVVPEV	GQIEVVPEV
RIKELEERI	RIKELEERI
HQIFHVLVV	HQIFHVLVV
AQQPHIAGV	AQQPHIAGV
RQVASHVGL	RQVASHVGL
KLWKGARSV	KLWKGARSV
RQHTQIVRL	RQHTQIVRL
HQLENLSNFI	HQLENLNFI
LRLLKTLET	LRLLKTLET
GVNKDSYLI	GVNKDSYLI
VQLLIPRI	VQLLIP-RI
RQHNWPLTM	RQHNWPLTM
GQDVGRYQV	GQDVGRYQV
RLYGKLAKV	RLYGKLAKV
AAQASDLEK	AAQASDLEK
HQAQLISKI	HQAQLISKI
HQIHVEQSI	HQIHVEQSI
LQNADPLKV	LQNADPLKV
GQAEALDKI	GQAEALDKI
RLAEAHAKVRL	RLAEAHAKV
RLMSGKVKV	RLMSGKVKV
QSESELQKL	QSESELQKL
KQMSISTGL	KQMSISTGL
SMPDVDLHV	SMPDVDLHV
LQSAHPVRV	LQSAHPVRV
LLRDREVGI	LLRDREVGI
RLYHITDQV	RLYHITDQV
GQSKGFALVGV	GQSKGFALV
STYLRPLLV	STYLRPLLV
RQIKINEV	RQIKIN-EV
LLVDEFLKV	LLVDEFLKV
TVTTVILEV	TVTTVILEV
HQTIVMQFI	HQTIVMQFI
MMAKKHLEI	MMAKKHLEI
SQSPLPQYV	SQSPLPQYV
AQGATLLHI	AQGATLLHI
RQYLDPAQRGV	YLDPAQRGV
RQAAEDKSWRV	RQAAEDKSW
HVSLVQLTL	HVSLVQLTL
AQAKPALKI	AQAKPALKI
RIFGKKQMRI	RIFGKKMRI
RQAKLDYQRL	RQAKLDQRL
RLAALEQNV	RLAALEQNV
RLAVYIDKV	RLAVYIDKV
LQASNVTNK	LQASNVTNK
RQPHTILRV	RQPHTILRV
KLSAEKVEI	KLSAEKVEI
AQFKGTQSL	AQFKGTQSL
MLRIVEPYV	MLRIVEPYV
GQSKGYAEVVV	GQSKGYAEV
GQAALDRLKV	GQAALDLKV
RQTKPLKVQV	RQTKPLVQV
RQWLIEQI	RQWLIE-QI
WQNVRALYI	WQNVRALYI
AVDPAILLI	AVDPAILLI
SQLTQHQSI	SQLTQHQSI
RVANQDLQV	RVANQDLQV
HQHRLGLGV	HQHRLGLGV
KLAVRPLSV	KLAVRPLSV
SQAEIEQKI	SQAEIEQKI
STAAVIQNV	STAAVIQNV
RQLSSGVSEI	RQLSSGSEI
SQVKSKLQI	SQVKSKLQI
YQTEIGQTL	YQTEIGQTL
AQYSGAQVRV	AQYSGAVRV
YTDATPLRV	YTDATPLRV
RVAQLEQVYI	RVAQLEVYI
RQLAKIHAI	RQLAKIHAI
TLMSLPTKI	TLMSLPTKI
AQMDYQLRL	AQMDYQLRL
RLTPLQLEI	RLTPLQLEI
YQYPRPLLI	YQYPRPLLI
HQPPPAPRV	HQPPPAPRV
KLAPKDIKI	KLAPKDIKI
AIFAIPLQI	AIFAIPLQI
KGIVLEKV	KGIVLE-KV
RQLGSKYILGI	RQLGSKYIL
IKLDISRTF	IKLDISRTF
AVMDAALLLI	AVMDAALLI
AQSQAVTKI	AQSQAVTKI
AQLPSLLSV	AQLPSLLSV
RLKEAYSV	RLKEAY-SV
GQTFVFHVV	GQTFVFHVV
AQKPVVHLI	AQKPVVHLI
YLGIVELLV	YLGIVELLV
RQMTVIRKV	RQMTVIRKV
NAPWAVTSL	NAPWAVTSL
RQVRELKTKI	RQVRELTKI
KLVAIVDVI	KLVAIVDVI
LQRYSEDRI	LQRYSEDRI
FSSDFTLKI	FSSDFTLKI
ALNSKILSV	ALNSKILSV
RIFGETIDI	RIFGETIDI
AVVDTVLAL	AVVDTVLAL
FLSSVIQNL	FLSSVIQNL
RIPAYFVTV	RIPAYFVTV
SQAAAKLAL	SQAAAKLAL
ALNYLQLLV	ALNYLQLLV
KLFGMIITI	KLFGMIITI
RLFSKEEKL	RLFSKEEKL
KATAYILSV	KATAYILSV
RMREEFDKI	RMREEFDKI
HQWNPPLAV	HQWNPPLAV
RLRPEDPVL	RLRPEDPVL
ATHLVILLI	ATHLVILLI
RILGIIDAI	RILGIIDAI
GQGPSHLSV	GQGPSHLSV
ALVRYYLQV	ALVRYYLQV
AQNPQIKRI	AQNPQIKRI
RLYSVSYLL	RLYSVSYLL
AQPLQPLQV	AQPLQPLQV
QMTNILQQI	QMTNILQQI
KQLKEKMKI	KQLKEKMKI
RVLKPGGLLKV	VLKPGGLKV
RQAATEFGWTL	RQAATEFGW
RQLVAQSGV	RQLVAQSGV
VQIKQETI	VQIKQE-TI
RPPGFSPFR	RPPGFSPFR
HQTPLHLAV	HQTPLHLAV
RVYGGLTTKV	RVYGGLTKV
RQQYLRQEV	RQQYLRQEV
TQDQNSSSWLI	DQNSSSWLI
RQHLLFRSL	RQHLLFRSL
GPSSVEDIK	GPSSVEDIK
FQALLPYAV	FQALLPYAV
AQVLLHNV	AQVLLH-NV
HLTETQVKI	HLTETQVKI
GSVVQFKI	GSVVQF-KI
KIVEIDAHI	KIVEIDAHI
RLSEEASQALI	RLSEEAQAL
HQSHLILRA	HQSHLILRA
MQLPTRQEI	MQLPTRQEI
DLAAVILHV	DLAAVILHV
RTTETQVLV	RTTETQVLV
KVHPAVVI	KVHPAV-VI
RIINTFLKT	RIINTFLKT
RQADITRETV	RQADITETV
RQVFQQTI	RQVFQQ-TI
GQNPTNAEV	GQNPTNAEV
LQFDGIHVV	LQFDGIHVV
RQNFTEPTAI	RQNFTETAI
SQPVLQIFV	SQPVLQIFV
RIHPVSTMV	RIHPVSTMV
KQHGDVVSAI	KQHGDVSAI
QQIELDLKA	QQIELDLKA
TMIDFPQMV	TMIDFPQMV
AQNLHQNLI	AQNLHQNLI
KLTVVVNNI	KLTVVVNNI
RQFGVIAKT	RQFGVIAKT
RLAKVHAYII	RLAKVHAYI
RMFFGKNKV	RMFFGKNKV
RQSGSAVITFV	RQSGSA-VI
KLFDAPLSI	KLFDAPLSI
ASLVFPLLV	ASLVFPLLV
IQPNIQLIL	IQPNIQLIL
KMYSEIDIKV	KMYSEIIKV
RQADFVQVL	RQADFVQVL
GQVPPLQSV	GQVPPLQSV
HQIIQQYMV	HQIIQQYMV
VQFFSGLEI	VQFFSGLEI
YQKSTELLI	YQKSTELLI
GQAFLYHQV	GQAFLYHQV
SQNKSYLAV	SQNKSYLAV
FSVPVKQEV	FSVPVKQEV
KLYHNEVEI	KLYHNEVEI
KQFHHQLRV	KQFHHQLRV
KQYTGINAI	KQYTGINAI
AQHKWILQL	AQHKWILQL
RISDIRLFI	RISDIRLFI
RLPFLDSQTGV	RLPFLDSQT
RLKEIKEEL	RLKEIKEEL
AMFGKLMTI	AMFGKLMTI
GQNESFARI	GQNESFARI
RLSPVSPAL	RLSPVSPAL
VQNHEFLLV	VQNHEFLLV
RQKLQLEKV	RQKLQLEKV
RVVKLNEV	RVVKLN-EV
GQTPSQLLI	GQTPSQLLI
SQTAIALDI	SQTAIALDI
QVAAEILEI	QVAAEILEI
KQIDVYRSV	KQIDVYRSV
RLLDQRDRI	RLLDQRDRI
VQYALPLQL	VQYALPLQL
RQSVNVESI	RQSVNVESI
RQFPVTVHF	RQFPVTVHF
RLVRVSTSV	RLVRVSTSV
SLVSIPLVI	SLVSIPLVI
KLLKPSLAV	KLLKPSLAV
AQHSVPLQLEL	AQHSVPLQL
QVFKGAVKI	QVFKGAVKI
IVEMSTSK	IVEMST-SK
KEFKSQLFV	KEFKSQLFV
FQVLQPQV	FQVLQP-QV
LLQDIILQV	LLQDIILQV
SQKAIQDEI	SQKAIQDEI
RLKKPDQAI	RLKKPDQAI
GLAPPQHLI	GLAPPQHLI
GQWEVKKI	GQWEVK-KI
RQMEPFPLRV	RQMEPFLRV
RTSDKAILV	RTSDKAILV
SEYPVILSI	SEYPVILSI
RQGPNANLV	RQGPNANLV
GLLPSPLAV	GLLPSPLAV
LEHKIIIRV	LEHKIIIRV
YSSNTRFTI	YSSNTRFTI
VQIRIFKI	VQIRIF-KI
AVYRKALVI	AVYRKALVI
KQHFINQAV	KQHFINQAV
RQAPPHIEL	RQAPPHIEL
AQLPMSIRI	AQLPMSIRI
GQSTPRLFSI	GQSTPRFSI
KETNIQLFV	KETNIQLFV
VVVATNGKVLK	VVVATNGKV
KEFIGQQLI	KEFIGQQLI
TQQDVELHV	TQQDVELHV
RTIKLEHV	RTIKLE-HV
RSIVLLLKV	RSIVLLLKV
RLQQLQHRV	RLQQLQHRV
RALQQFLYV	RALQQFLYV
HQRTFVLEV	HQRTFVLEV
AQYRGILEA	AQYRGILEA
RQLESMIRL	RQLESMIRL
FQRAVKDEL	FQRAVKDEL
HQQSIPAVLEI	QSIPAVLEI
RQVGQIIRV	RQVGQIIRV
SLFKLIVKV	SLFKLIVKV
LLFPESIRV	LLFPESIRV
GQTKEVLVI	GQTKEVLVI
HQEVVELLI	HQEVVELLI
GQMQNIQVSI	GQMQNIVSI
RISELQWSV	RISELQWSV
RLTSFIGAI	RLTSFIGAI
AQFSAQPHV	AQFSAQPHV
TLINLLLKV	TLINLLLKV
YVTSVILHI	YVTSVILHI
RLFPVPGSGLV	RLFPVPSGL
RLDETIQAI	RLDETIQAI
RMKGGEKIGI	RMKGGE-KI
YQTVVTPVI	YQTVVTPVI
SQHDILQMI	SQHDILQMI
RLYGKVLRA	RLYGKVLRA
KVGHVILEV	KVGHVILEV
HISHIAQQV	HISHIAQQV
HQGVAVLGI	HQGVAVLGI
KQLAENLVVI	KQLAENLVV
GQLKSVTI	GQLKSV-TI
GLHRQLLYI	GLHRQLLYI
GQLNLHQRI	GQLNLHQRI
RQFQPTQDNV	RQFQPTDNV
IVAHIIQKI	IVAHIIQKI
HQTNLILQT	HQTNLILQT
KQAGLVSKI	KQAGLVSKI
GQWGRAWEV	GQWGRAWEV
AQSRIALAL	AQSRIALAL
RLPEAIEEV	RLPEAIEEV
AQAPDLQRV	AQAPDLQRV
GQIKQIIRI	GQIKQIIRI
RQKDVKIVTV	RQKDVKVTV
RQREQEIAL	RQREQEIAL
RILDGMFAI	RILDGMFAI
GQVKPYSSV	GQVKPYSSV
YQHLRPQSI	YQHLRPQSI
AQYLINARL	AQYLINARL
KLFIGGLNV	KLFIGGLNV
RLLDSEIKI	RLLDSEIKI
ISSHIPLII	ISSHIPLII
RLKDLEALL	RLKDLEALL
LLSDTKLEL	LLSDTKLEL
AISGMILSI	AISGMILSI
SQLIVHQRI	SQLIVHQRI
QQTPLHLAV	QQTPLHLAV
RQHFVYDHV	RQHFVYDHV
MLSRVVLSA	MLSRVVLSA
LQAPTPLQI	LQAPTPLQI
LLTELHQLI	LLTELHQLI
KQFELALQL	KQFELALQL
RVTTINQEI	RVTTINQEI
GEHGLIIRV	GEHGLIIRV
KQIIHHLV	KQIIHH-LV
KMPDVELFV	KMPDVELFV
AQHKFLVAV	AQHKFLVAV
RLDPQSGALYI	RLDPQSGAL
RALKGVLRV	RALKGVLRV
TQHAVGIVV	TQHAVGIVV
KQVEQDIKV	KQVEQDIKV
TDTGEPMGR	TDTGEPMGR
RQFIAAIKL	RQFIAAIKL
SQTDGTLKI	SQTDGTLKI
MIRKEELEI	MIRKEELEI
VQFLVPQSI	VQFLVPQSI
SQLQTRQQI	SQLQTRQQI
RLFDDVPQV	RLFDDVPQV
AQAKIYWNL	AQAKIYWNL
GQIGPAPPLKV	QIGPAPLKV
LLKEREEKV	LLKEREEKV
RSHGVLLEV	RSHGVLLEV
RQATPLKKV	RQATPLKKV
KIIDIQEKV	KIIDIQEKV
RLMNETTAV	RLMNETTAV
FITNIPFDV	FITNIPFDV
AQFKQLLI	AQFKQL-LI
RLTDYISKV	RLTDYISKV
GQDNITVLHV	GQDNITLHV
FQAEIAQLM	FQAEIAQLM
SMTSLAQKI	SMTSLAQKI
SQHGVIIQL	SQHGVIIQL
LVFGKPVRV	LVFGKPVRV
RQIDQFLV	RQIDQF-LV
NQSSVDLKL	NQSSVDLKL
ELAEIVFKV	ELAEIVFKV
HQLFHIFVV	HQLFHIFVV
MQNPRQYKI	MQNPRQYKI
GLGKTIQAI	GLGKTIQAI
AAFEKALEV	AAFEKALEV
HQIDLIVQL	HQIDLIVQL
RLNPEMLQI	RLNPEMLQI
YQLGELVKV	YQLGELVKV
QVAPVPLNV	QVAPVPLNV
LQALEVLKI	LQALEVLKI
YLTAEILEL	YLTAEILEL
IQFKKPIIV	IQFKKPIIV
HLLPTQLEV	HLLPTQLEV
LIPNLPLQI	LIPNLPLQI
GQIRNLESARV	GQIRNLESA
LQWDKVLRL	LQWDKVLRL
RQDQIQQVV	RQDQIQQVV
RGFDKAYVV	RGFDKAYVV
RQSELEPVV	RQSELEPVV
AQKTILLQV	AQKTILLQV
MLRLLFTLV	MLRLLFTLV
MQFSGSLHT	MQFSGSLHT
ATASVNLKV	ATASVNLKV
MQVNQPLQT	MQVNQPLQT
SQLDVPFKV	SQLDVPFKV
STESLQANVQR	STESLQANV
HITNIPFSI	HITNIPFSI
AQAALAVNI	AQAALAVNI
RISDVHFSVK	RISDVHFSV
RIDGVSLLV	RIDGVSLLV
RIHPFHILI	RIHPFHILI
IQSQVVAQI	IQSQVVAQI
SIFKGQQLV	SIFKGQQLV
RQHEIVLKVAY	RQHEIVLKV
RVMLYPSRI	RVMLYPSRI
GQNRIHLEI	GQNRIHLEI
SVNATPLTI	SVNATPLTI
RQPDLVLRL	RQPDLVLRL
EDAANNYAR	EDAANNYAR
RQHILQQVL	RQHILQQVL
KQFDIQLLT	KQFDIQLLT
ALKKADIGV	ALKKADIGV
HLSDTLWLI	HLSDTLWLI
RQGKAKLVI	RQGKAKLVI
RSLEQDLKV	RSLEQDLKV
QLLDTLLAI	QLLDTLLAI
ALSPSYLTV	ALSPSYLTV
IIFETPLRV	IIFETPLRV
FQFGVPQAL	FQFGVPQAL
AQLPTIVAI	AQLPTIVAI
AETRVFLEV	AETRVFLEV
AQWHEQILV	AQWHEQILV
VATVSLPR	VATVSL-PR
FQTEVGKQLI	FQTEVGQLI
YQYPVIIHL	YQYPVIIHL
GQIELRTYV	GQIELRTYV
HLAAPKLGV	HLAAPKLGV
AQFLYAQKL	AQFLYAQKL
RIKAIVHAV	RIKAIVHAV
GQYAGHVVPTI	GQYAGH-VV
SQFGQILDI	SQFGQILDI
KLYQRDLEV	KLYQRDLEV
VQPTAAPGQKV	TAAPGQ-KV
FLGTFILKV	FLGTFILKV
KQSPPIVKI	KQSPPIVKI
TQLGAFYI	TQLGAF-YI
GQSKVFFRA	GQSKVFFRA
RLFHDSAVTSV	RLFHDS-AV
AQIDSNIAHTV	AQIDSNHTV
FQDELIRAI	FQDELIRAI
AQAEALRI	AQAEAL-RI
SLADIAQKL	SLADIAQKL
YQILPLHSQI	QILPLHSQI
YLKDLIEEV	YLKDLIEEV
GQIDKLTLKI	GQIDKLLKI
FLLHIQQQV	FLLHIQQQV
REYFHKLLI	REYFHKLLI
KQDHRGAFLI	KQDHRGFLI
HIDNNILLI	HIDNNILLI
RSGHFEQAI	RSGHFEQAI
LTQDIIMKI	LTQDIIMKI
GQVTRADILQV	QVTRADLQV
KLAPKDVKI	KLAPKDVKI
TENLNDDEK	TENLNDDEK
GQWASVIRV	GQWASVIRV
HISPVKLHL	HISPVKLHL
RQLEKIKTI	RQLEKIKTI
SLLHMPFTI	SLLHMPFTI
KLLNLISKL	KLLNLISKL
SLYGGTITI	SLYGGTITI
RQMFVQRV	RQMFVQ-RV
KLVNIRNDDI	KLVNIRDDI
GKDAVEDL	GKDAVE-DL
HQREKDFLL	HQREKDFLL
HQRLEPATL	HQRLEPATL
RIKRDIMSI	RIKRDIMSI
AQQQDVHLTV	QQQDVHLTV
LLSDVRFVL	LLSDVRFVL
AQYKFVYQV	AQYKFVYQV
GQHLVQQLVL	GQHLVQQLV
RLILIESRI	RLILIESRI
KLEEIRIKV	KLEEIRIKV
RQVPFHLHI	RQVPFHLHI
VQHIPSPKV	VQHIPSPKV
ISSNTSLKV	ISSNTSLKV
RTSSVQLRV	RTSSVQLRV
RLPAWQPIL	RLPAWQPIL
HLSKIETRI	HLSKIETRI
KLAEVSQNI	KLAEVSQNI
KAAKTPLKI	KAAKTPLKI
TVFFHPLLI	TVFFHPLLI
HEIDYILLV	HEIDYILLV
RQPYYATRV	RQPYYATRV
RQHVLTRIGV	RQHVLT-RI
SLADLQNDEV	SLADLQDEV
HQIGPGMVQQI	QIGPGMQQI
AQHQTKLYL	AQHQTKLYL
VIPELNGK	VIPELN-GK
HSVDQYLNI	HSVDQYLNI
MQTKVVERI	MQTKVVERI
AQRAEPMRI	AQRAEPMRI
GQHFNIPAI	GQHFNIPAI
KLFVIAQKI	KLFVIAQKI
YDAEISQIHQ	YDAEIS-QI
HIPEVYLIV	HIPEVYLIV
RLQSKTIKV	RLQSKTIKV
AQYEHDLEV	AQYEHDLEV
RLIDLHTNV	RLIDLHTNV
QTSATFLRV	QTSATFLRV
GSWDGTLRL	GSWDGTLRL
RIYTGEKLHV	RIYTGELHV
VTDALNATR	VTDALNATR
AAAAAAALQAK	AAAAAALQA
LQHPVTTDI	LQHPVTTDI
HAFSFPLLI	HAFSFPLLI
YQKSTELLIR	YQKSTELLI
KLLDFILKT	KLLDFILKT
FQHTGIYSV	FQHTGIYSV
KLAPPLVTL	KLAPPLVTL
RQHVIDVQI	RQHVIDVQI
RLNEAAVTV	RLNEAAVTV
ALLAKILQI	ALLAKILQI
TLFPSKIGV	TLFPSKIGV
RGADISLQV	RGADISLQV
KMYAVDTRV	KMYAVDTRV
AQNGIPLRI	AQNGIPLRI
HQNHLIVKV	HQNHLIVKV
SQLISHHRI	SQLISHHRI
AQPGIQMKV	AQPGIQMKV
AQHDDELTI	AQHDDELTI
HQTITIQEM	HQTITIQEM
SLFPGQVVI	SLFPGQVVI
GQTVNLQAV	GQTVNLQAV
DGRATQKLIV	GRATQKLIV
SSPPPHPQL	SSPPPHPQL
RLIGDAAKNQV	LIGDAANQV
SLVEIILHV	SLVEIILHV
GLSETILAV	GLSETILAV
GQFKDIITKV	GQFKDITKV
AQFKQGVKSV	AQFKQGKSV
RLLPGDIILKV	RLLPGDLKV
GQSELASRLTL	GQSELASRL
KIYEGQVEV	KIYEGQVEV
GQLIEPLQI	GQLIEPLQI
EITALAPSTMK	EITALAPST
AQTKVTFLI	AQTKVTFLI
LPAKEENVILV	AKEENVILV
GQALELPLRI	GQALELLRI
RLIEETISI	RLIEETISI
HLLPTEQRI	HLLPTEQRI
RIMEVIDAI	RIMEVIDAI
SLVNIVQHI	SLVNIVQHI
ELFGKFLFI	ELFGKFLFI
ESYGNPLRV	ESYGNPLRV
RLLEEQRRV	RLLEEQRRV
EIVRESHSL	EIVRESHSL
RIKSQELEV	RIKSQELEV
KLPFAAAQI	KLPFAAAQI
GQMPSDKTI	GQMPSDKTI
AQYLINVRL	AQYLINVRL
RSVPVRLHV	RSVPVRLHV
KVADTILFL	KVADTILFL
RVLFIKDVI	RVLFIKDVI
RLNKVIKSV	RLNKVIKSV
RQALAAPRV	RQALAAPRV
LQPEIIVKI	LQPEIIVKI
GTLDPVEK	GTLDPV-EK
RQIDQMVGLI	RQIDQMVGL
RMARTPQTV	RMARTPQTV
HQNDKQISI	HQNDKQISI
AQLDPEALGNI	AQLDPE-AL
GQSYVVNRV	GQSYVVNRV
RSVDLQTRI	RSVDLQTRI
SQAPSTMQV	SQAPSTMQV
VTLTSEEEAR	TLTSEEEAR
SQTSVQLIVF	SQTSVQLIV
SQYPFPVTL	SQYPFPVTL
HLLDFPNIVI	HLLDFPIVI
RMIKLGLGI	RMIKLGLGI
YTTDRVMTV	YTTDRVMTV
RQTEIYQYVL	RQTEIYQYV
KIYAIPIEI	KIYAIPIEI
QQFNVQALV	QQFNVQALV
KLLEQALVI	KLLEQALVI
LQRPDEEAI	LQRPDEEAI
RQIDVHIFNAV	RQIDVHFNA
KLYGKPIRV	KLYGKPIRV
PAPPKPEPK	PAPPKPEPK
RAHNVPLKL	RAHNVPLKL
QQSGVPQQI	QQSGVPQQI
YLLPAIVHI	YLLPAIVHI
TQLPQSMKI	TQLPQSMKI
RLLNKSIIRV	RLLNKSIRV
ELLRIGLSV	ELLRIGLSV
HQSTVDWIV	HQSTVDWIV
AQGQQTLKV	AQGQQTLKV
GQSPVALDI	GQSPVALDI
HLITPLVTI	HLITPLVTI
AQYNFILVV	AQYNFILVV
RQMSGAQIKI	RQMSGAIKI
RLTDTDAAI	RLTDTDAAI
VLSQHFQTV	VLSQHFQTV
QTVAVGVIK	QTVAVGVIK
KEIENGHIFTV	IENGHIFTV
SQANVVVKI	SQANVVVKI
RLSPKPVRV	RLSPKPVRV
AVHNVPLSV	AVHNVPLSV
RVIDYILDL	RVIDYILDL
AQIDHYLGL	AQIDHYLGL
SQWRAVQGI	SQWRAVQGI
RLKGKDMVV	RLKGKDMVV
FLHGPDQQV	FLHGPDQQV
RQLEEARQI	RQLEEARQI
GQYPRFLRA	GQYPRFLRA
RQDLTQSLIMI	RQDLTQSLI
SQNGVLLGI	SQNGVLLGI
KLKQFEERL	KLKQFEERL
RLADFGISAQI	RLADFGISA
NLYNHPQLI	NLYNHPQLI
AQYNPKLDV	AQYNPKLDV
RIKKPDYKV	RIKKPDYKV
AQVAAEILEI	AQVAAELEI
KQFEGTVEI	KQFEGTVEI
AVVRNALAHV	AVVRNAAHV
RIFSEVRRI	RIFSEVRRI
RSIAFHSAV	RSIAFHSAV
TQMIKAWQV	TQMIKAWQV
QIHSVITAI	QIHSVITAI
SQARFGQSV	SQARFGQSV
KMSSVKLRL	KMSSVKLRL
SQMPVPVHV	SQMPVPVHV
AIMDIVIKV	AIMDIVIKV
KLDHVVTII	KLDHVVTII
RQHEIVLKVA	RQHEIVLKV
HLAVVELLL	HLAVVELLL
RLINQVLEL	RLINQVLEL
KLFDTQHRV	KLFDTQHRV
RLFQTEEKI	RLFQTEEKI
GLIHISQVI	GLIHISQVI
AQHSVPLQL	AQHSVPLQL
KEIFLRELI	KEIFLRELI
SQVDVAVKI	SQVDVAVKI
GQAGGKLHII	GQAGGKLHI
SLSQVFLHL	SLSQVFLHL
RQLKAFKSV	RQLKAFKSV
SQFGHVVDI	SQFGHVVDI
VLHDVIYVI	VLHDVIYVI
RMLAHPLHVI	RMLAHPLHV
AQLSPTHQI	AQLSPTHQI
QQPPVQPQV	QQPPVQPQV
AMKPKPLSV	AMKPKPLSV
RQWLAIQKL	RQWLAIQKL
KQLENGVLQI	KQLENGLQI
VQPHISPLTI	VQPHISLTI
AQYGKKVMV	AQYGKKVMV
IQHMELQLI	IQHMELQLI
LQAQIQEQHV	LQAQIQQHV
DSQPPVFKV	DSQPPVFKV
RQFKEIAAV	RQFKEIAAV
ELSRIVLEV	ELSRIVLEV
KQQQQQQFV	KQQQQQQFV
RQGVLGIKV	RQGVLGIKV
FQKLYDLYI	FQKLYDLYI
RVFTGQAKV	RVFTGQAKV
RLIPTLVSI	RLIPTLVSI
GLSPVTNLTV	GLSPVTLTV
LMNAVVQTV	LMNAVVQTV
WQLKVIENV	WQLKVIENV
RQVQGPVLV	RQVQGPVLV
LSMGLILRL	LSMGLILRL
SQKHLILLI	SQKHLILLI
LLPSVRQEV	LLPSVRQEV
GAAATHLEV	GAAATHLEV
GSWDKMLKI	GSWDKMLKI
RLTRLYLKA	RLTRLYLKA
KLYEQHHVV	KLYEQHHVV
FEFDIHQVI	FEFDIHQVI
RVGDIHILEV	RVGDIHLEV
RLVSWVNLI	RLVSWVNLI
SQMPTVIYV	SQMPTVIYV
GQAHIHVVGV	GQAHIHVGV
RQMDIIVSEV	RQMDIISEV
RAYIVQLQI	RAYIVQLQI
HLPETKFSEL	HLPETKSEL
GQFIGPHRI	GQFIGPHRI
AFSDVILAV	AFSDVILAV
GQTIIHHHI	GQTIIHHHI
LLSHVEQLL	LLSHVEQLL
HQADIGEYV	HQADIGEYV
RLLAEPVPGI	RLLAEPPGI
GQVKLTKAV	GQVKLTKAV
RLHFLPESV	RLHFLPESV
SQSIHQAVI	SQSIHQAVI
RLKEYEKAL	RLKEYEKAL
RQGLSMRQI	RQGLSMRQI
VQYKGHVEI	VQYKGHVEI
KVIDTQQKV	KVIDTQQKV
RLTPQAVKI	RLTPQAVKI
WQVVDTPGI	WQVVDTPGI
HVPNVTLLI	HVPNVTLLI
HSLPLLLFI	HSLPLLLFI
AAGAVFLSV	AAGAVFLSV
KQGYVIYRI	KQGYVIYRI
RQLYEPLVM	RQLYEPLVM
SLLKEPQKV	SLLKEPQKV
QITQVNQRV	QITQVNQRV
KQHGVNVSV	KQHGVNVSV
ALSRLKLKL	ALSRLKLKL
RQPDSGISSI	RQPDSGSSI
TVNEIVLKV	TVNEIVLKV
HQALHSISV	HQALHSISV
AQVEGGVHSL	AQVEGGHSL
RIFGYPVGI	RIFGYPVGI
KQFEKQVEL	KQFEKQVEL
TLAAVLQRI	TLAAVLQRI
RQVGQVAKQQV	RQVGQVQQV
RQGPEGLEV	RQGPEGLEV
RQKLDPKI	RQKLDP-KI
AQAELAQKL	AQAELAQKL
KQWKGGPVKI	KQWKGGVKI
RILDIDIPMSV	LDIDIPMSV
RQGMFAQLV	RQGMFAQLV
VQFEDGQKI	VQFEDGQKI
KQLPKFFLI	KQLPKFFLI
ALDAHQQSI	ALDAHQQSI
SQLIVHQGI	SQLIVHQGI
DSYVGDEAQSK	YVGDEAQSK
KLTELEQRI	KLTELEQRI
RLAQVAKAV	RLAQVAKAV
KQAFERLEV	KQAFERLEV
RLLPKVQEV	RLLPKVQEV
AQTSYIQQI	AQTSYIQQI
VMKHADPRI	VMKHADPRI
EQAATQLKV	EQAATQLKV
RTMLVRKI	RTMLVR-KI
SVYDGKLLI	SVYDGKLLI
AQALAKLTI	AQALAKLTI
RQGEVVQRL	RQGEVVQRL
RGTKVILHL	RGTKVILHL
GQFKGLVKA	GQFKGLVKA
IQTAVRLLLP	IQTAVRLLL
RAMSIAQRV	RAMSIAQRV
AQFTTALRL	AQFTTALRL
RIFQTLLEV	RIFQTLLEV
VTIKKDVDGAY	TIKKDVDGA
QQGTTKLSV	QQGTTKLSV
KLRHIVDEV	KLRHIVDEV
SSSTVVQEI	SSSTVVQEI
TQTAVITRI	TQTAVITRI
TQEQVRLLI	TQEQVRLLI
AQYFLDKI	AQYFLD-KI
RVKFTDDRV	RVKFTDDRV
RQFYEEELI	RQFYEEELI
SQLIVHQEI	SQLIVHQEI
AQSKLALVL	AQSKLALVL
GLYPAPLKI	GLYPAPLKI
GQFILTPHI	GQFILTPHI
RMFDGKFVV	RMFDGKFVV
HQREREFLL	HQREREFLL
ILPKILQDV	ILPKILQDV
AQLELISRI	AQLELISRI
RQSTAKIQI	RQSTAKIQI
QQNGSVVRV	QQNGSVVRV
RQFVPIKVEQI	RQFVPI-KV
RIKNNDPKL	RIKNNDPKL
HAAEYGAEALE	HAAEYGAEA
GLHNVVYGI	GLHNVVYGI
RLAAIVAKQV	RLAAIVKQV
SLLHVEQEV	SLLHVEQEV
GQWKKGFVL	GQWKKGFVL
KMFEVDMKI	KMFEVDMKI
QLTLIKQEI	QLTLIKQEI
FVSGVIVKI	FVSGVIVKI
YQFGEIRTI	YQFGEIRTI
GSPAVTLLI	GSPAVTLLI
FLYSDEVQI	FLYSDEVQI
RQLTANTGHTI	LTANTGHTI
LLAEPVPGI	LLAEPVPGI
RQVSMVQTL	RQVSMVQTL
HQHQVHNVEI	HQHQVHVEI
KQNPEGQWTI	KQNPEGWTI
SLFAGGMLRV	SLFAGGLRV
QQIKLWKV	QQIKLW-KV
ELYPEPLLV	ELYPEPLLV
RQLTEKLTV	RQLTEKLTV
KIFQEMLYI	KIFQEMLYI
RLLENMTEV	RLLENMTEV
KQIDYTVPTVI	KQIDYTPTV
YQIAVTKV	YQIAVT-KV
ALAPSTMKI	ALAPSTMKI
FQSSAVMAL	FQSSAVMAL
FQNTFPHSI	FQNTFPHSI
RIDGKTYVI	RIDGKTYVI
RLSEVQASL	RLSEVQASL
KLSEYEMSI	KLSEYEMSI
RMLKEILKI	RMLKEILKI
LLLPGELAK	LLLPGELAK
GQAEEVVQERI	GQAEEVERI
RQFSTPFQL	RQFSTPFQL
REINYILRV	REINYILRV
AQITQKIGV	AQITQKIGV
HQSDRYVKI	HQSDRYVKI
RLQTALLV	RLQTAL-LV
AQLSPQLTV	AQLSPQLTV
RMPKVQQTV	RMPKVQQTV
KQQLFSYAI	KQQLFSYAI
RNVSTGDVNVE	NVSTGDVNV
RLLPPGAVVAV	RLLPPGAVV
RQYLPGNEQGV	YLPGNEQGV
RIADSFQVI	RIADSFQVI
GQFKKTQIL	GQFKKTQIL
RLAKSDPMV	RLAKSDPMV
KVSAAALAV	KVSAAALAV
KTLSAILRI	KTLSAILRI
AQILRLLHI	AQILRLLHI
QMLDVAIRV	QMLDVAIRV
GLNDFIQKI	GLNDFIQKI
HLKQYERSI	HLKQYERSI
KLLEATSAV	KLLEATSAV
GQYMGQLKM	GQYMGQLKM
QQVQTQIQV	QQVQTQIQV
RLLQRDVQI	RLLQRDVQI
TQHHVEALV	TQHHVEALV
SQAIVKVVI	SQAIVKVVI
AITSVQQRL	AITSVQQRL
TVAPTSLVV	TVAPTSLVV
GQDSIVLLI	GQDSIVLLI
RQVQPEGPYRV	VQPEGPYRV
RQLKHSYYRI	RQLKHSYRI
VLTQIILKT	VLTQIILKT
KQGAFITLV	KQGAFITLV
HLKNTMETI	HLKNTMETI
AQYFEPLTL	AQYFEPLTL
YALNHTLSV	YALNHTLSV
RSAVVEMLI	RSAVVEMLI
QQISGVQQI	QQISGVQQI
RQALPQVRL	RQALPQVRL
AQLQDFDWQV	QLQDFDWQV
RVANVADVV	RVANVADVV
EQGKIQLLI	EQGKIQLLI
RIPELVQRI	RIPELVQRI
GQASIPTEI	GQASIPTEI
RLAVYIDRV	RLAVYIDRV
RQKFGYSV	RQKFGY-SV
RSAEVTLEV	RSAEVTLEV
YQVGQLYSV	YQVGQLYSV
RIMKAQAL	RIMKAQ-AL
AQVPMNMTI	AQVPMNMTI
KLFEKKYSV	KLFEKKYSV
GLGKTIQTI	GLGKTIQTI
GQLNQAMKI	GQLNQAMKI
GQLDSPGSLKI	GQLDSPGSL
GQHMVEQLL	GQHMVEQLL
AQYDRQIRL	AQYDRQIRL
YQPLFDKRFEI	PLFDKRFEI
ALIPIPLAV	ALIPIPLAV
RLLDYVVNI	RLLDYVVNI
RQLQKMVHDI	RQLQKMHDI
FLFQEPRSI	FLFQEPRSI
RMITAMNTI	RMITAMNTI
SLFAGQPLTI	SLFAGQLTI
RLAQHITYV	RLAQHITYV
RQAAFKLYA	RQAAFKLYA
KLHGVNINV	KLHGVNINV
SQGRSELHI	SQGRSELHI
KQISQAYEV	KQISQAYEV
AQYKFIYVAI	AQYKFIVAI
IAGQVAAANK	GQVAAA-NK
FQGDIRLLM	FQGDIRLLM
KLPPKDLRI	KLPPKDLRI
QQNGTPLKV	QQNGTPLKV
RLKEIEHNL	RLKEIEHNL
SIFGKQLVV	SIFGKQLVV
HIFHAIAV	HIFHAI-AV
RLLQQEEKV	RLLQQEEKV
LSAEAAEK	LSAEAA-EK
ILLATGLHV	ILLATGLHV
RLQEVTHSV	RLQEVTHSV
HQQIQAQLV	HQQIQAQLV
GTAPVNLNI	GTAPVNLNI
VQIPVFVMI	VQIPVFVMI
GQIVQSKI	GQIVQS-KI
SLYVRPVLI	SLYVRPVLI
AQVVGVLKI	AQVVGVLKI
ETQITQIEHEV	QITQIEHEV
AQAAALYKV	AQAAALYKV
AQAIKGMHI	AQAIKGMHI
SQTIALLNI	SQTIALLNI
GSFGKVFLV	GSFGKVFLV
HGFAGVILI	HGFAGVILI
GQHAFYQLI	GQHAFYQLI
GQLKGFAV	GQLKGF-AV
KQYEGGIFKI	KQYEGGFKI
GQHGGFVVTV	GQHGGFVTV
GQAPEGLKV	GQAPEGLKV
ASYSGLMRI	ASYSGLMRI
IQRGPVRGI	IQRGPVRGI
SASRVVQVV	SASRVVQVV
RLLDLENIQI	RLLDLEIQI
RAAQLAIRV	RAAQLAIRV
GQSRGVPAV	GQSRGVPAV
KQMKPHIQNI	KQMKPHQNI
RIVKGEVSV	RIVKGEVSV
SLLRSIFTV	SLLRSIFTV
RMLAHPLHV	RMLAHPLHV
KQFGNILIL	KQFGNILIL
ALFAGGKLRV	ALFAGGLRV
VQVPVPVTV	VQVPVPVTV
RQGQIEVSI	RQGQIEVSI
FMFGQKLNV	FMFGQKLNV
AQLPLKVEV	AQLPLKVEV
KLIKDGLII	KLIKDGLII
AQFGYYFRV	AQFGYYFRV
HLTEMQAKV	HLTEMQAKV
VLYDRPLKI	VLYDRPLKI
RLVEVNGENV	RLVEVNENV
KQIDQFLVV	KQIDQFLVV
LLFDRPMHV	LLFDRPMHV
HLNPDPQLI	HLNPDPQLI
KQFLVKVLI	KQFLVKVLI
RIMEIVDAI	RIMEIVDAI
IQHVFQNLI	IQHVFQNLI
RLSQAGARVKI	SQAGARVKI
FALRVQQLV	FALRVQQLV
KLYGRPIKI	KLYGRPIKI
RIKQITEEV	RIKQITEEV
KLIGQVHEV	KLIGQVHEV
KQPKGTFLI	KQPKGTFLI
HMFGQNLEV	HMFGQNLEV
IQIDLETGKI	IQIDLEGKI
AQFPSVAV	AQFPSV-AV
LLNDHIYVV	LLNDHIYVV
AQIPLAAVI	AQIPLAAVI
VVVSVPQRI	VVVSVPQRI
LKLLLPLLL	LKLLLPLLL
RITSLIVHV	RITSLIVHV
REHTALLKI	REHTALLKI
KLLFWVTEV	KLLFWVTEV
AQHDPLLTGV	AQHDPLTGV
RLPAAGVGDMV	RLPAAGVGD
IQMKIFPAL	IQMKIFPAL
HLREYQDLL	HLREYQDLL
KTASIELRV	KTASIELRV
SLLPHPIIV	SLLPHPIIV
ALHDILTEI	ALHDILTEI
SLSGRPLKV	SLSGRPLKV
GLTDIRTLV	GLTDIRTLV
EQQSVLQRI	EQQSVLQRI
QLVDIIEKV	QLVDIIEKV
RQAEITRLLL	RQAEITLLL
RLISQIVSSI	RLISQISSI
KLNVAPLAV	KLNVAPLAV
RQTKTSLEVSL	RQTKTSLEV
QMNHIVMEI	QMNHIVMEI
EAAEVILRV	EAAEVILRV
GQVLVKPYI	GQVLVKPYI
RAFGIPIRV	RAFGIPIRV
RQIEGRVVEI	RQIEGRVEI
HVHGVLNGV	HVHGVLNGV
RQFDNFKRV	RQFDNFKRV
GQVIIHNI	GQVIIH-NI
KLHGKILVI	KLHGKILVI
VQFRLRQVV	VQFRLRQVV
DPFNPFELTNH	DPFNPFELT
GQLPEAPVI	GQLPEAPVI
KSSEIEQAV	KSSEIEQAV
QVVGTPLLV	QVVGTPLLV
AASPIITLV	AASPIITLV
RLLPEKLTI	RLLPEKLTI
EQHKALLKV	EQHKALLKV
RLTPKLMEV	RLTPKLMEV
YQSKVRELI	YQSKVRELI
RLKSKDVKL	RLKSKDVKL
FISKEILTI	FISKEILTI
RLPEIYIQL	RLPEIYIQL
ASQSTVKVLI	SQSTVKVLI
SLHDAIMIV	SLHDAIMIV
SQFAFESVV	SQFAFESVV
SQIKLYNI	SQIKLY-NI
DTGRPSTTVR	DTGRPSTTV
RQTASVTLQAI	RQTASVQAI
RQMAEIAVNAV	RQMAEI-AV
AQQVVKQEL	AQQVVKQEL
SQVAGTPMFV	SQVAGTMFV
VQMQVVQQL	VQMQVVQQL
RQLESLIRL	RQLESLIRL
RLQRIHAEI	RLQRIHAEI
GQHPSQHLI	GQHPSQHLI
GQVTALLTSI	GQVTALTSI
LLSRVLFAL	LLSRVLFAL
MSADVPLVV	MSADVPLVV
HLDVVALLI	HLDVVALLI
RLSLHKGKI	RLSLHKGKI
RVLQNVAFSV	VLQNVAFSV
RLIILIQQV	RLIILIQQV
QLAPVFQRV	QLAPVFQRV
RQFDVDILI	RQFDVDILI
AQFPESFTV	AQFPESFTV
GMYIFLHTV	GMYIFLHTV
RMLIKLLEV	RMLIKLLEV
ALSDIFQAV	ALSDIFQAV
LTTKIMQLI	LTTKIMQLI
RQLPMKIRI	RQLPMKIRI
KQPSHHPLRI	KQPSHHLRI
EANQAINPK	EANQAINPK
RQPQGHLLLI	RQPQGHLLI
RISPWLLRV	RISPWLLRV
SQVAVAGLLTV	SQVAVAGLL
AQHVEVESI	AQHVEVESI
RMLPHAPGV	RMLPHAPGV
SQTIQPKV	SQTIQP-KV
RVHPVSTMI	RVHPVSTMI
IANTVELRV	IANTVELRV
KQVHPDTGI	KQVHPDTGI
RLLGYQGIAV	RLLGYQIAV
LLFEGEKITI	LLFEGEITI
KLIQNVFEI	KLIQNVFEI
RLFPKALGQLI	RLFPKAQLI
RQTKTSLEV	RQTKTSLEV
RQSSLELTVW	RQSSLELTV
HLAEHSLQV	HLAEHSLQV
FQHKLGIAV	FQHKLGIAV
VQRDADIGV	VQRDADIGV
RQMEMKILRA	RQMEMKLRA
LLFEGEKKITI	LLFEGEKKI
GQKSYLDVI	GQKSYLDVI
FIAPVTLKV	FIAPVTLKV
RLYPLAIQI	RLYPLAIQI
ALSKVHFTA	ALSKVHFTA
RQWDYTEKL	RQWDYTEKL
KITTVIQHV	KITTVIQHV
SQIPAQPSV	SQIPAQPSV
GQLTLHQRI	GQLTLHQRI
GQVVAMKKI	GQVVAMKKI
TQAHVQTGI	TQAHVQTGI
ILSSKVLTI	ILSSKVLTI
QTIPLNKI	QTIPLN-KI
PTPPVFQVR	PTPPVFQVR
LQNGVLLRT	LQNGVLLRT
LQHEGIFRV	LQHEGIFRV
RQIKIKTGVV	RQIKIKTGV
IQARLPLLL	IQARLPLLL
GQTPKQLFV	GQTPKQLFV
YQVRIQPSI	YQVRIQPSI
RLQEASQTI	RLQEASQTI
RQDLTQSLI	RQDLTQSLI
KVGSFSQNV	KVGSFSQNV
RQHEIIHTGV	RQHEIITGV
VVNKTDLKV	VVNKTDLKV
HLMHLELDI	HLMHLELDI
KLFAKHIKV	KLFAKHIKV
HLTDITLKVA	HLTDITLKV
RLSQTFLQL	RLSQTFLQL
LLSEAVQKI	LLSEAVQKI
RLAHLGVQV	RLAHLGVQV
HLFIPALSV	HLFIPALSV
EDMAALEK	EDMAAL-EK
AQLKSLELI	AQLKSLELI
SQVEQQQLI	SQVEQQQLI
KQYGNEVFL	KQYGNEVFL
AQLAEDLKV	AQLAEDLKV
FVNDIFERI	FVNDIFERI
TQILQTVRI	TQILQTVRI
KQVDLIDLV	KQVDLIDLV
AQNRQEFAV	AQNRQEFAV
QIYAIRQSI	QIYAIRQSI
RLSASSTFQSI	SASSTFQSI
KMWDLSSNQAI	DLSSNQ-AI
ALFPERITV	ALFPERITV
MLRIVEPYI	MLRIVEPYI
SQVEILQRV	SQVEILQRV
ALQEASEAYLV	QEASEAYLV
RVAREAIQKV	RVAREAQKV
KEFEGKTLV	KEFEGKTLV
AQYDGAYKV	AQYDGAYKV
AQFVLLTQI	AQFVLLTQI
FQLIQKELI	FQLIQKELI
YQTPLELKL	YQTPLELKL
RAASVFIRV	RAASVFIRV
AQSTSIQRI	AQSTSIQRI
RQVEELQLQV	RQVEELLQV
RQFVTATDV	RQFVTATDV
ATMPVTMLI	ATMPVTMLI
RIAQLRFLL	RIAQLRFLL
YLFPGHPPT	YLFPGHPPT
RQYPWGTVQV	RQYPWGVQV
GQLRLAHGV	GQLRLAHGV
AQNPSLFVKI	AQNPSLVKI
SQINKFLYL	SQINKFLYL
GQDGSVVQFKI	GQDGSVFKI
IQTAVRLLL	IQTAVRLLL
RQILAARAI	RQILAARAI
RLNIPVSQV	RLNIPVSQV
AQVALVNEV	AQVALVNEV
GLPKNPDLRI	GLPKNPLRI
KIYEHHIKV	KIYEHHIKV
GQNESFARIQV	GQNESFARI
HLLSGQLPTI	HLLSGQPTI
IQQSIERLLV	QQSIERLLV
SQLKHIFKT	SQLKHIFKT
RQFSHRAI	RQFSHR-AI
GQQIQIQTV	GQQIQIQTV
KLFQGQLVL	KLFQGQLVL
AQSESILKV	AQSESILKV
KQAPPLEDI	KQAPPLEDI
RLPRSVTTV	RLPRSVTTV
AQLQIGVIRV	AQLQIGIRV
IILSILEVIII	IILSILEVI
QASEGPLK	QASEGP-LK
YQYLLVTAL	YQYLLVTAL
RVYNGRLKV	RVYNGRLKV
AQFSKSIEVI	AQFSKSIEV
RMEDIKILI	RMEDIKILI
SQFSYQHAI	SQFSYQHAI
LLFKEGVMV	LLFKEGVMV
KQLTMYRV	KQLTMY-RV
SITSVTVKI	SITSVTVKI
RLSNKVEAI	RLSNKVEAI
HLTPLPLYV	HLTPLPLYV
SGYDTILRV	SGYDTILRV
RVFASSDTI	RVFASSDTI
QVANLQMKI	QVANLQMKI
KLLEVQILEV	KLLEVQLEV
HTIDTILTV	HTIDTILTV
ALLNKTMRI	ALLNKTMRI
SQMEQFPVKV	SQMEQFVKV
RLKPPSNVV	RLKPPSNVV
RLLQQMIDI	RLLQQMIDI
HQAAQALHL	HQAAQALHL
KLLEYIEEI	KLLEYIEEI
ALNELLQHV	ALNELLQHV
RVTDKVLTA	RVTDKVLTA
RLPPDTLLQQV	RLPPDTQQV
RQGTHITVV	RQGTHITVV
SVHKVTIKI	SVHKVTIKI
RSVRTVMRV	RSVRTVMRV
GQLAEHESI	GQLAEHESI
RQKEIPRV	RQKEIP-RV
VQYAYFKKV	VQYAYFKKV
RLFQKTLKL	RLFQKTLKL
ALNRLFQQI	ALNRLFQQI
TLKTTEPGV	TLKTTEPGV
RQHPQPYI	RQHPQP-YI
SLFPGKLEV	SLFPGKLEV
KITDLKQKV	KITDLKQKV
KLNELGQRI	KLNELGQRI
HLYFETVTI	HLYFETVTI
RLLQQVSQI	RLLQQVSQI
KVWKEQFRV	KVWKEQFRV
AAMSVAQRV	AAMSVAQRV
HQAEYELNI	HQAEYELNI
KLIENNDTI	KLIENNDTI
SQASVTIRI	SQASVTIRI
RLLNILMQL	RLLNILMQL
RVPSINQKI	RVPSINQKI
RLKEAFDYI	RLKEAFDYI
QLMPLPVKV	QLMPLPVKV
RVHGLALQI	RVHGLALQI
RLMPALGVSV	RLMPALVSV
RVKLDSVRV	RVKLDSVRV
KLPEAVQLI	KLPEAVQLI
VQVESVNLQV	VQVESVLQV
QLNHLFVLI	QLNHLFVLI
IQIMKVEEI	IQIMKVEEI
SQHGIHDGLTV	SQHGIHDGL
YQHGIFQSI	YQHGIFQSI
SSQTIQPKV	SSQTIQPKV
RSITVEQHI	RSITVEQHI
GQWKEEQKL	GQWKEEQKL
GQVHLFEHI	GQVHLFEHI
GQPGSVLRV	GQPGSVLRV
RQLSHAISVI	RQLSHAISV
SQAKRVLQEV	SQAKRVQEV
AQYQFTGI	AQYQFT-GI
HQAGPVIKV	HQAGPVIKV
IQYQAVPQI	IQYQAVPQI
HMYPEKLKV	HMYPEKLKV
RLFFPEDPVKI	RLFFPEDPV
GQISETLKT	GQISETLKT
RLFDDSTVTTV	RLFDDS-TV
LQNAVIYSI	LQNAVIYSI
NQFPGFKEV	NQFPGFKEV
YVLDLAAKV	YVLDLAAKV
SQLASLLKV	SQLASLLKV
RQFKHSEKVHV	RQFKHSEKV
RLKTLEREI	RLKTLEREI
GQINQKLGV	GQINQKLGV
RIYESHVGI	RIYESHVGI
IQHLIPKI	IQHLIP-KI
GGFNGSLRV	GGFNGSLRV
RMVAEIQNV	RMVAEIQNV
GQINKNLLTV	GQINKNLTV
RQQLVKLEM	RQQLVKLEM
YLLSYIQSI	YLLSYIQSI
TQVGIEWNL	TQVGIEWNL
GQISVHVDI	GQISVHVDI
ILFGHENRV	ILFGHENRV
RMFFHFSEI	RMFFHFSEI
GQMAMGGAMGI	MAMGGAMGI
RLHDQMVKI	RLHDQMVKI
KQVLLREGI	KQVLLREGI
VVPPFLQPEV	VVPPFLPEV
RQHWTMTKI	RQHWTMTKI
SQLRVAKV	SQLRVA-KV
YIDQEELNK	YIDQEELNK
ALNAVRLLV	ALNAVRLLV
RQPPLVTGI	RQPPLVTGI
ATEGMVVADK	ATEGMVVAD
FQHVAAPYI	FQHVAAPYI
AAGPPISEGK	AGPPISEGK
IQHAEEFLI	IQHAEEFLI
KQLTVKEAV	KQLTVKEAV
RLAEGTGLQI	RLAEGTLQI
HIPNIFQKI	HIPNIFQKI
HQYVVPKI	HQYVVP-KI
KLSEIPLTL	KLSEIPLTL
IISQVDAKV	IISQVDAKV
SQIGTGDLKI	SQIGTGLKI
RQIQVMEKL	RQIQVMEKL
RQFVHIKKI	RQFVHIKKI
ALIAHYPRI	ALIAHYPRI
RVFVKPLVL	RVFVKPLVL
SLADVHIEV	SLADVHIEV
AIYHVIMSV	AIYHVIMSV
RQTGKILKV	RQTGKILKV
GLLEALLKI	GLLEALLKI
AQFNNLGVLHV	AQFNNLGVL
HETEVLLKV	HETEVLLKV
LLIPIHLEV	LLIPIHLEV
RLQDAIAKV	RLQDAIAKV
GQFDRPAGV	GQFDRPAGV
GQSKFAPTV	GQSKFAPTV
VQTSQITKI	VQTSQITKI
RQYPWGVAEV	RQYPWGAEV
RTFKGFQI	RTFKGF-QI
RLIAQRYLL	RLIAQRYLL
QVHPDTGISSK	QVHPDT-GI
RLKAAEAESKL	KAAEAESKL
RLFKIDKEYLL	RLFKIDEYL
HLIDFMSEI	HLIDFMSEI
RLIAIGGVKI	RLIAIGVKI
ALAQPVTTV	ALAQPVTTV
RQYKDYKI	RQYKDY-KI
RQTNIIWAVF	RQTNIIWAV
RSFQTSAI	RSFQTS-AI
RQMIMIRSI	RQMIMIRSI
KLFRGPLVI	KLFRGPLVI
AMAKIQAKI	AMAKIQAKI
KAFAEKLSV	KAFAEKLSV
RQILLGPNTGL	RQILLGPNT
RQADLKNWSL	RQADLKWSL
RQFGFIVLTT	RQFGFIVLT
HLASIHGYLGI	ASIHGYLGI
FQTILTEI	FQTILT-EI
RLLLLPLLL	RLLLLPLLL
AGFAFLTGV	AGFAFLTGV
KQLDGIHVTI	KQLDGIVTI
VQNPQAQTI	VQNPQAQTI
ALFQRPPLI	ALFQRPPLI
KLQQTTQLI	KLQQTTQLI
GQHEISFSV	GQHEISFSV
SQRFIPELI	SQRFIPELI
RQLRQEVVV	RQLRQEVVV
RQYNIQKKEI	RQYNIQKEI
GQADLATKV	GQADLATKV
SLIGLHFKI	SLIGLHFKI
TQLNLRSLLV	QLNLRSLLV
KQINQEYLI	KQINQEYLI
ALAQIPQKV	ALAQIPQKV
IAPTGHSL	IAPTGH-SL
KQTVHKLLI	KQTVHKLLI
AQQDRIQQEI	AQQDRIQEI
RLISKFDTV	RLISKFDTV
RVLQNLLTI	RVLQNLLTI
YLPPTVITI	YLPPTVITI
HQTNLILQTF	HQTNLILQT
AQYFLDKIDVI	AQYFLD-KI
QALSPLLSV	QALSPLLSV
KQILQAKRI	KQILQAKRI
ALNRSVQVV	ALNRSVQVV
RSALPTKTV	RSALPTKTV
AVSSIAQKI	AVSSIAQKI
RVFASPLRL	RVFASPLRL
RQIGVEHVV	RQIGVEHVV
LQNQIVWKI	LQNQIVWKI
VLTPVILQV	VLTPVILQV
SIHDVTFQV	SIHDVTFQV
GQWLGGRQI	GQWLGGRQI
GLVSTGLKV	GLVSTGLKV
AIYPEPFLI	AIYPEPFLI
RVHEIFKRI	RVHEIFKRI
RQVLEDFPTI	RQVLEDPTI
AVELAANTK	AVELAANTK
HLNSEKLII	HLNSEKLII
KMMDVTVTI	KMMDVTVTI
FQDPVPLTV	FQDPVPLTV
RILKSPEI	RILKSP-EI
QQLPDILKI	QQLPDILKI
RTMEIFQLL	RTMEIFQLL
RMIAGQVLDI	RMIAGQLDI
VQTAVRLLL	VQTAVRLLL
SQAMPVTTI	SQAMPVTTI
RQDNSILKV	RQDNSILKV
RQQQKLLKV	RQQQKLLKV
RQSIVGAEV	RQSIVGAEV
SQFKGVDILLT	SQFKGVILL
LLDKKSLKI	LLDKKSLKI
ATAVMPDGQFK	AVMPDGQFK
TLSDIKALI	TLSDIKALI
EQFHYFILI	EQFHYFILI
RKTEVLLKV	RKTEVLLKV
QLLGLIQRV	QLLGLIQRV
IQFPIQKI	IQFPIQ-KI
KQYPISLVL	KQYPISLVL
RQLHLNQLI	RQLHLNQLI
RSVLIANTV	RSVLIANTV
GVAIPLPGV	GVAIPLPGV
KQVSDLISV	KQVSDLISV
EQIRLAQMI	EQIRLAQMI
AMAPVTTRI	AMAPVTTRI
RVSELHLEV	RVSELHLEV
HLPVINVGI	HLPVINVGI
GQFTGSTGV	GQFTGSTGV
ALYPNVVQV	ALYPNVVQV
KLASKYLHV	KLASKYLHV
AQIRTIAII	AQIRTIAII
RVNPVEYSI	RVNPVEYSI
AQGVFQILI	AQGVFQILI
RLYQKDLRA	RLYQKDLRA
LVTDLVLHI	LVTDLVLHI
GQAGGKLHI	GQAGGKLHI
GQADPVVAV	GQADPVVAV
AQNRFLLEL	AQNRFLLEL
