Data	Data aligned
LMSGKDVFY	LMSGKDVFY
VSDRPVMRY	VSDRPVMRY
FTERSDKSY	FTERSDKSY
MTDKICWLY	MTDKICWLY
CGDPSSFDY	CGDPSSFDY
IIYYQLAGY	IIYYQLAGY
TQDLVQEKY	TQDLVQEKY
CADGTRHTY	CADGTRHTY
YANMWSLMY	YANMWSLMY
FAADKDSLY	FAADKDSLY
IVDSLTEMY	IVDSLTEMY
ESDGKPQKA	ESDGKPQKA
LSDAARLFL	LSDAARLFL
QTDNQLAVF	QTDNQLAVF
FTWQHNYYL	FTWQHNYYL
ASSSNYNTY	ASSSNYNTY
RSGIDTNAY	RSGIDTNAY
LSEEANWAF	LSEEANWAF
YSDPKRFFL	YSDPKRFFL
IMNHLMTLY	IMNHLMTLY
FIAQSKGLY	FIAQSKGLY
KTSVDCNMY	KTSVDCNMY
MSSAAHLLY	MSSAAHLLY
ITEAELTGY	ITEAELTGY
NTLGITHLY	NTLGITHLY
LTDALALGM	LTDALALGM
GTHVLLPFY	GTHVLLPFY
ITTFFTFAY	ITTFFTFAY
FIYFGKKQY	FIYFGKKQY
YSEESPTSY	YSEESPTSY
LVQIENLEY	LVQIENLEY
TLDSEDGLY	TLDSEDGLY
QVDQGIEYY	QVDQGIEYY
FTDPASIAA	FTDPASIAA
LLDNSMFTY	LLDNSMFTY
MTKEEFTRY	MTKEEFTRY
HSNASTLLY	HSNASTLLY
ATAKAAAAY	ATAKAAAAY
SSEADCFTY	SSEADCFTY
DMCDIYLLY	DMCDIYLLY
CSNDKSLVY	CSNDKSLVY
FTDNNELEF	FTDNNELEF
EISGSSARY	EISGSSARY
GVNFNLYYY	GVNFNLYYY
YAQMWSLMY	YAQMWSLMY
LSDLPGLGY	LSDLPGLGY
NTAIFDMLY	NTAIFDMLY
YTSDYFISY	YTSDYFISY
HSNLNDATY	HSNLNDATY
YTVRGTGKY	YTVRGTGKY
LEIICFHEY	LEIICFHEY
NADTGHSIY	NADTGHSIY
YSDPLALRE	YSDPLALRE
ITLVYKVYY	ITLVYKVYY
LVDENQSWY	LVDENQSWY
CGDPSSFEY	CGDPSSFEY
WTIGNRAPY	WTIGNRAPY
GTDSGFAAY	GTDSGFAAY
MSDIFHALV	MSDIFHALV
CSEVPQSGY	CSEVPQSGY
TTALVQCIY	TTALVQCIY
IYTDEVYDY	IYTDEVYDY
VMYMGTLSY	VMYMGTLSY
VSDGGPNLY	VSDGGPNLY
VSVKMFDAY	VSVKMFDAY
QQYHRFGLY	QQYHRFGLY
YQNEVTPEY	YQNEVTPEY
TSEHGGRAY	TSEHGGRAY
MIDGIGRFY	MIDGIGRFY
KGDTTTGVY	KGDTTTGVY
MCPFLFLAV	MCPFLFLAV
RSEVELCIY	RSEVELCIY
VSEKYTDMY	VSEKYTDMY
MTDVDLNYY	MTDVDLNYY
PSSKPDWFY	PSSKPDWFY
LTALRLCAY	LTALRLCAY
QSITRSLIY	QSITRSLIY
FMGRIRSVY	FMGRIRSVY
DHEFVDEFY	DHEFVDEFY
LTEIDIRDY	LTEIDIRDY
LSGNGHFHY	LSGNGHFHY
VIDLDPIPY	VIDLDPIPY
ETESQQIRY	ETESQQIRY
HTEFEGQVY	HTEFEGQVY
ISRQRLTKY	ISRQRLTKY
FVADSTPLY	FVADSTPLY
FVSVYFSDY	FVSVYFSDY
ATEDPSSGY	ATEDPSSGY
CTDDNALAY	CTDDNALAY
HLDMLRHLY	HLDMLRHLY
FLMRNAIQY	FLMRNAIQY
VTECKLIYY	VTECKLIYY
TTDGYLLRL	TTDGYLLRL
DSKEGFFTY	DSKEGFFTY
VWINNSWKF	VWINNSWKF
NTDNKFISY	NTDNKFISY
NIDPEHLDY	NIDPEHLDY
WTGMVDGWY	WTGMVDGWY
TTFPVNGGY	TTFPVNGGY
TSSMRGVYY	TSSMRGVYY
NSEQGGKAY	NSEQGGKAY
VFHLYLQYI	VFHLYLQYI
WCEFVDFSV	WCEFVDFSV
GIDVTDLFA	GIDVTDLFA
GTTEVNGLY	GTTEVNGLY
VVQPENLEY	VVQPENLEY
YSHGTGTGY	YSHGTGTGY
MSPDNALIY	MSPDNALIY
MLSSFGWIY	MLSSFGWIY
MLDDLTMGY	MLDDLTMGY
QAAESNERY	QAAESNERY
SSMNSDAAY	SSMNSDAAY
MTDDIGMGV	MTDDIGMGV
LSAFSLHSY	LSAFSLHSY
KSDPIMLLK	KSDPIMLLK
ESSINISGY	ESSINISGY
NTDDFPLTL	NTDDFPLTL
KVSDEIWNY	KVSDEIWNY
MVEASGGRY	MVEASGGRY
WSTIWRQLY	WSTIWRQLY
AADKAAAAY	AADKAAAAY
EVDPIGHLY	EVDPIGHLY
QSDTVFDHY	QSDTVFDHY
EADPTGHSY	EADPTGHSY
KSDGTGTIY	KSDGTGTIY
ESALNISGY	ESALNISGY
DHHFTPQII	DHHFTPQII
FLDQWWTEY	FLDQWWTEY
SVDGFRASY	SVDGFRASY
ATDKAAAAY	ATDKAAAAY
ITSKEVFTY	ITSKEVFTY
YTDDYPMYK	YTDDYPMYK
FTIRDVLAY	FTIRDVLAY
FSAVGNICY	FSAVGNICY
LADTSLSGY	LADTSLSGY
ATADLELAY	ATADLELAY
HSETVIHRY	HSETVIHRY
VVDKYFDCY	VVDKYFDCY
NLALLYGEY	NLALLYGEY
RTDNGGWAH	RTDNGGWAH
AIDLDPVVY	AIDLDPVVY
RINEGWPAY	RINEGWPAY
CTDPYSQMV	CTDPYSQMV
MTAAQIRRY	MTAAQIRRY
HSIKRNYPY	HSIKRNYPY
LTGHMLDMY	LTGHMLDMY
LTDDMIAAY	LTDDMIAAY
TTSDFFVNY	TTSDFFVNY
LSSIGIPAY	LSSIGIPAY
FTENGPWMY	FTENGPWMY
ATSTGNYNY	ATSTGNYNY
GTEELKSLY	GTEELKSLY
MTGVMRGNY	MTGVMRGNY
DSDDWLNKY	DSDDWLNKY
FLWPEAFLY	FLWPEAFLY
WSQNPTMLY	WSQNPTMLY
LTMDREMLY	LTMDREMLY
ATATWFQYY	ATATWFQYY
YTDYMPSMK	YTDYMPSMK
YSQESPQSY	YSQESPQSY
YTAVVPLVY	YTAVVPLVY
PTDPVELAV	PTDPVELAV
WSDLNTTDF	WSDLNTTDF
ITDVTTLVV	ITDVTTLVV
CSKILDLCY	CSKILDLCY
ITYTDVLRY	ITYTDVLRY
VVEKQSGLY	VVEKQSGLY
ASEELMDKY	ASEELMDKY
MMDLSHFLK	MMDLSHFLK
LCYALDLLY	LCYALDLLY
CTELKLSDY	CTELKLSDY
LSDLKKTIY	LSDLKKTIY
FTIDFKLKY	FTIDFKLKY
YLGTPNNTY	YLGTPNNTY
ATNNLGFMY	ATNNLGFMY
CGDPSSLDY	CGDPSSLDY
WVAGVQLLY	WVAGVQLLY
GTEEIRSLY	GTEEIRSLY
VVDALRNIY	VVDALRNIY
WTDLYTSMS	WTDLYTSMS
ISDEFMWRY	ISDEFMWRY
CSEYVKDIY	CSEYVKDIY
NSSKVSQNY	NSSKVSQNY
YAQMWTLMY	YAQMWTLMY
NQDLNGNWY	NQDLNGNWY
WSADGSSMY	WSADGSSMY
FVAAFDHFY	FVAAFDHFY
GAEHVDTSY	GAEHVDTSY
LTSSSKYTY	LTSSSKYTY
LTYKYNQFY	LTYKYNQFY
ETEQPTLDY	ETEQPTLDY
YSDIFNNVL	YSDIFNNVL
IIEDQYNRY	IIEDQYNRY
ICSSVLKRY	ICSSVLKRY
LTDYGALTL	LTDYGALTL
YTDLTYQSF	YTDLTYQSF
KLELKGMSY	KLELKGMSY
YIESKRGVY	YIESKRGVY
ESDSKPQKV	ESDSKPQKV
LSNFGAPSY	LSNFGAPSY
KSAAIDGEY	KSAAIDGEY
TCDGNTFTY	TCDGNTFTY
FTDPSSIAA	FTDPSSIAA
YSNRNRFLY	YSNRNRFLY
CSYKIGHHV	CSYKIGHHV
LSDNLSLVY	LSDNLSLVY
LTDNGYLLY	LTDNGYLLY
YSDPLALKE	YSDPLALKE
NSESGNSRY	NSESGNSRY
STDHIPILY	STDHIPILY
YSQIGAGVY	YSQIGAGVY
HSAEALQKY	HSAEALQKY
FLGEDGCWY	FLGEDGCWY
CVADYSVLY	CVADYSVLY
LADVCNWTY	LADVCNWTY
MSDIFASEV	MSDIFASEV
FMSRKLHRY	FMSRKLHRY
CSDDGFWSK	CSDDGFWSK
YTFEPHYFY	YTFEPHYFY
ISDYDYYRY	ISDYDYYRY
SAAAYFVGY	SAAAYFVGY
SSEQTFMYY	SSEQTFMYY
VSDRPMMRY	VSDRPMMRY
LTKQYLNLY	LTKQYLNLY
ESENISEPY	ESENISEPY
DVAAMSGYY	DVAAMSGYY
LTCSPQPEY	LTCSPQPEY
WTALMFAAY	WTALMFAAY
YSSPHLLRY	YSSPHLLRY
SSLPTTMNY	SSLPTTMNY
RSNDTELNY	RSNDTELNY
MTDLSKKGY	MTDLSKKGY
YTTDVNQLY	YTTDVNQLY
ITDYIVGYY	ITDYIVGYY
CLERWMLVA	CLERWMLVA
GTEKLTITY	GTEKLTITY
LTDNDDILM	LTDNDDILM
DTDPLPVVF	DTDPLPVVF
PSDFFYLLF	PSDFFYLLF
LSTASSWSY	LSTASSWSY
VQDCNCSIY	VQDCNCSIY
TTDDSTSYY	TTDDSTSYY
CASSSDWFY	CASSSDWFY
LSDDSGLMV	LSDDSGLMV
QSDTVFDYY	QSDTVFDYY
ASAAHLAAY	ASAAHLAAY
QTSTLYDFY	QTSTLYDFY
LSDDAVVCY	LSDDAVVCY
FLQMENLMY	FLQMENLMY
ETNMITLLV	ETNMITLLV
NTTQQGDMY	NTTQQGDMY
FTWSGDVRY	FTWSGDVRY
YTDKIAMSY	YTDKIAMSY
HSDTHGLYW	HSDTHGLYW
FSIPVTFSY	FSIPVTFSY
WFSQRGGSY	WFSQRGGSY
LTGVEAVMY	LTGVEAVMY
GTQLFEDNY	GTQLFEDNY
VTDTALAYF	VTDTALAYF
LSDLCNFLV	LSDLCNFLV
MMSAPPAEY	MMSAPPAEY
PSSVAARGY	PSSVAARGY
RTDAWSYPV	RTDAWSYPV
GTFLCANEY	GTFLCANEY
LSEISFHLV	LSEISFHLV
YRSDIVGTY	YRSDIVGTY
KSDLQPPNY	KSDLQPPNY
QSAANMYIY	QSAANMYIY
GSASPTPPY	GSASPTPPY
KTDFGFYQV	KTDFGFYQV
ITEMLRKDY	ITEMLRKDY
MSAIVSCRY	MSAIVSCRY
LAAEWVLAY	LAAEWVLAY
FTNKLINGY	FTNKLINGY
NSSYWRQGY	NSSYWRQGY
GTDSNGMLW	GTDSNGMLW
FTFWTFANY	FTFWTFANY
PTTTYTLEY	PTTTYTLEY
KLEYLAPSY	KLEYLAPSY
GSEDRDLLY	GSEDRDLLY
KTAVVVTRY	KTAVVVTRY
RADSMMLGY	RADSMMLGY
ATTFARFLY	ATTFARFLY
FLDGVNLVA	FLDGVNLVA
GTGDSRLTY	GTGDSRLTY
ETESVNSNY	ETESVNSNY
CTCGSSDLY	CTCGSSDLY
EVDQTKIQY	EVDQTKIQY
KTDAGASTY	KTDAGASTY
KTDIVNTTY	KTDIVNTTY
ATDALMTGF	ATDALMTGF
ISEYRHYCY	ISEYRHYCY
VSSIFISFY	VSSIFISFY
DTDISQLHH	DTDISQLHH
LTFLDCLYY	LTFLDCLYY
SAEVVTLWY	SAEVVTLWY
PVDEYITTY	PVDEYITTY
ISANANFSY	ISANANFSY
ATDALMTGY	ATDALMTGY
ISEKLRSGY	ISEKLRSGY
LRSEAFEYY	LRSEAFEYY
GSEEIKSLY	GSEEIKSLY
CTLNKSHLY	CTLNKSHLY
FSFEIALLK	FSFEIALLK
NATDTWVTY	NATDTWVTY
SSGCYIHFF	SSGCYIHFF
CTDKFSQLF	CTDKFSQLF
LAEQFSGEY	LAEQFSGEY
VTDVTLLMA	VTDVTLLMA
WMSNGTWNY	WMSNGTWNY
VTYECPLLV	VTYECPLLV
RSTLANGWY	RSTLANGWY
ITDITKYLY	ITDITKYLY
LSEMLNKEY	LSEMLNKEY
ASADKPYSY	ASADKPYSY
YLDDPDLKY	YLDDPDLKY
HSNLNDTTY	HSNLNDTTY
WTDLFDNKV	WTDLFDNKV
LSSKNNEHY	LSSKNNEHY
AADSFATSY	AADSFATSY
ESTINLLPY	ESTINLLPY
LLDGLLAWY	LLDGLLAWY
LTAHYCFLY	LTAHYCFLY
HTAAPWGSY	HTAAPWGSY
IMATIQRKY	IMATIQRKY
LTDSDSPTY	LTDSDSPTY
MTFPVSLEY	MTFPVSLEY
FSDLCNFLI	FSDLCNFLI
SSGDATTAY	SSGDATTAY
TVAYFNMVY	TVAYFNMVY
YAQMWQLMY	YAQMWQLMY
YVDHYYRDY	YVDHYYRDY
FTDPSSVAA	FTDPSSVAA
YIDNTTSWY	YIDNTTSWY
MIDNQKLSY	MIDNQKLSY
FTDISMSLY	FTDISMSLY
YTYPCIPEY	YTYPCIPEY
YTDFPCQYV	YTDFPCQYV
RMMGKNIFY	RMMGKNIFY
STFATVLEY	STFATVLEY
LTSRENLLL	LTSRENLLL
MLAPSTLGY	MLAPSTLGY
VTSSVSSGY	VTSSVSSGY
MIEPRTLQY	MIEPRTLQY
VSFDQNLDY	VSFDQNLDY
HMMAVTLFY	HMMAVTLFY
LIENELMNY	LIENELMNY
FNCGGEFFY	FNCGGEFFY
FTSCELYHY	FTSCELYHY
LVFLGPGLY	LVFLGPGLY
ATDGKVLLW	ATDGKVLLW
KVDWNQFTY	KVDWNQFTY
YMLFTKFFY	YMLFTKFFY
PTTGRTSLY	PTTGRTSLY
STGNYNYKY	STGNYNYKY
ITMVNSLTY	ITMVNSLTY
TSADQQSLY	TSADQQSLY
SSFFMNRFY	SSFFMNRFY
TSASFTDLY	TSASFTDLY
GSEELRSLY	GSEELRSLY
CSSLTEEFY	CSSLTEEFY
ITDFNIDTY	ITDFNIDTY
VSEHFSLLF	VSEHFSLLF
LTEEFYHSY	LTEEFYHSY
ALTDLGLIY	ALTDLGLIY
ISDESYRVY	ISDESYRVY
ATDFKFAMY	ATDFKFAMY
ASSEVAVLY	ASSEVAVLY
LVSTQEFRY	LVSTQEFRY
YSALRPHEY	YSALRPHEY
DSEEYHLLY	DSEEYHLLY
EIEPKLDGY	EIEPKLDGY
NSDPNTPDK	NSDPNTPDK
ATFRLECPY	ATFRLECPY
RTWNYHGSY	RTWNYHGSY
ITASILLWY	ITASILLWY
DTGNYILCY	DTGNYILCY
VIDLEPISY	VIDLEPISY
PSEKRIGAY	PSEKRIGAY
HTSSMRGVY	HTSSMRGVY
TTTIKPVSY	TTTIKPVSY
ESQRYIHCY	ESQRYIHCY
WTEHRQVRY	WTEHRQVRY
TDDNALAYY	TDDNALAYY
YVPEHWEYY	YVPEHWEYY
ATDPVEMAL	ATDPVEMAL
SVDSDHLGY	SVDSDHLGY
IQDEIVAAY	IQDEIVAAY
FADINGKLY	FADINGKLY
STNTLPTEY	STNTLPTEY
YTDFHCQYV	YTDFHCQYV
ATSGYRIAY	ATSGYRIAY
NTLTLAVPY	NTLTLAVPY
LTSREVLLL	LTSREVLLL
VSFNQNLEY	VSFNQNLEY
GSQYVSLAY	GSQYVSLAY
HVDIPLQAY	HVDIPLQAY
GVEGIGLQY	GVEGIGLQY
CTLSEQLDY	CTLSEQLDY
DCIMTSYQY	DCIMTSYQY
NSDPEFNVL	NSDPEFNVL
SSRMYCSFY	SSRMYCSFY
GTEMFRHGY	GTEMFRHGY
NTFVQANLY	NTFVQANLY
NSDEQSLEY	NSDEQSLEY
YTIGIGAFY	YTIGIGAFY
TSEIQLTDY	TSEIQLTDY
LLDTASALY	LLDTASALY
TSPYELSLY	TSPYELSLY
NVDQQNDMY	NVDQQNDMY
GTATYLPPY	GTATYLPPY
KTDVIDLLY	KTDVIDLLY
FTNMEAQLV	FTNMEAQLV
TADDITMGY	TADDITMGY
ESDPEGALW	ESDPEGALW
TSSTCMMCY	TSSTCMMCY
GTEEIKSLY	GTEEIKSLY
NTDIKTLKF	NTDIKTLKF
LTNDNTSRY	LTNDNTSRY
IADMGHLKY	IADMGHLKY
GTDLEGKFY	GTDLEGKFY
NTSTCFQEY	NTSTCFQEY
MLDQFGVSY	MLDQFGVSY
FYTTTGIGY	FYTTTGIGY
HSEEGSRAY	HSEEGSRAY
NSDTVDWSW	NSDTVDWSW
DSDGSFFLY	DSDGSFFLY
NSEQGGRAY	NSEQGGRAY
KAEVHTFYY	KAEVHTFYY
ALTSLGLLY	ALTSLGLLY
DTEFPNFKY	DTEFPNFKY
PTDYAKPQY	PTDYAKPQY
LKILVLSIL	LKILVLSIL
RLDAFRQTY	RLDAFRQTY
FSDLLSMAW	FSDLLSMAW
NTDAFSREY	NTDAFSREY
LTDRELLLL	LTDRELLLL
LITEQFLCY	LITEQFLCY
FSDVSHWWQ	FSDVSHWWQ
HTNFESFTV	HTNFESFTV
YTNPQFNVY	YTNPQFNVY
LGADSSIAY	LGADSSIAY
NTAINFFLY	NTAINFFLY
KSNRIPFLY	KSNRIPFLY
TSYVKVLEY	TSYVKVLEY
IVDCLTEMY	IVDCLTEMY
VTERIFREY	VTERIFREY
LMNVITLVY	LMNVITLVY
LIDGRTSFY	LIDGRTSFY
ETIEDYLGY	ETIEDYLGY
TTDISEMGA	TTDISEMGA
LTDKSGSEY	LTDKSGSEY
RLASYGLYY	RLASYGLYY
CSANNSHHY	CSANNSHHY
DTSEVHWNY	DTSEVHWNY
ATSRTLSYY	ATSRTLSYY
ADTDSPLRY	ADTDSPLRY
MLASIDLKY	MLASIDLKY
FSLPSSSSY	FSLPSSSSY
GTFDLGGLY	GTFDLGGLY
FTAMQALDY	FTAMQALDY
KTDWLPMTV	KTDWLPMTV
SSPLFNNFY	SSPLFNNFY
LSPRWYFYY	LSPRWYFYY
VIDLEPIPY	VIDLEPIPY
PTAIYTLEY	PTAIYTLEY
TIDLDPVVY	TIDLDPVVY
SASLAALFY	SASLAALFY
VSSWEEVPY	VSSWEEVPY
KSSLEVYIY	KSSLEVYIY
ESDGKPQKV	ESDGKPQKV
TTDFTRLRY	TTDFTRLRY
YSEESPTEY	YSEESPTEY
AMDEFIQRY	AMDEFIQRY
LYDVIPVTY	LYDVIPVTY
ITEMLQKEY	ITEMLQKEY
SQSDTVFDY	SQSDTVFDY
TTEAILPEY	TTEAILPEY
KLDLLEQEY	KLDLLEQEY
VSDTTVLLH	VSDTTVLLH
YSGNIVHRY	YSGNIVHRY
YMGEDGCWY	YMGEDGCWY
YTPSKLIEY	YTPSKLIEY
VSMDQLASY	VSMDQLASY
LTDAFHGYH	LTDAFHGYH
ASPILRFLY	ASPILRFLY
SSSGMDAYY	SSSGMDAYY
RTNGASYAY	RTNGASYAY
GTEYRLTLY	GTEYRLTLY
GSDCTTIHY	GSDCTTIHY
FRDYVDRFY	FRDYVDRFY
LTAGLDFAY	LTAGLDFAY
GSDGGLDDY	GSDGGLDDY
KSCLPACVY	KSCLPACVY
VAEMDGIQY	VAEMDGIQY
SSDDFALIV	SSDDFALIV
LSFKELLVY	LSFKELLVY
