Data	Data aligned
NPFQEAIVF	NPFQEAIVF
SPLAFEHVM	SPLAFEHVM
AMNPTNTVF	AMNPTNTVF
MPQGAPRLY	MPQGAPRLY
FPRDPEIEM	FPRDPEIEM
HPIDDLQSAY	HPIDLQSAY
HPWGSSSSF	HPWGSSSSF
LAAAAAASYQV	LAAAAAASY
HPNNVVSVKY	HPNNVSVKY
LPDPNLITF	LPDPNLITF
TPLSSTVTL	TPLSSTVTL
NVHAVVFVY	NVHAVVFVY
HPLEGTHEL	HPLEGTHEL
VPLREINQKY	VPLRINQKY
TALAAFLSY	TALAAFLSY
LAWLDEHVAF	LAWLEHVAF
IPTKQTQTF	IPTKQTQTF
LPIATVEEL	LPIATVEEL
HPHPVVPKM	HPHPVVPKM
TPGGTRIIY	TPGGTRIIY
LPIAPDLEHF	LPIADLEHF
YPQEDYESF	YPQEDYESF
FPVSKTLVL	FPVSKTLVL
NALNHTEQY	NALNHTEQY
IPADIVFVL	IPADIVFVL
APFGMEAEY	APFGMEAEY
YPYPPVPETF	YPYPVPETF
LPPEELVPY	LPPEELVPY
FPYGDASKF	FPYGDASKF
YPFENKREF	YPFENKREF
LPVPVLETY	LPVPVLETY
EAVKPTVGM	EAVKPTVGM
LPVATDFEF	LPVATDFEF
HPTDPLTSF	HPTDPLTSF
VPFDQFIQL	VPFDQFIQL
HPDQAQAIL	HPDQAQAIL
YPFPTFQPAF	YPFPFQPAF
QAFEQALEF	QAFEQALEF
YPYEAPPSY	YPYEAPPSY
LPESTHVEF	LPESTHVEF
QAIEDMVGY	QAIEDMVGY
RPVETHQVHEY	RPVETHQVH
YPSETTVKYVF	YPSETTVKY
APVEVTHNF	APVEVTHNF
SPIVKSAKF	SPIVKSAKF
FPMTMDEKY	FPMTMDEKY
FPEGLFYEF	FPEGLFYEF
MPADIATLL	MPADIATLL
MPQDLSEAL	MPQDLSEAL
SPQPDGKVVY	SPQPGKVVY
YVFDGTNPPY	YVFDTNPPY
LPYSEYFEY	LPYSEYFEY
ETQITQIEHEV	QITQIEHEV
NATGPDLEF	NATGPDLEF
EVLGILRYI	EVLGILRYI
HANDQTVIF	HANDQTVIF
GQKPWSQHY	GQKPWSQHY
YPGPASLTQIY	GPASLTQIY
FPLEAVREDAF	FPLEAVRED
HPLINPVAF	HPLINPVAF
IPAESYTF	IPAE-SYTF
FPEIHVAQY	FPEIHVAQY
TPLPEDNSM	TPLPEDNSM
WPHEDAAQF	WPHEDAAQF
QPVKVRVSY	QPVKVRVSY
NPNSPSITY	NPNSPSITY
TAAPPAQPL	TAAPPAQPL
LPYAGDVSM	LPYAGDVSM
IPIANTEKY	IPIANTEKY
HAHVDKVTY	HAHVDKVTY
FPAEKESEW	FPAEKESEW
MPYSHPSSY	MPYSHPSSY
IPLPLIKSY	IPLPLIKSY
TPSEPHPVL	TPSEPHPVL
AGHINPLIIY	HINP-LIIY
MPSPATLSH	MPSPATLSH
MPKSDVNKEYY	MPKSVNKEY
YPLEDLPSL	YPLEDLPSL
MPEGEKLVNYY	MPEGKLVNY
MPTRPVPSY	MPTRPVPSY
SATAVAQLY	SATAVAQLY
NPADSISHVAY	NPADSHVAY
HAAVDRWQY	HAAVDRWQY
TPFVEGLSY	TPFVEGLSY
YVVDLDDEY	YVVDLDDEY
FALPSELERSY	LPSELERSY
FVNPTSFVY	FVNPTSFVY
ILGPPGSVY	ILGPPGSVY
FPAGIVRVF	FPAGIVRVF
MPSSAVRVL	MPSSAVRVL
HPIDGFLQSL	HPIDFLQSL
FPDPNVKYVF	FPDPVKYVF
YPVLVRAAF	YPVLVRAAF
FPAELGIVF	FPAELGIVF
MPEPDAQRFF	MPEPDAQRF
IPFNQALVF	IPFNQALVF
YPDPVSIIQKY	DPVSIIQKY
LPAAAQDVYY	LPAAAQDVY
SVPEAQSAL	SVPEAQSAL
HPNNVVSIKY	HPNNVSIKY
FPHESARL	FPHE-SARL
HPYQPDPKM	HPYQPDPKM
FPHSAHQKY	FPHSAHQKY
FPSNFIKEL	FPSNFIKEL
SATELFEAY	SATELFEAY
TPAPPTHAL	TPAPPTHAL
YPFKPPKIAF	YPFKPKIAF
YARDETEFY	YARDETEFY
DAFPLAFDY	DAFPLAFDY
QAFQERLNSY	QAFQRLNSY
VPYWPEVGM	VPYWPEVGM
PEIAFLTAF	PEIAFLTAF
QPTEVVNIL	QPTEVVNIL
RPFASGANFEY	FASGANFEY
MPLEEGDTFF	MPLEEGDTF
HALERLFTM	HALERLFTM
IPAAVKLTY	IPAAVKLTY
LPWVGKELY	LPWVGKELY
TPTPFFHTF	TPTPFFHTF
FAADIISVL	FAADIISVL
APWIESQDWAY	APWIESQDW
FSNPYSIEY	FSNPYSIEY
MPHHTPHQL	MPHHTPHQL
EAFSPVYKY	EAFSPVYKY
FAFQEDDSF	FAFQEDDSF
SALPAVTEM	SALPAVTEM
IALVHTDSY	IALVHTDSY
YPETLGRLLIL	YPETLGRLL
LPYNHQHEY	LPYNHQHEY
LPSEHQTIL	LPSEHQTIL
ATADTVIIY	ATADTVIIY
HAFVELHEF	HAFVELHEF
NVIHNLATY	NVIHNLATY
SAIPHPLIM	SAIPHPLIM
LDPVLQNPL	LDPVLQNPL
HPLGDIVAF	HPLGDIVAF
LPVGNETGLL	LPVGNETGL
TVFREVVSF	TVFREVVSF
VPDPNVIKL	VPDPNVIKL
SMPADVSEAL	MPADVSEAL
FPESSAIEAL	FPESAIEAL
FAKSVSFSDVF	FAKSVSFSD
FPAEQYYRF	FPAEQYYRF
FANIDQETY	FANIDQETY
FPHVPHPSM	FPHVPHPSM
FPVGRVHRL	FPVGRVHRL
FPASVHTTRY	FPASHTTRY
FPVPKPILY	FPVPKPILY
VPEAASTLVSM	EAASTLVSM
YPAPYLDEY	YPAPYLDEY
HPSGATPTL	HPSGATPTL
VPFTEEQLF	VPFTEEQLF
LPLSIQEAY	LPLSIQEAY
FPLQPGKVATF	FPLQKVATF
HPAPPPSNY	HPAPPPSNY
MPHNQFIKM	MPHNQFIKM
FPNIGVEKF	FPNIGVEKF
EAYIDPIAM	EAYIDPIAM
LPPKIVIGY	LPPKIVIGY
MPMGPDQKY	MPMGPDQKY
FPGPFEEEM	FPGPFEEEM
LPYQGHNSF	LPYQGHNSF
NPHQQYSVY	NPHQQYSVY
VGGEFDLEMNF	VGGEFDLEM
LPAQGLIEF	LPAQGLIEF
YPFYKTDPF	YPFYKTDPF
HPTDITSLDQY	HPTD-ITSL
FPVGPGTGF	FPVGPGTGF
FPQEGMHQM	FPQEGMHQM
TAIGAHPVSM	TAIGHPVSM
YPLLQDPAY	YPLLQDPAY
LPQHPDVEM	LPQHPDVEM
MPHDLITQL	MPHDLITQL
TAVIDHHNY	TAVIDHHNY
MPHPETGKDLY	HPETGKDLY
HAQGFALTY	HAQGFALTY
YPVEIHEY	YPVE-IHEY
VPVWIIHYY	VPVWIIHYY
IPAAPVPSL	IPAAPVPSL
SADQVALVY	SADQVALVY
FPWGDGNHTLF	FPWGGNHTL
MPIQEERFVTY	MPIQRFVTY
SPIKDQPVM	SPIKDQPVM
HPVQHISF	HPVQ-HISF
MVHSEVAAY	MVHSEVAAY
ISPTGHSL	ISPT-GHSL
TPLATQLTY	TPLATQLTY
FPHHEFVAL	FPHHEFVAL
FPLMTIEEF	FPLMTIEEF
MPNVKVAVF	MPNVKVAVF
EPTAAAIAY	EPTAAAIAY
LPAAAAAGAA	LPAAAAAGA
TAMPYLTSY	TAMPYLTSY
QPSPQQDVY	QPSPQQDVY
APFTEGISF	APFTEGISF
FPESLVIQAY	FPESVIQAY
FPITDVLQM	FPITDVLQM
MPVRGPDVEAY	MPVRDVEAY
LPYNMPLAY	LPYNMPLAY
GAAGVHFIY	GAAGVHFIY
TAIREAQTF	TAIREAQTF
LPIDGANDLF	LPIDANDLF
NAITLPEEF	NAITLPEEF
LPIPSKLLEF	LPIPKLLEF
HPLDLRVQF	HPLDLRVQF
LPVRLATAM	LPVRLATAM
YATFIVTNY	YATFIVTNY
HATFNDPVM	HATFNDPVM
APWEVLVTY	APWEVLVTY
FPIPGEPGF	FPIPGEPGF
YPFHKQPPTY	YPFHQPPTY
LPVPDPILL	LPVPDPILL
TVTEKPEVIDA	TVTEKPEVI
FPANNIVKF	FPANNIVKF
FAAQTVGNTY	FAAQVGNTY
FPSAKDPTW	FPSAKDPTW
TASAVVQHM	TASAVVQHM
QPLKLDTSF	QPLKLDTSF
IPMEFVNKM	IPMEFVNKM
DPFPDHVVF	DPFPDHVVF
LPAPSTKEY	LPAPSTKEY
LHVDPENFR	LHVDPENFR
LPNNIVDVW	LPNNIVDVW
HPWEVMPDLY	HPWEVMPDL
DAWEGKGVSY	DAWEKGVSY
SAVDVHINM	SAVDVHINM
FPAGSVHVNVY	FPAGHVNVY
TAAAVGAVF	TAAAVGAVF
HPFQERHVY	HPFQERHVY
DAARLQAAY	DAARLQAAY
MPSEDVVSL	MPSEDVVSL
MANIPLPEY	MANIPLPEY
HPTSHVSLL	HPTSHVSLL
NAFYEHAQTY	NAFYHAQTY
YPSSDNSLY	YPSSDNSLY
FPHDNVEDL	FPHDNVEDL
RPFERTITM	RPFERTITM
MPRVQTQQY	MPRVQTQQY
FALVSQAY	FALV-SQAY
HVFPTFVAY	HVFPTFVAY
YPNVNIHNF	YPNVNIHNF
YPVSSPKSM	YPVSSPKSM
FPYIEENVKEY	FPYINVKEY
TAVHLVDSHY	TAVHVDSHY
YPLEVTKLIY	YPLETKLIY
LPLPAPHAQY	LPLPPHAQY
FPDHSLLAI	FPDHSLLAI
FPAEPLEL	FPAE-PLEL
QPWEEIKTSY	QPWEIKTSY
LPLQTSHAL	LPLQTSHAL
HPTAHAPMM	HPTAHAPMM
EPIYIITEY	EPIYIITEY
HPTAFVVSY	HPTAFVVSY
LPLDTVTFY	LPLDTVTFY
NALNEQRVEF	NALNQRVEF
EAAVAIKAM	EAAVAIKAM
FPQIGQIQY	FPQIGQIQY
NAWNNLEKY	NAWNNLEKY
LPQSTVPEM	LPQSTVPEM
IPISAQLKY	IPISAQLKY
LAMVEAISY	LAMVEAISY
HVYEIPVEY	HVYEIPVEY
VPRIQLEEY	VPRIQLEEY
HPFIDDYQY	HPFIDDYQY
MPFGNVVSA	MPFGNVVSA
MVGKTFTY	MVGK-TFTY
HPLEDRNTIEM	HPLEDRNTI
YPYPYPHTLY	YPYPYPHTL
YPHEPTAVF	YPHEPTAVF
IPHESQVY	IPHE-SQVY
FPFDVAVKF	FPFDVAVKF
YPRSDVDLY	YPRSDVDLY
FPLHLPLEL	FPLHLPLEL
YPALVVEKM	YPALVVEKM
YPFKPPKVTF	YPFKPKVTF
NVADLHEKY	NVADLHEKY
HAADVFEAY	HAADVFEAY
YPYNAPTVKF	YPYNPTVKF
TAHDDRGIRF	TAHDRGIRF
TPDEIDHVF	TPDEIDHVF
TAADTVIIY	TAADTVIIY
LPHYEPIPF	LPHYEPIPF
FPEEDKKTY	FPEEDKKTY
VPTDEITVY	VPTDEITVY
FPASFPNRQY	FPASPNRQY
MAVEGDHSM	MAVEGDHSM
LPLAHVLEL	LPLAHVLEL
EPVDISTAM	EPVDISTAM
LPVIIFTTF	LPVIIFTTF
LPDSGVVEY	LPDSGVVEY
LPEEHARFY	LPEEHARFY
YPANQGQEVEY	YPANQEVEY
FPMEIRQY	FPME-IRQY
FPIPLINRL	FPIPLINRL
MVYAATPIDF	YAAT-PIDF
LPALFTDLY	LPALFTDLY
LPPNTIMEY	LPPNTIMEY
HAFGGNKASY	HAFGNKASY
HPFHILIAL	HPFHILIAL
MPLGSAVDIL	MPLGAVDIL
IPVEEPLPF	IPVEEPLPF
LPNGLDVTF	LPNGLDVTF
SPWADNTAL	SPWADNTAL
NPWDDKLIF	NPWDDKLIF
FPEPNPRVIEL	EPNPRVIEL
EAIGAVIHY	EAIGAVIHY
TPLHLVALY	TPLHLVALY
MPNGTVQRF	MPNGTVQRF
NVYDFKTTY	NVYDFKTTY
QPAEMAAEL	QPAEMAAEL
YAAPAPEQAY	YAAPPEQAY
IPVPINAEL	IPVPINAEL
LPLPLPMAL	LPLPLPMAL
HPQGSTAGVVY	HPQGAGVVY
NPAIVALVY	NPAIVALVY
LPAKDIQTNVY	LPAKQTNVY
IPLDGETWSY	IPLDETWSY
VPVMLTEQY	VPVMLTEQY
YPLDLEGGSEY	YPLDGGSEY
VPWTELLSL	VPWTELLSL
HPSNVLHFF	HPSNVLHFF
TPTEISLVL	TPTEISLVL
LPSDVVTGY	LPSDVVTGY
MPISSHVDL	MPISSHVDL
SQRPPTRETF	SQRPTRETF
NAFEHGGEFTY	NAFEHGGEF
LPAPPTQNM	LPAPPTQNM
YPDEYHGEY	YPDEYHGEY
HAAHIISEL	HAAHIISEL
MVADRVEVY	MVADRVEVY
FAFDPSVNY	FAFDPSVNY
EAVWLTDNTY	AVWLTDNTY
APAPTAVVL	APAPTAVVL
HVAQPDSVY	HVAQPDSVY
VPFNIPLEF	VPFNIPLEF
HPNGLQVMY	HPNGLQVMY
SPFLTITSM	SPFLTITSM
HPIRVVNAL	HPIRVVNAL
EALKSHIM	EALK-SHIM
YPFDSPQVM	YPFDSPQVM
LPNSIASRF	LPNSIASRF
TAMDVVYAL	TAMDVVYAL
QAAMPQVSY	QAAMPQVSY
YPAEITLTW	YPAEITLTW
FPASPPKGYFL	FPASPPKGY
VPVDDLEVY	VPVDDLEVY
SASTTTLRY	SASTTTLRY
QAYDDKIYY	QAYDDKIYY
DPFVGSDPF	DPFVGSDPF
FPRHIEPEL	FPRHIEPEL
HPNDDDVHF	HPNDDDVHF
HPHLVAEAF	HPHLVAEAF
MAWLVDHVY	MAWLVDHVY
TPLEEAIKF	TPLEEAIKF
FPFAVANQL	FPFAVANQL
TAAAPMIGY	TAAAPMIGY
FPANIQVVY	FPANIQVVY
LPIPDQQLY	LPIPDQQLY
HVSTVNPNY	HVSTVNPNY
NPFPHSHTF	NPFPHSHTF
IPFLGHAIAF	IPFLHAIAF
EVIPYTPAM	EVIPYTPAM
FPNIPGKSL	FPNIPGKSL
HPIETLVDIF	HPIELVDIF
FPVEKQLDL	FPVEKQLDL
HPTSVISGY	HPTSVISGY
FPFLPGGPPEY	FPFLGPPEY
FPIIIHDEPTY	FPIIDEPTY
LPADWAPLF	LPADWAPLF
LPLDIQIFY	LPLDIQIFY
SPMDIFDMF	SPMDIFDMF
MPLSNGLQLY	MPLSNGLQL
FPNEFIVET	FPNEFIVET
DSNGAILVY	DSNGAILVY
LPSHTKIKY	LPSHTKIKY
TPFVDPRVY	TPFVDPRVY
LPEAQLSTVEY	EAQLSTVEY
MAIKLRNEY	MAIKLRNEY
TPRGVEGELSF	TPRGVEGEL
HPFFVGVQY	HPFFVGVQY
VPVNHTQVM	VPVNHTQVM
MINELAVAM	MINELAVAM
GQTKPVVVY	GQTKPVVVY
VHFPMVVY	VHFP-MVVY
IPSSVPATF	IPSSVPATF
FPFFDIAHY	FPFFDIAHY
HAYIFRPEVY	HAYIRPEVY
IPAATTIAY	IPAATTIAY
FPHRQPLRY	FPHRQPLRY
FPIHLTDQL	FPIHLTDQL
SPWPQDSRGLY	SPWPDSRGL
MPHQLQDTF	MPHQLQDTF
SPIEFLENAY	SPIELENAY
LPLLDPWYF	LPLLDPWYF
NPAPNPAVY	NPAPNPAVY
IPEESQLVF	IPEESQLVF
APFEEQENY	APFEEQENY
HPEPTDHVL	HPEPTDHVL
LPALPTQAL	LPALPTQAL
LPTAAHFIEY	LPTAHFIEY
FASHVSPEV	FASHVSPEV
MPFGNVISA	MPFGNVISA
HPDEPLYSF	HPDEPLYSF
HPKDIRESDYF	HPKDIRESD
FPQIEINKM	FPQIEINKM
HPASVLSQPQY	HPASSQPQY
LPDNVHYVF	LPDNVHYVF
LPFPKDASL	LPFPKDASL
QPYSKDSPF	QPYSKDSPF
HPDAPMSQVY	HPDAMSQVY
IAMDLILKM	IAMDLILKM
HPILNDPIY	HPILNDPIY
AQNAVRLHY	AQNAVRLHY
YPTVASVPH	YPTVASVPH
LPVEQGNFPY	LPVEGNFPY
HPHPFLNSVY	HPHPLNSVY
NAFYEHAQTYY	NAFYHAQTY
TAAPSLKNAAF	APSLKNAAF
QALALIELY	QALALIELY
SPNAKEFVY	SPNAKEFVY
TPVFSKARY	TPVFSKARY
TPHGLFILF	TPHGLFILF
FVNDYILYY	FVNDYILYY
RPTDVAISF	RPTDVAISF
FPVPGSGLVL	FPVPSGLVL
VPESSLAGHSF	VPESSLAGH
LPLTARWEY	LPLTARWEY
YPAPERLQEY	YPAPRLQEY
HPSQHVMQY	HPSQHVMQY
HAAPFQNIL	HAAPFQNIL
NVHDIMVSF	NVHDIMVSF
HPIPGEYKF	HPIPGEYKF
TAGDFQEIY	TAGDFQEIY
TATALAIIY	TATALAIIY
HPVVSSVPL	HPVVSSVPL
DAYPEIEKF	DAYPEIEKF
MPSVKVSVF	MPSVKVSVF
MALAVRVVY	MALAVRVVY
IPTPPLPSY	IPTPPLPSY
HPQFVTDVM	HPQFVTDVM
SATYIAEEY	SATYIAEEY
NAVNLAIKY	NAVNLAIKY
HAVGPSTAM	HAVGPSTAM
LPLEEAYRF	LPLEEAYRF
RPFDLVIPF	RPFDLVIPF
FPFSAVVPAAL	FPFSVVPAA
HAIQDLLVFY	HAIQDLLVF
TAIDDMEAY	TAIDDMEAY
FPWGDGNHTL	FPWGGNHTL
TPAEVSHRF	TPAEVSHRF
HPGQISAGY	HPGQISAGY
MPVDSFNSM	MPVDSFNSM
YPAHIEDIDY	YPAHEDIDY
LPMESAIL	LPME-SAIL
FPQLDSTSF	FPQLDSTSF
TAALIKGELY	TAALKGELY
FAFEHSEEY	FAFEHSEEY
IPFSSDVTHEM	IPFSSDVTH
MPNSPAPHF	MPNSPAPHF
HAEASAIVEY	HAEAAIVEY
HPVRDPVHMY	HPVRDPVHM
AVNALQSVY	AVNALQSVY
HPYIYRVTF	HPYIYRVTF
TGYGGYEEY	TGYGGYEEY
LPPGVHISY	LPPGVHISY
HPHQNLIATY	HPHQLIATY
YPATGADVAF	YPATADVAF
YPAQGVQQF	YPAQGVQQF
IPNENEAQF	IPNENEAQF
FPVEEKAVEY	FPVEKAVEY
LPESAPLIY	LPESAPLIY
YPLEDHTEF	YPLEDHTEF
HPEIDNPEY	HPEIDNPEY
IPVTIMDVF	IPVTIMDVF
MPLEDMNEF	MPLEDMNEF
HPYSQALIQY	HPYSALIQY
YPVEHPDKF	YPVEHPDKF
YPDPTFPAM	YPDPTFPAM
IPWKHIDYF	IPWKHIDYF
MVNHFIAEF	MVNHFIAEF
SPVFMQPVY	SPVFMQPVY
TALDKIEEM	TALDKIEEM
FAVDLEHHSY	FAVDEHHSY
VVAPITTGY	VVAPITTGY
FPIPDLQKY	FPIPDLQKY
SPDSGVYEM	SPDSGVYEM
LPHEILEM	LPHE-ILEM
YPFESAEAQLL	YPFEAEAQL
HPLGVLSAF	HPLGVLSAF
EALSLAHTY	EALSLAHTY
YPAAVPQAL	YPAAVPQAL
LPDTLKVTY	LPDTLKVTY
SPVNSSKQPSY	SPVNKQPSY
RPFAGFEDF	RPFAGFEDF
YPFKSPSIGF	YPFKPSIGF
MPHAPIGLYF	MPHAPIGLY
LPMGVVVDY	LPMGVVVDY
EAFLDVGEY	EAFLDVGEY
LPATATMSL	LPATATMSL
VPYRIFPY	VPYR-IFPY
SPIDVVEKY	SPIDVVEKY
HPAIALREY	HPAIALREY
LPADIRIPDGY	LPADIPDGY
TPIDSNIAF	TPIDSNIAF
LPVPSGVAF	LPVPSGVAF
HPDKKIVAY	HPDKKIVAY
TPSSDVLVF	TPSSDVLVF
LPFPIIQQY	LPFPIIQQY
YPAHMYQVY	YPAHMYQVY
HPRIITEGF	HPRIITEGF
LPSELERSY	LPSELERSY
FPDEPYKDGY	FPDEYKDGY
LPKNDLITY	LPKNDLITY
TPTGIKVVM	TPTGIKVVM
TPEEKIREY	TPEEKIREY
KPYNPIIGETF	NPII-GETF
LAAVAGARDTY	AAVAARDTY
IPFDGDLLSM	IPFDDLLSM
EAAPHDIGY	EAAPHDIGY
MPTVHYEF	MPTV-HYEF
IPVHPHVY	IPVH-PHVY
TAAKAILLY	TAAKAILLY
DAFKASVY	DAFK-ASVY
HPVVGDLTY	HPVVGDLTY
IPDEQIVVM	IPDEQIVVM
SPVDVLQIF	SPVDVLQIF
FPFHSAPAL	FPFHSAPAL
YPVTPELLERY	YPVTLLERY
VPVPPLPEY	VPVPPLPEY
HPQPGAVEL	HPQPGAVEL
DPWIGKLLY	DPWIGKLLY
IPFGNNPIF	IPFGNNPIF
HAVEISAVH	HAVEISAVH
FPVELNTVY	FPVELNTVY
HAIKVGVKY	HAIKVGVKY
LPLDDGAAHVM	LPLDDGAAH
FPRAQDKVHY	FPRADKVHY
HPDPDAELQRM	HPDP-DAEL
HVRPVTQGDVY	RPVTQGDVY
SPFPGPDPGF	SPFPPDPGF
LEEYAATL	LEEY-AATL
SASVVFTTY	SASVVFTTY
HIMEIFSTY	HIMEIFSTY
FPASSGVSH	FPASSGVSH
SPDATIRIW	SPDATIRIW
EAWASKDATY	EAWAKDATY
YGFQEKEAF	YGFQEKEAF
HPGSFDVVH	HPGSFDVVH
LPLSLQTVF	LPLSLQTVF
NAFDVFAAY	NAFDVFAAY
MPALFSDHTF	MPALSDHTF
AVHDITVAY	AVHDITVAY
LPFAEAEAF	LPFAEAEAF
VPFPLTLRF	VPFPLTLRF
FPTDPKVVVY	FPTDKVVVY
HAVHVALVL	HAVHVALVL
FPFGYVSNIHY	FPFGYVSNI
FPASVHDSL	FPASVHDSL
LPIRFNLTY	LPIRFNLTY
LPRISPEEY	LPRISPEEY
HPIEVSVGH	HPIEVSVGH
TAADTVIFY	TAADTVIFY
SPDPLPDNKVL	DPLPDNKVL
YPIDPVTQEF	YPIDVTQEF
FPVAGQKLIY	FPVAQKLIY
YAQDEHLITF	YAQDHLITF
VAQSTRIIY	VAQSTRIIY
SPVALNVQY	SPVALNVQY
SSLLEKGLD	SSLLEKGLD
YPYPPPPPEF	YPYPPPPEF
DAIRLAVSY	DAIRLAVSY
IPNGVQIFF	IPNGVQIFF
LPTPETVPF	LPTPETVPF
MPTQEVQEL	MPTQEVQEL
FPFLSGDNQHY	FPFLDNQHY
TPYKGGNLY	TPYKGGNLY
MPTGEAMVAF	MPTGAMVAF
EVFPLAMNY	EVFPLAMNY
SPVSKGILQY	SPVSGILQY
LPVDFHIKM	LPVDFHIKM
NAAQIFAIY	NAAQIFAIY
TVVRNLEAY	TVVRNLEAY
VPWLSSVRY	VPWLSSVRY
DASPVQAVF	DASPVQAVF
TAIMEKHSM	TAIMEKHSM
NPMMEDGISY	NPMMDGISY
VPHSIINGY	VPHSIINGY
NPENLATLERY	NPEN-LATL
LPHQPLAT	LPHQ-PLAT
FPAKVTAHW	FPAKVTAHW
QAVADMAAY	QAVADMAAY
MPLTVDEY	MPLT-VDEY
MPVRAADKL	MPVRAADKL
EPVELAQEF	EPVELAQEF
LPYKITAEEMY	LPYKTAEEM
FPAGIYDTKY	FPAGYDTKY
FPFNPLDFESF	NPLD-FESF
LPQPDVFPL	LPQPDVFPL
YPRFLESEFY	YPRFLESEF
SALEHSIQY	SALEHSIQY
TAIRALETY	TAIRALETY
MPSPVSPKL	MPSPVSPKL
QPLALNVAY	QPLALNVAY
NPYHVVILF	NPYHVVILF
MPYNYPVLL	MPYNYPVLL
QPAPPHISH	QPAPPHISH
YPVDLGDKF	YPVDLGDKF
LPSSEVVKF	LPSSEVVKF
HAWLQAGKIYY	HAWLAGKIY
MPATVFMLF	MPATVFMLF
NPTIVALVY	NPTIVALVY
DASKVVTVF	DASKVVTVF
HPDSRAIMY	HPDSRAIMY
MPAPHTSITM	MPAPTSITM
HSGPVIPVY	HSGPVIPVY
LPADHVSGY	LPADHVSGY
FPWDIDEAL	FPWDIDEAL
VPASLPVEF	VPASLPVEF
TALSWKEAY	TALSWKEAY
LPHPYAIAVF	LPHPAIAVF
MPIPGGNQRF	MPIPGNQRF
FPNAIEHTL	FPNAIEHTL
YPNGLQVNF	YPNGLQVNF
APEEHPVLL	APEEHPVLL
LPIENDVYKY	LPIEDVYKY
FPLDKAVAY	FPLDKAVAY
LPVVPKATY	LPVVPKATY
KPIESFNEY	KPIESFNEY
VPLGMTVTF	VPLGMTVTF
YPASTVQIL	YPASTVQIL
QPFQVAEVF	QPFQVAEVF
ISQPRILLY	ISQPRILLY
YIFKERESF	YIFKERESF
HPVNLTWPF	HPVNLTWPF
DPFIDLNYM	DPFIDLNYM
EAIKILKGEY	EAIKLKGEY
LPYPDPAIAQF	YPDPAIAQF
RPAPVEVSY	RPAPVEVSY
FPEIDLEKY	FPEIDLEKY
LPFFNDRPW	LPFFNDRPW
HAFVTEVAY	HAFVTEVAY
NPVDIVSTL	NPVDIVSTL
IAPTGHSL	IAPT-GHSL
NAHNLALVF	NAHNLALVF
NPTDPLLAY	NPTDPLLAY
FPYEESKEKF	FPYESKEKF
LPIGDVATQYF	LPIGVATQY
QAADIDTRSEF	AADITRSEF
LPVASSVM	LPVA-SSVM
FPLIPQEAF	FPLIPQEAF
FPLIEVNKVYY	FPLIVNKVY
AVSAVVHEY	AVSAVVHEY
IPVPYVEKY	IPVPYVEKY
HPFLYDRETY	HPFLDRETY
FPFEKGSVQY	FPFEGSVQY
SASALAVAL	SASALAVAL
PHADTIIY	PHAD-TIIY
LPSSVISAI	LPSSVISAI
HPQIIIRAF	HPQIIIRAF
DAIRSLASVSY	IRSLASVSY
ISSDTFITY	ISSDTFITY
IPSEDIARNLM	IPSEIARNL
YPAPGLKTF	YPAPGLKTF
FVSGVKIFY	FVSGVKIFY
DALVITHY	DALV-ITHY
HPSALSSVY	HPSALSSVY
FPNENQVVF	FPNENQVVF
SADKTVRVY	SADKTVRVY
HSSSIVTAY	HSSSIVTAY
TVTEKPEVID	TVTEKPEVI
MPEEKLVEAL	MPEELVEAL
HPLTQSAVM	HPLTQSAVM
FPIDKPPSF	FPIDKPPSF
NAFLDDPEF	NAFLDDPEF
YPFIISSESY	YPFISSESY
LALEPGVAY	LALEPGVAY
HPATVFILF	HPATVFILF
IPLHQINQVY	IPLHINQVY
FPNVSSFEW	FPNVSSFEW
FADPHSKRVF	FADPSKRVF
LPSDVSILY	LPSDVSILY
VPVEEPIAF	VPVEEPIAF
LPQPPEGQTY	LPQPEGQTY
VPTTGIIEY	VPTTGIIEY
QARPELLEVF	QARPLLEVF
YPKANIVAY	YPKANIVAY
APIDEAFESY	APIDAFESY
NAVDALIDSM	NAVDLIDSM
FPNIVIKGSEL	FPNIKGSEL
LPQEDLEAL	LPQEDLEAL
FPETKAEKY	FPETKAEKY
MPTSVAYIH	MPTSVAYIH
TPIQDNVDQTY	TPIQVDQTY
NIPEIVAVY	NIPEIVAVY
FAYSDSRVGF	FAYSSRVGF
FPQEEAIIDKY	FPQEIIDKY
FPEAYKPTVY	FPEAKPTVY
EANAIALKY	EANAIALKY
VVPTAILAF	VVPTAILAF
IPVAIRTQI	IPVAIRTQI
IPYPLPPNY	IPYPLPPNY
QAIENAHVL	QAIENAHVL
LPVHVFEAL	LPVHVFEAL
LPTKQNEEF	LPTKQNEEF
LPLLSPVTF	LPLLSPVTF
RPVPLEQTY	RPVPLEQTY
SPFFERSGLAY	SPFFERSGL
TAVRVHVSY	TAVRVHVSY
TPLSSTVTLSM	TPLSSTVTL
MPVGPAPGM	MPVGPAPGM
YANEVGEAF	YANEVGEAF
SPLGMPDPHLY	LGMPDPHLY
AVIAPKSSY	AVIAPKSSY
YAWESSAGGSF	YAWEAGGSF
QPAQDIFSVY	QPAQIFSVY
NAPWAVTSL	NAPWAVTSL
VPAESHIY	VPAE-SHIY
SAVAATYKY	SAVAATYKY
TALPTRIAY	TALPTRIAY
LPADITEDEF	LPADTEDEF
FPNTETNGEF	FPNTTNGEF
IPLGEIISF	IPLGEIISF
YPNGVVVHY	YPNGVVVHY
IPYEGFASL	IPYEGFASL
TVMNIAEHY	TVMNIAEHY
YPLDPTTEHIY	YPLDPTTEH
MPFAPAIQTF	MPFAAIQTF
DAFLEQAVSY	DAFLQAVSY
YAIEVDPVL	YAIEVDPVL
NPISTVTEL	NPISTVTEL
MPLEEGDTF	MPLEEGDTF
YPFKPPKVAF	YPFKPKVAF
FPVEIKSFYM	FPVEIKSFY
HGFGNVHAY	HGFGNVHAY
MPAAGGVLY	MPAAGGVLY
LPVPVIPSF	LPVPVIPSF
TANALALAM	TANALALAM
IPLTTFTPR	IPLTTFTPR
YPVPDVSTY	YPVPDVSTY
NPIWHREKY	NPIWHREKY
EAMRIGAEVY	EAMRGAEVY
LPFDLRASF	LPFDLRASF
NPDTHSWEM	NPDTHSWEM
LPEARGRAGL	LPEAGRAGL
TASHYYIKY	TASHYYIKY
YPYPYPHTL	YPYPYPHTL
MPEDLVEAL	MPEDLVEAL
YPFDSPQVMF	YPFDSPQVM
IPIAGRDITY	IPIARDITY
IPSPLQPEM	IPSPLQPEM
TRPLYRHLF	TRPLYRHLF
MPDSAAALL	MPDSAAALL
TAYVGSAVM	TAYVGSAVM
YAALHGEFY	YAALHGEFY
LPFDLRIPF	LPFDLRIPF
HPITSIEY	HPIT-SIEY
FPGPIFHL	FPGP-IFHL
LPIESNPHSF	LPIENPHSF
FPEELTQTF	FPEELTQTF
FPTYPVPHY	FPTYPVPHY
HPDTGISSKAM	HPDTGISSK
IPYHSEVPVSL	IPYHVPVSL
HPFKFSDHY	HPFKFSDHY
HPIKQVDVL	HPIKQVDVL
EAYPDHTQF	EAYPDHTQF
NPYRDLQIY	NPYRDLQIY
VNLGGSKSIS	VNLGGSKSI
FPGPLQAF	FPGP-LQAF
IPDQVIRVF	IPDQVIRVF
MPALAPPEVVM	MPALAPPEV
FPTVQHQEL	FPTVQHQEL
DLWLEREVF	DLWLEREVF
VPGPAAAL	VPGP-AAAL
EPFLFVDEF	EPFLFVDEF
YAYETKDAL	YAYETKDAL
LPDEIYHVY	LPDEIYHVY
TPIREQHVL	TPIREQHVL
HADPRIQGY	HADPRIQGY
IPNENELQF	IPNENELQF
MPTDVLEVT	MPTDVLEVT
EASAVTVRF	EASAVTVRF
HPLYPFNDPY	HPLYFNDPY
TPSPDIIVL	TPSPDIIVL
APVPTGEVY	APVPTGEVY
FAQPGSFEY	FAQPGSFEY
LPGEVLEY	LPGE-VLEY
FPQKPIQRY	FPQKPIQRY
NVADVVIKF	NVADVVIKF
FPPREIVTY	FPPREIVTY
FPNKQGYVL	FPNKQGYVL
SQFGTVTRF	SQFGTVTRF
YPLQDPKNLIL	YPLQDPKNL
LPTSVVTIT	LPTSVVTIT
FPEEVIATIF	FPEEIATIF
LPMRMLEVF	LPMRMLEVF
YPHQVPLVL	YPHQVPLVL
IPHTDPVDY	IPHTDPVDY
QPNPLPLRL	QPNPLPLRL
YPLDLLLKL	YPLDLLLKL
FPHSMEPQL	FPHSMEPQL
NPFHWGEVEY	NPFHGEVEY
FPGPSKPF	FPGP-SKPF
YPHDGKIFF	YPHDGKIFF
PALHEGPPL	PALHEGPPL
LPQKGDVEM	LPQKGDVEM
FPLEAITAF	FPLEAITAF
DAWIEHDVW	DAWIEHDVW
HPHDLVILM	HPHDLVILM
HAVPIYEGF	HAVPIYEGF
YPVFPWIIHDY	FPWI-IHDY
FPIEVRHYL	FPIEVRHYL
FAHDDSVMY	FAHDDSVMY
TASPVAVSL	TASPVAVSL
LPVEELRVY	LPVEELRVY
SPEDIKKAY	SPEDIKKAY
MPFNKEPKW	MPFNKEPKW
DPHQQIYTF	DPHQQIYTF
IPFDPKFITY	IPFDKFITY
YPDPVIQEL	YPDPVIQEL
LPDPNVQKY	LPDPNVQKY
LPSDVPLHF	LPSDVPLHF
FPVEVNTVL	FPVEVNTVL
LPTENVDKM	LPTENVDKM
APVPLYNSF	APVPLYNSF
LPRTDYSF	LPRT-DYSF
TALNPHIGY	TALNPHIGY
HAIRLLLEY	HAIRLLLEY
PVSVYEDPPDA	SVYEDPPDA
FPSPIRLEF	FPSPIRLEF
RPAPVEVTY	RPAPVEVTY
APVQILQEY	APVQILQEY
MPSKTELIV	MPSKTELIV
IPNEIIHAL	IPNEIIHAL
MPSQSVETY	MPSQSVETY
MAVIDGNVM	MAVIDGNVM
YAFPKEFPY	YAFPKEFPY
FPSSVAALRF	FPSSAALRF
LAAGVVSAM	LAAGVVSAM
DAFNQIMGY	DAFNQIMGY
HVIDVKFLY	HVIDVKFLY
LPTGIPIVY	LPTGIPIVY
HPNEGALVL	HPNEGALVL
FPDQNFEVM	FPDQNFEVM
FPSTAEHTL	FPSTAEHTL
MAQTAIKAM	MAQTAIKAM
MPESGPSYEF	MPESPSYEF
NPSPYHLYY	NPSPYHLYY
TAEGQTIVY	TAEGQTIVY
MALSIAERY	MALSIAERY
IPNSIMTIL	IPNSIMTIL
HADGTIVRY	HADGTIVRY
YARNDTVRF	YARNDTVRF
SPAPSPVPEPD	SPAPPVPEP
LPEDRALYY	LPEDRALYY
MPNQIVQIL	MPNQIVQIL
LPAKILVEF	LPAKILVEF
LPYKATENDIY	LPYKATEND
HAIPPTLAM	HAIPPTLAM
NAVVTVPAY	NAVVTVPAY
ELPQDVPEEPN	LPQDVPEEP
TPAGVVNKY	TPAGVVNKY
LPADIQAQF	LPADIQAQF
FPVIYDVKY	FPVIYDVKY
LPSEIEVKY	LPSEIEVKY
MPRLEVQSF	MPRLEVQSF
FPYQDKLVGY	FPYQKLVGY
QADPTKLEL	QADPTKLEL
MPEFVNAAF	MPEFVNAAF
FPAPAKAVVY	FPAPKAVVY
HPIDRSVDF	HPIDRSVDF
LEEALQQAKED	EALQQAKED
LPNGQMFVF	LPNGQMFVF
HPQQKVAVY	HPQQKVAVY
FPHTTPSM	FPHT-TPSM
NPVDWKEKY	NPVDWKEKY
VPTELALLY	VPTELALLY
EAVDVTPVM	EAVDVTPVM
LPAETGQNHPF	LPAETGQNH
HVSLVQLTL	HVSLVQLTL
FPVTPVSTL	FPVTPVSTL
DPVEPHGEM	DPVEPHGEM
YPLQISPVSSY	YPLQPVSSY
FPQPEKESF	FPQPEKESF
FPVEHVQLL	FPVEHVQLL
LPIVTPAL	LPIV-TPAL
LPLPSPALEY	LPLPPALEY
NPHEVQPAY	NPHEVQPAY
LPAEHQFSF	LPAEHQFSF
NAIEDTIFY	NAIEDTIFY
HPFENMVAF	HPFENMVAF
LPGVAVSM	LPGV-AVSM
AAAPVIKAY	AAAPVIKAY
QPAENISKDLY	QPAEISKDL
YPIDDVYTGM	YPIDVYTGM
YAFDFARQS	YAFDFARQS
LPTFQSPEF	LPTFQSPEF
PHNQFIKMM	PHNQFIKMM
YPSETTVKY	YPSETTVKY
YPFTGDHKQKF	YPFTHKQKF
TARMEDFTF	TARMEDFTF
IANQVQLFY	IANQVQLFY
LPAEFFEVL	LPAEFFEVL
AQAGWLQHDY	QAGWLQHDY
LPSHVVTML	LPSHVVTML
FPIHVQTSL	FPIHVQTSL
IPAESYTFF	IPAESYTFF
LPDLSGPHSY	LPDLGPHSY
MPQGGGQHY	MPQGGGQHY
FPVLNVTRY	FPVLNVTRY
MAADDVEEY	MAADDVEEY
HPDVLPFAL	HPDVLPFAL
LPFDKETGF	LPFDKETGF
HAAESISSPY	HAAEISSPY
TPAEIREEF	TPAEIREEF
EPFHLIVSY	EPFHLIVSY
MPVVAGAVF	MPVVAGAVF
LPVFLDSHFVY	LPVFLDSHF
HPLDLQSAL	HPLDLQSAL
FPWEVPKKLKY	FPWEVPKKL
HPQEVYNEY	HPQEVYNEY
NPLAATHEF	NPLAATHEF
FPFPKPDLIF	FPFPPDLIF
APAPVQPPM	APAPVQPPM
VPVRDIPAF	VPVRDIPAF
FPEIVAPLL	FPEIVAPLL
MPQEKSPGY	MPQEKSPGY
SAYEALEKY	SAYEALEKY
MPKVHIEF	MPKV-HIEF
MPVAAREASIY	VAAREASIY
LPTDSHASL	LPTDSHASL
YPTQPGQGY	YPTQPGQGY
HPGLILKY	HPGL-ILKY
HPLSLTSDQY	HPLSTSDQY
FVVEQVESY	FVVEQVESY
RPVETYQVHEY	RPVETYQVH
IPWKHAGKQDY	IPWKHAGKQ
HPHLVAEAY	HPHLVAEAY
FPFEDITQH	FPFEDITQH
DPNLEFVAM	DPNLEFVAM
QPIVWITPY	QPIVWITPY
LPTEPPYTAY	LPTEPYTAY
HPFPSPATDLY	FPSPATDLY
HPIIPEQSTF	HPIIEQSTF
FPNDPHVQY	FPNDPHVQY
FPHLQQPSF	FPHLQQPSF
SPVSFIATY	SPVSFIATY
MPLQLLLLL	MPLQLLLLL
SAMEVVPAL	SAMEVVPAL
MPVDDVIGTL	MPVDVIGTL
QPAPISPHL	QPAPISPHL
TPISITSSY	TPISITSSY
MIFQDPTAM	MIFQDPTAM
SPVENKEVY	SPVENKEVY
YMFVDENTF	YMFVDENTF
IAIDVIDAY	IAIDVIDAY
FVNPHVSSF	FVNPHVSSF
MPYLEHESF	MPYLEHESF
TPFSVGLVY	TPFSVGLVY
LPINDPLQTVY	LPINLQTVY
TPLHMAIAY	TPLHMAIAY
LPFPGRSASY	LPFPRSASY
DAYTHLETF	DAYTHLETF
VPYKDEELY	VPYKDEELY
YVHDDGRVSY	YVHDGRVSY
FPVPKPIDY	FPVPKPIDY
EAVKQYSSY	EAVKQYSSY
VPEEGGATHVY	VPEEATHVY
FPSPILKVQY	FPSPLKVQY
FPSEYVPTVF	FPSEVPTVF
VPYPDDLVGF	VPYPDLVGF
APFGEKEAY	APFGEKEAY
EAWLEMNPGY	EAWLMNPGY
FPSIYDVKY	FPSIYDVKY
LIFSVPIVY	LIFSVPIVY
HPVTGQFLY	HPVTGQFLY
TAWLEIMTKY	TAWLIMTKY
SALPLYNLY	SALPLYNLY
SASRLVLNY	SASRLVLNY
SPEGRLYQVEY	SPEGYQVEY
QPLHVTKGY	QPLHVTKGY
DAFEFHEAF	DAFEFHEAF
NAWADIERF	NAWADIERF
MPHANMNVHY	MPHAMNVHY
FPETTSPHEY	FPETSPHEY
HAVAVTESY	HAVAVTESY
YPQEVIPTF	YPQEVIPTF
EAFDELLASKY	EAFDLASKY
TAAPLLLAM	TAAPLLLAM
FPMEIRQYL	FPMEIRQYL
SPDPSIYAY	SPDPSIYAY
RPAQVSQPF	RPAQVSQPF
FPYGTTVTY	FPYGTTVTY
LPSRVIEEL	LPSRVIEEL
APARPQPAY	APARPQPAY
YPGQPHPAL	YPGQPHPAL
MPVTYKDPAY	MPVTKDPAY
MPEDVKNFY	MPEDVKNFY
MPDSGRPAF	MPDSGRPAF
LPDTRSEAY	LPDTRSEAY
SPFYPGKTTY	SPFYGKTTY
NAARSQLETY	NAARQLETY
LAQQYYLVY	LAQQYYLVY
FPTISLEF	FPTI-SLEF
APIQVFSTY	APIQVFSTY
TPMEVAVY	TPME-VAVY
TAAPVPTTL	TAAPVPTTL
LPRTTTESEVM	LPRTTTESE
HAAEYGAEALE	HAAEGAEAL
FPHNFQETTY	FPHNQETTY
SLVNLGGSK	SLVNLGGSK
TAISLFYEL	TAISLFYEL
MPNSASRDEF	MPNSSRDEF
HAVIDINAF	HAVIDINAF
DAFPLLSAY	DAFPLLSAY
HAAEDSSLLIY	HAAEDSSLL
YPYGEKQDEF	YPYGKQDEF
FPDETHERY	FPDETHERY
TPSQPLPTY	TPSQPLPTY
RPLPPMKSY	RPLPPMKSY
PLYWLGFVY	PLYWLGFVY
HPSHVQPAY	HPSHVQPAY
LPLNSVYVY	LPLNSVYVY
FPLKVFGY	FPLK-VFGY
LPLPDPLKY	LPLPDPLKY
SPQDLRLFY	SPQDLRLFY
QPILYSYSF	QPILYSYSF
EPIYIVTEY	EPIYIVTEY
IPADTFAAL	IPADTFAAL
NAFKEITTM	NAFKEITTM
NAWAEQTGM	NAWAEQTGM
YPDQYVREY	YPDQYVREY
QPAIIDGELY	QPAIDGELY
TAEGQATLERL	TAEG-QATL
FPEEVIATI	FPEEVIATI
MPADTNKAF	MPADTNKAF
HPQDSAFSY	HPQDSAFSY
HPELQALIY	HPELQALIY
HAGEAIPAL	HAGEAIPAL
PKVDFPTAI	PKVDFPTAI
NPISGLLEY	NPISGLLEY
LPNDVISSL	LPNDVISSL
SPSKPTLAY	SPSKPTLAY
FANVEEHSF	FANVEEHSF
FPEGSVELY	FPEGSVELY
DPFRDLHSL	DPFRDLHSL
SPLERYYDY	SPLERYYDY
EPVPASIPNYY	VPASIPNYY
FPFEQQSEF	FPFEQQSEF
LPYTVVIHY	LPYTVVIHY
VPVPPNVAF	VPVPPNVAF
IPFSGALEL	IPFSGALEL
FPAGILQAPF	FPAGLQAPF
HPVYILKGGY	HPVYLKGGY
MPSGAYVY	MPSG-AYVY
MPETTETVL	MPETTETVL
NVKVDPEIQ	NVKVDPEIQ
DVREEGKENAF	VREEKENAF
MPAPEEIVEEL	APEEIVEEL
VPLEEAAQEY	VPLEAAQEY
TALQAIVEY	TALQAIVEY
LPHDPDLAY	LPHDPDLAY
YPQDNMHQM	YPQDNMHQM
RPFEDQTSL	RPFEDQTSL
TPMFVVKAY	TPMFVVKAY
LPYRATENDIY	LPYRATEND
HAFVDLHEF	HAFVDLHEF
FPATPLLDY	FPATPLLDY
SPFHDIPIY	SPFHDIPIY
MPVPVILNF	MPVPVILNF
EPIYPEVVHMF	EPIYEVVHM
HPYQFLLKY	HPYQFLLKY
YPTSIASLAF	YPTSASLAF
MPAAQEGAVAF	AAQEGAVAF
SPIHTSVQF	SPIHTSVQF
LPDPLQEPY	LPDPLQEPY
TPNPGYQPSM	TPNPYQPSM
LPIPSQPQF	LPIPSQPQF
APAPIHNQF	APAPIHNQF
HATVATENEVF	TVATENEVF
HAVVNLINY	HAVVNLINY
MPPQNVGEVY	MPPQVGEVY
TADHNLLLY	TADHNLLLY
LPYDLRASF	LPYDLRASF
QPVEPLPGF	QPVEPLPGF
RNVSTGDVNVE	NVSTGDVNV
LPLTHFELY	LPLTHFELY
RPIRLQVQY	RPIRLQVQY
TPISEHAVF	TPISEHAVF
YPWSQRVSF	YPWSQRVSF
YPENIVPSF	YPENIVPSF
YALEEGIVRY	YALEGIVRY
LPFLPSTEDVY	LPFLTEDVY
LPTIVIVAH	LPTIVIVAH
YPLDVQKEF	YPLDVQKEF
RPFEQPQEY	RPFEQPQEY
EPFQDGYSL	EPFQDGYSL
MPFTTVSEL	MPFTTVSEL
MPDSAAAL	MPDS-AAAL
LPFPDETHERY	FPDETHERY
NVVKLLGEQY	NVVKLGEQY
YAAPHPLQSY	YAAPPLQSY
MPFQRAGVNF	MPFQAGVNF
QAYPEYLITY	QAYPYLITY
FPFSQDINSH	FPFSDINSH
IVSQIAVAY	IVSQIAVAY
IAFFDVRTF	IAFFDVRTF
MAHSFGESY	MAHSFGESY
FPLLATAY	FPLL-ATAY
LPYPDLQEF	LPYPDLQEF
MPFQQWEAL	MPFQQWEAL
DSHLPMLL	DSHL-PMLL
YPNPKPEVL	YPNPKPEVL
LPLRFDLQY	LPLRFDLQY
IATAVITLF	IATAVITLF
EAYTDHATY	EAYTDHATY
FPHYGFPTY	FPHYGFPTY
EPVDHGKIEY	EPVDGKIEY
HAAVPTPGY	HAAVPTPGY
LPNGYVYGY	LPNGYVYGY
LPYPDLETY	LPYPDLETY
LPNDGDEKY	LPNDGDEKY
SPLPAQLVY	SPLPAQLVY
FPFKPPSIY	FPFKPPSIY
NAVDLGQMSSF	NAVDQMSSF
YPGPAVVL	YPGP-AVVL
YPWWEQQGF	YPWWEQQGF
QAINNAISY	QAINNAISY
QPVDWFVVY	QPVDWFVVY
MPYNHQHKY	MPYNHQHKY
HLPETKFSEL	LPETKFSEL
VPVEEQEEF	VPVEEQEEF
VPFSIFDEF	VPFSIFDEF
MPNENIPEL	MPNENIPEL
RPVNVVNVY	RPVNVVNVY
IIHEIAVLEL	IIHEAVLEL
MPHDAIILL	MPHDAIILL
APFGNFPHY	APFGNFPHY
EPNSYAISF	EPNSYAISF
SPPIIVGEEY	PPIIVGEEY
HPQYEVVEI	HPQYEVVEI
HPVAKILHAY	HPVAILHAY
SPEELYRVF	SPEELYRVF
HPIHQGITEL	HPIHGITEL
VPMPYTLKVHY	MPYTLKVHY
TVLELVTQY	TVLELVTQY
MPEKEPSVL	MPEKEPSVL
EPSFITESY	EPSFITESY
FAANVYEAF	FAANVYEAF
LPHAPGVQM	LPHAPGVQM
YPDTDVILM	YPDTDVILM
HPFTNKPTTF	HPFTKPTTF
MPLQDSISL	MPLQDSISL
LPAPPHIDVMY	LPAPHIDVM
LPQVQNTAM	LPQVQNTAM
HPTPSPMAY	HPTPSPMAY
FPVDPQRMSIF	FPVD-PQRM
FPLDVGSIVGY	FPLDSIVGY
WARLDETPF	WARLDETPF
FPHLLQPVL	FPHLLQPVL
LPWKAFTY	LPWK-AFTY
HPEASIQAVF	HPEAIQAVF
FPEPSRPPLF	FPEPSRPPL
GAHGIIVVY	GAHGIIVVY
LPFPNPERNF	LPFPPERNF
NPVQALSEF	NPVQALSEF
TVSDAILRY	TVSDAILRY
HPAAKMIVM	HPAAKMIVM
MPAGEIEQF	MPAGEIEQF
VPSGLIVDY	VPSGLIVDY
IPMQSEPQY	IPMQSEPQY
QASSKILKY	QASSKILKY
HADDSFLVL	HADDSFLVL
SAVELVQEF	SAVELVQEF
DAVVSQVL	DAVV-SQVL
PVATVLTDM	PVATVLTDM
TPHSEIIFY	TPHSEIIFY
SPFSFHHVL	SPFSFHHVL
YPFSSEQKW	YPFSSEQKW
HPPHYFFTY	HPPHYFFTY
MPAPEIVSY	MPAPEIVSY
FPYPFQVVY	FPYPFQVVY
HAVQTVETM	HAVQTVETM
GQNPFELAF	GQNPFELAF
SALPTVVAY	SALPTVVAY
YPFKDVNNW	YPFKDVNNW
EAAPPGELY	EAAPPGELY
LPIDPNEPTY	LPIDNEPTY
NAMDVTTGY	NAMDVTTGY
NPTDISYVY	NPTDISYVY
DAIRLFAAY	DAIRLFAAY
MPLHVAPLL	MPLHVAPLL
EAWHELAELY	EAWHLAELY
LPYPSEASTTF	YPSEASTTF
TPLVDPSVY	TPLVDPSVY
APVALVVHM	APVALVVHM
HPNPIPSGL	HPNPIPSGL
TNFEDRNAF	TNFEDRNAF
KPAPLTPAY	KPAPLTPAY
HPFEVPREY	HPFEVPREY
IPAEEIPAY	IPAEEIPAY
MPFDFRRFDIY	MPFD-FRRF
LPLEEHYRF	LPLEEHYRF
NAAQTSVAY	NAAQTSVAY
VPIPTVNQY	VPIPTVNQY
NPTDAFTVF	NPTDAFTVF
HPLSNPAEL	HPLSNPAEL
MPAATDNRY	MPAATDNRY
SAFDEAMSY	SAFDEAMSY
FPAAPAPKM	FPAAPAPKM
IPTHTQPSY	IPTHTQPSY
MPVGPDAILRY	MPVGPDAIL
IAIPVTVAF	IAIPVTVAF
HPGSSALHY	HPGSSALHY
QAFFLHTTY	QAFFLHTTY
YPSEFATYL	YPSEFATYL
TAPAAPTMA	TAPAAPTMA
RAFDQGADAIY	FDQGADAIY
VPADAVVQY	VPADAVVQY
LPFHFPGSF	LPFHFPGSF
IPAEDMNAF	IPAEDMNAF
FPHGDLTEF	FPHGDLTEF
VPTPIHPIF	VPTPIHPIF
EPAHRTAPAG	EPAHRTAPA
LPVAKDVSY	LPVAKDVSY
FAYKDYLSF	FAYKDYLSF
MPFEIRLPEF	MPFERLPEF
NPDDVFREF	NPDDVFREF
LPAETMRI	LPAE-TMRI
FVNDDRHVM	FVNDDRHVM
LPQNQPFVF	LPQNQPFVF
MPSEKVSSY	MPSEKVSSY
SPIPFPPLSY	SPIPPPLSY
VADPYVVIM	VADPYVVIM
TPIKDGILY	TPIKDGILY
DAHPTLVTY	DAHPTLVTY
NAISVTTSY	NAISVTTSY
TASEMILVL	TASEMILVL
LPLHVLPLY	LPLHVLPLY
HPVEELLDSY	HPVELLDSY
QPMDIHVEL	QPMDIHVEL
SPSHIIHNY	SPSHIIHNY
QPLEEIITY	QPLEEIITY
LPHFDESTF	LPHFDESTF
MAYGHIDSY	MAYGHIDSY
FPAAPIPTL	FPAAPIPTL
VPTPIQPTF	VPTPIQPTF
QVFEGHTHY	QVFEGHTHY
TAAPVVPEL	TAAPVVPEL
TANPQTPVEY	TANPTPVEY
FASKEIAENAL	FASKAENAL
FPFLDENVV	FPFLDENVV
TAADLVPIF	TAADLVPIF
HPSLQPEEY	HPSLQPEEY
LAWLDEHTL	LAWLDEHTL
EAQPIVTKY	EAQPIVTKY
FPVYVLPKVEY	FPVYPKVEY
HPHKIIVMY	HPHKIIVMY
VPDSSGPERIL	VPDSSGPER
ISPSRTEAL	ISPSRTEAL
FPEHIFPAL	FPEHIFPAL
HPLLKTLEY	HPLLKTLEY
QPLEDLASF	QPLEDLASF
EVPKKLKY	EVPK-KLKY
HPSDIEVDL	HPSDIEVDL
EAYNAVVRY	EAYNAVVRY
LPLERDAESF	LPLEDAESF
MPVGMTHGL	MPVGMTHGL
FPHPVNQVTF	FPHPNQVTF
NPADITVLF	NPADITVLF
MPFYPRVVY	MPFYPRVVY
LPLNTNIRLAY	LPLNTNIRL
YPIALTRAEM	YPIATRAEM
HPTTISPRY	HPTTISPRY
MPIGPDVSL	MPIGPDVSL
NPITVQTVY	NPITVQTVY
FADGFVLVY	FADGFVLVY
FVNPGVVEF	FVNPGVVEF
IPEGEILVITY	IPEGLVITY
HAIQDLLVF	HAIQDLLVF
MPADSGYPAY	MPADGYPAY
LPHQPLATY	LPHQPLATY
SAAAAAAAAAY	AAAAAAAAY
FPSGSVHSF	FPSGSVHSF
YPASIVDEPTF	YPASDEPTF
NPLQKDPQY	NPLQKDPQY
NPFEKGDLY	NPFEKGDLY
HPISSGLEAM	HPISGLEAM
IPFSGKGYVL	IPFSKGYVL
QAVDAVEEF	QAVDAVEEF
DAISKTYSY	DAISKTYSY
LPVEEFNEL	LPVEEFNEL
DPFKDIILY	DPFKDIILY
HAAMLGLMY	HAAMLGLMY
VPILNPVVY	VPILNPVVY
SAAQPGVAF	SAAQPGVAF
TVFDLVEEY	TVFDLVEEY
HANVVVYSY	HANVVVYSY
IPFRPSIQF	IPFRPSIQF
MPIHSDIL	MPIH-SDIL
SPAEVAEQY	SPAEVAEQY
VPNDIQSEL	VPNDIQSEL
QAFESSQKY	QAFESSQKY
IPSSVIHPAM	IPSSIHPAM
APHAPGPPA	APHAPGPPA
HPDPFANKSL	HPDPANKSL
MPDDLLTTL	MPDDLLTTL
IPMELVNEVM	IPMEVNEVM
VPVDSAPVM	VPVDSAPVM
MPVHAAVQM	MPVHAAVQM
YPFKPPKITF	YPFKPKITF
HATTIQPEF	HATTIQPEF
NALPDTLKVTY	LPDTLKVTY
FPQTALVSF	FPQTALVSF
MPEPDAQRF	MPEPDAQRF
LPSDIAAEA	LPSDIAAEA
LPHGLIESF	LPHGLIESF
DPHTVTVSM	DPHTVTVSM
YPAQITPKM	YPAQITPKM
DPFSFDGPEIM	FSFDGPEIM
DALGHFFQY	DALGHFFQY
LPINHQIIY	LPINHQIIY
YAIDNPLHY	YAIDNPLHY
LPQHTIETY	LPQHTIETY
NAFEELVAF	NAFEELVAF
FAYDGKDYI	FAYDGKDYI
FPQPAAVY	FPQP-AAVY
LPLSIKDDEY	LPLSKDDEY
EALDHMVEY	EALDHMVEY
TAYPGQTQY	TAYPGQTQY
VPHTNPPEY	VPHTNPPEY
HPFHATPNVY	HPFHTPNVY
TAAETHYTY	TAAETHYTY
TATATNHVL	TATATNHVL
NPVEYSIVM	NPVEYSIVM
NAMNMQETY	NAMNMQETY
MPDPTPFLL	MPDPTPFLL
MPTSTILRL	MPTSTILRL
APIASIHSF	APIASIHSF
QALRLEREEY	QALREREEY
HPSESLEKM	HPSESLEKM
LPSDHSVKY	LPSDHSVKY
EAWADDVERF	EAWADVERF
FVAEQKVEY	FVAEQKVEY
NAMDVVVQF	NAMDVVVQF
QAVQQQEVY	QAVQQQEVY
TAVKIAPRY	TAVKIAPRY
LPAYPTENF	LPAYPTENF
LPYNHQHEYF	LPYNHQHEY
FPLPGLPDF	FPLPGLPDF
QAITLVTQY	QAITLVTQY
HPVSLEQYLM	HPVSLEQYL
HPSQTVELF	HPSQTVELF
DAGPPTHAF	DAGPPTHAF
TPLSLFGDTY	TPLSFGDTY
NPWDNKAVY	NPWDNKAVY
YPLQEVERF	YPLQEVERF
LPSDKALVL	LPSDKALVL
NAFHVYQVY	NAFHVYQVY
VPASNAIAY	VPASNAIAY
QPMEVQEGY	QPMEVQEGY
TPIQVLHEY	TPIQVLHEY
MVLENVKEM	MVLENVKEM
LPREGEQNF	LPREGEQNF
HAAGFAYTY	HAAGFAYTY
FPGIKLIY	FPGI-KLIY
HPLSVLGINY	HPLSLGINY
IPTRVITNF	IPTRVITNF
HAFDDQGREY	HAFDQGREY
HPLPETAVRGY	LPETAVRGY
MPVDPNEPTY	MPVDNEPTY
FPHHLQEYIEY	FPHH-LQEY
QPFLEVTKEAF	QPFLTKEAF
TAADIFKQY	TAADIFKQY
HPIQTQAQY	HPIQTQAQY
LEDALQQAKED	DALQQAKED
IPHEAFVY	IPHE-AFVY
YPNSHTHYF	YPNSHTHYF
QPQANSHVY	QPQANSHVY
SASEVTSTVY	SASETSTVY
HASVYQITY	HASVYQITY
MPAVKAIIY	MPAVKAIIY
LPQHQVPAY	LPQHQVPAY
HPNIITLKDVY	NIITLKDVY
IPVDTVLTM	IPVDTVLTM
YPYPGELTMM	YPYPGELTM
HVHHLINEY	HVHHLINEY
VPAEHQVAM	VPAEHQVAM
HALSLKIVL	HALSLKIVL
HPFLSGAETF	HPFLGAETF
FPVGDVNNF	FPVGDVNNF
QQVPVNQVF	QQVPVNQVF
FPLLPQDVHLL	FPLLQDVHL
FPYDYSASEY	FPYDSASEY
EAFLNNQEY	EAFLNNQEY
LPLLKAQEY	LPLLKAQEY
LPAVSWKM	LPAV-SWKM
QAIQWILHY	QAIQWILHY
IPWDDLIAL	IPWDDLIAL
QAINNAITY	QAINNAITY
VPFALFESF	VPFALFESF
VPQSGVPAL	VPQSGVPAL
LPHSATVTL	LPHSATVTL
MPSQSVEQTY	MPSQVEQTY
LPAAGVGDMVM	LPAAGVGDM
LPTEEEWEF	LPTEEEWEF
LPNNAKLEM	LPNNAKLEM
EAWNEEGKAVW	EAWNGKAVW
NAFEVAEKY	NAFEVAEKY
MPQFSTIEY	MPQFSTIEY
TPSPPEVVY	TPSPPEVVY
APLKSKMIY	APLKSKMIY
FAEMIQPEY	FAEMIQPEY
YDAEISQIHQ	YDAEISQIH
TPEEFFRIF	TPEEFFRIF
IPIALSGRDIL	IALSGRDIL
FPSPNQITL	FPSPNQITL
QARIEIESF	QARIEIESF
LSDTEVLEY	LSDTEVLEY
EAASVPVVY	EAASVPVVY
YPLTSPPTSY	YPLTPPTSY
YPQNPDHVL	YPQNPDHVL
MPVPTTPEF	MPVPTTPEF
YPFDDSPEH	YPFDDSPEH
DAADIRFVY	DAADIRFVY
LPIGDVATQY	LPIGVATQY
HPHPEDIKF	HPHPEDIKF
HPDEKSIITY	HPDESIITY
YPVEDFEASF	YPVEFEASF
YPLEDATHIAL	YPLEDATHI
TAFGGFLKY	TAFGGFLKY
ATAQPPAPL	ATAQPPAPL
LPNDKTLLY	LPNDKTLLY
NPVGGLLEY	NPVGGLLEY
YPYTETQMY	YPYTETQMY
QAVADAVTY	QAVADAVTY
EPWPENATLY	EPWPNATLY
QATRTVPVF	QATRTVPVF
IPPDVPILL	IPPDVPILL
IPVIVTEQY	IPVIVTEQY
TASELKILY	TASELKILY
YPAAPLPGF	YPAAPLPGF
IPMSDPQVL	IPMSDPQVL
FPVKGLKTGY	FPVKLKTGY
MALLVPLVY	MALLVPLVY
LPSPHPVRY	LPSPHPVRY
FPYIEAEVKY	FPYIAEVKY
YPDPRGAPW	YPDPRGAPW
YPMYSRDYVY	YPMYRDYVY
MPVLEQSVL	MPVLEQSVL
VPIHDIAAVSY	VPIHAAVSY
LPTDTLQEL	LPTDTLQEL
EAARLEYDAY	EAAREYDAY
IPYQDRESY	IPYQDRESY
FPHVQTDVL	FPHVQTDVL
YPVEIHEYL	YPVEIHEYL
IPVTIITGY	IPVTIITGY
QAFPGGHSM	QAFPGGHSM
MALQEASEAY	MALQASEAY
SPFNDRFPL	SPFNDRFPL
HPTGKMFIL	HPTGKMFIL
HPLDYELTY	HPLDYELTY
YAWRPVFDEY	YAWRVFDEY
APATSILEY	APATSILEY
TVTEVLLKY	TVTEVLLKY
SPFQPHVPY	SPFQPHVPY
IPAPGSGVSF	IPAPSGVSF
MPVPSMVPSY	MPVPMVPSY
YPFLLVGDLM	YPFLVGDLM
QPINLIFRY	QPINLIFRY
MAISDELHY	MAISDELHY
MPHEKHYTL	MPHEKHYTL
IPVEQKEGAF	IPVEKEGAF
APAPPASQY	APAPPASQY
IPIGGGTSVSY	IPIGTSVSY
LPGSIQHVY	LPGSIQHVY
FPDTGSDHSY	FPDTSDHSY
MPTAYNTDY	MPTAYNTDY
HPDLPLAVY	HPDLPLAVY
HAVVTVPAY	HAVVTVPAY
MPFKDRATSM	MPFKRATSM
FPEPEHSSF	FPEPEHSSF
LPLFPEPLHVF	FPEP-LHVF
YPQPPSQSY	YPQPPSQSY
FPYSENKEKY	FPYSNKEKY
LPAQLLELY	LPAQLLELY
FPFHEVIQEF	FPFHVIQEF
LPQEAFEKY	LPQEAFEKY
IPALAVEM	IPAL-AVEM
LPFFPIATY	LPFFPIATY
EPFNFQMVY	EPFNFQMVY
YPRPRDTSF	YPRPRDTSF
IPLRSSWVM	IPLRSSWVM
HPWELFVKY	HPWELFVKY
AAAPAIMSY	AAAPAIMSY
IPFEFPLHL	IPFEFPLHL
LPHELFQEF	LPHELFQEF
SAANIQPIF	SAANIQPIF
MPDLPHLL	MPDL-PHLL
TPDPSRSVF	TPDPSRSVF
QAVAIFTVY	QAVAIFTVY
HPESVSQSL	HPESVSQSL
QATQVLQEM	QATQVLQEM
FPAGKVPAF	FPAGKVPAF
VAAPLFELY	VAAPLFELY
LPVLERLIY	LPVLERLIY
QASDVSVKY	QASDVSVKY
LPFPKIDPY	LPFPKIDPY
HPTADVQTF	HPTADVQTF
HPNLVVGGTY	HPNLVGGTY
MPTVSVLEY	MPTVSVLEY
LSLPAVTFGET	LSLP-AVTF
HPDRSQPAF	HPDRSQPAF
HPWFGMEQEY	HPWFMEQEY
SPAPVPVTY	SPAPVPVTY
TAIPVHDGYVL	TAIPVHDGY
YPRFLESEF	YPRFLESEF
MAFLDSQTATF	MAFLDSQTA
SPVDSVLFY	SPVDSVLFY
IARREEEFDLF	IARR-EEEF
FPIEYHDIW	FPIEYHDIW
EAFRGVHRY	EAFRGVHRY
MAYEGQYDAY	MAYEQYDAY
VPFHSDLGY	VPFHSDLGY
YPLPAVKVSM	YPLPVKVSM
FADPHGKVF	FADPHGKVF
MPFPAHLTY	MPFPAHLTY
FPEPNPRVI	FPEPNPRVI
YPEPQNKEAF	YPEPNKEAF
SPSDVFIGY	SPSDVFIGY
YPNEEKDAW	YPNEEKDAW
HPMGGLNAM	HPMGGLNAM
LPYNDYFEY	LPYNDYFEY
LPWASTHSL	LPWASTHSL
MPEEIARYY	MPEEIARYY
APFSKVITF	APFSKVITF
FPWPSLRTY	FPWPSLRTY
LPLISVAL	LPLI-SVAL
NVIRDAVTY	NVIRDAVTY
EAVFLRGVDIY	AVFLGVDIY
HAVDVDSGNSY	HAVDSGNSY
FPASPPKGY	FPASPPKGY
FPVEIKSFY	FPVEIKSFY
TPALVNAAVTY	TPALAAVTY
FPEGLVIQAY	FPEGVIQAY
HPYPHNHYM	HPYPHNHYM
LPSTTIVSM	LPSTTIVSM
VPVDLQHQF	VPVDLQHQF
FPDKPITQY	FPDKPITQY
LPLLPNVSY	LPLLPNVSY
LPADVQNYY	LPADVQNYY
IPTHHPRVY	IPTHHPRVY
FPVPESILTSM	VPESILTSM
HAVDVDSGSVY	HAVDSGSVY
MPVSSQHRY	MPVSSQHRY
HPMAYQLQL	HPMAYQLQL
LPSEAGFAEY	LPSEGFAEY
FPLSHLDAL	FPLSHLDAL
MAGDIYSVF	MAGDIYSVF
MPYDTPVPGY	MPYDPVPGY
HAVGNVELY	HAVGNVELY
MPDLAHVM	MPDL-AHVM
EVYAGSHQY	EVYAGSHQY
TAWDEADVRF	TAWDADVRF
MAAKILEEF	MAAKILEEF
NADTLALVF	NADTLALVF
NAFAEPGRVPF	FAEPGRVPF
LPSPVTAQKY	LPSPTAQKY
MPIREGDTVTL	MPIRDTVTL
MVNPFAYEEY	NPFA-YEEY
