Data	Data aligned
IIHEIAVLEL	HEIA-VLEL
HELIHGSSF	HELIHGSSF
HRPLDPLTM	HRPLDPLTM
AANKTIIYL	AANKTIIYL
AGQESPIIL	AGQESPIIL
SIPILASAL	SIPILASAL
LIPLHVLVL	LIPLHVLVL
VTDTNVIL	VTDT-NVIL
SVIGFRILL	SVIGFRILL
TTGPIFSM	TTGP-IFSM
RLAEHIVSM	RLAEHIVSM
AGADHIITM	AGADHIITM
IVMPNILVL	IVMPNILVL
MQNPNAIIL	MQNPNAIIL
FRMDHEFVA	FRMDHEFVA
ITQIEHEVSSS	TQIEHEVSS
FRNPLAPAV	FRNPLAPAV
SYGLNIEM	SYGL-NIEM
VGGPEIEL	VGGP-EIEL
NRGVIITM	NRGV-IITM
AIHTAILTL	AIHTAILTL
IRHPNIITL	IRHPNIITL
SAIPHPLIM	SAIPHPLIM
KAPEATVTL	KAPEATVTL
AAPGVDLT	AAPG-VDLT
NAENEFVTIK	AENEFVTIK
VVPEPGQPL	VVPEPGQPL
NSGVPVYL	NSGV-PVYL
FVNSYPVTM	FVNSYPVTM
ASGMILVM	ASGM-ILVM
RSTDTVFHM	RSTDTVFHM
RELQKLSKF	RELQKLSKF
VGPPGRSSL	VGPPGRSSL
VLPERYSSL	VLPERYSSL
HVHEKAILL	HVHEKAILL
MAPERVASL	MAPERVASL
RDALKTEF	RDAL-KTEF
SRITTHFEL	SRITTHFEL
LEDALQQAKED	ALQQ-AKED
GGSNVHIIL	GGSNVHIIL
SSHTFVPIL	SSHTFVPIL
YEDIAQKS	YEDI-AQKS
VAMTGEITL	VAMTGEITL
IRSSYIRVL	IRSSYIRVL
QLAHSVVL	QLAH-SVVL
RELYHVISF	RELYHVISF
NIPEKTTAL	NIPEKTTAL
TDLTRKEGL	TDLTRKEGL
FRTDGHPVM	FRTDGHPVM
GLHGWAFTL	GLHGWAFTL
IINSNPIEL	IINSNPIEL
HDKLSHYL	HDKL-SHYL
ASSPHGLVM	ASSPHGLVM
AVSPVDLNL	AVSPVDLNL
AELERNVAL	AELERNVAL
AGQDAVIVL	AGQDAVIVL
HLTPVTLEL	HLTPVTLEL
TEKDSYVVAF	KDSY-VVAF
KVSPTEIVL	KVSPTEIVL
SELIRNVTL	SELIRNVTL
KEVERILGL	KEVERILGL
GDLQRELNL	GDLQRELNL
AAAPPLTL	AAAP-PLTL
HVGTEVVL	HVGT-EVVL
ITQIEHEVS	ITQIEHEVS
GELKRRLGL	GELKRRLGL
RDNLKISDF	RDNLKISDF
HVPEHAVVL	HVPEHAVVL
RAAPHRISL	RAAPHRISL
ADALRPSVV	ADALRPSVV
TAMDVVYAL	TAMDVVYAL
TDLLKTGF	TDLL-KTGF
HDYMKQMTF	HDYMKQMTF
RNVSTGDVNVE	NVSTGDVNV
FVGQTVEL	FVGQ-TVEL
YAIEVDPVL	YAIEVDPVL
QKPNFVIIL	QKPNFVIIL
TRPEKALIL	TRPEKALIL
SRSHSIFTV	SRSHSIFTV
RDHLRVNL	RDHL-RVNL
VITGVDIVM	VITGVDIVM
IVNEYAFLL	IVNEYAFLL
YENEVALRQ	YENEVALRQ
SVNPYIVKL	SVNPYIVKL
AAPNGAEPL	AAPNGAEPL
RRNDKIIVF	RRNDKIIVF
EELPHIHAF	EELPHIHAF
VRMENVTVL	VRMENVTVL
YQSKYEELQIT	YQSK-YEEL
RDHIKDSF	RDHI-KDSF
YNIVDDHLVV	NIVDDHLVV
SAPVPASPL	SAPVPASPL
RDVQHIIVF	RDVQHIIVF
FRHPHIIKL	FRHPHIIKL
FVVPYGTPL	FVVPYGTPL
AAAVQAFYL	AAAVQAFYL
NSHEMAIVF	NSHEMAIVF
IRLENEIQT	IRLENEIQT
QRIDEFESM	QRIDEFESM
KSIHIVVTM	KSIHIVVTM
AAPVPTTTL	AAPVPTTTL
AAIDHQIEV	AAIDHQIEV
RDFNHINV	RDFN-HINV
AGAYHAVVL	AGAYHAVVL
TVILHSIYL	TVILHSIYL
RQRSLFVVV	RQRSLFVVV
GTTDHVIVL	GTTDHVIVL
AAIWFRTYL	AAIWFRTYL
TVTEKPEVID	TVTEKPEVI
SLVNLGGSK	SLVNLGGSK
HEPEPHILL	HEPEPHILL
FVVEHDFIM	FVVEHDFIM
ARNDYLLTL	ARNDYLLTL
ITGVDIVM	ITGV-DIVM
AAIYHVLHF	AAIYHVLHF
VDLERTIAL	VDLERTIAL
FASVVDIKL	FASVVDIKL
QIPEIKQTL	QIPEIKQTL
GEMPRHMQL	GEMPRHMQL
KASDLYITL	KASDLYITL
YDLLRNTNF	YDLLRNTNF
SGDVSLLHL	SGDVSLLHL
IAPSHVIEM	IAPSHVIEM
AAAGSPVFL	AAAGSPVFL
SAPVGVTAL	SAPVGVTAL
TDSPREVFF	TDSPREVFF
AGGRVFVL	AGGR-VFVL
YNQGFEIVL	YNQGFEIVL
SGPGPAAAL	SGPGPAAAL
VRSPVVHSV	VRSPVVHSV
AAIASLLYL	AAIASLLYL
SSSKGSLGGGF	SSSKGSLGG
FYRPHTITL	FYRPHTITL
SAVSHFFSL	SAVSHFFSL
TEKPEVID	TEKP-EVID
VSPVVRVAV	VSPVVRVAV
LSHPLALHL	LSHPLALHL
REFPKFFTF	REFPKFFTF
INGLRRVLD	INGLRRVLD
RDNYVPEV	RDNY-VPEV
AAQQHETFL	AAQQHETFL
RDYVRYRL	RDYV-RYRL
ALEEQLQQIR	ALEEQLQQI
AAVEEGIVL	AAVEEGIVL
ADQIVTKL	ADQI-VTKL
ADLERVLGL	ADLERVLGL
AAAPSLLIL	AAAPSLLIL
RAAIHVVVL	RAAIHVVVL
FTLSHITQL	FTLSHITQL
YGIENEVFL	YGIENEVFL
GSDMRTERF	GSDMRTERF
FAHPYQYEL	FAHPYQYEL
AESLRYKLL	AESLRYKLL
AAGVVLEM	AAGV-VLEM
NAIGVLIYM	NAIGVLIYM
SAPSSDKPL	SAPSSDKPL
NRHPNFLVV	NRHPNFLVV
FGSEFSPEL	FGSEFSPEL
FRPPNPWTM	FRPPNPWTM
AVMLHSFTL	AVMLHSFTL
VINPEPITL	VINPEPITL
FRQDFHSEM	FRQDFHSEM
NAAPGVDL	NAAP-GVDL
AAHVSRVIL	AAHVSRVIL
SAHSHFISL	SAHSHFISL
AAVNHISQL	AAVNHISQL
YVAVTPFSL	YVAVTPFSL
YVPPKGDKKG	YVPPKGDKK
FVTPKVIKL	FVTPKVIKL
FAQEALTVL	FAQEALTVL
GVVDHQTEL	GVVDHQTEL
ASADTAYVL	ASADTAYVL
AAPVSATVL	AAPVSATVL
YGNPNTLRL	YGNPNTLRL
AVQEKVFEL	AVQEKVFEL
HSIGSYFTL	HSIGSYFTL
VDHEKPLSF	VDHEKPLSF
SELVRHSSF	SELVRHSSF
KRQEVIYEL	KRQEVIYEL
NLPAHTVII	NLPAHTVII
HRNEVTVEL	HRNEVTVEL
VAPGKDLTKTL	VAPGKDLTK
IVGPLVEM	IVGP-LVEM
DAVEDLESVGK	AVED-LESV
ADNLRLIQV	ADNLRLIQV
SEGPPLTSF	SEGPPLTSF
YRKGPPFYHA	KGPP-FYHA
EDQLRGAGF	EDQLRGAGF
SAIDRIFTL	SAIDRIFTL
TSIGHVVQL	TSIGHVVQL
AAPATRAAL	AAPATRAAL
FAPYNKPSL	FAPYNKPSL
TVNRTVITM	TVNRTVITM
IAPGVTHEL	IAPGVTHEL
SSTISSNVASK	TISSNVASK
AAHDALVEL	AAHDALVEL
VVGPNITL	VVGP-NITL
VTIKKDVDG	VTIKKDVDG
SEFQRLLGF	SEFQRLLGF
VAPVTHVSV	VAPVTHVSV
GVAGPKGPAGE	VAGPKGPAG
AAASHFFNL	AAASHFFNL
REKEWQRL	REKE-WQRL
RAHPQGLVL	RAHPQGLVL
FSSDVTHEM	FSSDVTHEM
IRPEYAWIV	IRPEYAWIV
LQIDNARLA	LQIDNARLA
ADSKRAFEL	ADSKRAFEL
NSGDVNVEIN	NSGDVNVEI
GDTLVTGF	GDTL-VTGF
AATGHTVVL	AATGHTVVL
IVGPVVGL	IVGP-VVGL
LAGPALEL	LAGP-ALEL
VIPESVILL	VIPESVILL
FVMETFVHL	FVMETFVHL
ARANQAIQM	ARANQAIQM
TISSNVASKA	TISSNVASK
EEQLQQIR	EEQL-QQIR
AALPKATIL	AALPKATIL
INSSVHVIM	INSSVHVIM
ASSFVFLNL	ASSFVFLNL
SANNVYLVM	SANNVYLVM
LGGIPIAI	LGGI-PIAI
KDLIHDVSF	KDLIHDVSF
KINELELRL	KINELELRL
SINDKIIEL	SINDKIIEL
AASPSELHL	AASPSELHL
YSHPGVVFL	YSHPGVVFL
NVTWVIVNL	NVTWVIVNL
KDVVIHRF	KDVV-IHRF
AVSNHVFQL	AVSNHVFQL
ADSQRFRQF	ADSQRFRQF
IDHPHTHVV	IDHPHTHVV
VLMDHILNL	VLMDHILNL
AVIEAEHTL	AVIEAEHTL
TEELNREVATN	EELNREVAT
FAGMPITL	FAGM-PITL
VVAPHTLKL	VVAPHTLKL
SIVGERGRLD	IVGERGRLD
FLPYHVLLL	FLPYHVLLL
SLPHNIIEL	SLPHNIIEL
SIPGGYNAL	SIPGGYNAL
YSAPVIHVL	YSAPVIHVL
SRSHAIFTI	SRSHAIFTI
AVGPDLYL	AVGP-DLYL
RSNPKIWNV	RSNPKIWNV
SFEDAKEAL	SFEDAKEAL
KDNERVVGF	KDNERVVGF
SSSPVSVVL	SSSPVSVVL
FASEYPLIL	FASEYPLIL
AGHDQVVVL	AGHDQVVVL
VVMNVVHQL	VVMNVVHQL
YVHPFIFAL	YVHPFIFAL
RRQEAIYEM	RRQEAIYEM
RDEIRPLSF	RDEIRPLSF
AVSPYSIVL	AVSPYSIVL
IIRAVGAYSK	IRAVGAYSK
KVPVHVIRM	KVPVHVIRM
HRTDLNPIL	HRTDLNPIL
FNDPNAKEM	FNDPNAKEM
HVQPRTIYL	HVQPRTIYL
TELERKLTF	TELERKLTF
ADQLRFSYL	ADQLRFSYL
AELEDLRQRL	AELEDRQRL
RVTDAAFNF	RVTDAAFNF
ATGNYIIIM	ATGNYIIIM
AANTSTVEL	AANTSTVEL
LVHTEVVEL	LVHTEVVEL
YGSPNALVL	YGSPNALVL
GDLSHIHRL	GDLSHIHRL
REALVKKF	REAL-VKKF
VSTWLAIIL	VSTWLAIIL
FNEKSKEL	FNEK-SKEL
RNVSTGDVNV	NVSTGDVNV
FNHPEIVQL	FNHPEIVQL
FVVDHVIKI	FVVDHVIKI
LASPVSPEL	LASPVSPEL
HVHPNYFSL	HVHPNYFSL
KYKDNPFSL	KYKDNPFSL
LAPTDVKEL	LAPTDVKEL
GAHSFVLTL	GAHSFVLTL
TLPWHSLIL	TLPWHSLIL
RVQSHILHL	RVQSHILHL
SLMSHAIEL	SLMSHAIEL
QRSRFIVVV	QRSRFIVVV
VVADHGLTL	VVADHGLTL
EDLIHEIAF	EDLIHEIAF
NAHGKIIIL	NAHGKIIIL
ADFETVRM	ADFE-TVRM
ADIVATGF	ADIV-ATGF
FVHDLVLYL	FVHDLVLYL
AKNKLNDLED	KNKLNDLED
SLTPVTLVL	SLTPVTLVL
TEELAYLK	TEEL-AYLK
SAPASQASL	SAPASQASL
YAHPLETLIL	YAHPLTLIL
VRNPFTVTV	VRNPFTVTV
SLSTVFVVL	SLSTVFVVL
NAPLVHATL	NAPLVHATL
KEQMRIQSL	KEQMRIQSL
REEKRVLGL	REEKRVLGL
RDLLTRRL	RDLL-TRRL
YMIAHITGL	YMIAHITGL
KNTDLWIVM	KNTDLWIVM
ATMGHWILL	ATMGHWILL
VGGVPVTL	VGGV-PVTL
YSKYYKTID	YSKYYKTID
RDTYVSSF	RDTY-VSSF
TTYKLVINGK	TTYKLVING
LGGIVVVL	LGGI-VVVL
SVPDTAFSL	SVPDTAFSL
YSSPFDPVL	YSSPFDPVL
VASEYPVIL	VASEYPVIL
ARANPFNTPH	RANPFNTPH
IDLLRVIHV	IDLLRVIHV
RDWYKRNF	RDWY-KRNF
MSSSVVVRL	MSSSVVVRL
NAPWAVTSL	NAPWAVTSL
TTYKLVINGKT	TTYKLVING
ALHHAVIFL	ALHHAVIFL
GGLPERSVSL	GLPERSVSL
VNLPINGNGKQ	NLPINGNGK
KVSPNELIL	KVSPNELIL
HDHPHALEF	HDHPHALEF
YAHILAVLL	YAHILAVLL
AAAPHLLLL	AAAPHLLLL
YAPSGNYV	YAPS-GNYV
RRIQFPIEM	RRIQFPIEM
KELERVTSL	KELERVTSL
VAMDSIIHM	VAMDSIIHM
YQGIAVVM	YQGI-AVVM
ASATVHIRM	ASATVHIRM
FVAETHIVL	FVAETHIVL
HAAVRSVLL	HAAVRSVLL
IRMEHVKIV	IRMEHVKIV
ATPDHVLFM	ATPDHVLFM
AAPEGKRSL	AAPEGKRSL
SVHEKIFTL	SVHEKIFTL
FVHTGVYNL	FVHTGVYNL
KAPEPLSSL	KAPEPLSSL
TDFISHLF	TDFI-SHLF
GRNALEIVM	GRNALEIVM
MANGAVIHL	MANGAVIHL
YSDDIPHAL	YSDDIPHAL
HSVAHTVVL	HSVAHTVVL
VGGEALELR	VGGEALELR
FYNERVVIM	FYNERVVIM
RDAFRTLGL	RDAFRTLGL
TSAAHQVVL	TSAAHQVVL
TGNPTVIKM	TGNPTVIKM
KSTPVTVVL	KSTPVTVVL
ASGQAFEL	ASGQ-AFEL
REHPVPLL	REHP-VPLL
TRHPENWTL	TRHPENWTL
ESVGKGAVHDV	SVGKGAVHD
AAGSHVIIL	AAGSHVIIL
SRGDVKVIM	SRGDVKVIM
KANHAELIL	KANHAELIL
NSTPAVFTM	NSTPAVFTM
IAPTGHSL	IAPT-GHSL
SAPKGSVL	SAPK-GSVL
TRGPVVRL	TRGP-VVRL
FRVDYILSV	FRVDYILSV
SSPQPGSAL	SSPQPGSAL
SYAGSIPLLI	YAGS-IPLL
FVGQNVLIL	FVGQNVLIL
AVGAVPVVL	AVGAVPVVL
IDNNIEQISSY	IDNN-IEQI
YAPKGSSL	YAPK-GSSL
YRHPDPREL	YRHPDPREL
LSGTVVEL	LSGT-VVEL
YSTPHAFTF	YSTPHAFTF
LASDFEIGHFF	SDFEIGHFF
FIGYPITL	FIGY-PITL
FSGPAITL	FSGP-AITL
SDLERVTSL	SDLERVTSL
RRGDFIHVM	RRGDFIHVM
SDTLKTYF	SDTL-KTYF
NVKVDPEIQ	NVKVDPEIQ
AEQRGELAIKD	QRGELAIKD
RLPAWQPIL	RLPAWQPIL
SRPALPFIL	SRPALPFIL
VRNNVIIVM	VRNNVIIVM
YDSVKVYF	YDSV-KVYF
RELVAHHL	RELV-AHHL
QAIENAHVL	QAIENAHVL
FVHPDPLWI	FVHPDPLWI
FYQEHPDL	FYQE-HPDL
RIMEFTTTL	RIMEFTTTL
RVMEHFIKL	RVMEHFIKL
RPPGFSPFR	RPPGFSPFR
AGMPTAYDL	AGMPTAYDL
TVGVDFAL	TVGV-DFAL
YGYEHILTL	YGYEHILTL
HVIHHTTVV	HVIHHTTVV
SVPLAATSM	SVPLAATSM
AAAHFYFEL	AAAHFYFEL
RVYIHPFHL	RVYIHPFHL
AVIESVTFL	AVIESVTFL
IRNDYYLNL	IRNDYYLNL
KRQEAIFEL	KRQEAIFEL
VAAAHSVVL	VAAAHSVVL
RIPSFVTEL	RIPSFVTEL
VIPGHLIFL	VIPGHLIFL
TNAENEFVTIK	AENEFVTIK
HLMPHLLTL	HLMPHLLTL
FSPVGSVL	FSPV-GSVL
SSHNSSFEL	SSHNSSFEL
SAHQDALIL	SAHQDALIL
TASPVAVSL	TASPVAVSL
KDSMIRKF	KDSM-IRKF
ASVPAALAS	ASVPAALAS
SDLRHLRAV	SDLRHLRAV
ARPKSAFKV	ARPKSAFKV
AGHPHIITL	AGHPHIITL
TSSAHYIIL	TSSAHYIIL
ATSNVAISV	ATSNVAISV
TAPTGHTL	TAPT-GHTL
YLPQHTIET	YLPQHTIET
TVTEKPEVIDA	TVTEKPEVI
YENEVALR	YENE-VALR
TAPQGNVDL	TAPQGNVDL
SIPDFPMHL	SIPDFPMHL
YIPNKVLIL	YIPNKVLIL
RAMDQKIIL	RAMDQKIIL
PDLPRNAQV	PDLPRNAQV
FVHQGETEL	FVHQGETEL
SVVQHLIHL	SVVQHLIHL
KDIEHALSV	KDIEHALSV
SGHTVVLTM	SGHTVVLTM
YVGPSLRM	YVGP-SLRM
QDVKKIEKF	QDVKKIEKF
TISSNVASK	TISSNVASK
VAPVASAL	VAPV-ASAL
FIGSHVIEL	FIGSHVIEL
KSNGTIIHV	KSNGTIIHV
HSGPIHVL	HSGP-IHVL
TKAVDAETAE	KAVDAETAE
WLPNHVVFL	WLPNHVVFL
ISNPNSIIL	ISNPNSIIL
SRMVHAIKM	SRMVHAIKM
TSGVALTL	TSGV-ALTL
AEYIRTEML	AEYIRTEML
SATFAEIFL	SATFAEIFL
RDWFSSQL	RDWF-SSQL
AAMSHLLEM	AAMSHLLEM
ASHDSTLSL	ASHDSTLSL
LAETEGRY	LAET-EGRY
SVPEAQSAL	SVPEAQSAL
KEALPKAAF	KEALPKAAF
LRSDSYVEL	LRSDSYVEL
REYYVNQF	REYY-VNQF
FAPYHLVLL	FAPYHLVLL
NATPDSHIM	NATPDSHIM
AIQEHPVVL	AIQEHPVVL
SELKHWATF	SELKHWATF
RDVQKVVGF	RDVQKVVGF
SSHELFITL	SSHELFITL
YSNKEIFL	YSNK-EIFL
SSNPVYMEM	SSNPVYMEM
YSGVLITL	YSGV-LITL
RAFDHVLHL	RAFDHVLHL
FLSHIPITL	FLSHIPITL
AAVGHVLVV	AAVGHVLVV
FVPLHHFYL	FVPLHHFYL
FAIHKKIVL	FAIHKKIVL
TSGIVLVL	TSGI-VLVL
KEMLPHVGV	KEMLPHVGV
VELPHINLL	VELPHINLL
FVGLDIEM	FVGL-DIEM
SAISEGTVL	SAISEGTVL
ITGVVITL	ITGV-VITL
SSNVVQLIM	SSNVVQLIM
FVHPKPVSL	FVHPKPVSL
REDVGKVKF	REDVGKVKF
GDYLRVWRV	GDYLRVWRV
FATTSPLVL	FATTSPLVL
MAPLKMLAL	MAPLKMLAL
AEMYVAKF	AEMY-VAKF
VRPEQPFIVL	VRPEQFIVL
RDSLVERL	RDSL-VERL
YTNPSGIVL	YTNPSGIVL
RDHAVVVGV	RDHAVVVGV
IAPTGIESL	IAPTGIESL
FAIPGSIFL	FAIPGSIFL
KDSYVVAF	KDSY-VVAF
SDSTHLVTL	SDSTHLVTL
FLPDHPIVL	FLPDHPIVL
NLPPHIIRL	NLPPHIIRL
SALPFITYL	SALPFITYL
KINEAFIEM	KINEAFIEM
RDHIHVHF	RDHI-HVHF
VIGPPVVL	VIGP-PVVL
REAPERPSL	REAPERPSL
REMLIRVNM	REMLIRVNM
RDFAARLV	RDFA-ARLV
RDFTVSAM	RDFT-VSAM
AINELLVEL	AINELLVEL
TDGKVFQF	TDGK-VFQF
IVGVVVVV	IVGV-VVVV
AGQEAIFIL	AGQEAIFIL
MRNKNIVHM	MRNKNIVHM
FLVEHVLTL	FLVEHVLTL
NVADLVVIL	NVADLVVIL
SEYARPHVM	SEYARPHVM
FKPETYWVL	FKPETYWVL
YVINVTTHL	YVINVTTHL
FQNPSTVTL	FQNPSTVTL
NAYTGIVLL	NAYTGIVLL
RESPRPLQL	RESPRPLQL
YRQKQVVIL	YRQKQVVIL
VNNPHFLIM	VNNPHFLIM
FVEPFVILL	FVEPFVILL
YRNAYTMVL	YRNAYTMVL
YYKPGLLMM	YYKPGLLMM
AATSVHVVA	AATSVHVVA
ADHIRSIHV	ADHIRSIHV
YVAPKAVWL	YVAPKAVWL
NVSNVNLTL	NVSNVNLTL
FRNIPGITL	FRNIPGITL
HVNQYDIVL	HVNQYDIVL
YRTDMIQAL	YRTDMIQAL
NGHEFVFLL	NGHEFVFLL
LFHPSNVEM	LFHPSNVEM
FQMPTPIQM	FQMPTPIQM
IVMEHVVFL	IVMEHVVFL
YYSPHGHIL	YYSPHGHIL
ITVGHETVM	ITVGHETVM
ADFLVYEF	ADFL-VYEF
AGFAGDDAPR	FAGD-DAPR
VRNPRITSL	VRNPRITSL
RAPDAVYTEL	RAPDAYTEL
AQYEDIAQK	AQYEDIAQK
GGPGGVGGL	GGPGGVGGL
AAPSAAREL	AAPSAAREL
FYAELYHII	FYAELYHII
YLPDGTASL	YLPDGTASL
KANPALYVL	KANPALYVL
FRVPTANVS	FRVPTANVS
TYDDATKTFT	TYDDATKTF
ADMAHISGL	ADMAHISGL
YAIESQLQL	YAIESQLQL
AKDIGFIKLD	KDIG-FIKL
YGIEHALAL	YGIEHALAL
RSDPGHYSF	RSDPGHYSF
YVGVVHRL	YVGV-VHRL
YAPGARLAL	YAPGARLAL
VDHEKIYRM	VDHEKIYRM
RDFVARNV	RDFV-ARNV
IEKGHGIRL	IEKGHGIRL
SASALAVAL	SASALAVAL
FTVPHTHVF	FTVPHTHVF
LRHPNIVSL	LRHPNIVSL
KEQERIFQL	KEQERIFQL
ITPTGTHPL	ITPTGTHPL
RDLERGVEI	RDLERGVEI
VSPYTEIHL	VSPYTEIHL
SRMLHFLTA	SRMLHFLTA
AVMEEKTIL	AVMEEKTIL
GDYIRTGFI	GDYIRTGFI
HMHPAGIIL	HMHPAGIIL
YDNPHEAL	YDNP-HEAL
KAPGSTSNL	KAPGSTSNL
ADVLKVEVF	ADVLKVEVF
TSGPPLTM	TSGP-PLTM
YGPPGTGKTL	YGPPGGKTL
GILSPSIVL	GILSPSIVL
HRNGGLITL	HRNGGLITL
AAGPGFSL	AAGP-GFSL
KGSGVVIIM	KGSGVVIIM
HAAEYGAEALE	AAEYGAEAL
VIQEAFIEL	VIQEAFIEL
SLVGLGGTK	SLVGLGGTK
TNSPTVIVM	TNSPTVIVM
LKPPHVILV	LKPPHVILV
YQSKYEEL	YQSK-YEEL
AAHTQATLL	AAHTQATLL
EEQLQQIRAE	EEQLQQIRA
KINMLVIEL	KINMLVIEL
AAGRPLEL	AAGR-PLEL
RDALVHARL	RDALVHARL
HSHPRVVEL	HSHPRVVEL
SNTYVMVVM	SNTYVMVVM
RASQFTIVL	RASQFTIVL
YTGGSLIPLL	TGGSLIPLL
KRGDVIYIL	KRGDVIYIL
AEMVRHAL	AEMV-RHAL
RVVSHEVVL	RVVSHEVVL
VYNENLVHM	VYNENLVHM
AELQRVQKV	AELQRVQKV
REHERLLKHKL	REHERLLKH
RANTFVAEL	RANTFVAEL
FAYDGKDYLTL	YDGKDYLTL
FASHVSPEV	FASHVSPEV
MLAKHVITL	MLAKHVITL
FVNPVQVVL	FVNPVQVVL
LRPPYQISM	LRPPYQISM
REIIINAV	REII-INAV
VVPDHPVLL	VVPDHPVLL
SATRVYIVL	SATRVYIVL
RSQEYKIVL	RSQEYKIVL
QDVARVLGF	QDVARVLGF
AVGKHFEL	AVGK-HFEL
YQGVLVEL	YQGV-LVEL
AVVAHAYYL	AVVAHAYYL
NRQDPFTVHM	RQDPFTVHM
LDSVHQLL	LDSV-HQLL
ISPTGHSL	ISPT-GHSL
QDLERVRNL	QDLERVRNL
SAPYGRITL	SAPYGRITL
ALTPVVVTL	ALTPVVVTL
FLPDLQITM	FLPDLQITM
YVVPYTIHL	YVVPYTIHL
TSHPYRLIL	TSHPYRLIL
SGAPHAILL	SGAPHAILL
TYKLILNGK	TYKLILNGK
SIPEFFHIM	SIPEFFHIM
YAAPHFFHL	YAAPHFFHL
AEAQRFARM	AEAQRFARM
IRPGTAFEL	IRPGTAFEL
AALDKATVL	AALDKATVL
AAMKNVTEL	AAMKNVTEL
YRPLYPFSL	YRPLYPFSL
RSSPLTVTM	RSSPLTVTM
TDFIKIEEF	TDFIKIEEF
FRQIIAVVL	FRQIIAVVL
LVGPQIYL	LVGP-QIYL
HRPSHFLNF	HRPSHFLNF
YYTDFLITL	YYTDFLITL
SDLMRMEKI	SDLMRMEKI
RESERQLRL	RESERQLRL
HLPETKFSEL	HLPETFSEL
