Data	Data aligned
YLRSVFAL	YLRSV-FAL
RPSVRSVL	RPSVR-SVL
EIKRINKEL	EIKRINKEL
DLRTTSTL	DLRTT-STL
RPKDKQAL	RPKDK-QAL
NSKLRQENM	NSKLRQENM
NLKTHLRL	NLKTH-LRL
IPQLRVSSV	IPQLRVSSV
RPKTSTTL	RPKTS-TTL
HKKRKYEL	HKKRK-YEL
SGFKRHVI	SGFKR-HVI
EIKEKLLQL	EIKEKLLQL
YPLLKDPSL	YPLLKDPSL
ALKNRQEL	ALKNR-QEL
DLHKKPFL	DLHKK-PFL
EGKPKRTL	EGKPK-RTL
EIKFKVETL	EIKFKVETL
IPMIIHQL	IPMII-HQL
RPNSHRTL	RPNSH-RTL
NLIKKTVL	NLIKK-TVL
ELYQRIYAF	ELYQRIYAF
APAQRAQSL	APAQRAQSL
KVKKKDSL	KVKKK-DSL
ELKTRALQL	ELKTRALQL
DLKVKLTEV	DLKVKLTEV
NLFTRPEVL	NLFTRPEVL
YLQEKRNTL	YLQEKRNTL
LRKLKASL	LRKLK-ASL
KINKKRIAL	KINKKRIAL
RRKERQEAL	RRKERQEAL
QLYQRSGDM	QLYQRSGDM
FPLIKEII	FPLIK-EII
ELKQRFSVF	ELKQRFSVF
LPHVVPTL	LPHVV-PTL
QPRKKESLL	QPRKKESLL
YILPKNVL	YILPK-NVL
NLLKRFLVL	NLLKRFLVL
VLKRQVQSL	VLKRQVQSL
DLKQKVENL	DLKQKVENL
QNKNRVAIL	QNKNRVAIL
SPYLRPLTL	SPYLRPLTL
EIRKVVQSL	EIRKVVQSL
EGKRKVESL	EGKRKVESL
DLKAQLREL	DLKAQLREL
ELKFKTGL	ELKFK-TGL
SPNKHNRL	SPNKH-NRL
LPTLKPIL	LPTLK-PIL
DIWKKFEL	DIWKK-FEL
ENKLRVPL	ENKLR-VPL
RPTCKAVL	RPTCK-AVL
VNHRKELAL	VNHRKELAL
APYERRAM	APYER-RAM
DLYRKVML	DLYRK-VML
DLYTRFDTL	DLYTRFDTL
FGLARAFSL	FGLARAFSL
HFLQKLYSL	HFLQKLYSL
KIKRHTPL	KIKRH-TPL
QLAQRPVSL	QLAQRPVSL
EARVKAEL	EARVK-AEL
FPHLRVLEA	FPHLRVLEA
SLFTKELEHAL	FTKELEHAL
SPQEKEAL	SPQEK-EAL
FLRLITTL	FLRLI-TTL
QNKKRVLL	QNKKR-VLL
EIKNRIKNV	EIKNRIKNV
IPLSKIKTL	IPLSKIKTL
HQRHKTVAL	HQRHKTVAL
TLRSTVAL	TLRST-VAL
TLKCKEHDL	TLKCKEHDL
DAKSKIRAL	DAKSKIRAL
YAFLREAL	YAFLR-EAL
TLNIKPVSL	TLNIKPVSL
ELLGRTGTL	ELLGRTGTL
SAACRLQL	SAACR-LQL
ELKKRQELL	ELKKRQELL
LPRIQSTAL	LPRIQSTAL
TPILKPVSL	TPILKPVSL
QLKRKQPEL	QLKRKQPEL
DILSRIHTI	DILSRIHTI
ELRPLPVSV	ELRPLPVSV
EPLVRQVL	EPLVR-QVL
QLNARTSVL	QLNARTSVL
LPLHKVKSL	LPLHKVKSL
EAVTRGCAL	EAVTRGCAL
TPKEKAEAL	TPKEKAEAL
QANIRLTSL	QANIRLTSL
VLKGKKLSL	VLKGKKLSL
SIHKKAVSI	SIHKKAVSI
NLKLKLHTF	NLKLKLHTF
FLLEKGYEV	FLLEKGYEV
IFKSRLVEL	IFKSRLVEL
FGGQRLTL	FGGQR-LTL
NAKLRVDQL	NAKLRVDQL
WLHLIPQTL	WLHLIPQTL
DMKTKYFFF	DMKTKYFFF
LSSLRSVSL	LSSLRSVSL
EAKRKAEL	EAKRK-AEL
FILKKLDSI	FILKKLDSI
QPITRSTL	QPITR-STL
EKKGKFTL	EKKGK-FTL
LPKPKAKTL	LPKPKAKTL
SAAQRQQL	SAAQR-QQL
DILRRVLVL	DILRRVLVL
DLRTKATIEL	DLRTKTIEL
FLKQKGIQSL	FLKQKIQSL
TAFKRNLSL	TAFKRNLSL
VPLLKTLDHVL	LLKTLDHVL
LAKERESAL	LAKERESAL
RLKAYASPAKL	KAYASPAKL
ELRVKELEV	ELRVKELEV
FTKVKPLL	FTKVK-PLL
SAKTRQGAL	SAKTRQGAL
NFIEKVEAL	NFIEKVEAL
HGRVRLLL	HGRVR-LLL
MPNTRPPII	MPNTRPPII
DLFRKALEL	DLFRKALEL
ERIMKAQAL	ERIMKAQAL
EILLRKLPF	EILLRKLPF
DLIGKLTSL	DLIGKLTSL
FIFLRLNVL	FIFLRLNVL
DLLEKSFSL	DLLEKSFSL
EGKSRHVDF	EGKSRHVDF
SPLTKSISL	SPLTKSISL
LAIYKQVL	LAIYK-QVL
DLLGRFVL	DLLGR-FVL
EALSKLKAL	EALSKLKAL
YLLEKSRAI	YLLEKSRAI
EVLQRIESL	EVLQRIESL
EALVRTVAL	EALVRTVAL
EFKTKYKI	EFKTK-YKI
NPLLRVINL	NPLLRVINL
LLHKRVVL	LLHKR-VVL
RLKIRGSL	RLKIR-GSL
EAFVRAFL	EAFVR-AFL
DVKGKRVVM	DVKGKRVVM
QLRTQPEAL	QLRTQPEAL
SLKERFAFL	SLKERFAFL
VPHSKRLL	VPHSK-RLL
DAKIRIFDL	DAKIRIFDL
LPALRYSL	LPALR-YSL
FLFGFSAVSI	FGFSA-VSI
APLLRWVL	APLLR-WVL
TPKPKRAAV	TPKPKRAAV
VPKTHLEL	VPKTH-LEL
VLLPKKTSA	VLLPKKTSA
IPLAKRVAL	IPLAKRVAL
YARLHPRAV	YARLHPRAV
ELKKRAQEL	ELKKRAQEL
TFLQRLISL	TFLQRLISL
LLLDKKYAL	LLLDKKYAL
ILMKRNHL	ILMKR-NHL
YARFKPVAV	YARFKPVAV
IPNEIIHAL	IPNEIIHAL
EAVKRFSL	EAVKR-FSL
DIKAKAQL	DIKAK-AQL
TPLKKVIL	TPLKK-VIL
EGKLRLVEI	EGKLRLVEI
SALKRSEL	SALKR-SEL
FLRTREPAL	FLRTREPAL
FAYLRDLL	FAYLR-DLL
DFLLKPEL	DFLLK-PEL
VIKSRYQTL	VIKSRYQTL
TAMKKIGL	TAMKK-IGL
SGNLRISSL	SGNLRISSL
LAVLKHVL	LAVLK-HVL
DVKKRAVAL	DVKKRAVAL
ISKERERAI	ISKERERAI
ELKKKSHF	ELKKK-SHF
FAKVHILYV	FAKVHILYV
DMKYKNRV	DMKYK-NRV
HLVQKPFSL	HLVQKPFSL
ALLERGYSL	ALLERGYSL
FQIEHHLF	FQIEH-HLF
IASQRLTPL	IASQRLTPL
QNMIKGVTL	QNMIKGVTL
YLLEKFVAV	YLLEKFVAV
EIILKRETL	EIILKRETL
AGKTKYTL	AGKTK-YTL
DIKKILDSV	DIKKILDSV
HLVIRKQL	HLVIR-KQL
HTKPRPAL	HTKPR-PAL
IGKMRYVSV	IGKMRYVSV
NSKQRAECL	NSKQRAECL
RVKEKEAEL	RVKEKEAEL
EGLKRQLL	EGLKR-QLL
ERPIRIVAL	ERPIRIVAL
SGKTRPTTL	SGKTRPTTL
VQRLKVAL	VQRLK-VAL
WPLLKQVL	WPLLK-QVL
MFPLVKSAL	MFPLVKSAL
LLREKVEFL	LLREKVEFL
SAGLRVLAL	SAGLRVLAL
LPLTHFEL	LPLTH-FEL
TPISRLVAL	TPISRLVAL
YLLEKSRVI	YLLEKSRVI
QAAQRAHTL	QAAQRAHTL
NLKSRNVEI	NLKSRNVEI
YALNHTLSV	YALNHTLSV
TVKARPSV	TVKAR-PSV
SVKIKTKL	SVKIK-TKL
QPSLKRSL	QPSLK-RSL
ASYLRLWAL	ASYLRLWAL
VVKPRVNSL	VVKPRVNSL
SPKVRKVL	SPKVR-KVL
FLKEIVETF	FLKEIVETF
DMRQTVAV	DMRQT-VAV
DINVRWLAV	DINVRWLAV
MPAVKAIIY	MPAVKAIIY
SLRIKSQEL	SLRIKSQEL
ELRERIEKL	ELRERIEKL
DIIKKPIAL	DIIKKPIAL
LQRSKQAL	LQRSK-QAL
FNFLRNVSL	FNFLRNVSL
FLKIKPVSL	FLKIKPVSL
YGKAKSIV	YGKAK-SIV
LVNIRKDSL	LVNIRKDSL
RNRLKYAL	RNRLK-YAL
YFAERVTSL	YFAERVTSL
VPQVKASAL	VPQVKASAL
FVRKKSSL	FVRKK-SSL
DLLVKYIF	DLLVK-YIF
YLWTKQVL	YLWTK-QVL
SPTPRIKAEL	TPRIK-AEL
FFYEKAIL	FFYEK-AIL
IPHIHKSL	IPHIH-KSL
LIKERNKL	LIKER-NKL
IPEIKTIL	IPEIK-TIL
TAKKKVLF	TAKKK-VLF
RNKLKYLAF	RNKLKYLAF
WIHVKPERL	WIHVKPERL
FLLPKVQSI	FLLPKVQSI
NERLKVAL	NERLK-VAL
NGYKRVLAL	NGYKRVLAL
EAVARGCAL	EAVARGCAL
EGKPRILSL	EGKPRILSL
SPLKKEQPL	SPLKKEQPL
LPHLRNKLVI	LPHLR-NKL
QNLVKIMSL	QNLVKIMSL
TNMNRALAL	TNMNRALAL
DIKIRQDSV	DIKIRQDSV
NLHLKFLAL	NLHLKFLAL
TIIPKVLAM	TIIPKVLAM
LINGRTNLSI	LINGR-TNL
RNKLKSQL	RNKLK-SQL
TPLSKSNTL	TPLSKSNTL
LPLEKVYSL	LPLEKVYSL
ELHEKGSKL	ELHEKGSKL
EIILRQEVL	EIILRQEVL
LLRLFKTAL	LLRLFKTAL
DVHKKYNAL	DVHKKYNAL
DIIYKKIAL	DIIYKKIAL
LPYARKEL	LPYAR-KEL
VPNLHKVIVVW	VPNLHKVIV
DAKQRLSAA	DAKQRLSAA
FLKQTEAL	FLKQT-EAL
ALKLKQSL	ALKLK-QSL
DARKKVQQV	DARKKVQQV
DPYLKPYAV	DPYLKPYAV
FSKAKPSVL	FSKAKPSVL
HIFLRTTL	HIFLR-TTL
VPYLKIFTV	VPYLKIFTV
YIYSKVQL	YIYSK-VQL
FPKWKPGSL	FPKWKPGSL
NLKEKIKEL	NLKEKIKEL
VPRAKIHSL	VPRAKIHSL
QAKLKAQAL	QAKLKAQAL
KSKDRKYTL	KSKDRKYTL
QLKLKTGKL	QLKLKTGKL
LPSIRKASL	LPSIRKASL
DPKKRLTTF	DPKKRLTTF
VGKVKFASL	VGKVKFASL
DAKRAFNAL	DAKRAFNAL
ELLSRTSL	ELLSR-TSL
TVHQKIHSL	TVHQKIHSL
LPAERVTL	LPAER-VTL
ALLQRLEAL	ALLQRLEAL
NPNLRKNVL	NPNLRKNVL
YPLLKNISM	YPLLKNISM
ESKKRQWAL	ESKKRQWAL
VPKLKVCAL	VPKLKVCAL
NLAQRNVAL	NLAQRNVAL
HAKRKTVTA	HAKRKTVTA
EGLPKPLTL	EGLPKPLTL
MLTKKSTL	MLTKK-STL
SAMVRVISV	SAMVRVISV
HLKQHYIDL	HLKQHYIDL
HLILRAEGL	HLILRAEGL
MPKVHIEF	MPKVH-IEF
YPHLKNHGL	YPHLKNHGL
ALLVKTTL	ALLVK-TTL
APKPRKVEL	APKPRKVEL
LDLQRTLSL	LDLQRTLSL
VVKLHTKL	VVKLH-TKL
QLFQRPNAL	QLFQRPNAL
YGYVRAEVL	YGYVRAEVL
LLKSKLYL	LLKSK-LYL
QPQDRNQAL	QPQDRNQAL
EQKLRVELL	EQKLRVELL
LRKEKEAAA	LRKEKEAAA
FVKLRIDLL	FVKLRIDLL
IIKDKHIL	IIKDK-HIL
FAKLRELLL	FAKLRELLL
LPYLKVKL	LPYLK-VKL
HALERLFTM	HALERLFTM
SGKLRVAL	SGKLR-VAL
SLFKRLYSL	SLFKRLYSL
IPALRDISI	IPALRDISI
DFKIKCVAF	DFKIKCVAF
DLISRDYSL	DLISRDYSL
RPKPIITSV	RPKPIITSV
SLLTKNSL	SLLTK-NSL
NSKLRTLSL	NSKLRTLSL
YLQERIMVI	YLQERIMVI
TLQRKICEL	TLQRKICEL
QLLEKVIEL	QLLEKVIEL
QLKETRQQL	QLKETRQQL
LLLERAKEL	LLLERAKEL
QLRSQVQSL	QLRSQVQSL
TLREKPQTL	TLREKPQTL
FLISRLIKL	FLISRLIKL
QPLLREVL	QPLLR-EVL
EFKTKYKL	EFKTK-YKL
QGKPRLSL	QGKPR-LSL
FLLQRVHSL	FLLQRVHSL
EPKLKYERL	EPKLKYERL
TFIQRVQSL	TFIQRVQSL
EQKKRVSMI	EQKKRVSMI
FLWQHVEL	FLWQH-VEL
HLNQRPAAL	HLNQRPAAL
DFKIKTVEL	DFKIKTVEL
DLRTKGFSL	DLRTKGFSL
ELHEKFDRL	ELHEKFDRL
FLKQRPTKL	FLKQRPTKL
DILNKALEL	DILNKALEL
APKIRAEQI	APKIRAEQI
DIHLHTEAL	DIHLHTEAL
YAFPKAVSV	YAFPKAVSV
LLQIRAEAL	LLQIRAEAL
LIREKEQL	LIREK-EQL
VIKEKLRL	VIKEK-LRL
FGLARAKSV	FGLARAKSV
DLKEHASSL	DLKEHASSL
FLYIRQLAI	FLYIRQLAI
LLNQKPLSL	LLNQKPLSL
NLYRKFWSL	NLYRKFWSL
ELKQRNGAL	ELKQRNGAL
KPREKVLVI	KPREKVLVI
QKKTKIAL	QKKTK-IAL
EIIHRYVEL	EIIHRYVEL
QVKKRQMDI	QVKKRQMDI
ESISRAYAL	ESISRAYAL
EAKRKEFL	EAKRK-EFL
YLKPYFLEA	YLKPYFLEA
NLKVKVLF	NLKVK-VLF
TPNCRVAL	TPNCR-VAL
YGFEKPSAI	YGFEKPSAI
KLRAKLQSL	KLRAKLQSL
AQRAKASL	AQRAK-ASL
FIFQKVGKL	FIFQKVGKL
DLKEKKEVV	DLKEKKEVV
SIISPKVKMAL	SPKVK-MAL
QLHKKQRL	QLHKK-QRL
EALYKWLL	EALYK-WLL
LPQRKPSL	LPQRK-PSL
EAKPRKTL	EAKPR-KTL
NIKIKNGM	NIKIK-NGM
HRKIQSSL	HRKIQ-SSL
LLILRPEEL	LLILRPEEL
LPALRSIGL	LPALRSIGL
LPKIKAIP	LPKIK-AIP
FPTVHAVILL	FPTVHAVIL
KNKQKFVL	KNKQK-FVL
FLTTRQTL	FLTTR-QTL
LLKIKDTVL	LLKIKDTVL
QINQRQESL	QINQRQESL
NSKYHGVSL	NSKYHGVSL
TEKPKFIL	TEKPK-FIL
LPFKKSLL	LPFKK-SLL
LPRVRLLPL	LPRVRLLPL
ALLDKLYAL	ALLDKLYAL
FLFPHSVL	FLFPH-SVL
TNTLRILAL	TNTLRILAL
YLRNLTWTL	YLRNLTWTL
YPRLKVLAF	YPRLKVLAF
AVILRALSL	AVILRALSL
FLRELVITI	FLRELVITI
MPSSRAYGL	MPSSRAYGL
FGLARIYSF	FGLARIYSF
NIHKRIHGV	NIHKRIHGV
FPHLREEIL	FPHLREEIL
LLFKKVKAL	LLFKKVKAL
MAFLKTAL	MAFLK-TAL
LPKDKLISL	LPKDKLISL
SPSPKTSL	SPSPK-TSL
FLLEKPFSV	FLLEKPFSV
EVLNKHSL	EVLNK-HSL
DIKSKIRAL	DIKSKIRAL
SPKKSTVL	SPKKS-TVL
SARAKAQAL	SARAKAQAL
QEGQRYQAL	QEGQRYQAL
QLFVRAQEL	QLFVRAQEL
YPLWKVTF	YPLWK-VTF
VPNQKRLTL	VPNQKRLTL
EAFLKHIL	EAFLK-HIL
TLLERAFSL	TLLERAFSL
SQKRHWTF	SQKRH-WTF
SPPKKKDLSL	PPKKKDLSL
TAKIRTLAE	TAKIRTLAE
ELRIKENEL	ELRIKENEL
LPIVKTEF	LPIVK-TEF
YVKLTPVSL	YVKLTPVSL
VPLPKQSL	VPLPK-QSL
YVLLKALAL	YVLLKALAL
SSKLKQLL	SSKLK-QLL
DVQKKLMSL	DVQKKLMSL
YFLSRAQSL	YFLSRAQSL
TIKNQINSL	TIKNQINSL
LLRIKINEL	LLRIKINEL
DLRIAHML	DLRIA-HML
DAKKRINL	DAKKR-INL
SLAVRVNSL	SLAVRVNSL
TLKDRELSF	TLKDRELSF
DAAIRVWSL	DAAIRVWSL
TLNEKLTAL	TLNEKLTAL
DVITKFEL	DVITK-FEL
FIYNRVVL	FIYNR-VVL
DLWTKIIL	DLWTK-IIL
LPSQKTASL	LPSQKTASL
LPATRGYAL	LPATRGYAL
APKPRLNQL	APKPRLNQL
RPKYQFLSL	RPKYQFLSL
EIRDKKTGL	EIRDKKTGL
ENKLREISL	ENKLREISL
TLKEYLESL	TLKEYLESL
DLRGHVEL	DLRGH-VEL
TIPPMEKAVV	PPMEK-AVV
SSKTKPVL	SSKTK-PVL
VGLLRLHSL	VGLLRLHSL
HIKDSFHSL	HIKDSFHSL
TALLIMRTV	TALLIMRTV
FLHIKETVL	FLHIKETVL
NPRVKAAAL	NPRVKAAAL
MPALRSINL	MPALRSINL
NSRIKLGL	NSRIK-LGL
ELKLKEIQL	ELKLKEIQL
ALKENQVSL	ALKENQVSL
FVQPRLESL	FVQPRLESL
AAKIRVSV	AAKIR-VSV
IVKPKPRAL	IVKPKPRAL
IAKKRQIFL	IAKKRQIFL
APKPKWTQL	APKPKWTQL
ELQLRLLAL	ELQLRLLAL
ELRAKALEL	ELRAKALEL
FPPLHYEL	FPPLH-YEL
SGKVKSSL	SGKVK-SSL
ELRLKYYGL	ELRLKYYGL
SPVVRVAV	SPVVR-VAV
SVKKKVKL	SVKKK-VKL
QKRLKTVL	QKRLK-TVL
HVKVLNTSL	HVKVLNTSL
SVFQRYLAL	SVFQRYLAL
DIHHKVLSL	DIHHKVLSL
QRKSKLQSL	QRKSKLQSL
YFIVKEIL	YFIVK-EIL
VPYEKGFAL	VPYEKGFAL
TLASKTISI	TLASKTISI
FPWEKPTTL	FPWEKPTTL
EQKARETL	EQKAR-ETL
VPLLKSLEV	VPLLKSLEV
DMKIKVTDL	DMKIKVTDL
DSKIRSKAL	DSKIRSKAL
NIWIRVASL	NIWIRVASL
HLLIKRSL	HLLIK-RSL
YSHKKILQL	YSHKKILQL
DAKTKAQL	DAKTK-AQL
DGKKKISTV	DGKKKISTV
QARLKVLRA	QARLKVLRA
DLMSKKIHL	DLMSKKIHL
DLGTHKSL	DLGTH-KSL
YIHVHFLEV	YIHVHFLEV
ALQQKQVSL	ALQQKQVSL
TIRAKQIL	TIRAK-QIL
LLNSKEAAL	LLNSKEAAL
DIILKTVL	DIILK-TVL
DGYLKTSAL	DGYLKTSAL
EATLRCWAL	EATLRCWAL
FTIFRTISV	FTIFRTISV
ELRKISQAL	ELRKISQAL
HSRAYQQAL	HSRAYQQAL
MAKMRLLTF	MAKMRLLTF
QPKAKAKEL	QPKAKAKEL
FAKFVVDL	FAKFV-VDL
WVKEKVVAL	WVKEKVVAL
DMALKSLSL	DMALKSLSL
ILKEKWSAL	ILKEKWSAL
TPFIRPVM	TPFIR-PVM
ETKQRTVL	ETKQR-TVL
AAAYRNAL	AAAYR-NAL
DAFVRLIAL	DAFVRLIAL
NQHVKSAL	NQHVK-SAL
TVKVHVVAL	TVKVHVVAL
FIKRVYVSL	FIKRVYVSL
AVKRKIQAL	AVKRKIQAL
KPKPKSAF	KPKPK-SAF
ELLKKLVGL	ELLKKLVGL
AVHQRIASL	AVHQRIASL
EAFLKKHNL	EAFLKKHNL
SPKIRSHAV	SPKIRSHAV
SPALKACL	SPALK-ACL
FPHLTVVL	FPHLT-VVL
FIHQHFVEV	FIHQHFVEV
EIKVKLIEA	EIKVKLIEA
SNKLHFAF	SNKLH-FAF
NIKEKLFSL	NIKEKLFSL
HLNGKNSSL	HLNGKNSSL
NGQTREHAL	NGQTREHAL
DVKKKVHL	DVKKK-VHL
ELNPKILAL	ELNPKILAL
YLPTRVTAI	YLPTRVTAI
LREKVEFL	LREKV-EFL
EALARNLL	EALAR-NLL
APYRLPAVL	APYRLPAVL
YIDQKFVL	YIDQK-FVL
NQREHTAL	NQREH-TAL
RLKPKVLL	RLKPK-VLL
LRKPRPVSL	LRKPRPVSL
DLLQRLDAL	DLLQRLDAL
IVAKRLESL	IVAKRLESL
QLLLKALTL	QLLLKALTL
NLKDKSSL	NLKDK-SSL
EARPRPLSL	EARPRPLSL
LPFLRITSL	LPFLRITSL
DALQRSVQL	DALQRSVQL
HLFPKLEL	HLFPK-LEL
LGHVRYVL	LGHVR-YVL
DAKGRIVL	DAKGR-IVL
YLKKKEERL	YLKKKEERL
YAIIKEEL	YAIIK-EEL
QLYRKYLEL	QLYRKYLEL
ALKKALAA	ALKKA-LAA
DPPLKFMSV	DPPLKFMSV
LPHNRLVSL	LPHNRLVSL
VLKSKTYL	VLKSK-TYL
LAKLKYQF	LAKLK-YQF
VPSPKVVL	VPSPK-VVL
FAKIYADTF	FAKIYADTF
ILRPKIGL	ILRPK-IGL
LLIERGASL	LLIERGASL
VAKNKICTL	VAKNKICTL
DNMPRILSL	DNMPRILSL
AILLKKISL	AILLKKISL
VAAKKNVSI	VAAKKNVSI
SIQRNLSL	SIQRN-LSL
APKLKEVKL	APKLKEVKL
NNKPRTVL	NNKPR-TVL
KIKEKVVTL	KIKEKVVTL
EALIRTVF	EALIR-TVF
LPLLRVLSI	LPLLRVLSI
EAAKRFIL	EAAKR-FIL
LGASRTLSL	LGASRTLSL
IPANRIVL	IPANR-IVL
NPQERTLTL	NPQERTLTL
VPQAKPVAV	VPQAKPVAV
ELQEKFLSL	ELQEKFLSL
IFRKKAVEL	IFRKKAVEL
FALGKILSV	FALGKILSV
DAGIRAMAL	DAGIRAMAL
DMLVKVNAL	DMLVKVNAL
AGKKKGFSL	AGKKKGFSL
EVKSRQTL	EVKSR-QTL
FINEKKYHL	FINEKKYHL
FPLPHRVL	FPLPH-RVL
HASQRISQL	HASQRISQL
SGKQRTLEL	SGKQRTLEL
QALLRISL	QALLR-ISL
QAKVRKLEL	QAKVRKLEL
IPLHVFVLL	IPLHVFVLL
EAQAKKHAL	EAQAKKHAL
RAKCKEVTL	RAKCKEVTL
YLKVKGNVF	YLKVKGNVF
HPYSRQTI	HPYSR-QTI
VSKKKTAL	VSKKK-TAL
YALPHAIL	YALPH-AIL
NPSLKQQL	NPSLK-QQL
RLKKKEYVM	RLKKKEYVM
LPKEKRHVL	LPKEKRHVL
EQRTKYRSL	EQRTKYRSL
VPFERPAVI	VPFERPAVI
RPKAKEIQL	RPKAKEIQL
EVKDRCTL	EVKDR-CTL
ALREKTSL	ALREK-TSL
LPKKLALL	LPKKL-ALL
AAKKKLQSL	AAKKKLQSL
DRNIRYVAL	DRNIRYVAL
KLKVRAESF	KLKVRAESF
TGYLKGYTL	TGYLKGYTL
VPKPFRPIL	VPKPFRPIL
NPKIKDIL	NPKIK-DIL
TAIRHHVL	TAIRH-HVL
ETRQKKLEV	ETRQKKLEV
TAITRAQSL	TAITRAQSL
HNFIKVTL	HNFIK-VTL
EILLRVLTL	EILLRVLTL
ELFPRYTSL	ELFPRYTSL
FVLQRLVFL	FVLQRLVFL
SGMQRLAQL	SGMQRLAQL
ELLKYQLEL	ELLKYQLEL
NAKNKESL	NAKNK-ESL
SAKIRVPF	SAKIR-VPF
FIFEKKLAQAL	FEKKLAQAL
INAQRNAL	INAQR-NAL
YAYLKAIVLF	YAYLKAIVL
ALKHRALSL	ALKHRALSL
TIKKRFKVL	TIKKRFKVL
KPKEKVDAL	KPKEKVDAL
AAYLRALSL	AAYLRALSL
EQKSRIQAM	EQKSRIQAM
VNHIRPRSV	VNHIRPRSV
ISKKKAVL	ISKKK-AVL
QILPKIKAI	QILPKIKAI
FPKWSVISL	FPKWSVISL
ELKQNSAFI	ELKQNSAFI
DAKGRTPL	DAKGR-TPL
DAHLRPTSL	DAHLRPTSL
AALARLLAA	AALARLLAA
ILIRKVSSL	ILIRKVSSL
LPKLYVKL	LPKLY-VKL
SNKPRPSEL	SNKPRPSEL
FFKERVMEI	FFKERVMEI
EPKSKSSL	EPKSK-SSL
MLNSRVIEI	MLNSRVIEI
ANKERSEAL	ANKERSEAL
AASLRKVSM	AASLRKVSM
SSKQREQSL	SSKQREQSL
SLSSRSLAL	SLSSRSLAL
RPHTKNVL	RPHTK-NVL
QSLERVYSL	QSLERVYSL
QLLRKIQL	QLLRK-IQL
TPLKKFLL	TPLKK-FLL
TLKGRTVIV	TLKGRTVIV
EVILRAEAV	EVILRAEAV
AQRLKFRL	AQRLK-FRL
EVKTREKL	EVKTR-EKL
NIKRKVTSV	NIKRKVTSV
NPHKRISAF	NPHKRISAF
RVKKKNEAL	RVKKKNEAL
NPHDRVVAL	NPHDRVVAL
SPGERATL	SPGER-ATL
QNKIRDTQL	QNKIRDTQL
FLLRRLVTL	FLLRRLVTL
QGYLRSVF	QGYLR-SVF
DGMERPSSL	DGMERPSSL
MPVLKVVL	MPVLK-VVL
EPLKKFGSV	EPLKKFGSV
FPKAVSVF	FPKAV-SVF
DLKQLQESL	DLKQLQESL
YLRELLTTM	YLRELLTTM
RVYIHPFHL	RVYIHPFHL
YLLQRAVEV	YLLQRAVEV
HTQMRLLPL	HTQMRLLPL
DAYIRIVL	DAYIR-IVL
NLKQKVTF	NLKQK-VTF
LQLLQRATL	LQLLQRATL
IPNVRIQAV	IPNVRIQAV
VPSKRQEAL	VPSKRQEAL
DLKIKRSKL	DLKIKRSKL
TSKLKYVL	TSKLK-YVL
FPHIKLTL	FPHIK-LTL
LIILKQVM	LIILK-QVM
APASRLLAL	APASRLLAL
RNKEKKEAL	RNKEKKEAL
DQFQKVLSL	DQFQKVLSL
ILKKKSFTF	ILKKKSFTF
TQKRKASQL	TQKRKASQL
DISKRIQSL	DISKRIQSL
IPKFAVATL	IPKFAVATL
MAAKRQQEL	MAAKRQQEL
SRKSKAEL	SRKSK-AEL
QLSLRTVSL	QLSLRTVSL
RLSERALSL	RLSERALSL
TAKFHFVDL	TAKFHFVDL
ELITKAVAA	ELITKAVAA
DIRAKKRVL	DIRAKKRVL
HLKQQVSGL	HLKQQVSGL
YLNNKKTI	YLNNK-KTI
KAKRKEAEL	KAKRKEAEL
NGKGRPASL	NGKGRPASL
KLKEKKERL	KLKEKKERL
DAAMKGLAL	DAAMKGLAL
SGHTRPSSL	SGHTRPSSL
LPIKESEII	LPIKESEII
DQRQKSMGL	DQRQKSMGL
SLRDKVLQL	SLRDKVLQL
FGLARAFGV	FGLARAFGV
ATKTKFTM	ATKTK-FTM
EAKVRYVKL	EAKVRYVKL
ENKIRSTL	ENKIR-STL
FLRLKLNNL	FLRLKLNNL
LPKGKHSV	LPKGK-HSV
RPGIHHSL	RPGIH-HSL
SLKSRVTI	SLKSR-VTI
FAKKKTLL	FAKKK-TLL
YILGKFFAL	YILGKFFAL
KVTSLGVLLL	TSLGV-LLL
NRKKLIESL	NRKKLIESL
YLKVLVDSL	YLKVLVDSL
LAALKKAL	LAALK-KAL
EAQLRQFTL	EAQLRQFTL
EAHNRVIVL	EAHNRVIVL
LALTRSSSL	LALTRSSSL
IPKSKFLAL	IPKSKFLAL
ALKLKQKSL	ALKLKQKSL
ELKEKAKI	ELKEK-AKI
LMEKFKIL	LMEKF-KIL
ETKKKFKL	ETKKK-FKL
NLLTKIIL	NLLTK-IIL
FLEEREIAL	FLEEREIAL
ESHKRKMAI	ESHKRKMAI
APYSRPKQL	APYSRPKQL
YIKRLLETL	YIKRLLETL
TGLQKVQSL	TGLQKVQSL
DLIQKHKSI	DLIQKHKSI
HPRAKVTL	HPRAK-VTL
DLLARIETL	DLLARIETL
LPRIKTEIEAL	LPRIK-TEI
WLTQKQTL	WLTQK-QTL
TPLTKDVSL	TPLTKDVSL
RPWLRPAAL	RPWLRPAAL
DIRPKISL	DIRPK-ISL
FSKVRSLTL	FSKVRSLTL
SPNQKLLAV	SPNQKLLAV
TLIHKPVSL	TLIHKPVSL
QPIIRIQSI	QPIIRIQSI
LFRDKVVAL	LFRDKVVAL
FGFERLEVL	FGFERLEVL
DLQARITSL	DLQARITSL
SMKQKQEEI	SMKQKQEEI
KPKIKVVNV	KPKIKVVNV
LPWKRIVAV	LPWKRIVAV
VLKEKGQSL	VLKEKGQSL
YLGAKPRSL	YLGAKPRSL
EALKKLIL	EALKK-LIL
AVKEKGSTL	AVKEKGSTL
EVVARPASL	EVVARPASL
TGMQRSTL	TGMQR-STL
LAALKPLAA	LAALKPLAA
FAHLRLEVL	FAHLRLEVL
ISKNKHVSL	ISKNKHVSL
EVKTKLFSL	EVKTKLFSL
LVKKRIEL	LVKKR-IEL
SLLEKLSAL	SLLEKLSAL
QAKEKQAQL	QAKEKQAQL
DFKIRTIEL	DFKIRTIEL
FIKIKMAF	FIKIK-MAF
NLKSKYFAV	NLKSKYFAV
EINKKGKAL	EINKKGKAL
RPFEKSRL	RPFEK-SRL
INKKRIAL	INKKR-IAL
DVQLRLNSI	DVQLRLNSI
HAIQKLYSL	HAIQKLYSL
HLPETKFSEL	LPETKFSEL
ASKERQTAL	ASKERQTAL
AMLERLLSL	AMLERLLSL
DLLLHSAL	DLLLH-SAL
FLFSKFIEL	FLFSKFIEL
WIKEKIYVL	WIKEKIYVL
HLKPISREL	HLKPISREL
DLLPKEKRHVL	LPKEKRHVL
TLNKKKREL	TLNKKKREL
NIKLARQL	NIKLA-RQL
VLHVKTESL	VLHVKTESL
ILKKSSHAV	ILKKSSHAV
TLKRTIEAL	TLKRTIEAL
RPKLKAFL	RPKLK-AFL
DFKIRTVEI	DFKIRTVEI
LPLVKPYL	LPLVK-PYL
EHKKRWASM	EHKKRWASM
KAKIRTPLL	KAKIRTPLL
VLNQKRLSL	VLNQKRLSL
DQKIHRPM	DQKIH-RPM
SSKCRTVL	SSKCR-TVL
ELLQKIEV	ELLQK-IEV
EVKERVTL	EVKER-VTL
NIKEKTRL	NIKEK-TRL
LPSRKLVAL	LPSRKLVAL
NAQQKKSL	NAQQK-KSL
NGATRKLAL	NGATRKLAL
DLKSSKASL	DLKSSKASL
KIKLKSSEL	KIKLKSSEL
VLKNRAQQL	VLKNRAQQL
VPFLVSVL	VPFLV-SVL
VPMFRNVSL	VPMFRNVSL
LPTSKRSL	LPTSK-RSL
EAIIRKAL	EAIIR-KAL
VPKTKVVWL	VPKTKVVWL
AASQRSSSL	AASQRSSSL
ILKKVLEAL	ILKKVLEAL
TALPRIFSL	TALPRIFSL
VIQERVHSL	VIQERVHSL
SLFFRKVAF	SLFFRKVAF
QLREKAGQL	QLREKAGQL
EIRQKNLSL	EIRQKNLSL
LPQIKIISA	LPQIKIISA
DLLKRLEAA	DLLKRLEAA
VNLTRVLAL	VNLTRVLAL
HLRKYNEAL	HLRKYNEAL
FGLPRWVTL	FGLPRWVTL
WPLIKATVGL	WPLIK-ATV
FVRKKVITI	FVRKKVITI
EAKQRLQQL	EAKQRLQQL
DAHIRLWDL	DAHIRLWDL
LPKLHIVQV	LPKLHIVQV
DIWVKSYSL	DIWVKSYSL
SGIIRNNSL	SGIIRNNSL
YGMPRQIL	YGMPR-QIL
KPMEKISL	KPMEK-ISL
QSMIRILGL	QSMIRILGL
QAITRVIPL	QAITRVIPL
ELKIKRSLF	ELKIKRSLF
ESKLHRNL	ESKLH-RNL
LPKLLVEF	LPKLL-VEF
ELRQKKKEL	ELRQKKKEL
FNWGRVVAL	FNWGRVVAL
HPLIRSLF	HPLIR-SLF
GLKVREYEL	GLKVREYEL
ELLTKALHL	ELLTKALHL
FLMRMRLT	FLMRM-RLT
IPKSKTKEQIL	KSKTKEQIL
HVITKTMEL	HVITKTMEL
FNRPRIETL	FNRPRIETL
RLKQKAESL	RLKQKAESL
SNKLKLNAL	SNKLKLNAL
TAYTRQQVL	TAYTRQQVL
MRQKAVSL	MRQKA-VSL
DLLIRAVEA	DLLIRAVEA
QTKTRHLAL	QTKTRHLAL
RLRSKQQSL	RLRSKQQSL
ELKHHHVTL	ELKHHHVTL
TSKKRKVSL	TSKKRKVSL
MGNKKVSV	MGNKK-VSV
FLFQKVGKL	FLFQKVGKL
SPAIKKQL	SPAIK-KQL
HPQTHRQL	HPQTH-RQL
DLRQRPASL	DLRQRPASL
VGLIRNLAL	VGLIRNLAL
DATIRIWSV	DATIRIWSV
SIAKRLQSI	SIAKRLQSI
DLRIKTSDV	DLRIKTSDV
FPLNKLTEL	FPLNKLTEL
ELFLRFISL	ELFLRFISL
NLKIKWENL	NLKIKWENL
TPKVTQAL	TPKVT-QAL
ELQSRLAAL	ELQSRLAAL
SANTRFAL	SANTR-FAL
LPASKQML	LPASK-QML
YINVKKGSI	YINVKKGSI
HLFQRLAAL	HLFQRLAAL
TPSERITSL	TPSERITSL
EVRKKTLQL	EVRKKTLQL
ELLKRSEKL	ELLKRSEKL
FPNLARVL	FPNLA-RVL
APNYRLKSL	APNYRLKSL
DAKKKLRL	DAKKK-LRL
IGKIRSSAF	IGKIRSSAF
DMGNRVTAL	DMGNRVTAL
LLKHKKAAL	LLKHKKAAL
DGLLRVLTV	DGLLRVLTV
DAKFRLIL	DAKFR-LIL
SPKKKIKL	SPKKK-IKL
EALQRNNL	EALQR-NNL
EGKIKYDAI	EGKIKYDAI
FVIKKHEL	FVIKK-HEL
NLKAHVVAV	NLKAHVVAV
DLKKITNSL	DLKKITNSL
YPTEKVNCL	YPTEKVNCL
SLKVKSARL	SLKVKSARL
FIISRTQAL	FIISRTQAL
YYKTKRVL	YYKTK-RVL
DLKGKHRL	DLKGK-HRL
FPHPKYVDL	FPHPKYVDL
DLKPKVYNL	DLKPKVYNL
LLKEHYVDL	LLKEHYVDL
ELNVRKVTL	ELNVRKVTL
EAKAKPRL	EAKAK-PRL
IPLVKVDM	IPLVK-VDM
FQKVKEWSL	FQKVKEWSL
QLKFARSL	QLKFA-RSL
DLLKRILKM	DLLKRILKM
ELLQKVITL	ELLQKVITL
HPYNKLWSL	HPYNKLWSL
ISPKVKMAL	ISPKVKMAL
LNKVKNSL	LNKVK-NSL
DLHEKDFSL	DLHEKDFSL
ETNLRYLAL	ETNLRYLAL
HVNIRLVEL	HVNIRLVEL
TAKEKKTQL	TAKEKKTQL
EIREKLIRL	EIREKLIRL
RNKERISV	RNKER-ISV
DLRTRVVL	DLRTR-VVL
ETHARIAL	ETHAR-IAL
GAHKRPASV	GAHKRPASV
QAWLRLTSL	QAWLRLTSL
MPTVHYEF	MPTVH-YEF
ALLIQKAL	ALLIQ-KAL
FSKIRPQL	FSKIR-PQL
KQKERFAAL	KQKERFAAL
FPSIKTEF	FPSIK-TEF
FNWIKTQL	FNWIK-TQL
YAFLHRTL	YAFLH-RTL
QLIQKFISV	QLIQKFISV
IQRKRQEAL	IQRKRQEAL
LVKTKKEL	LVKTK-KEL
EAFLKHILSV	EAFLK-HIL
TGKIRIAA	TGKIR-IAA
EIRLKIVGT	EIRLKIVGT
HLYARQLTL	HLYARQLTL
HLKALTSEL	HLKALTSEL
DAKKSPLAL	DAKKSPLAL
QPPYRTSL	QPPYR-TSL
VPPSRLMAL	VPPSRLMAL
QPHVRHLL	QPHVR-HLL
EGYIKKLL	EGYIK-KLL
ENRQKLSL	ENRQK-LSL
SSRYKTEL	SSRYK-TEL
FANLKYVSL	FANLKYVSL
TLREKSQQL	TLREKSQQL
ELWKKVETL	ELWKKVETL
DTRLKASL	DTRLK-ASL
VPLPRLLEV	VPLPRLLEV
AVKQRGISL	AVKQRGISL
EAHARIHL	EAHAR-IHL
FLKVSSVF	FLKVS-SVF
FPLVKSAL	FPLVK-SAL
QIKQRTKL	QIKQR-TKL
DISKKKAL	DISKK-KAL
NLKLKLHSF	NLKLKLHSF
RPREKKLGL	RPREKKLGL
TNKSRGFAF	TNKSRGFAF
SVKLRGSSL	SVKLRGSSL
DLQKRLLAL	DLQKRLLAL
LPHHRVIEV	LPHHRVIEV
EMLTKKSTL	EMLTKKSTL
GLNKKPMSL	GLNKKPMSL
LPAVRLSL	LPAVR-LSL
LLRKKTLV	LLRKK-TLV
HPKATRTL	HPKAT-RTL
VAMKKIRL	VAMKK-IRL
QGFFRSISL	QGFFRSISL
YPKLKTDVL	YPKLKTDVL
RPHSKVTL	RPHSK-VTL
DLRTKATI	DLRTK-ATI
DIKRKDFL	DIKRK-DFL
DLRKQVEEL	DLRKQVEEL
DLRAKAVEL	DLRAKAVEL
FLLDKKIGV	FLLDKKIGV
VLLKARLVPA	LLKARLVPA
QLKQRNTL	QLKQR-NTL
DLHLKGQAV	DLHLKGQAV
FLPLKTML	FLPLK-TML
LLLERLKAL	LLLERLKAL
RPKEKSLVL	RPKEKSLVL
EALQRLVNL	EALQRLVNL
NVKLRANAL	NVKLRANAL
FQKIQVRL	FQKIQ-VRL
TIMPKDIQL	TIMPKDIQL
NPTERVAAL	NPTERVAAL
LPYIKQEV	LPYIK-QEV
ETLKKVQAL	ETLKKVQAL
FSRLKTSL	FSRLK-TSL
TAQKRVYSL	TAQKRVYSL
TAKIRPFAV	TAKIRPFAV
SIKKLITSM	SIKKLITSM
LLLKKWSL	LLLKK-WSL
HGHIRISDL	HGHIRISDL
ILAIRQNAL	ILAIRQNAL
DLRSGLLHVAI	SGLLH-VAI
HAALRCESL	HAALRCESL
HRSIRHSSI	HRSIRHSSI
YLTARNSSL	YLTARNSSL
LPKSSTQSL	LPKSSTQSL
EGFLKAQAL	EGFLKAQAL
TLNTRMESL	TLNTRMESL
TRKEKAQAL	TRKEKAQAL
FPLIKEIISI	FPLIK-EII
SALIKAEL	SALIK-AEL
IFKDKVVL	IFKDK-VVL
EAFVREVL	EAFVR-EVL
SLRSKVTAI	SLRSKVTAI
DILKRLYEL	DILKRLYEL
LIKKNQTL	LIKKN-QTL
APYKKTCL	APYKK-TCL
TMKMRGQAF	TMKMRGQAF
EIREKLAKM	EIREKLAKM
SLNSKPSSL	SLNSKPSSL
AARPKATL	AARPK-ATL
AGHTRPSSL	AGHTRPSSL
VGREKKLAL	VGREKKLAL
EQKAKESL	EQKAK-ESL
LLKYKSII	LLKYK-SII
MPSEKVVM	MPSEK-VVM
KPYTKYVL	KPYTK-YVL
ANKVRVAL	ANKVR-VAL
SAKTRQTL	SAKTR-QTL
TPSSRPASL	TPSSRPASL
FVKTKVWSL	FVKTKVWSL
VLQQRLIAL	VLQQRLIAL
YPMPRVIF	YPMPR-VIF
WIKQKPISI	WIKQKPISI
IISPKVKMAL	SPKVK-MAL
LLPSKIKTL	LLPSKIKTL
DIKLKDIEHAL	DIKLKEHAL
ELKKKVSDL	ELKKKVSDL
IAKEKKAL	IAKEK-KAL
FPFSRPEL	FPFSR-PEL
ESKIRVLL	ESKIR-VLL
ERLIRTIAA	ERLIRTIAA
EAYLKYIEGL	EAYLKIEGL
EKLRKTEAI	EKLRKTEAI
YPNERFELL	YPNERFELL
SPNKKPFSL	SPNKKPFSL
VLLQKQIL	VLLQK-QIL
EVLKKVKTL	EVLKKVKTL
KLKEKTYSL	KLKEKTYSL
VVKRKSAL	VVKRK-SAL
HISQRLESL	HISQRLESL
DLLKKLEL	DLLKK-LEL
IIKEKRDL	IIKEK-RDL
DLKTKVLVL	DLKTKVLVL
DLRVKGIL	DLRVK-GIL
QTKSKVAL	QTKSK-VAL
SNKVKASL	SNKVK-ASL
EAKKRLEL	EAKKR-LEL
NNKVKVIL	NNKVK-VIL
TAKTRTSQF	TAKTRTSQF
SPYTKGASL	SPYTKGASL
TVMGRIATL	TVMGRIATL
NRALRGQSL	NRALRGQSL
YPWVHVVI	YPWVH-VVI
TPQYKASL	TPQYK-ASL
EAVHRAVAL	EAVHRAVAL
NNRAKLLSL	NNRAKLLSL
DLNYRWVSL	DLNYRWVSL
FPDLKERL	FPDLK-ERL
ELKKKPGTSL	ELKKKGTSL
NILDRFLAL	NILDRFLAL
ESALRKQSL	ESALRKQSL
DLKLRKFVF	DLKLRKFVF
CMHQKQRL	CMHQK-QRL
KLKVKGPAL	KLKVKGPAL
DMKAKQEAL	DMKAKQEAL
VVLLKARLVPA	VVLLK-ARL
QPVARPVSV	QPVARPVSV
LPDIKVLTL	LPDIKVLTL
EMATRAAL	EMATR-AAL
KLKAKYPSL	KLKAKYPSL
HAKRVTIM	HAKRV-TIM
DVKAKLHEL	DVKAKLHEL
IPYKREESL	IPYKREESL
DAKKREAL	DAKKR-EAL
NLGSRIAAL	NLGSRIAAL
ILRLKNQL	ILRLK-NQL
QIRSSTTSM	QIRSSTTSM
VIKVKIHEA	VIKVKIHEA
QLFQRTNAL	QLFQRTNAL
EALLRYVL	EALLR-YVL
LAAARLAAA	LAAARLAAA
VLLTKKSL	VLLTK-KSL
RPQGKVVAL	RPQGKVVAL
SARIRPTAV	SARIRPTAV
DIKESHLIEL	DIKESLIEL
MGNSRSAL	MGNSR-SAL
FPPKKLFSL	FPPKKLFSL
YLLLKTHQL	YLLLKTHQL
FLRYAVVL	FLRYA-VVL
VLRQKLFAL	VLRQKLFAL
LGKERFLEL	LGKERFLEL
FSFVRVISL	FSFVRVISL
ELKRKLNIL	ELKRKLNIL
LLKSKLLVL	LLKSKLLVL
MPTMRLLSF	MPTMRLLSF
SLITRLLEV	SLITRLLEV
DILPKKIL	DILPK-KIL
WIKEKIYV	WIKEK-IYV
LIKHKPSV	LIKHK-PSV
QIRKKMMEI	QIRKKMMEI
TVLQRPLSL	TVLQRPLSL
EAKRHLLQV	EAKRHLLQV
ELDVRITAL	ELDVRITAL
NRALKRFSL	NRALKRFSL
HSRVKLIL	HSRVK-LIL
ELKKKYGI	ELKKK-YGI
EYKKKKAL	EYKKK-KAL
ELHKKLLSV	ELHKKLLSV
QPYSRFLL	QPYSR-FLL
DIRLKDGSL	DIRLKDGSL
VPYFRNIL	VPYFR-NIL
LVKKKERSL	LVKKKERSL
QLYLKLWNL	QLYLKLWNL
FPFERLYDL	FPFERLYDL
VPASRVAL	VPASR-VAL
HLKNKHGL	HLKNK-HGL
TIKYKPKL	TIKYK-PKL
FGKLRNIEL	FGKLRNIEL
DLRHKLNL	DLRHK-LNL
SGHQRCEAL	SGHQRCEAL
DLIIKGISV	DLIIKGISV
RGKYKAAL	RGKYK-AAL
LVKRKQEL	LVKRK-QEL
EIKDKRQL	EIKDK-RQL
TLRQRLEEL	TLRQRLEEL
DIYQRALNL	DIYQRALNL
EAKAKPNL	EAKAK-PNL
WPLPKALL	WPLPK-ALL
ELRLKPQLL	ELRLKPQLL
NMRSHHRF	NMRSH-HRF
DARSYTAAV	DARSYTAAV
YLKVRPDEI	YLKVRPDEI
NLKKKTDL	NLKKK-TDL
ALKERADSL	ALKERADSL
QIVERLFSL	QIVERLFSL
RPKIKVSLI	RPKIKVSLI
ELVKRKQEL	ELVKRKQEL
EAHAKVRL	EAHAK-VRL
DLKRKPADL	DLKRKPADL
DPKVKAAF	DPKVK-AAF
LIKELEQSL	LIKELEQSL
ETKLRKEEL	ETKLRKEEL
ALALRFLAL	ALALRFLAL
SQKTKASL	SQKTK-ASL
AMKPKPLSV	AMKPKPLSV
DLKTRYPIL	DLKTRYPIL
DLNIRVERL	DLNIRVERL
FLLGKEVSL	FLLGKEVSL
DVVKRLLSL	DVVKRLLSL
IPKNKTKENIL	KNKTKENIL
TPLARIVAF	TPLARIVAF
NLKRKEIL	NLKRK-EIL
FMKPGKVVL	FMKPGKVVL
SLKSKVLSV	SLKSKVLSV
LLFLRASEL	LLFLRASEL
FGKEKFEV	FGKEK-FEV
HQQQRQESL	HQQQRQESL
RIKQKQSQL	RIKQKQSQL
DLNEKARAL	DLNEKARAL
TLRLKVEEL	TLRLKVEEL
ERALRELAL	ERALRELAL
DGKIKLTTL	DGKIKLTTL
SLGPRIHAL	SLGPRIHAL
TLTSKLYSL	TLTSKLYSL
DLKPRNIFL	DLKPRNIFL
LPKVQMPSL	LPKVQMPSL
FVKILIVEI	FVKILIVEI
NALLRYLL	NALLR-YLL
DLRAANIL	DLRAA-NIL
SPASRSISL	SPASRSISL
YIHIRPGQL	YIHIRPGQL
SNKVRILEL	SNKVRILEL
VPRIQPQSL	VPRIQPQSL
YAFVRPVIL	YAFVRPVIL
LPDERTISL	LPDERTISL
RLREKEDSL	RLREKEDSL
ALKTKEKL	ALKTK-EKL
IIKEKQAF	IIKEK-QAF
DVMIRKEEL	DVMIRKEEL
TNMLKVVAL	TNMLKVVAL
SNNSREYAL	SNNSREYAL
NLKLKERL	NLKLK-ERL
VPKERLALL	VPKERLALL
TLKNREASL	TLKNREASL
ELLIRKLPF	ELLIRKLPF
YFHQKRKL	YFHQK-RKL
NLAERIKSL	NLAERIKSL
FPIYKVLF	FPIYK-VLF
YAITRKAL	YAITR-KAL
DVRKRVQDL	DVRKRVQDL
EVYKRAKAL	EVYKRAKAL
EIKEKTGL	EIKEK-TGL
KPKVKKLQL	KPKVKKLQL
QLELRVEAL	QLELRVEAL
APSPRPLSL	APSPRPLSL
SALERLTTL	SALERLTTL
TPKEEAQSL	TPKEEAQSL
SPVFKTVL	SPVFK-TVL
SSKIKRHVL	SSKIKRHVL
AILRRLVAL	AILRRLVAL
ALIQNKVL	ALIQN-KVL
AVKARLAAL	AVKARLAAL
QVIEKTKSL	QVIEKTKSL
VQKRKQLEL	VQKRKQLEL
SAKTKTAL	SAKTK-TAL
ILLEKILSL	ILLEKILSL
YIIKDKHIL	YIIKDKHIL
FGKIKSCTL	FGKIKSCTL
TPKVKNQL	TPKVK-NQL
FGLLKAIL	FGLLK-AIL
DQRQKIKAA	DQRQKIKAA
VALLRVTPF	VALLRVTPF
SRVLKVLSV	SRVLKVLSV
EVAKRNSL	EVAKR-NSL
ETHKRHTL	ETHKR-HTL
TLFKKIQAL	TLFKKIQAL
QIKRKIQEF	QIKRKIQEF
VPAKKITAA	VPAKKITAA
SAFLKTIAL	SAFLKTIAL
ELGKRVQAL	ELGKRVQAL
EAVIKHSL	EAVIK-HSL
KPMEKLLGL	KPMEKLLGL
ILKQMQVL	ILKQM-QVL
YIKVRPAEL	YIKVRPAEL
VPLVREITF	VPLVREITF
DVRTKASVHTL	DVRTK-ASV
QLVQRVASV	QLVQRVASV
ELLEKHGL	ELLEK-HGL
TPKEKAQAL	TPKEKAQAL
DLKERTVL	DLKER-TVL
LPFEKSQL	LPFEK-SQL
QPILRFLQL	QPILRFLQL
ELLFRPTAL	ELLFRPTAL
ELFLRRISL	ELFLRRISL
HGLIRKYGL	HGLIRKYGL
HTKIRHVDA	HTKIRHVDA
YNKTKPFQL	YNKTKPFQL
LPQQREKL	LPQQR-EKL
VIIEKTYSL	VIIEKTYSL
EAKRKISSL	EAKRKISSL
ALKQRQQQL	ALKQRQQQL
EASKRAATL	EASKRAATL
HPKRSVSL	HPKRS-VSL
EAFVRHIL	EAFVR-HIL
RPKEKSLVLV	RPKEKSLVL
FIAQKILAL	FIAQKILAL
TALLKSLSA	TALLKSLSA
NLHSKYSL	NLHSK-YSL
EQKSGRTAL	EQKSGRTAL
MPSLKHIVEL	SLKHI-VEL
HIKHRVQEL	HIKHRVQEL
AGKTRVTL	AGKTR-VTL
DLLRKVGAL	DLLRKVGAL
YAQIRTIAI	YAQIRTIAI
QLRKEVAAL	QLRKEVAAL
NATIRNVL	NATIR-NVL
YLKVLPQEL	YLKVLPQEL
RLKAFKVAL	RLKAFKVAL
ELKEKLRSI	ELKEKLRSI
VAKLRRLL	VAKLR-RLL
EIKTKIKEL	EIKTKIKEL
DLPQRKSSL	DLPQRKSSL
ALHHRILAL	ALHHRILAL
VSKLRSQVM	VSKLRSQVM
NDMKRKFAL	NDMKRKFAL
EALHKGCSL	EALHKGCSL
VIKEKALTL	VIKEKALTL
EVISKLYAV	EVISKLYAV
YLRLVETSL	YLRLVETSL
ILKTHPKSV	ILKTHPKSV
ERLSRETAL	ERLSRETAL
TIKQRTSEV	TIKQRTSEV
IPIVHRVIKV	IPIVH-RVI
EAKKKFRNL	EAKKKFRNL
FLAQRAVEL	FLAQRAVEL
VAKQQVASL	VAKQQVASL
AAAKRQVL	AAAKR-QVL
MPSSRLWSL	MPSSRLWSL
QSKFRHVF	QSKFR-HVF
EVHRKHIM	EVHRK-HIM
ALREKAAL	ALREK-AAL
TVRFKNEL	TVRFK-NEL
HLHRKDSL	HLHRK-DSL
FILPKEIAV	FILPKEIAV
DLRAANVL	DLRAA-NVL
ELHKKAQASL	ELHKKQASL
SGKLKLSL	SGKLK-LSL
ERKHKEAL	ERKHK-EAL
VPPQKLQAL	VPPQKLQAL
IAHLRQIL	IAHLR-QIL
TLRERISAF	TLRERISAF
HIRDRAHIL	HIRDRAHIL
EPKKKASAL	EPKKKASAL
SIIQRLLEV	SIIQRLLEV
EVKRLQKSL	EVKRLQKSL
DVKLKFEEI	DVKLKFEEI
LPPKKFVL	LPPKK-FVL
ELKHKPGM	ELKHK-PGM
SLLLKAVV	SLLLK-AVV
KAKEKRESL	KAKEKRESL
TPHLRNLAV	TPHLRNLAV
AALKKALAA	AALKKALAA
FIREKGKSV	FIREKGKSV
DAKQKWLLL	DAKQKWLLL
ELKERKSSL	ELKERKSSL
LPHLRNKL	LPHLR-NKL
HLREKPSL	HLREK-PSL
