Data	Data aligned
TVNTSLNVYR	TVNTLNVYR
RIMELEGRVR	RIMEEGRVR
KISSTAVTR	KISSTAVTR
AIQGKEVRFLR	QGKEVRFLR
SLLQWVTSR	SLLQWVTSR
ILKTGGGFQR	ILKTGGFQR
KLKGDDLQAIK	KLKGDDLQA
TVYHSPVSR	TVYHSPVSR
STARHLYLR	STARHLYLR
AVNKFGVGR	AVNKFGVGR
GVANALAHR	GVANALAHR
RLREPLLR	RL-REPLLR
QLAQFHFTNR	QLAQHFTNR
KQLLKKEWLR	QLLKKEWLR
KIFAGKVLR	KIFAGKVLR
KLSSYPRLR	KLSSYPRLR
HLFDHVVNR	HLFDHVVNR
RSYPVTEQR	RSYPVTEQR
KLYVANVGTNR	YVANVGTNR
KLLTRAGSFSR	LTRAGSFSR
KTLNYTARFSR	TLNYARFSR
ALNVLLFYR	ALNVLLFYR
KTLAGDVHIVR	TLAGVHIVR
VLNEGMPIYR	VLNEMPIYR
RLFSIVRPRR	RLFSIVRPR
RVNKPPYPK	RVNKPPYPK
RQAEVKRLFR	RQAEKRLFR
ATAAFGHVQR	ATAAGHVQR
HTNAVATVR	HTNAVATVR
ATRPVTPPR	ATRPVTPPR
RSVRPGVVVPR	SVRPVVVPR
RLYMKLVMR	RLYMKLVMR
ILYEKPHFR	ILYEKPHFR
RLQENPGAWKR	RLQEGAWKR
KVFERVSRSVR	KVFESRSVR
SIRDPVHNR	SIRDPVHNR
KLKGIGKPR	KLKGIGKPR
KQRLFENLR	KQRLFENLR
SIIGGGVKAPR	IIGGVKAPR
RTFPGVASR	RTFPGVASR
KQATLLLER	KQATLLLER
RLFSIKPFYR	RLFSKPFYR
RIQAGDPVAR	RIQADPVAR
QTFYKFMKR	QTFYKFMKR
AMGINMPAR	AMGINMPAR
ALAPPDVHHER	ALAPVHHER
QQQTQLNLR	QQQTQLNLR
AAPSAAREL	AAPSAAREL
RVRELYRAWYR	RVRERAWYR
RITSLLAYR	RITSLLAYR
KINPDWKTHR	KINPWKTHR
KLRIPAISR	KLRIPAISR
RLIAAFEQKER	RLIAAFEQK
KLRLGVGNR	KLRLGVGNR
QLRNFLAKR	QLRNFLAKR
RMHLSQIQR	RMHLSQIQR
MVLAHVTNR	MVLAHVTNR
RVQEAVESMVK	RVQEAVESM
LLRGGIAER	LLRGGIAER
ATNILTATR	ATNILTATR
ATRWPLAVR	ATRWPLAVR
RLNSSPITTR	RLNSPITTR
VKKGKPELR	VKKGKPELR
ILYPATTGR	ILYPATTGR
TLLPSHPPR	TLLPSHPPR
RQQASIISR	RQQASIISR
KLFVGFLNR	KLFVGFLNR
RLAQEKALK	RLAQEKALK
IVKGPRGTLR	IVKGRGTLR
RVLSQPQLR	RVLSQPQLR
GVNQLKFAR	GVNQLKFAR
KVRKIGELVR	KVRKGELVR
RVFPVRPGSGR	RVFPPGSGR
KLKWIVSGR	KLKWIVSGR
RLGPPKRPPR	RLGPKRPPR
GSYHPGVFR	GSYHPGVFR
AQFGGKILR	AQFGGKILR
KSKDFVQVMR	KSKDVQVMR
RLSKIGATR	RLSKIGATR
SLGPPPYLR	SLGPPPYLR
RLRDLLTRR	RLRDLLTRR
KTSMHWVVR	KTSMHWVVR
KLNIMAAKR	KLNIMAAKR
YLPDGTASL	YLPDGTASL
KVAELKGHTSR	KVAEGHTSR
ILNSNHIGR	ILNSNHIGR
KTKLPVTLR	KTKLPVTLR
VTVDGPREPR	VTVDPREPR
RLLEKPYVR	RLLEKPYVR
RTVEKTWKL	RTVEKTWKL
KVMNSAVMR	KVMNSAVMR
KLYNKITSR	KLYNKITSR
KTFQGKPIMAR	KTFQPIMAR
QLYDRQLYR	QLYDRQLYR
HLNSQFPGTQR	NSQFPGTQR
RVFRNQLPR	RVFRNQLPR
KTVYPASYR	KTVYPASYR
KLAPEFAKR	KLAPEFAKR
KLKDKNTLFTR	KLKDKNTLF
RLSDVNVER	RLSDVNVER
RLSPSPTSQR	RLSPPTSQR
RTREEIQEVR	RTREIQEVR
TVFPNHTVKR	TVFPHTVKR
RARLQQFFR	RARLQQFFR
TLKPNLTIHQR	KPNLTIHQR
TLREYKVVGR	TLREKVVGR
HTFDHINKR	HTFDHINKR
RLLPRAEKRR	RLLPRAEKR
VIKEVRINR	VIKEVRINR
RVYTYIQSR	RVYTYIQSR
KTMNEKAWKR	KTMNKAWKR
RMNPNSPSITY	RMNPNSPSI
KVNLIKDRRR	KVNLKDRRR
KTITQVKKIGR	ITQVKKIGR
RVKGPGISK	RVKGPGISK
KLNEILQAR	KLNEILQAR
TIRSIYHVR	TIRSIYHVR
KLRDWTPPR	KLRDWTPPR
VMQKRISFR	VMQKRISFR
NIPEKTTAL	NIPEKTTAL
VLMEQPPLR	VLMEQPPLR
KVLAKQLVHLR	VLAKLVHLR
RLRGPSTAATR	RLRGTAATR
ASQAFAAQR	ASQAFAAQR
RLKDENGALIR	RLKDENGAL
RLIAELARR	RLIAELARR
SQNSVVIIR	SQNSVVIIR
RLYPGSVYGR	RLYPSVYGR
IIAAKKVLR	IIAAKKVLR
ATSRTYLYR	ATSRTYLYR
AIMKVHRIYR	AIMKHRIYR
SMFDVHVKR	SMFDVHVKR
ATFLPKWTR	ATFLPKWTR
KVRGISEVLAR	RGISEVLAR
RQKFQILGR	RQKFQILGR
LSSGLTAAR	LSSGLTAAR
KIADFGLAR	KIADFGLAR
KLYHKKIFR	KLYHKKIFR
KMKITDFENRR	KITDFENRR
VLGPPPPPR	VLGPPPPPR
ATVKKGKPELR	TVKKKPELR
RLLPLAPGRLR	RLLPLAPGR
AIWSGAALRAR	AIWSGAALR
LRQETNRLLEH	RQ-ETNRLL
RVQKSPVFR	RVQKSPVFR
RTLSESFSR	RTLSESFSR
RQAVKTPPR	RQAVKTPPR
KIRTSPTFR	KIRTSPTFR
KIKFPLPHR	KIKFPLPHR
RIMAKYYTR	RIMAKYYTR
HQRGLTVLR	HQRGLTVLR
IVRPFSIETK	IVRPSIETK
ATRTDKVRALR	RTDKVRALR
KTIDMELVKR	KTIDELVKR
RMRVLSKAFSR	RVLSKAFSR
RLISELYVR	RLISELYVR
GTYPWVVDR	GTYPWVVDR
RLKDSWVERL	RLKDSWVER
STIPFHYKR	STIPFHYKR
RLFQSNDQTLR	RLFQDQTLR
KIIETPGIRAR	KIIETPGIR
AALYPPWRGV	ALYPPWRGV
ILRPVFQQR	ILRPVFQQR
WVSVVTPAR	WVSVVTPAR
AVFSRISTR	AVFSRISTR
KIRPHITTLR	KIRPITTLR
RLKEDVLEQR	RLKEVLEQR
SLWKKTVYR	SLWKKTVYR
ALLAFILGR	ALLAFILGR
KTYEIWHRR	KTYEIWHRR
ALKQGNAIMR	ALKQNAIMR
RQFYINVER	RQFYINVER
RLFFGPQHR	RLFFGPQHR
HSYYNVWLR	HSYYNVWLR
VQGPVITTR	VQGPVITTR
RLNPKNVHQR	RLNPNVHQR
ATSPVVYTR	ATSPVVYTR
KLRPSADELLR	KLRPSADEL
STFEWVARR	STFEWVARR
KLFDWANTSRR	KLFDANTSR
AQADPLVRR	AQADPLVRR
ATATVYFKR	ATATVYFKR
AMFGPKGFGR	AMFGKGFGR
KTAVAPIER	KTAVAPIER
VLVAVKGAHV	VLVAKGAHV
KTKIIAKIQQR	KIIAKIQQR
KVNDVEAIR	KVNDVEAIR
VQFPHESSPR	VQFPESSPR
VQKPSYYVR	VQKPSYYVR
RLKEKEDALTR	RLKEKEDAL
RQQHPPPPPR	RQQHPPPPR
SMFRKPYVR	SMFRKPYVR
RVYQKPPMR	RVYQKPPMR
TVTEKPEVIDA	TVTEKPEVI
KLVSFGRTLT	KLVSFGRTL
RIFVHYPR	RI-FVHYPR
IQSSFVVER	IQSSFVVER
RLYLNVLNR	RLYLNVLNR
RLYPTPRVR	RLYPTPRVR
KTSTVPPSLR	KTSTPPSLR
RMRYISSQIER	RYISSQIER
KSLESINSR	KSLESINSR
VQYLLNKAKF	VQYLLNKAK
RLQPGPPRGR	RLQPPPRGR
YTQPGPGYR	YTQPGPGYR
ATQSFSTFR	ATQSFSTFR
KLIDPQTQVTR	KLIDTQVTR
KWLSLLQR	KW-LSLLQR
SLMQFSKPR	SLMQFSKPR
RIQEEIAKR	RIQEEIAKR
RLSPVPVPR	RLSPVPVPR
RVWDLRTGR	RVWDLRTGR
RLLAEGINRPR	RLLAEGINR
ALAAEALRVAR	LAAELRVAR
RLFPLLPLRP	RLFPLLPLR
KLASDPALR	KLASDPALR
KTAIKIQSVYR	AIKIQSVYR
KLNIRPLLR	KLNIRPLLR
ASLKWETER	ASLKWETER
KVFNQPKAKAK	KVFNQPKAK
ALVAGIDRYPR	LVAGDRYPR
TLYTQIRNR	TLYTQIRNR
RVYDPASPQRR	RVYDASPQR
RVKEYFVFR	RVKEYFVFR
RLRAIYTIMR	RLRAYTIMR
ALEEQLQQIR	ALEELQQIR
KTLGLAIKR	KTLGLAIKR
GTLQPPFTAR	TLQPPFTAR
KLLESIFHR	KLLESIFHR
VMFDKITSR	VMFDKITSR
ILRDFFELR	ILRDFFELR
KAKYPPVNR	KAKYPPVNR
ISPTGHSL	IS-PTGHSL
NVEIDPEIQ	NVEIDPEIQ
SQFRKDKIWLR	SQFRKIWLR
KLAPGGHVGR	KLAPGHVGR
ATYGKPVHH	ATYGKPVHH
RTLEKISSR	RTLEKISSR
RMLTSGVVHR	RMLTGVVHR
GSRPSDARFTR	RPSDARFTR
AVYEINVLR	AVYEINVLR
KIATSKIRG	KIATSKIRG
RLFEMPAVLER	RLFEMPAVL
RASAIIIQR	RASAIIIQR
KTGESGMIVFR	KTGEMIVFR
RLWDRAYVRL	RLWDRAYVR
RLLEYTPTAR	RLLETPTAR
KAKQGYVIYR	KAKQYVIYR
RQQQEEMRQLR	QQQEMRQLR
LIYNHITTR	LIYNHITTR
RIKDQYKVSVR	RIKDKVSVR
STRLFAVLR	STRLFAVLR
HQQLYWSHPR	QQLYWSHPR
RMKEFERER	RMKEFERER
RQTSTKGQVLR	QTSTGQVLR
RVQRHPFER	RVQRHPFER
VVQQVKGHYR	VVQQKGHYR
VLQERVMTR	VLQERVMTR
KMYEEHLKR	KMYEEHLKR
KIKESVIISR	KIKEVIISR
LLWEEKFPER	LLWEKFPER
KLNEVIVTR	KLNEVIVTR
RIIEPLTSR	RIIEPLTSR
RIKEVLKER	RIKEVLKER
RLLNFPTIVER	LLNFTIVER
RLSPSASPPR	RLSPASPPR
RQFWFQGNRYR	RQFWFQGNR
KLNAKLAELR	KLNALAELR
KIIEPIQSR	KIIEPIQSR
KSEEKELRKFR	KS-EEKELR
RVHLPSSIYR	RVHLSSIYR
GTKQQEIVVSR	KQQEIVVSR
MLQTFISHR	MLQTFISHR
RTSEGVLRNR	RTSEVLRNR
AVLPAGAFARR	AVLPGAFAR
RARPGVTLR	RARPGVTLR
KLTFISGRTK	KL-TFISGR
AAPEGVPL	AA-PEGVPL
SLMDKTFER	SLMDKTFER
HTNDTIGSVRR	HTNDIGSVR
LQNPDLALR	LQNPDLALR
RLMEEDPAFRR	RLMEDPAFR
RLKEEYQSLIR	RLKEEYQSL
QQNEVRVLR	QQNEVRVLR
IAPGVTHEL	IAPGVTHEL
ALRSPLAQR	ALRSPLAQR
TLKPEGNILR	TLKPGNILR
RVIAIRPIR	RVIAIRPIR
RIRDSEYEIQR	RIRDYEIQR
ALFGANANR	ALFGANANR
RLFWPFSKR	RLFWPFSKR
VTQEIVTER	VTQEIVTER
KMMADYGIRK	KMMAYGIRK
SMRPPIIIHR	SMRPIIIHR
RTRPEVGEMLR	RTRPGEMLR
GTSSFKESALR	SSFKESALR
RQINHIFYR	RQINHIFYR
RIKTPIPTSLR	KTPIPTSLR
VVKVGGPVYR	VVKVGPVYR
KLLEKIEEKQ	KLLEKIEEK
VVAPPGVVVSR	VAPPVVVSR
RLQDNRQFR	RLQDNRQFR
RLRDDTELR	RLRDDTELR
RLFPGLTSR	RLFPGLTSR
RLLAGATARLR	RLLAGATAR
KVFGGTVHK	KVFGGTVHK
ATYGLNVER	ATYGLNVER
KLLASLVKR	KLLASLVKR
KLKKPEAVR	KLKKPEAVR
ALRRSPVPR	ALRRSPVPR
RVLDFDVKR	RVLDFDVKR
TEKPEVID	TE-KPEVID
KLMDGSLQRAR	KLMDGSLQR
KLSIFIHKR	KLSIFIHKR
RVETRITARLR	RVETRITAR
KIKNYILMR	KIKNYILMR
RVYIHPFHL	RVYIHPFHL
SFEDAKEAL	SFEDAKEAL
SLMSQVSYR	SLMSQVSYR
SVLNFATNR	SVLNFATNR
RTSEIYVHR	RTSEIYVHR
ALSGFTIFR	ALSGFTIFR
RLFANRSSIMR	RLFASSIMR
AVLKITAQR	AVLKITAQR
KVSDWSYER	KVSDWSYER
RQMAHVQIFQR	QMAHQIFQR
RIFQKFLQR	RIFQKFLQR
TQLNTTWLR	TQLNTTWLR
KTQIPTQR	KT-QIPTQR
RLIFTRKGVLR	LIFTKGVLR
RIREILKASR	RIRELKASR
RLKDSWVER	RLKDSWVER
ALAPKFPEYR	ALAPFPEYR
KLLNSSKARLR	LLNSKARLR
VTTFEALKARV	TTFEALKAR
KLKYLAFLRKR	KLKYLAFLR
HLLADVARF	HLLADVARF
SIQHPGGQR	SIQHPGGQR
IANPNVPAYR	IANPVPAYR
RTIQYNMTRTR	RTIQYNMTR
ATASLRKLR	ATASLRKLR
RQKELESNYR	RQKEESNYR
LSRTARAW	LS-RTARAW
RTAPAANLASR	RTAPAANLA
QIFSGTSKR	QIFSGTSKR
KNLFRTVLR	KNLFRTVLR
RVLPAPAPR	RVLPAPAPR
STWLKGQVR	STWLKGQVR
MIRTKIAHR	MIRTKIAHR
TLYERIVSR	TLYERIVSR
KSREHGIAMR	KSREGIAMR
RALAMLQRFS	RA-LAMLQR
SVMDQEMRVKR	VMDQMRVKR
RVRDDLRFR	RVRDDLRFR
KLLGRVKAFDR	KLLGRVKAF
RVHELERVKR	RVHEERVKR
KSQLIIHQR	KSQLIIHQR
ATVQQLEGRWR	ATVQQLEGR
RVLLREAGFKR	LLREAGFKR
STNLKTHFR	STNLKTHFR
RLSPATENKLR	RLSPATENK
RLRPEREPRL	RLRPEREPR
KVKEWYVGVLR	KVKEVGVLR
SQYGWSGNMER	SQYGGNMER
KTYSVPAHQER	KTYSVPAHQ
ATAYRPDWNR	ATAYPDWNR
ALYGDKKPR	ALYGDKKPR
KVFALAEYRTR	KVFALAEYR
RLAEKLRAQK	RLAELRAQK
RVFIGGKINR	RVFIGKINR
KQQEIVVSR	KQQEIVVSR
SLSRHAALLYR	SLSRHAALL
SLYSVVSLR	SLYSVVSLR
KQRDLEGAVSR	RDLEGAVSR
LLQEKRFLR	LLQEKRFLR
RSIERHAPWVR	RSIEAPWVR
RVFSLVGKR	RVFSLVGKR
NVPVRDIPA	NVPVRDIPA
RLKAQKSLLYR	KAQKSLLYR
RQKLEEALR	RQKLEEALR
HIHSVIILR	HIHSVIILR
ATTPIFANR	ATTPIFANR
IINKVTRNR	IINKVTRNR
HLKEDLNLR	HLKEDLNLR
KLVPLSKKVER	KLVPKKVER
VTNNSVALR	VTNNSVALR
RLIIKPYLR	RLIIKPYLR
HSMDFVAYR	HSMDFVAYR
RMRHLKIVYR	RMRHKIVYR
KVKEPPILR	KVKEPPILR
RINEILSNALK	RINELSNAL
RLLPAELPAKR	LLPALPAKR
KQNVKIWGR	KQNVKIWGR
SLNPKNVNR	SLNPKNVNR
RSGFPRYNR	RSGFPRYNR
RLFEGTGARLR	RLFEGTGAR
RVMKALVNR	RVMKALVNR
RTYKYFKDYR	RTYKFKDYR
GTIGKKFAR	GTIGKKFAR
GTKQLQVLR	GTKQLQVLR
SIRNAHSIHQR	RNAHSIHQR
KLKDIVSLVPR	KLKDSLVPR
RTFTWLVGK	RTFTWLVGK
LTREHGRAYLR	REHGRAYLR
RLFEGNALLRR	RLFENALLR
RLMKIGIVR	RLMKIGIVR
RVNKPPYPKL	RVNKPPYPK
SVMYSTLPGR	VMYSTLPGR
AQTGLLWLR	AQTGLLWLR
RMLEEGSFRGR	RMLEEGSFR
RLLPRHDDFAR	RLLPDDFAR
SVFVATFLR	SVFVATFLR
TTYKLVINGK	TTYKVINGK
AQHGGIYVKR	AQHGIYVKR
KLFAIIVGR	KLFAIIVGR
SSHKTFRIKR	SSHKFRIKR
RSAAKFYRR	RSAAKFYRR
RIIEKVIHR	RIIEKVIHR
RLGAPFTVGR	RLGAFTVGR
AQRDPIIAK	AQRDPIIAK
SLLASGRAPR	SLLAGRAPR
RTNERLKVALR	RTNEKVALR
SISGPFGSR	SISGPFGSR
KTLPWGPKR	KTLPWGPKR
ALKPGIHVPR	ALKPIHVPR
ALNDVTAAR	ALNDVTAAR
RTMWFAGGFHR	TMWFGGFHR
TVIEKTESWPR	VIEKESWPR
TLRDLIFKR	TLRDLIFKR
QLYPWKYISR	QLYPKYISR
GQRVFVVKR	GQRVFVVKR
AIQDKKNFR	AIQDKKNFR
RLLHGSPNLR	RLLHSPNLR
QLYEYLQNR	QLYEYLQNR
KIMLPPRNR	KIMLPPRNR
ASNPATFQR	ASNPATFQR
RLQQLTEVSRR	RLQQTEVSR
SVVSWKTGVFR	VSWKTGVFR
RVAQKKASFLR	AQKKASFLR
RVFVVKRQNR	RVFVKRQNR
ALGTYYPPPR	ALGTYPPPR
LINNKIANR	LINNKIANR
KTFYWREHL	KTFYWREHL
SIPEKNRPL	SIPEKNRPL
AIFKGVFVHR	AIFKVFVHR
RLFNHPNILR	RLFNPNILR
RLHQVQRITR	RLHQQRITR
RMFAPTKTWRR	RMFATKTWR
RVFQGAPKGYR	RVFQPKGYR
KLIGEYGLRNK	KLIGEYGLR
RLRELMGELQR	RLRELMGEL
ATRWAKKIEAR	RWAKKIEAR
RTAALPTFR	RTAALPTFR
VVNPKVFPH	VVNPKVFPH
RLNTSIPQKR	RLNTIPQKR
NAPLVHATL	NAPLVHATL
RVMFKITAR	RVMFKITAR
RVKLDSVRVLR	KLDSVRVLR
KSLLKEFKR	KSLLKEFKR
KVIEKQLER	KVIEKQLER
IVHGDLSPR	IVHGDLSPR
ILQNEPLPERL	LQNEPLPER
RLFEWVVNRI	RLFEWVVNR
YVQRFHYSR	YVQRFHYSR
KQLYDKGLVYR	QLYDGLVYR
KLSGLPKHR	KLSGLPKHR
KTFHGLLTR	KTFHGLLTR
KLYIDSRARR	KLYISRARR
ALNDAKRELR	ALNDKRELR
HLPETKFSEL	HLPEKFSEL
RVSGLVPSR	RVSGLVPSR
RLFMSRTNR	RLFMSRTNR
HTRHYELYR	HTRHYELYR
RLQQLRELR	RLQQLRELR
RVLYPRVVR	RVLYPRVVR
RLSENVVNR	RLSENVVNR
KLRANVNAR	KLRANVNAR
SQFQGLPSR	SQFQGLPSR
AQMDRVLREER	RV--LREER
QTQSIYIPR	QTQSIYIPR
TVKRGLVLR	TVKRGLVLR
QTKAPPFVAR	QTKAPFVAR
KIKNGTPPMR	KIKNTPPMR
RVHSIFVLR	RVHSIFVLR
HMQNEKFFR	HMQNEKFFR
KIFSGVFVK	KIFSGVFVK
KTLSPDQRVER	TLSPQRVER
RITNHIHVR	RITNHIHVR
STIDWNKLYRR	STIDNKLYR
RTRWSGITR	RTRWSGITR
SLKDPSNNFR	SLKDSNNFR
TIIDTKGVTAL	TIIDKGVTA
RTQNVLGEKGR	RTQNVLGEK
RTRLAAWAR	RTRLAAWAR
RLNPQYPMFR	RLNPYPMFR
ATQPWNRIQR	ATQPNRIQR
RTLPWSSVLR	RTLPSSVLR
ILNTWISLK	ILNTWISLK
RVITALVER	RVITALVER
AVKAPGFGDNR	KAPGFGDNR
HSMALIHNR	HSMALIHNR
KLFSPVIAR	KLFSPVIAR
RIQEDYLRILR	RIQELRILR
AVTAFVTFR	AVTAFVTFR
RVWDISGLRKK	RVWDISGLR
VIFVKSVQR	VIFVKSVQR
ASFLRAQER	ASFLRAQER
ILKHILTQR	ILKHILTQR
KVFHRPWRR	KVFHRPWRR
NAPWAVTSL	NAPWAVTSL
KTLTGVLPER	KTLTVLPER
MTILQTYFR	MTILQTYFR
RVANHQKDLFR	VANHKDLFR
RLFSIVRPR	RLFSIVRPR
ALMSPAGMLR	ALMSAGMLR
RLFSKSIETLR	RLFSIETLR
RVKTVWLVGR	RVKTWLVGR
VLGPVPLTR	VLGPVPLTR
KTFGQKPVK	KTFGQKPVK
RQNLYTKYR	RQNLYTKYR
STYGWTANMER	STYGWTANM
RLLDGIKQR	RLLDGIKQR
RVIKWLYGL	RVIKWLYGL
SLFSGRLVR	SLFSGRLVR
SLADGRDRPLR	SLADDRPLR
RLKQIKEFHR	RLKQKEFHR
KQSDVMRFLLR	KQSDVMRFL
VLKSTPQVR	VLKSTPQVR
MLWKKLIER	MLWKKLIER
RNTLFQLQR	RNTLFQLQR
RLWGNHKNR	RLWGNHKNR
KLLKPISGKLR	LLKPSGKLR
SLQSAQYLR	SLQSAQYLR
RIAQLVARQR	RIAQVARQR
RVRDIVPTLR	RVRDVPTLR
RLSLQVVNR	RLSLQVVNR
KIQKFENQYR	KIQKENQYR
KLQPPPVGR	KLQPPPVGR
KSLPSEVERLR	KSLPSEVER
RLKSRQGLLR	RLKSQGLLR
KLMEMKKLLR	KLMEKKLLR
KLALRYAGR	KLALRYAGR
RLLPRAEKR	RLLPRAEKR
RIYSKFHQK	RIYSKFHQK
VVFDSNTNR	VVFDSNTNR
RIKLEGIITR	RIKLGIITR
RTYYSPVYR	RTYYSPVYR
ATIALMIQR	ATIALMIQR
RLALAPAAR	RLALAPAAR
RVMMEVQKRQR	RVMMEVQKR
RLKPFGVQRF	RLKPFGVQR
RTYVGSMPGR	RTYVSMPGR
RQQETEHIPR	RQQEEHIPR
KLQKLNEVRKR	KLQKLNEVR
RLFSIVRPRRL	RLFSIVRPR
RVRDIQKQVR	RVRDQKQVR
GTIAGLNVLR	TIAGLNVLR
SMSSTFFSR	SMSSTFFSR
KQRHVQLLGR	KQRHQLLGR
QLYHSPARR	QLYHSPARR
GTYTDVTPR	GTYTDVTPR
AQWQKVLPRR	AQWQKVLPR
RVMEPLTASR	RVMELTASR
HLPEGALNSL	HLPEALNSL
RSQEYKIVLR	RSQEKIVLR
KIWQNLRLK	KIWQNLRLK
RTKRLVVFDAR	RTKRLVVFD
RVLDERLVRLR	RVLDERLVR
RIYELRNKER	RIYERNKER
KLFEREPTKR	KLFEEPTKR
VVQSSPVER	VVQSSPVER
MMFSATFPK	MMFSATFPK
VLPEHVSVL	VLPEHVSVL
TIRDRPFER	TIRDRPFER
RLFTEKILR	RLFTEKILR
GTRYGASLR	GTRYGASLR
KLLERIGIAR	KLLEIGIAR
SLYHQPANR	SLYHQPANR
VLYDRQGIGR	VLYDQGIGR
RTFATALDTTR	AT-ALDTTR
KSLIKSWKK	KSLIKSWKK
KISSPKVGR	KISSPKVGR
RTLQEPVAR	RTLQEPVAR
RILPRLQAR	RILPRLQAR
RLQNEHRVLR	RLQNHRVLR
KVSLVTHQR	KVSLVTHQR
RTRTGSSFSVR	RTGSSFSVR
SSPQPGSAL	SSPQPGSAL
RTLVTGALR	RTLVTGALR
RIREAAGLFR	RIREAGLFR
STFIHAEDFAR	FIHAEDFAR
RLAELARRQR	RLAEARRQR
KSNSIIVSPR	KSNSIVSPR
KMLQTDPTAR	MLQTDPTAR
KMKPDVVLR	KMKPDVVLR
VVLKWYENFQR	VLKWENFQR
SQFVISPPALR	FVISPPALR
GLKQVIIPR	GLKQVIIPR
RTSASIILR	RTSASIILR
RLRPFHLAAVR	RLRPLAAVR
QMYDKGLVYR	QMYDGLVYR
KLWDGSEAR	KLWDGSEAR
RIRTGSALVQR	RTGSALVQR
ASRIRIALR	ASRIRIALR
RLLSIKEAFR	RLLSKEAFR
LRPLLAAAA	LRPLLAAAA
KSQEKVGIVGR	KSQEGIVGR
KIIEKQPGHIR	KIIEKQPGH
TVRDHLVGR	TVRDHLVGR
RVLDTNDRFLR	VLDTDRFLR
RLAPRFGTER	RLAPFGTER
RLWDLQQLR	RLWDLQQLR
KQRLIYQGR	KQRLIYQGR
RTMVDKLLSSR	TMVDLLSSR
RTKLETVLALR	KLETVLALR
RTQQIPETRKR	RTQQIPETR
RTKTELSQLR	RTKTLSQLR
VILPPRPPK	VILPPRPPK
VVAPRLNSR	VVAPRLNSR
KVFPEDMAKYR	KVFPEDMAK
KLQEAMKLR	KLQEAMKLR
RTSIFIAHR	RTSIFIAHR
QARLRDDTELR	RLRDDTELR
LLVVYPWTQR	LLVVPWTQR
RLYHPTVPLAR	RLYHPTVPL
RLLRKGNYAER	LLRKNYAER
KLPPVYVRKER	KLPPVYVRK
KIKDTVLQR	KIKDTVLQR
RLQAWERAFR	RLQAERAFR
RLLDFLQKR	RLLDFLQKR
KQWPKRSLR	KQWPKRSLR
RQTGIVLNR	RQTGIVLNR
HLQTGYKVER	HLQTYKVER
KTRSERQLLR	KTRSRQLLR
GLGGTLPPR	GLGGTLPPR
RLISETAQR	RLISETAQR
QQNSGHFLR	QQNSGHFLR
KTKPIHTIIRK	KTKPHTIIR
RSFSLGVPR	RSFSLGVPR
ILAPRPWSR	ILAPRPWSR
VVKTESVLIKR	KTESVLIKR
KVIERAAFPR	KVIEAAFPR
KLYPDSRVR	KLYPDSRVR
ALWDRYMGTLR	ALWDMGTLR
RLLDEEISRVR	RLLDEEISR
AMRDSIHAR	AMRDSIHAR
VIKDKFIRR	VIKDKFIRR
RLREGQTLR	RLREGQTLR
RSNKLHFAFR	RSNKHFAFR
ASIDWLAQR	ASIDWLAQR
ALAEFHVQR	ALAEFHVQR
RTIAKRLVLR	RTIARLVLR
RLFEEPELTQR	RLFEELTQR
KLHDMIIKR	KLHDMIIKR
SLFRGEHHSR	SLFREHHSR
AGEDPGLARQ	AGEDPGLAR
KTVRLVIGR	KTVRLVIGR
VIRSAVSVHLR	RSAVSVHLR
KSQLIVHQR	KSQLIVHQR
STSKRHWLR	STSKRHWLR
RARPSLTVTPR	RARPTVTPR
SLQRWEHLK	SLQRWEHLK
KLFSVTRNR	KLFSVTRNR
ATAELIMSR	ATAELIMSR
KSFIRKDHLR	KSFIKDHLR
RLRDPAQQVR	RLRDAQQVR
HVRTWSVTR	HVRTWSVTR
RVRPGEYRQR	RVRPEYRQR
RLWDFIENR	RLWDFIENR
RLFPSVPLFAR	RLFPPLFAR
KTKDVTVWR	KTKDVTVWR
RVRQSPLATR	RVRQPLATR
RSAALSWLR	RSAALSWLR
MVQNRVFLR	MVQNRVFLR
RLREKLTLLH	RLREKLTLL
KVIDGERVIGR	KVIDRVIGR
KVMHFVARVR	KVMHVARVR
SVFLYQSLR	SVFLYQSLR
GTYQPLSTR	GTYQPLSTR
RVVEGNHMVYR	RVVEHMVYR
KLNEQQSVLQR	KLNEQQSVL
KVFLFIRNR	KVFLFIRNR
RIQDIVGILR	RIQDVGILR
KLDSVRVLR	KLDSVRVLR
KTSPKPLPSRF	KTSPPLPSR
HTLEPLIPR	HTLEPLIPR
KTQQTRDVLR	KTQQRDVLR
KIALKEITR	KIALKEITR
ATREFIEMWR	ATREIEMWR
RTRKFMTNRL	RTRKFMTNR
LQNDEVAFR	LQNDEVAFR
MVVPAALKVVR	VVPALKVVR
KLYPWIHQF	KLYPWIHQF
RQQLRSDIQKR	QLRSDIQKR
SLRSVVGISR	SLRSVGISR
RTRDYASLPPK	RTRDYASLP
SSRKEYFYR	SSRKEYFYR
TVKVQIHSR	TVKVQIHSR
RIKDDEWNIYR	RIKDWNIYR
RIRPAVGWGR	RIRPVGWGR
RLASSYIAHLR	ASSYIAHLR
STRDFSVDR	STRDFSVDR
LQFPVGRIHR	LQFPGRIHR
RTLTYMSHR	RTLTYMSHR
ALNSKAYKR	ALNSKAYKR
RTIQAHEGFVR	TIQAEGFVR
TTFTWNINHAR	FTWNINHAR
RSRPYAVLR	RSRPYAVLR
SLSPIYPAAR	SLSPYPAAR
KVLRPFLLR	KVLRPFLLR
RTKRWEGGYER	KRWEGGYER
YWVPRNAL	YW-VPRNAL
KIHLQIARQR	KIHLIARQR
ATFFPSSSRNR	ATFFPSSSR
RLRAAYNLVKR	RAAYNLVKR
KQMSFLEKR	KQMSFLEKR
KSNGSVFVR	KSNGSVFVR
SVPLAATSM	SVPLAATSM
RTIGISVDPRR	RTIGSVDPR
KLHTSIAGR	KLHTSIAGR
AVFYTFVFR	AVFYTFVFR
ALQTRLAKR	ALQTRLAKR
KQMDLNTGRMR	KQMDLNTGR
RLKIGFILR	RLKIGFILR
KLINQEKKMFR	LINQKKMFR
KQRGEEMIAR	KQRGEMIAR
ATWAVPTVR	ATWAVPTVR
RLQQAQMLR	RLQQAQMLR
AVHDLLRPR	AVHDLLRPR
RVKETSNENLR	RVKESNENL
KVYELQASR	KVYELQASR
RLFEGNALLR	RLFENALLR
KLNAKLAELRR	KLNALAELR
RLSDFQMHR	RLSDFQMHR
ALRDTPIPR	ALRDTPIPR
SIQSFFYSR	SIQSFFYSR
IVPEGVHAL	IVPEGVHAL
ASKMESTIKPR	KMESTIKPR
AGKSVHVLR	AGKSVHVLR
KAPAPRPSL	KAPAPRPSL
SLNVALPMR	SLNVALPMR
RVAFRDADMQR	AFRDADMQR
RLQPPRDLR	RLQPPRDLR
RVLTAPTLR	RVLTAPTLR
KSIWNNRWLR	SIWNNRWLR
STQLTIHQR	STQLTIHQR
KIKELYETR	KIKELYETR
RLLQHTPSAR	RLLQTPSAR
KLNSIHISQR	KLNSHISQR
VLNGELPLR	VLNGELPLR
KTIWSTMLR	KTIWSTMLR
KSKVPAFVR	KSKVPAFVR
KTHNLLTTR	KTHNLLTTR
TLMPHNYSR	TLMPHNYSR
KIRPHIATLR	KIRPIATLR
SMWKGKTLR	SMWKGKTLR
ALNPINVKR	ALNPINVKR
RLAEVIQKHQR	RLAEVIQKH
ATKFKQLYR	ATKFKQLYR
RLSAKMALR	RLSAKMALR
RVRDVFEAK	RVRDVFEAK
KIRKTFVQR	KIRKTFVQR
KIKELYRRR	KIKELYRRR
LSYDQAKRVPR	YDQAKRVPR
RLIDQKWQR	RLIDQKWQR
SLLRQPPPTR	LLRQPPPTR
HQQSGSELALR	QQSGELALR
TTFPESHLR	TTFPESHLR
VAPVTHVSV	VAPVTHVSV
SLANIARQR	SLANIARQR
VKPDQLIKRR	VKPDQLIKR
SLFRPGGRA	SLFRPGGRA
KLFELYTKR	KLFELYTKR
RLKEVFQTK	RLKEVFQTK
AVYDFFIGR	AVYDFFIGR
RQFQARVSR	RQFQARVSR
KTAGINVRK	KTAGINVRK
GQRKGAGSVFR	RKGAGSVFR
AVFPFKPPQR	AVFPKPPQR
KSEKRTFLR	KSEKRTFLR
KTITGKTFSSR	ITGKTFSSR
KVAVPGPTR	KVAVPGPTR
MLRNLLALR	MLRNLLALR
WSIMKWNRER	SIMKWNRER
KVIPPIRSR	KVIPPIRSR
ALWRWTQVR	ALWRWTQVR
KSLPAPVAQR	SLPAPVAQR
ITYLMEHKR	ITYLMEHKR
RVIIEKYYTR	VIIEKYYTR
RVLQPGALPDR	VLQPALPDR
KLLLHRPFFR	KLLLRPFFR
RIFGPIWNR	RIFGPIWNR
RVKGVTIVK	RVKGVTIVK
KVMEYENRIR	KVMEENRIR
KLAPFIAKR	KLAPFIAKR
RLFPPAFRR	RLFPPAFRR
KLREQVVKR	KLREQVVKR
RTHSLRYFRL	RTHSLRYFR
VIKPWITKR	VIKPWITKR
KMRIPVAR	KM-RIPVAR
RLKSPVLR	RL-KSPVLR
RVQPIKLAR	RVQPIKLAR
MTKSGYQPPR	MTKSYQPPR
KQKDLSGFYR	KQKDSGFYR
RTHNVLERQR	RTHNLERQR
RVSPTSPRLR	RVSPSPRLR
KTTKKIVLR	KTTKKIVLR
AQNSGLTLR	AQNSGLTLR
KTVDVKINHR	KTVDKINHR
RSKIKSFVK	RSKIKSFVK
RMIVRVTNR	RMIVRVTNR
IVKPPASAR	IVKPPASAR
KLYELIITR	KLYELIITR
KSLDQAISRF	KSLDQAISR
RLQFNKHGVLR	LQFNHGVLR
RVFEHHGQVRL	RVFEHGQVR
KVKSYIHEVAR	KSYIHEVAR
RLRPPIMIMMR	RLRPPIMIM
RLKENQISVR	RLKEQISVR
QQRQEQSYFVR	RQEQSYFVR
RTLIPRYFR	RTLIPRYFR
ATAALAWRPP	AT-AALAWR
LLNDRKVFVGR	LLNDVFVGR
AIKPFYQKR	AIKPFYQKR
RTNSLMVSR	RTNSLMVSR
AMATVTALR	AMATVTALR
RLLKKQFFH	RLLKKQFFH
KMNLTRGINLR	NLTRGINLR
RSQDWKFALR	RSQDKFALR
RTSRPLKILR	RTSRLKILR
KTRPFEYLR	KTRPFEYLR
KTQGLKIHQR	KTQGKIHQR
QIKNFLSKR	QIKNFLSKR
AQFKPSSQILR	AQFKSQILR
MLITERKHFR	LITERKHFR
RLLDQRDRIMR	RLLDDRIMR
KLKETSSFRMR	KLKETSSFR
QTFARTVAR	QTFARTVAR
TINDISVLR	TINDISVLR
SLFQAFVKR	SLFQAFVKR
MDAKSLTAWSR	AKSLTAWSR
VNLPINGNGKQ	NLPINGNGK
GSRSFIINR	GSRSFIINR
KLTDSVLRSFR	KL-TDSVLR
RLQDPQKVAR	RLQDQKVAR
MLAPPLGNTR	MLAPLGNTR
AMFQPSSPTRR	AMFQSSPTR
LMFDKTTNR	LMFDKTTNR
KQNPFWWTH	KQNPFWWTH
VLKEVVRQR	VLKEVVRQR
RIRDIDLKR	RIRDIDLKR
KLREIEENQKR	KLREEENQK
KILGPFHKR	KILGPFHKR
RQINWTVLYRR	RQINTVLYR
LAPTDVKEL	LAPTDVKEL
QLKAPHANR	QLKAPHANR
RVQVWFQNR	RVQVWFQNR
SLHSIIRHR	SLHSIIRHR
RIIPGGIADR	RIIPGIADR
VLKHVLTPR	VLKHVLTPR
AVISRTMNR	AVISRTMNR
RQKFGYSVNR	RQKFYSVNR
STNSHPILR	STNSHPILR
KTFSDEGRLR	KTFSEGRLR
RLADTHFVQR	RLADHFVQR
RTPGNERPPR	RTPGERPPR
AMITVHTPR	AMITVHTPR
RTLEFIPKGR	RTLEIPKGR
KLAVAIALR	KLAVAIALR
RTQQRYLKVLR	QQRYLKVLR
AISVAWGRGR	AISVWGRGR
RGFRYNWPQR	RGFRNWPQR
RLHPFHVIR	RLHPFHVIR
KLSIVPVRR	KLSIVPVRR
QVANSAFVER	VANSAFVER
RSIYLQWNR	RSIYLQWNR
QQLYWSHPR	QQLYWSHPR
KQLPLVKPYLR	QLPLKPYLR
RLQQQLEKKQR	RLQQQLEKK
GLAPMGTLPRR	GLAPGTLPR
QLMPALVQR	QLMPALVQR
GVVPAGVILER	VVPAVILER
KMKEALLSIGK	KMKEALLSI
MIKGKTPEEIR	KGKTPEEIR
KQFSVPLRR	KQFSVPLRR
ITPTGTHPL	ITPTGTHPL
RLFGALLER	RLFGALLER
SLKADIVLR	SLKADIVLR
MLNVSPIGR	MLNVSPIGR
KMKESSPLSSR	KESSPLSSR
RLVGIISSR	RLVGIISSR
RTFSRHVVQR	RTFSHVVQR
GQVITIGNER	QVITIGNER
SQNSLFTFR	SQNSLFTFR
HTKAVNVVR	HTKAVNVVR
SLKGSFGVTR	SLKGFGVTR
VVQGDPRELR	VVQGPRELR
RGFQRDLSSLR	FQRDLSSLR
ALGTYYPPPRL	ALGTYPPPR
ATYSLANERLR	ATYSLANER
RLTKHTKFVR	RLTKTKFVR
SLSSLTYQR	SLSSLTYQR
RLADFAKER	RLADFAKER
FRHKQTFVGH	RHKQTFVGH
KLFKPPQPPAR	KLFKQPPAR
KVHPAVVIRQR	KVHPAVVIR
MQAENIYNR	MQAENIYNR
RLQDVVSER	RLQDVVSER
ILAFREKEWQR	AFREKEWQR
SLSDRTNLYR	SLSDTNLYR
AINYPTVPR	AINYPTVPR
RVSGILVKR	RVSGILVKR
KIKEGAENLR	KIKEAENLR
HQVDFTFDR	HQVDFTFDR
RIWQSPRFIAR	WQSPRFIAR
VQQRYLSYR	VQQRYLSYR
VIRGYVGNR	VIRGYVGNR
KMVGFIIGR	KMVGFIIGR
TLKPDPHLR	TLKPDPHLR
AVFPSIVGR	AVFPSIVGR
RLLHYFRGR	RLLHYFRGR
RLHDSLAIER	RLHDLAIER
ALAEYVIYR	ALAEYVIYR
KTFTGHREWVR	KTFTREWVR
KMFFTTKHR	KMFFTTKHR
KISVVTKRER	KISVTKRER
KLIPVHQVR	KLIPVHQVR
IVVPKAAIVAR	VVPKAIVAR
IIQSTPYGR	IIQSTPYGR
HLNAQQVSR	HLNAQQVSR
GTLREYKVVGR	TLREKVVGR
RINERMPPR	RINERMPPR
HLYEQPKINR	HLYEPKINR
RMFRWLVLR	RMFRWLVLR
KTFEFNKELR	KTFENKELR
TTLTKIALR	TTLTKIALR
VIIEKYYTR	VIIEKYYTR
SIFSNIKNR	SIFSNIKNR
KLIETGERER	KLIEGERER
VLGPVREPR	VLGPVREPR
KTLDPDPAIRR	KTLDDPAIR
KTLGTVTPR	KTLGTVTPR
RTFNRKSGVSR	RTFNSGVSR
QRSRVAYR	QR-SRVAYR
STRRFVMLR	STRRFVMLR
KLLGGLAVRR	KLLGLAVRR
RAGSRVAYR	RAGSRVAYR
SQFKGPAPR	SQFKGPAPR
KLNPYAKTMR	KLNPAKTMR
AVANFIRQR	AVANFIRQR
TLLEISKRFR	TLLESKRFR
KIRSATKLASR	RSATKLASR
RLQELPGKVHR	RLQEGKVHR
RLRFSAFLR	RLRFSAFLR
VTFPVRQPR	VTFPVRQPR
SINKPTSER	SINKPTSER
VLSPPRWPR	VLSPPRWPR
RLHDRIVFR	RLHDRIVFR
RIMKAQALR	RIMKAQALR
ALYRGPITR	ALYRGPITR
ALQSMISSR	ALQSMISSR
RLLSPPLRPR	RLLSPLRPR
KTILKRLFR	KTILKRLFR
LLHGIAAAR	LLHGIAAAR
VLRQPQLGVLR	RQPQLGVLR
KVFPSHFTQQR	KVFPFTQQR
AIRSSVIPR	AIRSSVIPR
RSVGRIIGR	RSVGRIIGR
RALGVPFVPR	ALGVPFVPR
YAPSGNFV	YA-PSGNFV
SVWPFLVQR	SVWPFLVQR
RLKEAYSVKSR	RLKEAYSVK
HLKEIISYR	HLKEIISYR
KSKLIIHQR	KSKLIIHQR
RVLDALVAR	RVLDALVAR
KLLPNGFTKR	KLLPGFTKR
IVKKNFDLR	IVKKNFDLR
KIFGNKEMR	KIFGNKEMR
RLKNNQSKFFR	KNNQSKFFR
ASMPWGDPNYR	SMPWDPNYR
KLYLPTGPR	KLYLPTGPR
KINPVQQSR	KINPVQQSR
RTYQSITER	RTYQSITER
ATSAVTVTR	ATSAVTVTR
SVSPVVHVR	SVSPVVHVR
AIKSVKIYR	AIKSVKIYR
RVIQPMGMSPR	VIQPGMSPR
AMFHKVRVPR	AMFHVRVPR
RQLWRVIER	RQLWRVIER
RVQDHIQSR	RVQDHIQSR
RLYGGMNYR	RLYGGMNYR
STIDADQRVLR	TIDAQRVLR
KVFSIGPVFR	KVFSGPVFR
SLHQRGLTVLR	HQRGLTVLR
KLLWQDSRYR	KLLWDSRYR
RVEFPRSGR	RVEFPRSGR
HVYDGKFLAR	HVYDKFLAR
ATKILTELR	ATKILTELR
KQYVTQINR	KQYVTQINR
RQSLHTYLR	RQSLHTYLR
KVNLNTIKR	KVNLNTIKR
ILNDKRHILTK	ILNDKRHIL
RLGQPPGVR	RLGQPPGVR
SVNSHIYQR	SVNSHIYQR
STISQRPYR	STISQRPYR
KMQWVQRQR	KMQWVQRQR
RLHEEGIIYR	RLHEGIIYR
RVVQQEEGWFR	VQQEEGWFR
RHPLADILHR	HPLADILHR
KIMLKVYSR	KIMLKVYSR
RLREGANINR	RLREANINR
ATSGVVAVR	ATSGVVAVR
RQIDQFLVVAR	RQIDLVVAR
RLGQPLTGR	RLGQPLTGR
MVQRLTYRR	MVQRLTYRR
KILKDIANR	KILKDIANR
KQKQDYITR	KQKQDYITR
KVKDRLKAYVR	KVKDKAYVR
VILKPKMLDK	ILKPKMLDK
RLKMLGQTR	RLKMLGQTR
ASYKWNVSR	ASYKWNVSR
RLQQDNIRTR	RLQQNIRTR
RLQDNRQFRGR	RLQDNRQFR
KTFSEILNR	KTFSEILNR
AVAKLFWSQR	AVAKFWSQR
QQFGSRFLR	QQFGSRFLR
RVTLKQYPR	RVTLKQYPR
RVKDLESLFHR	RVKDSLFHR
RVLEKLGVTVR	RVLEGVTVR
SVQTADHRFLR	QTADHRFLR
AAPVSATVL	AAPVSATVL
RLSPFLAAR	RLSPFLAAR
VVFVYVATR	VVFVYVATR
KLQDAGVYR	KLQDAGVYR
SAPVGVTAL	SAPVGVTAL
VSNKWLHER	VSNKWLHER
AVRPKVLMR	AVRPKVLMR
RLKLSDVAR	RLKLSDVAR
KLAVNMVPFPR	AVNMVPFPR
RLVKREYLR	RLVKREYLR
RLFVGSIPK	RLFVGSIPK
ATRGLPAAR	ATRGLPAAR
KLWERNIKSHL	KLWERNIKS
RLLTKTNRMPR	RL-LTKTNR
KQKEITKAIKR	KQKEKAIKR
LQNEPIPER	LQNEPIPER
AVMKNQVAR	AVMKNQVAR
AQMSSVFQR	AQMSSVFQR
KTRPFEYLRL	KTRPFEYLR
SIRSFEMNR	SIRSFEMNR
RTKKVGIVGK	RTKKGIVGK
SLKSQLIVHQR	KSQLIVHQR
RLNVTPLAR	RLNVTPLAR
VLAGPLAQR	VLAGPLAQR
KLYPGKSLLR	KLYPKSLLR
KLKEIQLQER	KLKEQLQER
KLTDFYPVRR	KLTDYPVRR
HSQDLSGRLR	HSQDSGRLR
KLFEKKYSVKR	KLFEKYSVK
ATAPVVTFSPR	ATAPTFSPR
RVFPMPLPR	RVFPMPLPR
LLPSHPLEL	LLPSHPLEL
IVNDKSQNLR	IVNDSQNLR
KLNPYAKTMRR	KLNPAKTMR
KISAIIEKR	KISAIIEKR
RIFTLKPVR	RIFTLKPVR
KVNLIKDRR	KVNLIKDRR
ATLRVSEGRAR	ATLRVSEGR
RIMELEGRVRR	RIMEEGRVR
ILKTITHPR	ILKTITHPR
KTLEGVITR	KTLEGVITR
AVFAGFEGR	AVFAGFEGR
RIQELEERRR	RIQELEERR
RQKEYVAPR	RQKEYVAPR
VLRQISNNR	VLRQISNNR
RLFDIKPEQQR	RLFDPEQQR
SVRELILKR	SVRELILKR
RVKIADMGFAR	KIADMGFAR
KLDRPRFER	KLDRPRFER
RTFLLQGLLR	RTFLQGLLR
KMYEEHLKRM	KMYEEHLKR
IVKEFQRNR	IVKEFQRNR
VGPPGRSSL	VGPPGRSSL
STAKIQIVR	STAKIQIVR
KTIDKKTFYK	KTIDKTFYK
PIRLLAAAA	PIRLLAAAA
RLSSAINHR	RLSSAINHR
GTWNWIWRR	GTWNWIWRR
SVLAYSFSR	SVLAYSFSR
AAPGVDLT	AA-PGVDLT
KLREAEEALR	KLREEEALR
AVREVLHGNQR	AVREHGNQR
KLINRPIIVFR	LINRIIVFR
MLNISPIGR	MLNISPIGR
RQAFLSGRSR	RQAFSGRSR
TTYKLVINGKT	TTYKVINGK
RLREPLLRR	RLREPLLRR
KIRVVRKSIAR	RVVRKSIAR
VVRSSRWVR	VVRSSRWVR
RTISETIER	RTISETIER
RLAAVVGVER	RLAAVGVER
KLSKPVYLR	KLSKPVYLR
RLHELRIARL	RLHELRIAR
STREYVMFR	STREYVMFR
ALIPHSDQRLR	ALIPHSDQR
KQNDTKVLR	KQNDTKVLR
RVNGSLAVSR	RVNGLAVSR
ASFGGLASR	ASFGGLASR
RTRDIINVSNR	RTRDNVSNR
KTEEEALKHFR	KT-EEEALK
KQWKDVVER	KQWKDVVER
QTIPPPYVVR	QTIPPYVVR
RLQEKLTSR	RLQEKLTSR
RLIGWGQIRR	RLIGGQIRR
KTKDIVNGLR	KTKDVNGLR
RLRREYLYR	RLRREYLYR
KLRQPFFQK	KLRQPFFQK
RTYDETYQRYR	RTYDETYQR
RQKLQDLNDLR	KLQDLNDLR
RLYDSSPSRQR	RLYDSSPSR
RIKDSENFRR	RIKDENFRR
RLDETVVNR	RLDETVVNR
KAQLKIYTR	KAQLKIYTR
RIFPVDKSRSR	RIFPVDKSR
AVRNAGSRFLR	RNAGSRFLR
STRPPSVTR	STRPPSVTR
GQRPHHFLR	GQRPHHFLR
KLISQVQKR	KLISQVQKR
KVWVPKQK	KV-WVPKQK
KTAGKRYVYR	KTAGRYVYR
KQNYVHRIGR	KQNYHRIGR
YQYPSSQPR	YQYPSSQPR
SSYFRIHER	SSYFRIHER
RMLFKSKAYER	MLFKKAYER
KAPGSTSNL	KAPGSTSNL
KMLQHIDYRMR	KMLQHIDYR
VLAGRYSGR	VLAGRYSGR
GGSTMFRDFGR	STMFRDFGR
ALNVPLHNR	ALNVPLHNR
HIFAKVQQR	HIFAKVQQR
RLSDVTRER	RLSDVTRER
RVGDNWREAR	RVGDWREAR
RVAAHPILR	RVAAHPILR
HIQEIRTLR	HIQEIRTLR
KLGKITFIR	KLGKITFIR
KKGKPELR	KK-GKPELR
KQVDPSITRR	KQVDPSITR
VQVGPLPSR	VQVGPLPSR
KLSSSFSSR	KLSSSFSSR
QLYPRNFLR	QLYPRNFLR
RLKSIKNIQK	RLKSKNIQK
STKPGSYIFR	STKPSYIFR
IQFQGGFSSR	IQFQGFSSR
KVQTFPFLGR	KVQTPFLGR
RILMGSTLRKR	RILMGSTLR
TLKSGISYR	TLKSGISYR
AIYKFQSRR	AIYKFQSRR
KMKDPKQIIR	KMKDKQIIR
TGSRPIPSRP	TGSRPIPSR
AVRPGDRVL	AVRPGDRVL
ATRLLAEKR	ATRLLAEKR
GTVRRVVLR	GTVRRVVLR
QVVGEATFIAR	VVGETFIAR
LLPGESNKIPR	LLPGNKIPR
KQLEEEKRR	KQLEEEKRR
RVNILSDMHLR	NILSDMHLR
AVLSNPDKRLR	VLSNDKRLR
SIPGGYNAL	SIPGGYNAL
RTNESLIQR	RTNESLIQR
ALMPMKVKQLR	ALMPKVKQL
KSYLIIHQR	KSYLIIHQR
RLREMIEKR	RLREMIEKR
HLFPYVKKR	HLFPYVKKR
VSPYTEIHL	VSPYTEIHL
LQFPVGRVHR	LQFPGRVHR
SLGTLNFPGR	SLGTNFPGR
KAWPRNAETQR	KAWPAETQR
SLKAPPARP	SLKAPPARP
RSYLTVHKR	RSYLTVHKR
RILNVTKAR	RILNVTKAR
RIAPPDRRFSR	RIAPRRFSR
RLKFGFGFHR	RLKFFGFHR
RVQEEVKLR	RVQEEVKLR
SLYGAARYR	SLYGAARYR
KIWSQKSGMER	KIWSSGMER
SQIRTWSNSR	QIRTWSNSR
KQNPFWWTHQR	KQNPWTHQR
KLTDIARHVR	KLTDARHVR
RTQLLGQLR	RTQLLGQLR
SLRVHITSR	SLRVHITSR
RLHLTLRSA	RLHLTLRSA
VVFQKRQER	VVFQKRQER
AQKNYPYSPR	AQKNPYSPR
SVQGIIIYR	SVQGIIIYR
RMQEENITR	RMQEENITR
RIHQFGIVHR	RIHQGIVHR
TTHNIIEKR	TTHNIIEKR
RVKESITR	RV-KESITR
KQKSILYDER	KQKSLYDER
RVKELEVRK	RVKELEVRK
KIRNTKYPIQR	RNTKYPIQR
KLISGWVSR	KLISGWVSR
AVRALVASR	AVRALVASR
ALRGKVYQR	ALRGKVYQR
RKIDTHPSP	RKIDTHPSP
RLQSIHTMR	RLQSIHTMR
RLAPIPRAR	RLAPIPRAR
ILHFGLPPR	ILHFGLPPR
TVTEKPEVID	TVTEKPEVI
RVNEVGVDVNR	RVNEVDVNR
KQLGYSVYR	KQLGYSVYR
KQINIDFRTR	KQINDFRTR
GIKPPPIIGR	GIKPPIIGR
AIKDRVSLIKR	AIKDSLIKR
GTQSFVFQR	GTQSFVFQR
RTNQFSVTRH	RTNQFSVTR
SLFTQTHQR	SLFTQTHQR
KTKEGYYYR	KTKEGYYYR
HLNQEVAVR	HLNQEVAVR
IIQKYIRAR	IIQKYIRAR
GTSQLYVYR	GTSQLYVYR
RLITGLGVGR	RLITLGVGR
TTVKRGLVLR	TVKRGLVLR
RLKKFITRR	RLKKFITRR
KVWVKLIGR	KVWVKLIGR
KISSFLRQR	KISSFLRQR
AVGGVYHPR	AVGGVYHPR
VQAGIFVER	VQAGIFVER
LLLPAASRPPR	LLPASRPPR
SVPEAQSAL	SVPEAQSAL
RVGDVYIPR	RVGDVYIPR
KVKTPEMIIQK	KTPEMIIQK
TYDDATKTF	TYDDATKTF
KIRDLIAIER	KIRDIAIER
KVKAPPSVPR	KVKAPSVPR
KTWNPKFTLR	KTWNKFTLR
SSYPKQILR	SSYPKQILR
ILRTEQWPR	ILRTEQWPR
RLQDLKSRFR	RLQDKSRFR
RLKAAITIR	RLKAAITIR
KLGVKLVQR	KLGVKLVQR
KLRQPFFQKR	KLRQFFQKR
KTIPKGFSSSR	TIPKFSSSR
KIRVPFLR	KI-RVPFLR
KLLGGLAVR	KLLGGLAVR
STLSPIAPR	STLSPIAPR
SIRRFTTSVVR	RRFTTSVVR
RLREPLLRRL	RLREPLLRR
LEEALQQAKED	AL---QQAK
RLKGDAWVYKR	RLKGAWVYK
KTFEKNVVR	KTFEKNVVR
RLQDFKGNILR	RLQDGNILR
TLQGYGFPVNR	TLQGFPVNR
RLPTSKRSLR	RLPTKRSLR
KTNFRLLKR	KTNFRLLKR
RLLPSLIGR	RLLPSLIGR
KQVEELFER	KQVEELFER
RLQARIAHR	RLQARIAHR
LRNKTIFLR	LRNKTIFLR
KLQGSKRILR	KLQGKRILR
RVYRNFHYR	RVYRNFHYR
RIYADPTKR	RIYADPTKR
RLQKLWVGR	RLQKLWVGR
KVMGILINR	KVMGILINR
EEQLQQIR	EE-QLQQIR
RLKEGININR	RLKEININR
RVYNWDVKR	RVYNWDVKR
RIMDRFNLPR	RIMDFNLPR
KLLAELEGKLR	LLAEEGKLR
VLKETVSQR	VLKETVSQR
TNAENEFVTIK	AENEFVTIK
GLKGYVAER	GLKGYVAER
RTLLVADPR	RTLLVADPR
KLREAEEALRR	KLREEEALR
QVRSIQQTMAR	RSIQQTMAR
PLGQRGYPGNP	GQRGYPGNP
KVAQPKEVYR	KVAQKEVYR
SVVAVPLPLHR	VVAVLPLHR
KQLQKDKQVYR	LQKDKQVYR
ITRIFGVKR	ITRIFGVKR
RLWEVATAR	RLWEVATAR
RVQLPKRYR	RVQLPKRYR
RTNQFSVTR	RTNQFSVTR
GMNPREPAVYR	GMNPPAVYR
VVPEPGQPL	VVPEPGQPL
RMVAVLVSR	RMVAVLVSR
SIMKWNRERRR	SIMKWNRER
KLKAIVASK	KLKAIVASK
KTYYQDRPFFR	KTYYRPFFR
ALAMGSRALR	ALAMSRALR
RIIDIVMQR	RIIDIVMQR
RLRELVPGVPR	RLREPGVPR
RVTNFVAQR	RVTNFVAQR
STKFPAYER	STKFPAYER
IQNRFKYAR	IQNRFKYAR
KTQEPFSVR	KTQEPFSVR
KTQEVSALR	KTQEVSALR
QLRQGQLTGR	QLRQQLTGR
RQFADPGALQR	RQFAGALQR
RQINWTVLYR	RQINTVLYR
QLQKDKQVYR	LQKDKQVYR
RVLRQISNNR	VLRQISNNR
RVSEVKPSYR	RVSEKPSYR
RTSTPNSRIQR	STPNSRIQR
RTFRKFTYR	RTFRKFTYR
KAFPYSSHLIR	KAFPYSSHL
ALQSHQPVAR	ALQSQPVAR
SLFAGGMLR	SLFAGGMLR
AQFDSPEILRR	AQFDPEILR
RMQSLSLNK	RMQSLSLNK
KLKDASKSLER	KLKDASKSL
TIMDRSIILR	TIMDSIILR
MAPLKMLAL	MAPLKMLAL
KINSLAHLR	KINSLAHLR
RIMAKDLVRTR	RIMAKDLVR
QTKPVYVYR	QTKPVYVYR
RLRPGDGLLR	RLRPDGLLR
KLKYLAFLR	KLKYLAFLR
ASLHWTSER	ASLHWTSER
SLRDYTPASR	SLRDTPASR
RVNEKEIVR	RVNEKEIVR
RMAPPASRAPQ	RM-APPASR
RVIEDRDSQLR	RVIEDSQLR
SIMKWNRER	SIMKWNRER
SLNPKTWGR	SLNPKTWGR
IQAGIYATR	IQAGIYATR
KTNGKFLIR	KTNGKFLIR
SVASLVGRSK	SVASVGRSK
RMLPPLTKNQR	MLPPTKNQR
RLAQFIGNR	RLAQFIGNR
RLYDVPANSMR	RLYDVPANS
ATLNVSTTR	ATLNVSTTR
QVRVWFQNR	QVRVWFQNR
KTHAVILSR	KTHAVILSR
KQSPLQKHLR	KQSPQKHLR
RQKGINGQLR	RQKGNGQLR
SVLEATRVNR	SVLETRVNR
MLWERLSSTKR	RL--SSTKR
RSWEAAKLFAR	RSWEKLFAR
KQHSLLKRLR	KQHSLKRLR
SLKHSTTLTNR	KHSTTLTNR
SIVGENETYPR	IVGEETYPR
ILQILSLNR	ILQILSLNR
AVKQGRFYLR	AVKQRFYLR
RLLNFQRQLR	RLLNQRQLR
RLAEVIKNR	RLAEVIKNR
TLRKPPAVGR	TLRKPAVGR
SQKPVMVKR	SQKPVMVKR
STKKIPTVNR	STKKPTVNR
VLRKIEELR	VLRKIEELR
NVGDWLRGVYR	GDWLRGVYR
RSYTKAYSR	RSYTKAYSR
SLFKQTFQR	SLFKQTFQR
LVNKRIGLYR	LVNKIGLYR
RVLDALVAREK	RVLDALVAR
RIFTSVPKR	RIFTSVPKR
RTYDREGFKK	RTYDEGFKK
LYDRQGIGR	LYDRQGIGR
VLRQAIAER	VLRQAIAER
KVRNFEVHR	KVRNFEVHR
QLQDPREPR	QLQDPREPR
KVQSSLGGRVR	KVQSSLGGR
KIKIIAPPER	KIKIAPPER
RMPPPPRHR	RMPPPPRHR
KTLRGINSR	KTLRGINSR
TTNAKVALR	TTNAKVALR
RQLKHSYYR	RQLKHSYYR
KIRIFDLGR	KIRIFDLGR
SVKFGATLR	SVKFGATLR
STFTNITYR	STFTNITYR
RLNEAAVTVSR	RLNEVTVSR
VIIGGDGRRN	VIIGGDGRR
ATFQFTVER	ATFQFTVER
AQWQKVLPR	AQWQKVLPR
KQRDDILINR	KQRDILINR
KLFSPNIKFR	KLFSNIKFR
RLNSKWDLR	RLNSKWDLR
KVFDVTKGR	KVFDVTKGR
STMKKSFRVKK	TMKKFRVKK
RLASNVAKR	RLASNVAKR
RLIAASTSRTR	RLIAASTSR
TVKDLRLVTNR	TVKDLVTNR
SLNTPGSFR	SLNTPGSFR
RLLERFHGASR	RLLEHGASR
KSAAWHGILR	KSAAHGILR
ALKPLRDVFQR	ALKPDVFQR
RLDQMRKFR	RLDQMRKFR
IVHTVTVKR	IVHTVTVKR
KLKSFESER	KLKSFESER
AVKDWANQR	AVKDWANQR
RTFGNEARFIR	RTFGNEARF
RLFQPWGSILR	RLFQGSILR
LSSTVLIVR	LSSTVLIVR
KTAKLILERF	KTAKLILER
RVYHYFQWRR	RVYHFQWRR
ALFNTRIPR	ALFNTRIPR
RLFVSVHLR	RLFVSVHLR
KASELRIQLR	KASERIQLR
KLFGPASSR	KLFGPASSR
RSFSGLIKR	RSFSGLIKR
ATSPALFNR	ATSPALFNR
RTVEGALKER	RTVEALKER
QLRPTGQLR	QLRPTGQLR
TVKWFNVR	TV-KWFNVR
RLFGLAQRSAR	RL-FGLAQR
GTADVHFER	GTADVHFER
KIFAKPEEQRK	KIFAPEEQR
ATAGIIGVNR	ATAGIGVNR
TTLSRERWLR	TLSRERWLR
RTFSSIPVSR	RTFSIPVSR
RQMEMKILR	RQMEMKILR
LTGPVMPVR	LTGPVMPVR
RVFEHHGQVR	RVFEHGQVR
KAFDRITTR	KAFDRITTR
ALAKFKSSIYR	AKFKSSIYR
TAPQGNVDL	TAPQGNVDL
YAPSGNYV	YA-PSGNYV
ATIQGAYAR	ATIQGAYAR
SVTPEGVIKQR	VTPEVIKQR
VTNPNARLR	VTNPNARLR
QLFHKEVLR	QLFHKEVLR
RLLSAVTAR	RLLSAVTAR
KTLDKAGVLHR	KTLDAGVLH
ATSPLQENR	ATSPLQENR
KLQGEFQLRLR	KLQGEFQLR
RQFFFINRR	RQFFFINRR
VQKPGFGVGR	VQKPFGVGR
VVKDITNAFR	VVKDTNAFR
RVFQGFFTGR	RVFQFFTGR
ALMDRGAIVR	ALMDGAIVR
VTNVKVTLR	VTNVKVTLR
RLRDGQLVSQR	RLRDLVSQR
RLLHHKRIYK	RLLHKRIYK
RVVKDITNAFR	VVKDTNAFR
KMIDMAEPAQR	IDMAEPAQR
TDTYKLILNGK	KL--ILNGK
STMPHTSGMNR	STMPHTSGM
KLKEILKER	KLKEILKER
RQHTFALHQR	RQHTALHQR
RTFLHTVQR	RTFLHTVQR
ATMVPSVLWPR	MVPSVLWPR
RQREQEIALR	RQREEIALR
KIKPRNITR	KIKPRNITR
GVRTPVPPR	GVRTPVPPR
VLRDNIQGITK	VLRDNIQGI
AQKKASFLR	AQKKASFLR
KMADKVLPQR	KMADVLPQR
KLSTFPANR	KLSTFPANR
ATNGREGLLR	ATNGEGLLR
GLFSGLIPR	GLFSGLIPR
KTQPPLMKR	KTQPPLMKR
GTQPTVLRTFR	GT-QPTVLR
RLFNAIIHR	RLFNAIIHR
RVSPQPMISR	RVSPPMISR
ATYPYQVVR	ATYPYQVVR
SLNNKILNR	SLNNKILNR
KTNLIVDSR	KTNLIVDSR
ATELWTYVR	ATELWTYVR
SVRPKPFLNR	SVRPPFLNR
SVRPGVVVPR	SVRPVVVPR
RQAGLSYIR	RQAGLSYIR
KVKGPALSR	KVKGPALSR
KAPVTKVAA	KAPVTKVAA
KVYDQMPEPR	KVYDMPEPR
TVMSVKIIR	TVMSVKIIR
RMGPVMDR	RM-GPVMDR
ILSKPPAER	ILSKPPAER
KTRGDHFKLR	KTRGHFKLR
RVKDLMVINR	RVKDMVINR
RVISGHLGWVR	VISGLGWVR
KLSPSPSLR	KLSPSPSLR
TLSPAFSTR	TLSPAFSTR
RLQPGTLRAR	RLQPTLRAR
KTNNSEKFERF	KTNNEKFER
RSFGWKDQR	RSFGWKDQR
HLRDGISAR	HLRDGISAR
SLTGHISTVR	SLTGISTVR
RMFGGPGTASR	RMFGGTASR
RQLFRILFR	RQLFRILFR
SVAGLTAAAYR	AGLTAAAYR
RLEERYVPR	RLEERYVPR
KTLLVNNNR	KTLLVNNNR
RIRAPIMR	RI-RAPIMR
KTTTVKFNR	KTTTVKFNR
RLNHEGKIVLR	RLNHKIVLR
LRLAELARR	LRLAELARR
RVQFGVMTR	RVQFGVMTR
KLYSEQRAIR	KLYSQRAIR
SLNPKTWGRL	SLNPKTWGR
RISLQWLR	RI-SLQWLR
AAPATRAAL	AAPATRAAL
SVWKMYHSR	SVWKMYHSR
RMQEKHLHLR	RMQEHLHLR
YDRQGIGR	YD-RQGIGR
KQQELLRQR	KQQELLRQR
KLYPLPSAR	KLYPLPSAR
RSYLIIHQR	RSYLIIHQR
KVQERRFLR	KVQERRFLR
KLFRGPLVINR	KLFRLVINR
TLFKGVITR	TLFKGVITR
RLRDQGGVVLR	RLRDGVVLR
ILFGKKYEK	ILFGKKYEK
RTSKPVFR	RT-SKPVFR
KKEIVAFLK	KKEIVAFLK
RIANGIATR	RIANGIATR
KLQDERTVR	KLQDERTVR
SIREPIANR	SIREPIANR
GTYVSSVPR	GTYVSSVPR
MVKPTPGLTPR	KPTPGLTPR
ILGPPGPRGA	IL-GPPGPR
KVADGFKVVAR	KVADKVVAR
RLQQAGNVLR	RLQQGNVLR
SLMSALAAR	SLMSALAAR
KIIAPLVTR	KIIAPLVTR
RTLKPEGNILR	TLKPGNILR
SILSHIHKR	SILSHIHKR
RTGPPMGSRF	RTGPPMGSR
RTMPLLSLHSR	RTMPLLSLH
KLNPQQFEV	KLNPQQFEV
KLWERYTHR	KLWERYTHR
RTMALPVGR	RTMALPVGR
SVLEQSFLR	SVLEQSFLR
KILWFIPFRQR	KILWFIPFR
RLIPDFPVAR	RLIPFPVAR
VINSVSTSR	VINSVSTSR
GTNADTPVLR	GTNATPVLR
QLYDKGLVYR	QLYDGLVYR
RVLDVGFVGR	RVLDGFVGR
RLQDAAVVR	RLQDAAVVR
HIIEKDKITTR	IEKDKITTR
LINEESHFP	LINEESHFP
SAPYGRITL	SAPYGRITL
RLKRIAGQDLR	KRIAGQDLR
KLAEVTKVVVR	KLAEKVVVR
RVTDFFARR	RVTDFFARR
GVRPPVGNR	GVRPPVGNR
QLFPGYGNGR	QLFPYGNGR
KLRDFLLEH	KLRDFLLEH
KMGQPVLPR	KMGQPVLPR
RLQHYFMGR	RLQHYFMGR
ATFPGMWER	ATFPGMWER
KVFVGRFKSR	KVFVRFKSR
RLSDVLKRKR	RLSDLKRKR
SVIPDREYLR	SVIPREYLR
GTLGFGDKFKR	TLGFDKFKR
ILKAQVAAR	ILKAQVAAR
RVNLSAAQTLR	NLSAAQTLR
AQYEDIAQKS	AQYEDIAQK
SLAPPPRER	SLAPPPRER
AVKGYFTLR	AVKGYFTLR
RVSEVLQNR	RVSEVLQNR
RIFEKMFAM	RIFEKMFAM
RISKPHLR	RI-SKPHLR
ALTEKQWLR	ALTEKQWLR
RVLHLEKRER	RVLHEKRER
AVAAVAARR	AVAAVAARR
RIYEIEDRTR	RIYEEDRTR
KLWVIARER	KLWVIARER
RLNINARER	RLNINARER
ILNGGPSKR	ILNGGPSKR
QITAVIINR	QITAVIINR
VKGPRGTLR	VKGPRGTLR
AAQDRDQIYR	AAQDDQIYR
KVYNISEFTRR	KVYNSEFTR
KQFQKSLPPR	KQFQSLPPR
KQKTEQLGLTR	KTEQLGLTR
KLQEMRAQR	KLQEMRAQR
AVIGGIDGRLR	AVIGGIDGR
RQKPPIIHR	RQKPPIIHR
ITQIEHEVS	ITQIEHEVS
TVVSIQRRYR	VVSIQRRYR
HLNAVRIQR	HLNAVRIQR
SLKGVDPKFLR	KGVDPKFLR
KVSPVSYLR	KVSPVSYLR
VAPVASAL	VA-PVASAL
SLFSAVVAR	SLFSAVVAR
RIFGKKQMR	RIFGKKQMR
KMRLWDLQQLR	RLWDLQQLR
RVLSKAFSR	RVLSKAFSR
KIGSFLSNR	KIGSFLSNR
KMFNALIHR	KMFNALIHR
KQSQHMTEVVR	SQHMTEVVR
KTFPYQHRYR	KTFPQHRYR
ALFAGGKLR	ALFAGGKLR
QIQKWIRTR	QIQKWIRTR
TQHQIIHTR	TQHQIIHTR
KIRIEDPPR	KIRIEDPPR
GVYATRSSAVR	AT-RSSAVR
RLQPYNGVALR	RLQPNGVAL
HLNGLTETR	HLNGLTETR
SMFQKIILR	SMFQKIILR
LLQEHFYLR	LLQEHFYLR
KMLPSSSSRMR	KMLPSSSSR
ALNSNNFVR	ALNSNNFVR
RVWIQGKFQK	RVWIGKFQK
EESNYELEGK	ESNYELEGK
QMRPFLENR	QMRPFLENR
ATLKDITRRLK	ATLKDITRR
RVTKVLGR	RV-TKVLGR
RVAPSLKSQR	RVAPLKSQR
ALNSIEGVYR	ALNSEGVYR
RVRDIAIATR	RVRDAIATR
RLLPPVGTGR	RLLPVGTGR
IVNENLVER	IVNENLVER
KTKTEQFQAR	KTKTQFQAR
ALNAHTFLR	ALNAHTFLR
RLWDRAYVR	RLWDRAYVR
IVPGNVKSL	IVPGNVKSL
RSYVTTSTR	RSYVTTSTR
LQAPLPPMR	LQAPLPPMR
ATLIRPHNR	ATLIRPHNR
ITVDGPREPR	ITVDPREPR
ATWFNQPAR	ATWFNQPAR
RLDSNRIGR	RLDSNRIGR
STRGKPNFTR	STRGPNFTR
SVFSKYFER	SVFSKYFER
KQKESWQLR	KQKESWQLR
RVVEASDRLQR	VVEADRLQR
RIFKPTHSR	RIFKPTHSR
KLLEGEEERLR	KLLEGEEER
SLAQHPSALR	SLAQPSALR
LLNAVIVQR	LLNAVIVQR
RVAKFPENRNR	RVAKFPENR
RLGSWARALLR	RLGSARALL
GTGPNVPPR	GTGPNVPPR
KTQKENTVFR	KTQKNTVFR
AVRPVIEKR	AVRPVIEKR
RVRNKLIVMR	RVRNLIVMR
VMKDFEEMR	VMKDFEEMR
RIYEYVESR	RIYEYVESR
KSFLGINKER	KSFLINKER
QVKSGRPSLR	QVKSRPSLR
RLADVFNQR	RLADVFNQR
RQYLDPAQR	RQYLDPAQR
RTSFFHVKR	RTSFFHVKR
GVMPSHFSR	GVMPSHFSR
RLMKVFVTR	RLMKVFVTR
KVFESWMHHW	KVFESWMHH
RLSEGFSIHTR	RLSESIHTR
KVFVKSSDLLK	KVFVSSDLL
ASYYKDALR	ASYYKDALR
KTKDPTAALR	KTKDTAALR
VLNPTPIKR	VLNPTPIKR
RINSYSGIKR	RINSSGIKR
VVREPSGTLR	VVRESGTLR
RTGSPLAAR	RTGSPLAAR
RIYAQKFIDR	RIYAKFIDR
KSRDPFWNR	KSRDPFWNR
GQKPGGSDFLR	GQKPSDFLR
KINLRIQTR	KINLRIQTR
KTRLGRNVYR	KTRLRNVYR
RLREQGGAVLR	RLREGAVLR
KTRGFSFPRQ	KTRGFSFPR
KVAPSELARSR	KVAPSELAR
RIAELQQRNR	RIAEQQRNR
VMYSTLPGR	VMYSTLPGR
RVIWGKVTR	RVIWGKVTR
RVNAELQAR	RVNAELQAR
KTLPKIVGR	KTLPKIVGR
RMLPSTSRR	RMLPSTSRR
KIKENRQQIVR	KENRQQIVR
AMYPDYFAKR	AMYPYFAKR
RLLSIVGRQR	RLLSVGRQR
ASSPGGVYATR	SSPGVYATR
KSFDKNLYR	KSFDKNLYR
KTIDIREER	KTIDIREER
RTKAPKIQR	RTKAPKIQR
SGPGPAAAL	SGPGPAAAL
KLADFGLARAK	KLADFGLAR
ALKERIELR	ALKERIELR
RVGQAVALR	RVGQAVALR
STQPAPRSIFR	TQPARSIFR
RATEVTVAR	RATEVTVAR
RMLELPTIYR	RMLEPTIYR
RTITARITGR	RTITRITGR
QVAIKVIPR	QVAIKVIPR
KVQEGERQLR	KVQEERQLR
TLSAVTNNR	TLSAVTNNR
RMFAPTKTWR	RMFATKTWR
KTFHRYTVR	KTFHRYTVR
RIGQAIARR	RIGQAIARR
NSPLGEAL	NS-PLGEAL
QTMPTNMPPPR	TMPTMPPPR
KMQEQLERNR	KMQELERNR
RIQNPSAYAKR	IQNPAYAKR
KLFDRPQELKL	KLFDRPQEL
LLWYHTVVR	LLWYHTVVR
RLMMEQRSR	RLMMEQRSR
RVIAHTQMR	RVIAHTQMR
KVLSNRPIMFR	VLSNPIMFR
RILPWSTFR	RILPWSTFR
SVQPSSSLSAR	VQPSSLSAR
LQNEPLPERL	LQNEPLPER
KLQPPPLGR	KLQPPPLGR
RLRDDLNVTRL	RLRDLNVTR
QVQPKPSPPR	QVQPPSPPR
KTYQVTPMTPR	KTYQPMTPR
TVYEGPFASR	TVYEPFASR
RLKINLIIHQR	KINLIIHQR
RLLSAFLPAR	RLLSFLPAR
IVKQKAFER	IVKQKAFER
RIYKPLRTR	RIYKPLRTR
AVMGNPVTR	AVMGNPVTR
KLKDQNIFVSR	KLKDIFVSR
SVRGFNMGR	SVRGFNMGR
KMALSFVQR	KMALSFVQR
TVFPHGLPPR	TVFPGLPPR
KSHLIIHQR	KSHLIIHQR
AIRHQRAL	AI-RHQRAL
YFAERVTSL	YFAERVTSL
SVQPEELIYQR	VQPELIYQR
RLWEAVKRRK	RLWEAVKRR
VARDALLAR	VARDALLAR
SVYSPSGPVNR	SVYSGPVNR
KVAAIVVKR	KVAAIVVKR
SLNNFISQR	SLNNFISQR
RLIGWGQIR	RLIGWGQIR
LLHEKRYLR	LLHEKRYLR
AMWQKNFKR	AMWQKNFKR
RIHSITAER	RIHSITAER
SLNGNSSIVGR	SLNGSIVGR
ATRLGYFGR	ATRLGYFGR
KVSKKEFLR	KVSKKEFLR
RLQAPVGQR	RLQAPVGQR
RQFPGSHRVKR	RQFPHRVKR
RVSADSFVR	RVSADSFVR
ALFLFQEPR	ALFLFQEPR
RLPDAHSDYAR	RLPDSDYAR
SLYGPGTNR	SLYGPGTNR
RTPGPRPPR	RTPGPRPPR
TLYEGTWRR	TLYEGTWRR
SMMSPMAER	SMMSPMAER
KLRGIVSEK	KLRGIVSEK
RLAQQLRQR	RLAQQLRQR
KLFQSNDPTLR	KLFQDPTLR
ISHHWPFQR	ISHHWPFQR
ITTTINPR	IT-TTINPR
KTLPGPKIAR	KTLPPKIAR
STFEKKMQR	STFEKKMQR
YENEVALRQ	YENEVALRQ
SLKFHNELNLR	KFHNELNLR
KVRVSQRELSR	RVSQRELSR
KLFSTPSPVIR	KLFSSPVIR
ALRSGPSLR	ALRSGPSLR
RIREDIAKYLR	RIREAKYLR
RLRAVDFAER	RLRADFAER
RTKQEVLSLR	RTKQVLSLR
RTFLSKTGR	RTFLSKTGR
KAIPSSVRITR	AIPSVRITR
KSNLIVHQR	KSNLIVHQR
RVFKTVNR	RV-FKTVNR
KVSGDIFSR	KVSGDIFSR
KVLGPIHER	KVLGPIHER
RVWKHLTTK	RVWKHLTTK
RVNQQIRLR	RVNQQIRLR
KVQFRDPKSQR	VQFRPKSQR
RQYQMNKNFER	YQMNKNFER
SALPWSINR	SALPWSINR
LLYSHPTSR	LLYSHPTSR
KINLIIHQR	KINLIIHQR
RVTGVSSFR	RVTGVSSFR
VISNINITR	VISNINITR
ALNVITKKR	ALNVITKKR
RAKVEVNIPR	RAKVVNIPR
IQAGYSSPR	IQAGYSSPR
KSFQKIQVR	KSFQKIQVR
VLWRKGDIVR	VLWRGDIVR
RVLEDRALK	RVLEDRALK
KSANTEPYYR	SANTEPYYR
IAPTGHSL	IA-PTGHSL
RVAAWGGKLR	RVAAGGKLR
RIFSGAVTR	RIFSGAVTR
KVVAARAPR	KVVAARAPR
KLLDDEQPLR	KLLDEQPLR
RIRESFFR	RI-RESFFR
RLRDELRAVVR	RLRDRAVVR
KLQEYLGKFR	KLQELGKFR
VVKPQSVTVR	VVKPSVTVR
KLHVDPENFR	KLHVPENFR
MLNTVLYAR	MLNTVLYAR
KQKSSLIWR	KQKSSLIWR
RLDAVRHAR	RLDAVRHAR
VTYKYYVGR	VTYKYYVGR
KLWMKELQTQR	WMKELQTQR
ATLYLGWNR	ATLYLGWNR
SINQVVQLR	SINQVVQLR
KIQDSLGGRVR	KIQDSLGGR
RIKRHLLTQR	RIKRLLTQR
RVIAIRPIRR	RVIARPIRR
IINIRAGGSLR	NIRAGGSLR
AMKRGEPAIYR	KRGEPAIYR
KLAFSKVLR	KLAFSKVLR
RMKSLEQDALR	KSLEQDALR
ALRYYYNKR	ALRYYYNKR
RLILIESRIHR	ILIESRIHR
AIFTKAYQR	AIFTKAYQR
RLLAFAEARAR	RLLAFAEAR
AINAALAQR	AINAALAQR
RVQVQVVER	RVQVQVVER
RLFEQNVQR	RLFEQNVQR
RQKQQLVER	RQKQQLVER
SVNSVAVLR	SVNSVAVLR
RVQVVGTYR	RVQVVGTYR
RTNHIGWVR	RTNHIGWVR
RLPEPTTRLPR	RLPEPTTRL
KLQTPNTFPKR	KLQTNTFPK
RLFQTAITR	RLFQTAITR
AGLQRLSKER	GLQRLSKER
RLAVRTVIR	RLAVRTVIR
KIQKHQEHILR	IQKHEHILR
ATNAAVTVLR	ATNAVTVLR
SVSEVVVNR	SVSEVVVNR
KMQDVDLFIKR	KMQDLFIKR
RLNSKQLNR	RLNSKQLNR
RGSGLQLLPR	RGSGQLLPR
VLKDIVSQR	VLKDIVSQR
ALSHHLVAR	ALSHHLVAR
VLKTDEGIAYR	KTDEGIAYR
KVFSEASSLRR	KVFSASSLR
QVNKAPKMR	QVNKAPKMR
RLYTKFSAR	RLYTKFSAR
GSYSKAFAR	GSYSKAFAR
KQQGVLALR	KQQGVLALR
QPKIVKWDRDM	KI--VKWDR
LLRKGNYAER	LLRKNYAER
IVNENLVERF	IVNENLVER
GLFEKRRFR	GLFEKRRFR
RILKSPEIQR	ILKSPEIQR
TVKATGPALR	TVKAGPALR
VVYALKRQGR	VVYAKRQGR
RLYSENDRLR	RLYSNDRLR
ALAALIFRR	ALAALIFRR
KSQIVTNVR	KSQIVTNVR
AQIKATVKR	AQIKATVKR
RIREIELKNR	RIREELKNR
KQFFVAVER	KQFFVAVER
KLQSGKISR	KLQSGKISR
RLPELARVLR	RLPEARVLR
QTMFHHFQR	QTMFHHFQR
KTFSQSSKLIR	KTFSQSSKL
RTMKYTTATGR	TMKYTATGR
KLIEWENNRL	KLIEWENNR
RIYNGIGVSR	RIYNIGVSR
RMAWKSFTR	RMAWKSFTR
RIYSYVVSR	RIYSYVVSR
QTILHFPQNR	TILHFPQNR
RVYHYFQWR	RVYHYFQWR
RIGVITNR	RI-GVITNR
ALMDRDLVHR	ALMDDLVHR
QTKPVVVYR	QTKPVVVYR
VQKPPLNIQR	VQKPLNIQR
KQLGLPHQR	KQLGLPHQR
RMFEFQNFER	RMFEQNFER
MQIAWSREFLK	IAWSREFLK
KLEDGPKFLK	KLEDPKFLK
KLSPSPSSR	KLSPSPSSR
SLVNLGGSK	SLVNLGGSK
KVMELHKSYR	KVMEHKSYR
RLRHQELFR	RLRHQELFR
SMRDHIDYR	SMRDHIDYR
RVVGVTQPR	RVVGVTQPR
RLGQFLTKR	RLGQFLTKR
HLFDHVTVR	HLFDHVTVR
RVREKPPWR	RVREKPPWR
TMNEKAWKR	TMNEKAWKR
ASRPPVTLR	ASRPPVTLR
VLKVIVVMR	VLKVIVVMR
KQYEEVMVKR	KQYEVMVKR
RTLYERIVSR	TLYERIVSR
RSAPGGIRETR	RSAPIRETR
VLTGYIYPR	VLTGYIYPR
RMFLSFPTTK	RMFLFPTTK
ARVVIERIAR	RVVIERIAR
RTIRYLYRR	RTIRYLYRR
RVKQLQENRL	RVKQLQENR
KMLPERGQRVR	KMLPERGQR
KTVSLVLQR	KTVSLVLQR
RQATVAMMNR	RQATAMMNR
RLYQGHTLR	RLYQGHTLR
KLRIQEEIAKR	RIQEEIAKR
SLNLRTFLR	SLNLRTFLR
KQAGVAIGR	KQAGVAIGR
RTINVYPNFR	RTINYPNFR
KLQEALTSR	KLQEALTSR
KTKKGTDVMVR	KTKKDVMVR
ALRHPIQVSR	ALRHIQVSR
SVNELIYKR	SVNELIYKR
RVKLPSGSKK	RVKLSGSKK
RINELPSTMQR	RINESTMQR
QLQRRFKEFLR	LQRRKEFLR
RTLTPISGGQR	TLTPSGGQR
SVNNLMAKR	SVNNLMAKR
ILKGEYAVR	ILKGEYAVR
RLNMYRQKER	RLNMRQKER
RLWEAVKRR	RLWEAVKRR
RLREEVTKLR	RLREVTKLR
KSFYQFQHYR	KSFYFQHYR
KLWDGVSNR	KLWDGVSNR
ATFDRQELQR	ATFDQELQR
KSLLMGKEFQR	LLMGKEFQR
KTKQEVEISR	KTKQVEISR
KLQELKAILR	KLQEKAILR
KLNPRKIIR	KLNPRKIIR
RLMQESVRR	RLMQESVRR
RSLDVVGKIRR	RSLDVGKIR
RIATIVPRTER	ATIVPRTER
RLFLGPYKGR	RLFLPYKGR
KLMDVGLIAIR	KLMDLIAIR
RLWSLSYTK	RLWSLSYTK
RVTPAAANYR	RVTPAANYR
KTFEISIGR	KTFEISIGR
RLEERSSEFYR	RLEESEFYR
KVMDLSIVR	KVMDLSIVR
ALLGGRWLQPR	LLGGWLQPR
RLFHLHSQK	RLFHLHSQK
RIPPPKVHR	RIPPPKVHR
MMTPYVVTR	MMTPYVVTR
RIRTLKGKLAR	RTLKGKLAR
KLKDLGNLVLR	KLKDNLVLR
RLYVRVKTER	RLYVVKTER
STYYGSFVTR	STYYSFVTR
SINVHLSAR	SINVHLSAR
KIFAGKVLRL	KIFAGKVLR
KIAEHIAGR	KIAEHIAGR
RSHSIFSIR	RSHSIFSIR
STNFKLIYR	STNFKLIYR
RLYGNTPMRR	RLYGNTPMR
LVATHDYYR	LVATHDYYR
KTIDPKVAFPR	KTIDVAFPR
KLRTELPAGAR	RTELPAGAR
RTFGNDARFIR	RTFGNDARF
VLQRGLVAR	VLQRGLVAR
LLWASPPGR	LLWASPPGR
KQREQPEMVFR	REQPEMVFR
AIFSGISQR	AIFSGISQR
RLSDNPRAR	RLSDNPRAR
RVKVYTLNEDR	KVYTLNEDR
RANMPLHVR	RANMPLHVR
RLNARIGKMKR	RLNAGKMKR
RIIPGGVAER	RIIPGVAER
GLANGEVRIYR	LANGVRIYR
KVYTPVASR	KVYTPVASR
RMGLSMER	RM-GLSMER
RLWAGPRVQR	RLWAPRVQR
KTLHGSALFQR	TLHGALFQR
RVLEGFIKGR	RVLEFIKGR
KLASYQAAR	KLASYQAAR
HIQPGTVNR	HIQPGTVNR
RLISPYKKKQR	RLISPYKKK
RQIASIVQR	RQIASIVQR
IVRANLARV	IVRANLARV
KILEPGRRER	KILEGRRER
KSNLIVVQR	KSNLIVVQR
KQRDSEIMQQK	KQRDEIMQQ
TIVSTRHYR	TIVSTRHYR
RVIDEAKKWER	VIDEKKWER
KAKSIVFHR	KAKSIVFHR
STNPFRPQK	STNPFRPQK
RLGEALPGR	RLGEALPGR
AQYEDIAQK	AQYEDIAQK
EKQIKQLR	EK-QIKQLR
NVKVDPEIQ	NVKVDPEIQ
RTFNRGSHLTR	RTFNRGSHL
GLDKKVGAER	GLDKVGAER
TVFDAKRLIGR	TVFDRLIGR
FKQYANDNGVD	KQYANDNGV
RTQLYEYLQNR	QLYEYLQNR
VQAFVRHMQR	QAFVRHMQR
RVVLVEGKAR	RVVLEGKAR
RLTNVAVVR	RLTNVAVVR
VTYTEHAKR	VTYTEHAKR
VVDPHSFPR	VVDPHSFPR
SVKEISDIVQR	KEISDIVQR
RLFEWVVNR	RLFEWVVNR
RRFSLMTLR	RRFSLMTLR
RLTEGSERLPR	RLTEERLPR
KLIKEGDIVKR	LIKEDIVKR
RLKPDWVLR	RLKPDWVLR
RIRAPIMRMR	RIRAIMRMR
RIGVITNRER	RI-GVITNR
RTILFGVKR	RTILFGVKR
TVHRGPLPR	TVHRGPLPR
KLLEVWFSR	KLLEVWFSR
RSKDLRHAFR	RSKDRHAFR
TIMPKDIQLAR	IMPKIQLAR
RVFAAESIIKR	RVFASIIKR
RLLRKGNYSER	LLRKNYSER
MLMSTATAFYR	ST-ATAFYR
RVFRGRFQGR	RVFRRFQGR
KTNEHGMKTFR	KTNEMKTFR
KQINNIFYR	KQINNIFYR
IVKPVKVSAPR	IVKPVSAPR
KLRLITFNR	KLRLITFNR
SLADIMAKR	SLADIMAKR
KLFKDIGLSPR	KLFKGLSPR
RVYNIYIRR	RVYNIYIRR
RLKYPPFAK	RLKYPPFAK
AQNPSLFVK	AQNPSLFVK
RLLQTGQERAR	RLLQTGQER
RVYSPPEWISR	RVYSEWISR
SLAGGIWHGR	SLAGIWHGR
RLVESTSLR	RLVESTSLR
RLKPTNPAAQK	RLKPTNPAA
RMLERVIGR	RMLERVIGR
GTMSDVLRAER	TMSDLRAER
RTYSLGSALR	RTYSGSALR
KLYSLLFRR	KLYSLLFRR
RVSYKGSISYR	VSYKSISYR
KISGFPKNR	KISGFPKNR
KIKDFGEAAKR	KIKDEAAKR
ALQSGPPQSR	ALQSPPQSR
SVFNEHPSR	SVFNEHPSR
RIQNWLSAKVR	RIQNWLSAK
SIKKGNNAFR	SIKKNNAFR
KLKTVDVIVR	KLKTDVIVR
GMRPGVAYR	GMRPGVAYR
LQNVNITLR	LQNVNITLR
ILKSPGSVVFR	KSPGSVVFR
RLLVVYPWTQR	RLLVPWTQR
SLFDNPRTFSR	SLFDRTFSR
ALFASGLIHR	ALFAGLIHR
LVREIRQYR	LVREIRQYR
IIFVKSVQR	IIFVKSVQR
SLRPFVQKR	SLRPFVQKR
KSSDIAKTFR	KSSDAKTFR
RLWEREAVLVR	RLWEREAVL
RVKTPTSQSYR	KTPTSQSYR
RIKPPYANR	RIKPPYANR
RLRGSANAVR	RLRGANAVR
RMEEIEGFRYR	RMEEIEGFR
RMISKQFHH	RMISKQFHH
ALQEFSKVYR	ALQESKVYR
KQIASVMKHR	KQIAVMKHR
ASKNFSIKR	ASKNFSIKR
RSLALSPRL	RSLALSPRL
RLFQPNLNMDR	RLFQPNLNM
RYRPGTVALR	RYRPTVALR
HLRDFNFSRL	HLRDFNFSR
ATFGNMNNAVR	ATFGNMNNA
VVRDPAASQPR	VVRDPAASQ
RSQKPVMVKR	SQKPVMVKR
RQFQFKVKR	RQFQFKVKR
RIKRALDLNLK	RIKRLDLNL
RLLGKGGFAR	RLLGGGFAR
RQHQRFMAR	RQHQRFMAR
RTLMGPTRVFR	TLMGTRVFR
RLAQFIGNRR	RLAQFIGNR
RLNDKEGYVPR	RLNDGYVPR
RVLSGHLMQTR	VLSGLMQTR
RLNGLAAQR	RLNGLAAQR
KVVEDGILKLR	VVEDILKLR
HVHEPNPLR	HVHEPNPLR
SVNNSIFYR	SVNNSIFYR
RVSTSHQPLR	RVSTHQPLR
KLWEISTGR	KLWEISTGR
ILQQQVNPR	ILQQQVNPR
ALNEEIVNR	ALNEEIVNR
KLKETGYVVER	KLKEYVVER
KLLDWIEGKER	KLLDWIEGK
HLHQKGIIYR	HLHQGIIYR
RLKDKIPNVR	RLKDIPNVR
KQWDYYARR	KQWDYYARR
KQLNFVFTGR	KQLNVFTGR
RMFHIRAVILR	RMFHAVILR
SVRSGYSHLPR	RSGYSHLPR
RSKQGFPR	RS-KQGFPR
KSFGDLVSR	KSFGDLVSR
RLLEADSKSMR	RLLESKSMR
KVFHAERIVR	KVFHERIVR
LLKPPHPHHR	LLKPHPHHR
RLQAENRELR	RLQANRELR
RVMGIRVLR	RVMGIRVLR
RLKPFGVQR	RLKPFGVQR
SSKKVAFLR	SSKKVAFLR
KVWPLASGR	KVWPLASGR
RLNKRKEYMVR	RLNKEYMVR
IIHEIAVLEL	IIHEAVLEL
VVKPDQLIKRR	VVKPQLIKR
ALAPGLPTAR	ALAPLPTAR
KLTFEELER	KLTFEELER
HLFGGIAER	HLFGGIAER
RVQLHIFTGR	RVQLIFTGR
QLLKKEWLR	QLLKKEWLR
KVKAEGPGLSR	KVKAPGLSR
QLFRGSSLLFR	QLFRGSSLL
KSKPGQFIR	KSKPGQFIR
TMYPGLPSRL	TMYPGLPSR
TVNKSVIPR	TVNKSVIPR
MIWRGRSTYR	MIWRRSTYR
RLRELTSIVNR	RLRESIVNR
KTMPTTFNR	KTMPTTFNR
LKLGGRVKTWK	KLGGVKTWK
LLQKSFLRR	LLQKSFLRR
RTIAPIIGR	RTIAPIIGR
VLWDKIVLR	VLWDKIVLR
HINTVFVLR	HINTVFVLR
ATKQYALGR	ATKQYALGR
RLLETLFVHR	RLLELFVHR
IQKEQNYQR	IQKEQNYQR
IQFEPEEDIKR	IQFEEDIKR
RVAVVNQIAR	RVAVNQIAR
VTNAQAVLR	VTNAQAVLR
RLAGGDWFTSR	RLAGWFTSR
VLRKDIYQR	VLRKDIYQR
QLFSHTQLR	QLFSHTQLR
ATLLRPVLR	ATLLRPVLR
KLNIPAILR	KLNIPAILR
RSNPKIWNV	RSNPKIWNV
RLAELRQRQR	RLAERQRQR
QVFEKSPLR	QVFEKSPLR
KVTEKIPVR	KVTEKIPVR
HLQDLSGRISR	HLQDGRISR
IVQQFGYQR	IVQQFGYQR
STYIRLYGR	STYIRLYGR
RLRPLERPALR	RLRPRPALR
RVATVTRILR	RVATTRILR
RPVRGPLLR	RPVRGPLLR
ASQGFRFLR	ASQGFRFLR
RVQGEAQKVER	VQGEQKVER
KLFNGTFLK	KLFNGTFLK
TVQKETIHPR	VQKETIHPR
KLREGQNFIFR	KLRENFIFR
KTRLSKNLLR	KTRLKNLLR
GIKPEWMMIHR	GIKPMMIHR
RQRAILYKR	RQRAILYKR
NSRSRSPIQR	NSRSSPIQR
RVLSKAFSRL	RVLSKAFSR
RIQEAVYKNVR	RIQEAVYKN
HLYGFPQPR	HLYGFPQPR
TLRHYGYLR	TLRHYGYLR
RINVAVTR	RI-NVAVTR
RLQELNARRR	RLQELNARR
