Data	Data aligned
SVSPFLLGR	SVSPFLLGR
KYLDKELAGR	KYLDKELGR
SVLRGAALVPR	VLRGAALPR
KIRVPFLR	KIRVPFL-R
ILRDFFELR	ILRDFFELR
SFAAFLASR	SFAAFLASR
RVNILSDMHLR	RVNILSDLR
LQFPVGRVHR	LQFPVGRHR
KLQYELQYRNR	KLQYELQYR
FGGPVHHQAQR	GGPVHHQQR
TVLGYFIGR	TVLGYFIGR
KYLDEDTIYHL	KYLDEDTYH
HPGSFDVVHVK	GSFDVVHVK
VVINYTEQLLR	INYTEQLLR
ATNILTATR	ATNILTATR
SSKPLYLAR	SSKPLYLAR
ALFNTRIPR	ALFNTRIPR
ISDPYKVYR	ISDPYKVYR
ATFARIWYL	ATFARIWYL
VSYPFDTVR	VSYPFDTVR
KYLNWDAVFR	KYLNWDAFR
RLMKVFVTR	RLMKVFVTR
SVNELIYKR	SVNELIYKR
RSVAGLLPR	RSVAGLLPR
RVLTAPTLR	RVLTAPTLR
ATLSSIRHMIR	ATLSSIRHM
SLLPVDIRQYL	SLLPVDI-R
RAFVPQLR	RAFVPQL-R
AQKALDDIIYR	KALDDIIYR
SVVSVGWLR	SVVSVGWLR
YSNKEIFLR	YSNKEIFLR
KYLEESNFVHR	YLEESNFHR
RVKEPVKELLR	RVKEPVKLR
QALPSQAFIYR	ALPSQAFYR
LVFVPSLR	LVFVPSL-R
KVWVPKQK	KVWVPKQ-K
QVKIWFQNR	QVKIWFQNR
LTGPVMPVR	LTGPVMPVR
QYIRPVFVSR	QYIRPVFSR
SAFSILFNR	SAFSILFNR
RLNDTIQLLVR	RLNDTIQLL
RVMEVFLAQLR	RVMEVFLLR
AVADTVYRALR	VADTVYRLR
VLLGALWTSP	VLLGALWTS
SVYSWDIVVQR	YSWDIVVQR
TVSRFFLYR	TVSRFFLYR
HYGGLTGLNK	HYGGLTGNK
GTLDFYMARL	GTLDFYMAR
AGGDWFTSR	AGGDWFTSR
RLLPSLIGR	RLLPSLIGR
ITTVPPNLR	ITTVPPNLR
RTLKLSVQR	RTLKLSVQR
QFFYVPVKR	QFFYVPVKR
KTRDAILQLR	KTRDAILLR
HYTEAIKR	HYTEAIK-R
TVFDAKRLIGR	VFDAKRLGR
KYLAFLRKR	KYLAFLRKR
LYFPDFIVR	LYFPDFIVR
IDEPLEGSEDR	EPLEGSEDR
IYNFRIFER	IYNFRIFER
YKDAIHFYNK	KDAIHFYNK
RLLPLAPGRLR	RLLPLAPGR
DYFEQYGK	DYFEQYG-K
GTLQPPFTAR	TLQPPFTAR
KQRDDILINR	KQRDDILNR
VTKPNIPEAIR	KPNIPEAIR
GTRLPLVLR	GTRLPLVLR
TMYPGLPSRL	TMYPGLPSR
IGWMVSLRYR	GWMVSLRYR
RTMVDKLLSSR	TMVDKLLSR
AVIQVSQIVAR	IQVSQIVAR
RPPPEHFR	RPPPEHF-R
SVARLSQKFPK	ARLSQKFPK
RLLLPHNR	RLLLPHN-R
TAYRPPALR	TAYRPPALR
SLLPLTEANLR	SLLPLTENL
RNLIPVSR	RNLIPVS-R
RVLDALVAREK	RVLDALVAR
VLYDRQGIGR	VLYDRQGGR
VVIIVRAPR	VVIIVRAPR
VMFDKITSR	VMFDKITSR
KISAIIEKR	KISAIIEKR
VGVNGFGR	VGVNGFG-R
RLGQFLTKR	RLGQFLTKR
SQKPVMVKR	SQKPVMVKR
MTIMEDYFAYR	TIMEDYFYR
GINSILYQR	GINSILYQR
AWKSWTALR	AWKSWTALR
SFLNFGFANR	SFLNFGFNR
ATWAVPTVR	ATWAVPTVR
LDHKFDLMYAK	HKFDLMYAK
QSWVPLLSR	QSWVPLLSR
GTATRWPLAVR	ATRWPLAVR
QEFGLARFK	QEFGLARFK
RQAGLSYIR	RQAGLSYIR
AVVGAVVFQKR	VVGAVVFKR
RSFSLGVPRL	RSFSLGVPR
HHTFYNELR	HHTFYNELR
HLTGEFEK	HLTGEFE-K
SLKGVDPKFLR	KGVDPKFLR
YALYDATYETK	ALYDATYTK
RYLTVAAVFR	RYLTVAAFR
RYREDLDFVLR	REDLDFVLR
KVIPPIRSR	KVIPPIRSR
LGIHEDSQNR	GIHEDSQNR
RTLKPEGNILR	TLKPEGNLR
RLIGLPEGRAR	RLIGLPEGR
AIKIQSVYR	AIKIQSVYR
SQNSLFTFR	SQNSLFTFR
SLGLKFNK	SLGLKFN-K
GSYHPGVFR	GSYHPGVFR
RALPGLLEAR	RALPGLLAR
SLLKKNWQNVR	LLKKNWQVR
KTIDMELVKR	KTIDMELKR
SVSDIIRLR	SVSDIIRLR
AGFQRDLGSLR	FQRDLGSLR
RNLVPVQR	RNLVPVQ-R
SYVELSQYR	SYVELSQYR
RYQDILVFR	RYQDILVFR
RVHLPSSIYR	RVHLPSSYR
QVFNKLIRR	QVFNKLIRR
RLFPPLRQR	RLFPPLRQR
SLKIPNVER	SLKIPNVER
AGALFLHQR	AGALFLHQR
GLFSGLIPR	GLFSGLIPR
LKGDDLQAIKK	KGDDLQAKK
LINPQGKAFR	LINPQGKFR
QTYEKFLHR	QTYEKFLHR
KYFIRDEFLR	KYFIRDELR
ADKDYHFK	ADKDYHF-K
RSIPPLFSGR	RSIPPLFGR
IVNENLVER	IVNENLVER
VQVGPLPSRLR	VQVGPLPSR
KAMENLFINR	KAMENLFNR
RVFQGFFTGR	RVFQGFFGR
RYQKSTELLIR	KSTELLI-R
GTYYPPPRLR	TYYPPPRLR
ATAGIIGVNR	ATAGIIGNR
RVFAAESIIKR	FAAESIIKR
DRVYIHPF	DRVYIHP-F
RLKPFGVQR	RLKPFGVQR
QVRSIQQTMAR	RSIQQTMAR
RVHSIFVLRL	RVHSIFVLR
FSMGNEVLQNR	MGNEVLQNR
IYLPPEASSQR	IYLPPEAQR
GTMSDVLRAER	TMSDVLRER
ATLGAILNRL	ATLGAILNR
RTMWFAGGFHR	MWFAGGFHR
RFLDRFVYR	RFLDRFVYR
SYFSFSRNR	SYFSFSRNR
HIYYITGETK	IYYITGETK
LGNDFHTNKR	LGNDFHTKR
RVIWGKVTR	RVIWGKVTR
TALVIMWQK	TALVIMWQK
AVYDFFIGR	AVYDFFIGR
GVVPAGVILER	VVPAGVIER
RVKEYFVFR	RVKEYFVFR
KYVDTNLQKQR	KYVDTNLQK
MLRNLLALR	MLRNLLALR
RLFEWVVNRI	RLFEWVVNR
SFFSPSPARKR	SFFSPSPAR
RVLDLGPITR	RVLDLGPTR
KVIRVPPEK	KVIRVPPEK
KVLNLLWNL	KVLNLLWNL
GTQSFVFQR	GTQSFVFQR
GILVVGGVVWK	LVVGGVVWK
RSSIPITVR	RSSIPITVR
RSLQLQEHRL	RSLQLQEHR
QVIPRTPSSFR	IPRTPSSFR
KISLIQIFR	KISLIQIFR
AVIDVGINR	AVIDVGINR
RYFYLFPNRL	RYFYLFPNR
RGMNVPFKR	RGMNVPFKR
YEELQITAGR	EELQITAGR
SYLHENQIIHR	YLHENQIHR
LQFPVGRIHR	LQFPVGRHR
ATQTQFFHV	ATQTQFFHV
SAWYPFFR	SAWYPFF-R
KLKDQNIFVSR	KDQNIFVSR
KYFNSYTLTGR	YFNSYTLGR
AVVPGTLLLFR	AVVPGTLLL
QFPVGRVHR	QFPVGRVHR
KTLLDKALTQR	TLLDKALQR
SFSDYPPLGR	SFSDYPPGR
LTKVLKISD	LTKVLKISD
KFLDPITGTFR	KFLDPITFR
HRPELIDYGK	RPELIDYGK
STARHLYLR	STARHLYLR
SFMDPASALYR	SFMDPASAL
ATLTVEQLSSR	LTVEQLSSR
LPVLSPPRWPR	VLSPPRWPR
AVEDLRWFR	AVEDLRWFR
VVKLGDLGLGR	KLGDLGLGR
RTKRLVVFDAR	KRLVVFDAR
ALDPAKMNR	ALDPAKMNR
MDAKSLTAWSR	KSLTAWS-R
LLLPAASRPPR	LLLPAAS-R
TVIPATVVTSR	TVIPATVSR
AYLTLPSYR	AYLTLPSYR
LINNKIANR	LINNKIANR
AALPGIVHR	AALPGIVHR
LVKSTSQLLSR	KSTSQLLSR
SFKDYIQER	SFKDYIQER
KPFSQHVR	KPFSQHV-R
RYFNSKVPITR	YFNSKVPTR
ATGSIPITVR	ATGSIPIVR
SFISFANSR	SFISFANSR
SVLDYFSER	SVLDYFSER
AVWPVLRER	AVWPVLRER
IGGIGTVPVGR	GIGTVPVGR
SVSVQGIIIYR	SVQGIIIYR
SVQGIIIYR	SVQGIIIYR
KQFLPFLQR	KQFLPFLQR
ALVAGIDRYPR	LVAGIDRPR
ATIALMIQR	ATIALMIQR
VVLTLLSIFVR	LTLLSIFVR
SFITKVFRSR	SFITKVFSR
QLGQFLQHR	QLGQFLQHR
HLQDLSGRISR	QDLSGRISR
IGAEVYHNLK	IGAEVYHNL
ATATVYFKR	ATATVYFKR
RVSVVWVER	RVSVVWVER
VYFGGFFIR	VYFGGFFIR
VQNPALRLVTR	VQNPALRTR
SVHLQPITR	SVHLQPITR
QVAIKVIPR	QVAIKVIPR
VVYALKRQGR	VVYALKRGR
SVWPFLVQR	SVWPFLVQR
KVLSDDMKKLK	KVLSDDMKK
DKHIEEVR	DKHIEEV-R
FLFVPPQFR	FLFVPPQFR
RYYPQILTNK	RYYPQILNK
RVMGIRVLR	RVMGIRVLR
TVLPVPPLSVR	VLPVPPLVR
ALMDRGAIVR	ALMDRGAVR
THHNDTELIRK	HHNDTELIR
KGLDSFLNR	KGLDSFLNR
VVNPLFEKR	VVNPLFEKR
TQQEMMDAQLR	EMMDAQL-R
SSLLRTSIMSK	LLRTSIMSK
YRPGTVALR	YRPGTVALR
VVLPTFILEKR	VLPTFILKR
TVLQYVVGR	TVLQYVVGR
RLAVRTVIR	RLAVRTVIR
RYIPPIPVHR	RYIPPIPHR
KESYSVYVYK	ESYSVYVYK
TVLIIKSLR	TVLIIKSLR
RLIDVLENR	RLIDVLENR
GVLGSFIHR	GVLGSFIHR
RTMPLLSLHSR	RTMPLLSSR
RSLGELYFLPR	SLGELYFPR
RFVDFQKVR	RFVDFQKVR
NYKPLDTIWNR	KPLDTIWNR
GIPHLVTHDAR	HLVTHDA-R
QTFLRVQER	QTFLRVQER
STVARIQFR	STVARIQFR
VLSPPRWPR	VLSPPRWPR
RYLEVEPVSR	RYLEVEPSR
RQLFRILFR	RQLFRILFR
KQPFKDLGNLR	PFKDLGNLR
LLLPGELAK	LLLPGELAK
GGYRPVWNR	GGYRPVWNR
HVYDGKFLAR	VYDGKFLAR
RVLSIGLPVAR	LSIGLPVAR
STYIRLYGR	STYIRLYGR
RYRPGTVALR	RYRPGTVLR
TVQQLEGRWR	VQQLEGRWR
KFYSVNVDYSK	SVNVDYS-K
AARDFLQTFR	AARDFLQFR
SINLLLAQR	SINLLLAQR
RFNDLRFVGR	RFNDLRFGR
HSFRPAYR	HSFRPAY-R
VVKPDQLIKRR	VVKPDQLKR
RSWQGLEPRL	RSWQGLEPR
STYYGSFVTR	TYYGSFVTR
LQNEPLPERL	LQNEPLPER
VSNKWLHER	VSNKWLHER
AFHPQPVSR	AFHPQPVSR
RVTVPLVRR	RVTVPLVRR
TIRLLTSLR	TIRLLTSLR
KADIDLTKR	KADIDLTKR
RNTLFQLQR	RNTLFQLQR
STMYPGLPSRL	STMYPGLSR
ATLKDITRRL	ATLKDITRR
AMYPDYFAKR	AMYPDYFKR
KLKDLGNLVLR	KDLGNLVLR
RVKGPGISKF	RVKGPGISK
VYRNPESFKEK	VYRNPESFK
VLKVIVVMR	VLKVIVVMR
IYMDTLNIFMR	DTLNIFM-R
YGIPQRALR	YGIPQRALR
SVVLLPAGR	SVVLLPAGR
FYEEVHDLER	FYEEVHDER
AVRDILEGIQR	RDILEGIQR
HYLPAEILQKK	HYLPAEIQK
VLSAPGLRGFR	SAPGLRGFR
KYIDYIFNV	KYIDYIFNV
SFMPYHIQR	SFMPYHIQR
ITFSPPLPR	ITFSPPLPR
KVVEIVDEKVR	KVVEIVDEK
AVLKWNREMR	AVLKWNRMR
RNMEIPKGLIR	MEIPKGLIR
AQFGGKILR	AQFGGKILR
RYMDAWNTVSR	RYMDAWNSR
RQKFQILGR	RQKFQILGR
TSYLDKFFSR	SYLDKFFSR
RMFHIRAVILR	RMFHIRALR
RSGPFGQIFR	RSGPFGQFR
RLAPIPRAR	RLAPIPRAR
EGVHGGLINK	GVHGGLINK
AVIPRPEPMLR	AVIPRPELR
ADHGEPIGR	ADHGEPIGR
GIKPEWMMIHR	KPEWMMIHR
RTKLSLIMR	RTKLSLIMR
ALGAFLNHR	ALGAFLNHR
RSINQGLDRLR	SINQGLDLR
AVYPIDLVKTR	AVYPIDLVK
AGKPAFMGR	AGKPAFMGR
KGLEISGTFTR	LEISGTFTR
IVVPKAAIVAR	VPKAAIVAR
SYNYEIVNR	SYNYEIVNR
SLMSALAAR	SLMSALAAR
AVFPSIVGR	AVFPSIVGR
KVVNPLFEKR	KVVNPLFKR
SLNNFISQR	SLNNFISQR
LYVDFPQHLR	LYVDFPQLR
IYSGYIRNR	IYSGYIRNR
LFRPVASQLPR	RPVASQLPR
KVITMFVQR	KVITMFVQR
SMKSPLYLVSR	KSPLYLVSR
GTLNLDRVTR	GTLNLDRTR
KAIDYYLKALR	AIDYYLKLR
SYLDKFFSR	SYLDKFFSR
RVQPIKLAR	RVQPIKLAR
GTLSPAFSTR	GTLSPAFTR
GTVKWFNVR	GTVKWFNVR
RVYHYFQWR	RVYHYFQWR
SSFRFWQAR	SSFRFWQAR
VSWKTGVFR	VSWKTGVFR
RFINPLKNLR	RFINPLKLR
RTPELTWERVR	RTPELTWER
RLFVIRPSR	RLFVIRPSR
TYYPPPRLR	TYYPPPRLR
VAIPPDVLKSR	AIPPDVLSR
SLKALIQSR	SLKALIQSR
AVQEFGLARFK	AVQEFGLAR
RLFSIVRPR	RLFSIVRPR
ATLKDITRRLK	ATLKDITRR
TLYTQIRNR	TLYTQIRNR
KYVTDVGVLQR	VTDVGVLQR
SLQQLVSQR	SLQQLVSQR
IQPGSTVHVLR	PGSTVHVLR
YARVRAVVMTR	RVRAVVMTR
RGQVVSLIRMR	QVVSLIRMR
KLYELIITR	KLYELIITR
VQKPGFGVGR	VQKPGFGGR
RINELPSTMQR	RINELPSQR
YVKEQFAWR	YVKEQFAWR
KSFQKIQVR	KSFQKIQVR
ASQGFRFLR	ASQGFRFLR
KAFPYSSHLIR	KAFPYSSHL
KLQPPPLGR	KLQPPPLGR
SVQTALLNRL	SVQTALLNR
ILNLIPSTR	ILNLIPSTR
DIDIHEVR	DIDIHEV-R
QKHKDHFRL	QKHKDHFRL
RVLSKAFSRL	RVLSKAFSR
VMAPRTLIL	VMAPRTLIL
ATNAAVTVLR	ATNAAVTLR
TYLTKFIAR	TYLTKFIAR
RQLWRVIER	RQLWRVIER
AVKALWNLR	AVKALWNLR
KYLNPFFTR	KYLNPFFTR
RYKLLGGLAVR	KLLGGLAVR
RIEQHYFEDR	RIEQHYFDR
ASIDWLAQR	ASIDWLAQR
VVAPPGVVVSR	VVAPPGVSR
ASMPSRTIGR	ASMPSRTGR
HLPETKFSEL	HLPETKFEL
MYRNEFTAWYR	YRNEFTAYR
NGRPLEMIEPR	RPLEMIEPR
RYYDILKKR	RYYDILKKR
QLYDKGLVYR	QLYDKGLYR
VLNEGMPIYR	VLNEGMPYR
ATKPLYVAL	ATKPLYVAL
KLKDIVSLVPR	KLKDIVSPR
TIMPKDIQLAR	MPKDIQLAR
RQIDQFLVVAR	RQIDQFLAR
TVNTSLNVYR	TVNTSLNYR
LYQEVFGRLR	LYQEVFGLR
GTKQLQVLRF	GTKQLQVLR
GSMVPFSMR	GSMVPFSMR
KLLESIFHR	KLLESIFHR
VFPSIVGRPR	VFPSIVGPR
SHGIDLDHNR	HGIDLDHNR
RYIHLENLLAR	IHLENLLAR
KYQIFSGTSKR	QIFSGTSKR
GTQPTVLRTFR	TQPTVLRFR
VTLPVYFRER	VTLPVYFER
GALPGFLLKGR	ALPGFLLGR
KLLEVWFSR	KLLEVWFSR
RLSPVPVPR	RLSPVPVPR
AVFAGFEGR	AVFAGFEGR
ATLGAILNR	ATLGAILNR
KVHVIFNYK	KVHVIFNYK
QFFQRILER	QFFQRILER
LSKEDIER	LSKEDIE-R
SVREGQGFAFR	REGQGFAFR
NVGDWLRGVYR	GDWLRGVYR
RVIAIRPIR	RVIAIRPIR
KKVHPAVVIR	KVHPAVVIR
ILKHILTQR	ILKHILTQR
STERHRAEVR	STERHRAVR
IVNENLVERF	IVNENLVER
KEVVEEAENGR	VVEEAENGR
ALNGKIYFR	ALNGKIYFR
QVVGEATFIAR	VVGEATFAR
SFYQFQHYR	SFYQFQHYR
RVNIPKVLR	RVNIPKVLR
APDFVFYAPR	APDFVFYPR
GILGLGRIGR	GILGLGRGR
RTLGLLVKR	RTLGLLVKR
AYIHIVFSR	AYIHIVFSR
RVPELFANR	RVPELFANR
YLTVAAVFR	YLTVAAVFR
RLFWPFSKR	RLFWPFSKR
KSIANLIER	KSIANLIER
GSYVPPRRL	GSYVPPRRL
KQKSILYDER	KQKSILYER
AYRDAVFLAER	RDAVFLAER
KMKEALLSIGK	KEALLSIGK
RYIEIFKSSR	RYIEIFKSR
YEKDIAAYR	YEKDIAAYR
HTLEPLIPR	HTLEPLIPR
SVKEISDIVQR	KEISDIVQR
KIMLPPRNR	KIMLPPRNR
AYVPGFAHIPR	AYVPGFAPR
RTLTPISGGQR	RTLTPISGG
AIFLWLITR	AIFLWLITR
SVVSWKTGVFR	VSWKTGVFR
IALTDNALIAR	ALTDNALAR
AVANFIRQR	AVANFIRQR
LYISEGLHPR	LYISEGLPR
KVVNPYYLRVR	KVVNPYYLR
RMLERVIGR	RMLERVIGR
GVWKGLFAR	GVWKGLFAR
RGFQRDLSSLR	FQRDLSSLR
RALESELQQLR	ALESELQLR
KLWEISTGR	KLWEISTGR
VGRPPGPYTR	VGRPPGPTR
GSRYFALVER	GSRYFALER
RLWDFIENR	RLWDFIENR
STVPSILNR	STVPSILNR
DYGNSPLHR	DYGNSPLHR
AVVDVRIGMTR	VVDVRIGTR
HGGVIHIYVDK	GVIHIYVDK
RYIEIFPSRR	RYIEIFPSR
RVAQDWLKEAR	VAQDWLKAR
STFSGIKELAR	STFSGIKEL
ILQILSLNR	ILQILSLNR
RAPFDLFENRK	APFDLFENR
RFVNLISER	RFVNLISER
RSLDNFFAKR	RSLDNFFKR
IQQEMDLLRFR	QEMDLLRFR
RFTGSIFIGR	RFTGSIFGR
SVITQVFHV	SVITQVFHV
KVDENGKISRL	KVDENGKSR
HINTVFVLR	HINTVFVLR
GSFTLLWPSR	GSFTLLWSR
HAMQFPAELTR	MQFPAELTR
ILKSPGSVVFR	KSPGSVVFR
GVFTKLINR	GVFTKLINR
ASRPPVTLR	ASRPPVTLR
AAEYLYFFR	AAEYLYFFR
RVNKPPYPKL	RVNKPPYPK
LGIHEDSTNR	GIHEDSTNR
LGLPSTLFTPR	GLPSTLFPR
RQYAKDIGFIK	RQYAKDIGF
SSLNPILFR	SSLNPILFR
TVRVWDISGLR	RVWDISGLR
STKPPGTFLLR	STKPPGTFL
RSNPKIWNV	RSNPKIWNV
GHDFHEGVR	GHDFHEGVR
RSRYQDILVFR	RYQDILVFR
IGLGIYIGR	IGLGIYIGR
RYFALVERRL	RYFALVERR
TVLDPDLRMTF	TVLDPDL-R
RLIPDFPVAR	RLIPDFPAR
VVKDITNAFR	VVKDITNFR
VIFVKSVQR	VIFVKSVQR
ILIDPFHKAIR	ILIDPFHIR
TTKPAIIFR	TTKPAIIFR
FATHAAALSVR	ATHAAALVR
WGTLPPEPNLV	GTLPPEPNL
RVLDALVAR	RVLDALVAR
SIADRPLYLR	SIADRPLLR
KSFLPLIRR	KSFLPLIRR
AYIAGFVLQER	AYIAGFVER
ILRPEELGFLR	RPEELGFLR
HQQLYWSHPR	QQLYWSHPR
KFFLSHPAYR	KFFLSHPYR
KLYSLLFRR	KLYSLLFRR
ATYPYQVVR	ATYPYQVVR
RKVDWLTEK	RKVDWLTEK
IVRPFSIETK	IVRPFSITK
KVFLKYPESLR	FLKYPESLR
LRQFSDLWVR	RQFSDLWVR
KLNPYAKTMR	KLNPYAKMR
GTSQLYVYR	GTSQLYVYR
ASSYIAHLR	ASSYIAHLR
SVLWPWINR	SVLWPWINR
FHHTIGGSR	FHHTIGGSR
KINLIIHQR	KINLIIHQR
HTKAVNVVRF	HTKAVNVVR
RLYDVPANSMR	RLYDVPANS
FQLYPRNFLR	QLYPRNFLR
MLYGLIHAR	MLYGLIHAR
RSWKVFNER	RSWKVFNER
SVFDFQKAYK	SVFDFQKYK
KSKVPAFVR	KSKVPAFVR
GTMNLGGSLTR	TMNLGGSTR
RFKIDLGIFR	RFKIDLGFR
ALAPKFPEYR	ALAPKFPYR
AAQEEYVKR	AAQEEYVKR
RVLPPSALQSV	RVLPPSALQ
AMYPNIILTNR	MYPNIILNR
RVYNWDVKR	RVYNWDVKR
YSPHLLANSK	SPHLLANSK
HNKPEVEVR	HNKPEVEVR
RGLSYIHQR	RGLSYIHQR
ATSPIIIHR	ATSPIIIHR
SAIHIRVFR	SAIHIRVFR
SMFDVHVKR	SMFDVHVKR
KYLQEEVNINR	YLQEEVNNR
FHHTFSTEIAK	HTFSTEIAK
GTLGFGDKFKR	LGFGDKFKR
TYYGSFVTR	TYYGSFVTR
RVHSIFVLR	RVHSIFVLR
SVLGSLLYYSR	VLGSLLYSR
SYRKFLNLR	SYRKFLNLR
RAVFPSIVGR	AVFPSIVGR
KTNGKFLIR	KTNGKFLIR
EVVQITWNR	EVVQITWNR
ALNRITVWR	ALNRITVWR
TYLNILLQTR	TYLNILLTR
SMLEYFINR	SMLEYFINR
SIIGGGVKAPR	IGGGVKAPR
RVLDVGFVGR	RVLDVGFGR
SGKYDLDFK	SGKYDLDFK
GLANGEVRIYR	LANGEVRYR
TSYPFDTVR	TSYPFDTVR
SSLPALLFKAR	SSLPALLFK
VMKDFEEMR	VMKDFEEMR
IFYTAIVNR	IFYTAIVNR
AVMGAYVLLKR	AVMGAYVLL
GLKQVIIPR	GLKQVIIPR
IVIAFYEER	IVIAFYEER
LQFPDRSVQR	LQFPDRSQR
RYYTPTISR	RYYTPTISR
RIAPPDRRFSR	APPDRRFSR
SQTSSFFTR	SQTSSFFTR
AYVPFGAGRHR	AYVPFGAGR
RFWNKNIGSNR	WNKNIGSNR
AMFPKLNNQER	AMFPKLNER
FDAKRLIGR	FDAKRLIGR
KVWVKLIGR	KVWVKLIGR
TVLPKDILQER	LPKDILQER
ATFKDLLTR	ATFKDLLTR
HYASEEIKEK	YASEEIKEK
SLRLLTHQR	SLRLLTHQR
WHHTFYNELR	HTFYNEL-R
VQKPSYYVR	VQKPSYYVR
GTLDYILQR	GTLDYILQR
RVYSPPEWISR	VYSPPEWSR
KVRGISEVLAR	RGISEVLAR
TYYGSFVTRA	TYYGSFVTR
VYFKRFYAR	VYFKRFYAR
RNKDPILHVLR	RNKDPILLR
ISSIPINLR	ISSIPINLR
IVKGPRGTLR	IVKGPRGLR
RVLIGVGKLLR	VLIGVGKLR
ELLRPIDVATS	LLRPIDVTS
RIIVPLNNR	RIIVPLNNR
SVLRRFVVR	SVLRRFVVR
ALRALEGLVYR	RALEGLVYR
KLMDVGLIAIR	KLMDVGLIR
ALLEVMRMNR	ALLEVMRNR
VFLLWKNWR	VFLLWKNWR
ATRLGYFGR	ATRLGYFGR
TVRTAMSLIER	RTAMSLIER
AYFVPLVKR	AYFVPLVKR
SYSLFTALR	SYSLFTALR
VQKDIQPYMRR	VQKDIQPMR
SVLENFVGR	SVLENFVGR
RYRLPVATR	RYRLPVATR
GTFANIRLLNR	FANIRLLNR
KIWDPVHRVAL	KIWDPVH-R
SLWHIQISR	SLWHIQISR
KIIETPGIRAR	IIETPGIAR
KLLASLVKR	KLLASLVKR
TILIILTGR	TILIILTGR
SVKFGATLR	SVKFGATLR
KIRDLIAIER	KIRDLIAER
SVINPGAIYR	SVINPGAYR
YLQHHHFHQER	QHHHFHQER
AGISFIIKR	AGISFIIKR
VQVSPLIKLGR	QVSPLIKGR
GGYPYSFWIGR	GYPYSFWGR
VQKPSYYVRL	VQKPSYYVR
KGVDPKFLR	KGVDPKFLR
RLKDSWVER	RLKDSWVER
KLNIRPLLR	KLNIRPLLR
ITNHIHVR	ITNHIHV-R
QGVDADINGLR	GVDADINLR
KLKWIVSGR	KLKWIVSGR
QQLYWSHPR	QQLYWSHPR
AQWQKVLPR	AQWQKVLPR
GYLHWVNER	GYLHWVNER
VVKPDQLIKR	VVKPDQLKR
SILLWATQR	SILLWATQR
VGQYPRFLR	VGQYPRFLR
ATQPWNRIQR	ATQPWNRQR
KFFTESRLLQR	FTESRLLQR
LAQFHFTNR	LAQFHFTNR
KTIDPKVAFPR	KTIDPKVPR
LQKPVLPLYR	LQKPVLPYR
MVVPAALKVVR	VVPAALKVR
SAPKINLEIEL	APKINLEEL
KYFLGQSVLR	KYFLGQSLR
RSLNPPLTIVR	SLNPPLTVR
VQKPPLNIQR	VQKPPLNQR
KVKAPPSVPR	KVKAPPSPR
KLYPLPSAR	KLYPLPSAR
YVFPKPFNR	YVFPKPFNR
ILRTEQWPR	ILRTEQWPR
KYYKYILTR	KYYKYILTR
KTLAGDVHIVR	LAGDVHIVR
DHYEATAMHR	DHYEATAHR
RVVQQEEGWFR	VQQEEGWFR
STNFKLIYR	STNFKLIYR
RTQLYEYLQNR	QLYEYLQNR
RVKTVWLVGR	RVKTVWLGR
RSLVPQLR	RSLVPQL-R
SLQHANHEKR	SLQHANHKR
QTQSIYIPR	QTQSIYIPR
GSLTRLLDSVR	LTRLLDSVR
GFGFVLFK	GFGFVLF-K
RSQVFNILR	RSQVFNILR
RVQVVGTYR	RVQVVGTYR
KYITDWQNVFR	YITDWQNFR
GYDDRDYYSR	GYDDRDYSR
RFYDRRFLK	RFYDRRFLK
HSVHTLVFR	HSVHTLVFR
RQINWTVLYRR	RQINWTVYR
VYIEKFVRR	VYIEKFVRR
RALAMLQRFS	RALAMLQ-R
SHEGETAYIR	SHEGETAIR
RTLPAWIREGL	RTLPAWI-R
STLNKLIKR	STLNKLIKR
RVWDISGLRKK	RVWDISGLR
RSFGHFIARL	RSFGHFIAR
IMSSPLSKELR	SSPLSKELR
RIFTSVPKR	RIFTSVPKR
LQNVNITLR	LQNVNITLR
RQTGIVLNR	RQTGIVLNR
TSKLYSLLFRR	KLYSLLFRR
EHQHEEIQNVR	HQHEEIQVR
MSIPVTMRAIR	SIPVTMRIR
SVLTPLLLR	SVLTPLLLR
RTKLETVLALR	KLETVLALR
VVYPKVIER	VVYPKVIER
KVNIPFVRL	KVNIPFVRL
ATRPFQLVTGR	RPFQLVTGR
TTLTKIALR	TTLTKIALR
QYLDPAQRGVR	QYLDPAQ-R
TSSGIKVPPR	SSGIKVPPR
SVYIPAHGR	SVYIPAHGR
ALHHGIDLEK	ALHHGIDEK
AIWSGAALRAR	AIWSGAALR
MTILQTYFR	MTILQTYFR
KVQTFPFLGR	KVQTFPFGR
SLLQPLNVEID	SLLQPLNEI
AFRNLVPVTR	AFRNLVPTR
RLFEQNVQR	RLFEQNVQR
AYKSILQER	AYKSILQER
GTGWGENGYFR	TGWGENGFR
IQVWHEEHR	IQVWHEEHR
KPHTLLQR	KPHTLLQ-R
SVLNFATNR	SVLNFATNR
GAIRDIDLKNR	AIRDIDLNR
KTILKRLFR	KTILKRLFR
KVLRPFLLR	KVLRPFLLR
RVLEKLGVTVR	RVLEKLGVR
RVIIEKYYTR	RVIIEKYTR
HFSVEGQLEFR	SVEGQLEFR
KTKEYIFLRL	KTKEYIFLR
VFLPQAIRHLK	VFLPQAI-R
LIRKLPFQR	LIRKLPFQR
SGYPPFVGR	SGYPPFVGR
VQKDIQPYMR	VQKDIQPMR
RVNLKFLTR	RVNLKFLTR
SVSTITRIYR	SVSTITRYR
FPSIVGRPR	FPSIVGRPR
ILKEILQKR	ILKEILQKR
ATIELKALR	ATIELKALR
TFYSISQER	TFYSISQER
ASMPWGDPNYR	ASMPWGDYR
QLLKKEWLR	QLLKKEWLR
IGQSKVFFR	IGQSKVFFR
RTLIPRYFR	RTLIPRYFR
ATLLIVNR	ATLLIVN-R
GKLEEQRPER	KLEEQRPER
VYVNYTILKPR	VNYTILKPR
KYIERIITRF	KYIERIITR
ATFQFTVERF	ATFQFTVER
KTFTIKRFLAK	KTFTIKRFL
RVFSVAELQSR	FSVAELQSR
SIMKWNRER	SIMKWNRER
LSLPGITNR	LSLPGITNR
RLQQLRELR	RLQQLRELR
RSKYDYLMILR	KYDYLMILR
SFLPRKFPSLR	SFLPRKFLR
RSMVQFIGR	RSMVQFIGR
ITVKLTIQNR	TVKLTIQNR
ISFDEFIK	ISFDEFI-K
RTAALPTFR	RTAALPTFR
RIFPVDKSRSR	RIFPVDKSR
KTKADGSFRL	KTKADGSFR
MQIAWSREFLK	IAWSREFLK
RSHSIFSIR	RSHSIFSIR
KTLPKIVGR	KTLPKIVGR
VQKLPMIGR	VQKLPMIGR
RITVKLTIQNR	TVKLTIQNR
TYFPSFLSR	TYFPSFLSR
AVFYTFVFR	AVFYTFVFR
KVFLFIRNR	KVFLFIRNR
KQQGVLALR	KQQGVLALR
GTLGGMLTR	GTLGGMLTR
RLLDFLQKR	RLLDFLQKR
VREEEIEVDSR	REEEIEVSR
ATSPALFNR	ATSPALFNR
RLKIGFILR	RLKIGFILR
AQNPSLFVK	AQNPSLFVK
RVYNIYIRR	RVYNIYIRR
VNLPINGNGKQ	VNLPINGGK
HTRTPPIIHR	HTRTPPIHR
RQKFGYSVNR	RQKFGYSNR
RILKSPEIQR	ILKSPEIQR
SVLSRINQR	SVLSRINQR
GVNQLKFAR	GVNQLKFAR
SLKGIPTLVYR	KGIPTLVYR
SVLNMVVRR	SVLNMVVRR
VTIVNILTNR	VTIVNILNR
RSFSLGVPR	RSFSLGVPR
RLFEWVVNR	RLFEWVVNR
RARPSLTVTPR	RARPSLTPR
RTIAPIIGR	RTIAPIIGR
LIKPPTILR	LIKPPTILR
KAWSPVFR	KAWSPVF-R
LYRKMEIYR	LYRKMEIYR
RFKEPLPEYVR	RFKEPLPVR
GVMTVLIKR	GVMTVLIKR
QLYPRNFLR	QLYPRNFLR
RLFGALLER	RLFGALLER
SMIRLSEAMAR	RLSEAMA-R
AVKLERMLTER	VKLERMLER
RAGLQFPVGR	AGLQFPVGR
AVKGYFTLR	AVKGYFTLR
SVTPEGVIKQR	VTPEGVIQR
RTMALPVGR	RTMALPVGR
KSLPGVVTR	KSLPGVVTR
AVMAESAFSFK	AVMAESASF
ALAALIFRR	ALAALIFRR
EVVEEAENGR	VVEEAENGR
ATWLPQRR	ATWLPQR-R
ATLSILAVR	ATLSILAVR
RLRELTSIVNR	RELTSIVNR
KAFDRITTR	KAFDRITTR
RTLLVADPR	RTLLVADPR
ATYPYQVVRAR	ATYPYQVVR
QIVSVAARMLK	QIVSVAA-R
SVNSLLKELR	SVNSLLKLR
KGLEFVLIHQR	KGLEFVLQR
SLNLRTFLR	SLNLRTFLR
LVFPSEIVGKR	LVFPSEIGK
RFIKIDGKVR	RFIKIDGVR
RVGDVYIPR	RVGDVYIPR
QVHPDTGISSK	VHPDTGISK
AVFPFKPPQR	AVFPFKPQR
KLIKEGDIVKR	LIKEGDIKR
STFIHAEDFAR	FIHAEDFAR
STKPGSYIFRL	STKPGSYFR
RYIPPHLRNR	RYIPPHLNR
KLLGGLAVR	KLLGGLAVR
HSQDLSGRLR	HSQDLSGLR
AYLAWRLAR	AYLAWRLAR
LEKHELIEFR	LEKHELIFR
VGMNFKTPR	VGMNFKTPR
GQKPGGSDFLR	KPGGSDFLR
RVFNETPINPR	VFNETPIPR
AVFPSIVGRPR	AVFPSIVGR
KAKQGYVIYR	KAKQGYVYR
KYPVWLWKR	KYPVWLWKR
KFKESFAEMNR	KFKESFANR
ALLGGRWLQPR	LGGRWLQPR
RLFNAIIHR	RLFNAIIHR
QYIQVNEPWKR	IQVNEPWKR
KSKDFVQVMR	KSKDFVQMR
KTFSEILNR	KTFSEILNR
VMKPPQVVR	VMKPPQVVR
SLQNAESWINR	LQNAESWNR
AFKDIPVQR	AFKDIPVQR
VSLPSFFER	VSLPSFFER
RVLDTNDRFLR	DTNDRFL-R
HIEIFTDLSSR	EIFTDLSSR
GIWLRYDSR	GIWLRYDSR
AGNYAWVNR	AGNYAWVNR
TTLPDDMITQR	TLPDDMIQR
AFWIPFIYR	AFWIPFIYR
AIVPIGYHVPR	IVPIGYHPR
SVLPFDGDFAR	LPFDGDFAR
RYVASYLLAAL	YVASYLLAL
TVMGAEIRHVL	TVMGAEI-R
FHVEEEGKGK	HVEEEGKGK
MVKPTPGLTPR	KPTPGLTPR
AERRQLLPR	AERRQLLPR
RMFAPTKTWR	RMFAPTKWR
KYVDLGLGTHR	VDLGLGTHR
EHIKNPDWR	EHIKNPDWR
KIPDWFLNR	KIPDWFLNR
IENALITQSR	IENALITSR
NTTAVAEAWAR	TAVAEAWAR
RTLDPSWLR	RTLDPSWLR
VFDAKRLIGR	VFDAKRLGR
ENKKHHSTIVY	KHHSTIV--
SGKIIFVGR	SGKIIFVGR
RYMTPEDFVQR	MTPEDFVQR
FPVGRIHR	FPVGRIH-R
IVKPVKVSAPR	IVKPVKVPR
RLRAVDFAER	RLRAVDFER
KTSDFLKVLNR	SDFLKVLNR
LYIDRFLGGV	LYIDRFLGG
GSHIPGWFR	GSHIPGWFR
RLWDLQQLR	RLWDLQQLR
SVIPHQKLFTR	IPHQKLFTR
IYLPEVVKPPR	IYLPEVVPR
AIKSVKIYR	AIKSVKIYR
ELSDIAHR	ELSDIAH-R
VKEVLPHVPLG	KEVLPHVPL
HSMDFVAYR	HSMDFVAYR
MSMEISIHR	MSMEISIHR
AVTAFVTFR	AVTAFVTFR
TVKWFNVR	TVKWFNV-R
RLFDIKPEQQR	RLFDIKPQR
RLYTKFSAR	RLYTKFSAR
KTKESLDVSRL	KTKESLDSR
WSRINPNKAR	RINPNKA-R
STKDTVVSRSW	STKDTVVSR
GVNGFGRIGR	GVNGFGRGR
SFFGERRIPR	SFFGERRPR
TTFTWNINHAR	FTWNINHAR
RVVIKQIITSR	VVIKQIISR
GSRSFIINR	GSRSFIINR
KVFPEDMAKYR	KVFPEDMAK
ATIGHVEKFLR	IGHVEKFLR
KLFSVTRNR	KLFSVTRNR
ATRWPLAVR	ATRWPLAVR
VFKEEGVLR	VFKEEGVLR
AAWYSGVNR	AAWYSGVNR
QGYSDFINR	QGYSDFINR
SYVRWEGVFR	YVRWEGVFR
SNLPAKAIGHR	LPAKAIGHR
ASIPHVIAR	ASIPHVIAR
FEELNADLFR	ELNADLF-R
GLQLRIATR	GLQLRIATR
HSMALIHNR	HSMALIHNR
ATIVDLVER	ATIVDLVER
SQRQAIQQLR	SQRQAIQLR
LHPFHVIR	LHPFHVI-R
AVQEFGLAR	AVQEFGLAR
ATSPIIIHRL	ATSPIIIHR
LLNAVIVQR	LLNAVIVQR
GTIHIFRVR	GTIHIFRVR
SVLKELQNR	SVLKELQNR
FTDEEVDELYR	DEEVDELYR
ASGDWFTSR	ASGDWFTSR
QQFGSRFLR	QQFGSRFLR
KVKVGVNGFGR	KVGVNGFGR
KWYEKFFGR	KWYEKFFGR
AVRPKVLMR	AVRPKVLMR
GTWNWIWRR	GTWNWIWRR
RIGVITNRER	RIGVITNER
HANPRLWLR	HANPRLWLR
NVRETHSLFFR	RETHSLFFR
RSAALSWLR	RSAALSWLR
SMRPPIIIHR	SMRPPIIHR
RLVYLNEAWKR	VYLNEAWKR
RTVLVIAHRL	RTVLVIAHR
ATMVPSVLWPR	MVPSVLWPR
MSRFLNVLR	MSRFLNVLR
IDTIEIITDR	DTIEIITDR
FSSVFQFLR	FSSVFQFLR
ASKEPFYVR	ASKEPFYVR
SYPSLFIFR	SYPSLFIFR
HYYDGTIFHR	HYYDGTIHR
MVNVPKTR	MVNVPKT-R
RALLQQCLHAR	ALLQQCLAR
AGISFIINR	AGISFIINR
AGMDASFKAFR	GMDASFKFR
LVKPVTINVGR	LVKPVTIGR
LLQDFFNGK	LLQDFFNGK
RIMDRFNLPR	RIMDRFNPR
SIPTFYFPR	SIPTFYFPR
KSLDQAISRF	KSLDQAISR
LLWKDKKIG	LLWKDKKIG
RTYKYFKDYR	RTYKYFKYR
YGKLLKLPTCW	KLLKLPT--
ATNILNKLRAR	ATNILNKLR
KQRPYTFLLPR	RPYTFLLPR
RVITALVER	RVITALVER
RIIEKVIHR	RIIEKVIHR
ATFQFTVER	ATFQFTVER
VVTDPAFLVTR	VTDPAFLTR
AIRDIDLKNRR	AIRDIDLNR
TTKDIILPFR	TTKDIILFR
RLLETLFVHR	RLLETLFHR
TVFSPTLPAAR	VFSPTLPAR
RTIALLIGR	RTIALLIGR
ALRDFTRLFR	ALRDFTRFR
KSLPSEVERLR	KSLPSEVER
AFKPILSTR	AFKPILSTR
ATNWDLIGR	ATNWDLIGR
IANPNVPAYR	IANPNVPYR
VTLIPAFR	VTLIPAF-R
KVMGILINR	KVMGILINR
ATVPRLAER	ATVPRLAER
ATVQQLEGRWR	ATVQQLEGR
GTADVHFER	GTADVHFER
RYISKMFLR	RYISKMFLR
VTWIHPVTR	VTWIHPVTR
TTFVPMLHR	TTFVPMLHR
KFKFPGRQK	KFKFPGRQK
VSEIDWLKRIR	SEIDWLKIR
QYKFPVVITR	QYKFPVVTR
QTRSLPATPSK	RSLPATPSK
IWHHTFYNELR	HTFYNEL-R
EIIDLVLDR	EIIDLVLDR
GTYVSSVPR	GTYVSSVPR
DRVYIHPFHL	RVYIHPFHL
GVMPSHFSR	GVMPSHFSR
NAPWAVTSL	NAPWAVTSL
RMLPPLTKNQR	RMLPPLTQR
SLNPKTWGR	SLNPKTWGR
LALDESLFRGR	ALDESLFGR
SVVAVPLPLHR	VAVPLPLHR
SVFSKYFER	SVFSKYFER
KLFVGFLNR	KLFVGFLNR
LDQELKLFVSR	QELKLFVSR
RSLPFFSAR	RSLPFFSAR
YYLPYYKRER	YYLPYYKER
GTILIILTGR	GTILIILGR
YENEVALRQ	YENEVALRQ
RIWQSPRFIAR	WQSPRFIAR
MLRLPTVFR	MLRLPTVFR
AQIFRVNLR	AQIFRVNLR
RYIEIFPSR	RYIEIFPSR
AVLDVANHFSR	AVLDVANHF
ATTPIFANR	ATTPIFANR
RTNIFQIQR	RTNIFQIQR
VYITNFHVR	VYITNFHVR
TLVLLMGK	TLVLLMG-K
RVKVFGWVH	RVKVFGWVH
QQQIVRVLR	QQQIVRVLR
SVREVRQLTLR	REVRQLTLR
IREEYPDR	IREEYPD-R
SFRYNGLIHR	RYNGLIH-R
SGLSIFIYR	SGLSIFIYR
FPVGRVHR	FPVGRVH-R
RYQQFKDFQR	RYQQFKDQR
KLNIDSIIQR	KLNIDSIQR
GTLAAQALRAR	GTLAAQALR
AYAEYVIYR	AYAEYVIYR
AVKVHSFPTLK	KVHSFPTLK
LALNIIQNR	LALNIIQNR
ILRKILGKFY	ILRKILGKF
ALWDRYMGTLR	ALWDRYMLR
QLMPALVQR	QLMPALVQR
RAKVEVNIPR	RAKVEVNPR
TSWVPLVSR	TSWVPLVSR
KYIERIITR	KYIERIITR
KISGFPKNR	KISGFPKNR
SMSSTFFSR	SMSSTFFSR
QVYVPPILR	QVYVPPILR
RYQQFKDFQRR	QQFKDFQRR
SVYQIKVHR	SVYQIKVHR
VTLTIFVAR	VTLTIFVAR
LTKLPAFAR	LTKLPAFAR
RTWEKLLLAAR	RTWEKLLAR
KVVEDGILKLR	VVEDGILLR
RVLQPGALPDR	RVLQPGALP
QVKTWFQNR	QVKTWFQNR
VSIGLTIRNRG	VSIGLTINR
QGNRLFVGR	QGNRLFVGR
GLFTGLTPR	GLFTGLTPR
IGSLQHIKSR	GSLQHIKSR
KVLQLLRLR	KVLQLLRLR
KYLSVQGQLFR	SVQGQLF-R
ITFPAMVHR	ITFPAMVHR
ALQLIVTAR	ALQLIVTAR
RALGVRDLSYR	ALGVRDLYR
PSIVGRPR	PSIVGRP-R
AGFAGDDAPR	AGFAGDDPR
SLMHSFILKAR	SLMHSFILK
VLNPTPIKR	VLNPTPIKR
GYSFTTTAER	YSFTTTAER
VIIEKYYTR	VIIEKYYTR
DSYVGDEAQSK	YVGDEAQSK
ALMDRDLVHR	ALMDRDLHR
LAVNMVPFPR	AVNMVPFPR
RVQEAVESMVK	RVQEAVESM
RVYIHPFHL	RVYIHPFHL
