Data	Data aligned
NRFNYPFEL	NRFNYPFEL
AYKNVKFVL	AYKNVKFVL
VRANLPQSF	VRANLPQSF
SRVETPVSY	SRVETPVSY
FRPEWQSVY	FRPEWQSVY
LLPSHPLEL	LLPSHPLEL
TRNPLVAVY	TRNPLVAVY
SYPDFLRMM	SYPDFLRMM
TRNDYVMMY	TRNDYVMMY
IYQELVTKY	IYQELVTKY
YYDVEPFLF	YYDVEPFLF
QRNEVVVEL	QRNEVVVEL
KRVEDAYIL	KRVEDAYIL
YYDLQEVLL	YYDLQEVLL
IKPETILYY	IKPETILYY
AYPEVRIVL	AYPEVRIVL
AYHELAQVY	AYHELAQVY
TYPEVVRMV	TYPEVVRMV
RYDDMATCM	RYDDMATCM
HRSPLVLAY	HRSPLVLAY
FKGQNPFEL	FKGQNPFEL
IYYFKANVF	IYYFKANVF
HRFYMFHSF	HRFYMFHSF
TYDNVHQQF	TYDNVHQQF
NRLFHKTVY	NRLFHKTVY
SYRDSYDSY	SYRDSYDSY
YYYARPQTL	YYYARPQTL
SRPYAFLEF	SRPYAFLEF
FRQQRPLEF	FRQQRPLEF
KYAGSALQY	KYAGSALQY
IRKPYIWEY	IRKPYIWEY
MRAENFFIL	MRAENFFIL
VYPLYTIVF	VYPLYTIVF
IRPEIHENY	IRPEIHENY
KYKDIYTEL	KYKDIYTEL
KYFGGVLEY	KYFGGVLEY
YRNKFTQKY	YRNKFTQKY
SRSPYSPVL	SRSPYSPVL
FRPLYTHEY	FRPLYTHEY
FYHPETTQL	FYHPETTQL
VYDLSIRGF	VYDLSIRGF
VRNDIYITL	VRNDIYITL
YYFVFDHAL	YYFVFDHAL
QRKGAGSVF	QRKGAGSVF
LYDGEFREF	LYDGEFREF
YRRNKSYSF	YRRNKSYSF
IYPYVIQEL	IYPYVIQEL
YYDDFLQRL	YYDDFLQRL
SNPGGRPAL	SNPGGRPAL
YRVHSIFVL	YRVHSIFVL
NRPEFITEF	NRPEFITEF
SRKTFSHEL	SRKTFSHEL
SRQVGERTL	SRQVGERTL
KYKDSYNVF	KYKDSYNVF
NYPGLSISL	NYPGLSISL
LRADLAEEY	LRADLAEEY
FYDDKKYTY	FYDDKKYTY
VYPGIAVFF	VYPGIAVFF
SKSPFIVHL	SKSPFIVHL
TRPPALLLL	TRPPALLLL
SRPPVTLRL	SRPPVTLRL
AAPATRAAL	AAPATRAAL
VYGTRLVVL	VYGTRLVVL
HYKPTPLYF	HYKPTPLYF
VSPLATSAL	VSPLATSAL
YLPYRDYNY	YLPYRDYNY
FRLDTPLYF	FRLDTPLYF
KKEDLVFIF	KKEDLVFIF
HRSWWVYTL	HRSWWVYTL
VYPPPHQVF	VYPPPHQVF
ARPEEPIAF	ARPEEPIAF
NRLLEATSY	NRLLEATSY
SRVHAALVY	SRVHAALVY
NRPTNSIVF	NRPTNSIVF
SYPTTTISY	SYPTTTISY
SYRDSYESY	SYRDSYESY
SYPGSSYIF	SYPGSSYIF
ARAGVSQVL	ARAGVSQVL
SRIQYEMEY	SRIQYEMEY
SRGDVKVIM	SRGDVKVIM
QYYALEVSY	QYYALEVSY
YKIPYTTVL	YKIPYTTVL
YKLDNQFEL	YKLDNQFEL
YYRAWQEYY	YYRAWQEYY
GKIDFLNNY	GKIDFLNNY
IRQDNERVL	IRQDNERVL
FYSEVHPHY	FYSEVHPHY
AYHGLTVPL	AYHGLTVPL
MKPLVVFVL	MKPLVVFVL
FRKSMVEHY	FRKSMVEHY
VRPLLSASY	VRPLLSASY
FYEDNVLYM	FYEDNVLYM
IRPQVVTTF	IRPQVVTTF
RRFDTAFFL	RRFDTAFFL
YRMDGHIQL	YRMDGHIQL
NRIHYNIFY	NRIHYNIFY
RRNDKIIVF	RRNDKIIVF
SRFIKFQEM	SRFIKFQEM
FYDQRQVLL	FYDQRQVLL
ILTERGYSF	ILTERGYSF
VRPPQIKSL	VRPPQIKSL
IYKELLISL	IYKELLISL
VRNAVTQEF	VRNAVTQEF
YRYPGGESY	YRYPGGESY
IRDNFVIIY	IRDNFVIIY
RRNPGVVIY	RRNPGVVIY
NYFGAQPHY	NYFGAQPHY
VRTPYTMSY	VRTPYTMSY
FRLEQGYEL	FRLEQGYEL
NRPGTVSSL	NRPGTVSSL
AYPEYLITY	AYPEYLITY
FRNLHTIVL	FRNLHTIVL
FYQRFPLSF	FYQRFPLSF
VRSPVVHSV	VRSPVVHSV
HRPEATPSM	HRPEATPSM
MRPDLELQF	MRPDLELQF
FRSDSSFNF	FRSDSSFNF
MRTRVNKEM	MRTRVNKEM
NRPPSSTEL	NRPPSSTEL
HRKDYINAY	HRKDYINAY
FYMDTSHLF	FYMDTSHLF
NAPWAVTSL	NAPWAVTSL
KRPVFIFEW	KRPVFIFEW
IRPGTAFEL	IRPGTAFEL
KYKDAIHFY	KYKDAIHFY
IYDEDEVLL	IYDEDEVLL
MRSLLRTPF	MRSLLRTPF
LRPPIMIMM	LRPPIMIMM
TRLYPVFFL	TRLYPVFFL
FYNERVVIM	FYNERVVIM
KYGNQLVRL	KYGNQLVRL
VYPQYVIEY	VYPQYVIEY
VHAFPELFL	VHAFPELFL
KRNDYVHAL	KRNDYVHAL
FKNPEPELL	FKNPEPELL
YYGNRAATL	YYGNRAATL
FRPPNPWTM	FRPPNPWTM
AYTPFHAVL	AYTPFHAVL
YYRAIQFYL	YYRAIQFYL
VRPTYCLEY	VRPTYCLEY
FRSEPALYF	FRSEPALYF
TRNPVSEEL	TRNPVSEEL
HRHPDAFYL	HRHPDAFYL
LRHDRPYTL	LRHDRPYTL
KYHGFGNVH	KYHGFGNVH
ERNPAVYNF	ERNPAVYNF
GAPVAAAAL	GAPVAAAAL
IRHPNIITL	IRHPNIITL
LYDPCTVMF	LYDPCTVMF
IHSPVVNEL	IHSPVVNEL
ARGLLEEQY	ARGLLEEQY
NRAEYYHLL	NRAEYYHLL
NRPNDVYAY	NRPNDVYAY
YRFDPRSGP	YRFDPRSGP
YYPEYKLLF	YYPEYKLLF
VYPPLKGSF	VYPPLKGSF
VRSPHPYQL	VRSPHPYQL
VYRTVIEYY	VYRTVIEYY
VYDLLKNHL	VYDLLKNHL
YRNEFTAWY	YRNEFTAWY
VYGPLPQSF	VYGPLPQSF
LYWSHPRKF	LYWSHPRKF
HYSPIYLSF	HYSPIYLSF
HRAEVTEEF	HRAEVTEEF
SRFSNVYHL	SRFSNVYHL
YYFSKLIEF	YYFSKLIEF
NRPGLSYHY	NRPGLSYHY
ARADSYYEY	ARADSYYEY
SAPYGRITL	SAPYGRITL
YYSGLIYTY	YYSGLIYTY
TRVDTILEF	TRVDTILEF
SYNDYVREF	SYNDYVREF
KRYKSIVKY	KRYKSIVKY
YYFFTPYVY	YYFFTPYVY
SRPALPFIL	SRPALPFIL
AYRDARVEL	AYRDARVEL
YYDPMISKL	YYDPMISKL
NYDEHISNF	NYDEHISNF
LRPLLAAAA	LRPLLAAAA
YAGLSMEGG	YAGLSMEGG
NYDEMKDFL	NYDEMKDFL
RYDEMVESM	RYDEMVESM
YRAQPSVSL	YRAQPSVSL
FRLLQETLY	FRLLQETLY
TYKDYVDLF	TYKDYVDLF
SIPGGYNAL	SIPGGYNAL
SGPGPAAAL	SGPGPAAAL
SRNKDTYFL	SRNKDTYFL
KRQEAIFEL	KRQEAIFEL
VYKKSIFVF	VYKKSIFVF
AYPEIVAVY	AYPEIVAVY
SFEDAKEAL	SFEDAKEAL
VRPAEPAFL	VRPAEPAFL
VYPEYVIQY	VYPEYVIQY
YRVYQPVRY	YRVYQPVRY
YYHARVYEF	YYHARVYEF
FYNLIHPEY	FYNLIHPEY
FYRPLAPEL	FYRPLAPEL
PIRLLAAAA	PIRLLAAAA
FRPPGTSDL	FRPPGTSDL
YYPQQAIVF	YYPQQAIVF
YRPGPWMKY	YRPGPWMKY
RRKDGVFLY	RRKDGVFLY
SAPSSSTPF	SAPSSSTPF
SAPGIISAL	SAPGIISAL
NYDLALKYF	NYDLALKYF
AYHTQTTPL	AYHTQTTPL
NRPVEVYQY	NRPVEVYQY
GRNQEVHTL	GRNQEVHTL
KRPVGGFLL	KRPVGGFLL
KRYIFADAY	KRYIFADAY
NRRDSEYIF	NRRDSEYIF
TRTPVAKEL	TRTPVAKEL
YRPNETFHL	YRPNETFHL
NRYYSHVDY	NRYYSHVDY
NRLGYTHLY	NRLGYTHLY
YRTTTVIFY	YRTTTVIFY
SRFEKEFSF	SRFEKEFSF
FYQPKIQQF	FYQPKIQQF
SRKSFVFEL	SRKSFVFEL
NKADVILKY	NKADVILKY
FYPPPRITL	FYPPPRITL
NRTETVTSF	NRTETVTSF
LAPTDVKEL	LAPTDVKEL
HRYEVVTEL	HRYEVVTEL
NRTDTEYVL	NRTDTEYVL
FYNSFLEQL	FYNSFLEQL
FRHPHIIKL	FRHPHIIKL
IYGEKTYAF	IYGEKTYAF
FYPPDPAQL	FYPPDPAQL
SRAIFEEVY	SRAIFEEVY
SRPDGSASF	SRPDGSASF
HRGPDAFRF	HRGPDAFRF
SYIGLGHIY	SYIGLGHIY
AAPEGAGAL	AAPEGAGAL
YKIAFPYLY	YKIAFPYLY
RRQEAIYEM	RRQEAIYEM
NRKEFVNLY	NRKEFVNLY
RYSEAVFYY	RYSEAVFYY
FKNPIIEKY	FKNPIIEKY
ARNTVTQVL	ARNTVTQVL
KRLDVEFVL	KRLDVEFVL
NRPPFGQGY	NRPPFGQGY
VYNIYIRRY	VYNIYIRRY
TKNGHVYKY	TKNGHVYKY
SRIHPVSTM	SRIHPVSTM
SKADALFEL	SKADALFEL
KYPEGIRKY	KYPEGIRKY
YKVEYPIMY	YKVEYPIMY
FRSDISEEL	FRSDISEEL
MAPLKMLAL	MAPLKMLAL
AQVTVVVAQ	AQVTVVVAQ
YRREIFIAF	YRREIFIAF
KRPAGPLVL	KRPAGPLVL
FRNIPGITL	FRNIPGITL
SYLEYQKVM	SYLEYQKVM
HYPPVQVLF	HYPPVQVLF
HRLPPVTSF	HRLPPVTSF
ITPTGTHPL	ITPTGTHPL
RRGDFIHVM	RRGDFIHVM
IYDNAVQGL	IYDNAVQGL
AKFSLPVSL	AKFSLPVSL
TYDAHHSAF	TYDAHHSAF
IRPENVIIY	IRPENVIIY
ARFGSVNEL	ARFGSVNEL
YRIESYWTY	YRIESYWTY
FRHEVGYVL	FRHEVGYVL
FYADHPFIF	FYADHPFIF
YRTQSSASL	YRTQSSASL
FYGTFDVHL	FYGTFDVHL
WRRGQEVLL	WRRGQEVLL
FYQPTCIVL	FYQPTCIVL
YYGHTNYIY	YYGHTNYIY
QRIDEFESM	QRIDEFESM
SRPHFLIEL	SRPHFLIEL
YRSPLASRY	YRSPLASRY
LYDVPANSM	LYDVPANSM
IYLTFPVAM	IYLTFPVAM
FRQEYLDTL	FRQEYLDTL
HRNFKPVVY	HRNFKPVVY
SRSWLSYSY	SRSWLSYSY
NYDIAIAEL	NYDIAIAEL
TRWPGFYIL	TRWPGFYIL
ARPVLLQVY	ARPVLLQVY
FYSGSPTSY	FYSGSPTSY
MRPNNLVHF	MRPNNLVHF
FYHEAVVLF	FYHEAVVLF
MKHYEVEIL	MKHYEVEIL
AYKPPGFSL	AYKPPGFSL
VRAWVVFKL	VRAWVVFKL
SVPEAQSAL	SVPEAQSAL
FKSPAASSF	FKSPAASSF
HRNPLPEYL	HRNPLPEYL
GRFEDVYQL	GRFEDVYQL
NKKDDGISF	NKKDDGISF
AAPVPTTTL	AAPVPTTTL
RRPARCYRY	RRPARCYRY
NRSQFFITF	NRSQFFITF
FRYTAGTPY	FRYTAGTPY
AYDPYLIAM	AYDPYLIAM
HRQGFSYDY	HRQGFSYDY
FKAPITSEF	FKAPITSEF
AKSDVTNQL	AKSDVTNQL
LYDVTWEEM	LYDVTWEEM
VYNPVIYVF	VYNPVIYVF
HYDLFIERF	HYDLFIERF
ARIPLNPVL	ARIPLNPVL
VRPDTVRNL	VRPDTVRNL
VRKKFVTEL	VRKKFVTEL
SYPDFLHKM	SYPDFLHKM
SYMEVPTYL	SYMEVPTYL
IYDLFQKSF	IYDLFQKSF
FRHNPYTAF	FRHNPYTAF
SGPVPGTAI	SGPVPGTAI
RKNPFVYKV	RKNPFVYKV
VYPWTQRFF	VYPWTQRFF
NYYGKYIAL	NYYGKYIAL
YRPENYLLY	YRPENYLLY
YRPLQSTEF	YRPLQSTEF
WRPPPLNPY	WRPPPLNPY
FRDAFTQEL	FRDAFTQEL
LYDFIHTSF	LYDFIHTSF
KRVFPKWTY	KRVFPKWTY
ARGAFSEEY	ARGAFSEEY
FRSSIDYQY	FRSSIDYQY
RYNGLSFVY	RYNGLSFVY
LRSGVIVRL	LRSGVIVRL
VYQEMPAQL	VYQEMPAQL
YKAPITNEF	YKAPITNEF
SRPLHISTF	SRPLHISTF
KKNPFHLEL	KKNPFHLEL
TRYDLYHTF	TRYDLYHTF
KRGDVIYIL	KRGDVIYIL
KYPDVIQEL	KYPDVIQEL
FRVDYILSV	FRVDYILSV
SRSVMTEEY	SRSVMTEEY
RRIEIAHSL	RRIEIAHSL
TYMEFLWQY	TYMEFLWQY
FYDDTYNTL	FYDDTYNTL
FRGNTPLHL	FRGNTPLHL
SKNPHIVSF	SKNPHIVSF
QYNTYPIKL	QYNTYPIKL
TYSEFAREL	TYSEFAREL
VVPEPGTSL	VVPEPGTSL
KRPDTTESL	KRPDTTESL
VYDTNPAKF	VYDTNPAKF
NRPVHAYKF	NRPVHAYKF
QRKAVVLEY	QRKAVVLEY
IYAVNGIAF	IYAVNGIAF
AYDKAVASF	AYDKAVASF
KAPVTKVAA	KAPVTKVAA
YYDPKHVIF	YYDPKHVIF
VRFDQVTVY	VRFDQVTVY
MYHGAAFQL	MYHGAAFQL
TFRDVAIEF	TFRDVAIEF
HYRPPEVIL	HYRPPEVIL
YRPLFDYFL	YRPLFDYFL
TYRLFAVVY	TYRLFAVVY
SRPSTYYEL	SRPSTYYEL
IAPETRRSI	IAPETRRSI
VRQDVINTL	VRQDVINTL
YYTEFPTVL	YYTEFPTVL
YYPELAFQF	YYPELAFQF
SRPPGQGEF	SRPPGQGEF
VSPVVRVAV	VSPVVRVAV
NRVLHYWTM	NRVLHYWTM
AYDDKIYYF	AYDDKIYYF
ARAPGTRTL	ARAPGTRTL
YYSPHGHIL	YYSPHGHIL
QRAPGGLSY	QRAPGGLSY
VYPQPPFSY	VYPQPPFSY
RRNPYCRTL	RRNPYCRTL
IRPDNMSEY	IRPDNMSEY
FRLLQETMY	FRLLQETMY
YKQVLEPSF	YKQVLEPSF
KYQDVYVEL	KYQDVYVEL
KYFAKHPRL	KYFAKHPRL
RRFFPYYVY	RRFFPYYVY
IRSSYIRVL	IRSSYIRVL
VKTDTVLIL	VKTDTVLIL
SRFGNAFHL	SRFGNAFHL
TAPQGNVDL	TAPQGNVDL
FYDWDNTEL	FYDWDNTEL
HRAVFPIYL	HRAVFPIYL
ARLDLPYEL	ARLDLPYEL
HGPGPVGAL	HGPGPVGAL
VYDALNVLM	VYDALNVLM
AYRLSVEIY	AYRLSVEIY
RAGLPAPTI	RAGLPAPTI
VRAEVQHQL	VRAEVQHQL
AYPDKNFTL	AYPDKNFTL
ARPLVETIF	ARPLVETIF
FYRPHTITL	FYRPHTITL
YYKPDSPEY	YYKPDSPEY
HLPSGVKSL	HLPSGVKSL
FRFQPFESY	FRFQPFESY
QYKDVPITY	QYKDVPITY
YYPNPPLVL	YYPNPPLVL
KYEDGIALL	KYEDGIALL
VYRTPTEAL	VYRTPTEAL
SRPKLSFSL	SRPKLSFSL
FRQPVVDTF	FRQPVVDTF
DYDPLVVKL	DYDPLVVKL
AYSDVAKRL	AYSDVAKRL
RRMEVYNEF	RRMEVYNEF
VHPPPTTTY	VHPPPTTTY
FRPEHVSRL	FRPEHVSRL
YYYGQGHPM	YYYGQGHPM
FYDLQEADL	FYDLQEADL
HRPGIVVDY	HRPGIVVDY
YRPGHYDIL	YRPGHYDIL
RRAEVELEY	RRAEVELEY
NRHAVVMEL	NRHAVVMEL
VSPYTEIHL	VSPYTEIHL
IRMPSLPSY	IRMPSLPSY
FRHLIEFTY	FRHLIEFTY
FYHPFPTPY	FYHPFPTPY
RRIDFVLVY	RRIDFVLVY
FRNSLGLIY	FRNSLGLIY
FRSIRPLSY	FRSIRPLSY
TKQNSVLLL	TKQNSVLLL
KYGFYTHVF	KYGFYTHVF
AAPTAQKSL	AAPTAQKSL
FRHEVMYSF	FRHEVMYSF
KRVTWIVEF	KRVTWIVEF
TYPPAIVVY	TYPPAIVVY
VAPVAQVAL	VAPVAQVAL
YKFDFPVSY	YKFDFPVSY
AYKDAIYVF	AYKDAIYVF
AYRKLALKY	AYRKLALKY
LYDELRNLL	LYDELRNLL
NYDFGPIHM	NYDFGPIHM
RYHPQALIY	RYHPQALIY
AFKDVSFSL	AFKDVSFSL
NYGVLLHEL	NYGVLLHEL
ARVPHSLDL	ARVPHSLDL
KRKGYSYEL	KRKGYSYEL
GYFLRAWNY	GYFLRAWNY
YRNPVSQCM	YRNPVSQCM
VAPGKRPAL	VAPGKRPAL
IRMTYIKEL	IRMTYIKEL
FYYGGQVNY	FYYGGQVNY
SYFGSFSSL	SYFGSFSSL
TRSFYKHIL	TRSFYKHIL
SRVEAVYVL	SRVEAVYVL
FRNPKTSFY	FRNPKTSFY
IYAPKLQEF	IYAPKLQEF
NYPGFLTIL	NYPGFLTIL
RYLTVAAVF	RYLTVAAVF
HYDPATEEF	HYDPATEEF
TYDPTYSDF	TYDPTYSDF
RRSPVKVVF	RRSPVKVVF
ARVIFITEY	ARVIFITEY
FRGPTVSNI	FRGPTVSNI
YYNKVSTVF	YYNKVSTVF
AGPLRKSSL	AGPLRKSSL
VYDVTPPEL	VYDVTPPEL
RRQNVAYEY	RRQNVAYEY
ARSPALQVL	ARSPALQVL
VKSDVEINY	VKSDVEINY
YRNPKEWTK	YRNPKEWTK
RYRPGTVAL	RYRPGTVAL
AYSEAIFEL	AYSEAIFEL
TYEGKPIFL	TYEGKPIFL
LRPPERQAL	LRPPERQAL
VYPGLAVFF	VYPGLAVFF
VRSALAFEL	VRSALAFEL
EYPDLIHIY	EYPDLIHIY
YRHDAVKIL	YRHDAVKIL
TSPEAFLAL	TSPEAFLAL
KYPPVNRKY	KYPPVNRKY
QRPFFPILY	QRPFFPILY
SYRDAISMY	SYRDAISMY
KRSTYNYSL	KRSTYNYSL
ARIPFYGSY	ARIPFYGSY
YKGQYILTL	YKGQYILTL
AYFPYFITY	AYFPYFITY
LYSPQYISY	LYSPQYISY
VHADVYRVL	VHADVYRVL
KYKDNPFSL	KYKDNPFSL
AKAGVYYVF	AKAGVYYVF
KKTEVVITL	KKTEVVITL
YRKPKWNHL	YRKPKWNHL
FRVPFIYGH	FRVPFIYGH
YKNPWVQIM	YKNPWVQIM
NRTIVITSH	NRTIVITSH
YHSPYPEEY	YHSPYPEEY
MRKEFTLEF	MRKEFTLEF
MYRSYVEML	MYRSYVEML
ARSLKVFEL	ARSLKVFEL
AANPHSFVF	AANPHSFVF
NYVEFTRIL	NYVEFTRIL
ARADFQKVL	ARADFQKVL
VRNNVIIVM	VRNNVIIVM
SRKGPAPEL	SRKGPAPEL
KYPSYIHKM	KYPSYIHKM
LRNQSVFNF	LRNQSVFNF
KYREMYEEF	KYREMYEEF
NRLSFFFDF	NRLSFFFDF
KRFGKAYNL	KRFGKAYNL
LYRNCVYTY	LYRNCVYTY
RRFTEIYEF	RRFTEIYEF
SRTPYHVNL	SRTPYHVNL
HYDEQQNFF	HYDEQQNFF
FRVHTVMTL	FRVHTVMTL
FRSFVVSKF	FRSFVVSKF
SYHSYVIGF	SYHSYVIGF
VVPEPGQPL	VVPEPGQPL
SRNSNTVVF	SRNSNTVVF
VYPERSTSY	VYPERSTSY
IKSDVHLNF	IKSDVHLNF
NYPAFMMEM	NYPAFMMEM
SIPTKALEL	SIPTKALEL
NRPADVYSY	NRPADVYSY
YRGQPGNAY	YRGQPGNAY
HRYPAVHVY	HRYPAVHVY
KYIGYARQY	KYIGYARQY
KRFADFTVY	KRFADFTVY
VRANVPEEL	VRANVPEEL
YAPGARLAL	YAPGARLAL
KKANITFEY	KKANITFEY
VRVDRDYVL	VRVDRDYVL
YKQPMFYHL	YKQPMFYHL
SRFIFNYVY	SRFIFNYVY
TRYQGVNLY	TRYQGVNLY
NRHSYPNVY	NRHSYPNVY
TYGERVVAF	TYGERVVAF
NRYSHDFNF	NRYSHDFNF
SYPGGQLVF	SYPGGQLVF
NRGEVVTSF	NRGEVVTSF
ARPSSTITY	ARPSSTITY
SRPPAQTSL	SRPPAQTSL
SSPAPRTAL	SSPAPRTAL
MAPERVASL	MAPERVASL
FFMPGFAPL	FFMPGFAPL
FRPLDVSLY	FRPLDVSLY
LRNKVIIEY	LRNKVIIEY
IKLLNENSY	IKLLNENSY
FRSDNSFSF	FRSDNSFSF
IRGPTQHEL	IRGPTQHEL
FRGPVVPAF	FRGPVVPAF
KRINWRTVL	KRINWRTVL
IYACVCRIF	IYACVCRIF
VYNENLVHM	VYNENLVHM
TYRAIAETY	TYRAIAETY
LYHEHIIKY	LYHEHIIKY
NRGQFFTVY	NRGQFFTVY
NRTDVVLIL	NRTDVVLIL
FRPEEIELL	FRPEEIELL
FRKLSSETY	FRKLSSETY
RRWEQALTF	RRWEQALTF
HYVEKPSTF	HYVEKPSTF
YRHGKAYRF	YRHGKAYRF
AKADVPYIL	AKADVPYIL
NRPKALNAL	NRPKALNAL
NRLLLPHAF	NRLLLPHAF
IYDEAISSF	IYDEAISSF
TYKDPITEF	TYKDPITEF
VAPVTHVSV	VAPVTHVSV
NRSNFPVVL	NRSNFPVVL
LYRPGSVAY	LYRPGSVAY
KYFLWVVKF	KYFLWVVKF
GRAKTPVTL	GRAKTPVTL
YYDLQGHLF	YYDLQGHLF
YRHPDPREL	YRHPDPREL
GRSEYVEKF	GRSEYVEKF
HRPSHFLNF	HRPSHFLNF
YRVFTTQEL	YRVFTTQEL
FRNERAIRF	FRNERAIRF
SYPYFVIQY	SYPYFVIQY
SRNAYMLVY	SRNAYMLVY
VRKSIARVL	VRKSIARVL
SAPVGVTAL	SAPVGVTAL
VRPHIDISF	VRPHIDISF
FREGKGHEY	FREGKGHEY
VRNPEAEEM	VRNPEAEEM
VYHEILIGY	VYHEILIGY
FRPQSGRVL	FRPQSGRVL
FRKVDVDEY	FRKVDVDEY
VYGVVPISL	VYGVVPISL
LYDEAIRHF	LYDEAIRHF
YRTDMIQAL	YRTDMIQAL
VRPPTPREL	VRPPTPREL
SRVLQNVAF	SRVLQNVAF
SYDLANRDF	SYDLANRDF
GYSNRVVDL	GYSNRVVDL
YYVVAHFHY	YYVVAHFHY
ARPSVLWCY	ARPSVLWCY
IRVDHAGEY	IRVDHAGEY
YYDVPIATL	YYDVPIATL
SRKELPEYY	SRKELPEYY
TYDLPGNFL	TYDLPGNFL
NYKKFYEQF	NYKKFYEQF
YRPAYLVTL	YRPAYLVTL
IRKGSITEY	IRKGSITEY
YRDEHIYPY	YRDEHIYPY
AYQELLQHY	AYQELLQHY
SRSHYSPIY	SRSHYSPIY
AYPTYPVGF	AYPTYPVGF
IRPEHVLRL	IRPEHVLRL
FRPEWTQRY	FRPEWTQRY
HRNLIEIGY	HRNLIEIGY
YRDPHVDQY	YRDPHVDQY
SRLFQPVQY	SRLFQPVQY
KRLNFITEY	KRLNFITEY
SRGDFVVEY	SRGDFVVEY
NSPLPGSEL	NSPLPGSEL
YRPSYSYDY	YRPSYSYDY
SRSHSVFQL	SRSHSVFQL
TRPAAQPSF	TRPAAQPSF
TRMRHVISY	TRMRHVISY
YRKPTYESY	YRKPTYESY
YYDDYRVQL	YYDDYRVQL
SYREKPIVF	SYREKPIVF
YRPLTVLTF	YRPLTVLTF
NRPNLYYEV	NRPNLYYEV
SVPLAATSM	SVPLAATSM
AAPAYSRAL	AAPAYSRAL
HRTDLNPIL	HRTDLNPIL
TYQVLAVTF	TYQVLAVTF
IRNDYYLNL	IRNDYYLNL
SRPEANEAL	SRPEANEAL
YRPPGARLT	YRPPGARLT
SRPLSAVVL	SRPLSAVVL
QRVDYIMQL	QRVDYIMQL
HYPDYSWSA	HYPDYSWSA
FYKDSGITY	FYKDSGITY
LRPDMVLEL	LRPDMVLEL
ARYPKKIHY	ARYPKKIHY
ISPSRTEAL	ISPSRTEAL
YRPVRQYVY	YRPVRQYVY
YRHFFGHTF	YRHFFGHTF
VRVEPLVTM	VRVEPLVTM
YKVPHPLEH	YKVPHPLEH
HYDVQSILF	HYDVQSILF
SRPESFAIY	SRPESFAIY
ARMEFAWIY	ARMEFAWIY
FRNDFLELL	FRNDFLELL
SRFLNKQPY	SRFLNKQPY
GRNPFVHEL	GRNPFVHEL
YYDEKVVKL	YYDEKVVKL
SRSLLESTY	SRSLLESTY
YYTDFVMEL	YYTDFVMEL
IYATRLIQM	IYATRLIQM
SRPNIILVM	SRPNIILVM
IHPVVITSF	IHPVVITSF
NRAFVSMVY	NRAFVSMVY
FYRVTTEQY	FYRVTTEQY
ARFLFTTGF	ARFLFTTGF
NYLPFIMEL	NYLPFIMEL
AYPEYLITF	AYPEYLITF
KYMDVQFDF	KYMDVQFDF
KYKERGTVL	KYKERGTVL
VYDTVFKHF	VYDTVFKHF
IAPGVTHEL	IAPGVTHEL
YRFETVQKL	YRFETVQKL
FYDTSEENY	FYDTSEENY
KRKELVTLY	KRKELVTLY
KYFDEHYEY	KYFDEHYEY
ARVPSSLAY	ARVPSSLAY
KRADLQSTF	KRADLQSTF
ARNPSTVCL	ARNPSTVCL
FRGQVYSEL	FRGQVYSEL
NKTDVILIL	NKTDVILIL
YKLEVLYVL	YKLEVLYVL
VRNYEQWQL	VRNYEQWQL
SRFTYPYLL	SRFTYPYLL
SIPEKNRPL	SIPEKNRPL
MRDGHYTTF	MRDGHYTTF
VYPPIRHHL	VYPPIRHHL
RRFMQTFVL	RRFMQTFVL
YRNPCYVSY	YRNPCYVSY
FKIHQPYTL	FKIHQPYTL
YRVVFPLEL	YRVVFPLEL
SRPENAIIY	SRPENAIIY
FYEERALYL	FYEERALYL
ARPPAAPEL	ARPPAAPEL
NRNLVSPAY	NRNLVSPAY
IYDSVKVYF	IYDSVKVYF
NRFPWPKVL	NRFPWPKVL
QRQDIAFAY	QRQDIAFAY
NAPLVHATL	NAPLVHATL
IYDFIGEFM	IYDFIGEFM
HYDPMIAKL	HYDPMIAKL
LYDHTTILF	LYDHTTILF
VYKAFVDNY	VYKAFVDNY
NRGINITIY	NRGINITIY
LYDVVDVKY	LYDVVDVKY
YYDVAKQLL	YYDVAKQLL
FYNEYVREL	FYNEYVREL
ARPLVQTIF	ARPLVQTIF
SKIDYFLEY	SKIDYFLEY
IVPGNVKSL	IVPGNVKSL
VYFGHWVVM	VYFGHWVVM
QYNPLPIEY	QYNPLPIEY
FKIADPFVL	FKIADPFVL
SRFAKVHIL	SRFAKVHIL
RVYIHPFHL	RVYIHPFHL
HRYENVSIL	HRYENVSIL
ARPELLEVF	ARPELLEVF
VFRDLVIKY	VFRDLVIKY
FRMPVLREY	FRMPVLREY
YRVPGQFML	YRVPGQFML
HRNGGLITL	HRNGGLITL
AAPTSAAAL	AAPTSAAAL
VRPSYWLVL	VRPSYWLVL
NIPEKTTAL	NIPEKTTAL
FYIESISYL	FYIESISYL
VRVPVTSNL	VRVPVTSNL
FRQDHPSSM	FRQDHPSSM
RRNPEPLRF	RRNPEPLRF
GYRDFFPEY	GYRDFFPEY
YRAQPSASL	YRAQPSASL
NYRDTFFNL	NYRDTFFNL
FRFDPQFAL	FRFDPQFAL
LYPSIIQEF	LYPSIIQEF
KYPENFFLL	KYPENFFLL
LYDLVTEKM	LYDLVTEKM
NYDETISTL	NYDETISTL
LYPGIPVIF	LYPGIPVIF
LSPTPATAL	LSPTPATAL
SYDPLVIYL	SYDPLVIYL
MRMATPLLM	MRMATPLLM
KRKGQVIQF	KRKGQVIQF
YYEEQHPEL	YYEEQHPEL
FKFVEQQSY	FKFVEQQSY
FRLPTAEVM	FRLPTAEVM
FRVPTANVS	FRVPTANVS
NKNPNIVNY	NKNPNIVNY
AAPEGKRSL	AAPEGKRSL
ARPERPMAF	ARPERPMAF
YRLHHVVVY	YRLHHVVVY
IRFTSPVSL	IRFTSPVSL
NRMTVEYVY	NRMTVEYVY
TRIGYHISL	TRIGYHISL
YRNAYTMVL	YRNAYTMVL
YRDPRERTL	YRDPRERTL
AYAGTGIQY	AYAGTGIQY
WYDPNASLL	WYDPNASLL
NRSNTVVIM	NRSNTVVIM
FRVGNVQEL	FRVGNVQEL
VYPTAVHVL	VYPTAVHVL
SFYFFFSSF	SFYFFFSSF
FYDVQFKEL	FYDVQFKEL
YYLTFVQEL	YYLTFVQEL
YRPISASVL	YRPISASVL
FRSILSWEL	FRSILSWEL
LRPGIHHSL	LRPGIHHSL
AYKDFLWFF	AYKDFLWFF
SYDSKLVWF	SYDSKLVWF
ARAYEPQEL	ARAYEPQEL
YRPGTVALR	YRPGTVALR
VRPPQQVVY	VRPPQQVVY
YRPLYPFSL	YRPLYPFSL
NYDETLSTL	NYDETLSTL
IYPEVVHMF	IYPEVVHMF
MYPAFAEEY	MYPAFAEEY
FYDERGDQF	FYDERGDQF
YRNQLLNIF	YRNQLLNIF
SRFNRYYSL	SRFNRYYSL
ARPPVLAKL	ARPPVLAKL
EYAHLFEVF	EYAHLFEVF
VRPLRLFVY	VRPLRLFVY
KRFSGTVRL	KRFSGTVRL
FRFENVNGY	FRFENVNGY
FYDPDTVEL	FYDPDTVEL
YRQPPVPQY	YRQPPVPQY
FYDPDVGNF	FYDPDVGNF
IAPTGIESL	IAPTGIESL
AYDLAKALL	AYDLAKALL
FRQIIAVVL	FRQIIAVVL
SYDYSGRYL	SYDYSGRYL
KAPGSTSNL	KAPGSTSNL
FRKEAGDFY	FRKEAGDFY
RYNDITKVY	RYNDITKVY
SYLENPTSY	SYLENPTSY
YRQEREGFL	YRQEREGFL
SRKTFTETF	SRKTFTETF
YYELAQVLL	YYELAQVLL
FRPPITQEI	FRPPITQEI
NRHGLIRKY	NRHGLIRKY
FSNPYSIEY	FSNPYSIEY
NYDEALRLL	NYDEALRLL
SYPDIHFDM	SYPDIHFDM
LYSSYVIFY	LYSSYVIFY
FRKDSSYEL	FRKDSSYEL
TYDPETQEF	TYDPETQEF
NYFHLAVAF	NYFHLAVAF
TYDYAKTIL	TYDYAKTIL
SRFELYQIF	SRFELYQIF
VYKGVVTEY	VYKGVVTEY
YYEERTCIL	YYEERTCIL
VRENVPRVL	VRENVPRVL
YRLESTLNY	YRLESTLNY
KKIPGIYVL	KKIPGIYVL
ARDPGARVL	ARDPGARVL
FYETLPAEM	FYETLPAEM
AKQDVVLNY	AKQDVVLNY
VYVQHPITF	VYVQHPITF
FYGSHPWHW	FYGSHPWHW
RYPAEIRKY	RYPAEIRKY
FRKSTVEHF	FRKSTVEHF
SSPQPGSAL	SSPQPGSAL
KRSPALQIL	KRSPALQIL
FYQSLGIPY	FYQSLGIPY
SRSLLQTTF	SRSLLQTTF
VRRDDPGEF	VRRDDPGEF
ARPPPLPGL	ARPPPLPGL
LYPPVPQVY	LYPPVPQVY
LKSDIYLEY	LKSDIYLEY
ERPPNPIEF	ERPPNPIEF
ARHVVKVEY	ARHVVKVEY
SYQDAAFTY	SYQDAAFTY
GSLRVLVLR	GSLRVLVLR
NYIEFTRIL	NYIEFTRIL
AYRQGHFTY	AYRQGHFTY
IYPDSFTVL	IYPDSFTVL
ARPLEGTSF	ARPLEGTSF
FRVHLQYEF	FRVHLQYEF
KKSDPVVSY	KKSDPVVSY
IRQTGVIVL	IRQTGVIVL
SYKGHVDIL	SYKGHVDIL
IYDKTSVLF	IYDKTSVLF
RRGEYVLTF	RRGEYVLTF
KYPSPFFVF	KYPSPFFVF
FKSPVKTIR	FKSPVKTIR
HRYPNQVYY	HRYPNQVYY
FYRTLITLL	FYRTLITLL
FYDSELFRM	FYDSELFRM
SVPAFASSL	SVPAFASSL
QYPVFPWVL	QYPVFPWVL
SAPDKSLEL	SAPDKSLEL
VRDHWVHVL	VRDHWVHVL
ARPEPATGY	ARPEPATGY
ARAHSIQIM	ARAHSIQIM
GRAPGGLSL	GRAPGGLSL
KYDYVGRLL	KYDYVGRLL
TRNNFAVGY	TRNNFAVGY
SYDPLRIYL	SYDPLRIYL
TRAQWFYEY	TRAQWFYEY
NRLPLVVSF	NRLPLVVSF
VRPLATLSY	VRPLATLSY
ARPDATKVL	ARPDATKVL
FFKELIQEF	FFKELIQEF
YFAERVTSL	YFAERVTSL
IYDLATQTL	IYDLATQTL
VYDPSLKTL	VYDPSLKTL
SRAMLLTSY	SRAMLLTSY
VKSPVQVIL	VKSPVQVIL
YYEDGNVQL	YYEDGNVQL
YRKGSISVF	YRKGSISVF
ARADFIEEF	ARADFIEEF
QYYFNQHIF	QYYFNQHIF
ERVPFILTY	ERVPFILTY
HYLPVKIIL	HYLPVKIIL
AYKEPPLAL	AYKEPPLAL
LYFARPVPL	LYFARPVPL
NRGDFFMTL	NRGDFFMTL
SRVVTVSEY	SRVVTVSEY
IRGNVGFVF	IRGNVGFVF
FRAPQVMTY	FRAPQVMTY
YRAPGTPTY	YRAPGTPTY
AYIPTPIYF	AYIPTPIYF
FYVPFAKAL	FYVPFAKAL
SSPQAGSSL	SSPQAGSSL
MRPLDIVEL	MRPLDIVEL
NYNEKIYEL	NYNEKIYEL
YRNVHAVVF	YRNVHAVVF
HRFYMHHSF	HRFYMHHSF
FRQLPARTL	FRQLPARTL
AYLESFYKF	AYLESFYKF
VRSGIVEYL	VRSGIVEYL
GRPLFPHVL	GRPLFPHVL
VYKDLVLLL	VYKDLVLLL
ARPPSVDSL	ARPPSVDSL
YYDEIINAL	YYDEIINAL
QRPPTRETF	QRPPTRETF
YRLEYMRVL	YRLEYMRVL
LRSDSYVEL	LRSDSYVEL
SIPILASAL	SIPILASAL
SRSPVYSHF	SRSPVYSHF
HAPFTATSL	HAPFTATSL
YRRLSESQL	YRRLSESQL
LRPSTSRSL	LRPSTSRSL
YRVPNMRFL	YRVPNMRFL
FYRSYFSQF	FYRSYFSQF
NYRTSNYIY	NYRTSNYIY
FRRPVLQVL	FRRPVLQVL
FYMPQQVAY	FYMPQQVAY
IRHYEGLSY	IRHYEGLSY
SYDHVELTF	SYDHVELTF
IYPVNAISF	IYPVNAISF
FYVDTVRAF	FYVDTVRAF
RRFEYKYSF	RRFEYKYSF
HRAQVIYTR	HRAQVIYTR
IYDKFIAQL	IYDKFIAQL
NVPVRDIPA	NVPVRDIPA
LYQDTHQEY	LYQDTHQEY
GRPETIFQL	GRPETIFQL
KYPHYFPVM	KYPHYFPVM
SRYVLDDEY	SRYVLDDEY
QRPTIYYVM	QRPTIYYVM
VRPDDAIEL	VRPDDAIEL
VSPDAKTSL	VSPDAKTSL
ARNERIYVY	ARNERIYVY
NRQTALYTL	NRQTALYTL
YYRPLHDEY	YYRPLHDEY
AKNNVVINY	AKNNVVINY
ARDDTHYLL	ARDDTHYLL
ARPTAPFTL	ARPTAPFTL
SRNEIIQSY	SRNEIIQSY
RYPDLELKY	RYPDLELKY
IYKDLPFET	IYKDLPFET
AYQEAVRTL	AYQEAVRTL
FRPDEPYYY	FRPDEPYYY
VRPPPGPEL	VRPPPGPEL
NYNQQPSNY	NYNQQPSNY
YYHVYKLTL	YYHVYKLTL
KAPSAARSL	KAPSAARSL
VYDLLKTNL	VYDLLKTNL
YRSPHSPFY	YRSPHSPFY
SRPEAPNEF	SRPEAPNEF
FYFALRDTL	FYFALRDTL
RYKDLRTAY	RYKDLRTAY
FRNIQNMIL	FRNIQNMIL
IRPEYAWIV	IRPEYAWIV
FRPPTRAEL	FRPPTRAEL
YYYTKEEQF	YYYTKEEQF
KRQEVIYEL	KRQEVIYEL
VAPTSGPAL	VAPTSGPAL
QYPVFPWIL	QYPVFPWIL
SRAPSTYTY	SRAPSTYTY
LYDTHITVL	LYDTHITVL
KRADAGFVY	KRADAGFVY
SRNGKSYTF	SRNGKSYTF
FYDECLRKY	FYDECLRKY
RYDLGGLVM	RYDLGGLVM
IRVDKITEY	IRVDKITEY
HRKPMFNIH	HRKPMFNIH
VRPDNTYEV	VRPDNTYEV
HRVAQAWEL	HRVAQAWEL
SRNEGVATY	SRNEGVATY
LYDVRTILL	LYDVRTILL
YYTDFLITL	YYTDFLITL
SRVAFFEEL	SRVAFFEEL
SRYDPSISF	SRYDPSISF
FRNVEVLIY	FRNVEVLIY
IYPGHGMMF	IYPGHGMMF
NYSQQLQVY	NYSQQLQVY
SYGGQQQSY	SYGGQQQSY
GRKGIYEIY	GRKGIYEIY
FRSPLARQL	FRSPLARQL
TRSPHIETY	TRSPHIETY
KRPPGYYSY	KRPPGYYSY
GRQIKPYTL	GRQIKPYTL
AYSSYVHQY	AYSSYVHQY
YKNPSEYHY	YKNPSEYHY
HRNEVTVEL	HRNEVTVEL
KAFARPWSL	KAFARPWSL
SYPNVFLVF	SYPNVFLVF
QYDEAVAQF	QYDEAVAQF
LRELAVGSL	LRELAVGSL
RRDYVFIEF	RRDYVFIEF
SYLESFYHM	SYLESFYHM
TRTIYQFHY	TRTIYQFHY
VYDVVELKF	VYDVVELKF
IYDVQHANL	IYDVQHANL
VRGPPTLEY	VRGPPTLEY
VRNEHFWTL	VRNEHFWTL
YREHPYGRY	YREHPYGRY
NYFMHCVAF	NYFMHCVAF
FRTPHVLVL	FRTPHVLVL
SYANYFIRL	SYANYFIRL
VRSGYYKVL	VRSGYYKVL
VYDPLFSQL	VYDPLFSQL
HYYSITINY	HYYSITINY
IYELMQTEF	IYELMQTEF
ARPDINLIL	ARPDINLIL
YHIGIPLTY	YHIGIPLTY
TRPPEPRHI	TRPPEPRHI
TRPDMIRIL	TRPDMIRIL
FRTPFPLAF	FRTPFPLAF
NKTDVVLIL	NKTDVVLIL
NTPSGTNAL	NTPSGTNAL
FRVDFTEAL	FRVDFTEAL
VAPRSGLAA	VAPRSGLAA
ARWWAVVVL	ARWWAVVVL
KYFLQQWEL	KYFLQQWEL
IRHDVPYLF	IRHDVPYLF
NYDPALHPF	NYDPALHPF
KAPAPRPSL	KAPAPRPSL
YRPHTITLL	YRPHTITLL
MYRDYPLEL	MYRDYPLEL
NYIPRFWTF	NYIPRFWTF
LRLPLQDVY	LRLPLQDVY
AYPHPHFAL	AYPHPHFAL
ARSPGSISY	ARSPGSISY
AYATYPREL	AYATYPREL
FRNFFSNMF	FRNFFSNMF
NKIEKIYIM	NKIEKIYIM
TRVKAVRIL	TRVKAVRIL
HYDHVLIEL	HYDHVLIEL
FKSNVTKTM	FKSNVTKTM
NRPRNIMVY	NRPRNIMVY
SYNPVTHIY	SYNPVTHIY
SRLFFVIEY	SRLFFVIEY
YKNPDQVYL	YKNPDQVYL
SRNAITSSY	SRNAITSSY
KRIDIIHNL	KRIDIIHNL
YRADGIRIY	YRADGIRIY
HYLNVAFDL	HYLNVAFDL
SRKESSEVY	SRKESSEVY
TRPEKALIL	TRPEKALIL
WRSDTPLIY	WRSDTPLIY
NYDPNQRPF	NYDPNQRPF
GRSEAVVEY	GRSEAVVEY
VYPGYYLTF	VYPGYYLTF
SYDDVQQSF	SYDDVQQSF
VRVPYFIDL	VRVPYFIDL
FYPLFVHMY	FYPLFVHMY
LYDPVISKL	LYDPVISKL
KYFEKQFEL	KYFEKQFEL
MRYVASYLL	MRYVASYLL
TVMDKTRAL	TVMDKTRAL
RYREAIIKY	RYREAIIKY
YRQKQVVIL	YRQKQVVIL
TRSAIILHL	TRSAIILHL
KRSNYITRL	KRSNYITRL
FRKNFATSL	FRKNFATSL
VYDGKIYTL	VYDGKIYTL
FRPALPVSY	FRPALPVSY
YYDTHTNTY	YYDTHTNTY
LRDHSVRVL	LRDHSVRVL
TYDDGATKL	TYDDGATKL
AAQDRDQIY	AAQDRDQIY
TYGDAGLTY	TYGDAGLTY
YYNETHKIL	YYNETHKIL
FYSNKEIFL	FYSNKEIFL
YREILVKEL	YREILVKEL
YRNIEPVYL	YRNIEPVYL
ARTPVTSTY	ARTPVTSTY
GRHGVFLEL	GRHGVFLEL
NRNSIPLQL	NRNSIPLQL
SRHLDSYEF	SRHLDSYEF
QIPEIKQTL	QIPEIKQTL
VGPPGRSSL	VGPPGRSSL
TFRDVVIEF	TFRDVVIEF
HYPDFHQEL	HYPDFHQEL
YRRPVLLLH	YRRPVLLLH
RRPPILEDY	RRPPILEDY
ARSRFPQTF	ARSRFPQTF
IYDPNLAFL	IYDPNLAFL
FKPETYWVL	FKPETYWVL
GRPGPIGPA	GRPGPIGPA
YRMNAERIL	YRMNAERIL
KYFLRGYRY	KYFLRGYRY
AAPVSATVL	AAPVSATVL
ARHVVAVVL	ARHVVAVVL
IYRWFNISF	IYRWFNISF
ARHFLHHYY	ARHFLHHYY
IRTDFNILY	IRTDFNILY
HRHGKPFVF	HRHGKPFVF
FRTDGHPVM	FRTDGHPVM
NAPLVNVTL	NAPLVNVTL
ARAIYAYAL	ARAIYAYAL
RYDDMASAM	RYDDMASAM
YYISPRITF	YYISPRITF
AYDSTMETM	AYDSTMETM
AYLEAHETF	AYLEAHETF
YYDKHFTEF	YYDKHFTEF
AYLPVNESF	AYLPVNESF
LRPAVGYEL	LRPAVGYEL
VKSDYVVKY	VKSDYVVKY
FRFEEPVVL	FRFEEPVVL
TYDVQKLSL	TYDVQKLSL
SRFPEALRL	SRFPEALRL
YRDAYLFLL	YRDAYLFLL
SAPVPASPL	SAPVPASPL
FRADDADEF	FRADDADEF
LYHYYIMEL	LYHYYIMEL
VHVDVHSHY	VHVDVHSHY
TYYGSFVTR	TYYGSFVTR
YLPDGTASL	YLPDGTASL
SRGEQAWTL	SRGEQAWTL
QRPETAATL	QRPETAATL
LYDSTRVSF	LYDSTRVSF
SRKESYSVY	SRKESYSVY
ARNDYLLTL	ARNDYLLTL
MRRDVQEIF	MRRDVQEIF
TKIDVSYEY	TKIDVSYEY
FRPQQTEIY	FRPQQTEIY
FAPYERRAM	FAPYERRAM
NRRPSVYLP	NRRPSVYLP
NYHAQHYHL	NYHAQHYHL
SSPTSPNAL	SSPTSPNAL
IYDLVDRHL	IYDLVDRHL
AYPPPAPAY	AYPPPAPAY
GRYQVSWSL	GRYQVSWSL
RYPNIELSY	RYPNIELSY
VAPPVSGDL	VAPPVSGDL
YKPDVKIEY	YKPDVKIEY
YKVPQVRVL	YKVPQVRVL
NYRHVANTL	NYRHVANTL
IKADHVSTY	IKADHVSTY
FRPPLLEML	FRPPLLEML
ARHEHQVML	ARHEHQVML
NKKGEIFEL	NKKGEIFEL
YYDGKVMKL	YYDGKVMKL
