Data	Data aligned
YEILNNPEL	YEILNNPEL
REGGSIPVTL	REGGIPVTL
AEAFEAIPRAL	FEA-IPRAL
GEGKPTPAL	GEGKPTPAL
QESLAQARL	QESLAQARL
KEFIKIVEA	KEFIKIVEA
GENLKVLTV	GENLKVLTV
GEKQPELQI	GEKQPELQI
AETPARPGL	AETPARPGL
AEIDVIFKDF	AEIDIFKDF
KELEVPHF	KEL-EVPHF
AEYRHLRKL	AEYRHLRKL
REVEIQSHL	REVEIQSHL
YEQILNTKL	YEQILNTKL
REAVSKTAL	REAVSKTAL
IEKNLETPL	IEKNLETPL
SSEFEAPSL	SSEFEAPSL
SESGSNLHAL	SESGNLHAL
MEKTDETRL	MEKTDETRL
AEILNGKEISA	AEILNGKEI
SEHPDQAQAIL	SEHPQAQAI
HEVDDSSVVGL	HEVDDSSVV
SEMVELVEL	SEMVELVEL
KEKYPDAVYL	KEKYDAVYL
REANFTVSSM	REANTVSSM
GEVEGHPVW	GEVEGHPVW
AEIDPKQLVDI	AEIDPKQLV
IEKELLERL	IEKELLERL
ADASIRLLKA	ADA-SIRLL
AEGPAVSL	AEG-PAVSL
HEFDGDEQF	HEFDGDEQF
AEIKVKLIEA	AEIKKLIEA
ARELLPLLL	ARELLPLLL
SEYDRGVNTF	SEYDGVNTF
IEATGIAVHAL	IEA-TGIAV
GEIQAGAKL	GEIQAGAKL
EEWHGHVTAL	EEWHHVTAL
GEKGPVKVL	GEKGPVKVL
GEFTDLKQQL	GEFTLKQQL
IDYTGQQL	IDY-TGQQL
GEGPVITAL	GEGPVITAL
RDIDEVSSL	RDIDEVSSL
REFPTHRSVL	REFPHRSVL
SEGPIVATL	SEGPIVATL
GEESKRPPL	GEESKRPPL
QEVENFKKV	QEVENFKKV
SEAPEAPLL	SEAPEAPLL
QELDLSQNFL	QELDSQNFL
YEITEQRKI	YEITEQRKI
REDYTRYNQL	REDYRYNQL
GEIETIARF	GEIETIARF
KEKEPEEEL	KEKEPEEEL
VEHANIIKV	VEHANIIKV
KEKEPDYVLL	KEKEPDYVL
YEVGDPGQRTL	YEVGPGQRT
TELKGLSKI	TELKGLSKI
KEVQTNEL	KEV-QTNEL
GEIKSHDL	GEI-KSHDL
REELSNVL	REE-LSNVL
HEVGIGSVLSL	HEVGIGSVL
HELFTPPVI	HELFTPPVI
SEVDGLNSL	SEVDGLNSL
YEAVSPERL	YEAVSPERL
YERGFENIM	YERGFENIM
KEFGDDKVQL	KEFGDKVQL
GEIPKQVKV	GEIPKQVKV
AEFDTPGHTL	AEFDPGHTL
AEGPYKIIL	AEGPYKIIL
GEEVPRPIL	GEEVPRPIL
RELEKVLHKF	RELEVLHKF
AELKSSTVGL	AELKSTVGL
GEVPVHKL	GEV-PVHKL
GEARKQVEV	GEARKQVEV
REKSPGRML	REKSPGRML
VEAAQGVKIL	VEAAGVKIL
YETEGIRGL	YETEGIRGL
AEMLVELV	AEM-LVELV
REIQTAVRL	REIQTAVRL
REKIEASRNEL	IEA-SRNEL
AEKGVARVV	AEKGVARVV
ADTLALVF	ADT-LALVF
GEFSITYKP	GEFSITYKP
EEFQFIKKA	EEFQFIKKA
ESRLEKAELS	SRL-EKAEL
SEIPLPPIL	SEIPLPPIL
AESAPAWRL	AESAPAWRL
TEIKELKETL	TEIKLKETL
LEHVQPWSV	LEHVQPWSV
FETEPVSKL	FETEPVSKL
GEVRLGGSL	GEVRLGGSL
ASDKETYEL	ASDKETYEL
HESLQNPLL	HESLQNPLL
REQLKHKL	REQ-LKHKL
FENTFVVET	FENTFVVET
VEKVVVVIL	VEKVVVVIL
IEKFDKSKL	IEKFDKSKL
SEFILGKSEL	SEFIGKSEL
KEFEGKTLVSV	KEFEGKTLV
MEYQPIPIL	MEYQPIPIL
FEKASELRI	FEKASELRI
ITLSCPLDLTL	LSCPLDLTL
AEMTTRMV	AEM-TTRMV
AEFKEAFQL	AEFKEAFQL
EEREPTPVL	EEREPTPVL
KEDSKLIAL	KEDSKLIAL
KEALVQVEV	KEALVQVEV
VEYDPGTHDL	VEYDGTHDL
SEMHVPSVAL	SEMHPSVAL
GEMQKQAQL	GEMQKQAQL
NEKSPYASL	NEKSPYASL
IQRTPKIQVY	IQRTPKIQV
AEALPKQSV	AEALPKQSV
GEWNRKSPNL	GEWNKSPNL
REFGNLTRM	REFGNLTRM
TEVRVANEL	TEVRVANEL
REPSPSSSSL	REPSSSSSL
GEVIQRPANAI	GEVIRPANA
GEVRIWNL	GEV-RIWNL
TEAGVPLATL	TEAGPLATL
GALELLQQL	GALELLQQL
AEYAHPLETL	AEYAPLETL
KEWEKVFEM	KEWEKVFEM
LEKELQISL	LEKELQISL
HETLFILGV	HETLFILGV
GEFGKPYFIKL	GEFGKPYFI
DSDILVRKV	DSDILVRKV
GETEKLYQL	GETEKLYQL
TEVTLPKSI	TEVTLPKSI
AEAEKLFKQA	AEAELFKQA
GEHIIAGAGEL	GEH-IIAGA
AELDPVEYTL	AELDVEYTL
NEVIGIRQL	NEVIGIRQL
REGDLTNLL	REGDLTNLL
AEHSTVITF	AEHSTVITF
SEKVFVDVL	SEKVFVDVL
GEAPGVVRM	GEAPGVVRM
SDIPIHNAL	SDIPIHNAL
KESEVYKML	KESEVYKML
HETPKQPVV	HETPKQPVV
GEFSDTNAAV	GEFSTNAAV
GELLMHPVL	GELLMHPVL
SENKLPAEL	SENKLPAEL
SEITPAAFSTL	SEI-TPAAF
KESWDKILAL	KESWKILAL
GELKPRQQQDL	GELKPRQQQ
RELEDHIRKL	RELEHIRKL
AELDTTNSL	AELDTTNSL
GENRPIATL	GENRPIATL
LEQDFKVTL	LEQDFKVTL
KEFEDKKVEL	KEFEKKVEL
YEYEGGHIKT	YEYEGHIKT
TEYSKSEEKL	TEYSSEEKL
LEKAENQVL	LEKAENQVL
QEFGADVRL	QEFGADVRL
KEVDIYTV	KEV-DIYTV
AEVTTKSQI	AEVTTKSQI
AETHIVLLF	AETHIVLLF
TEYRKKWDAL	TEYRKWDAL
SDIIDPVAL	SDIIDPVAL
SELTQPKL	SEL-TQPKL
FEAPNQEKV	FEAPNQEKV
AEIGAAAQQSL	AEIGAQQSL
SEKENLTNEL	SEKELTNEL
HELGDFVILL	HELGFVILL
REAGFQVKA	REAGFQVKA
KESSPIPSP	KESSPIPSP
AEIRHVLVT	AEIRHVLVT
SEKVSHVL	SEK-VSHVL
SEFEGGKSTV	SEFEGKSTV
VEDPETGLRLL	VEDPTGLRL
FEIKEVVVTL	FEIKVVVTL
KELSSSLHQKL	KELSLHQKL
KEIEVEEV	KEI-EVEEV
AEFLTSKL	AEF-LTSKL
SESDKTAVLTL	SESDKTAVL
GEAVAPPST	GEAVAPPST
QDIASVVAL	QDIASVVAL
RELLLNLI	REL-LLNLI
GGKLGASVIEI	KLGASVIEI
TELRDLLVQTL	RDL-LVQTL
VDAKAQKL	VDA-KAQKL
SEMFPKTSV	SEMFPKTSV
QEVDLQQLI	QEVDLQQLI
FEVTGQETV	FEVTGQETV
NEYGPVLHM	NEYGPVLHM
ADLVVLGA	ADL-VVLGA
HEFRDKLAA	HEFRDKLAA
YEFIQGEAL	YEFIQGEAL
KEFIEGVSQF	KEFIGVSQF
KELKLLQTI	KELKLLQTI
RELWNQGAGLL	RELWQGAGL
REAAYNAITL	REAANAITL
AEYGEIKNI	AEYGEIKNI
TEIKKTEV	TEI-KKTEV
IEQEIRILL	IEQEIRILL
AETDHLFDL	AETDHLFDL
QESPLFNNVKL	QESPLFNNV
SEIRAPIVTV	SEIRPIVTV
RGWTGQESL	RGWTGQESL
LEADITAKL	LEADITAKL
IEVFLPPRL	IEVFLPPRL
SELVQKAKL	SELVQKAKL
QEVYHKSMTL	QEVYKSMTL
KENQNIAYVSL	KENQNIAYV
FEHKEEVL	FEH-KEEVL
HESPAVKLM	HESPAVKLM
IEQVNERVL	IEQVNERVL
GEHGLIIRV	GEHGLIIRV
AEVFIVKM	AEV-FIVKM
QEYAQVIKM	QEYAQVIKM
METDLANVL	METDLANVL
TEFDARKLHKL	TEF-DARKL
KDVEMVRL	KDV-EMVRL
REVKVAQL	REV-KVAQL
KELEAFREEL	KELEFREEL
EELVVQPLL	EELVVQPLL
GEYQRMGVM	GEYQRMGVM
HEGKVFISL	HEGKVFISL
GEIDGNKV	GEI-DGNKV
KESSIIGVTL	KESSIGVTL
QEIKTKIKEL	QEIKKIKEL
AEVYKELRL	AEVYKELRL
KEFEVKDPEL	KEFEKDPEL
RQADLKNWSL	ADL-KNWSL
MEIDGQKL	MEI-DGQKL
IEKSTQEKL	IEKSTQEKL
VEVKLTPLIL	VEVKTPLIL
GEHEIDYILL	GEHEIDYIL
GEDPNKAEEL	GEDPKAEEL
KELEVLLM	KEL-EVLLM
SEILQKEVYL	SEILKEVYL
AEIYGVTHT	AEIYGVTHT
KEKVTRIIL	KEKVTRIIL
GELDLPILKV	GELDPILKV
KEIYVISA	KEI-YVISA
SENPVPLTV	SENPVPLTV
SELQGERIVSL	SELQGERIV
REDEKPLVL	REDEKPLVL
KEFEGKTLV	KEFEGKTLV
AEIDREMISSL	IDREMISSL
KENVIRPIL	KENVIRPIL
VEVVITHL	VEV-VITHL
KEKYIDQEEL	KEKYDQEEL
GEGGSFGELAL	GEGGSFGEL
TEKWNTDNTL	TEKWTDNTL
SEALHAQSL	SEALHAQSL
AEVDPDTILKA	AEVDPDTIL
REAEKVLHYL	REAEVLHYL
REIEEKLHKL	REIEKLHKL
HEAWLIHKT	HEAWLIHKT
HEVDELTQII	HEVDELTQI
RELGFSSNL	RELGFSSNL
IEAALRESL	IEAALRESL
GERDSQTQAIL	GERDQTQAI
REKMTQIMF	REKMTQIMF
HEMQIQHPTA	HEMQQHPTA
GENDRGVSF	GENDRGVSF
AETQQPPAA	AETQQPPAA
SEEVVSREV	SEEVVSREV
SESSSSDRPVL	SSSSDRPVL
GEDKGIKAL	GEDKGIKAL
HQQSIPAVL	HQQSIPAVL
GELREQLKAL	GELRQLKAL
AENFVPPLL	AENFVPPLL
LERDDNPSL	LERDDNPSL
TEAPVPVSV	TEAPVPVSV
AEHNDLQYAA	AEHNLQYAA
REWTEQETL	REWTEQETL
KEYDWLQHL	KEYDWLQHL
AEAILGQNAA	AEAIGQNAA
REGEIAQFL	REGEIAQFL
SEHGINIDL	SEHGINIDL
HELVIKTL	HEL-VIKTL
SEEDFIRSL	SEEDFIRSL
TERANSMGL	TERANSMGL
IERTGIAAI	IERTGIAAI
AEFEVPKL	AEF-EVPKL
KEVERILGL	KEVERILGL
SEVDGNRMTL	SEVDNRMTL
IEHGQAVSL	IEHGQAVSL
KDSTLIMQL	KDSTLIMQL
KEFEEKRGL	KEFEEKRGL
HEIQRTENSL	HEIQTENSL
HETQTLVKT	HETQTLVKT
AEFSSAGHSL	AEFSAGHSL
GEIDRARAI	GEIDRARAI
AELLLIPKVL	AELLLIPKV
LEKQQVTIL	LEKQQVTIL
HEFSSPSHL	HEFSSPSHL
DEFTIIPVL	DEFTIIPVL
HEFDGDEEF	HEFDGDEEF
SEKHIEVEV	SEKHIEVEV
TEALPVKLI	TEALPVKLI
AEKNFELVI	AEKNFELVI
SEFKYNKPAFL	SEFKNKPAF
FEREVGRQSV	REV-GRQSV
KEKAIEVERI	KEKAEVERI
KEIGELTQL	KEIGELTQL
FERLMTIYL	FERLMTIYL
HDVVILDSL	HDVVILDSL
REMERLIKKL	REMELIKKL
YEEVHVPAL	YEEVHVPAL
REMKDLKEKM	REMKLKEKM
GEMKSGVPVL	GEMKGVPVL
HETALQGNVF	HETAQGNVF
VEKGHFAEL	VEKGHFAEL
AELEDRRQL	AELEDRRQL
KEVAELTRL	KEVAELTRL
REPRPFPKL	REPRPFPKL
GEIVALKKV	GEIVALKKV
TEYLEPVVL	TEYLEPVVL
NENSNIQVL	NENSNIQVL
KDDVVLPAL	KDDVVLPAL
REAATSNLKKL	REA-ATSNL
SEWKAGKGRVL	SEWKGKGRV
NEVVTDWIL	NEVVTDWIL
RESPLIVNTM	RESPIVNTM
KEDDVRQYVV	KEDDRQYVV
KEYSDDKVQL	KEYSDKVQL
IDVLGETL	IDV-LGETL
GDFKEISSV	GDFKEISSV
DHSDIQVTEL	SDI-QVTEL
EEYQNPHTV	EEYQNPHTV
LEVVQTEKL	LEVVQTEKL
KEGEEQPVL	KEGEEQPVL
SEHSGPPIVI	SEHSGPPIV
AEAQGSTTL	AEAQGSTTL
SEADKIKVA	SEADKIKVA
AESTSSRML	AESTSSRML
GEAPSKTLVET	GEA-PSKTL
LEANLAVLKL	LEANAVLKL
MDLVVKTV	MDL-VVKTV
LENVIRDAV	LENVIRDAV
AEIKTTNEVVL	AEIKTTNEV
KEKELVTTV	KEKELVTTV
AEIIQLVNA	AEIIQLVNA
LELEMNSDL	LELEMNSDL
SSDVVVQVL	SSDVVVQVL
REELREKDRLL	EELREKDRL
KELEPLKEM	KELEPLKEM
HEFEEATNLL	HEFEEATNL
GEVIPPMKEF	GEVIPMKEF
LEFQEGDIIL	LEFQGDIIL
ADYLAHES	ADY-LAHES
GEHHSTPSL	GEHHSTPSL
LEKKIEQEL	LEKKIEQEL
QEKLPDEVVL	QEKLDEVVL
QELDISDNKL	QELDSDNKL
YEEIVKEV	YEE-IVKEV
KEREVVNKDVL	REVVNKDVL
LEKSVLLEL	LEKSVLLEL
REIEIQAHL	REIEIQAHL
VEKYIEEQL	VEKYIEEQL
REKLAEKKELL	REKLEKKEL
LEKGVNTSV	LEKGVNTSV
TELDMTDFVF	TELDMTDFV
SESQKIPGM	SESQKIPGM
YEIDKTLGI	YEIDKTLGI
KEKDNIDITL	KEKDIDITL
LERFPWPSL	LERFPWPSL
FEQNLSEKL	FEQNLSEKL
RELDQQKLWL	REL-DQQKL
SEAKGLVTL	SEAKGLVTL
AELRSHALPGA	AEL-RSHAL
HEISEGNVATA	HEISEGNVA
AEKLGGSAV	AEKLGGSAV
SEAGQPQAL	SEAGQPQAL
RELDRERQKL	RELDERQKL
FEQVVNEL	FEQ-VVNEL
VEWEGATAS	VEWEGATAS
AEVAGQFVI	AEVAGQFVI
AEIGQVKQEL	AEIGVKQEL
HEWLQQHGI	HEWLQQHGI
TEFGGSIYQKV	TEFGSIYQK
AESEKWQQAL	AESEWQQAL
LERMGANSL	LERMGANSL
GEYPSGINTW	GEYPSGINT
REIDVRIDRNA	REIDVRIDR
SEISPIKGSV	SEISIKGSV
AEDPLGAIHL	AEDPGAIHL
KELGITAL	KEL-GITAL
GSDPVVIVSA	SDPVVIVSA
TEDGDRLYSL	TEDGRLYSL
AEVFHVPLL	AEVFHVPLL
AENVAVPEA	AENVAVPEA
TEMESQKQL	TEMESQKQL
IEKAILEQQVL	IEKALEQQV
PEYGEVIQL	PEYGEVIQL
AAPAYSRAL	AAPAYSRAL
REGDLLTKERL	GDLLTKERL
REISDHVLRM	REI-SDHVL
HEAVIEKHVF	HEAVEKHVF
AEIDLRQGRL	AEIDRQGRL
SEYMNNKEAL	SEYMNKEAL
TEAIGIISKM	TEAIIISKM
KEKLEPITL	KEKLEPITL
AEVRVQQQTA	AEVRQQQTA
SEWKDTNYTL	SEWKTNYTL
GEQGGGKLVL	GEQGGKLVL
HPDVLPFAL	HPDVLPFAL
TEKHFFHKV	TEKHFFHKV
KELPEYYEL	KELPEYYEL
GEVFRVVDTL	GEVFVVDTL
KEFEFSQL	KEF-EFSQL
IEAVLLNSL	IEAVLLNSL
QDVVQPLTL	QDVVQPLTL
RELEQEAKEL	RELEEAKEL
SELEKTFNL	SELEKTFNL
VEFVKSFNL	VEFVKSFNL
GEEAVPVAL	GEEAVPVAL
VDISVPKI	VDI-SVPKI
SEISSATKL	SEISSATKL
GEEVAMRTV	GEEVAMRTV
KETGDIKEL	KETGDIKEL
VEVSIPAKL	VEVSIPAKL
TEKGNLEVL	TEKGNLEVL
GEHPGLSI	GEH-PGLSI
AWDIAIATM	AWDIAIATM
LESKTYHAL	LESKTYHAL
LEGQIHPEL	LEGQIHPEL
AEQKVEYTL	AEQKVEYTL
REHVVAASKAM	REHVAASKA
AEVVLAHL	AEV-VLAHL
PVFNSVEL	PVF-NSVEL
SELDVPFKV	SELDVPFKV
IELPNIQKV	IELPNIQKV
HEWEERRDAL	HEWERRDAL
REASPLSSNKL	REASSSNKL
SELNISEIQKL	SEL-NISEI
AEVTPLLNL	AEVTPLLNL
AEKILKEQERL	AEKIEQERL
REYRPEYERL	REYREYERL
EGDNEFERIL	GDNEFERIL
GEFNEQVLRLM	GEFNQVLRL
HEAQHGVTSL	HEAQGVTSL
REEWKLDTL	REEWKLDTL
QVHPDTGISSK	PDT-GISSK
NELEKLPSL	NELEKLPSL
NEIENLKNEL	NEIELKNEL
HEYQVNGKRIL	HEYQNGKRI
GELEYATKI	GELEYATKI
QENDRVVMV	QENDRVVMV
SDFIAPLHSG	SDFIAPLHS
LEEPVVLAL	LEEPVVLAL
AEINEIIRVL	AEINIIRVL
KELDPTNMTYI	KELDPTNMT
TEFGGVTQHL	TEFGVTQHL
EEIKDFLLTA	EEIKFLLTA
SESQKIPGMTL	SESQKIPGM
SETPTFAKV	SETPTFAKV
HESAAHAIVSV	HES-AAHAI
VEKKPLVAL	VEKKPLVAL
GEFIIGRVI	GEFIIGRVI
AEYENLTNKL	AEYELTNKL
WEPLPLSSL	WEPLPLSSL
SEFGAPVSV	SEFGAPVSV
KENDFDRLVL	KENDDRLVL
SEFSGDVDSL	SEFSDVDSL
TELIKVDKV	TELIKVDKV
QELILQQI	QEL-ILQQI
AEAEKSQLIM	AEAEKSQLI
AELPLIRL	AEL-PLIRL
KEVAQAVLL	KEVAQAVLL
AEHADTVQL	AEHADTVQL
EEIGAEMAL	EEIGAEMAL
AEIDLQEL	AEI-DLQEL
SEIELFRVFSL	SEIELFRVF
VDVTGPHL	VDV-TGPHL
REGDLLFTV	REGDLLFTV
GERESGLRSL	GEREGLRSL
VEHDAFIFAL	VEHDFIFAL
QELQEINRV	QELQEINRV
AEYPAVKF	AEY-PAVKF
REKENVTVL	REKENVTVL
VEFREVTEL	VEFREVTEL
SDVAYHNSL	SDVAYHNSL
HEKQVYDIAA	HEKQYDIAA
TEAETIQKL	TEAETIQKL
SEINSLPTI	SEINSLPTI
LEHEYIHNF	LEHEYIHNF
GERVIVEHA	GERVIVEHA
KEKKLVKEVI	KEKKLVKEV
GEYDVTVPKL	GEYDTVPKL
AESERVVQEAL	SERVVQEAL
VESDVKSQTIL	SDVKSQTIL
GEAHLKTIL	GEAHLKTIL
KEFSGNPIKV	KEFSNPIKV
AEIRHVLVTL	AEIRVLVTL
KENQNIAYV	KENQNIAYV
KEFEENTQHL	KEFENTQHL
QESAAKLHAL	QESAKLHAL
EEFLSKVSI	EEFLSKVSI
LERIEETAL	LERIEETAL
KEVKEVATL	KEVKEVATL
REKDDDVVSL	REKDDVVSL
AEKIVAEAI	AEKIVAEAI
SEVDLTRSFSF	SEVDLTRSF
YETVIMPVF	YETVIMPVF
HEQFIPIAA	HEQFIPIAA
HPISSEELL	HPISSEELL
FEIFLPTSL	FEIFLPTSL
VEEENIRVV	VEEENIRVV
KELSPAGSI	KELSPAGSI
LEQLVQEQL	LEQLVQEQL
HELEKKIEL	HELEKKIEL
IEYQSKPLL	IEYQSKPLL
SESKIRVLL	SESKIRVLL
AEIQETITAL	AEIQTITAL
VEFDEVDSL	VEFDEVDSL
KEAVIKHSL	KEAVIKHSL
LERQGQGQL	LERQGQGQL
AETEARTL	AET-EARTL
AEEKLPMTL	AEEKLPMTL
AEALPRPNWEL	AEALPRPNW
MEMVKPSL	MEM-VKPSL
IERIDGVSL	IERIDGVSL
VEWKGTSQL	VEWKGTSQL
AETERKKAL	AETERKKAL
GEVNLGPNKM	GEVNGPNKM
AEIDAHLV	AEI-DAHLV
KEITQEMQTL	KEITEMQTL
AELNKIFAL	AELNKIFAL
SELEKPQKV	SELEKPQKV
AEDPLVQSL	AEDPLVQSL
VEWNKKEEL	VEWNKKEEL
REYELRKNNF	REYERKNNF
SEMTQVKEV	SEMTQVKEV
AERQPLGHVT	AERQPLGHV
KEGMFNNANVL	GMFNNANVL
QEFEEKSGRTF	FEEKSGRTF
IEYEHERDM	IEYEHERDM
LLEGEESR	LLE-GEESR
AEISQPPAL	AEISQPPAL
SEMDRVPFV	SEMDRVPFV
KEQVPPPAV	KEQVPPPAV
SDFEARQL	SDF-EARQL
REELFIQKL	REELFIQKL
REFLFNAIETM	REF-LFNAI
LEKGIEIL	LEK-GIEIL
GEQELFVQF	GEQELFVQF
GEAEYIQRL	GEAEYIQRL
VDWIVADIL	VDWIVADIL
EETQPPVAL	EETQPPVAL
AESQGRSEILM	AESQRSEIL
AEALATHILSL	AEALATHIL
LEKIIPLVV	LEKIIPLVV
AEFKEGKKEL	AEFKGKKEL
AEFIVAKAI	AEFIVAKAI
LETTVQKV	LET-TVQKV
GEKFEFSGL	GEKFEFSGL
SEAYLVGL	SEA-YLVGL
GEKFEDENFIL	GEKFEDENF
HENESVYKASL	HENESVYKA
SELIGQFGV	SELIGQFGV
KEQEGFINL	KEQEGFINL
YEKTPFDQL	YEKTPFDQL
GEHTLLVTV	GEHTLLVTV
GEVPFNHEIL	GEVPFNHEI
KENPVVVA	KEN-PVVVA
GEALPHVVPTL	GEA-LPHVV
AEKVEIATL	AEKVEIATL
LETSTGHSL	LETSTGHSL
TEHYSPLSL	TEHYSPLSL
TEHAHQVVV	TEHAHQVVV
YEGSPIKVTL	YEGSIKVTL
KEFEGKTLVS	KEFEGKTLV
AETRAGLTL	AETRAGLTL
AEAHRIQQI	AEAHRIQQI
RENLEEEAIIM	RENLEEEAI
LEILINRL	LEI-LINRL
HEDLLNITL	HEDLLNITL
AEDTAHPKL	AEDTAHPKL
AEARINAQL	AEARINAQL
YEAFPHDSQL	YEAFHDSQL
KESDHIHIIAL	SDHIHIIAL
AEAAALEVL	AEAAALEVL
KEKEKVSTAVL	KEKVSTAVL
KEAPAPPKA	KEAPAPPKA
KEMDLSVETLF	KEMDSVETL
REIEGDLLL	REIEGDLLL
GELGNGNIKL	GELGGNIKL
SESTNQRVL	SESTNQRVL
IEWDKPPVP	IEWDKPPVP
RERITSEAEDL	RER-ITSEA
EKLGETEKL	EKLGETEKL
TEKKIPVVF	TEKKIPVVF
HEGEGNIRSV	HEGENIRSV
SEAYLVGLL	SEAYLVGLL
AEFEQGHQF	AEFEQGHQF
SELAKERVV	SELAKERVV
AEYIQKNVQL	AEYIKNVQL
SEGTFGIHV	SEGTFGIHV
REAAAVFQETL	REAAVFQET
QEAEMAQNAV	AEM-AQNAV
AEIKDGERL	AEIKDGERL
KEFPLLSMF	KEFPLLSMF
REVLPEHVSVL	REVLEHVSV
SEAKDLISKL	SEAKLISKL
GELRHITKL	GELRHITKL
TESGLNVTL	TESGLNVTL
NEIRTLIDL	NEIRTLIDL
REDGSHILTV	REDGHILTV
RELAKAEKL	RELAKAEKL
LERTGYTL	LER-TGYTL
LEDAGVREL	LEDAGVREL
HELDQGQQL	HELDQGQQL
HEAQLSEKISL	HEAQLSEKI
TELLWPGAAL	TELLPGAAL
AEYMPIKL	AEY-MPIKL
GEFQIVNPHL	GEFQVNPHL
SEIKISNPTEF	SEIKISNPT
AELKQIVDQSL	AELKVDQSL
QEIDGRFTSI	QEIDRFTSI
LDKATVLL	LDK-ATVLL
IEKKKGDFVL	IEKKGDFVL
SEGNITKQL	SEGNITKQL
FEQLALPVL	FEQLALPVL
LEAAIPERV	LEAAIPERV
QQHLVLLSL	QQHLVLLSL
AEPTVTNIL	AEPTVTNIL
PEYQGQPVV	PEYQGQPVV
AEPILPYAL	AEPILPYAL
AESQELIYTF	AESQLIYTF
YEKIDLTLL	YEKIDLTLL
HEAPIPTF	HEA-PIPTF
GEFSPNVPKSL	GEFSVPKSL
YEIQHGDLKL	YEIQGDLKL
HEIEVETI	HEI-EVETI
PDVVVPTL	PDV-VVPTL
RETSPNRIGL	RETSNRIGL
QEIEEFKERL	QEIEFKERL
SEKLVSVM	SEK-LVSVM
RQIIAVVL	RQI-IAVVL
FEADPPGQVAA	FEADPGQVA
KETHVMDYRAL	KETHMDYRA
SEDEVKLAL	SEDEVKLAL
HENDAIHKI	HENDAIHKI
WEWPNPVLL	WEWPNPVLL
PEAAEGPEV	PEAAEGPEV
VEIAKQSV	VEI-AKQSV
GEIDLAKL	GEI-DLAKL
AEGDLVRLL	AEGDLVRLL
LEFPAQEL	LEF-PAQEL
REGSFKETI	REGSFKETI
KEQDIYTHL	KEQDIYTHL
GEAGAKFIEV	GEAGKFIEV
LEQPTWQL	LEQ-PTWQL
AEVQKLQAL	AEVQKLQAL
AEVEGRLPA	AEVEGRLPA
KENSPEKFAL	KENSEKFAL
AERVKQENL	AERVKQENL
KEANPAVPEV	KEANAVPEV
SEADPSGVASI	SEADPSGVA
LEKEVIAL	LEK-EVIAL
AEEKMPLSL	AEEKMPLSL
REKDPKYSAL	REKDKYSAL
KEPDSEQQPL	KEPDEQQPL
AETPGHTPSL	AETPHTPSL
NEASVLHNL	NEASVLHNL
KDFEQPLAI	KDFEQPLAI
HEISNAVREM	HEISAVREM
YENLVVAL	YEN-LVVAL
QETISLVVV	QETISLVVV
FEWVAERVEL	FEWVERVEL
ADVIYPMAV	ADVIYPMAV
IAVGYVDDTQF	VGYVDDTQF
KEKLIKRQEEL	KEKLRQEEL
SEFKEFSQSF	SEFKFSQSF
NEVFIGESL	NEVFIGESL
KEIEGVTKT	KEIEGVTKT
AEQEKTLAL	AEQEKTLAL
GESHIGGVLL	GESHGGVLL
HEVPGHQSV	HEVPGHQSV
REWTGIDRL	REWTGIDRL
AESVVPARM	AESVVPARM
GEWPTQLDV	GEWPTQLDV
LEKIADPTL	LEKIADPTL
VERVIVVSM	VERVIVVSM
GEPRVKHFEA	GEP-RVKHF
TEKITQTLL	TEKITQTLL
RDFKAYSL	RDF-KAYSL
YELPDGQVI	YELPDGQVI
NEHDVVVQL	NEHDVVVQL
VETAKVYQL	VETAKVYQL
REYEDGPLSL	REYEGPLSL
AEPLEIILHL	AEPLIILHL
AENPGKYNI	AENPGKYNI
IELEEPPLVL	IELEPPLVL
ADVSVPKL	ADV-SVPKL
HEAMEQQTI	HEAMEQQTI
VEAPPSVVL	VEAPPSVVL
SEVGKLLSA	SEVGKLLSA
GEIINTHTLL	GEIINTHTL
KETGTPISM	KETGTPISM
TELTTKSSL	TELTTKSSL
GELIRPTTL	GELIRPTTL
HEDPSIISM	HEDPSIISM
RELPAGINSI	RELPGINSI
SEMPAAKRL	SEMPAAKRL
KEKGSTLDL	KEKGSTLDL
AEIPGVRSV	AEIPGVRSV
LEFDPAQRITL	LEFDPAQRI
AEKPVLTAV	AEKPVLTAV
GEYGDQNSRLV	GEYGQNSRL
KEIQSSNLET	KEI-QSSNL
IETEGKMIM	IETEGKMIM
AEQSVAKASL	AEQSAKASL
ADAVAVTM	ADA-VAVTM
GEIPVVAI	GEI-PVVAI
REHTALLKI	REHTALLKI
LSELEAALQR	SELEAALQR
SEAPFLHYL	SEAPFLHYL
MELDLPPTHS	MELDLPPTH
KEFSEENVL	KEFSEENVL
LERLGSLTL	LERLGSLTL
AENGFLPIHLL	AENGLPIHL
KEVTPKPVL	KEVTPKPVL
KEGEFVAQF	KEGEFVAQF
AEHNFVAKA	AEHNFVAKA
TETIAPKI	TET-IAPKI
REVDQVKRL	REVDQVKRL
YEHDDIVSTV	YEHDIVSTV
LEKKETPSL	LEKKETPSL
AEAENKAAAL	AEAEKAAAL
SEQGLIEIL	SEQGLIEIL
GEFRTGKTQI	GEFRGKTQI
MEVEVDGQKF	MEVEDGQKF
KEIFLRELI	KEIFLRELI
LEYDPAKRITL	LEYDPAKRI
VEYDGERKKTL	YDGERKKTL
SEIHSGNSVSL	SEIHSGNSV
AEPLRPGPAL	AEPLPGPAL
VGTKSELII	VGTKSELII
SEHRLSNKL	SEHRLSNKL
AEWREALRAL	AEWRALRAL
AEYQELLDVKL	QEL-LDVKL
GELVLDNNSV	GELVDNNSV
SEIRSAWQAL	SEIRAWQAL
AEKRDPQELVA	AEKRDPQEL
FEFAGYDVL	FEFAGYDVL
YEAVREVL	YEA-VREVL
IEVENKEVL	IEVENKEVL
HESRQITQV	HESRQITQV
KEVATVTKL	KEVATVTKL
GEVLISRV	GEV-LISRV
QEVGLFHL	QEV-GLFHL
AEAEAVAALLL	AEAEAVAAL
MENKIRSTL	MENKIRSTL
RELVAIKKV	RELVAIKKV
AEAFVRAFL	AEAFVRAFL
NEIKDSVVA	NEIKDSVVA
GEGRPPVL	GEG-RPPVL
LDALGHEL	LDA-LGHEL
DEHAGVISV	DEHAGVISV
AESGAKEEL	AESGAKEEL
SETQFSHL	SET-QFSHL
EEFLKLPRL	EEFLKLPRL
TEIGSIHSA	TEIGSIHSA
HEMEEIRKKL	HEMEIRKKL
REIDKKMNSI	REIDKMNSI
REMENIIATV	REMEIIATV
KELNILHEM	KELNILHEM
YEKTIAQMI	YEKTIAQMI
IEHLIGKKL	IEHLIGKKL
KDLANQVSV	KDLANQVSV
YEGEVTEL	YEG-EVTEL
YELLMPHRI	YELLMPHRI
GEKHRELRL	GEKHRELRL
GQWKKGFVL	GQWKKGFVL
SEIHSLVHRL	SEIHLVHRL
SEYPVILSI	SEYPVILSI
QELDLSNNHL	QELDSNNHL
KEAEILEVL	KEAEILEVL
REYQDLLNVKM	REYQDLLNV
REKYGDKML	REKYGDKML
KEVEATKL	KEV-EATKL
GEFGKPYFI	GEFGKPYFI
IEYARQLEMIV	IEYARQLEM
KEIFFHYSEF	KEIFHYSEF
SEIILRQEVL	SEIIRQEVL
REIEGSQVTF	REIESQVTF
KEFNFPEEAVL	KEFNPEEAV
NERPIIFAL	NERPIIFAL
KEQEPMPTV	KEQEPMPTV
VEKPLKLVL	VEKPLKLVL
REFEKMNQSL	REFEMNQSL
AEYRLGPLL	AEYRLGPLL
AEAVSRVL	AEA-VSRVL
KEFKNGYNL	KEFKNGYNL
SEIDQLFRIF	SEIDQLFRI
LENDKTIKL	LENDKTIKL
RETDDTLVL	RETDDTLVL
KEVFGDLLL	KEVFGDLLL
TEFVHQNSQEI	TEFVHQNSQ
EEGKNIIVIM	EEGKNIIVI
KENQHVQQTL	KENQVQQTL
AEQPSVKL	AEQ-PSVKL
HEFSKTEELKL	HEFSKTEEL
AEIAAKDKL	AEIAAKDKL
KEFEKRKML	KEFEKRKML
AEKLEALSV	AEKLEALSV
KELLITDL	KEL-LITDL
RELSGTIKEI	RELSTIKEI
SESSTVRTV	SESSTVRTV
VEKKVPLL	VEK-KVPLL
YEVTPPTL	YEV-TPPTL
AEVGDGTTSV	AEVGGTTSV
TEKKIARAL	TEKKIARAL
YELLFKEGVM	YELLFKEGV
QEVECEEQRL	QEVEEEQRL
HEVEKMFTL	HEVEKMFTL
NEADLVRPL	NEADLVRPL
LRVAPEEHPVL	RVAPEHPVL
KELDPIQKL	KELDPIQKL
KELIYKEVM	KELIYKEVM
SELEESLLVL	SELESLLVL
AELQRLVAA	AELQRLVAA
KDFRVQEL	KDF-RVQEL
KDWEMHVHF	KDWEMHVHF
SEVAAIGQL	SEVAAIGQL
GETSTVEKL	GETSTVEKL
AEFEKIQKL	AEFEKIQKL
GEISTIDKV	GEISTIDKV
SETEGTPKL	SETEGTPKL
GEFKKYLEV	GEFKKYLEV
GELKIAYQL	GELKIAYQL
FENPHTSTM	FENPHTSTM
NELDGIPLI	NELDGIPLI
YEKIHKDHL	YEKIHKDHL
REFQNPPQL	REFQNPPQL
IEWRDRRITL	IEWRRRITL
HEFFEAIGF	HEFFEAIGF
SELQVHSAL	SELQVHSAL
SEITTKDL	SEI-TTKDL
MEHTEVLQL	MEHTEVLQL
MEGAIIYVI	MEGAIIYVI
GEARKQVEVF	GEARKQVEV
AEGPVVEKI	AEGPVVEKI
HESGASIKI	HESGASIKI
RELVKNWVP	RELVKNWVP
TEIQQQSAL	TEIQQQSAL
AELGSSTSL	AELGSSTSL
KEYVAPRVL	KEYVAPRVL
AEHKEFITAL	AEHKFITAL
GEPDHNEAL	GEPDHNEAL
REIRKELKI	REIRKELKI
SESSPPKAM	SESSPPKAM
AEVSPDAKTSL	AEVSPDAKT
RDSIVAEL	RDS-IVAEL
SEGPPAPAL	SEGPPAPAL
REGSYDRYL	REGSYDRYL
GEFAKVLEL	GEFAKVLEL
KEAEPDLLAVL	AEPDLLAVL
KERSGVSL	KER-SGVSL
RELDATATVL	RELDTATVL
LEKRTSPQVL	LEKRSPQVL
REKQHTKAIEL	REKQHTKAI
TDRVMTVSF	TDRVMTVSF
SQANIAQVL	SQANIAQVL
SEDRSVQEVL	SEDRVQEVL
SEAGSHIIQRM	SEA-GSHII
LERQTWDQL	LERQTWDQL
KEFLKPEKF	KEFLKPEKF
RELENGNLEV	RELEGNLEV
TVTEKPEVID	TVTEKPEVI
LEHGADPTV	LEHGADPTV
AEQAKVVL	AEQ-AKVVL
SERELFNAV	SERELFNAV
AEGEPRYAL	AEGEPRYAL
LEHELQSRL	LEHELQSRL
AEKSEQPTL	AEKSEQPTL
GEAVELRSL	GEAVELRSL
YEEEVKKTL	YEEEVKKTL
QELKLIGEYGL	QELKGEYGL
NEFVHINNL	NEFVHINNL
HETQPPSV	HET-QPPSV
AEKVQREPLL	AEKVREPLL
KENRGINTL	KENRGINTL
GEVYAIETF	GEVYAIETF
FEGAVIRTV	FEGAVIRTV
KEIGTKQSF	KEIGTKQSF
TEKTKPEVL	TEKTKPEVL
QEGDIILVL	QEGDIILVL
QEVDAIGQTL	QEVDIGQTL
SELGGIWSV	SELGGIWSV
REIFLSQPIL	REIFSQPIL
SEKHVRLEHL	SEKHRLEHL
LERDISQDSL	LERDSQDSL
AELKQVQTL	AELKQVQTL
REAEDTQVF	REAEDTQVF
KEGVVYVEV	KEGVVYVEV
RESTKISSL	RESTKISSL
SELDLAVPF	SELDLAVPF
IETIVAAM	IET-IVAAM
YEDEDSLKTL	YEDESLKTL
IENKVVADL	IENKVVADL
GEYGDQNSRL	GEYGQNSRL
SENAIVWKI	SENAIVWKI
GESKYLMAL	GESKYLMAL
TETVHIFKL	TETVHIFKL
KELLGQGLLL	KELLQGLLL
HEVMEQQTI	HEVMEQQTI
SELEGNLQTL	SELENLQTL
KENPSTVGV	KENPSTVGV
IEKLEEYRL	IEKLEEYRL
LETLVMPTL	LETLVMPTL
ARPEAPPAK	ARPEAPPAK
TEEERRAEL	TEEERRAEL
GEVQDLLVRL	GEVQLLVRL
GEVTKQTVL	GEVTKQTVL
SEHINEGETAM	SEHIEGETA
HEFVIEAGAL	HEFVEAGAL
EEFLEIMAL	EEFLEIMAL
VDVGELVGL	VDVGELVGL
ADFGLARAF	ADFGLARAF
YEDGSIRIF	YEDGSIRIF
HEFHSPAL	HEF-HSPAL
RETAQAIKGM	RETAAIKGM
REDGSFSFYSL	RED-GSFSF
REIVIGVLHQL	REI-VIGVL
NTDEMVEL	NTD-EMVEL
HEVPSVLGTPL	HEVPSVLGT
PRLCDVLQVL	RLCDVLQVL
SEFGKLERV	SEFGKLERV
WEKESGESQRL	KESGESQRL
SEQKFLIGL	SEQKFLIGL
AETRESTQL	AETRESTQL
SEFSDVDKL	SEFSDVDKL
RELRIRKL	REL-RIRKL
AEANHFIDL	AEANHFIDL
VEILIPVAA	VEILIPVAA
REWVAPEKA	REWVAPEKA
AEKLITQTF	AEKLITQTF
AENGLTVRL	AENGLTVRL
AEGAGLHAL	AEGAGLHAL
IESSVGKSL	IESSVGKSL
LEFQKSLETL	LEFQSLETL
RELEVQHPAA	RELEQHPAA
AEWLGVLKA	AEWLGVLKA
NEHHVNATL	NEHHVNATL
HEWHKRVAL	HEWHKRVAL
VELAENGKK	VELAENGKK
VEYEVPEAAQL	YEVPEAAQL
SEGPLVGSV	SEGPLVGSV
AEIPLRMV	AEI-PLRMV
LEADSILQAL	LEADILQAL
KEPDVSEEL	KEPDVSEEL
AEAHAKVRL	AEAHAKVRL
KEFDGTKVFL	KEFDTKVFL
REGFLDTLVV	REGFDTLVV
IERYPEETL	IERYPEETL
NVEIDPEIQ	NVEIDPEIQ
HEFFHILNL	HEFFHILNL
HDFQDIASV	HDFQDIASV
REDKVHLKL	REDKVHLKL
TELIQKAKL	TELIQKAKL
SEIIGLLML	SEIIGLLML
AEAAEVILRV	AEAAVILRV
KEVDVSKQL	KEVDVSKQL
LETDSVQRL	LETDSVQRL
SEIVGSIKM	SEIVGSIKM
SEYITHEI	SEY-ITHEI
TEIPLTGL	TEI-PLTGL
LERAIESL	LER-AIESL
KEVEIRKKVL	KEVERKKVL
TETARIAQL	TETARIAQL
RELEVQHPA	RELEVQHPA
AEKELVTII	AEKELVTII
GELKITSV	GEL-KITSV
SEAPGQRAL	SEAPGQRAL
AEDGSRVYVV	AEDGRVYVV
GEGDSVITQVL	GEGDVITQV
HEMEKAFAF	HEMEKAFAF
GEIQEIVKTGL	GEIQEIVKT
GENPQVPKL	GENPQVPKL
RELDTVTL	REL-DTVTL
YELGGPMTL	YELGGPMTL
WEDTVQPLL	WEDTVQPLL
RDHAVVVGV	RDHAVVVGV
AEFKVRAL	AEF-KVRAL
REVEGLKDLL	REVEGLKDL
SEVELMKVA	SEVELMKVA
RELSLTSQL	RELSLTSQL
VEAVLAGHEA	VEAVAGHEA
QEFELPYVSV	QEFEPYVSV
LAVSLAVIL	LAVSLAVIL
SEKILLLCV	SEKILLLCV
QEHPSIRTL	QEHPSIRTL
LEMIQQEKL	LEMIQQEKL
LEKKIGKSI	LEKKIGKSI
QEIPIIAL	QEI-PIIAL
HEADKTYML	HEADKTYML
VEVPDGPTL	VEVPDGPTL
EEYDDRTARVL	EEYDRTARV
GEISKKVAQI	GEISKVAQI
SEVNIPLSL	SEVNIPLSL
KEDRGRPYTL	KEDRRPYTL
NEFHSPIGL	NEFHSPIGL
YEYDNLYVHF	YEYDLYVHF
QEVPIIIVF	QEVPIIIVF
ELPQAAPPQI	LPQAAPPQI
AEVLNKHSL	AEVLNKHSL
KEPELFQTV	KEPELFQTV
KESEKQLLL	KESEKQLLL
TEWERVARL	TEWERVARL
DEIQVPVL	DEI-QVPVL
HEQEEIFKL	HEQEEIFKL
AEVDKVARL	AEVDKVARL
REIEQVNERVL	REIEVNERV
AETDLSQGV	AETDLSQGV
LEKGLATSL	LEKGLATSL
DSDFPIHNL	DSDFPIHNL
HDINAQMV	HDI-NAQMV
GEPGAQPQL	GEPGAQPQL
SEKVHVNLL	SEKVHVNLL
SEIESVKI	SEI-ESVKI
GEFADPFKL	GEFADPFKL
IENSIVHRV	IENSIVHRV
REAEQRRAYL	REAERRAYL
SEKVAHNIL	SEKVAHNIL
NEFKNIPEI	NEFKNIPEI
KELILHNPVTL	KELILHNPV
AERDVYTGDAL	RDVYTGDAL
SETKTRVL	SET-KTRVL
NEFILYAV	NEF-ILYAV
LESKTNTL	LES-KTNTL
REVRQKVQL	REVRQKVQL
NEGIAIFAL	NEGIAIFAL
AEKSPGPIV	AEKSPGPIV
LEKERQEQL	LEKERQEQL
AEHSESGQLV	AEHSESGQL
KENSLHRAL	KENSLHRAL
REENKQIAL	REENKQIAL
SEQVIVEVL	SEQVIVEVL
LELPGQPSV	LELPGQPSV
TENPHGVKAV	TENPGVKAV
FEKQSPSAL	FEKQSPSAL
AEALPSLAA	AEALPSLAA
IEKEVGNDL	IEKEVGNDL
GENSGIGKL	GENSGIGKL
NDVLVPKPF	NDVLVPKPF
KEIADLKKQEL	ADL-KKQEL
GESEKLVRL	GESEKLVRL
ADFEIGHFL	ADFEIGHFL
KEIELPSGQL	KEIEPSGQL
AEIGAVTLV	AEIGAVTLV
SELEQIEL	SEL-EQIEL
SEMVKLYDL	SEMVKLYDL
TEKQYIATI	TEKQYIATI
TEKHVQVAV	TEKHVQVAV
AERVGLHKV	AERVGLHKV
KEFEKEISA	KEFEKEISA
RELESQLHVL	RELEQLHVL
AEASMISKL	AEASMISKL
GEWPDQPRI	GEWPDQPRI
HEVFNHREV	HEVFNHREV
GEFQFPPKSL	GEFQPPKSL
EEFNQPLSV	EEFNQPLSV
EEFNTGPLSVL	EEFNGPLSV
KELTLENSEL	KELTENSEL
HELVQTAL	HEL-VQTAL
NDIAINEL	NDI-AINEL
EEYPNKPPT	EEYPNKPPT
VEAPMPKL	VEA-PMPKL
REASPSRLSV	REASSRLSV
SEIYIHGLGL	SEI-YIHGL
SEMVTIKL	SEM-VTIKL
YERIYNEIP	YERIYNEIP
TEHGVKVTA	TEHGVKVTA
SEFLLTHPVL	SEFLTHPVL
REREEFYRL	REREEFYRL
QEMDAQTIAKL	MDAQTIAKL
VEKFGDLIL	VEKFGDLIL
RQFSGARNQL	RQFSARNQL
AERQRQIQL	AERQRQIQL
AEIDARNDSF	AEIDRNDSF
GEDRSPPTAL	GEDRPPTAL
AEHPIVIVC	AEHPIVIVC
AELGLAPSAL	AELGAPSAL
AETPEGHAV	AETPEGHAV
KEHDLAMINQL	HDLAMINQL
LEHVDFSSL	LEHVDFSSL
KEVPIHRV	KEV-PIHRV
YEIHDGMNL	YEIHDGMNL
FEHPNVVRL	FEHPNVVRL
QEKAIPLAL	QEKAIPLAL
VDYPIYDVL	VDYPIYDVL
KEINKAQNAI	KEINAQNAI
HESQLSVEL	HESQLSVEL
VEHVVNAIL	VEHVVNAIL
VEVLLPKF	VEV-LLPKF
SEVVGSSTL	SEVVGSSTL
REGERREQVL	REGEREQVL
GERFPWQEL	GERFPWQEL
AEMAQNAVRL	AEMANAVRL
IEALVRTVL	IEALVRTVL
AEMREKLRL	AEMREKLRL
KEFLMENRV	KEFLMENRV
GEPNIDSPL	GEPNIDSPL
LEEKLPSL	LEE-KLPSL
GEVESIEL	GEV-ESIEL
IKNNLLSKKLP	KNNLLSKKL
SEDFPRPLV	SEDFPRPLV
AESSPFVERLL	AESSFVERL
KEKNDEILSL	KEKNEILSL
ESVGKIEIV	ESVGKIEIV
AEFGAAGVNRL	AEF-GAAGV
GEGKNGTIEL	GEGKGTIEL
AEKNSNVETL	AEKNNVETL
QERVTLLDL	QERVTLLDL
GEIASFDKAKL	GEIASFDKA
QENAEIIKL	QENAEIIKL
GETREKSPKL	GETRKSPKL
KEFVGKPTI	KEFVGKPTI
VEHISGVSL	VEHISGVSL
GELKDLTQKV	GELKLTQKV
GEAKVKKQLV	GEAKVKKQL
AEHLKTLSL	AEHLKTLSL
YEAPDVMNL	YEAPDVMNL
LCVATVGIAV	VAT-VGIAV
SDYTPLSL	SDY-TPLSL
QEKPLLRAL	QEKPLLRAL
HEAAFPIAVV	HEAAFPIAV
DSDVEVYRA	DSDVEVYRA
KERELDQQKL	KEREDQQKL
GESIDIITRA	GESIIITRA
GELQSLRPIL	GELQLRPIL
KEFMPPGLQEL	KEF-MPPGL
GEGKLFSLEL	GEGKFSLEL
VELLGETSI	VELLGETSI
VEQEIQTSV	VEQEIQTSV
RERFLKGEGL	RERFKGEGL
KEDDPKAAL	KEDDPKAAL
MPADIATLL	MPADIATLL
GEALGFVSL	GEALGFVSL
NEYFTNEVL	NEYFTNEVL
AEDSVSQRAVL	AEDSSQRAV
QELPGLPLV	QELPGLPLV
HEDPGQATL	HEDPGQATL
REIRRKLREL	REIRKLREL
HEAVPLSVF	HEAVPLSVF
EEWPNPPTL	EEWPNPPTL
AEIDRRISA	AEIDRRISA
QEFGILDKV	QEFGILDKV
REDSQRPGAHL	REDSQRPGA
AEDPSKSYVKL	AEDPSKSYV
EEWLSIPEV	EEWLSIPEV
HENESVYKA	HENESVYKA
SEIPKLPAV	SEIPKLPAV
AEVSNTFVRL	AEVSTFVRL
GEFGGFGSV	GEFGGFGSV
FETIVKQQI	FETIVKQQI
AELLTELHQL	AELLELHQL
GEVGGNTL	GEV-GGNTL
GETDPVTTM	GETDPVTTM
VENDKLVGVAL	VENDKLVGV
KDVNIPTL	KDV-NIPTL
HEASGKAVF	HEASGKAVF
AEGRIIDVI	AEGRIIDVI
TADQPGLIPRL	ADQPLIPRL
AEVSQPRL	AEV-SQPRL
PEISTRPPL	PEISTRPPL
GEPQVQFKL	GEPQVQFKL
NEQEGVPSV	NEQEGVPSV
SEAGSRIVL	SEAGSRIVL
AENKSAVEM	AENKSAVEM
AEVSLMEVRF	AEVSMEVRF
IEFVADRL	IEF-VADRL
VEFPLPPHL	VEFPLPPHL
GEYRGSDFTA	GEYRSDFTA
KEDATKGKFAF	KEDATKGKF
KEIYDDLQAL	KEIYDLQAL
WEISQKTVL	WEISQKTVL
LEVGELAKL	LEVGELAKL
NEWIAVNTV	NEWIAVNTV
AEWEPPEA	AEW-EPPEA
SEKSLENETL	SEKSENETL
LEFAQTQL	LEF-AQTQL
GEITGEVRM	GEITGEVRM
GEGDIVPKI	GEGDIVPKI
GEISEKAKL	GEISEKAKL
REQEAREPVL	REQEREPVL
VEVPETPKA	VEVPETPKA
RERVTVAKL	RERVTVAKL
SEDKRKTYSL	SEDKKTYSL
KEHPLFKKL	KEHPLFKKL
IEPADAHVL	IEPADAHVL
RELDLYDNQI	RELDYDNQI
GELAKHAV	GEL-AKHAV
AEIAHNVSS	AEIAHNVSS
SELKKEVTL	SELKKEVTL
SDVVVQVL	SDV-VVQVL
LELGEIPTL	LELGEIPTL
LETLVSPKL	LETLVSPKL
CPTLLEVL	CPT-LLEVL
HEIGELQQRL	HEIGLQQRL
SEVEKGEAL	SEVEKGEAL
GEVDVEQHTL	GEVDEQHTL
KETTYYDVL	KETTYYDVL
AELLIFSV	AEL-LIFSV
KEFDGKSL	KEF-DGKSL
GEAPSKTL	GEA-PSKTL
SEAAIRSVEL	SEAARSVEL
GEELVTKPV	GEELVTKPV
TEFEQQERL	TEFEQQERL
IEKNIELFF	IEKNIELFF
RELQPGVKAV	RELQGVKAV
KEFTGIDNL	KEFTGIDNL
SYTSGPGSR	SYTSGPGSR
LESGGFRSL	LESGGFRSL
HEVLLPGLQKL	HEV-LLPGL
AEVLDLRRL	AEVLDLRRL
GELDLERAPAL	LDLERAPAL
VLDELVRP	VLD-ELVRP
AELKQAQTL	AELKQAQTL
SEDDVKMAL	SEDDVKMAL
SEIKGEVLYL	SEI-KGEVL
KEVTPEGLQMV	KEV-TPEGL
GEVIRTLPSL	GEVITLPSL
VEAPPVVTA	VEAPPVVTA
KEEELQAAL	KEEELQAAL
SETKVFTA	SET-KVFTA
KELTQSELEL	KELTSELEL
SEKFIKAAI	SEKFIKAAI
GERDEFNIQVL	GERDFNIQV
VDLTGPQL	VDL-TGPQL
VEDPAGHQEEA	VEDPAGHQE
REGEYSKVL	REGEYSKVL
SEIVKQSVF	SEIVKQSVF
GETYNGHLV	GETYNGHLV
IEFSDKESV	IEFSDKESV
LEHEYIQNF	LEHEYIQNF
VERNKVKAL	VERNKVKAL
YELKEGRQI	YELKEGRQI
HELLEQQKRAA	HELLQQKRA
SDWSLPATA	SDWSLPATA
SENEEFVEV	SENEEFVEV
GETPQVAV	GET-PQVAV
SEIASQGREL	SEIAQGREL
FEAPAFLNM	FEAPAFLNM
AEIEIVKDL	AEIEIVKDL
IETNVKPSI	IETNVKPSI
HEGLPGLAV	HEGLPGLAV
AEKREHEKEVL	REH-EKEVL
SELDLPLGTQL	LDLPLGTQL
AEIVKKDDFVL	AEIVKKDDF
TEMEQDYQL	TEMEQDYQL
KEFDGKSLV	KEFDGKSLV
KEGDFNNLTA	KEG-DFNNL
TETVFIVEI	TETVFIVEI
GEGKLFSL	GEG-KLFSL
AEIRDQMQQQL	AEIRMQQQL
AELQSRLAAL	AELQRLAAL
AEASSVKNEL	AEASVKNEL
REVQTNDL	REV-QTNDL
KEFEQLAPVL	KEFELAPVL
VEVRSDWEV	VEVRSDWEV
VEFFHVEDL	VEFFHVEDL
AEVKRPGESL	AEVKPGESL
KEIDMLLKEYL	IDMLLKEYL
AEVARAQAAL	AEVAAQAAL
ADFETVRM	ADF-ETVRM
AEAQLRFIQA	AEAQRFIQA
RENIATHHL	RENIATHHL
AEVEGIGEAL	AEVEIGEAL
AEALATHIL	AEALATHIL
SESRIFNEL	SESRIFNEL
KEEPPQPQL	KEEPPQPQL
SEIVPLFTSL	SEIVLFTSL
REVENPQNQL	REVEPQNQL
DATASIVMD	DATASIVMD
VELVVKNPL	VELVVKNPL
LEIRELLTEF	LEIRLLTEF
SETDMVRQI	SETDMVRQI
TETEPPVAL	TETEPPVAL
KEHFEVNVV	KEHFEVNVV
GEAKVEQL	GEA-KVEQL
HDLAMINQL	HDLAMINQL
REAEETQSTL	REAETQSTL
HEWEESNVQIL	HEWESNVQI
KEWMPVTKL	KEWMPVTKL
HEGDIILKI	HEGDIILKI
AEDITTGQVL	AEDITGQVL
KIEGEIATL	KIEGEIATL
ITPSVAIIV	ITPSVAIIV
AEIHVPTL	AEI-HVPTL
QEFAGRLNSV	QEFARLNSV
RELDLEENKL	RELDEENKL
FEYMFEEV	FEY-MFEEV
SEIELFRV	SEI-ELFRV
HEYFPEMQIL	HEYFEMQIL
AEQKLQQTL	AEQKLQQTL
AETGQVQKI	AETGQVQKI
SESSVKVRL	SESSVKVRL
SEWTGASL	SEW-TGASL
FEIPIKVRL	FEIPIKVRL
GEIQNAKTL	GEIQNAKTL
TEIEKSISA	TEIEKSISA
PMGLLSLL	PMG-LLSLL
KEDLPKVVV	KEDLPKVVV
REVSPAHQYAL	REVSHQYAL
REYDGNIRQA	REYDNIRQA
SEDPSHPSM	SEDPSHPSM
AQFEHTILL	AQFEHTILL
KEVTAAREAL	KEVTAREAL
RESIKLVSI	RESIKLVSI
GELFSSPHL	GELFSSPHL
GEIRELKQL	GEIRELKQL
TEKEVEDSEL	TEKEEDSEL
KEVDDLTAEL	KEVDLTAEL
YEELVRMVL	YEELVRMVL
LELIIEKL	LEL-IIEKL
QESNVRLKL	QESNVRLKL
AEQDLVQTL	AEQDLVQTL
IEHVIIPRI	IEHVIIPRI
HEHQANLL	HEH-QANLL
REPALDGGFQM	REPALDGGF
VEHVPLSL	VEH-VPLSL
SEKGFQQISF	SEKGQQISF
RERHPGSFDVV	RERHGSFDV
FEHIQHIVI	FEHIQHIVI
AELENLVNQAA	AELELVNQA
RELEETNQKL	RELETNQKL
WESSIVDRL	WESSIVDRL
AEKYQTVIA	AEKYQTVIA
SEYSVHSSL	SEYSVHSSL
REGNAVAV	REG-NAVAV
GELPEHAKI	GELPEHAKI
VEFSGKPAA	VEFSGKPAA
AEVEHVVNA	AEVEHVVNA
GEKGTGKTLSL	GEKGTGKTL
FEQNVQRSM	FEQNVQRSM
QEALQRASTAL	QEALQRAST
REKDSSLVQL	REKDSLVQL
KELEGPQIAV	KELEPQIAV
REKLQQKEL	REKLQQKEL
TEIKEITVSF	TEIKITVSF
KEFSGHSSL	KEFSGHSSL
SEEVTPIAV	SEEVTPIAV
LEKIISQL	LEK-IISQL
HESPAVKL	HES-PAVKL
QEWEVKAL	QEW-EVKAL
AEVYRILSV	AEVYRILSV
HEDDHNFEL	HEDDHNFEL
GEFRAVTEL	GEFRAVTEL
AEASALYGRAL	AEASYGRAL
YESPGKIFL	YESPGKIFL
EELPALPVL	EELPALPVL
AEVDLPKL	AEV-DLPKL
KNLQCLVI	KNL-QCLVI
RENVNLAQI	RENVNLAQI
HEFLVKPSF	HEFLVKPSF
SEILPTKET	SEILPTKET
QELPSHGV	QEL-PSHGV
ATASFPEAL	ATASFPEAL
AEVNQETIQRL	AEV-NQETI
AEVADEKML	AEVADEKML
REFNEEGAL	REFNEEGAL
SERIMQLSL	SERIMQLSL
SELPIVTPAL	SELPVTPAL
TEFHELEKI	TEFHELEKI
SEVFAPLL	SEV-FAPLL
RDILLQGL	RDI-LLQGL
TIMNLLVDL	TIMNLLVDL
GELHGHFML	GELHGHFML
RETGVIEKL	RETGVIEKL
REIPIVHRV	REIPIVHRV
REAEFTKSIA	REAEFTKSI
AEQASILSL	AEQASILSL
YESEKVGVA	YESEKVGVA
GERIRLEKV	GERIRLEKV
GEFTSARAV	GEFTSARAV
FESSPDPEL	FESSPDPEL
GERSGLKPPL	GERSLKPPL
RELYANVVL	RELYANVVL
TESQVVITL	TESQVVITL
KEVEQFTQV	KEVEQFTQV
FEFGVFPAIL	FEFGVFPAI
AESLPPPTL	AESLPPPTL
LDFVAPAT	LDF-VAPAT
IEKAVQSL	IEK-AVQSL
REVNKLKVQM	REV-NKLKV
HELTIPNNLI	HELTIPNNL
AEFREPLILL	AEFREPLIL
SEFRPKIKST	SEFRKIKST
TEAVVTNEL	TEAVVTNEL
KEAERDVSL	KEAERDVSL
REVVNKDVL	REVVNKDVL
IEQLYVRQL	IEQLYVRQL
SEIEQAVQSL	SEIEAVQSL
TEISSAEKV	TEISSAEKV
AEKLPNLTHL	AEKLNLTHL
GEIQEIVKT	GEIQEIVKT
MEVAGVTAL	MEVAGVTAL
AEHYTETAL	AEHYTETAL
HEQANVESL	HEQANVESL
KDAALATAL	KDAALATAL
SDVVQPAAV	SDVVQPAAV
GEIVIGGQNI	GEIVGGQNI
SELQAPPLM	SELQAPPLM
GEAGPSAEAL	GEAGSAEAL
GEIKVLQGF	GEIKVLQGF
REAGEGAVAAV	REAGGAVAA
REYHTDTTV	REYHTDTTV
REAHAQSIGM	REA-HAQSI
HEFQAPFGM	HEFQAPFGM
AELVTPIL	AEL-VTPIL
AEVDRIIAQL	AEVDIIAQL
LENDGATAL	LENDGATAL
GELAANKSEM	GELANKSEM
SEKKVVVEQL	SEKKVVEQL
YEKTSGSEMAL	YEKTSGSEM
YEALPQHKL	YEALPQHKL
LETLLRNI	LET-LLRNI
SEGPSRPVL	SEGPSRPVL
RETVSEESNVL	RETVEESNV
GEVNVLDNL	GEVNVLDNL
KEALGIPAAA	KEALGIPAA
REEGTPLTL	REEGTPLTL
NEFLAQTL	NEF-LAQTL
REKQLAAENRL	KQLAAENRL
AEIRRFSSV	AEIRRFSSV
TEAVVKEKL	TEAVVKEKL
DEVNGLISM	DEVNGLISM
GEWDSGTENRL	GEWDTENRL
KEIENTYANVA	KEIETYANV
KEEEAGVKEL	KEEEGVKEL
IEQGNTKAL	IEQGNTKAL
LESKLEQLL	LESKLEQLL
KQLEDGRTL	KQLEDGRTL
GEPFASHSL	GEPFASHSL
AEAPLPSPKL	AEAPPSPKL
KEIQGHQPRI	KEIQHQPRI
TEVDMKEVEL	TEVDKEVEL
FERNKAIKV	FERNKAIKV
KEVEIAYSDV	KEVEAYSDV
GETSTDLKL	GETSTDLKL
SESAQSKML	SESAQSKML
AEIEPPHHEL	AEIEPHHEL
QEIEQKLEV	QEIEQKLEV
KEMPSVFQNVL	KEMPVFQNV
NEKIQNEQL	NEKIQNEQL
REYEPDHNL	REYEPDHNL
TEFPTVLDI	TEFPTVLDI
TETKVLQEAL	TETKLQEAL
QEYIDSQKL	QEYIDSQKL
AENNIQPIF	AENNIQPIF
AEKAAQTAERL	AEK-AAQTA
QEENITRAL	QEENITRAL
AEVIVRQL	AEV-IVRQL
YEIITPWRLT	YEIITPWRL
IEKQPPQVL	IEKQPPQVL
EEPVEEAVI	EEPVEEAVI
SEAEGLKFSL	SEAELKFSL
REAKVERPSTL	REAKERPST
GEYKKTLLKL	GEYKTLLKL
AENPAMTRELL	AENPMTREL
REDMIDIKL	REDMIDIKL
GEYFPGTGDL	GEYFGTGDL
YERSNEYQLI	YERSNEYQL
SELLTTVSL	SELLTTVSL
REKEIKSEL	REKEIKSEL
LENSKQPSV	LENSKQPSV
AEGREAPAL	AEGREAPAL
KEILKEREL	KEILKEREL
AEALKEVSL	AEALKEVSL
VLEISGIIM	VLEISGIIM
REAGAGGLAI	REAGGGLAI
AELPIIVVL	AELPIIVVL
AEQLPVAQI	AEQLPVAQI
AEGPVAVVV	AEGPVAVVV
VEVVKTFNL	VEVVKTFNL
GEHTPSALAI	GEH-TPSAL
AEIKTTNEV	AEIKTTNEV
KEINTNQEAL	KEINNQEAL
AEHFLEQQM	AEHFLEQQM
AEINEIIRV	AEINEIIRV
REHDIAIKFF	REHDIAIKF
LEFSATKL	LEF-SATKL
REKQAPEL	REK-QAPEL
RENGKTVIRVL	RENGTVIRV
AEAKQIVRKL	AEAKIVRKL
KETSATGINSL	TSATGINSL
REKPDDPLNYF	REK-PDDPL
AELATRAIP	AELATRAIP
GEARVGSEL	GEARVGSEL
REIADKLIEL	REIAKLIEL
VDIKGPKV	VDI-KGPKV
IEKKLKETL	IEKKLKETL
SERVVQEAL	SERVVQEAL
HDVIVTII	HDV-IVTII
KEYEEDGARSI	YEEDGARSI
REMRHKLKTAF	REMRKLKTA
TEFPGVVV	TEF-PGVVV
TETHVERVL	TETHVERVL
REIQDDMQTL	REIQDMQTL
REVSPEPIV	REVSPEPIV
LEIDISSNKL	LEIDSSNKL
LEGENIEI	LEG-ENIEI
LEMPQITRL	LEMPQITRL
AEMKAQEV	AEM-KAQEV
KEAIETIVAAM	KEAITIVAA
TEYENFKVQVL	YENFKVQVL
SELRNQYVTL	SELRQYVTL
REWEVVSV	REW-EVVSV
QEFLTDMKQVF	QEFLDMKQV
AETEPIVKM	AETEPIVKM
EELQKRFIL	EELQKRFIL
SEIEVPLL	SEI-EVPLL
EEIIKAWSV	EEIIKAWSV
GENPSGKSL	GENPSGKSL
KEMPVKVEA	KEMPVKVEA
ADFAKVLEL	ADFAKVLEL
NEITIPVTF	NEITIPVTF
REFGKALQL	REFGKALQL
AEHPNVTL	AEH-PNVTL
AEQQKAQFTA	AEQQAQFTA
SETGHVYTF	SETGHVYTF
GESTVRTIAM	GES-TVRTI
RELENLIGI	RELENLIGI
SEELLLPLL	SEELLLPLL
TEISSAEKVAL	TEISSAEKV
LEHLTNEAL	LEHLTNEAL
FEAPDQKTL	FEAPDQKTL
GEEWKGYVV	GEEWKGYVV
REKEQFRKL	REKEQFRKL
KEIEGIFHA	KEIEGIFHA
LERAPGETAL	LERAGETAL
HENPDIIIAT	HENPIIIAT
GEISDIHTKL	GEISIHTKL
KEKKLLEDRI	KEKKLEDRI
AENAGSYSL	AENAGSYSL
AEKWEVAEV	AEKWEVAEV
TEWLDGKHVVF	TEWLGKHVV
AEILQESRM	AEILQESRM
EELIESPKL	EELIESPKL
REVSPAPAV	REVSPAPAV
AEVKRVGDTL	AEVKVGDTL
REAFLVNSDL	REAFVNSDL
AEINKSLLAL	AEINSLLAL
TEFEKILKT	TEFEKILKT
GEFEKKYVATL	GEFEKKYVA
AEEDFYEKL	AEEDFYEKL
AELRNASAVM	AELRNASAV
GEAGAIERVL	GEAGIERVL
VEGDPIVAL	VEGDPIVAL
QEKVSDYEM	QEKVSDYEM
ADILVQPTL	ADILVQPTL
YELQESNVRL	YELQSNVRL
EELQGVRSL	EELQGVRSL
SEVAQAGKAV	SEVAAGKAV
GEFTLHGRAIL	GEFTHGRAI
EEIEDLVARL	EEIELVARL
SEPDAVHVVL	SEPDVHVVL
QEHQQQVL	QEH-QQQVL
RESTGAQVQV	RESTAQVQV
SEYFYQEEF	SEYFYQEEF
SEARKGFSYL	SEARGFSYL
HETVTIEL	HET-VTIEL
AELMQQVNVL	AELMQVNVL
AEVKIEKRTT	AEVKEKRTT
SERELLEIV	SERELLEIV
KEKPDIFQL	KEKPDIFQL
READFKETLL	READFKETL
KESPVVKGNAL	KESPKGNAL
RVYIHPFHL	RVYIHPFHL
REVDLKNGHNL	VDLKNGHNL
TEVKKIYKL	TEVKKIYKL
VETAITKV	VET-AITKV
GEPHGLENMEL	GEPHGLENM
KEPESILQVL	KEPEILQVL
TEIEKARAV	TEIEKARAV
TAKAAPLPSV	AKAAPLPSV
SENQNRAYVTL	SENQNRAYV
AEFIMLNHF	AEFIMLNHF
DEYQFVERL	DEYQFVERL
AEINNIIKI	AEINNIIKI
TEKSPEVTL	TEKSPEVTL
TEIDSKWQEL	TEIDKWQEL
HEVPSGNSL	HEVPSGNSL
LEIDFPARAI	LEIDPARAI
KEESIVSSL	KEESIVSSL
KEFLPEGQDI	KEFLEGQDI
NELIRQEKL	NELIRQEKL
NDIVVKVL	NDI-VVKVL
LENILVIL	LEN-ILVIL
AEVLVKSNNL	AEVLKSNNL
HEIGFGSKV	HEIGFGSKV
KDILGPPM	KDI-LGPPM
KDFSPEAL	KDF-SPEAL
AEALERMFLSF	AEALERMFL
REDSGTFSL	REDSGTFSL
SEARELVAL	SEARELVAL
HEVKEAQTL	HEVKEAQTL
KELAPAVSVL	KELAAVSVL
GEKNVFEAL	GEKNVFEAL
REFEEVVV	REF-EEVVV
AELPAKILV	AELPAKILV
KETLKIDIL	KETLKIDIL
AEALVSKGL	AEALVSKGL
AEEPPTPAL	AEEPPTPAL
VEFMHYIIAA	VEFMYIIAA
TERPQPQTL	TERPQPQTL
GELVSVAHAL	GELVVAHAL
GEAGSITHL	GEAGSITHL
RELFQEMNI	RELFQEMNI
IDVSGPKV	IDV-SGPKV
AENSPTRQQF	AENSTRQQF
SEVNKHETAL	SEVNHETAL
AEKIQTIIL	AEKIQTIIL
LRNVSTGD	LRN-VSTGD
TEKEDFIEL	TEKEDFIEL
RETPVPPAM	RETPVPPAM
LESDNNTAL	LESDNNTAL
SEPVTPASL	SEPVTPASL
AEFKEAFSL	AEFKEAFSL
AEFLMKNSDL	AEFLKNSDL
HEAQAVLGV	HEAQAVLGV
QENGSLVEI	QENGSLVEI
AEYDFRNDSV	AEYDRNDSV
KEAPTAYSL	KEAPTAYSL
TERSPGPRL	TERSPGPRL
QEQAAKAVL	QEQAAKAVL
AERNVYTSEVL	AERNYTSEV
AEREEKRVL	AEREEKRVL
TEVIVPHL	TEV-IVPHL
HEEIAMATV	HEEIAMATV
AEIQNVEGQNL	AEIQEGQNL
HEREKEVVL	HEREKEVVL
TETVFVPVI	TETVFVPVI
SEFKNITV	SEF-KNITV
GEFGEIEAI	GEFGEIEAI
REWTEQETLL	REWTEQETL
AEFEVVRTI	AEFEVVRTI
NEFPEPIKL	NEFPEPIKL
KEKLQEIYL	KEKLQEIYL
TEFQGHKVIL	TEFQHKVIL
KEKSFLDLVV	KEKSLDLVV
FEALTPNLL	FEALTPNLL
AEVKERVTL	AEVKERVTL
TENPHGARL	TENPHGARL
QELSLEKL	QEL-SLEKL
AEFEQKINRL	AEFEKINRL
HDFQAPYL	HDF-QAPYL
REVLEKQPVL	REVLKQPVL
KEIVGVVNV	KEIVGVVNV
GEIKIHKM	GEI-KIHKM
TEIQLVQSL	TEIQLVQSL
AEIEKFDKSKL	IEKFDKSKL
IEQLGGKQL	IEQLGGKQL
GEFDNAGAMM	GEFDNAGAM
EEIAKVEKL	EEIAKVEKL
RDTALETAL	RDTALETAL
VERVIQQL	VER-VIQQL
AEKVANAESL	AEKVNAESL
VDLTLPKV	VDL-TLPKV
FESGISQAL	FESGISQAL
KESEKIIAEL	KESEIIAEL
SELSPGRSV	SELSPGRSV
VEKAIEFVL	VEKAIEFVL
AEHHVATL	AEH-HVATL
TEPHHIWPTL	TEPHIWPTL
GESAVGKSSL	GESAGKSSL
SLEAIELGL	SLEAIELGL
AEAVLYEHL	AEAVLYEHL
AEMAQNAV	AEM-AQNAV
KEITGETAL	KEITGETAL
AEKAYHEQL	AEKAYHEQL
GELDQLKEHL	GELDLKEHL
RETEKTLTEL	RETETLTEL
TEIEKKLPRL	TEIEKLPRL
HEKPEIFTEL	HEKPIFTEL
GEVPKFKAL	GEVPKFKAL
GENKSPLLL	GENKSPLLL
REVDPNEQL	REVDPNEQL
TEIYEFHKTL	TEIYFHKTL
NEFTTHVM	NEF-TTHVM
REESEQIVL	REESEQIVL
HDLVIKSL	HDL-VIKSL
AEIQDMKQEL	AEIQMKQEL
GELKSVPTT	GELKSVPTT
TEIGTMISV	TEIGTMISV
GEAQVGKTSL	GEAQGKTSL
GERLFPLIQAM	GERLPLIQA
AENGKSNFL	AENGKSNFL
VEIEREVLL	VEIEREVLL
KELYVPENKL	KELYPENKL
REALDVLGAVL	REALVLGAV
LEIVPNGITL	LEIVNGITL
QEASEAYLV	QEASEAYLV
VEKKGEKLIL	VEKKEKLIL
AETEKQVAL	AETEKQVAL
RELPAGINSIV	RELPGINSI
HEKAALIMQVL	HEKALIMQV
KEIEKVAL	KEI-EKVAL
AEAYLGKTVT	AEAYLGKTV
VEMGFSRSL	VEMGFSRSL
REIFRNEKL	REIFRNEKL
SDIQVKEL	SDI-QVKEL
TEGKVGYEL	TEGKVGYEL
AEILELAGNAA	AEILLAGNA
HELSVEQQL	HELSVEQQL
GEYGKFFVT	GEYGKFFVT
RETADVIAKV	RETAVIAKV
AEIIQHDQL	AEIIQHDQL
SELQLPFQA	SELQLPFQA
TEIDPINAL	TEIDPINAL
REFKLSKV	REF-KLSKV
GEVIGVNTM	GEVIGVNTM
GEIRNLEKF	GEIRNLEKF
TEVKSVEM	TEV-KSVEM
GEVRTHIRV	GEVRTHIRV
GEYPLTAMTL	GEYPTAMTL
SEGPPLTSF	SEGPPLTSF
REAEFTKSI	REAEFTKSI
SEHPNVTL	SEH-PNVTL
AEAIHSPQV	AEAIHSPQV
HEHRLPHVL	HEHRLPHVL
AETVNLRSL	AETVNLRSL
GEALAPRQV	GEALAPRQV
AEAPSESKPAA	AEAPSESKP
VELKKGATL	VELKKGATL
GEKNIAIEFL	GEKNAIEFL
SEGPHHVAL	SEGPHHVAL
RESERQLRL	RESERQLRL
LEFENQKTRL	LEFEQKTRL
KDIVVPSL	KDI-VVPSL
TEVKPNTPVL	TEVKNTPVL
GEGEPVKEV	GEGEPVKEV
AEFSKTWEF	AEFSKTWEF
HELLISTL	HEL-LISTL
SESTKQPKL	SESTKQPKL
GEYEKGVDHL	GEYEGVDHL
GEFNEQVLRL	GEFNQVLRL
GEVTNVTTA	GEVTNVTTA
REEEKVSAV	REEEKVSAV
FERPQYAEIL	FERPYAEIL
AEKDNAEIRV	AEKDAEIRV
HELLKTNAA	HELLKTNAA
AEVLRTMEL	AEVLRTMEL
AEKVHMRAM	AEKVHMRAM
AEFEDLDSL	AEFEDLDSL
GETIHIPTM	GETIHIPTM
HELVFGVSL	HELVFGVSL
HENLLEALL	HENLLEALL
QEIQDQLSL	QEIQDQLSL
AEKPKTVQL	AEKPKTVQL
NEVEKQWRL	NEVEKQWRL
SEERFRPSL	SEERFRPSL
AEIRAINEA	AEIRAINEA
AEGEIYTKL	AEGEIYTKL
KEMDLSVVRL	KEMDSVVRL
SELEKKLVAI	SELEKLVAI
IESQDRPKL	IESQDRPKL
DRQQQITV	DRQ-QQITV
KDAYLPLRL	KDAYLPLRL
AEEKSIPTL	AEEKSIPTL
LEQEIIRL	LEQ-EIIRL
SEKVDRAVL	SEKVDRAVL
SEMSRVIRV	SEMSRVIRV
IEKALDLSL	IEKALDLSL
FELGKLMEL	FELGKLMEL
KEAIETIVA	KEAIETIVA
VESIISPKV	VESIISPKV
SEFEAPSL	SEF-EAPSL
FEADPPGQV	FEADPPGQV
GETGTLVDM	GETGTLVDM
TEAQVPFLAM	TEA-QVPFL
GEKFHSEVA	GEKFHSEVA
SEPLHNVQVL	SEPLNVQVL
FERPQYAEI	FERPQYAEI
GEKGAVKVL	GEKGAVKVL
AEIEDVKPA	AEIEDVKPA
KEGFPITAL	KEGFPITAL
FEQVSGVTV	FEQVSGVTV
GENSRVARL	GENSRVARL
YEWDVAEARKI	YEWDVAEAR
AERYKLERL	AERYKLERL
LEVPIPEGL	LEVPIPEGL
GEHVILGTGEL	GEH-VILGT
HEIGEWEAF	HEIGEWEAF
IDILQPAII	IDILQPAII
KESTLHLVLRL	KESTLHLVL
QELFLAHIL	QELFLAHIL
AEEAPKTPL	AEEAPKTPL
YDVTVPKL	YDV-TVPKL
AEIDAHLVAL	AEIDHLVAL
FENPKQGKL	FENPKQGKL
RDMTMFVTA	RDMTMFVTA
HELVPEHVV	HELVPEHVV
GEIHDSKMRL	GEIHSKMRL
GETQKTISL	GETQKTISL
REINGMTGL	REINGMTGL
YEALKENEKL	YEALENEKL
HERNLQSDVL	HERNQSDVL
IENIIVEV	IEN-IIVEV
REGETMILTL	REGEMILTL
QEHAQEVVL	QEHAQEVVL
SEIDMSVKA	SEIDMSVKA
LEHLVTEL	LEH-LVTEL
VEKPAETHL	VEKPAETHL
IETINFHEV	IETINFHEV
PPSLFTAVFVL	SLFTAVFVL
LERGLESATSL	LER-GLESA
REAIIVGSIIT	REAIIVGSI
RELPEPLMTF	RELPPLMTF
HEAEVLKQL	HEAEVLKQL
REIESSPQYRL	IESSPQYRL
REKEDLVDL	REKEDLVDL
SETTKGAYSL	SETTGAYSL
VEKVPNPSL	VEKVPNPSL
SEKVIFFEL	SEKVIFFEL
AERIKPVL	AER-IKPVL
SERPLPRAA	SERPLPRAA
GEKKAYVRL	GEKKAYVRL
AEIAPFVEI	AEIAPFVEI
LEVIPMAL	LEV-IPMAL
TEVDTSHRL	TEVDTSHRL
KELRHPNIVSL	KELRHPNIV
SEMRFVQDL	SEMRFVQDL
HDFKSVDHL	HDFKSVDHL
KEFPEKQEL	KEFPEKQEL
SESPRSTSL	SESPRSTSL
SELDLISRL	SELDLISRL
IEFIFSDTHEL	IEFIDTHEL
AETPVYRF	AET-PVYRF
GELKSPKVL	GELKSPKVL
SEIGQKQKL	SEIGQKQKL
AEVTTKSQIPL	AEVTTKSQI
LEFDPEEFYHL	LEF-DPEEF
LEVAGRML	LEV-AGRML
FPGSEDVKL	FPGSEDVKL
SEVNPNTRVM	SEVNPNTRV
LEVIIKDNSL	LEVIKDNSL
IEHNLSKIMKL	IEH-NLSKI
SENASVPSL	SENASVPSL
AELLLIPKV	AELLLIPKV
LEHEGLVSL	LEHEGLVSL
KEKPEEESL	KEKPEEESL
HEIAVLEL	HEI-AVLEL
REGSFRVTTA	REGSRVTTA
LEIQEKPAL	LEIQEKPAL
SERYTWIVL	SERYTWIVL
GENVIISHF	GENVIISHF
AEVPDVTAT	AEVPDVTAT
KEAAGEGPAL	KEAAEGPAL
HEIGHIFGL	HEIGHIFGL
GELNVDSLIT	GEL-NVDSL
LESDPQQVV	LESDPQQVV
AERENFHRL	AERENFHRL
REAEALKQKEL	AEALKQKEL
FEVKKWNAV	FEVKKWNAV
LDLLLPKL	LDL-LLPKL
REAEKIKTL	REAEKIKTL
TESPVRTL	TES-PVRTL
FELAVDAV	FEL-AVDAV
KEAGNINRSL	KEAGINRSL
ADRMVGQVL	ADRMVGQVL
REHEEYLKL	REHEEYLKL
REMLQQSKI	REMLQQSKI
REPDQTFSL	REPDQTFSL
RETDFYLQSV	RETDYLQSV
LEHVAVTV	LEH-VAVTV
KESHEMGQAL	KESHMGQAL
GEAVEVIHKL	GEAVVIHKL
KEVDVGLAA	KEVDVGLAA
REAEMRNSIL	REAEMRNSI
SEIKDVLSL	SEIKDVLSL
AELRTWIEGL	AELRWIEGL
WEQQEPGERKL	QEP-GERKL
AEDGPRVVF	AEDGPRVVF
TEDFKHLARKL	EDFKLARKL
SEYITHEITVL	SEYIHEITV
KEFALHKL	KEF-ALHKL
EEILITVL	EEI-LITVL
AEEPKARVL	AEEPKARVL
SEFQERHEV	SEFQERHEV
YENEKLTKL	YENEKLTKL
RDYVAPTA	RDY-VAPTA
RENEQKRIL	RENEQKRIL
SESRMVVTFL	SESRMVVTF
AERWIVNLI	AERWIVNLI
GEALPFSHL	GEALPFSHL
GENKMGQLGL	GENKGQLGL
VDYELERTL	VDYELERTL
HEFSIPYVEL	HEFSPYVEL
EEAASAPAV	EEAASAPAV
KDVLSVAF	KDV-LSVAF
AEILAEIARIL	AEILEIARI
EEVQSLPLPL	EEVQLPLPL
QEKDIKKEEI	QEKDKKEEI
IEVNVSEL	IEV-NVSEL
RESLPIYKL	RESLPIYKL
SERMSLPLL	SERMSLPLL
QEQEIEQRL	QEQEIEQRL
QEFSFFDKV	QEFSFFDKV
HEKEDGAISTI	KEDGAISTI
HESETTTSL	HESETTTSL
GEVDKRELI	GEVDKRELI
LEADRMAAL	LEADRMAAL
KDIPVVHQL	KDIPVVHQL
TEHPVPIIL	TEHPVPIIL
FEISDRLIGI	FEISRLIGI
GELSLPVHL	GELSLPVHL
AEKEPINKM	AEKEPINKM
TEIDGRSISL	TEIDRSISL
VDVTLPRV	VDV-TLPRV
LEQKIQQEL	LEQKIQQEL
REKITAQSI	REKITAQSI
AEVSELETRL	AEVSLETRL
SEIDQLFRI	SEIDQLFRI
REGEGGLSL	REGEGGLSL
TEDARTILEL	TEDATILEL
REFIGSFL	REF-IGSFL
VEHKVETF	VEH-KVETF
REPLVRQVL	REPLVRQVL
SEVKPILEKL	SEVKILEKL
GEYTEHLHSA	GEYTHLHSA
SERHFIMQV	SERHFIMQV
REPVQLETL	REPVQLETL
HEVKKVTL	HEV-KKVTL
GEVHTGTTIM	GEVHTGTTI
GEVSGLMRKV	GEVSLMRKV
KEIELPSGQLM	KEIEPSGQL
REGLLFTAL	REGLLFTAL
IENVETLVL	IENVETLVL
LEAILPLAV	LEAILPLAV
KEIGTKQSFSL	KEIGTKQSF
KEIEDFDSL	KEIEDFDSL
AEVERVKDVL	AEVEVKDVL
QENEPEPLSL	QENEEPLSL
SEIKVPDVEL	SEIKPDVEL
IEILLEKL	IEI-LLEKL
VDITTPKAA	VDITTPKAA
TELEQPVGM	TELEQPVGM
SEIEVPREAL	SEIEPREAL
AEPEDHYFLL	AEPEHYFLL
AEADRTAIHEV	AEA-DRTAI
VEADLVEAL	VEADLVEAL
AEEKIPPSTL	AEEKPPSTL
SEEIIQYVL	SEEIIQYVL
TEHYDIPKV	TEHYDIPKV
AEEKAAVTSL	AEEKAVTSL
GELVHPKAL	GELVHPKAL
SEGVVAVLL	SEGVVAVLL
SETLFQRL	SET-LFQRL
HELFITLL	HEL-FITLL
LEKNIADLM	LEKNIADLM
GELTDGHPLTL	GELTDGHPL
AEHPAGHLVL	AEHPGHLVL
HEHFVTSL	HEH-FVTSL
RELGFSSNLLC	RELGSSNLL
GELLFPSSL	GELLFPSSL
HDFQAPYLL	HDFQAPYLL
DLVLEVVI	DLV-LEVVI
GEKTISVVL	GEKTISVVL
FEITQPPLL	FEITQPPLL
REMETLIL	REM-ETLIL
YEFDEGSIIF	YEFDEGSII
AEHQVPVEKL	AEHQPVEKL
REKLPSSEVV	REKLPSSEV
AESGVERQVL	AESGERQVL
AELEKLQAEL	AELELQAEL
GQSELASRLTL	SELASRLTL
LEKKFGIQL	LEKKFGIQL
REIAGHIMEF	REIAHIMEF
GENSILGQLKA	GENSILGQL
AEFGEPLPKRL	GEP-LPKRL
KESAEFQTQL	KESAFQTQL
GEFVEAMIRQL	VEA-MIRQL
GELITQREL	GELITQREL
SEFEENTNL	SEFEENTNL
RQIEEQKAL	RQIEEQKAL
AEFAERSVA	AEFAERSVA
SEPHILETL	SEPHILETL
HEGTDSYEL	HEGTDSYEL
VEFPVRNL	VEF-PVRNL
RELLKPNASV	RELLPNASV
FEFGSLEQKL	FEFGLEQKL
AEIEQYRL	AEI-EQYRL
AEYPGSSAQL	AEYPSSAQL
VEVKDIELVM	VEVKDIELV
KEMEVSPSA	KEMEVSPSA
AEVPGAGAV	AEVPGAGAV
YELAQVLL	YEL-AQVLL
REVIQSDSL	REVIQSDSL
GETKISQSEL	GETKSQSEL
KELERVTSL	KELERVTSL
FEADTITL	FEA-DTITL
DQLLRTLDI	DQLLRTLDI
SELPMPLLI	SELPMPLLI
IEVDDERKL	IEVDDERKL
GEEGYGRSL	GEEGYGRSL
IEQEQKLAL	IEQEQKLAL
YEEGPGKNLP	YEEGPGKNL
GEAAAVFKTL	GEAAVFKTL
QDVVLNYPM	QDVVLNYPM
LEWELVVL	LEW-ELVVL
SEIRSISV	SEI-RSISV
LERNITIKL	LERNITIKL
KEAIETIVAA	KEAITIVAA
FELEKSESL	FELEKSESL
RDLIVATI	RDL-IVATI
SEVGSVVSF	SEVGSVVSF
VESVQPLSL	VESVQPLSL
KGNKEILI	KGN-KEILI
AELLILKR	AEL-LILKR
KESTITRKL	KESTITRKL
KEIIGLEGVEL	KEIIGLEGV
SELEAARML	SELEAARML
HELSPPQKRM	HELSPQKRM
MESGIEPSV	MESGIEPSV
GEKKDEVYL	GEKKDEVYL
KELDGLWSF	KELDGLWSF
TELITQAL	TEL-ITQAL
GEPTNFVHTA	GEPTFVHTA
SEVKGLDAF	SEVKGLDAF
GEIPTLKTL	GEIPTLKTL
VETSYVKVL	VETSYVKVL
FETAVKKL	FET-AVKKL
LEQEEQQRL	LEQEEQQRL
SEAARPATSTL	SEAAPATST
REVLPSTRL	REVLPSTRL
KENYQMLTL	KENYQMLTL
FEYAVERVL	FEYAVERVL
AEVDKLELM	AEVDKLELM
SEVSTVLKL	SEVSTVLKL
AELPIIVV	AEL-PIIVV
KESDLNGAQI	KESDNGAQI
SEQPIAAL	SEQ-PIAAL
EEFKKIRSA	EEFKKIRSA
AEITPKGRAL	AEITKGRAL
AEFLYQVLI	AEFLYQVLI
TDFISHLF	TDF-ISHLF
SEVVVNSVF	SEVVVNSVF
AEALRSLQQL	AEALSLQQL
YESPEIAL	YES-PEIAL
AEVEAQKAQQL	VEAQKAQQL
SEVSKIVTV	SEVSKIVTV
AEMPDSAAA	AEMPDSAAA
ELAAPGQAKI	LAAPGQAKI
SENDKKIKAL	SENDKIKAL
SESHRFTVL	SESHRFTVL
GEAELNWSRL	GEAENWSRL
AELIDKPL	AEL-IDKPL
REASIYTGITL	REASIYTGI
LEKAAEPTL	LEKAAEPTL
KELEPLKEMTA	KELEPLKEM
AEGTVVSNL	AEGTVVSNL
GEVLIDTHL	GEVLIDTHL
MELLDGKQTL	MELLGKQTL
TDVLVVGVL	TDVLVVGVL
AEVKGVYQF	AEVKGVYQF
SEIKQINHL	SEIKQINHL
KEYAVNEVVA	KEYAVNEVV
LEYIARAIL	LEYIARAIL
GEWASGGVRSF	GEW-ASGGV
TEVIHTGTL	TEVIHTGTL
VEGPGGRPL	VEGPGGRPL
REKTLTEHAL	REKTTEHAL
YPETLGRLLIL	PETLRLLIL
SEHLPLSKL	SEHLPLSKL
RELSPQRNL	RELSPQRNL
TEAQANQISL	TEAQNQISL
AEKGPMIVL	AEKGPMIVL
KEVQDGIEL	KEVQDGIEL
LEANLAVL	LEA-NLAVL
GEFVEVISL	GEFVEVISL
VEHDHPHAL	VEHDHPHAL
AEKPAVPET	AEKPAVPET
AESLIVPVRM	AESLVPVRM
LELVAGERL	LELVAGERL
GQAPPGKAL	GQAPPGKAL
IEILKLEI	IEI-LKLEI
NEVPVKEL	NEV-PVKEL
TEMESMKTTL	TEMEMKTTL
SEFKGDLETL	SEFKDLETL
REHDIAIKF	REHDIAIKF
AEVFHVPLLL	AEVFHVPLL
AETDRLREI	AETDRLREI
VDVTLPKV	VDV-TLPKV
KELEFSKDKIL	LEFSKDKIL
KEEVTPEQL	KEEVTPEQL
RELESQISEL	RELEQISEL
SEVKSRQTL	SEVKSRQTL
AEERRKYTL	AEERRKYTL
GEFILKTYV	GEFILKTYV
LEAVFIHGL	LEAVFIHGL
TEIEGTQKL	TEIEGTQKL
QEYVPSAHL	QEYVPSAHL
IEHRNEAEL	IEHRNEAEL
SEKNMISKL	SEKNMISKL
GEILKKIIPTL	GEILIIPTL
REITKPLRPL	REITPLRPL
GEIEDKLKKEL	IEDKLKKEL
HESETTTSLVL	HESETTTSL
KEEDLQWVL	KEEDLQWVL
YELLLIQQL	YELLLIQQL
AELELQKQL	AELELQKQL
SEVTFALHSA	SEVTALHSA
GENEDLLKL	GENEDLLKL
ELVRAVLEL	ELVRAVLEL
AEIQGVIDA	AEIQGVIDA
SDLKVILM	SDL-KVILM
SEHGLVVIA	SEHGLVVIA
SELITKAVAA	SELITKAVA
SEVWLIDGL	SEVWLIDGL
REIQDAYLQL	REIQAYLQL
SEPRISESL	SEPRISESL
AEKAVTKEEF	AEKATKEEF
LSKPFLDIVL	LSKPLDIVL
TEVEIINQQL	TEVEINQQL
REIVRDIKEKL	REIVIKEKL
AEQVYISSL	AEQVYISSL
AEPQAGSPMTL	AEPQAGSPM
TDREDINSL	TDREDINSL
KENSYVKKF	KENSYVKKF
HERPEFIA	HER-PEFIA
MENEMRTQL	MENEMRTQL
KEILGTAQSV	KEILTAQSV
AERPGEAAV	AERPGEAAV
LEHVPDTVL	LEHVPDTVL
KEIDIYANL	KEIDIYANL
KEKGLEHVTV	KEKGEHVTV
QEAIALINSL	QEAILINSL
AELSPVEQKL	AELSVEQKL
SSEVAVSVL	SSEVAVSVL
RELAQQVQQVA	RELAQVQQV
HERAAILSV	HERAAILSV
RELLNPVVEF	RELLPVVEF
GEVKDFPDL	GEVKDFPDL
VEKEFEPLL	VEKEFEPLL
TESTARVEL	TESTARVEL
IETFIPLLL	IETFIPLLL
GESNKIPRL	GESNKIPRL
SELEDGHTAL	SELEGHTAL
AELAGEGISV	AELAEGISV
LENLLESI	LEN-LLESI
QEQEIEHHL	QEQEIEHHL
VEKKSVAKL	VEKKSVAKL
SDVEVPASV	SDVEVPASV
IEMETKTSI	IEMETKTSI
TEIDPICAL	TEIDPICAL
SEYHRIQHQL	SEYHIQHQL
YEKILFTEA	YEKILFTEA
EEIANYRPTL	EEIAYRPTL
RETSHVTMV	RETSHVTMV
SEVISQHLV	SEVISQHLV
HEFSKTEEL	HEFSKTEEL
KEQDVEKEL	KEQDVEKEL
GVEARTLLKL	VEARTLLKL
KEWVTPKEF	KEWVTPKEF
SEVHSPPNV	SEVHSPPNV
HEIFVDYEL	HEIFVDYEL
VEHPGHPEV	VEHPGHPEV
VEIRSGFLAA	VEIRGFLAA
LELGPKPEV	LELGPKPEV
AELPLDYKF	AELPLDYKF
SELSSQLGL	SELSSQLGL
LRELIRKL	LRE-LIRKL
HDFVVVET	HDF-VVVET
SENQPFPSL	SENQPFPSL
SENNRIFTL	SENNRIFTL
QEGAKMAVRL	QEGAMAVRL
FEYLIETL	FEY-LIETL
EATLLQKL	EAT-LLQKL
AENGKAPHL	AENGKAPHL
SWLDLQELF	SWLDLQELF
AERVDDPEL	AERVDDPEL
VEKEMRVTL	VEKEMRVTL
GEADILAAL	GEADILAAL
TEVDKILKV	TEVDKILKV
AEMLYGLIHA	AEMLGLIHA
RELGFSSNLL	RELGSSNLL
TDHLIAML	TDH-LIAML
EELPHIHAF	EELPHIHAF
KESTQGVSSL	KESTGVSSL
VDVEQHTL	VDV-EQHTL
YESDTLLHSF	YESDLLHSF
RQAPPHIEL	RQAPPHIEL
IEDNPHPRL	IEDNPHPRL
QENSRVIVM	QENSRVIVM
GETTILQL	GET-TILQL
AEVRKIIRV	AEVRKIIRV
IDTVINAL	IDT-VINAL
PEFNLIHSL	PEFNLIHSL
DEYSDLVTL	DEYSDLVTL
TEWSELENLVL	SEL-ENLVL
GEAQKIDRM	GEAQKIDRM
HEFLQTEI	HEF-LQTEI
RENDIKSYF	RENDIKSYF
HEVRIQPSL	HEVRIQPSL
EEIQGLTDL	EEIQGLTDL
AEAEKKVQL	AEAEKKVQL
REMLIRVNM	REMLIRVNM
ETLDLSHNQL	LDL-SHNQL
YEAGQLYGL	YEAGQLYGL
AEFAERSVAKL	AER-SVAKL
FEGVSPKSL	FEGVSPKSL
RELAQQVQQV	RELAQVQQV
AEVPHSTGV	AEVPHSTGV
GEIGTKTTL	GEIGTKTTL
RDFKGKVL	RDF-KGKVL
QEIEELTKI	QEIEELTKI
VEIHIPITL	VEIHIPITL
SEEGGHVAV	SEEGGHVAV
AEPAPVQSL	AEPAPVQSL
AEHLEKSSL	AEHLEKSSL
TEVGPRFEL	TEVGPRFEL
SELMDITKL	SELMDITKL
GEYSDPVTL	GEYSDPVTL
AQFKGTQSL	AQFKGTQSL
AELDIPQSV	AELDIPQSV
MEMFQPSAV	MEMFQPSAV
RENPQLLQQI	RENPLLQQI
SEVVVNSV	SEV-VVNSV
RDMDIIMKL	RDMDIIMKL
REVVFVEDV	REVVFVEDV
YEKPEAPEL	YEKPEAPEL
GETTPDKLFTL	GET-TPDKL
SEVIFGHVL	SEVIFGHVL
KEKEPEYTLL	KEKEPEYTL
KEVNFTSEL	KEVNFTSEL
SETFLLPHL	SETFLLPHL
RELMGGIGKT	RELMGIGKT
GGSFDVADRMF	GSFDVADRM
KELHIQGNRL	KELHQGNRL
HSDAQALVL	HSDAQALVL
KESAAINQIL	KESAINQIL
REIKDTQAQL	REIKTQAQL
LEQQNKILL	LEQQNKILL
AEVKPILQA	AEVKPILQA
KEFEGKTL	KEF-EGKTL
KDPKISTSL	KDPKISTSL
AEFAERTVA	AEFAERTVA
GEELQMEPV	GEELQMEPV
FEITPPVVL	FEITPPVVL
GEIETVKQL	GEIETVKQL
HEIEVIDQRL	HEIEIDQRL
NEIGVPLPRL	NEIGPLPRL
AEKLPINRL	AEKLPINRL
HEAEPVRTL	HEAEPVRTL
FEKVVTSEAL	FEKVTSEAL
AEAVSRVLNKL	AEA-VSRVL
SEVELMKV	SEV-ELMKV
REWAIKKHL	REWAIKKHL
REIEGDLL	REI-EGDLL
AEVAAKNQSL	AEVAKNQSL
SEIEGIQSL	SEIEGIQSL
RMFGGPGTA	RMFGGPGTA
TEMLPSILNQL	TEM-LPSIL
KEILKEIGV	KEILKEIGV
GEKQINQEYL	GEKQNQEYL
AESPSRDVV	AESPSRDVV
REYNEYENIKL	NEY-ENIKL
REHIKVQQL	REHIKVQQL
AELQEKFLSL	AELQKFLSL
AELAIFRV	AEL-AIFRV
REVEKVKL	REV-EKVKL
KELGSSTNAL	KELGSTNAL
QATTFTLTGL	ATTFTLTGL
AELLLKSSDL	AELLKSSDL
RELMGGIGKTM	RELMGIGKT
TEASEQQAL	TEASEQQAL
REIAEVNKKL	REIAVNKKL
QEIKDIYGL	QEIKDIYGL
AEINATMSV	AEINATMSV
LDIDIPMSV	LDIDIPMSV
LKERESILK	LKERESILK
EEQLQQIRAE	EEQLQQIRA
AEVSQEVTRSL	AEVSVTRSL
AEMEKATEV	AEMEKATEV
KELVTVLL	KEL-VTVLL
AELQRVQKV	AELQRVQKV
QEIPEPLQL	QEIPEPLQL
RDINAVLI	RDI-NAVLI
REKLKHPVM	REKLKHPVM
AEFKEAFSLF	AEFKEAFSL
AEVMLGHGLF	AEVMLGHGL
GEWEPPVI	GEW-EPPVI
VETPPMVVV	VETPPMVVV
LEARGILGL	LEARGILGL
SEDRARASLVL	SEDRARASL
HEFLHEVPAA	HEFLEVPAA
REMVATQQEM	REMVTQQEM
RDFEVKDLL	RDFEVKDLL
HEQLTVAEI	HEQLTVAEI
SEYDDPPGL	SEYDDPPGL
LEWLDKSKSSF	LDK-SKSSF
QELLSDTKL	QELLSDTKL
KELEKTYSA	KELEKTYSA
GEQGAAGARVL	GEQGAGARV
GEASPSHII	GEASPSHII
NENSLFKSL	NENSLFKSL
KEILIPVF	KEI-LIPVF
GDFALINKL	GDFALINKL
TEKDFLEAV	TEKDFLEAV
SEWDGIVTV	SEWDGIVTV
GEDPDKRISI	GEDPKRISI
ADVIIHEI	ADV-IIHEI
GEILRVIEI	GEILRVIEI
GERLNQDQL	GERLNQDQL
GEHGLIIRVK	GEHGLIIRV
LELLGLEKL	LELLGLEKL
TDVIIETM	TDV-IIETM
AEALRQPVL	AEALRQPVL
SSLLEKGLD	SSLLEKGLD
AEVLGLYGL	AEVLGLYGL
HEGLLMPVV	HEGLLMPVV
QENVVKTLL	QENVVKTLL
SEAGSHTI	SEA-GSHTI
SESPVITKA	SESPVITKA
AEALKQGNAI	AEALQGNAI
VETPVQKL	VET-PVQKL
EEAPSRPAL	EEAPSRPAL
GEGQFGEVHL	GEGQGEVHL
YEELQWLL	YEE-LQWLL
GELEAERQAL	GELEERQAL
FEITPPVV	FEI-TPPVV
RAESTTPEL	RAESTTPEL
REGTIGDMAIL	REGTGDMAI
HEAQIQEM	HEA-QIQEM
SEFTNSNNHL	SEFTSNNHL
QERDVVIRL	QERDVVIRL
PEWYIPII	PEW-YIPII
MEAIAPPLL	MEAIAPPLL
REARITEKL	REARITEKL
YEGFSLPHL	YEGFSLPHL
FEAAILTQL	FEAAILTQL
TEILKNLVL	TEILKNLVL
GESGQSWPRL	GESGSWPRL
SELDLSDNKL	SELDSDNKL
NEFASQINL	NEFASQINL
TDVLVVGV	TDV-LVVGV
EEHSIATLLL	EEHSIATLL
LENKINIIL	LENKINIIL
SEAERVSEL	SEAERVSEL
LEMIEPRTL	LEMIEPRTL
RENYDRGYSSL	YDR-GYSSL
GELTTLIHQL	GELTLIHQL
LEAHFVPLV	LEAHFVPLV
GEAALPLPGL	GEAAPLPGL
TEIKKTEVL	TEIKKTEVL
REHMGQLLHQL	REH-MGQLL
AEGLLQEAL	AEGLLQEAL
KEIQELEQLL	KEIQELEQL
IEQETPVSA	IEQETPVSA
KEFQKIAM	KEF-QKIAM
VEYISVAAL	VEYISVAAL
RELDQKTWL	RELDQKTWL
GEIDKRVEV	GEIDKRVEV
GEFPDLHRTIV	GEFPLHRTI
YEEGPGKNL	YEEGPGKNL
LENPHQPASL	LENPQPASL
REVGIPPEQSL	REVGPEQSL
KEYIQPVQL	KEYIQPVQL
KEHDILSQL	KEHDILSQL
LETELLQEI	LETELLQEI
FEAQGKPEL	FEAQGKPEL
EEYGLVVRL	EEYGLVVRL
NEFDAIQKA	NEFDAIQKA
LEKQEESEL	LEKQEESEL
REVSPAPAVA	REVSPAPAV
AEFLDKHVT	AEFLDKHVT
TETNVYFKL	TETNVYFKL
GEIDGNKVTL	GEIDNKVTL
HESAVTGLSL	HESATGLSL
AELEGRQEEL	AELERQEEL
KQQLELDSI	KQQLELDSI
HEFVEEKTKVA	HEFVEKTKV
SMDPLPVFL	SMDPLPVFL
EEIKEMHGL	EEIKEMHGL
AELLKKEKI	AELLKKEKI
AEERPRVAL	AEERPRVAL
SESVAGSHRL	SESVGSHRL
REGGFLLLHTL	REG-GFLLL
AEKLGFAGL	AEKLGFAGL
GELAPSHGL	GELAPSHGL
SESVPVIAA	SESVPVIAA
GENAHNVTL	GENAHNVTL
VEFVVEKAL	VEFVVEKAL
SIPEKNRPL	SIPEKNRPL
GEPSLYNSL	GEPSLYNSL
NEVIVGIAL	NEVIVGIAL
SEHGVPTSV	SEHGVPTSV
SETAVAKNQAL	SETAAKNQA
AELNFFQRI	AELNFFQRI
GELANEVKV	GELANEVKV
FEIEIEPLF	FEIEIEPLF
AENDAQKPSL	AENDQKPSL
HEFDGDEQFYV	HEFDGDEQF
SEWNTVERL	SEWNTVERL
REKQSKFIL	REKQSKFIL
HDKIVIVL	HDK-IVIVL
VEVFGVIRSL	VEVFVIRSL
QEVQITEA	QEV-QITEA
LDIIIHSL	LDI-IIHSL
RERDLGAQRL	RERDGAQRL
LEHKIIIRV	LEHKIIIRV
VELQTQRPIAL	VELQTQRPI
KEVLLENTNL	KEVLENTNL
AEVPVPSSL	AEVPVPSSL
DNLAIEGGI	DNLAIEGGI
HENLLINEL	HENLLINEL
REKLQEEML	REKLQEEML
SEFDDEPKF	SEFDDEPKF
EEKEIEHAL	EEKEIEHAL
GEVEGHPVWAL	VEGHPVWAL
RETLTQGLEF	RET-LTQGL
AEKLGGSAVI	AEKLGGSAV
SELIRNVTL	SELIRNVTL
KEKLIQEGKL	KEKLQEGKL
SEVILPVP	SEV-ILPVP
AEPPPIKSA	AEPPPIKSA
YEYMEEQVI	YEYMEEQVI
SEGETIVNVL	SEGEIVNVL
KEWKKKYVTL	KEWKKYVTL
IEVDPVLTV	IEVDPVLTV
RRDLPLLL	RRD-LPLLL
KELLLQPVTI	KELLQPVTI
HEAEDLKMLI	HEAEDLKML
GEAPVPASV	GEAPVPASV
VDVSLPKL	VDV-SLPKL
KEIIQDVTL	KEIIQDVTL
KESGAINTSL	KESGINTSL
IESSPQYRL	IESSPQYRL
KDVLIQGL	KDV-LIQGL
YEMEVSQRL	YEMEVSQRL
GELSKYRVPNL	GEL-SKYRV
AEFHQIEGV	AEFHQIEGV
KEQELQQTL	KEQELQQTL
QEVLLQTGRAL	QEVLTGRAL
HEAPSLQEAAL	HEAPSLQEA
SEHVKLEQL	SEHVKLEQL
REYDVPYHI	REYDVPYHI
RENKTAVVV	RENKTAVVV
IEFDKPEVL	IEFDKPEVL
GEYIAPEKI	GEYIAPEKI
SEMSEEKRAKL	SEE-KRAKL
LEMNSDLKAQL	LEMNSDLKA
GESVTKLTL	GESVTKLTL
IEPFSSPPEL	IEPFSPPEL
KELSDSVTL	KELSDSVTL
AEKLGETEKL	AEKLETEKL
TDAVGIVL	TDA-VGIVL
RFEDSPSYV	RFEDSPSYV
SEVIGPVSL	SEVIGPVSL
YEASLPHQI	YEASLPHQI
GEFKVSERYL	GEFKSERYL
GELEKENHQL	GELEENHQL
TESSLLAKL	TESSLLAKL
HEFGAITFV	HEFGAITFV
EDVKMITSL	EDVKMITSL
NEFEELAIL	NEFEELAIL
GENPLQVLV	GENPLQVLV
YELQESNVQL	YELQSNVQL
YEQLLDIKV	YEQLLDIKV
AESPTPQAL	AESPTPQAL
AEPELQYVAL	AEPEQYVAL
RDELLPHIL	RDELLPHIL
AELKTDVFQSL	AEL-KTDVF
HEQIVIAV	HEQ-IVIAV
AEVEPGVHL	AEVEPGVHL
GEFKVHRV	GEF-KVHRV
KEFGFSGLNV	KEF-GFSGL
NEVEQRHTL	NEVEQRHTL
TEVLKTHGL	TEVLKTHGL
GESQPVKMF	GESQPVKMF
KEAALSTAL	KEAALSTAL
QEYQEKGVRVL	QEK-GVRVL
AELALKTL	AEL-ALKTL
AEALIKHKPSV	AEALIKHKP
GEMIIDRV	GEM-IIDRV
SEVTGMGTL	SEVTGMGTL
AEIPGLSINF	AEI-PGLSI
IEKTDPTTL	IEKTDPTTL
TEIGQTLDL	TEIGQTLDL
ELLKPTELVP	ELL-KPTEL
FEISDIGAKI	FEISIGAKI
TENGVLLPSL	TENGLLPSL
AEINNIIKIV	AEINNIIKI
SDFPIGTSL	SDFPIGTSL
AEFPLEPML	AEFPLEPML
SELERPHKV	SELERPHKV
SEMRERQMAM	SEMRERQMA
LEKSDQTNIL	LEKSQTNIL
QETEEKILL	QETEEKILL
KEIESRVVF	KEIESRVVF
SEVELGGNGL	SEVEGGNGL
TEVPVEPVL	TEVPVEPVL
AEKVATRGL	AEKVATRGL
AEISLLKQQL	AEISLKQQL
QEKLFIQKL	QEKLFIQKL
AENNTLSKLQL	AENNTLSKL
GESGIKVAVL	GESGKVAVL
AEIEHFIHI	AEIEHFIHI
AERFHFEAL	AERFHFEAL
EEMDSNKVSL	EEMDNKVSL
QEIVILPSL	QEIVILPSL
VEFPLDPAL	VEFPLDPAL
RDFKVVLL	RDF-KVVLL
LESPRPAL	LES-PRPAL
SEWKPGSL	SEW-KPGSL
KEKPDPNNL	KEKPDPNNL
REILVKELTT	REI-LVKEL
TERAKDFSL	TERAKDFSL
AEMLKENKV	AEMLKENKV
VEGQVPHSL	VEGQVPHSL
QEIIIRDGSL	QEIIRDGSL
YEILLGKATL	YEILGKATL
AEGPPRLAI	AEGPPRLAI
REAGSEDIIVV	REAGEDIIV
SEIENVHGF	SEIENVHGF
AEDFYSRLL	AEDFYSRLL
FEWENKVTV	FEWENKVTV
AEIQELHQSV	AEIQLHQSV
LEHQVFTVL	LEHQVFTVL
SEFKYNKPAF	SEFKNKPAF
REFHNKLKL	REFHNKLKL
AEVGRVLQV	AEVGRVLQV
RELSPLISL	RELSPLISL
AERYGINTT	AERYGINTT
EEISGIVEV	EEISGIVEV
LEVEKSLVL	LEVEKSLVL
SEPVKGTGAL	SEPVGTGAL
AELESKTNTL	AELEKTNTL
LEAKNTQTL	LEAKNTQTL
RDMRQTVAV	RDMRQTVAV
AEMPDSAAALL	AEMPSAAAL
ADYLVPIL	ADY-LVPIL
REAEDMVQKV	REAEMVQKV
AEVLEQSAQTL	AEV-LEQSA
FESFLPQLL	FESFLPQLL
SESGERPQITI	SESGERPQI
GELQKAILEL	GELQAILEL
IEEDFNIAL	IEEDFNIAL
AEPKLAFVI	AEPKLAFVI
TEISLKDSTL	TEISKDSTL
REILVEESNV	REILEESNV
SEIERQAQV	SEIERQAQV
SELPIVTPA	SELPIVTPA
MSLKQTPLSR	SLKQTPLSR
GEHLHIREF	GEHLHIREF
KETIDNNSV	KETIDNNSV
SEWKSGTKV	SEWKSGTKV
HEIITPEQFQL	HEIITPEQF
AEYDNFFQHL	AEYDFFQHL
GEAVRDFSL	GEAVRDFSL
HDLVLPLVM	HDLVLPLVM
GEKGIDIII	GEKGIDIII
VEVLVEIL	VEV-LVEIL
TEILIPEAL	TEILIPEAL
MEKIQPAL	MEK-IQPAL
QEAVAGAAVL	QEAVGAAVL
KENTPPAL	KEN-TPPAL
HERILAIGL	HERILAIGL
GESGLGKSTLI	GESGGKSTL
AEVAPVKDM	AEVAPVKDM
VELVVNKM	VEL-VVNKM
ASEAIKGAVVG	SEAIKGAVV
LEHLITEL	LEH-LITEL
DTQLLATL	DTQ-LLATL
TEELAYLK	TEE-LAYLK
NDIKVWDL	NDI-KVWDL
GEVRIWDL	GEV-RIWDL
FELDLPTVH	FELDLPTVH
GEWVERTQQL	GEWVRTQQL
RDIPVTIM	RDI-PVTIM
KERSGVSLAAL	KER-SGVSL
REFFDSNGNFL	REFFSNGNF
PVTDGAISTLL	TDGAISTLL
IERPVTVFL	IERPVTVFL
REFEERRSL	REFEERRSL
RDIKIVKKL	RDIKIVKKL
QEILDLIHKV	QEILLIHKV
SEGRPVGPA	SEGRPVGPA
KEAAIGVLVL	KEAAGVLVL
VDIYTVKV	VDI-YTVKV
REKQPMVPESL	REKQVPESL
REKKPEELI	REKKPEELI
KELIKPPTI	KELIKPPTI
YETGDFERTL	YETGFERTL
GEFDNAGGMM	GEFDNAGGM
TEHPRSTEL	TEHPRSTEL
EELTGFREL	EELTGFREL
KEHVIEAL	KEH-VIEAL
RDAIVFVTV	RDAIVFVTV
TEKSPNPSL	TEKSPNPSL
IEMNEPVQL	IEMNEPVQL
SQFGTEHVL	SQFGTEHVL
SEVDSPNVL	SEVDSPNVL
TEYETQVKV	TEYETQVKV
GETLGIIGL	GETLGIIGL
AEGTFPGKI	AEGTFPGKI
VEDPERPAC	VEDPERPAC
LEVDGHFVTM	LEVDHFVTM
YEQVSTPEI	YEQVSTPEI
GEKSPEPLGL	GEKSEPLGL
RGFSLRKDGPL	FSLRKDGPL
GEDLNKWQAL	GEDLKWQAL
HEVFLQRL	HEV-FLQRL
LEVLVKTL	LEV-LVKTL
REKSPGRMLST	REKSPGRML
SEFDPPGPNVA	SEFDPGPNV
MEDPRRAASSL	EDPRAASSL
SEGEIIQTV	SEGEIIQTV
QEEPLPHEL	QEEPLPHEL
TESYLKNVAL	TESYKNVAL
VEQNGKPSL	VEQNGKPSL
HELLQPFNVL	HELLPFNVL
REKDLTEVSTL	KDLTEVSTL
SERVVSVLL	SERVVSVLL
SEFEGHKRI	SEFEGHKRI
ETKLLASEI	ETKLLASEI
GEALAPRQVL	GEALPRQVL
HAAEYGAEALE	AEY-GAEAL
SEILPTKETL	SEILTKETL
HEAATKAVL	HEAATKAVL
SEVDGLMDL	SEVDGLMDL
AEFVGVSHL	AEFVGVSHL
REVALLRRL	REVALLRRL
IENGGVAVL	IENGGVAVL
QEIEVRPGI	QEIEVRPGI
KEGEWKIML	KEGEWKIML
YDVTVPKV	YDV-TVPKV
REKPDDPLNY	REK-PDDPL
NDWVAVHV	NDW-VAVHV
REFWAKPKP	REFWAKPKP
SEREMRNTL	SEREMRNTL
GSIDFGKTVVS	IDF-GKTVV
GETPEQPGL	GETPEQPGL
AEKLKDFKI	AEKLKDFKI
AERAIEKM	AER-AIEKM
LENKLQQQL	LENKLQQQL
TERKKLPKETL	RKKLPKETL
AEDNLIHKF	AEDNLIHKF
QDILIPNVL	QDILIPNVL
DYLHLLIGL	DYLHLLIGL
AELDEKISAL	AELDKISAL
SESIPKDSL	SESIPKDSL
GETPSGVKRL	GETPGVKRL
NELMLMAVL	NELMLMAVL
AEVTKVVV	AEV-TKVVV
IEIEKGEAV	IEIEKGEAV
REAEHLYHTL	REAELYHTL
YEPPVQESV	YEPPVQESV
KELGIWEPLAV	KELGIWEPL
GEEGDLKTSL	GEEGLKTSL
TELEYIHAL	TELEYIHAL
IEILSDVQL	IEILSDVQL
TEFQLGSKL	TEFQLGSKL
AEEFKVPAA	AEEFKVPAA
AESLIAKKI	AESLIAKKI
GEKIRTRAI	GEKIRTRAI
KEHEAITKV	KEHEAITKV
FESDLHSLL	FESDLHSLL
KETPQSLAF	KETPQSLAF
SELTQPKLAL	SELTPKLAL
RELQEAPLSL	RELQAPLSL
KEMSPTRQL	KEMSPTRQL
REFEDQKLTML	REF-EDQKL
REAELRKQRL	REAERKQRL
IEKLLIDSV	IEKLLIDSV
SELITKAV	SEL-ITKAV
IEVDGKQVEL	IEVDKQVEL
SEFVHIVAISF	SEFVHIVAI
HELLINTL	HEL-LINTL
AEDKDTPAL	AEDKDTPAL
REGNVPNIII	REGNVPNII
KEFGDQAEA	KEFGDQAEA
SENVLQVHL	SENVLQVHL
GEILIQGL	GEI-LIQGL
TELNIREST	TELNIREST
SEKDVQTAL	SEKDVQTAL
VDVSLPKV	VDV-SLPKV
LEKKKDYKL	LEKKKDYKL
TEISWENKL	TEISWENKL
GENDGETRAL	GENDETRAL
GEFDYSGSQAI	GEFDSGSQA
KEIEKDLRL	KEIEKDLRL
AEVFPLKVF	AEVFPLKVF
RDWEVLVL	RDW-EVLVL
TEINFTQKL	TEINFTQKL
TESDTAVRL	TESDTAVRL
SEARIQQL	SEA-RIQQL
GESATLRSL	GESATLRSL
GESSGKNVTL	GESSKNVTL
RDFTVSAM	RDF-TVSAM
HDFLGQVF	HDF-LGQVF
AELRSTASL	AELRSTASL
KEIEQEAAVEL	KEIEQEAAV
QELPVPLAL	QELPVPLAL
KEHEVEKMFTL	HEVEKMFTL
GEWEESEVKL	GEWESEVKL
FEFEYQTKV	FEFEYQTKV
REAESFTQL	REAESFTQL
KEWLEDKGQVL	LED-KGQVL
SERGPQEEVL	SERGQEEVL
AEIQGNINKV	AEIQNINKV
REFQTSVV	REF-QTSVV
TENDIRVMF	TENDIRVMF
AEIDSIHQL	AEIDSIHQL
IEYAKPTRL	IEYAKPTRL
SETTAAHSL	SETTAAHSL
LEYGVPVTL	LEYGVPVTL
GESLLIKTL	GESLLIKTL
GEKTVAAVM	GEKTVAAVM
GEDNGQRGYLL	GEDNQRGYL
GEGLLIVKV	GEGLLIVKV
GERLPLAV	GER-LPLAV
TYDDATKTF	TYDDATKTF
KQFEKQVEL	KQFEKQVEL
REFGEEALNSL	REF-GEEAL
AEFTVETRSA	AEFTETRSA
REKFPHVKL	REKFPHVKL
REKETKALSL	REKEKALSL
SEFYEPEAL	SEFYEPEAL
KDFEQLISI	KDFEQLISI
GERPPPKRL	GERPPPKRL
YEAEGLAL	YEA-EGLAL
WEEERQPIL	WEEERQPIL
EASGLLSL	EAS-GLLSL
GEAGPIHHL	GEAGPIHHL
RDFQHVEKL	RDFQHVEKL
AENQRITAV	AENQRITAV
SEAPATVEL	SEAPATVEL
LEDFPTISL	LEDFPTISL
AELHQEHDL	AELHQEHDL
GEFPDLHRT	GEFPDLHRT
LEKYIIEEL	LEKYIIEEL
AEDGSAGVRVL	AEDGAGVRV
GDYVPPEKL	GDYVPPEKL
KEYVGIVRL	KEYVGIVRL
FEQQMVEKL	FEQQMVEKL
VEEPSRPSA	VEEPSRPSA
REDQINRLI	REDQINRLI
KEFDGKSLVSV	KEFDGKSLV
RDLLAVVF	RDL-LAVVF
SIGLALTVSAL	GLALTVSAL
TEFLQVIEI	TEFLQVIEI
AEGDRVMVVL	AEGDVMVVL
SEIESVKISA	SEIEVKISA
SEASYLITSV	SEASLITSV
RERSPSPSF	RERSPSPSF
GSFSRFYSL	GSFSRFYSL
AEIAVNAV	AEI-AVNAV
RETLQQHKL	RETLQQHKL
ADFREPVAV	ADFREPVAV
SEAVFKEEL	SEAVFKEEL
AELRHVMTNL	AELRVMTNL
GEVVGKFYL	GEVVGKFYL
IENGEKITSL	IENGKITSL
AEVMPAQWEF	AEVMAQWEF
REGSASTEVL	REGSSTEVL
RESTGAQVQVA	RESTAQVQV
AETLPALKI	AETLPALKI
HEVIVSAA	HEV-IVSAA
KELEEKVMEL	KELEKVMEL
KEPEAPEM	KEP-EAPEM
HEYNVLLETL	HEYNLLETL
RENTQTTIKL	RENTTTIKL
SENSLIILL	SENSLIILL
RTAMPAISV	RTAMPAISV
HEYNERVRTL	HEYNRVRTL
AEMTEPKSV	AEMTEPKSV
TENPVIMGL	TENPVIMGL
DEHLQLISL	DEHLQLISL
HENIAAVVF	HENIAAVVF
FEHLQQLEL	FEHLQQLEL
GETDWKLIAI	GETDKLIAI
SEDIIVVAL	SEDIIVVAL
AEHENMKAVL	AEHEMKAVL
REAEAAIYHL	REAEAIYHL
AEMVLQVL	AEM-VLQVL
SEVQFGHAGA	SEVQGHAGA
KDYLAAIA	KDY-LAAIA
AERPGEAAVA	AERPGEAAV
EERRVKEVV	EERRVKEVV
AEVEVSIPAKL	VEVSIPAKL
AETVVVSAHSL	AET-VVVSA
QEMPWNVRM	QEMPWNVRM
IEYGEILSF	IEYGEILSF
TESILRGIFSV	TES-ILRGI
SEIEEFYQKL	SEIEFYQKL
RELSGTIKEIL	RELSTIKEI
GEFSLRGKEL	GEFSRGKEL
RDFLLKPEL	RDFLLKPEL
SEKNPSEVTL	SEKNSEVTL
LEIVTPTSL	LEIVTPTSL
TDFLIPML	TDF-LIPML
KETGGVEKL	KETGGVEKL
RETSQTKVL	RETSQTKVL
GEIVTTIPTI	GEIVTIPTI
EEYGPELHVAL	EEYGELHVA
TEKDLVTSL	TEKDLVTSL
REIDGGLETL	REIDGLETL
AEFEEPRVI	AEFEEPRVI
FEDVGRQVL	FEDVGRQVL
AEVAATEIKM	AEVATEIKM
GEQREPETL	GEQREPETL
KETPDKVEL	KETPDKVEL
PLLASPLLA	PLLASPLLA
AEKYAKESL	AEKYAKESL
VEDIHGLFSL	VEDIGLFSL
HEIIEFPVVLL	HEIIFPVVL
KEIQKLETEL	KEIQLETEL
REKSEKFAF	REKSEKFAF
SEQSLGQKL	SEQSLGQKL
AELVKRKQEL	AELVRKQEL
NEKQISQVL	NEKQISQVL
GEIERLINL	GEIERLINL
RDVDFVTAL	RDVDFVTAL
REDAEQVAL	REDAEQVAL
AELNLRSNEL	AELNRSNEL
KELEEEITL	KELEEEITL
KEIGDIAGV	KEIGDIAGV
TETSIAKEL	TETSIAKEL
REIITSILL	REIITSILL
KEGVFAKEV	KEGVFAKEV
GEPEKLGQAL	GEPELGQAL
SDVEIPATV	SDVEIPATV
GEVDGKAIPDL	GEV-DGKAI
SELVLTRL	SEL-VLTRL
LEKPSIVRL	LEKPSIVRL
LEILEIPQL	LEILEIPQL
AENKDEIAL	AENKDEIAL
GEAAKREIL	GEAAKREIL
SEKPAGADL	SEKPAGADL
KELQLLSETL	KELQLSETL
AEQSVLFKSL	AEQSLFKSL
SEFQIPTA	SEF-QIPTA
AEFHTELERL	AEFHELERL
KEIYNQVNVVL	KEIYQVNVV
YEVTPDDKRKA	YEVTPDDKR
SEKEATPVV	SEKEATPVV
REVYLQDSF	REVYLQDSF
EEAELQQVL	EEAELQQVL
REFDYVINDL	REFDVINDL
IEVIPFLVL	IEVIPFLVL
GEKGEFHKL	GEKGEFHKL
REDVLTLLL	REDVLTLLL
KEITALAPSTM	KEITLAPST
KELARQISF	KELARQISF
KELNEAVAAL	KELNAVAAL
IEGPIIKL	IEG-PIIKL
RDLEWVERL	RDLEWVERL
KEFNEPRVL	KEFNEPRVL
ELENRAPGL	ELENRAPGL
SEVGKTPTL	SEVGKTPTL
LEQKMLLNL	LEQKMLLNL
KEPEINTTL	KEPEINTTL
AEPEVGVPSSL	PEVGVPSSL
ADIIMEKL	ADI-IMEKL
GEIRNVGTGL	GEIRVGTGL
AEKELHEKF	AEKELHEKF
KDVNQQEF	KDV-NQQEF
REIAGKMDL	REIAGKMDL
AEFEKSAKENL	FEKSAKENL
FESGDVKAT	FESGDVKAT
TGSEILLWAL	SEI-LLWAL
SEFRAFSSF	SEFRAFSSF
AEHIESRTL	AEHIESRTL
LEQDRVQSL	LEQDRVQSL
IEVENKNNL	IEVENKNNL
EDARTILEL	EDARTILEL
EEGPPVTTV	EEGPPVTTV
AEYPEGFEI	AEYPEGFEI
REMFEVTGL	REMFEVTGL
GEVEKYQQL	GEVEKYQQL
GEQFVEEAL	GEQFVEEAL
VDWLITKL	VDW-LITKL
QEIRLEPQEV	QEIREPQEV
QEYPDLIHI	QEYPDLIHI
SETKIFTA	SET-KIFTA
REFSKEPEL	REFSKEPEL
SETTQIVKL	SETTQIVKL
YEHDLEVAQ	YEHDLEVAQ
SEYTSGHSV	SEYTSGHSV
VEVQRLLML	VEVQRLLML
AEDEGVSQRKF	AEDEGVSQR
IESPLFLKL	IESPLFLKL
IEHSKAVEIL	IEHSAVEIL
IEKEHVEEI	IEKEHVEEI
REEKVKAVL	REEKVKAVL
YEHDDIVST	YEHDDIVST
SEILDGNQL	SEILDGNQL
AEPKSIPAL	AEPKSIPAL
LEVIEPEVL	LEVIEPEVL
TEILLRKL	TEI-LLRKL
SEIDQVVPAA	SEIDVVPAA
REKAEIIRF	REKAEIIRF
REVSVPTF	REV-SVPTF
AEPGPRPAL	AEPGPRPAL
IEKDIAAHI	IEKDIAAHI
GEAQRLIEIL	GEAQLIEIL
SEFQKAVKL	SEFQKAVKL
HEAAFPIAV	HEAAFPIAV
SEVSQVKETL	SEVSVKETL
KEFDGKSLVS	KEFDGKSLV
REGHTSVHTL	REGHSVHTL
AERKNISQEL	AERKISQEL
GEYPKLLRL	GEYPKLLRL
REAFPAHKV	REAFPAHKV
HEVGIGSVL	HEVGIGSVL
AETAVQLFI	AETAVQLFI
RETPSPRPM	RETPSPRPM
ADVKVHIL	ADV-KVHIL
KEFNFLDYL	KEFNFLDYL
HEYKGPKADL	HEYKPKADL
AEILHEIAVL	AEILEIAVL
HDFVVVETV	HDFVVVETV
AEKSPQLGL	AEKSPQLGL
YERDHAVVV	YERDHAVVV
AERLGLRSL	AERLGLRSL
GEAKKMEFL	GEAKKMEFL
NEAAILSSL	NEAAILSSL
RQNKLTYTM	RQNKLTYTM
ADVINPMAL	ADVINPMAL
KEINEKSNIL	KEINKSNIL
RELDGRTL	REL-DGRTL
KEKDFSPEAL	KEKDSPEAL
GENPQRQGL	GENPQRQGL
HDLEVAQTT	HDLEVAQTT
VEAIFLVI	VEA-IFLVI
MEIDIPHVWL	MEI-DIPHV
IEGLAPKL	IEG-LAPKL
SEIYIWDL	SEI-YIWDL
SETRVLVDI	SETRVLVDI
QELDSRPQL	QELDSRPQL
AELKIKRL	AEL-KIKRL
GESDDSILRL	GESDSILRL
SEFPIRTL	SEF-PIRTL
RETQAINSSL	RETQINSSL
QELLSKGLIKL	QEL-LSKGL
SEDPSHPSMAL	SEDPSHPSM
KDLKESLEI	KDLKESLEI
REGFFTNGL	REGFFTNGL
NARLAADD	NAR-LAADD
AEKQLELRL	AEKQLELRL
KEGKPPISV	KEGKPPISV
SEHQAIVQHL	SEHQIVQHL
KESEVFYEL	KESEVFYEL
KELLGPPEA	KELLGPPEA
TEIEQFAETL	TEIEFAETL
REKKILEVHI	REK-KILEV
SELKKVVAL	SELKKVVAL
RSFPTLPTL	RSFPTLPTL
AEFNSTPAVF	AEFNSTPAV
AETGVGKTV	AETGVGKTV
FEFVEPLL	FEF-VEPLL
YEVIQPFFL	YEVIQPFFL
HENETLASL	HENETLASL
AEGKKQAQIL	AEGKQAQIL
TEISLQQRL	TEISLQQRL
GELEAAKALVL	GELEAAKAL
GELYNEVKV	GELYNEVKV
AEAPGLVDV	AEAPGLVDV
HEKVVRPAL	HEKVVRPAL
NAPWAVTSL	NAPWAVTSL
AERPERQQL	AERPERQQL
REFQVIQDL	REFQVIQDL
LEARLVSL	LEA-RLVSL
AELLAIIEEL	AELLIIEEL
ESKNEEIL	ESK-NEEIL
NEIQVVVA	NEI-QVVVA
KELDQWIEQL	KELDWIEQL
VELEIRELL	VELEIRELL
REKFYEAKL	REKFYEAKL
KEYDSISRL	KEYDSISRL
IELDLKATQAL	LDLKATQAL
KELEGLINT	KELEGLINT
GEDAEIAAREL	AEI-AAREL
AEAVFASEV	AEAVFASEV
YEETRQEVL	YEETRQEVL
AEQDLIREL	AEQDLIREL
IWDPVLSVM	IWDPVLSVM
FESEFVEVL	FESEFVEVL
GELTDLHGL	GELTDLHGL
QEFAEGFVKA	QEFAGFVKA
FEHQRAPRV	FEHQRAPRV
KEWDLLNENI	KEWDLNENI
SEHSTEGSVSL	SEHSTEGSV
GEGSFSTVVL	GEGSSTVVL
GEVPPQKLQAL	GEV-PPQKL
AEFLLHML	AEF-LLHML
AEAGPLASV	AEAGPLASV
GEHLKTDLL	GEHLKTDLL
HERSISPLL	HERSISPLL
IEILPLPVM	IEILPLPVM
AEISKYLTL	AEISKYLTL
HDILIRKF	HDI-LIRKF
REDQKPVM	RED-QKPVM
AELFKGKKGVL	AELFGKKGV
TEWSELENL	TEWSELENL
HEVDKLYKV	HEVDKLYKV
AEERPRIAL	AEERPRIAL
GEVLIDTHLF	GEVLIDTHL
AEWAAANHVL	AEWAANHVL
TAAARLPPSV	AAARLPPSV
SEMRAPPAA	SEMRAPPAA
HEFHSQENL	HEFHSQENL
SEVTDPLSV	SEVTDPLSV
KEAPAKVEV	KEAPAKVEV
RQGLLPVL	RQG-LLPVL
HDIGIVTM	HDI-GIVTM
REAPERPSL	REAPERPSL
NEMDLIWTL	NEMDLIWTL
KEQIKWSLL	KEQIKWSLL
YEQLLDVKL	YEQLLDVKL
HEFLLVHHL	HEFLLVHHL
IERLINLL	IER-LINLL
LEFQVMPQLL	LEFQVMPQL
SEIEIKKEM	SEIEIKKEM
KEPEKEIRPAL	PEKEIRPAL
HEVLLISA	HEV-LLISA
GEIKHVSSL	GEIKHVSSL
EEVDLSGNQL	EEVDSGNQL
HDIQIVST	HDI-QIVST
AEIVLRSL	AEI-VLRSL
GEWDKALSI	GEWDKALSI
HEALKENGVT	HEALKENGV
NERDPIRAL	NERDPIRAL
LLSGQRPAL	LLSGQRPAL
IEYENKEKL	IEYENKEKL
KEKTIHLTL	KEKTIHLTL
IEQEKRSEI	IEQEKRSEI
TDLIEPTL	TDL-IEPTL
IEWLENTVTL	IEWLNTVTL
GENDRGVSFTF	GENDRGVSF
AEDPKVTL	AED-PKVTL
AEWEESQTQKI	AEWEESQTQ
AEELLRIGL	AEELLRIGL
KEFETPEKA	KEFETPEKA
KELLGQGL	KEL-LGQGL
IEDPVRPEV	IEDPVRPEV
RESPRPLQL	RESPRPLQL
HEVNRILKV	HEVNRILKV
AEAEGLSGTTL	AEGLSGTTL
REQGAIPRL	REQGAIPRL
HELPDVSEF	HELPDVSEF
SENPERPFL	SENPERPFL
NETTGLYSL	NETTGLYSL
YEDQTKPVL	YEDQTKPVL
LTAEEGKNITI	AEEGKNITI
HEADVDVLM	HEADVDVLM
YETKPPKL	YET-KPPKL
KEIYNEKELL	KEIYEKELL
VDISAPKI	VDI-SAPKI
AELKGHTSRVL	AELKHTSRV
GETDLSKALVL	GETDLSKAL
SELYLPSST	SELYLPSST
REFGNPNRPVA	REFGPNRPV
SELITPHAI	SELITPHAI
KEYSEELVQQL	SEE-LVQQL
AELKEKIVL	AELKEKIVL
GEVELLQQKL	GEVELQQKL
LESEIISKL	LESEIISKL
FEITIRPPP	FEITIRPPP
IDIIQPAL	IDI-IQPAL
MELITPISA	MELITPISA
SEQQIVSNTL	SEQQVSNTL
RELENIIQET	RELEIIQET
YEAYLPETF	YEAYLPETF
GEGLIIVKM	GEGLIIVKM
VEGQRLVYQF	VEGQLVYQF
WEQGFSQSF	WEQGFSQSF
HQLSQLQAL	HQLSQLQAL
AETPDIKLF	AETPDIKLF
KELEKTLAL	KELEKTLAL
KEIEELQSQA	KEIELQSQA
LEWPSLTA	LEW-PSLTA
KEAQLYAAQA	KEA-QLYAA
TEVGEKIAL	TEVGEKIAL
HEMPPHIYAI	HEMPHIYAI
LEKAGVEHQL	LEKAVEHQL
TEWPPFVVTL	TEWPFVVTL
NEVVQVHAA	NEVVQVHAA
AEIPLNEQTTL	AEIPLNEQT
KEITEKTRVAL	KEITEKTRV
SEIHNLQNKF	SEIHLQNKF
LETVILGL	LET-VILGL
GEPGPVRSV	GEPGPVRSV
SEAFLPQSI	SEAFLPQSI
RESEKTVRQF	RESETVRQF
KEVEQFDV	KEV-EQFDV
FEVETPAVL	FEVETPAVL
REVVIGTPTL	REVVGTPTL
KEFAQIIKI	KEFAQIIKI
EEHNFLFQL	EEHNFLFQL
YEGAVVIL	YEG-AVVIL
HEAMEQQSI	HEAMEQQSI
KDLVVPEKW	KDLVVPEKW
AELALAGINML	AEL-ALAGI
SENGDRSQHLL	SENGRSQHL
KQLDEWLK	KQL-DEWLK
GEYQNQEIHNL	GEY-QNQEI
HDVVVENNL	HDVVVENNL
YEVDGGKLRF	YEVDGKLRF
KESTLHLVL	KESTLHLVL
KEAETRAEF	KEAETRAEF
GELSLMAAL	GELSLMAAL
AQLKQRNTL	AQLKQRNTL
AEMVALVEQRA	AEMVLVEQR
RERIIPRSV	RERIIPRSV
AEASVDPSL	AEASVDPSL
SEEEVKLAL	SEEEVKLAL
GETPQVAVI	GETPQVAVI
AEVLISTV	AEV-LISTV
KELDVQIIGV	KELDQIIGV
REATKAAREAL	REATAAREA
GEEALLRYVL	GEEALRYVL
GEAIKYLTEAL	GEAIYLTEA
HELRIARL	HEL-RIARL
REMDEQIRL	REMDEQIRL
EEFEIPPISL	EEFEPPISL
ADFPALVV	ADF-PALVV
SELITKAVA	SELITKAVA
KEVSMDDHKL	KEVSDDHKL
SEAEKVYIV	SEAEKVYIV
KEKEVSQEL	KEKEVSQEL
IEYVKPSDL	IEYVKPSDL
AEDVQHQIL	AEDVQHQIL
LERNEFITL	LERNEFITL
SELPEQVQV	SELPEQVQV
LEKAVVLEL	LEKAVVLEL
KDFIIFEA	KDF-IIFEA
KETAVFINI	KETAVFINI
GETPEAAAL	GETPEAAAL
SEVTVQPSPYL	SEVTVQPSP
RENTQTTI	REN-TQTTI
KEKPNDPTL	KEKPNDPTL
TEKIISAEL	TEKIISAEL
KEHLYFETV	KEHLYFETV
SEKISNTAI	SEKISNTAI
REIVIGVL	REI-VIGVL
AEMETQKEKI	AEMEQKEKI
IEIIQPLL	IEI-IQPLL
SEVDPKLVSNL	SEV-DPKLV
VEKIDFDSV	VEKIDFDSV
FADLNLAEF	FADLNLAEF
AEVENVFHSL	AEVEVFHSL
SEDEPTRSL	SEDEPTRSL
TEHGVEVVL	TEHGVEVVL
KELEALIQNL	KELELIQNL
TEVNLNNML	TEVNLNNML
IEFSIPDSL	IEFSIPDSL
REGKIAGRAV	REGKAGRAV
GEKITQDTL	GEKITQDTL
EDYEVLYTI	EDYEVLYTI
RERIVPRAV	RERIVPRAV
GETAFAFHL	GETAFAFHL
REIEGRAIRL	REIERAIRL
SETHIYQV	SET-HIYQV
VECPPPRTTA	VECPPRTTA
EAKKIERL	EAK-KIERL
ADFKAGKAL	ADFKAGKAL
SEKPLSERL	SEKPLSERL
LERLSELAL	LERLSELAL
AEYSTKNNAL	AEYSKNNAL
HEFQETVGL	HEFQETVGL
VDILAPTV	VDI-LAPTV
LEKDAQNRL	LEKDAQNRL
AEVDYLEQF	AEVDYLEQF
AETAKATPRL	AETAATPRL
SEIYIHGL	SEI-YIHGL
GEIDYEAIVKL	IDYEAIVKL
SEQAVWAL	SEQ-AVWAL
NELNIVLEL	NELNIVLEL
QEWDGKESTI	QEWDKESTI
GEPVNGRHTL	GEPVGRHTL
GEFRTTTV	GEF-RTTTV
IAPTGHSL	IAP-TGHSL
AEKPSGIHVF	AEKPGIHVF
IEVGVVTV	IEV-GVVTV
AEVKDMEQLL	AEVKDMEQL
TELDLHKRL	TELDLHKRL
LEQEKTQAL	LEQEKTQAL
KEMNPLPTQL	KEMNLPTQL
KEGELITIGV	KEGEITIGV
AETVRPEEV	AETVRPEEV
IELTPPKGYEA	IELTPPKGY
REIFLSQPILL	REIFSQPIL
GEWPTMPHTI	GEWPMPHTI
AELLVSHGASL	AELLVSHGA
KEVPNYKL	KEV-PNYKL
EAHAKVRL	EAH-AKVRL
SEFGSKIILL	SEFGKIILL
KEIILQGL	KEI-ILQGL
REYSPPYAP	REYSPPYAP
EELEVLPRL	EELEVLPRL
AEADKPRRL	AEADKPRRL
KEFETAETLL	KEFETAETL
AEQKRLKTVL	AEQKLKTVL
AELLMTSGVVL	AELLMTSGV
SEAQLRQFTL	SEAQRQFTL
ADFAVQPAV	ADFAVQPAV
AELTKVFEI	AELTKVFEI
IETEEVNKTL	IETEVNKTL
IEAINGQSL	IEAINGQSL
GEQSPNVSL	GEQSPNVSL
GEVSFINIKTL	GEVSINIKT
RENEVLKVQL	RENELKVQL
YENEVALRQ	YENEVALRQ
HELQAVLL	HEL-QAVLL
YELPTDSHASL	YELPTDSHA
REAGITEKVVF	REAGITEKV
HEQVVERL	HEQ-VVERL
IKADHVSTY	IKADHVSTY
SELASRLTL	SELASRLTL
GEFRQGLISA	GEFRGLISA
HEVMEQQTL	HEVMEQQTL
AETLKKEKL	AETLKKEKL
SEKKIFIGL	SEKKIFIGL
KELESRLQQV	KELERLQQV
GEHDPVTEF	GEHDPVTEF
GELARAVVL	GELARAVVL
AENPFLTHL	AENPFLTHL
QEITNRLSL	QEITNRLSL
AETFHTPSL	AETFHTPSL
VEFEELLKA	VEFEELLKA
YEFERTTSI	YEFERTTSI
SEGVRVNVV	SEGVRVNVV
AEMYVAKF	AEM-YVAKF
AETLLSSLLGL	AETLLSSLL
HEVHPISSGL	HEVHISSGL
AEHVVQPKA	AEHVVQPKA
KELYTDNQHL	KELYDNQHL
RELKGAKL	REL-KGAKL
QETSVIHKI	QETSVIHKI
GEIVQQVRV	GEIVQQVRV
AENGFLPIHL	AENGLPIHL
KEVNETYKL	KEVNETYKL
LEVEDRTSL	LEVEDRTSL
HEPFIFHEV	HEPFIFHEV
LEEEVELVL	LEEEVELVL
AEVVKAPQV	AEVVKAPQV
HEIITPEQF	HEIITPEQF
GEIIGVKVL	GEIIGVKVL
QEKSPKQAL	QEKSPKQAL
KEGFPITSL	KEGFPITSL
SEYPIVDGKL	SEYPVDGKL
GEEKLIASV	GEEKLIASV
AEFKTKYKL	AEFKTKYKL
VEGREIISNL	VEGRIISNL
IEHDVVMKA	IEHDVVMKA
NEITKLTSL	NEITKLTSL
QEAGIKTAF	QEAGIKTAF
TETVVTEYL	TETVVTEYL
SEIRHLLTL	SEIRHLLTL
IEAKFYEEV	IEAKFYEEV
KEIEVGGGRKA	IEVGGGRKA
REALGDAQQSV	REALAQQSV
FEVGSSRQL	FEVGSSRQL
GEDSSFLVVRL	GEDSSFLVV
SELNGHHTL	SELNGHHTL
YEVHHQKL	YEV-HHQKL
AEIEELTASA	AEIELTASA
LEPHDSPVL	LEPHDSPVL
HEIESLYTKL	HEIELYTKL
AELRLEAL	AEL-RLEAL
SELRSVLVM	SELRSVLVM
GEAELLQDL	GEAELLQDL
HELVPEHVVM	HELVPEHVV
SELPAKRL	SEL-PAKRL
AEVAPVAQV	AEVAPVAQV
SEYPAERKQAL	SEYPERKQA
HELLLTEL	HEL-LLTEL
EEVQFLKTL	EEVQFLKTL
AEFEWENKV	AEFEWENKV
AEQAKASPAL	AEQAASPAL
FFEVSPVSF	FFEVSPVSF
EREKLASEIL	REKLASEIL
SEASQGFRFL	SEASGFRFL
QEHVADLSRSL	HVADLSRSL
VEHPAAKVL	VEHPAAKVL
GEIADAIKTL	GEIAAIKTL
GEKLLPGIEVL	GEKLPGIEV
ADFEAHNIL	ADFEAHNIL
SEVNKLYKL	SEVNKLYKL
QELLIYEAF	QELLIYEAF
AEHERELAL	AEHERELAL
SESDKTAVL	SESDKTAVL
REKAVRVDKL	REKARVDKL
TEFPGVVA	TEF-PGVVA
GEVHIGGVML	GEVHGGVML
TEVFLHVV	TEV-FLHVV
KEKAEIERM	KEKAEIERM
SEFEIVKAI	SEFEIVKAI
IEHFIHIIT	IEHFIHIIT
REVDEQHQL	REVDEQHQL
TENLVRELL	TENLVRELL
SDIVVHRL	SDI-VVHRL
TEAQRFSSL	TEAQRFSSL
AEVHSEEAL	AEVHSEEAL
GEPGFPLNAI	GEPGPLNAI
TEAKIKQKL	TEAKIKQKL
AEFELPKTM	AEFELPKTM
AESLQQVRQQL	AESLVRQQL
HEAEGHIVTC	HEAEGHIVT
ADVVLQPRL	ADVVLQPRL
KELQIPAL	KEL-QIPAL
REYNEVEPIIL	NEV-EPIIL
YEYKDGSRKL	YEYKGSRKL
FEILPGLSV	FEILPGLSV
AEIETRIAEL	AEIERIAEL
HEVEVGVL	HEV-EVGVL
IEVLQPLI	IEV-LQPLI
FEKATFIKV	FEKATFIKV
EELLRKLL	EEL-LRKLL
KEKVIKAVV	KEKVIKAVV
RELEKAKVAA	RELEKAKVA
HEMDTSNGVLL	HEMDTSNGV
SEGPLRPVL	SEGPLRPVL
QELFPAPIL	QELFPAPIL
KEAPPPVLL	KEAPPPVLL
LESIIRGL	LES-IIRGL
LSFNPLTSL	LSFNPLTSL
HETSNINDF	HETSNINDF
AESISLLEL	AESISLLEL
SEEGLRNAL	SEEGLRNAL
AEYTAKIAL	AEYTAKIAL
YEIPGLEPITF	YEIPGLEPI
REIEELHKL	REIEELHKL
VDISLPKL	VDI-SLPKL
REKEDLVDLVL	REKEDLVDL
TEIGPRMTL	TEIGPRMTL
YEEALAVL	YEE-ALAVL
LELIELREL	LELIELREL
GVTEVGLSAYA	TEVGLSAYA
IEIKLPKL	IEI-KLPKL
AENLFIFGL	AENLFIFGL
KEMEVKPSSV	KEMEKPSSV
VEKEGIHVL	VEKEGIHVL
SEHVMPYAA	SEHVMPYAA
AEFRDYPPVL	AEFRYPPVL
AEHKIFPAAL	AEHKFPAAL
TEVTPVTGASL	TEVTPVTGA
VETAIKVL	VET-AIKVL
AEEEGPKREL	AEEEPKREL
YDVRTILL	YDV-RTILL
LEKAKAKEL	LEKAKAKEL
GESHVSGTTTL	GESHSGTTT
QEVKNLHQRL	QEVKLHQRL
IEFKETQAL	IEFKETQAL
KEGANINKSL	KEGAINKSL
AEQQGKGVAL	AEQQKGVAL
SEKKVGIQEL	SEKKGIQEL
IEFVADRLML	IEF-VADRL
AEFLPDPSAL	AEFLDPSAL
GETKAKVLL	GETKAKVLL
TDFQTHTSL	TDFQTHTSL
TEFSVDARAL	TEFSDARAL
EEFLNGRAV	EEFLNGRAV
TDFKIPIL	TDF-KIPIL
LEALVMPTL	LEALVMPTL
QEYQAREQL	QEYQAREQL
RELDGDRSKQL	LDGDRSKQL
AESDKPVVI	AESDKPVVI
REFAVVTDM	REFAVVTDM
RERIIPRSVL	RERIIPRSV
SDIKGSVL	SDI-KGSVL
GETPKHFAV	GETPKHFAV
QEIDGKSLLL	QEIDKSLLL
GELKTVRL	GEL-KTVRL
SEHGVGIYV	SEHGVGIYV
LEDIHRPVL	LEDIHRPVL
WEQDQIAHM	WEQDQIAHM
AEHRTPDVL	AEHRTPDVL
HEHIEILTV	HEHIEILTV
VEGADVVKLL	VEGADVVKL
SEPDFVAKF	SEPDFVAKF
AEIEDPPIP	AEIEDPPIP
MEQSIKSVL	MEQSIKSVL
GEPENTYIL	GEPENTYIL
AEIAKAEL	AEI-AKAEL
RERQDRISRL	RERQRISRL
LEHAGPQL	LEH-AGPQL
SELQVHSA	SEL-QVHSA
QEWDGLVRI	QEWDGLVRI
GEDKGGYVI	GEDKGGYVI
REKELAKVTI	REKEAKVTI
GEKSESISV	GEKSESISV
VEIGPRFVL	VEIGPRFVL
REHEKEVL	REH-EKEVL
GEIDVPSHEL	GEIDPSHEL
AEMPEKGAL	AEMPEKGAL
TEITHAVVI	TEITHAVVI
KESGLKPTL	KESGLKPTL
GQWKEEQKL	GQWKEEQKL
RDLASTTL	RDL-ASTTL
AEDKPRAQL	AEDKPRAQL
TEMWPVYVEL	TEMWVYVEL
GENKPRPSL	GENKPRPSL
KEKEFQEEL	KEKEFQEEL
EEYPSVSTL	EEYPSVSTL
KDILKPEIM	KDILKPEIM
GEKIIQEFL	GEKIIQEFL
AEIGYRNSL	AEIGYRNSL
AEASVMTQL	AEASVMTQL
AEFHVQRV	AEF-HVQRV
TEKPEVID	TEK-PEVID
KEIAAVIETV	KEIAVIETV
RQIDQFLVV	RQIDQFLVV
KEKAILQATL	KEKALQATL
AEAEKIRKI	AEAEKIRKI
SEVLAILL	SEV-LAILL
IEKETKEYF	IEKETKEYF
TEDSKRIAVV	TEDSKRIAV
GEAEYVVALF	GEAEYVVAL
KENDAVTIQVL	KENDVTIQV
TEVVIYVV	TEV-VIYVV
SEFLSTAPRSL	SEFLAPRSL
SSELEQIEL	SSELEQIEL
AETKNVAL	AET-KNVAL
RETGYPLAV	RETGYPLAV
SEIHSGNSV	SEIHSGNSV
SEYQQYQDATA	SEYQQYQDA
AEAEPPSEV	AEAEPPSEV
LEVPEINAL	LEVPEINAL
ADYLVPILA	ADYLVPILA
GEIDTRFSF	GEIDTRFSF
LELDPSNTKAL	LELDSNTKA
KEGEDLIQQL	KEGELIQQL
YEAPFDAQASL	APFDAQASL
VEILIPDVL	VEILIPDVL
SEKGQVEVF	SEKGQVEVF
GELVKAIVV	GELVKAIVV
TELQGMNEYL	TELQMNEYL
SELKIKNQQL	SELKKNQQL
GETGIGKSTL	GETGGKSTL
AEVHRLVVV	AEVHRLVVV
AEDRQICPSL	AEDRICPSL
GEAGPVGNM	GEAGPVGNM
KDILTSVV	KDI-LTSVV
SEIQVLEHL	SEIQVLEHL
MEKEDGESL	MEKEDGESL
AEAEERGELAL	AEAEERGEL
KEQSPEPHL	KEQSPEPHL
HEYFPEMQI	HEYFPEMQI
IEATKQYAL	IEATKQYAL
KESEVKAL	KES-EVKAL
VEKQPPQVL	VEKQPPQVL
SEVSPSGVGF	SEVSSGVGF
VDVSGPKL	VDV-SGPKL
LERELNLVL	LERELNLVL
REGSGRFSL	REGSGRFSL
SEMAGPPQM	SEMAGPPQM
TELNLPQL	TEL-NLPQL
GESVPVTKT	GESVPVTKT
SEKDTKEEIL	SEKDKEEIL
FWDPSVNLF	FWDPSVNLF
YETPTGIKV	YETPTGIKV
REKDVERFF	REKDVERFF
QEALGVAVI	QEALGVAVI
WEGPFPLSM	WEGPFPLSM
GEVDFKEFI	GEVDFKEFI
TEFYLGKRC	TEFYLGKRC
RELVAHHL	REL-VAHHL
QEHPAIRTL	QEHPAIRTL
AEIAQLMSL	AEIAQLMSL
GEEPSPEAL	GEEPSPEAL
AEIEELTAS	AEIEELTAS
REMENYEKI	REMENYEKI
FEFPEFQL	FEF-PEFQL
VEIILHVV	VEI-ILHVV
AEAPPPSVV	AEAPPPSVV
REIEGRAI	REI-EGRAI
AELLQKIEV	AELLQKIEV
SEAVIWEVL	SEAVIWEVL
LEHIKTHEL	LEHIKTHEL
STKREIQEI	STKREIQEI
GEANVPFITV	GEANPFITV
FERTVEAL	FER-TVEAL
TEADPEMIKRA	TEA-DPEMI
REKELEARV	REKELEARV
AEFKEAFQLF	AEFKEAFQL
VEFPHSPEI	VEFPHSPEI
AETARLTSF	AETARLTSF
YEHPKDLKL	YEHPKDLKL
SDYEIVRL	SDY-EIVRL
GEYDMTVPKL	GEYDTVPKL
SEWKEHKVAL	SEWKHKVAL
NEASPVKRPRL	ASPVKRPRL
AETEQHIKV	AETEQHIKV
GEISPQREV	GEISPQREV
AENPDTPAL	AENPDTPAL
AELLTKTL	AEL-LTKTL
TEIAPTGIESL	TEIAGIESL
HDFTSQIF	HDF-TSQIF
SESRYPQAL	SESRYPQAL
GEKIGIAEF	GEKIGIAEF
WEDADFPIL	WEDADFPIL
KEYAVNEV	KEY-AVNEV
GEAEGLMKV	GEAEGLMKV
LERTEGLSVL	LERTGLSVL
KELEGLQV	KEL-EGLQV
AEVKSRTTL	AEVKSRTTL
SEASPSREAI	SEASSREAI
YETQVKVM	YET-QVKVM
RDVIMREF	RDV-IMREF
SEFKAMDSI	SEFKAMDSI
SEYWDRETRSA	SEYWDRETR
KELSPPPGL	KELSPPPGL
SEVIEPPSL	SEVIEPPSL
AELLLQNL	AEL-LLQNL
AEGPITAL	AEG-PITAL
KEKLFRERL	KEKLFRERL
WEISTGRTL	WEISTGRTL
VELMFPLLL	VELMFPLLL
REAESLIAKKI	AESLIAKKI
KENRPGAYEL	KENRGAYEL
KEILPAAEI	KEILPAAEI
AEAPAGPAL	AEAPAGPAL
GEKVNIISV	GEKVNIISV
YEVKSENL	YEV-KSENL
ISLKQAPLVH	ISLKQAPLV
REIEENQKRI	REIENQKRI
AEHRYYGKSL	AEHRYGKSL
GEIPVQEHL	GEIPVQEHL
QEVEDRPEV	QEVEDRPEV
AEIRVHTV	AEI-RVHTV
ADLLAVHAV	ADLLAVHAV
KEDSNSLTL	KEDSNSLTL
KEGEIIHLI	KEGEIIHLI
SEIEWNPATKL	IEWNPATKL
REGEKLIRLH	REGEKLIRL
GENPHGVKAV	GENPGVKAV
GEVSARQEL	GEVSARQEL
LPPAAPGK	LPP-AAPGK
AETHYQLGL	AETHYQLGL
LEWDQSGSRLL	LEWDSGSRL
LEREGEENEAL	REGEENEAL
AEVEHLTEVL	AEVELTEVL
SERKEGLLGL	SERKGLLGL
IEKPGGIIV	IEKPGGIIV
QEHLQLQNL	QEHLQLQNL
QEKQIEAKI	QEKQIEAKI
REHVEAIKIGL	REHVEAIKI
KELDKFDNL	KELDKFDNL
AEFPLDPQL	AEFPLDPQL
AEARHIKAEM	AEARIKAEM
HEDLGHVAL	HEDLGHVAL
SELPVVISL	SELPVVISL
AEMPDSAAAL	AEMPSAAAL
KEYDGFTITI	KEYDFTITI
REFQTSAI	REF-QTSAI
AELEREKEKL	AELEEKEKL
LEKGKETLL	LEKGKETLL
LEKNGADEKL	LEKNADEKL
SAPVGVTAL	SAPVGVTAL
TELLWPGAALL	TELLPGAAL
NDKILPISL	NDKILPISL
RETHEIVAL	RETHEIVAL
REFQKTEDM	REFQKTEDM
QEETNFKSL	QEETNFKSL
VDWLTEKM	VDW-LTEKM
GEPHSSPEL	GEPHSSPEL
GEIRTITVV	GEIRTITVV
REKHPDGKIL	REKHDGKIL
GEKDLKQQL	GEKDLKQQL
QELPIPSKL	QELPIPSKL
QEVDASIFKAW	QEVDSIFKA
KQQLLQGI	KQQ-LLQGI
QEEYVKRAL	QEEYVKRAL
AEIELLQNLL	AEIELLQNL
FEQFLQERI	FEQFLQERI
YEDATKITV	YEDATKITV
HEKDMELSF	HEKDMELSF
KEMEQLLEM	KEMEQLLEM
KEAEKSPQL	KEAEKSPQL
NKEDIIEL	NKE-DIIEL
GELKEQYST	GELKEQYST
YEEVARKL	YEE-VARKL
SEKPYILEA	SEKPYILEA
QDRISLVSV	QDRISLVSV
VENEVIKSL	VENEVIKSL
FEFTGSHLTV	FEFTSHLTV
RDWVLNEF	RDW-VLNEF
AEEKLQASV	AEEKLQASV
QEYEDIAVKL	QEYEIAVKL
LEREDTSSL	LEREDTSSL
ADFAGVERL	ADFAGVERL
VEKLGAYEL	VEKLGAYEL
TEQTVSQVL	TEQTVSQVL
VEAGGMQAL	VEAGGMQAL
YEIDTGEETKF	YEIDTGEET
KEAVTGITV	KEAVTGITV
GEYPLTAM	GEY-PLTAM
KELQDVGQSL	KELQVGQSL
SEAPSQPSL	SEAPSQPSL
AEHKVQSL	AEH-KVQSL
REGKLEHTL	REGKLEHTL
IEYQEKPLL	IEYQEKPLL
GERLPRETL	GERLPRETL
SLVNLGGSK	SLVNLGGSK
AEVELKKGATL	VELKKGATL
SDLKVIVM	SDL-KVIVM
LETLFVHRF	LETLFVHRF
SDSFENPVL	SDSFENPVL
KESIGNVQV	KESIGNVQV
VLGTQTLSQI	LGTQTLSQI
NEIAFINTL	NEIAFINTL
AETTSMVSM	AETTSMVSM
SEYLRYEDTL	SEYLYEDTL
IEWPGANAQLL	IEWPANAQL
IEVEKPFAI	IEVEKPFAI
FEKIHQETF	FEKIHQETF
QESNVQLKL	QESNVQLKL
KDTTLPASA	KDTTLPASA
REIFKPRQL	REIFKPRQL
GEYSEAIPILR	GEYSAIPIL
KESSTVFEL	KESSTVFEL
NEVEILQGL	NEVEILQGL
SELIQVHKL	SELIQVHKL
VEFFDEKLNSL	VEF-FDEKL
SEHSMDTLL	SEHSMDTLL
SEIGVFHL	SEI-GVFHL
REIAQDFKTDL	REIAQDFKT
YEVVMNVV	YEV-VMNVV
KDIQHWESL	KDIQHWESL
SDFRMEESF	SDFRMEESF
LEHVAPQL	LEH-VAPQL
SEIELFRVF	SEIELFRVF
VERPAEPVA	VERPAEPVA
GEVDKRELIAL	GEVDKRELI
HEIEVIGGYL	HEIEIGGYL
REGFLDTLVVL	REGFDTLVV
YEKVGPQL	YEK-VGPQL
QEVGDGTNFVL	QEVGDGTNF
PAYHSSLMD	PAYHSSLMD
IEPELPMQL	IEPELPMQL
AEIKIQGL	AEI-KIQGL
SEHPFVNGV	SEHPFVNGV
VDISQDNAL	VDISQDNAL
YEGPAKIEV	YEGPAKIEV
MEHPYFYTV	MEHPYFYTV
MDISVPKL	MDI-SVPKL
REVSSLKNKL	REVSLKNKL
VEKHVVQSI	VEKHVVQSI
GEFVDDYTV	GEFVDDYTV
TLELLVTGL	TLELLVTGL
SESASPSAL	SESASPSAL
TETDLHGSLRV	TETDLHGSL
SELFDNKSL	SELFDNKSL
AEVEVVEM	AEV-EVVEM
AELEELKQVL	AELELKQVL
SELRSVEGL	SELRSVEGL
SERVTIEHA	SERVTIEHA
AEGLAALHSL	AEGLALHSL
KENDPSVRL	KENDPSVRL
KEILQKEL	KEI-LQKEL
KEAELKDLLL	KEAELKDLL
REGSFKETITL	REGSFKETI
IEDPVPTL	IED-PVPTL
AEVGIIESIHL	AEVGIIESI
TEFAGKGLRF	TEFAKGLRF
SEIKGEVL	SEI-KGEVL
SEKKDPPQL	SEKKDPPQL
SQYPFPVTL	SQYPFPVTL
VERFSQEV	VER-FSQEV
SQIPAQPSV	SQIPAQPSV
REIIINAV	REI-IINAV
RERPPEEVAA	RERPPEEVA
VESVMNSVVSL	VESVMNSVV
FEDGQKIVV	FEDGQKIVV
AEMVRHAL	AEM-VRHAL
GEVGATSAL	GEVGATSAL
REKEPDLKL	REKEPDLKL
AELAWIDGVL	AELAIDGVL
VEDDARGTVVL	VEDDRGTVV
TELHHVRTL	TELHHVRTL
IEQEKQRSL	IEQEKQRSL
VETPRGKPPL	VETPGKPPL
GEADPSIQL	GEADPSIQL
HQYDGLVEL	HQYDGLVEL
SEVQDRVML	SEVQDRVML
SEAPKPASL	SEAPKPASL
ADVKASVL	ADV-KASVL
REKIDQERL	REKIDQERL
VELFGPISL	VELFGPISL
HESGHAIIA	HESGHAIIA
GEGSALEKSL	GEGSLEKSL
LDWPVRTL	LDW-PVRTL
IWDETPLYF	IWDETPLYF
GEVRPVETL	GEVRPVETL
SDFLTPKAI	SDFLTPKAI
LDWPIERL	LDW-PIERL
AERVPAILM	AERVPAILM
LERLGLPGLAL	LERLGLPGL
FEMPYVVRL	FEMPYVVRL
AENELGVVVA	AENELGVVV
LEQEELQAL	LEQEELQAL
FEHRVNPLSL	FEHRNPLSL
GELKRRLGL	GELKRRLGL
AEIDSVKMTL	AEIDVKMTL
GEFSGANKEKL	GEFSNKEKL
RETEPPPKAAL	RETEPPPKA
KEVLPAGVTI	KEVLAGVTI
REMIPFAVV	REMIPFAVV
KEIDLESIFSL	KEIDLESIF
MESDPGVFTEL	SDPGVFTEL
REVTGSSQQTL	REVTSQQTL
KEKKDRLAL	KEKKDRLAL
FEEAQLPRL	FEEAQLPRL
TEQHHTQPVL	TEQHTQPVL
FEFVEPML	FEF-VEPML
SESISRAYAL	SESIRAYAL
SEKNPVTLL	SEKNPVTLL
HEFAENPGL	HEFAENPGL
GEVLDILTRL	GEVLILTRL
VEQPAQEL	VEQ-PAQEL
YEEQHPEL	YEE-QHPEL
KEPVTPSAL	KEPVTPSAL
AELEKDAQNRL	LEKDAQNRL
AEPDIIEQL	AEPDIIEQL
SEVTAALRV	SEVTAALRV
GEALILLVV	GEALILLVV
KETKDVSAL	KETKDVSAL
AEVEKIIAV	AEVEKIIAV
TEVSKVPSL	TEVSKVPSL
LETTGGHSV	LETTGGHSV
RENQQITV	REN-QQITV
VEKPSPLTL	VEKPSPLTL
MPLGSAVDIL	MPLGAVDIL
REAVVNTQEL	REAVNTQEL
TEFGHPAAI	TEFGHPAAI
GEKSQAPTL	GEKSQAPTL
KEGYVLTAV	KEGYVLTAV
FEQGGARVV	FEQGGARVV
REKIVEVMF	REKIVEVMF
EEAPVQPIL	EEAPVQPIL
AEFKLIPGL	AEFKLIPGL
ETAVLPKL	ETA-VLPKL
IEKEGVEHQL	IEKEVEHQL
KERPDLEQL	KERPDLEQL
AEDPALKEIVL	AEDPALKEI
HDKVLSILL	HDKVLSILL
RDFVLVKL	RDF-VLVKL
AEQHVTQLM	AEQHVTQLM
GEGRVEVL	GEG-RVEVL
SEMPQTHHHAL	SEMPTHHHA
RDLEIQQEL	RDLEIQQEL
TETTKFEKL	TETTKFEKL
AEYAGLKVA	AEYAGLKVA
EEIEATKNHVL	IEATKNHVL
REAPNPIHL	REAPNPIHL
RDWFSSQL	RDW-FSSQL
KEVGEAFTIL	KEVGAFTIL
TENMPIKINL	TENMIKINL
TEIEDMPTL	TEIEDMPTL
KEEQFKQVF	KEEQFKQVF
KELEVRKL	KEL-EVRKL
TEIQLPAEV	TEIQLPAEV
FEVSLADL	FEV-SLADL
HENEDIYKL	HENEDIYKL
SEIEFLVNHM	SEIELVNHM
FEYDPDNAL	FEYDPDNAL
AELFAVVKT	AELFAVVKT
TEKNVIAAL	TEKNVIAAL
REMQEKLARL	REMQKLARL
GETDKRQIAI	GETDRQIAI
KEISDLHYL	KEISDLHYL
GEFQIVNPHLL	GEFQVNPHL
REAEAGRLRTL	AEAGRLRTL
LEKSGVLDTL	LEKSVLDTL
GELPAVRDL	GELPAVRDL
REAELLRKQL	REAELRKQL
SEIEDVNTL	SEIEDVNTL
REKIYNRSL	REKIYNRSL
HEYSEELEKL	HEYSELEKL
AEAVRTTL	AEA-VRTTL
AEVNLKKKSYL	AEVNLKKKS
REKEAAYQERL	KEAAYQERL
AEVLIQQGGL	AEVLQQGGL
FEEASNQL	FEE-ASNQL
GELPQGFARL	GELPGFARL
AELDKRIEAL	AELDRIEAL
GEIEGLNDTF	GEIELNDTF
GEVKPVLQKL	GEVKVLQKL
TELNLPQLEM	TEL-NLPQL
RDVQHIIVF	RDVQHIIVF
REAQVFVRL	REAQVFVRL
AEYSAFKL	AEY-SAFKL
MESKEKDRQVL	KEK-DRQVL
HEYLPILGL	HEYLPILGL
WEYDESHVITA	WEYDESHVI
NEFPVIVRL	NEFPVIVRL
RDFSAPTL	RDF-SAPTL
HESLYNALQSL	HES-LYNAL
KEQMKVESL	KEQMKVESL
EVLDIVLI	EVL-DIVLI
KEIEQGDVTA	KEIEGDVTA
VETGHLAAF	VETGHLAAF
GELSKVTKV	GELSKVTKV
LEKEGLIL	LEK-EGLIL
EELILPLL	EEL-ILPLL
GEFEKGGKSV	GEFEGGKSV
SEFDFKPQQL	SEFDKPQQL
REQTHTRHYEL	REQTHTRHY
YEKINVNEI	YEKINVNEI
RELQQENKEL	RELQENKEL
IEKEGEFTL	IEKEGEFTL
RELKPARIYGL	REL-KPARI
SELQAIKTEL	SELQIKTEL
GERESGVVAV	GEREGVVAV
SEFAKDPSL	SEFAKDPSL
NEFSQIFQL	NEFSQIFQL
RESNVGGIQQL	RESNGIQQL
AEQMRKIAL	AEQMRKIAL
EEFDLFMRM	EEFDLFMRM
AEFTKSIAKF	AEFTSIAKF
VEKDLDEVL	VEKDLDEVL
GETQDFHSL	GETQDFHSL
AEVLTGIPAM	AEVLGIPAM
GEVHIKTM	GEV-HIKTM
QEVRDLFQM	QEVRDLFQM
VRFDSDATSPR	FDS-DATSP
SDLHAHKL	SDL-HAHKL
AEAIIHGLSSL	AEA-IIHGL
AEEFPNLAV	AEEFPNLAV
RELVSGGRSV	RELVGGRSV
DTIVNVQQI	DTIVNVQQI
SEKNLKALL	SEKNLKALL
ERLDGFGL	ERL-DGFGL
AEYIRTEML	AEYIRTEML
TEDPVPEAV	TEDPVPEAV
AEEKSIILQL	AEEKIILQL
LERAVEAL	LER-AVEAL
GEKLQDLEL	GEKLQDLEL
KEKEGEVFTL	KEKEEVFTL
KEETQPPVAL	EETQPPVAL
EEREIKERI	EEREIKERI
AEYKGRVTL	AEYKGRVTL
AEIEIMKKL	AEIEIMKKL
IEDRPMPKL	IEDRPMPKL
AERSIHDAL	AERSIHDAL
AERFNVPVSL	AERFVPVSL
REIMGTPEYL	REIMTPEYL
GESGIKVAV	GESGIKVAV
GESGLGKSTL	GESGGKSTL
HEFEEATNL	HEFEEATNL
MEFEGAIIAL	MEFEAIIAL
AELDPGTISV	AELDGTISV
REHVEAIKI	REHVEAIKI
NEQPPVVL	NEQ-PPVVL
AETKGVAL	AET-KGVAL
IELRVTSL	IEL-RVTSL
HEPEKSFSL	HEPEKSFSL
WEKQESIVL	WEKQESIVL
GEIQQIPVQL	GEIQIPVQL
GEYDVTMPKV	GEYDTMPKV
AEIRQQIPVF	AEIRQIPVF
TEKTVLVAL	TEKTVLVAL
KEGIVFKSL	KEGIVFKSL
LEQRVVEL	LEQ-RVVEL
AELSNEERNLL	AELSEERNL
AEQFKKTSL	AEQFKKTSL
IEWFSIEKL	IEWFSIEKL
SEIEYYAML	SEIEYYAML
NEYLLPESV	NEYLLPESV
KEMGTPDVRI	KEMGPDVRI
SEERAGAPL	SEERAGAPL
AEADKTIKV	AEADKTIKV
TERIMTEKL	TERIMTEKL
HEESREYSL	HEESREYSL
HEGTLVHAV	HEGTLVHAV
REKIATQQRL	REKITQQRL
EEQLQQIR	EEQ-LQQIR
LELPGLPLSL	LELPLPLSL
LEALVPVTI	LEALVPVTI
ADVIAKVAF	ADVIAKVAF
HEFSREPSL	HEFSREPSL
SEKPTVTTV	SEKPTVTTV
FEMATRAAL	FEMATRAAL
YEQRKIVEF	YEQRKIVEF
KENTIEHLL	KENTIEHLL
LEHLESQEL	LEHLESQEL
SEWEGRTHAL	SEWERTHAL
GESDPMKGV	GESDPMKGV
GEINVIGEPFL	GEINIGEPF
YEHRYVELF	YEHRYVELF
AEAGGMHTV	AEAGGMHTV
KEKEFEETM	KEKEFEETM
AELQQQQAVL	AELQQQAVL
REAILEYIL	REAILEYIL
AEVLITTRTA	AEVLTTRTA
AEAYLGKTV	AEAYLGKTV
SDFVVHEI	SDF-VVHEI
VEKIDNEVL	VEKIDNEVL
KERDLKEILTL	KERDLKEIL
AELDISNNKI	AELDSNNKI
AEFPGLPEAL	AEFPLPEAL
REKASKTFL	REKASKTFL
VEWDPTGRYVV	VEWDTGRYV
AEIDAHLVA	AEIDAHLVA
SEHLAAIEI	SEHLAAIEI
HEQQFAHPPLL	HEQQAHPPL
REIQGKKAAL	REIQKKAAL
KEWVAKQT	KEW-VAKQT
SESPIVVVL	SESPIVVVL
SEKLFGETTL	SEKLGETTL
NEMFPSAIL	NEMFPSAIL
IEVNINKNL	IEVNINKNL
HLPETKFSEL	PET-KFSEL
TETLALTKL	TETLALTKL
IEVPLYSL	IEV-PLYSL
SEQGLAKAV	SEQGLAKAV
LEAAQRAVGVG	LEA-AQRAV
KEIDGRLKEL	KEIDRLKEL
KEEIIKTL	KEE-IIKTL
HEVPYTTSF	HEVPYTTSF
GEDWFRPKL	GEDWFRPKL
AEATALVHTL	AEATLVHTL
RELQGETKL	RELQGETKL
AEGDLIEHF	AEGDLIEHF
EHLEALLL	EHL-EALLL
SEFLKEEKL	SEFLKEEKL
YEKANTPEL	YEKANTPEL
REIQKVTKL	REIQKVTKL
DSSDVVVQVL	SDV-VVQVL
RELVEKNSQL	RELVKNSQL
LERLWQEEL	LERLWQEEL
GEKTIIITC	GEKTIIITC
LDRETEEI	LDR-ETEEI
LADYLVPIL	LADYLVPIL
TEIHNINII	TEIHNINII
AEREAEIRSL	AEREEIRSL
GEKLLRPSL	GEKLLRPSL
HEINGLLVGF	HEINLLVGF
TEKLEDVAL	TEKLEDVAL
HENPKMQTM	HENPKMQTM
LEVECATQL	LEVECATQL
AERIGVDHV	AERIGVDHV
HEIKSLEDL	HEIKSLEDL
LENDKILQI	LENDKILQI
GEEVVRVL	GEE-VVRVL
SEMEQLKQKL	SEMELKQKL
AELLLERL	AEL-LLERL
LEAEPQFSL	LEAEPQFSL
RQMQLEDGGQL	MQLEDGGQL
SDLKAEAL	SDL-KAEAL
GELQRVAL	GEL-QRVAL
EEVNLNGSGKL	EEVNGSGKL
RETAEALLQVL	AEA-LLQVL
SELLKRTAL	SELLKRTAL
TEHEKVAIL	TEHEKVAIL
GEVGKTTGI	GEVGKTTGI
GEIVEKIGV	GEIVEKIGV
SEKPTVQQL	SEKPTVQQL
YEVRLTQTV	YEVRLTQTV
HEISEGNVAT	HEISEGNVA
KEFFMSFGNVV	KEFFSFGNV
NELLLFIL	NEL-LLFIL
LEYQIKTNQL	LEYQKTNQL
FEWAKNSPL	FEWAKNSPL
HEAQLKNGSL	HEAQKNGSL
LEFPQLIRV	LEFPQLIRV
GERKVEHL	GER-KVEHL
HEKDPQVKEKL	KDPQVKEKL
AEIQAELERL	AEIQELERL
TEYPVEKL	TEY-PVEKL
AEFVSTPEL	AEFVSTPEL
IGNALIILAI	GNALIILAI
GEIPTYGL	GEI-PTYGL
TKAVDAETAE	KAV-DAETA
SENRDLKTV	SENRDLKTV
HDITVPLEV	HDITVPLEV
GEHTPSALAIM	GEH-TPSAL
YEIERTIVQL	YEIETIVQL
IEIIIPLLI	IEIIIPLLI
KELENANDL	KELENANDL
DSYVGDEAQSK	SYVGEAQSK
SETHKAIQAL	SETHAIQAL
YFEELITML	YFEELITML
NEYKGWVL	NEY-KGWVL
KEHPFILNL	KEHPFILNL
AEHGETLAM	AEHGETLAM
FDYNSQQQL	FDYNSQQQL
AEEKPAPQM	AEEKPAPQM
KEKEGIAKI	KEKEGIAKI
KEAKFAQTL	KEAKFAQTL
HEGEIVNIIL	HEGEVNIIL
AEAVAGGRVL	AEAVGGRVL
AELPGSSAV	AELPGSSAV
RELDGFGLYL	RELDFGLYL
GEKQFSEERI	GEKQSEERI
SEIQNVLGV	SEIQNVLGV
ELIEGEREL	ELIEGEREL
TEAAVPKVTL	TEAAPKVTL
YEALFPLVL	YEALFPLVL
FEDETIRNI	FEDETIRNI
KELEEQRKL	KELEEQRKL
TEADVEEAL	TEADVEEAL
HEFTDLNLV	HEFTDLNLV
SDVEVYRAV	SDVEVYRAV
RESQVSILQSL	SQVSILQSL
KEADPSNFANF	KEADPSNFA
LQDAEIAR	LQD-AEIAR
GEFPGEKSKRL	GEFPKSKRL
REVLKSKEL	REVLKSKEL
KELGVGIAL	KELGVGIAL
TDVLATVL	TDV-LATVL
PAYEADVAQL	YEA-DVAQL
KEVDIYTVKV	KEVDYTVKV
FEADPPGQVA	FEADPGQVA
AELPASVHAL	AELPSVHAL
IELFRVFSL	IELFRVFSL
KEEERLIAL	KEEERLIAL
AEITDKLGL	AEITDKLGL
IDITGPKV	IDI-TGPKV
GEFKLNQPEL	GEFKNQPEL
VEHFILEVI	VEHFILEVI
HDGLHVASL	HDGLHVASL
GEFDNAGAM	GEFDNAGAM
FETKVTTL	FET-KVTTL
GEIVTIAHL	GEIVTIAHL
KETEIVKKL	KETEIVKKL
MEDETQKEL	MEDETQKEL
GELDHVVEI	GELDHVVEI
KEGLPTRAL	KEGLPTRAL
VEFNGKLLA	VEFNGKLLA
KENKVLKTL	KENKVLKTL
YEIITPWRL	YEIITPWRL
AERPQEWAM	AERPQEWAM
AEINDLENL	AEINDLENL
LENMHIEQL	LENMHIEQL
FEKKYVATL	FEKKYVATL
SDYIIRTL	SDY-IIRTL
TEFLPLLSV	TEFLPLLSV
SETLPLLAL	SETLPLLAL
SEFIKEKSA	SEFIKEKSA
GEIERLINLL	GEIELINLL
HDLLVHKA	HDL-LVHKA
AEFHQIEGVVA	AEFHQIEGV
QEIDLTGVKL	QEIDTGVKL
AEITNIRPS	AEITNIRPS
VEKPVGVAA	VEKPVGVAA
SEYSKQMQRF	SEYSQMQRF
KEIGADLVL	KEIGADLVL
HDGITVAV	HDG-ITVAV
REVGQLIGL	REVGQLIGL
FEGILIKKL	FEGILIKKL
SEVEVVDLVL	SEVEVDLVL
TEAHLPSQTL	TEAHPSQTL
PEVSPRPAL	PEVSPRPAL
QETDVRAQI	QETDVRAQI
KETEIKEITV	KETEKEITV
DEYEKLQVL	DEYEKLQVL
TEILEILEI	TEILEILEI
VEAEVHRL	VEA-EVHRL
REANQAINPKL	REANINPKL
FKQYANDNGVD	KQYANDNGV
KEKPGSEVL	KEKPGSEVL
NELITNAL	NEL-ITNAL
GEALGLVGA	GEALGLVGA
SEYARPHVM	SEYARPHVM
AEAGAKISIM	AEAGAKISI
SEFYKHIVL	SEFYKHIVL
SEMRYGIEIL	SEMRGIEIL
NEIGELLQT	NEIGELLQT
REKEPNRLESL	KEPNRLESL
REHALLAYTL	REHALAYTL
GEGMGISHEL	GEGMISHEL
EEWNDPPAV	EEWNDPPAV
KEDGAISTIVL	KEDGAISTI
KEFEDAVRKV	KEFEAVRKV
VEKYIEEQLL	VEKYIEEQL
RERESVLRL	RERESVLRL
SELLSDVRFVL	SELLSDVRF
AVEAKKTYVRD	VEA-KKTYV
TEWPGRTQVL	TEWPRTQVL
SSEFQIPTA	SSEFQIPTA
TELLIRKL	TEL-LIRKL
GEGHLVLLV	GEGHLVLLV
IDYEAIVKL	IDYEAIVKL
REMPVKVEA	REMPVKVEA
REVLRLTKL	REVLRLTKL
IENGHIFTV	IENGHIFTV
AELTVIKV	AEL-TVIKV
FEEGKKISL	FEEGKKISL
TEFDAARLVML	TEFDAARLV
IEVAKTQAL	IEVAKTQAL
SEHSKVRLV	SEHSKVRLV
REWKEQGSKTF	KEQ-GSKTF
AEHLRKYNEAL	AEHLKYNEA
EVVSLLEAL	EVVSLLEAL
REILVKEL	REI-LVKEL
FEVEKQALL	FEVEKQALL
FEFGSLDQKL	FEFGLDQKL
KEMQPTHPIRL	KEMQPTHPI
AEAIRILAA	AEAIRILAA
YEVGQRHGL	YEVGQRHGL
REYQDLLNV	REYQDLLNV
AEAQAGTTTL	AEAQGTTTL
HEIEALKSF	HEIEALKSF
QEKSPEERL	QEKSPEERL
REIELKVMKF	REIEKVMKF
TSLPVLDLI	TSLPVLDLI
HERTIHTDVL	HERTHTDVL
GETELREYF	GETELREYF
KELESQVSGL	KELEQVSGL
GEKEPPTTL	GEKEPPTTL
IEAWISEKL	IEAWISEKL
RERAVELL	RER-AVELL
MLDPLEVHL	MLDPLEVHL
AEVSQNIEKL	AEVSNIEKL
AEQRGENALKD	AEQRGENAL
GEIRATAF	GEI-RATAF
HEYPWILSA	HEYPWILSA
LEVEVIEGTL	LEVEIEGTL
LERKVESL	LER-KVESL
VEHGSVALP	VEHGSVALP
VESHIQHSL	VESHIQHSL
YEKEKLNERL	YEKELNERL
GEEAESNVL	GEEAESNVL
GESVKVHQL	GESVKVHQL
GEKKPIDQRL	GEKKIDQRL
GEKAVNPFL	GEKAVNPFL
LETIIKSL	LET-IIKSL
AEVSPMYGV	AEVSPMYGV
LENWITSL	LEN-WITSL
RPPGFSPFR	RPPGFSPFR
GEGDTHTAL	GEGDTHTAL
AQYEDIANR	AQYEDIANR
KEVDPGTKTA	KEVDGTKTA
TEDFIIDTL	TEDFIIDTL
SEIPQTERM	SEIPQTERM
KEAEILSVL	KEAEILSVL
HEGDDFGKLAL	HEGDDFGKL
IDMLLKEYL	IDMLLKEYL
KEVAVKKL	KEV-AVKKL
SERPKEIKV	SERPKEIKV
VELPHINLL	VELPHINLL
GEIGGTEEYKI	GEIGGTEEY
RETVNKAVAL	RETVKAVAL
AEPMKGPIAM	AEPMGPIAM
LQQIKIQQL	LQQIKIQQL
NETQIAEAL	NETQIAEAL
KEMGQMQVL	KEMGQMQVL
LESEHPKVM	LESEHPKVM
QEEQRYQAL	QEEQRYQAL
KEIENGHIFTV	KEIENGHIF
DLDFDISDL	DLDFDISDL
SVPEAQSAL	SVPEAQSAL
KEGDIVTLI	KEGDIVTLI
KEAEKLERQL	KEAELERQL
GETTSHLM	GET-TSHLM
RDIVVLGV	RDI-VVLGV
AEFLQPLL	AEF-LQPLL
SEQRFPVATM	SEQRPVATM
SEAFVIKGL	SEAFVIKGL
WELEKKSAV	WELEKKSAV
HDAEIVRL	HDA-EIVRL
AEPARPQAVL	AEPAPQAVL
REIVTSEGL	REIVTSEGL
SEIALLEGL	SEIALLEGL
SEEKPVPAA	SEEKPVPAA
AEWKKEEERL	AEWKEEERL
REQLKHKLEQL	REQ-LKHKL
AESGRGQVM	AESGRGQVM
SDIQVHVT	SDI-QVHVT
AELQEVVKV	AELQEVVKV
AEKTPYVVV	AEKTPYVVV
IDREMISSL	IDREMISSL
KEVEQFTQVA	KEVEQFTQV
AEEYLGFIL	AEEYLGFIL
KENGEPGTRVV	KENGPGTRV
TERIEKERM	TERIEKERM
NEFLTREL	NEF-LTREL
AEDTPVVQL	AEDTPVVQL
IEIEQLLARL	IEIELLARL
AEGIVNGHTL	AEGINGHTL
YEVRLTQTVA	YEVRLTQTV
KEKASWSSL	KEKASWSSL
AEAAVVAVA	AEAAVVAVA
GEWERAAAV	GEWERAAAV
AEALKKLIL	AEALKKLIL
SEFHQSSFLL	SEFHSSFLL
VEIAAKNL	VEI-AAKNL
LERLVSVL	LER-LVSVL
AEILGALVSV	AEILALVSV
REIAQDFKT	REIAQDFKT
HEIRTGVRTL	HEIRGVRTL
SEQEHFLIV	SEQEHFLIV
FEAMFSHGL	FEAMFSHGL
KEKVPGITI	KEKVPGITI
GENPFATVKL	GENPATVKL
GEFEKKYVA	GEFEKKYVA
KEEPVKLAV	KEEPVKLAV
KEITEGKTV	KEITEGKTV
PEVSLPAAL	PEVSLPAAL
REVDPDGRRTL	REVDGRRTL
QEVDPEGDRTI	QEVDEGDRT
TEVRELVSL	TEVRELVSL
HEFPLILIF	HEFPLILIF
LEKNEFITL	LEKNEFITL
SEADLQNQF	SEADLQNQF
READGTEKLVF	READGTEKL
KEVDPQGLRTI	KEV-DPQGL
VECPPPRTT	VECPPPRTT
LESRVTNQTL	LESRTNQTL
REIRKDNQFL	REIRKDNQF
VEQILPTL	VEQ-ILPTL
GEIKNIHLNL	GEIKIHLNL
AEALIKHKP	AEALIKHKP
AETGSGKTL	AETGSGKTL
GETEVLKVI	GETEVLKVI
AEPVNLFQHL	AEPVLFQHL
SETTPKAVV	SETTPKAVV
TEIRSQQQQL	TEIRQQQQL
REYHTDTTVKF	REYHTDTTV
VEKSPRPPL	VEKSPRPPL
KETQALVL	KET-QALVL
GEFEKKYVAT	GEFEKKYVA
TETVLRQAI	TETVLRQAI
KEWETIRSF	KEWETIRSF
HELTIPNNL	HELTIPNNL
KEVDSKSQVI	KEVDSKSQV
IEYDSPEQL	IEYDSPEQL
REKALEDVVVL	REKAEDVVV
KETELELQM	KETELELQM
HEYYQPTAL	HEYYQPTAL
HEWMKSEEL	HEWMKSEEL
NEILNGIKVL	NEILGIKVL
AQYEDIAQKS	YED-IAQKS
TEWIRAIQM	TEWIRAIQM
REDNQTNRL	REDNQTNRL
SEFLNLIGGL	SEFLLIGGL
REGDVITII	REGDVITII
TEAPPIIFA	TEAPPIIFA
AENRRLHEL	AENRRLHEL
LEKLGVTV	LEK-LGVTV
SEHSSINVL	SEHSSINVL
KEKKEEQVI	KEKKEEQVI
SESPVKAV	SES-PVKAV
VELPEQPAV	VELPEQPAV
VEAQKAQQL	VEAQKAQQL
REFVEREVI	REFVEREVI
KEHEVTIFV	KEHEVTIFV
GEGTFGRVV	GEGTFGRVV
HEVEQGCAVL	HEVEGCAVL
AEYGEIKNIHL	GEI-KNIHL
REYGSPLKA	REYGSPLKA
RELHLEGNFL	RELHEGNFL
SEKDSVVSL	SEKDSVVSL
AEAQQLITI	AEAQQLITI
QELYFFHEL	QELYFFHEL
QEAPALVRL	QEAPALVRL
AEMRPPLIET	AEMRPLIET
IESNHPIVL	IESNHPIVL
RELLPVKKF	RELLPVKKF
RDELLQVL	RDE-LLQVL
REFVRQYYT	REFVRQYYT
LDLLLPLNL	LDLLLPLNL
QELGPRFTL	QELGPRFTL
VDFVIPKEL	VDFVIPKEL
SEVMGEPHL	SEVMGEPHL
REAGIQPSLL	REAGIQPSL
HEFDEQVAA	HEFDEQVAA
YETERLIQEL	YETELIQEL
SEGPQRPPL	SEGPQRPPL
AENFAEHVL	AENFAEHVL
TEFLPFYAL	TEFLPFYAL
NLDTIVQAI	NLDTIVQAI
SEYRWHINF	SEYRWHINF
IEPGVSVSL	IEPGVSVSL
REKPDDPL	REK-PDDPL
YEERVQAVV	YEERVQAVV
REMVELAAQRL	VEL-AAQRL
HEDVKKALLLL	HEDVKKALL
SEGPKVVSV	SEGPKVVSV
SEGLPEPVL	SEGLPEPVL
REVVAGSHEL	REVVGSHEL
AEPEALQSL	AEPEALQSL
LTQALKDNK	LTQALKDNK
GEWTAPAPEF	GEWTPAPEF
RELDLSGQGF	RELDSGQGF
GEHGDSSVAV	GEHGSSVAV
RETSEKFKL	RETSEKFKL
MEFERQAEI	MEFERQAEI
IEVETRSL	IEV-ETRSL
GESDDSILRLA	GESDSILRL
LEKILPQL	LEK-ILPQL
RDIPIVHRV	RDIPIVHRV
AEKALFRAL	AEKALFRAL
AERLGVTRL	AERLGVTRL
AEVELKRDEA	AEVEKRDEA
SELPGAFEA	SELPGAFEA
GETSLMRTL	GETSLMRTL
AEFQEHEHAL	AEFQHEHAL
TEHINIHQL	TEHINIHQL
KEQDKPPNL	KEQDKPPNL
KEQSPQTLLEL	KEQSPQTLL
AEIDDRKQL	AEIDDRKQL
KEKTLGKEVL	KEKTGKEVL
REIEIRFDQL	REIERFDQL
PSEFETPAL	PSEFETPAL
SELGPIVQF	SELGPIVQF
KEIPIPFYL	KEIPIPFYL
AELRKRQAEL	AELRRQAEL
KEKVLATVT	KEKVLATVT
AEAKKIERL	AEAKKIERL
TELILTNNSL	TELITNNSL
QETAVAPSL	QETAVAPSL
HEVEEATNIL	HEVEATNIL
KENSLITQF	KENSLITQF
LEMGMPLLL	LEMGMPLLL
GEVHTGTTI	GEVHTGTTI
GEIKRDFIATL	GEIKFIATL
SEGVHTVDQVL	SEGVTVDQV
AEFQELLKV	AEFQELLKV
NVKVDPEIQ	NVKVDPEIQ
AEFQRDIML	AEFQRDIML
KEIENTYANV	KEIETYANV
REAVRPGVL	REAVRPGVL
KDLSIGNPIPT	KDLSIGNPI
HEHRGTPVGL	HEHRTPVGL
GEEILITVL	GEEILITVL
RERDFLKKV	RERDFLKKV
AEVGVPVSV	AEVGVPVSV
HVVPEPGTSL	HVVPPGTSL
IENIIPIII	IENIIPIII
SEFENKQALL	SEFENKQAL
AEIEHHEM	AEI-EHHEM
GEDEPLHAL	GEDEPLHAL
AEYEKTIAQMI	AEYETIAQM
GEYKDNALL	GEYKDNALL
LEAKLNENL	LEAKLNENL
RDFVARNV	RDF-VARNV
DAAPVAPSV	DAAPVAPSV
FEQEMATAA	FEQEMATAA
SEVGTDHKL	SEVGTDHKL
KEEYLKPVL	KEEYLKPVL
AEKCPNLTHL	AEKCNLTHL
GEIIMGNIEL	GEIIGNIEL
AEKHYSNTL	AEKHYSNTL
AEKLQRITV	AEKLQRITV
RELQLQEVAL	RELQQEVAL
REGDLLFTVA	REGDLLFTV
GEWYIRGQTI	GEWYRGQTI
AEGHPAPQI	AEGHPAPQI
SEIKSIPGV	SEIKSIPGV
QDFQIQAF	QDF-QIQAF
TEYSFLKEV	TEYSFLKEV
REDLNQVITI	REDLQVITI
HEYGSPGILEF	HEYGSPGIL
ADLLMEKL	ADL-LMEKL
GEIENIEL	GEI-ENIEL
RETVIKQTM	RETVIKQTM
AEWKATKL	AEW-KATKL
AEPDYVQPQL	AEPDVQPQL
GERVALNTL	GERVALNTL
KESQVYVHAL	KESQYVHAL
AENPGKYNIL	AENPKYNIL
KELGLAEHQL	KELGAEHQL
SEKDTKQIL	SEKDTKQIL
SAPKGSVL	SAP-KGSVL
HEASAILVHL	HEASILVHL
REIIQKLML	REIIQKLML
SEVLLATM	SEV-LLATM
MEKQNIEYEAL	KQNIEYEAL
KEVVIVSA	KEV-VIVSA
REILETLIKGL	LET-LIKGL
GELDLDKQSEL	LDLDKQSEL
EEYGKILEV	EEYGKILEV
AEDENKNVL	AEDENKNVL
GEGNWSKILL	GEGNSKILL
FEQFLLPVI	FEQFLLPVI
MEKVLAGETL	MEKVAGETL
VEAAVKQSL	VEAAVKQSL
TEFIGTVNI	TEFIGTVNI
TEQFVATVL	TEQFVATVL
KETGQIVAI	KETGQIVAI
RELDKIKGL	RELDKIKGL
AEVAKLLDL	AEVAKLLDL
LEKNKIPAL	LEKNKIPAL
KELKAFNIRL	KELKFNIRL
QEVTPSRSTL	QEVTSRSTL
SEKDIGNQL	SEKDIGNQL
REIQTAVRLL	REIQTAVRL
GEAPAPVSV	GEAPAPVSV
IDQKVYEI	IDQ-KVYEI
ISPTGHSL	ISP-TGHSL
REKDDANFKL	REKDANFKL
HEFKPQSGAEI	HEFKPQSGA
IEAEIPLVV	IEAEIPLVV
KEQERIFQL	KEQERIFQL
LELEVINL	LEL-EVINL
TEAQVTQEL	TEAQVTQEL
SEVPNGKEV	SEVPNGKEV
RDFEGKVV	RDF-EGKVV
AELPLRLFL	AELPLRLFL
HDILMATML	HDILMATML
NEFLLPPVF	NEFLLPPVF
SERALPWQL	SERALPWQL
REEWKFDTL	REEWKFDTL
AENPHSEYGL	AENPSEYGL
IEKAQLKSL	IEKAQLKSL
AETGKVVII	AETGKVVII
TEAVLPKL	TEA-VLPKL
AEIEDIRVL	AEIEDIRVL
KEVDALLHL	KEVDALLHL
GEVPFNHEI	GEVPFNHEI
LEYTQILQT	LEYTQILQT
SSYGNIRAV	SSYGNIRAV
GEKVKQVLL	GEKVKQVLL
RESPPPSAL	RESPPPSAL
KEIKEVIEL	KEIKEVIEL
KEGFPITAI	KEGFPITAI
LEIDGLEEKL	LEIDLEEKL
REVQPDVVVV	REVQDVVVV
VEMDIVEKL	VEMDIVEKL
QEIKTAHKL	QEIKTAHKL
VELPGINSV	VELPGINSV
AEKLDEIYV	AEKLDEIYV
KDLEIERL	KDL-EIERL
YEQLLDVKI	YEQLLDVKI
TEIFIHSL	TEI-FIHSL
REKQPPIDNI	REKQPIDNI
WENPPHCL	WEN-PPHCL
GELLKQADL	GELLKQADL
LESLPSPTL	LESLPSPTL
KEAQRIMTL	KEAQRIMTL
GELQHASAVL	GELQASAVL
RETIIMNQI	RETIIMNQI
IENRDVAKTVL	RDV-AKTVL
GEWSASLPHRF	GEWSSLPHR
VEFGNFNNL	VEFGNFNNL
LEADVNIKL	LEADVNIKL
SETETPKL	SET-ETPKL
IEAPIRMM	IEA-PIRMM
LEKSELIQL	LEKSELIQL
REPKLFRAV	REPKLFRAV
SEKDHMVTM	SEKDHMVTM
AEIAALRFL	AEIAALRFL
REVSEEHNL	REVSEEHNL
AEITKEQRL	AEITKEQRL
GENPASHSYVL	GENPSHSYV
KETTGIVSM	KETTGIVSM
QEIEKPVAV	QEIEKPVAV
QESEARIQQL	SEA-RIQQL
HEVDPEGDRTI	HEVDEGDRT
HEIESRILDL	HEIERILDL
KEIVGTLL	KEI-VGTLL
GEMTLKSALAL	GEMTLKSAL
NEYIFDFEL	NEYIFDFEL
GEFQELMKL	GEFQELMKL
RENSPVQSI	RENSPVQSI
KEAADIIQKL	KEAAIIQKL
TELPVMVEL	TELPVMVEL
SDVKIYKV	SDV-KIYKV
GEAHLELNAF	GEAHELNAF
AENLFRAFL	AENLFRAFL
YESHYALPL	YESHYALPL
TENPHGARLSL	TENPHGARL
VELIQNVL	VEL-IQNVL
GYSFTTTAER	YSFTTTAER
SEIDQINKV	SEIDQINKV
VERQVSTAM	VERQVSTAM
FEKEQQQL	FEK-EQQQL
TEIPTKITI	TEIPTKITI
KEVEASHLAL	KEVESHLAL
LCDVLQVL	LCD-VLQVL
KEFFSQGIHSL	KEFFGIHSL
AERPTVARI	AERPTVARI
SEKSTEQIL	SEKSTEQIL
AGFAGDDAPR	AGFAGDDAP
LRELELQRR	LRELELQRR
NEVKIYSL	NEV-KIYSL
SEYRFPEEL	SEYRFPEEL
AEWRHAHGM	AEWRHAHGM
TDFIAHLL	TDF-IAHLL
TRVLMCLLP	TRVLMCLLP
IERENAAQL	IERENAAQL
VEKQLLGEHL	VEKQLGEHL
GEVDPKVAL	GEVDPKVAL
VEYEVPEAA	VEYEVPEAA
AEKFKVQGEAV	AEKFVQGEA
HSPVVNEL	HSP-VVNEL
SEGVQVPSV	SEGVQVPSV
AETLLSSLL	AETLLSSLL
SEKPETEAV	SEKPETEAV
KELELLTI	KEL-ELLTI
KEAELRGSPSL	AELRGSPSL
QELENVKTL	QELENVKTL
TESTPITAV	TESTPITAV
KELEENKRSL	KELENKRSL
AAWLQVLPV	AAWLQVLPV
KDFSIHRL	KDF-SIHRL
EEHEVAVL	EEH-EVAVL
SEDLNKHVL	SEDLNKHVL
GESKLGGNEI	GESKGGNEI
AELTGDHQL	AELTGDHQL
REIVAISSAQL	REIVAISSA
GEAEPRTVV	GEAEPRTVV
HEKDLVWKL	HEKDLVWKL
REFLDGTRKT	REFLGTRKT
GEKTAGINV	GEKTAGINV
AEFDDRRGVL	AEFDRRGVL
IEFDPSKPFSL	FDPSKPFSL
TETTVKKVV	TETTVKKVV
RTLEGLQV	RTL-EGLQV
HDFQPHVI	HDF-QPHVI
PEFADMITV	PEFADMITV
RENGKTVIRV	RENGTVIRV
SEMKQLIDNIL	SEMKLIDNI
VDFGSREAV	VDFGSREAV
WEASRIPLL	WEASRIPLL
HDLEDNLL	HDL-EDNLL
MEHGTVTVV	MEHGTVTVV
LEKPNGATPVF	LEKPGATPV
KENKKFPVF	KENKKFPVF
KESEVVMKF	KESEVVMKF
IDFMPTIL	IDF-MPTIL
KEIDKEEHL	KEIDKEEHL
AELERNVAL	AELERNVAL
AEARHNPSI	AEARHNPSI
AEIVTKTI	AEI-VTKTI
YEYKKRLTL	YEYKKRLTL
RELDVSYVLV	RELDVSYVL
AEIQGNINHV	AEIQNINHV
GEKVAHTSL	GEKVAHTSL
IEKVEHSDL	IEKVEHSDL
GEITTLNHKL	GEITLNHKL
HEQSGVYEL	HEQSGVYEL
NEIVTIERL	NEIVTIERL
REREVEERL	REREVEERL
SESRLEKAEL	SESREKAEL
YENFKVQVL	YENFKVQVL
AETEALSKL	AETEALSKL
VEQFVFEAL	VEQFVFEAL
GEIASFDKA	GEIASFDKA
QENTQTPTV	QENTQTPTV
FNDTFVHV	FND-TFVHV
SEGKAYSL	SEG-KAYSL
RQADFVQVL	RQADFVQVL
FEHHGQVRL	FEHHGQVRL
KEISYFVAEF	KEISFVAEF
TERLIKHAV	TERLIKHAV
AESWGTGRAV	AESWTGRAV
AELLVKGYEI	AELLKGYEI
REFDFFNKI	REFDFFNKI
FERIPDIVL	FERIPDIVL
DVEVPASV	DVE-VPASV
AEIAKVEL	AEI-AKVEL
GEPEPTPVV	GEPEPTPVV
VEAPFIPKF	VEAPFIPKF
HDFDHFHSL	HDFDHFHSL
HDPHLLYTL	HDPHLLYTL
IEHIIENIV	IEHIIENIV
TEVLESFKL	TEVLESFKL
TEYPVKIV	TEY-PVKIV
KEYEKTQTVL	KEYETQTVL
AENRLTEMETL	AEN-RLTEM
TEKAPEPHV	TEKAPEPHV
SEILSKKQNEL	SEILKQNEL
KEVEEISLL	KEVEEISLL
HEVVGVFTV	HEVVGVFTV
HPDQAQAIL	HPDQAQAIL
YEEQFVTLF	YEEQFVTLF
IERAVQEL	IER-AVQEL
AEFKRAVKV	AEFKRAVKV
IEYEKKQTL	IEYEKKQTL
WEAETIIQKI	AET-IIQKI
IEHLLPLFL	IEHLLPLFL
AEMKEYITKF	AEMKYITKF
AEQRVPLSV	AEQRVPLSV
HEGPVWQV	HEG-PVWQV
AETDVLFNKV	AETDLFNKV
AEMLKVNKT	AEMLKVNKT
GELKVYKT	GEL-KVYKT
TEIEDSHTL	TEIEDSHTL
NEFQGAEAM	NEFQGAEAM
AEFAILRM	AEF-AILRM
REWKGIDRL	REWKGIDRL
AESPAGHSF	AESPAGHSF
VEKKKIRSL	VEKKKIRSL
TEWEKVAQL	TEWEKVAQL
TDFYVPVSL	TDFYVPVSL
SDFPIHNL	SDF-PIHNL
GEEKIVTSV	GEEKIVTSV
GEQEDRPGL	GEQEDRPGL
KDVKLPVQL	KDVKLPVQL
GESGKSTIV	GESGKSTIV
GETSVGKTSL	GETSGKTSL
AELEAANL	AEL-EAANL
KEAEKIIKNL	KEAEIIKNL
HQIDLIVQL	HQIDLIVQL
IDKYTEVL	IDK-YTEVL
HETSKMKVL	HETSKMKVL
VERPDPVVL	VERPDPVVL
LEAPPSPSL	LEAPPSPSL
VEFEVNIV	VEF-EVNIV
HEGDLVEVVL	HEGDVEVVL
VDHILVQEL	VDHILVQEL
SAQGSDVSLTA	SAQGSDVSL
AEAHARIHL	AEAHARIHL
IEAFTPLL	IEA-FTPLL
QEKEAIERL	QEKEAIERL
KEISITHHV	KEISITHHV
GELPRQPTT	GELPRQPTT
VDTAVRHVL	VDTAVRHVL
GEVIHVKIL	GEVIHVKIL
REGNAVAVRL	REGNVAVRL
YEIKNEADRTL	YEIKEADRT
IEVEIPKV	IEV-EIPKV
KEAGNINTSL	KEAGINTSL
AELERQAVL	AELERQAVL
METLILKEL	METLILKEL
KELLTREL	KEL-LTREL
AEKKLRPHL	AEKKLRPHL
KEVFLDRKL	KEVFLDRKL
TEYRRQVQSL	TEYRQVQSL
AEAKPITEML	AEAKPITEM
IELLLPKL	IEL-LLPKL
YENEVALR	YEN-EVALR
AERDSALETL	AERDALETL
VENSGQRESL	VENSQRESL
QDITLPHL	QDI-TLPHL
REYEKIKSQL	REYEIKSQL
AEISSKSPVAV	AEISKSPVA
TEAPIAVVT	TEAPIAVVT
KEDEINLIL	KEDEINLIL
GESAGAASVSL	GESAGAASV
AEARKSPAL	AEARKSPAL
YESINHVVVF	YESINHVVV
REYDVPYHIRL	REYDVPYHI
REIRHPNIITL	REIRHPNII
YELEKQKKL	YELEKQKKL
QEFPEHHKM	QEFPEHHKM
LEKLMFEEL	LEKLMFEEL
REDAVHAMNNL	RED-AVHAM
RELAQQIQKV	RELAQIQKV
AEGHTKAVL	AEGHTKAVL
VEINIDHKF	VEINIDHKF
KEIHIQPHL	KEIHIQPHL
NEIPVEVVL	NEIPVEVVL
KETDLLILF	KETDLLILF
AEKQLANITM	AEKQANITM
AEIGRNYSM	AEIGRNYSM
AEFLLPLLI	AEFLLPLLI
YETNKQPGL	YETNKQPGL
EEREPLIIAM	EERELIIAM
KEIESTKGEL	KEIETKGEL
SEVTISNLL	SEVTISNLL
AEAFSPPRL	AEAFSPPRL
AEAPSQVRL	AEAPSQVRL
AERIGETPEL	AERIETPEL
FESSGIHVA	FESSGIHVA
VGEFSGANK	VGEFSGANK
FEFDEQGREL	FEFDQGREL
SEKEEEARL	SEKEEEARL
VELPELPRL	VELPELPRL
AEQKVIAKL	AEQKVIAKL
SENSQPAHL	SENSQPAHL
QEVIITKF	QEV-IITKF
SEFEARVISL	SEFERVISL
SESEKQWKA	SESEKQWKA
REKTLITEKL	REKTITEKL
TELELREQL	TELELREQL
VEKPPDNQKL	VEKPDNQKL
VEAISLPSL	VEAISLPSL
SESLPVRTL	SESLPVRTL
ADYKPPAT	ADY-KPPAT
KEKELPGQTL	KEKEPGQTL
RETPPKSKL	RETPPKSKL
IELEGSQSL	IELEGSQSL
AEREQALRL	AEREQALRL
GEHDTTEYKL	GEHDTEYKL
HEIGEFPVF	HEIGEFPVF
SEVGPVVSF	SEVGPVVSF
SEAPPSKMVL	SEAPSKMVL
AENLSVPVI	AENLSVPVI
SEATLLNML	SEATLLNML
AEVGVKAHHL	AEVGKAHHL
HEEKVFRAV	HEEKVFRAV
KEALKQEVM	KEALKQEVM
GEQVIALSV	GEQVIALSV
AEHKPLVL	AEH-KPLVL
AEKPEEEL	AEK-PEEEL
RDTTLETAL	RDTTLETAL
AEKLFKQAL	AEKLFKQAL
REAEHGYASL	REAEGYASL
LERQLQDKL	LERQLQDKL
SEHAVNKQL	SEHAVNKQL
SELQKIHKA	SELQKIHKA
REFDKKKLISV	REF-DKKKL
AEIESHHPRL	AEIEHHPRL
VEKQRVREEIL	VEKQVREEI
KELDSKTIRA	KELDKTIRA
GEKVWQIRV	GEKVWQIRV
SEHGPNPIL	SEHGPNPIL
REAATQAQQTL	AATQAQQTL
RELDIYNNL	RELDIYNNL
ITLAALLLAL	TLAALLLAL
NEISEITSI	NEISEITSI
TEGINLPEL	TEGINLPEL
HESGELNQYSA	GEL-NQYSA
GELKHGPLAL	GELKGPLAL
ADWAAKKL	ADW-AAKKL
FEILPGLSVM	FEILPGLSV
EIMIPASKAGL	IMIPSKAGL
SETGKLIML	SETGKLIML
AEALVGQVL	AEALVGQVL
KEVDNFVDKL	KEVDFVDKL
KEFEKASKIL	KEFEKASKI
IESVIKEL	IES-VIKEL
SEKLLLYDTL	SEKLLYDTL
GEHQINQIAL	GEHQNQIAL
SEDAEKKVL	SEDAEKKVL
GERPGGEEL	GERPGGEEL
HEWLAGVGL	HEWLAGVGL
TEFRNIQKL	TEFRNIQKL
REIATEKKNSL	REIAKKNSL
KQFGNILIL	KQFGNILIL
AEPEKAPAL	AEPEKAPAL
AEQIKHIL	AEQ-IKHIL
HEIDRYTAI	HEIDRYTAI
AELENLVNQA	AELELVNQA
AEEEMRASL	AEEEMRASL
KEAPPMEKP	KEAPPMEKP
AEAKEKIYL	AEAKEKIYL
LTEGLEIL	LTE-GLEIL
REDGVFNISV	REDGFNISV
REKTPSEDKL	REKTSEDKL
HELQENTICSL	HEL-QENTI
AELILHDAL	AELILHDAL
REKVIKGAEI	REKVKGAEI
RENNKPRTVL	RENNPRTVL
ADVIVHRL	ADV-IVHRL
RENVFQEHQTL	RENVQEHQT
SEREAIEVF	SEREAIEVF
REFIAPVTL	REFIAPVTL
AKVKFEERY	AKVKFEERY
REKVESEL	REK-VESEL
TEIPLPML	TEI-PLPML
GEKVVKTAL	GEKVVKTAL
AENEYQTAI	AENEYQTAI
RDLDFTIDL	RDLDFTIDL
SELKQDTQNAL	SELKDTQNA
SEGTPVNKL	SEGTPVNKL
HEVTLSNL	HEV-TLSNL
MEFKAVQQV	MEFKAVQQV
HEIQSDVLTI	HEIQDVLTI
YDPTAPTL	YDP-TAPTL
