Data	Data aligned
AATLAGRLY	AATLAGRLY
TVTTVILEV	TVTTVILEV
LSLHNDHPY	LSLHNDHPY
RSFHEVREF	RSFHEVREF
FALTKVQQY	FALTKVQQY
YVTSVILHI	YVTSVILHI
FSAHRIVL	FSAHR-IVL
SMDLLGIVL	SMDLLGIVL
FGSEVIKVY	FGSEVIKVY
QSSSWTRVF	QSSSWTRVF
RSSKFRHVF	RSSKFRHVF
RVYEANVEKM	RVYEANVEK
YNYYKKFSY	YNYYKKFSY
WASPVALNV	WASPVALNV
AAGHRQLL	AAGHR-QLL
AAMMAVRVL	AAMMAVRVL
KAIDYIRFL	KAIDYIRFL
MAKRFAYPL	MAKRFAYPL
VASYGVKPR	VASYGVKPR
VASEKIEVL	VASEKIEVL
FSSDSKKVY	FSSDSKKVY
VSSDVIDQKVY	VSSDVIDQK
YAFAHILTV	YAFAHILTV
QAAGHARQF	QAAGHARQF
AASFGKSINF	AASFG-KSI
RTGKPIAV	RTGKP-IAV
AATSRTYLY	AATSRTYLY
TSSLPKYPL	TSSLPKYPL
YAIIKEEL	YAIIK-EEL
YAGARFVF	YAGAR-FVF
FAKGPTLTV	FAKGPTLTV
HASKPKNAF	HASKPKNAF
YAKEVTRVL	YAKEVTRVL
IATDIIHLH	IATDIIHLH
RTTNLIRHF	RTTNLIRHF
AAAERLGY	AAAER-LGY
FASGPREL	FASGP-REL
VARSNIMTL	VARSNIMTL
NANEMFRIF	NANEMFRIF
SAFLPARFY	SAFLPARFY
FQTIARNAL	FQTIARNAL
VAMIYPLEY	VAMIYPLEY
NSTNRVFF	NSTNR-VFF
RSAVRPASL	RSAVRPASL
MSSPLSKEL	MSSPLSKEL
FTTEGEVF	FTTEG-EVF
PSVWQNIL	PSVWQ-NIL
KLKTVNLVL	KLKTVNLVL
VTNEYQHML	VTNEYQHML
SHALQLNNR	SHALQLNNR
PSVNYSKVY	PSVNYSKVY
TADGAHFEL	TADGAHFEL
SAAAARFY	SAAAA-RFY
LTVLGQPK	LTVLG-QPK
HAPFTATSL	HAPFTATSL
VAKPCAIAL	VAKPCAIAL
FANLKYVSL	FANLKYVSL
TLTALVRYY	TLTALVRYY
FTMPLHMTF	FTMPLHMTF
NATKARIPF	NATKARIPF
PVAASIMKIY	VAASIMKIY
YASTGREF	YASTG-REF
MTSFRLAL	MTSFR-LAL
VARSNILTL	VARSNILTL
FAFVHISF	FAFVH-ISF
QSVQSIRPPY	VQSIR-PPY
LAALRLQSL	LAALRLQSL
VATNLLKLF	VATNLLKLF
LATSLPRLM	LATSLPRLM
VIIDDRHVY	VIIDDRHVY
KAMPYRLLL	KAMPYRLLL
IALLLPQL	IALLL-PQL
VSRPLFLVL	VSRPLFLVL
MASGLVRLL	MASGLVRLL
VAVKGRQAL	VAVKGRQAL
IAQYKPEEY	IAQYKPEEY
SAMMYIQEL	SAMMYIQEL
LALEPGVAY	LALEPGVAY
KLSELLRYY	KLSELLRYY
YAYDIEDGKFY	YAYDIEDGK
FASIAGLEF	FASIAGLEF
ISTIRTQNL	ISTIRTQNL
VASEVYKAV	VASEVYKAV
YATKHLRVL	YATKHLRVL
ITDPEVVFV	ITDPEVVFV
IASKVTRTV	IASKVTRTV
FAAASREVL	FAAASREVL
FALPVGLIV	FALPVGLIV
FALPSELERSY	FALPSELER
SAAFAVKLF	SAAFAVKLF
FAYVEGESL	FAYVEGESL
YTTTRSHL	YTTTR-SHL
KAASVRPVL	KAASVRPVL
YAALHGEFY	YAALHGEFY
FVWLAAGAVT	FVWLAAGAV
AAAIRDAF	AAAIR-DAF
AAREVILVL	AAREVILVL
FTKGIPNVL	FTKGIPNVL
LANIVPIAM	LANIVPIAM
FAGEIPKV	FAGEI-PKV
TAAVPYRLL	TAAVPYRLL
AAAPQRQAY	AAAPQRQAY
RSYQRFTAF	RSYQRFTAF
VLVLDTDYKK	VLVLD-TDY
YSMDENLEF	YSMDENLEF
YRPGTVAL	YRPGT-VAL
FKDLGEENFK	FKDLGEENF
YATQREKL	YATQR-EKL
FVKEHFDEL	FVKEHFDEL
VARDLRAEF	VARDLRAEF
ISDPYKVYRIV	ISDPY-KVY
NQTEFERVF	NQTEFERVF
YAGAILEV	YAGAI-LEV
TSPEAFLAL	TSPEAFLAL
FTAWRILEV	FTAWRILEV
VAKMYISEL	VAKMYISEL
LVTGTVRTF	LVTGTVRTF
ISTLKTEF	ISTLK-TEF
RSFPTLPTL	RSFPTLPTL
LAYLRLNTL	LAYLRLNTL
FARQYYEML	FARQYYEML
NSILRKQAF	NSILRKQAF
SSAPPRTAF	SSAPPRTAF
YSSIRGFL	YSSIR-GFL
AAAARIEAM	AAAARIEAM
IAHVLPAL	IAHVL-PAL
YAKGALVL	YAKGA-LVL
VAMYGGLVL	VAMYGGLVL
KALTHLEM	KALTH-LEM
FASIAPSIY	FASIAPSIY
VTNLRRVTY	VTNLRRVTY
LSSFKVAQY	LSSFKVAQY
SAVSACRVF	SAVSACRVF
QVTEAFREF	QVTEAFREF
LSQNRVAEF	LSQNRVAEF
SAFADRPAF	SAFADRPAF
KTTNRLLL	KTTNR-LLL
HSHFHDTL	HSHFH-DTL
SSYPNPVAH	SSYPNPVAH
ISLLKAVFY	ISLLKAVFY
AALNQALEM	AALNQALEM
TLPKISPSSL	LPKISPSSL
VSTLWLHLL	VSTLWLHLL
KAAMLFRQY	KAAMLFRQY
FSHHHIEM	FSHHH-IEM
LTSDPRLPY	LTSDPRLPY
MATVVYKVF	MATVVYKVF
AARTQQLLL	AARTQQLLL
EASWRFTFY	EASWRFTFY
NAKGYTIPL	NAKGYTIPL
SATALKHVF	SATALKHVF
FASIPGLEF	FASIPGLEF
YSQNQQSY	YSQNQ-QSY
ASNTRLQL	ASNTR-LQL
AAINPELLQL	AAINPELQL
VAAVREGM	VAAVR-EGM
EERAAPFSLEY	RAAPFSLEY
MAYGASFLSF	YGASF-LSF
SVSPVVRVA	SVSPVVRVA
SQRGYYLTL	SQRGYYLTL
FQNDFLRLL	FQNDFLRLL
LQQTRDLAF	LQQTRDLAF
IAAPDSRRW	IAAPDSRRW
FNFLRNVSL	FNFLRNVSL
VAAMARLL	VAAMA-RLL
EIGELYLPK	EIGELYLPK
LASNSIREA	LASNSIREA
YAFSRRFAW	YAFSRRFAW
AAMQDPEVM	AAMQDPEVM
MSIPFRSAY	MSIPFRSAY
YSNCQHDF	YSNCQ-HDF
FATPYGYAM	FATPYGYAM
FAQPGTFEF	FAQPGTFEF
AASFHSLSL	AASFHSLSL
RAKGYDLEL	RAKGYDLEL
VVLVAVDK	VVLVA-VDK
YSNMRQEAL	YSNMRQEAL
FSRAIFEEV	FSRAIFEEV
FAIDPHLLLSV	FAIDPHLLL
ILATVILL	ILATV-ILL
VTADARAL	VTADA-RAL
SSSKRNEF	SSSKR-NEF
ATDDPAARF	ATDDPAARF
AAIQGRPPY	AAIQGRPPY
YAFDEAFVREV	YAFDEAFVR
MAKEGNLEL	MAKEGNLEL
KAQTLAASIL	AQTLAASIL
FSTARSHEF	FSTARSHEF
IAIEVLHLL	IAIEVLHLL
YSNIRFQF	YSNIR-FQF
FAVLPRLL	FAVLP-RLL
RASLKTAIY	RASLKTAIY
STGKNLLV	STGKN-LLV
SAQEIPVV	SAQEI-PVV
LFMPRSTEF	LFMPRSTEF
LALARLETY	LALARLETY
VASVGHGVF	VASVGHGVF
KATVKMEEY	KATVKMEEY
FAMPYFIQV	FAMPYFIQV
IITDLLRSV	IITDLLRSV
KAQLSQAL	KAQLS-QAL
VALPYFWEH	VALPYFWEH
DTYGSSILSIL	YGSSILSIL
FALPYVIVL	FALPYVIVL
YTIENPRHF	YTIENPRHF
YGAEALERMF	YGAEA-LER
FTNDKIINL	FTNDKIINL
VAMVHPLL	VAMVH-PLL
FANIDQETY	FANIDQETY
ITTTFRPEL	ITTTFRPEL
RAIQFYLEF	RAIQFYLEF
ISIEGNKMPL	ISIEG-NKM
FITPIVKVS	FITPIVKVS
SAVTNIPHV	SAVTNIPHV
RPPGFSPFR	RPPGFSPFR
ISKINEVL	ISKIN-EVL
AAWLQVLPV	AAWLQVLPV
EYTDASFTNR	YTDASFTNR
TASNTFRVV	TASNTFRVV
LSTIRSFL	LSTIR-SFL
MTSSNHRAF	MTSSNHRAF
LANLRPLL	LANLR-PLL
TAAFPRML	TAAFP-RML
LAAPGHPPVL	LAAPGHPVL
ASSPGHPAF	ASSPGHPAF
AAYTRDAL	AAYTR-DAL
MAAGLARLL	MAAGLARLL
LAAFPKLM	LAAFP-KLM
YAAPHFFHL	YAAPHFFHL
VSTDVIRRV	VSTDVIRRV
KQKDQIISL	KQKDQIISL
VASVRPAVL	VASVRPAVL
YAAERSMM	YAAER-SMM
NSLFEYQK	NSLFE-YQK
STANRHVL	STANR-HVL
LSSVKLEY	LSSVK-LEY
KAMKQGFEF	KAMKQGFEF
HSTVHLIEF	HSTVHLIEF
FAAAKLLAL	FAAAKLLAL
FSGIRNISF	FSGIRNISF
TAAPGRFSF	TAAPGRFSF
VARDYESLIDL	VARDY-ESL
QTRGWFYTL	QTRGWFYTL
NAAERRGPL	NAAERRGPL
YANIGKTL	YANIG-KTL
LVNEVTEF	LVNEV-TEF
ISGKRQEL	ISGKR-QEL
YGLEKFWAF	YGLEKFWAF
FASSPLRVL	FASSPLRVL
FADPHSKRV	FADPHSKRV
AAFVLGAAL	AAFVLGAAL
YSSVRTEAL	YSSVRTEAL
NSNNHDVL	NSNNH-DVL
YAYDGKDYLAL	YAYDGKDYL
KTIDPKVAF	KTIDPKVAF
MTQQPRPVL	MTQQPRPVL
ISATGRGVF	ISATGRGVF
GFQNALIVR	GFQNALIVR
LSSWVLLMK	LSSWVLLMK
HASQSARFY	HASQSARFY
YVSPRILTA	YVSPRILTA
LAFERRHEF	LAFERRHEF
SSGLRFVL	SSGLR-FVL
VSYLRVKSF	VSYLRVKSF
SSAGPRSPY	SSAGPRSPY
ASNVRGSL	ASNVR-GSL
FAQAPQLSV	FAQAPQLSV
LSSPAVITDK	LSSPAVTDK
GWVTDGFSSLK	VTDGF-SSL
VTTVILEV	VTTVI-LEV
TATATNHVL	TATATNHVL
KSPKSVLVI	KSPKSVLVI
YAATRATV	YAATR-ATV
QASHSYRVY	QASHSYRVY
AATGFLKLL	AATGFLKLL
FSVVSPSSF	FSVVSPSSF
VSNIRQVF	VSNIR-QVF
FLGIRFAEY	FLGIRFAEY
AARQPIEL	AARQP-IEL
YSAPGRDL	YSAPG-RDL
YIMEPSIFNTL	YIMEP-SIF
VACGASHVL	VACGASHVL
MATGDERFY	MATGDERFY
LLSDYIRLI	LLSDYIRLI
YAAQLERQL	YAAQLERQL
TLVLASITY	TLVLASITY
AAASRDITL	AAASRDITL
VGFNRLLEY	VGFNRLLEY
FASNREEL	FASNR-EEL
TAASTSRSL	TAASTSRSL
YAHTKEQTY	YAHTKEQTY
VLQLRVHTF	VLQLRVHTF
NAMDVVVQF	NAMDVVVQF
AAKPFFCEL	AAKPFFCEL
AAADPKVAF	AAADPKVAF
RATHRLLLL	RATHRLLLL
FAVALPQL	FAVAL-PQL
RANLRLTL	RANLR-LTL
FAYDGKDY	FAYDG-KDY
AAMPRPVSY	AAMPRPVSY
RAADVRDAM	RAADVRDAM
LSAGATRVY	LSAGATRVY
AAAVPTRSY	AAAVPTRSY
VTSIQDWVQK	VTSIQ-DWV
FSIVMNEL	FSIVM-NEL
FQPTLLTLPR	FQPTL-LTL
FTSEKFLVM	FTSEKFLVM
VASQLPRIF	VASQLPRIF
FAYGGHPYPF	FAYGG-HPY
TSAAIYHVL	TSAAIYHVL
FGLARIYSY	FGLARIYSY
LAASALPAL	LAASALPAL
RTREEIQEV	RTREEIQEV
YASQQIRQI	YASQQIRQI
RNYYRKIGY	RNYYRKIGY
IATSQNRIY	IATSQNRIY
HAQGFALTY	HAQGFALTY
VAIESTPMIL	VAIESTMIL
YSTIRKQEY	YSTIRKQEY
SAAEEVKTY	SAAEEVKTY
VATNLLKLFL	VATNLLKLF
AATLTSKLY	AATLTSKLY
AAGSRARVY	AAGSRARVY
VASTVKHAL	VASTVKHAL
TAIESTPTL	TAIESTPTL
ALPEIFTEL	ALPEIFTEL
SAFLKTIAL	SAFLKTIAL
AFVTGYDI	AFVTG-YDI
YSSEKLSYF	YSSEKLSYF
FASEKKWAF	FASEKKWAF
LAMEPTPEL	LAMEPTPEL
LAFDQQPAM	LAFDQQPAM
ISSTHVNHL	ISSTHVNHL
VSYLRPLDF	VSYLRPLDF
VANTMRTSL	VANTMRTSL
IVTELIRDY	IVTELIRDY
MANWQLIHM	MANWQLIHM
TASSGHYIAY	ASSGHYIAY
HAATIRLIF	HAATIRLIF
LAFERGYEF	LAFERGYEF
KASLRELAL	KASLRELAL
TSSWVIRDL	TSSWVIRDL
VGPEADKYR	VGPEADKYR
ISTEKVNQL	ISTEKVNQL
AASQINRAY	AASQINRAY
IASYRTAL	IASYR-TAL
VANVSLLAL	VANVSLLAL
SDDKVTLEER	DDKVTLEER
LSKIREEY	LSKIR-EEY
LAVDPNRAV	LAVDPNRAV
MATNTVYVF	MATNTVYVF
KATERTLVY	KATERTLVY
KSTEYAHLF	KSTEYAHLF
FSWIRNTL	FSWIR-NTL
AAAPVIKAY	AAAPVIKAY
NATIRNVL	NATIR-NVL
KILKDMRIF	KILKDMRIF
MTIEPFISL	MTIEPFISL
AAADSIKIW	AAADSIKIW
MTFPGERIY	MTFPGERIY
IIYDRDFSY	IIYDRDFSY
LLLLRGYAF	LLLLRGYAF
YAFPLAHSL	YAFPLAHSL
PPYTVVYFPVR	YTVVYFPVR
AAFLKAIGY	AAFLKAIGY
KAFIHHEL	KAFIH-HEL
HSIFTPETNPR	IFTPETNPR
YTAAGYRVV	YTAAGYRVV
YAAVKIHQL	YAAVKIHQL
LATKILHLL	LATKILHLL
LSTPLIRTF	LSTPLIRTF
HAISRYWYY	HAISRYWYY
FSQIQPKL	FSQIQ-PKL
SAQYRGVM	SAQYR-GVM
FSANPKEL	FSANP-KEL
KSAEGRVL	KSAEG-RVL
SAAQPGVAF	SAAQPGVAF
GASIVEDK	GASIV-EDK
YAANPRPDAL	AANPRPDAL
FSTSTGRVY	FSTSTGRVY
YALTVLEM	YALTV-LEM
VSTLHHVL	VSTLH-HVL
SSVPSKPPM	SSVPSKPPM
MLAPPRELF	MLAPPRELF
YAKPYFLRL	YAKPYFLRL
YSYFSPRTM	YSYFSPRTM
VAAVREFYL	VAAVREFYL
LTTKNIKMY	LTTKNIKMY
VSYYEKHSL	VSYYEKHSL
VTSFRFVYF	VTSFRFVYF
SVPEAQSAL	SVPEAQSAL
VASSRQVL	VASSR-QVL
VAIWGRVVF	VAIWGRVVF
VATEVLMWF	VATEVLMWF
YTRDIYKEL	YTRDIYKEL
NTDEPPMVF	NTDEPPMVF
VATPVLIPK	VATPVLIPK
NSASPKHSL	NSASPKHSL
SAQDRQLTL	SAQDRQLTL
KTQDLFRRV	KTQDLFRRV
AASTARHLY	AASTARHLY
STDDGVQF	STDDG-VQF
GSALPRLY	GSALP-RLY
VAFDKDRREY	VAFDKDREY
RVAPEEHPVL	VAPEEHPVL
ISSPVILQF	ISSPVILQF
KITPWFKII	KITPWFKII
SAMVMFEL	SAMVM-FEL
GNYYKPWFF	GNYYKPWFF
NAAIAKQAL	NAAIAKQAL
FAHTVVTSR	FAHTVVTSR
GTYTGFIKV	GTYTGFIKV
SAASALHLL	SAASALHLL
LSMEILEV	LSMEI-LEV
LVTGFARIF	LVTGFARIF
LASAFFLVV	LASAFFLVV
LAGVAGLLVAL	VAGLL-VAL
IATPGRLIDF	IATPG-RLI
KSMETKVQF	KSMETKVQF
IAQDQPKIL	IAQDQPKIL
NSSNKPAV	NSSNK-PAV
FAIDPHLLL	FAIDPHLLL
YASLRIEEL	YASLRIEEL
AASFYQRAL	AASFYQRAL
YSQEADDRVF	YSQEADRVF
IANQRITAF	IANQRITAF
RTGPPMGSRF	RTGPPMGSR
LSSLRFVF	LSSLR-FVF
TTSLRVLAL	TTSLRVLAL
FIFLRLNVL	FIFLRLNVL
KTKPVASV	KTKPV-ASV
AATEKLLEY	AATEKLLEY
KLSTYIRLY	KLSTYIRLY
VATFRLML	VATFR-LML
LASLSNRLY	LASLSNRLY
FAHPYQYEL	FAHPYQYEL
VTADFVKIY	VTADFVKIY
AANLLIPAV	AANLLIPAV
YATTGKCEL	YATTGKCEL
AFKNRMEV	AFKNR-MEV
KAFSQNAGL	KAFSQNAGL
RAAAFFLSL	RAAAFFLSL
RASLLLKTY	RASLLLKTY
QASDVSVKY	QASDVSVKY
YFVDDRLVM	YFVDDRLVM
IAHDGQRIY	IAHDGQRIY
TATHFPRVY	TATHFPRVY
MTSSRLWFS	MTSSRLWFS
AAAKAALIY	AAAKAALIY
EALPLAFTQK	ALPLAFTQK
FARLPLVV	FARLP-LVV
VTQLRLIFY	VTQLRLIFY
NAADIENRVL	AADIENRVL
AACPYFKSM	AACPYFKSM
VARPPNIVL	VARPPNIVL
FIRGNNVL	FIRGN-NVL
YFLLRPETL	YFLLRPETL
VLRQPRPAL	VLRQPRPAL
SAATRKAF	SAATR-KAF
YASPAHAVDAV	YASPA-HAV
SSQERPLKV	SSQERPLKV
KANPALYVL	KANPALYVL
FAVDFEKIY	FAVDFEKIY
TAAPPKANF	TAAPPKANF
FIMGKTIEF	FIMGKTIEF
VSQQRALAL	VSQQRALAL
LAAFKPEAY	LAAFKPEAY
RSSPQEIKV	RSSPQEIKV
FSSVRQEL	FSSVR-QEL
AAGTRMYEY	AAGTRMYEY
SMAGPRLEI	SMAGPRLEI
AEFQDALEK	AEFQDALEK
NMAEFRPEM	NMAEFRPEM
SANHNILQI	SANHNILQI
TASPLVKSV	TASPLVKSV
LSTIQKIAL	LSTIQKIAL
IAILNNNLNTL	ILNNNLNTL
FGQLRDFYF	FGQLRDFYF
VLALRPWSF	VLALRPWSF
AAALRRQM	AAALR-RQM
FAYYRVGEY	FAYYRVGEY
HAKPPTPSL	HAKPPTPSL
LASWGHEY	LASWG-HEY
LSTPYIHSL	LSTPYIHSL
SLLERLLTY	SLLERLLTY
MAAMPQTVY	MAAMPQTVY
LQAQRLVM	LQAQR-LVM
KATTLEKTY	KATTLEKTY
VTSHRVEM	VTSHR-VEM
VATEGSREL	VATEGSREL
FAYHMIETY	FAYHMIETY
SARRPLLL	SARRP-LLL
FSVVQPSSF	FSVVQPSSF
IIAPPERKY	IIAPPERKY
ISQEHQEL	ISQEH-QEL
LAIEDRFVY	LAIEDRFVY
YSKLPGVSL	YSKLPGVSL
KANLKMEAY	KANLKMEAY
YSGLRDVY	YSGLR-DVY
STTDVEKSF	STTDVEKSF
SAAEARSM	SAAEA-RSM
ISRDPFYEM	ISRDPFYEM
FSFVRITAL	FSFVRITAL
LSLKGDQAL	LSLKGDQAL
YANYYTREV	YANYYTREV
RARDPGARVL	RARDPGRVL
IAYQKKKL	IAYQK-KKL
SATDAAIRVW	SATDAAIRV
YWQNHPEL	YWQNH-PEL
GSTEKVLRV	GSTEKVLRV
VLAPTREL	VLAPT-REL
VASFRSKAY	VASFRSKAY
TATGFSHVL	TATGFSHVL
VAAYKDAY	VAAYK-DAY
DAFERIDSF	DAFERIDSF
NANFRSFIF	NANFRSFIF
APYGRITL	APYGR-ITL
VALGNMYEL	VALGNMYEL
VASDKTNTF	VASDKTNTF
TVGSDTFYSFK	VGSDTFYSF
SASPHCPVY	SASPHCPVY
FAQEAISVL	FAQEAISVL
RAAPFSLEY	RAAPFSLEY
KNSIRLTL	KNSIR-LTL
SIKDYFLEF	SIKDYFLEF
ISTWKPEM	ISTWK-PEM
FSADSKYIF	FSADSKYIF
FAVDLEHHSY	FAVDLEHSY
FSSPAVYVL	FSSPAVYVL
YTNPTVRRY	YTNPTVRRY
ITVGPRGPL	ITVGPRGPL
FGKGYFLEI	FGKGYFLEI
FTMVGKTF	FTMVG-KTF
LSADPRSVY	LSADPRSVY
NFTPNLRVW	NFTPNLRVW
VSAAIVKEL	VSAAIVKEL
LNSPYAKLY	LNSPYAKLY
HTLNQIDEVK	HTLNQIDEV
LSAELRGAM	LSAELRGAM
ISAAERDVY	ISAAERDVY
FASMRDLY	FASMR-DLY
FTTSILRHW	FTTSILRHW
YATDRKETY	YATDRKETY
TMPDTPRLF	TMPDTPRLF
VAAALARLL	VAAALARLL
KATNVVRLLL	KATNVVRLL
KASSITREL	KASSITREL
FAKFHPNLV	FAKFHPNLV
QAFDVTIMF	QAFDVTIMF
DEPPQSPWDR	DEPPQ-SPW
VATEQPEL	VATEQ-PEL
IAAMPLISL	IAAMPLISL
AASFTKEEM	AASFTKEEM
HFGIHEEM	HFGIH-EEM
ASFHRVWSF	ASFHRVWSF
KSQSLTNAF	KSQSLTNAF
ISSIREFGF	ISSIREFGF
VFMTHLEF	VFMTH-LEF
MARGAALAL	MARGAALAL
AFAEFLRTY	AFAEFLRTY
YARDETEFY	YARDETEFY
ISTPVIRTF	ISTPVIRTF
MAAERQEAL	MAAERQEAL
SATLRVEDF	SATLRVEDF
VTSILPVL	VTSIL-PVL
HSHVGYTL	HSHVG-YTL
IAKADTLTL	IAKADTLTL
IAIGSQPVL	IAIGSQPVL
AATVRPVTL	AATVRPVTL
LAALGRQV	LAALG-RQV
RSGKPVRV	RSGKP-VRV
QQSPVRPSF	QQSPVRPSF
AASALPAL	AASAL-PAL
IATKASHLL	IATKASHLL
QLNEINYEDHK	QLNEINYED
VAIRPSSKKTY	VAIRPSSKK
IQAPPRPFL	IQAPPRPFL
FGGKRLSL	FGGKR-LSL
AAAYRVTL	AAAYR-VTL
SSSYREAVF	SSSYREAVF
ATKILHLL	ATKIL-HLL
TASPVIKAV	TASPVIKAV
TASQRFIEL	TASQRFIEL
MAALRTQTL	MAALRTQTL
SSYVGLVY	SSYVG-LVY
VSHGRPLAL	VSHGRPLAL
VARPDVVEM	VARPDVVEM
YALGERQSY	YALGERQSY
VSALEQRL	VSALE-QRL
YTADGKEVL	YTADGKEVL
FSNAHINEL	FSNAHINEL
MTAVRPAL	MTAVR-PAL
YMDYRGYSY	YMDYRGYSY
VASFKHAL	VASFK-HAL
FGKDYLLEM	FGKDYLLEM
IGYPKPAL	IGYPK-PAL
VALLRVTPF	VALLRVTPF
SAYARLIDY	SAYARLIDY
SAAGEGKPAL	AAGEGKPAL
SASDVHGNF	SASDVHGNF
YTQIQPHSL	YTQIQPHSL
IAQRYLLQY	IAQRYLLQY
AAKTHTTAL	AAKTHTTAL
VATVQISSL	VATVQISSL
YAFNGTQRFL	YAFNGTRFL
YSKEKTISV	YSKEKTISV
VAAMQPRM	VAAMQ-PRM
VAIQAVLSL	VAIQAVLSL
NAAEKREQM	NAAEKREQM
TSSPVSRVV	TSSPVSRVV
FAGQGVVY	FAGQG-VVY
FAGWGRAL	FAGWG-RAL
VANAIIHLF	VANAIIHLF
TLNNDIMLIK	TLNND-IML
ITTLRKYTY	ITTLRKYTY
VSSFRPNEF	VSSFRPNEF
ITDVQLAIF	ITDVQLAIF
SAQDRFLIM	SAQDRFLIM
YSRYPPREY	YSRYPPREY
VSAPLRLQA	VSAPLRLQA
KATEYIQYM	KATEYIQYM
LSSESARQL	LSSESARQL
FAWGHDEL	FAWGH-DEL
HSFLKALYY	HSFLKALYY
AASHRMWAL	AASHRMWAL
FARIAIEV	FARIA-IEV
SAALRASSL	SAALRASSL
MSLPYRLVF	MSLPYRLVF
YAFLRREYY	YAFLRREYY
KMYEEHLKRM	KMYEEHLKR
WSSTSPHRPR	SSTSPHRPR
LAALAKAPF	LAALAKAPF
STVLTSKY	STVLT-SKY
RACSRVRVV	RACSRVRVV
VGAETKTLPS	VGAET-KTL
QATTAYFLY	QATTAYFLY
KSSERTAAF	KSSERTAAF
QGSFQGGFR	QGSFQGGFR
QATELVHQL	QATELVHQL
KSAVGHEY	KSAVG-HEY
ISNPTRHVY	ISNPTRHVY
TTTTEHRFF	TTTTEHRFF
TGGFVLLY	TGGFV-LLY
VANPEHMEM	VANPEHMEM
VARVWSLMRF	VARVW-SLM
SATWPKEV	SATWP-KEV
NAQKEIATL	NAQKEIATL
AATEREISL	AATEREISL
ITTPGVRFY	ITTPGVRFY
FFKERVMEI	FFKERVMEI
YAQERKQL	YAQER-KQL
RSYWKEVLL	RSYWKEVLL
VANDYARQL	VANDYARQL
HAPIRSSL	HAPIR-SSL
FSQPGLRSL	FSQPGLRSL
ITSSAKVDM	ITSSAKVDM
VTGVHRLY	VTGVH-RLY
TATQLLKLA	TATQLLKLA
VASFPRTVL	VASFPRTVL
ISSVRAVAV	ISSVRAVAV
AARSGPLAM	AARSGPLAM
VAREWFFLI	VAREWFFLI
AAATRTTSF	AAATRTTSF
AAAFHPEEY	AAAFHPEEY
YNFVRDVL	YNFVR-DVL
ITQGIPRSY	ITQGIPRSY
NVKVDPEIQ	NVKVDPEIQ
LSGNHIAY	LSGNH-IAY
FTGYRIEL	FTGYR-IEL
RITAVRRVY	RITAVRRVY
YQADIERMY	YQADIERMY
YAVQRNYGF	YAVQRNYGF
NAHNRLEL	NAHNR-LEL
VSRAHQLVM	VSRAHQLVM
YSVNKEQL	YSVNK-EQL
FLIEPFVPH	FLIEPFVPH
LSKDSILSL	LSKDSILSL
FSTDSPRLL	FSTDSPRLL
VASETGHVY	VASETGHVY
AATDVRRVW	AATDVRRVW
YIAPWSGRFY	IAPWSGRFY
SAAPVAHLL	SAAPVAHLL
KAVNPGRSL	KAVNPGRSL
FAQDVGRM	FAQDV-GRM
YSSDFRQIF	YSSDFRQIF
LSSNAIREV	LSSNAIREV
KAIMALVAAI	KAIMALVAA
AFHDNEETFLK	AFHDNEETF
SSAFAAFVK	SSAFAAFVK
YSSPYPQEY	YSSPYPQEY
VAVHYYRLY	VAVHYYRLY
FTVFVQVL	FTVFV-QVL
IAVEPVKTY	IAVEPVKTY
AADWHNLIL	AADWHNLIL
VATSRIIKY	VATSRIIKY
FFSEREASF	FFSEREASF
FISSTFRDM	FISSTFRDM
FSTTKPLF	FSTTK-PLF
LIVEPSREL	LIVEPSREL
FAAVKLFL	FAAVK-LFL
LATNFLLEM	LATNFLLEM
ATTDWIAIY	ATTDWIAIY
YAITTLHNL	YAITTLHNL
VAKINREV	VAKIN-REV
TAANVYHLL	TAANVYHLL
TAISCSRVF	TAISCSRVF
VSSDGREVL	VSSDGREVL
KSIHHARVL	KSIHHARVL
YAISKPEVL	YAISKPEVL
FASNHIQL	FASNH-IQL
LSSLRSVSL	LSSLRSVSL
TITDQIRLW	TITDQIRLW
VAQTWFRFL	VAQTWFRFL
LPLAGIRSAL	LAGIR-SAL
AAREFSHML	AAREFSHML
ISLLLNIL	ISLLL-NIL
YATHRDSY	YATHR-DSY
KSTDVAKTF	KSTDVAKTF
FGEVRPYFY	FGEVRPYFY
FAQERQML	FAQER-QML
HIARKAVEL	HIARKAVEL
YAQKVRQQF	YAQKVRQQF
VFKERIGY	VFKER-IGY
RAIDSIHQL	RAIDSIHQL
FAVDPRFL	FAVDP-RFL
FVTFYTRKA	FVTFYTRKA
FSRLYLNVL	FSRLYLNVL
FGTEHVLRI	FGTEHVLRI
NAAIREKL	NAAIR-EKL
SASYKPVF	SASYK-PVF
AAAQGRLL	AAAQG-RLL
FQTVTDYGK	FQTVTDYGK
RTTFFHHEY	RTTFFHHEY
TWYPEVPK	TWYPE-VPK
NSTERISF	NSTER-ISF
VASSRSSVL	VASSRSSVL
ETFQRPYQY	ETFQRPYQY
SAAYIPAHTY	AAYIPAHTY
FSKAGRVY	FSKAG-RVY
LSVIQLWHY	LSVIQLWHY
FAVIAHVGM	FAVIAHVGM
TSTTRPVL	TSTTR-PVL
KQINDYVEK	KQINDYVEK
HAKSSVAL	HAKSS-VAL
FAHPPLLVL	FAHPPLLVL
YTDLEVRV	YTDLE-VRV
KALTLSNL	KALTL-SNL
FTAERSSYY	FTAERSSYY
VATQVGIEW	VATQVGIEW
INTDLSRIL	INTDLSRIL
FASLRSAY	FASLR-SAY
FTATRPGVYY	FTATRPGVY
GQWLRRVSY	GQWLRRVSY
NAVEGLRTL	NAVEGLRTL
RIYQYIQSRF	RIYQYIQSR
LAYLRTECY	LAYLRTECY
YALERMGVTY	YALERMVTY
LANERLMTL	LANERLMTL
LSKFYELEL	LSKFYELEL
QSGLYFIKPLK	SGLYFIKPL
SATYIAEEY	SATYIAEEY
RLNAPLSQM	RLNAPLSQM
FSMYKPITY	FSMYKPITY
YATKHLRVLL	YATKHLRVL
FGSAAPPRQF	SAAPP-RQF
VSAPPMPSV	VSAPPMPSV
KTDVVVNSV	KTDVVVNSV
LATETVRSI	LATETVRSI
KINEAFIEM	KINEAFIEM
VATPLNRKM	VATPLNRKM
VVIDPYLVY	VVIDPYLVY
GASAVVHTM	GASAVVHTM
RAAQGRAF	RAAQG-RAF
VTVSGQRVF	VTVSGQRVF
NAHTQKYPM	NAHTQKYPM
MFLIRDWSY	MFLIRDWSY
AAALRNLM	AAALR-NLM
YAFPKEFPY	YAFPKEFPY
LATRILHLL	LATRILHLL
YASQKNVSL	YASQKNVSL
FSINGHFY	FSING-HFY
KSDERLTAF	KSDERLTAF
YAAIPREM	YAAIP-REM
SASNRLSV	SASNR-LSV
ITNKYQLVF	ITNKYQLVF
FKDLGEEHFK	FKDLGEEHF
GGLPERSVSL	GLPERSVSL
TSSTRFLVF	TSSTRFLVF
YANPFWLAL	YANPFWLAL
FTAHPRVL	FTAHP-RVL
AAGVHFIY	AAGVH-FIY
VASEPRKL	VASEP-RKL
SATYRILEV	SATYRILEV
VSLVRKEL	VSLVR-KEL
VTAGVRLAM	VTAGVRLAM
ESYLRRVVY	ESYLRRVVY
STALRLTAF	STALRLTAF
LALLRELSL	LALLRELSL
AALLRTFSF	AALLRTFSF
ILYEFPRVF	ILYEFPRVF
KTTQVTQFI	KTTQVTQFI
VAGDKPRTF	VAGDKPRTF
FMMMRAENF	FMMMRAENF
SAFPFPVTV	SAFPFPVTV
NATKTFREF	NATKTFREF
ITSSAKVDMTF	SSAKVDMTF
FAQAQQQL	FAQAQ-QQL
KATPLSSTV	KATPLSSTV
YAQVKQKM	YAQVK-QKM
HSSRQGVF	HSSRQ-GVF
VAQGGGRAL	VAQGGGRAL
YVTSLLKMY	YVTSLLKMY
TVLKQVQEL	TVLKQVQEL
AASALIRTL	AASALIRTL
VGYVSGWGR	VGYVSGWGR
AAVWPYRRL	AAVWPYRRL
VATPHARIIEL	VATPHARII
FAAEFSNVM	FAAEFSNVM
FAAFFSHIL	FAAFFSHIL
YVQDFHPRL	YVQDFHPRL
QMAFQILL	QMAFQ-ILL
AASPKSFTL	AASPKSFTL
GARWYSMEM	GARWYSMEM
AAALSGGLL	AAALSGGLL
SAMSNPRAM	SAMSNPRAM
YALYQIKEM	YALYQIKEM
YALNHTLSV	YALNHTLSV
YAANPGQLF	YAANPGQLF
YAAEFHARFV	YAAEFHARF
KASALLRLY	KASALLRLY
LSTLVRPVF	LSTLVRPVF
TSSIHFEAY	TSSIHFEAY
NSYLRDQWF	NSYLRDQWF
IAAEREREL	IAAEREREL
YAAQRIISL	YAAQRIISL
FAKTKEEV	FAKTK-EEV
FAKPFLASL	FAKPFLASL
LAAAMVRVL	LAAAMVRVL
ESTVRTIAM	ESTVRTIAM
FAISILQQL	FAISILQQL
LSMLRAAL	LSMLR-AAL
ITSSPHPEY	ITSSPHPEY
NMTVRFFSF	NMTVRFFSF
ASYLRLWAL	ASYLRLWAL
YASPVVAFY	YASPVVAFY
YLRPPNTSL	YLRPPNTSL
YAYDGKDYIAL	YAYDG-KDY
YFLQRHEL	YFLQR-HEL
YSYVTEEL	YSYVT-EEL
VATIKSVSF	VATIKSVSF
SSQEEVRSY	SSQEEVRSY
HSIVQKTAM	HSIVQKTAM
LTAQPRLM	LTAQP-RLM
TGLQEVEVK	TGLQEVEVK
ITNIRPSF	ITNIR-PSF
AVTDALVWVI	AVTDA-LVW
FTADFVRQL	FTADFVRQL
FADGHVLEL	FADGHVLEL
ITQVLHFTK	ITQVLHFTK
AAALRVEL	AAALR-VEL
SALEVVRKY	SALEVVRKY
AASWTSRQV	AASWTSRQV
KAMESQRAY	KAMESQRAY
YTRPGLPTL	YTRPGLPTL
SAADPQIRQF	AADPQIRQF
YTFPFQQL	YTFPF-QQL
YASLHGRIY	YASLHGRIY
FAHWGQEL	FAHWG-QEL
IAVGYVDDTQF	VGYVDDTQF
QVVAGLNFR	QVVAGLNFR
AARDFVNYL	AARDFVNYL
YGYNQRPPY	YGYNQRPPY
AAMAKAFSTL	AAMAKASTL
WAAPIRKLY	WAAPIRKLY
ISNPNSIIL	ISNPNSIIL
KSEKRHLQV	KSEKRHLQV
NANNRLLL	NANNR-LLL
ALFFRFVDF	ALFFRFVDF
YGMPRQIL	YGMPR-QIL
HTTSYLHEV	HTTSYLHEV
VASDEIAQHAL	ASDEIAHAL
LTADAREL	LTADA-REL
AAAYPHTSL	AAAYPHTSL
SSEAHREV	SSEAH-REV
FATPVFITK	FATPVFITK
YSQERVNCF	YSQERVNCF
ISAEGKTM	ISAEG-KTM
TFTNHMVF	TFTNH-MVF
YLGEEYVK	YLGEE-YVK
RSLDDALKL	RSLDDALKL
KQIEDLNMTL	QIEDLNMTL
VALDFEQEM	VALDFEQEM
ASFNRMVM	ASFNR-MVM
KALNRFEKL	KALNRFEKL
FSSPHLQML	FSSPHLQML
NAESGRGQVM	AESGRGQVM
LAQDIFKEL	LAQDIFKEL
SIVENIRIY	SIVENIRIY
YANKYNIML	YANKYNIML
KASGTLREY	KASGTLREY
YAPYPSPVL	YAPYPSPVL
FTAQPKPAT	FTAQPKPAT
YAANLKNVM	YAANLKNVM
RSYSDPPLKF	YSDPP-LKF
ISKQFHHQL	ISKQFHHQL
ASKAWTLEV	ASKAWTLEV
SANDIYLIF	SANDIYLIF
FTLGNVVGM	FTLGNVVGM
VSLLRLYQY	VSLLRLYQY
KTAGKRYVY	KTAGKRYVY
ATDTIRKM	ATDTI-RKM
YARLHPRAV	YARLHPRAV
YSAADRSMM	YSAADRSMM
YGQWKNETY	YGQWKNETY
RATIGRYF	RATIG-RYF
YSMPSTHAM	YSMPSTHAM
VFFVHEGY	VFFVH-EGY
FASDRISL	FASDR-ISL
AKPALEDLR	AKPALEDLR
YAFVRPVIL	YAFVRPVIL
FLTDAKRPAL	LTDAKRPAL
ATDPTIHTV	ATDPTIHTV
VFGIRYDDY	VFGIRYDDY
HLVDEPQNLIK	HLVDEPQNL
FAQNKPTGF	FAQNKPTGF
LSTMFRVEY	LSTMFRVEY
FFGIRDSSF	FFGIRDSSF
KATILCTSY	KATILCTSY
QANIRLTSL	QANIRLTSL
TAMTVQILL	TAMTVQILL
FSDGLAHL	FSDGL-AHL
TAAKPKRSF	TAAKPKRSF
AASTAIYVY	AASTAIYVY
RLDGSVDFK	RLDGSVDFK
QTVFDQPQEY	TVFDQPQEY
AAIDWFDGKEF	AAIDWFDGK
FSVTGRVL	FSVTG-RVL
VASMRLAY	VASMR-LAY
LSLLGHVY	LSLLG-HVY
FALLPRLEY	FALLPRLEY
RASPFLLQY	RASPFLLQY
VAVLRAYNY	VAVLRAYNY
ASLLRVEPF	ASLLRVEPF
SATKYSRRL	SATKYSRRL
VTSPIRASY	VTSPIRASY
YTSSEIRVF	YTSSEIRVF
YALELLTVY	YALELLTVY
PATTVVRTL	PATTVVRTL
KIINAFRYY	KIINAFRYY
ASAVRNSL	ASAVR-NSL
FSSSRTATL	FSSSRTATL
NATVGRRY	NATVG-RRY
TTTGVHNLY	TTTGVHNLY
LATAVVQLY	LATAVVQLY
ATYFQGVRL	ATYFQGVRL
YAKDDPLEF	YAKDDPLEF
YAKIVEIPF	YAKIVEIPF
VVSPPKFVF	VVSPPKFVF
FASTMVHAL	FASTMVHAL
VAKAVTQAL	VAKAVTQAL
YAKLFADAV	YAKLFADAV
LSFQEVREY	LSFQEVREY
FSSDRTITEY	FSSDRTTEY
QTAPLRAEL	QTAPLRAEL
IANTLYRIF	IANTLYRIF
LIVTQTMK	LIVTQ-TMK
FSRSDMHCL	FSRSDMHCL
FSAYNYRTY	FSAYNYRTY
WFYIASAFR	WFYIASAFR
IQNILTEEPK	NILTE-EPK
LLETALTRV	LLETALTRV
IIPFLEPL	IIPFL-EPL
FLYPFFGVL	FLYPFFGVL
MAKMRLLTF	MAKMRLLTF
YLKPYFLEA	YLKPYFLEA
KSAEAIQL	KSAEA-IQL
AASVRPVL	AASVR-PVL
SSHVERVF	SSHVE-RVF
IAAVIARFY	IAAVIARFY
MATSHSWEM	MATSHSWEM
ISQVFEIAL	ISQVFEIAL
YAFLREAL	YAFLR-EAL
GANPAARMY	GANPAARMY
FIAPNKYEY	FIAPNKYEY
TGYLKGYTL	TGYLKGYTL
VSTPQRPPL	VSTPQRPPL
IDALNENK	IDALN-ENK
ATGVLYDYVNK	ATGVL-YDY
FARPASPSL	FARPASPSL
TEVIPPLIENR	VIPPLIENR
ITDGQIFL	ITDGQ-IFL
VAISPWKTY	VAISPWKTY
LAVNLTRVL	LAVNLTRVL
YAKLHPEM	YAKLH-PEM
QAMPPLFSL	QAMPPLFSL
SAIDFYRKF	SAIDFYRKF
VSLLRVLEM	VSLLRVLEM
QAAPVKWIF	QAAPVKWIF
SSFDLLPREF	SSFDLLREF
FSALITRIF	FSALITRIF
RSSPYLRQL	RSSPYLRQL
YAGLKLVEY	YAGLKLVEY
IAHLRQIL	IAHLR-QIL
HAASVFLTL	HAASVFLTL
SVTGVHRLY	SVTGVHRLY
SAAPPLPSL	SAAPPLPSL
SAIQNRFKY	SAIQNRFKY
ILMDPSPEY	ILMDPSPEY
AAAVDIRTW	AAAVDIRTW
SAALPRIL	SAALP-RIL
RAALRSCSL	RAALRSCSL
FSLAPYRDY	FSLAPYRDY
NALVHLIEI	NALVHLIEI
TATPVVQCM	TATPVVQCM
SAGMRLVL	SAGMR-LVL
FTLGNVVGMY	FTLGNVVGM
KIYEGAARKL	KIYEGARKL
TFALRYLNF	TFALRYLNF
YASTEMSLHAL	ASTEMSHAL
TAVMPKVSL	TAVMPKVSL
RTTKCVRQY	RTTKCVRQY
QAIETARAW	QAIETARAW
FASGLIHRV	FASGLIHRV
NYTDNELEK	NYTDNELEK
RAVGTVKVY	RAVGTVKVY
LSMPLGARDL	LSMPLGRDL
KSLKIIYI	KSLKI-IYI
HALERLFTM	HALERLFTM
VAYWRQAGL	VAYWRQAGL
AAFTRALEY	AAFTRALEY
SASEITRAF	SASEITRAF
NSTYIMRVL	NSTYIMRVL
FAVDSLRQL	FAVDSLRQL
VAQPVPLLM	VAQPVPLLM
VAVNKPAEF	VAVNKPAEF
IATGILHLL	IATGILHLL
ASGQRPVF	ASGQR-PVF
SAIASTKVM	SAIASTKVM
MAPSETQFSHL	MAPSE-TQF
AAAAQIRY	AAAAQ-IRY
GSYQRGYEY	GSYQRGYEY
RTAGPHTQF	RTAGPHTQF
DYSVVLLLR	DYSVVLLLR
YSTVRTKVY	YSTVRTKVY
FASLVSQDY	FASLVSQDY
GYAILRVSL	GYAILRVSL
AASQHVFRFY	AASQHVRFY
SAYIKKIGY	SAYIKKIGY
LSRPNIFIL	LSRPNIFIL
VAAQRLVL	VAAQR-LVL
ASIDQRLTF	ASIDQRLTF
TASRVIREL	TASRVIREL
ITAPTVRQY	ITAPTVRQY
AAGIKLIFF	AAGIKLIFF
KAFDQRLTF	KAFDQRLTF
SAGLRVLAL	SAGLRVLAL
LSITGTYDLK	LSITGTYDL
MTALQNTAL	MTALQNTAL
IASLIPTPR	IASLIPTPR
TSWIHPVM	TSWIH-PVM
ATAVVRHM	ATAVV-RHM
LSSLRPSL	LSSLR-PSL
FATKVVHLL	FATKVVHLL
LSIFEENLF	LSIFEENLF
SSGTRVVL	SSGTR-VVL
FSPFHASVL	FSPFHASVL
TAGKRYVY	TAGKR-YVY
TASNPKPYM	TASNPKPYM
FATESSHFY	FATESSHFY
MAFYVVKMY	MAFYVVKMY
RSHYSPIYL	RSHYSPIYL
ITRPFPFLM	ITRPFPFLM
AATPRTSQF	AATPRTSQF
IALLNNIPY	IALLNNIPY
FATGPRQY	FATGP-RQY
TTRDYYFAL	TTRDYYFAL
TQAVRAVAF	TQAVRAVAF
KSAIKTVGL	KSAIKTVGL
FSAFLEKEY	FSAFLEKEY
FAFEHSEEY	FAFEHSEEY
DAHKGVAL	DAHKG-VAL
KAHLGTAL	KAHLG-TAL
FATFKMQY	FATFK-MQY
YTAEKLKEM	YTAEKLKEM
KSKSITNL	KSKSI-TNL
YSEVHPHY	YSEVH-PHY
TAADKRLTV	TAADKRLTV
QGIPFFGQVR	QGIPFFGQV
FIRDPLTL	FIRDP-LTL
SAPGYLPTSL	SAPGYLTSL
RSLAVLAPL	RSLAVLAPL
VSSTWLRDF	VSSTWLRDF
YAKSQPDM	YAKSQ-PDM
RAGDNERVY	RAGDNERVY
ESAINWISY	ESAINWISY
FAASFAHLL	FAASFAHLL
LDGSVDFK	LDGSV-DFK
KSQVHPVL	KSQVH-PVL
VAMEKNYTL	VAMEKNYTL
KAYFDVKEY	KAYFDVKEY
TFFQRAVYL	TFFQRAVYL
LSQERIIQF	LSQERIIQF
SFFVRGQEF	SFFVRGQEF
FASETNLDF	FASETNLDF
FTVVRVINF	FTVVRVINF
SSTVRTVSL	SSTVRTVSL
HASTLHRLY	HASTLHRLY
GEKVVEIVKK	KVVEI-VKK
SAFPEVRSL	SAFPEVRSL
FSSLRAMF	FSSLR-AMF
FASFKPTYL	FASFKPTYL
RAWTRLYAM	RAWTRLYAM
AAMSHLLEM	AAMSHLLEM
DGAGDVAFVK	GAGDVAFVK
KARNYLLSL	KARNYLLSL
YVSDITRTW	YVSDITRTW
YAIDSVLEV	YAIDSVLEV
FAGFQRKAV	FAGFQRKAV
GLPAPIEK	GLPAP-IEK
KLSEIVREF	KLSEIVREF
LASLKTDTF	LASLKTDTF
YFFKRTQYF	YFFKRTQYF
LSSPVTKSF	LSSPVTKSF
FSHNRAHF	FSHNR-AHF
YAQERDAF	YAQER-DAF
YTLFGRSY	YTLFG-RSY
AARSSIRVV	AARSSIRVV
SASLPRSY	SASLP-RSY
FASQPRLV	FASQP-RLV
YAALHGEF	YAALH-GEF
KSFFRRLSF	KSFFRRLSF
LASSYERKL	LASSYERKL
FGADARAL	FGADA-RAL
YATQLQKTY	YATQLQKTY
FSDVLPVL	FSDVL-PVL
LSAPLHPEF	LSAPLHPEF
TAISLFYEL	TAISLFYEL
VTIYRHQEY	VTIYRHQEY
NATAFFRQH	NATAFFRQH
SATEAERVY	SATEAERVY
FSSWVQLEV	FSSWVQLEV
YSFHKFHYL	YSFHKFHYL
FAQMYQKTL	FAQMYQKTL
FSYAFPKAV	FSYAFPKAV
AASPFYRGY	AASPFYRGY
AATTVLRQL	AATTVLRQL
RGKDYFLTI	RGKDYFLTI
IAATRAQL	IAATR-AQL
LAVDRLSLA	LAVDRLSLA
YSNGFCTVY	YSNGFCTVY
AAFNIIEV	AAFNI-IEV
ISSEAHREV	ISSEAHREV
LAFLRHLTL	LAFLRHLTL
FVYLRQPYY	FVYLRQPYY
RRGDFIHVM	RRGDFIHVM
ITNNRTFAF	ITNNRTFAF
AAAVRITL	AAAVR-ITL
YASTKESY	YASTK-ESY
LARIYSYQM	LARIYSYQM
MSAGPRYEY	MSAGPRYEY
LTGTIATPPV	TGTIATPPV
FASNLPTL	FASNL-PTL
ISQLRSEL	ISQLR-SEL
IAMGMAQAL	IAMGMAQAL
FTVNPKGEL	FTVNPKGEL
NSSEKLQFY	NSSEKLQFY
YTSGTFRTV	YTSGTFRTV
KATNVVRLL	KATNVVRLL
HIPDHLRPEY	HIPDHLPEY
SKEQLTPLIKK	KEQLTPLIK
YATEKLRMI	YATEKLRMI
YSNLHEQTL	YSNLHEQTL
ISAVRPVI	ISAVR-PVI
FTGKQGEM	FTGKQ-GEM
RATWKSNYF	RATWKSNYF
FSDTGNFGF	FSDTGNFGF
AARDVFLM	AARDV-FLM
YAYTGRLEL	YAYTGRLEL
NAKAALLEL	NAKAALLEL
IFGEILPQAL	FGEILPQAL
YFAERVTSL	YFAERVTSL
FAMYPPSMI	FAMYPPSMI
MYSIITPN	MYSII-TPN
KTAPKGVWV	KTAPKGVWV
TSSPPRLAM	TSSPPRLAM
FAHHKNQTL	FAHHKNQTL
IATSNKPAV	IATSNKPAV
RANERLEL	RANER-LEL
YSATRAAL	YSATR-AAL
FNITRIVTF	FNITRIVTF
LVNEVTEFAK	LVNEV-TEF
YAKRPGIGL	YAKRPGIGL
AAMDEIPVL	AAMDEIPVL
FVAEPDNKNVY	VAEPDNKNV
VAGLQPVL	VAGLQ-PVL
AARPVLLQV	AARPVLLQV
VARPLFLEF	VARPLFLEF
LAKNFFNEL	LAKNFFNEL
KWLLRLEEY	KWLLRLEEY
FATLVSDRFL	FATLVSRFL
VASVAKESIPL	VASVAKESI
YAVDAYFREA	YAVDAYREA
FTVPHTHVF	FTVPHTHVF
SANDAGRLL	SANDAGRLL
FARPDLLLL	FARPDLLLL
RAIIRENEF	RAIIRENEF
QATIYVHKV	QATIYVHKV
RSFGTGTHV	RSFGTGTHV
GAWSIPWKWL	AWSIPWKWL
VASKKEVF	VASKK-EVF
LAKDGVLTL	LAKDGVLTL
GATNVGSIRIY	ATNVGSRIY
FSPTGEIL	FSPTG-EIL
SVTISFRIY	SVTISFRIY
HSHIRGLGL	HSHIRGLGL
YAKMIFMEL	YAKMIFMEL
TAAFWTRLY	TAAFWTRLY
SAVDGQRQV	SAVDGQRQV
FARKHHITL	FARKHHITL
RGTDFVRTL	RGTDFVRTL
AATIRLIF	AATIR-LIF
YAIPQPDL	YAIPQ-PDL
GTTDVTRTM	GTTDVTRTM
YAASFINLL	YAASFINLL
AATAVTQAL	AATAVTQAL
FALQREQEL	FALQREQEL
SAYQRYYSL	SAYQRYYSL
AALERQAL	AALER-QAL
SSMARIHSM	SSMARIHSM
FTDEESRVF	FTDEESRVF
VASIKTGF	VASIK-TGF
FATLQNEL	FATLQ-NEL
FSKDSSQIL	FSKDSSQIL
VFQYRLVEY	VFQYRLVEY
HSVTRGLAY	HSVTRGLAY
KSTIKFQM	KSTIK-FQM
TAVPPSRQY	TAVPPSRQY
IANVGSREM	IANVGSREM
ANVVRNISY	ANVVRNISY
RTKDTPLSL	RTKDTPLSL
FLGPLHPSF	FLGPLHPSF
MTMEYKQEL	MTMEYKQEL
FAKPVYPGQTL	FAKPVYQTL
RTALPRIF	RTALP-RIF
MSVGDPRTF	MSVGDPRTF
KTSDFLKVL	KTSDFLKVL
VATWMLEV	VATWM-LEV
FANKQLEL	FANKQ-LEL
VSTPFHEIM	VSTPFHEIM
YALERLKVM	YALERLKVM
NALGHVRYV	NALGHVRYV
IVNENLVERF	IVNENLVER
FARELANQL	FARELANQL
NASPVISSV	NASPVISSV
MASIKKDYY	MASIKKDYY
LAAQGARVY	LAAQGARVY
VATSPGRLF	VATSPGRLF
YAKEAQQSL	YAKEAQQSL
AANVIPVL	AANVI-PVL
FSHGTHEY	FSHGT-HEY
VASNVPKVV	VASNVPKVV
KAFARPWSL	KAFARPWSL
TSAVREEL	TSAVR-EEL
LSAIQSEV	LSAIQ-SEV
ASLRKVSM	ASLRK-VSM
YANSKAVTL	YANSKAVTL
AAVARAVTL	AAVARAVTL
YAIIKFPL	YAIIK-FPL
SVPLAATSM	SVPLAATSM
YTTDRVMTV	YTTDRVMTV
FTITKTVEY	FTITKTVEY
VASGRLHL	VASGR-LHL
HATEELKEF	HATEELKEF
VSSDTCRSL	VSSDTCRSL
SSTSHVPEV	SSTSHVPEV
KAIEKNVL	KAIEK-NVL
RSSPVEYEF	RSSPVEYEF
KAVDQPRQL	KAVDQPRQL
YSAEPLPEL	YSAEPLPEL
TAAETHYTY	TAAETHYTY
FVTFTTRAM	FVTFTTRAM
MATPYMNHY	MATPYMNHY
YSTKLYRFF	YSTKLYRFF
QSRPFFNEL	QSRPFFNEL
FSMVGLYY	FSMVG-LYY
FAKVHILYV	FAKVHILYV
RSTDSIRLL	RSTDSIRLL
AAFAYTVKY	AAFAYTVKY
LASYIHYVF	LASYIHYVF
KSGNRIVM	KSGNR-IVM
SAKTPGFSV	SAKTPGFSV
ISSNSHRSL	ISSNSHRSL
TTTTTEHRFF	TTTEH-RFF
QATTLVHQI	QATTLVHQI
MARDASLTL	MARDASLTL
AAKDYNQKL	AAKDYNQKL
SAIDRIFTL	SAIDRIFTL
SAGHRDVFY	SAGHRDVFY
AGFQRVQAL	AGFQRVQAL
KASPLRLSF	KASPLRLSF
SAAERDKAL	SAAERDKAL
IATSHNIVY	IATSHNIVY
FTAERSSY	FTAER-SSY
VLAIRYDAF	VLAIRYDAF
VTSDGRYVF	VTSDGRYVF
ISVEGREF	ISVEG-REF
VAPSRLDF	VAPSR-LDF
KLSSWVLLMK	LSSWV-LLM
TGYIKTEL	TGYIK-TEL
SATRYIKAL	SATRYIKAL
YAAIQENAL	YAAIQENAL
RAKEPILAL	RAKEPILAL
SAVTGARHL	SAVTGARHL
AARDVFLML	AARDVFLML
VFSVRGTSF	VFSVRGTSF
KGLALSQRAL	LALSQ-RAL
NAAEGRSF	NAAEG-RSF
FAMPPPHGM	FAMPPPHGM
KLVNEVTEFAK	LVNEV-TEF
SAMYSRKAM	SAMYSRKAM
FLGERVFPF	FLGERVFPF
QAITRVIPL	QAITRVIPL
FATGVWHQM	FATGVWHQM
LTADARLL	LTADA-RLL
HFYMRKVKF	HFYMRKVKF
KTFARYLSF	KTFARYLSF
KLNEGVVEF	KLNEGVVEF
LLLCVLLL	LLLCV-LLL
TAASARLF	TAASA-RLF
AATSNLKKL	AATSNLKKL
FAIGGIARTY	FAIGGIRTY
TAGQRIDL	TAGQR-IDL
SASSLARAY	SASSLARAY
VAQELEEK	VAQEL-EEK
IASKVKRVV	IASKVKRVV
SAGPMRLY	SAGPM-RLY
KGYTQQLAFR	KGYTQQLAF
SSSAVFLII	SSSAVFLII
AASFRPGL	AASFR-PGL
KAAVLLHLL	KAAVLLHLL
SSQEPRPTL	SSQEPRPTL
AAVGFHKTL	AAVGFHKTL
YAVEGRDLTL	YAVEGRLTL
VAPSKAREY	VAPSKAREY
RSNEHIREL	RSNEHIREL
FANSRDTSF	FANSRDTSF
YSTDSRESF	YSTDSRESF
ITAPPSRVL	ITAPPSRVL
AAFLRHWKL	AAFLRHWKL
KATPIKLIW	KATPIKLIW
SLSQARLLTSF	LSQARLTSF
VTGWGNLK	VTGWG-NLK
SAKPYAHIL	SAKPYAHIL
VATIRKVL	VATIR-KVL
LATTVRPVF	LATTVRPVF
TTTSQAREL	TTTSQAREL
KILTERGYSFT	ILTERGYSF
ASAIRSSTY	ASAIRSSTY
RSALPRPSL	RSALPRPSL
DLATVYVDVLK	LATVYVDVL
RSTDWSSQY	RSTDWSSQY
FALLQAQL	FALLQ-AQL
FSSDVTHEM	FSSDVTHEM
VSVTSVAGL	VSVTSVAGL
YTLINHRVL	YTLINHRVL
ELDESLQVAER	ESLQV-AER
FSNIREEL	FSNIR-EEL
SASSKEPAM	SASSKEPAM
KAYERGISL	KAYERGISL
YSNPIKEEM	YSNPIKEEM
IAMQLPVL	IAMQL-PVL
HAKEYIQQL	HAKEYIQQL
ASTVVTYVY	ASTVVTYVY
FAFTPSRIY	FAFTPSRIY
SGTVLRAML	SGTVLRAML
VAVTRAKAL	VAVTRAKAL
FSQIRKDAL	FSQIRKDAL
YLGYLEQLLR	YLGYLEQLL
VSASLPRSY	VSASLPRSY
ALSPNHRIY	ALSPNHRIY
TAKSGGLSV	TAKSGGLSV
NSDDRVLL	NSDDR-VLL
LSFVRAFEF	LSFVRAFEF
QATPHHGVY	QATPHHGVY
RLATSLVEKL	LATSLVEKL
VSSTWDRQF	VSSTWDRQF
AAASHRVL	AAASH-RVL
VSSHVERVF	VSSHVERVF
MAQEGLREV	MAQEGLREV
LGALRELGF	LGALRELGF
FAVDPRFLAY	FAVDPRLAY
VSSSPREL	VSSSP-REL
SSHQVVPSL	SSHQVVPSL
KYLYEIAR	KYLYE-IAR
NATLWYKIF	NATLWYKIF
AAQEGHLEL	AAQEGHLEL
AAHTHPVY	AAHTH-PVY
AEFVEVTK	AEFVE-VTK
RSVEEPREF	RSVEEPREF
AAVIGDVIRVY	VIGDVIRVY
FSNGHIKVL	FSNGHIKVL
PASLRDVAY	PASLRDVAY
FAIPLIEKL	FAIPLIEKL
FTIIREEF	FTIIR-EEF
FATILVEY	FATIL-VEY
KADGVPVYL	KADGVPVYL
IAVLQAEVY	IAVLQAEVY
AAAFARRVL	AAAFARRVL
KTANPILL	KTANP-ILL
AASLSYRVL	AASLSYRVL
YARQGQIEV	YARQGQIEV
TTTNRDIAF	TTTNRDIAF
TAGLRPIL	TAGLR-PIL
FAGFLPRII	FAGFLPRII
VAAIPRLL	VAAIP-RLL
TFHQRGIAL	TFHQRGIAL
LSFFMARVF	LSFFMARVF
TASPFFRAL	TASPFFRAL
YTMVYWHAL	YTMVYWHAL
RASWIAQVF	RASWIAQVF
VASEAKIQQLM	VASEAKQQL
RSSEYLRAL	RSSEYLRAL
FALNHPEL	FALNH-PEL
YAFPKAVSV	YAFPKAVSV
NLIQSTLAL	NLIQSTLAL
LAGPALEL	LAGPA-LEL
YAATYPRQL	YAATYPRQL
ILHLRQVTF	ILHLRQVTF
NASKHRIY	NASKH-RIY
YAIGVSHPL	YAIGVSHPL
FSSFDPRLF	FSSFDPRLF
YISAKPLEM	YISAKPLEM
NARTYMDVM	NARTYMDVM
SSSQGRSEL	SSSQGRSEL
AANIQPIF	AANIQ-PIF
ALEVDETYVPK	ALEVD-ETY
YAVDRAITH	YAVDRAITH
QLANGVDR	QLANG-VDR
VGSFRQEY	VGSFR-QEY
VARERERVV	VARERERVV
AANIYPLSL	AANIYPLSL
FASRAKLAV	FASRAKLAV
VSMEGHLY	VSMEG-HLY
YSFDSRHKPAF	FDSRHKPAF
VFSFKMVSY	VFSFKMVSY
AANVRELM	AANVR-ELM
VSAYPRQL	VSAYP-RQL
ELGFRPEY	ELGFR-PEY
KAHFRRDEF	KAHFRRDEF
VSATREEL	VSATR-EEL
LSSSRESAF	LSSSRESAF
WFNVRNGY	WFNVR-NGY
QTLDQTLLEL	TLDQTLLEL
LATVLGRF	LATVL-GRF
VTQVRKEL	VTQVR-KEL
NFNTRFVM	NFNTR-FVM
TSFERMLSL	TSFERMLSL
KAAARDVTL	KAAARDVTL
IQSIRMGM	IQSIR-MGM
FTSEPRLI	FTSEP-RLI
IAMQVRKLV	IAMQVRKLV
FASHVSPEV	FASHVSPEV
VVTGVANAL	VVTGVANAL
VSHVRKLVF	VSHVRKLVF
MANPTALLL	MANPTALLL
AASNAKLALFY	AASNAKLAL
VAFDRHLYVF	VAFDRHLYV
FAAKQREL	FAAKQ-REL
SASDVHGNFAF	SASDVHGNF
YITPFIRPVM	YITPFIRPV
FAKATFDAI	FAKATFDAI
YSHPHVRLL	YSHPHVRLL
FTRTFIAV	FTRTF-IAV
NAIDPEVQRV	NAIDPEVQR
FAGLVPRLL	FAGLVPRLL
VFLMIEQNTK	FLMIEQNTK
FSAFEKHQY	FSAFEKHQY
MFHNRHLF	MFHNR-HLF
YSSSRSDLY	YSSSRSDLY
AATFQRASY	AATFQRASY
ASTSRSLAL	ASTSRSLAL
NAIHAILLY	NAIHAILLY
FSTSVVRPF	FSTSVVRPF
FARMTAEEM	FARMTAEEM
VAATRWWQL	VAATRWWQL
AAAYRNAL	AAAYR-NAL
SATPTFLFF	SATPTFLFF
SARDHAISL	SARDHAISL
KATPTTRLW	KATPTTRLW
FSHNGMAL	FSHNG-MAL
AAYLRALSL	AAYLRALSL
IAVDTAGRVL	IAVDTARVL
SAALPRRY	SAALP-RRY
LASELNKQY	LASELNKQY
VAPEEHPVL	VAPEEHPVL
SASSFFKEL	SASSFFKEL
KSKDYIVAL	KSKDYIVAL
FIKEIPPEL	FIKEIPPEL
SIPTKALEL	SIPTKALEL
FGTGFPHML	FGTGFPHML
FTQQQPQEL	FTQQQPQEL
FSSQRSGL	FSSQR-SGL
AAEALGRL	AAEAL-GRL
QDGSVDFGR	QDGSVDFGR
SAHNKDIAL	SAHNKDIAL
LATAAALTY	LATAAALTY
SASLHLPK	SASLH-LPK
YTATERQY	YTATE-RQY
KAALAHPFF	KAALAHPFF
VFFSRGSSF	VFFSRGSSF
SAMVRVISV	SAMVRVISV
YTSDYFISY	YTSDYFISY
AAFVKAVGF	AAFVKAVGF
LAFVKNDSY	LAFVKNDSY
ITSPVHVSF	ITSPVHVSF
HFQIRNVTF	HFQIRNVTF
AALYHGMAL	AALYHGMAL
QSTQRSLAL	QSTQRSLAL
IATIKNISM	IATIKNISM
VSNFKPGVY	VSNFKPGVY
YSSGLVRLY	YSSGLVRLY
NATGRPIAF	NATGRPIAF
YSSKLYRFF	YSSKLYRFF
FALAREVVY	FALAREVVY
FVAESHIILVL	FVAESHIIL
FAAQRGLAV	FAAQRGLAV
IATFWNKAF	IATFWNKAF
FAMIIDKL	FAMII-DKL
RALERREL	RALER-REL
RASPAGPRAY	RASPAGRAY
RALEGLVY	RALEG-LVY
FARALRQEF	FARALRQEF
KMADKVLPQRI	MADKVLPQR
ISVKGRIY	ISVKG-RIY
FSQKGTLTV	FSQKGTLTV
FAQKISRTV	FAQKISRTV
RVTERFVM	RVTER-FVM
KSSDQPLTV	KSSDQPLTV
AAMILNEL	AAMIL-NEL
AAARPKSAF	AAARPKSAF
FAMVHVAY	FAMVH-VAY
RASMDPKRFY	ASMDPKRFY
FATEGLRTL	FATEGLRTL
YSSEKLSY	YSSEK-LSY
KSTAISLFY	KSTAISLFY
AFQERLNSY	AFQERLNSY
YAREGEVM	YAREG-EVM
MATTMIQSK	MATTMIQSK
FFENHPYF	FFENH-PYF
ASSGHYIAY	ASSGHYIAY
NTGQRAVL	NTGQR-AVL
KAHGSPRVY	KAHGSPRVY
FATIRFHDL	FATIRFHDL
FANLPNQVY	FANLPNQVY
IAAIRGFLV	IAAIRGFLV
YGAATFTR	YGAAT-FTR
ITRVGLAL	ITRVG-LAL
TAMDVVYAL	TAMDVVYAL
VSTECGHVF	VSTECGHVF
QATPLLHAL	QATPLLHAL
SSSSLEKSY	SSSSLEKSY
FASEVSNVL	FASEVSNVL
LASNRGTL	LASNR-GTL
EDGGGWWYNR	EDGGG-WWY
FAYLGRLA	FAYLG-RLA
KAQAQPVM	KAQAQ-PVM
FAQDVGRMF	FAQDVGRMF
AAMEFLQEL	AAMEFLQEL
TAAPVPTTL	TAAPVPTTL
FSVLQHVL	FSVLQ-HVL
SAFINLVEF	SAFINLVEF
FAQPAFML	FAQPA-FML
SATGLSKGY	SATGLSKGY
YAQEKGIYY	YAQEKGIYY
VSHPMPTM	VSHPM-PTM
FANDATFEI	FANDATFEI
KASDAFHFF	KASDAFHFF
NATQFIKQL	NATQFIKQL
FALEHLEM	FALEH-LEM
FSATFPKEI	FSATFPKEI
YTRQQVLEL	YTRQQVLEL
FGNYRPFL	FGNYR-PFL
SAAENFLVL	SAAENFLVL
SAAQRLTAL	SAAQRLTAL
WIASHTTEER	IASHTTEER
RFYGRDYEY	RFYGRDYEY
NSANRLFQY	NSANRLFQY
YARQLEMIV	YARQLEMIV
FTVDQIRAI	FTVDQIRAI
TTTSSSRIF	TTTSSSRIF
ASFHRVQAL	ASFHRVQAL
EATDYLRNL	EATDYLRNL
SAMPSRLMM	SAMPSRLMM
HAALRCESL	HAALRCESL
FTAGGAIEF	FTAGGAIEF
FASELSRSL	FASELSRSL
TFMEKLYPY	TFMEKLYPY
SITTDFIPSFR	ITTDFIPSF
MTAPLKLTY	MTAPLKLTY
KANHAELIL	KANHAELIL
FSREEFPTL	FSREEFPTL
NATIRVTNL	NATIRVTNL
FTIGMREAF	FTIGMREAF
AAAHFYFEL	AAAHFYFEL
AAAISHGRVF	AAISHGRVF
RAFVHWYV	RAFVH-WYV
ISYYKPEFY	ISYYKPEFY
VAADFYHRL	VAADFYHRL
AISGFAYEY	AISGFAYEY
AAKTVFEAL	AAKTVFEAL
LFTFRPAL	LFTFR-PAL
IAHLRQLL	IAHLR-QLL
LSFPTTKTY	LSFPTTKTY
FTVPDTREL	FTVPDTREL
KAVSLFLCY	KAVSLFLCY
FFVNRPDSY	FFVNRPDSY
VAVVKGLTY	VAVVKGLTY
YSLNKIHAY	YSLNKIHAY
LTVPFEKHSTL	VPFEKHSTL
LSTEAARVL	LSTEAARVL
SMQVKTVAY	SMQVKTVAY
MFLVRDWSF	MFLVRDWSF
YSKDKMWYL	YSKDKMWYL
NATAVVRHM	NATAVVRHM
GSHSMRYF	GSHSM-RYF
VSHLRLLP	VSHLR-LLP
LTIDNGVF	LTIDN-GVF
SAHAGTYEV	SAHAGTYEV
AISENYRIM	AISENYRIM
KALDGFVM	KALDG-FVM
YSALREIAF	YSALREIAF
FAAEAIAM	FAAEA-IAM
LSMTRPVSI	LSMTRPVSI
ASGQPRPEM	ASGQPRPEM
FAALEKTYY	FAALEKTYY
KASGTIKKF	KASGTIKKF
YAEVGRVL	YAEVG-RVL
FTSDPKPTI	FTSDPKPTI
QGLLPVLESFK	GLLPVLESF
TTNPYVLMV	TTNPYVLMV
TSSSGHPTF	TSSSGHPTF
YSSPFAFFY	YSSPFAFFY
FASGANFEY	FASGANFEY
LQAMPRTEF	LQAMPRTEF
SAASKFLCL	SAASKFLCL
NALLRPRTF	NALLRPRTF
TSGYRPSM	TSGYR-PSM
LAVLRLDSL	LAVLRLDSL
NSSEGKVF	NSSEG-KVF
IAFSRPVKY	IAFSRPVKY
VSTHVSQIF	VSTHVSQIF
SASGPRPTY	SASGPRPTY
NSDTHSSTF	NSDTHSSTF
GSELIQKY	GSELI-QKY
KTTNVNKQL	KTTNVNKQL
LVTEVTKK	LVTEV-TKK
AAAALHPAL	AAAALHPAL
NLMEIVKKL	NLMEIVKKL
FVVTFPRAY	FVVTFPRAY
YSYNQFSTY	YSYNQFSTY
KARLQLVL	KARLQ-LVL
AAMLGLMY	AAMLG-LMY
KAPSKLGL	KAPSK-LGL
FSAPRHGSL	FSAPRHGSL
NATSLQHLL	NATSLQHLL
CASDKILEF	CASDKILEF
KASEKILQV	KASEKILQV
WQEEMELYR	WQEEMELYR
YIYIRGEFY	YIYIRGEFY
LAMVSLEM	LAMVS-LEM
MASLRSLSL	MASLRSLSL
ASIGNAQKL	ASIGNAQKL
YSQEQRQAF	YSQEQRQAF
QAAARLLVF	QAAARLLVF
MAFNRAASF	MAFNRAASF
FYNQVSTPLLR	YNQVSTPLL
ATKLERVF	ATKLE-RVF
FFFSRLEY	FFFSR-LEY
VSTDPRPASY	VSTDPRASY
YFGLRTEEM	YFGLRTEEM
LAIPQLPSL	LAIPQLPSL
STSKWNHLL	STSKWNHLL
KLTELLRYY	KLTELLRYY
INHERNEL	INHER-NEL
TITQVIKVL	TITQVIKVL
ISPKVKMAL	ISPKVKMAL
YIIDTTGKL	YIIDTTGKL
VSPVVRVAV	VSPVVRVAV
VSNVRPKM	VSNVR-PKM
TIIPKVLAM	TIIPKVLAM
FNWYVDGVEVH	NWYVDGVEV
VALEHFVL	VALEH-FVL
FARNAFTVL	FARNAFTVL
KTHLYTLIL	KTHLYTLIL
SMAARVPI	SMAAR-VPI
AASMRALVL	AASMRALVL
AAAFGRIAF	AAAFGRIAF
FSSLHTVF	FSSLH-TVF
AASPVVAEY	AASPVVAEY
SAVTSVRIL	SAVTSVRIL
FSHWTYEY	FSHWT-YEY
FFAPSRDMY	FFAPSRDMY
AAVSRIVAL	AAVSRIVAL
DLGEEHFK	DLGEE-HFK
SAAGHLKVV	SAAGHLKVV
SASAIRKLM	SASAIRKLM
FVTYVVREH	FVTYVVREH
FANTRLQSV	FANTRLQSV
AAQLRAQAL	AAQLRAQAL
KAIAEIKKM	KAIAEIKKM
AANTQQTL	AANTQ-QTL
VFSHRLSVY	VFSHRLSVY
CAAGHRAEL	CAAGHRAEL
KAFPASAAL	KAFPASAAL
FAQDGQHQVL	FAQDGQHQV
QAMGNPRSV	QAMGNPRSV
FSFQRPLL	FSFQR-PLL
FSSLKLNVY	FSSLKLNVY
AASYVRKVI	AASYVRKVI
IAISRTPVL	IAISRTPVL
LLHERIVQY	LLHERIVQY
AALFKAWAL	AALFKAWAL
LASFREMVY	LASFREMVY
ALRPPLPPL	ALRPPLPPL
RSSYVARQY	RSSYVARQY
FTNPWTKEL	FTNPWTKEL
VANPNSAIF	VANPNSAIF
RAKNWVKEL	RAKNWVKEL
HASENNRIF	HASENNRIF
IALEHPML	IALEH-PML
ISTNRENF	ISTNR-ENF
FTHPHLEL	FTHPH-LEL
ISSQPRNDF	ISSQPRNDF
LSRSRNITY	LSRSRNITY
NASIGKTL	NASIG-KTL
SQAPQRLSF	SQAPQRLSF
NATVRTAM	NATVR-TAM
AVDAALKK	AVDAA-LKK
IAREWFFLL	IAREWFFLL
LQIGVIRVY	LQIGVIRVY
FAVISRHSL	FAVISRHSL
IALGHLVM	IALGH-LVM
VATFFAKML	VATFFAKML
QATISFPK	QATIS-FPK
LSSIRHMI	LSSIR-HMI
SNTIRSLSF	SNTIRSLSF
LSVEIYDRREY	EIYDR-REY
YSAVRNDQF	YSAVRNDQF
NANVQTVAM	NANVQTVAM
LSYSRISL	LSYSR-ISL
AAAGRAYSF	AAAGRAYSF
LSQSYVKMY	LSQSYVKMY
LAQRGARVY	LAQRGARVY
LAIDAIHQL	LAIDAIHQL
FTSSRHTVV	FTSSRHTVV
KASDKATIM	KASDKATIM
GIPTHHPRVY	IPTHHPRVY
MTAEERSQF	MTAEERSQF
YAAYPLTEV	YAAYPLTEV
VASDFYLRYY	VASDFYLRY
VAAEEARNY	VAAEEARNY
IANTARAY	IANTA-RAY
NATIMVVSV	NATIMVVSV
LAAEVHRVL	LAAEVHRVL
YLYLRGLVY	YLYLRGLVY
TAVENMPSL	TAVENMPSL
AAKDPSPSV	AAKDPSPSV
PINGNGKQ	PINGN-GKQ
AAKTLILCL	AAKTLILCL
VTVEGKVY	VTVEG-KVY
VSVAERVAF	VSVAERVAF
RSILREFAF	RSILREFAF
STMLRLYEF	STMLRLYEF
VSVDTARTL	VSVDTARTL
VSGRILVV	VSGRI-LVV
STSDVVRQY	STSDVVRQY
RQLNGTYAI	RQLNGTYAI
FSSQRPVV	FSSQR-PVV
LASHYIHIV	LASHYIHIV
STGSWSTLK	STGSWSTLK
YSKEGWEY	YSKEG-WEY
HSTNKFEM	HSTNK-FEM
VASMTVREL	VASMTVREL
SAQKHVLHV	SAQKHVLHV
SMIFRKEPF	SMIFRKEPF
VSTSYIKVW	VSTSYIKVW
YTRYQTLEL	YTRYQTLEL
ISLVGFVL	ISLVG-FVL
FSEPHARFY	FSEPHARFY
SAGEPRVL	SAGEP-RVL
AAAIKALEL	AAAIKALEL
EATSFIKQI	EATSFIKQI
FAMVKGYFF	FAMVKGYFF
HAIKSVKIY	HAIKSVKIY
LAVGLSRIF	LAVGLSRIF
SANRHSLMV	SANRHSLMV
LGAPAKPPL	LGAPAKPPL
AVSPIAKYY	AVSPIAKYY
AIGYLNTGYQR	AIGYLNTGY
SQNPRVAAW	SQNPRVAAW
AAAPERVVL	AAAPERVVL
FAFVTDNTY	FAFVTDNTY
ISTNTLRIL	ISTNTLRIL
ASTPVAREL	ASTPVAREL
YSMGGPNRFY	YSMGGPRFY
IATPFIKLF	IATPFIKLF
DVSSALDK	DVSSA-LDK
KAADFVKAF	KAADFVKAF
FAALQLEYF	FAALQLEYF
AASGLPLMV	AASGLPLMV
VAAIHPSL	VAAIH-PSL
YAIKKKDEL	YAIKKKDEL
KATAYILSV	KATAYILSV
KSVGKGLQV	KSVGKGLQV
GASQLFRIW	GASQLFRIW
RGTPWLRVH	RGTPWLRVH
FQGFRLVPF	FQGFRLVPF
KIDALNENK	KIDALNENK
KRQEVIYEL	KRQEVIYEL
FTDEESRV	FTDEE-SRV
VSYLRAKSF	VSYLRAKSF
FAAEAKFF	FAAEA-KFF
HAKDPNNLFM	HAKDPNNLF
FAAHLRCTY	FAAHLRCTY
VALHQPLISF	VALHQPISF
FAYPAPLEV	FAYPAPLEV
HGPGLIYR	HGPGL-IYR
ASVLRSISL	ASVLRSISL
VAAKKRFSV	VAAKKRFSV
SSSPVFKAM	SSSPVFKAM
TASDKILIV	TASDKILIV
VATSTVRIL	VATSTVRIL
VTSYDPLRIY	TSYDPLRIY
SAAELRHVM	SAAELRHVM
SAHIMGEAM	SAHIMGEAM
NFPSPVDAAFR	FPSPVDAAF
KAQEGMREM	KAQEGMREM
QTALVELVK	QTALVELVK
KPNLVVKPL	KPNLVVKPL
FASKRKVL	FASKR-KVL
YAQLHSLTL	YAQLHSLTL
FAILRQAEL	FAILRQAEL
IATQVVVEK	IATQVVVEK
GAFLREYLY	GAFLREYLY
TATSTQRPL	TATSTQRPL
YASVVVKRY	YASVVVKRY
YAADNSRTL	YAADNSRTL
TTTEVNMARVY	TTTEVNMAR
IAFLMINAV	IAFLMINAV
FAFVEFEL	FAFVE-FEL
FSFPSLPTM	FSFPSLPTM
STSVRHTAL	STSVRHTAL
TAAYVRIL	TAAYV-RIL
ISREPSPAL	ISREPSPAL
AAAVPRAAF	AAAVPRAAF
QASDTCHSY	QASDTCHSY
SQQYRPYSF	SQQYRPYSF
NSNLRQEL	NSNLR-QEL
YISGLPRTM	YISGLPRTM
YSSDRIHSL	YSSDRIHSL
DSYVRPCTL	DSYVRPCTL
MAVEFLHEL	MAVEFLHEL
LATDFIQSL	LATDFIQSL
VSATPREDF	VSATPREDF
YAQEHGLNF	YAQEHGLNF
VAKEIARAV	VAKEIARAV
NAAFPFLAY	NAAFPFLAY
LAGKVLAL	LAGKV-LAL
KGAPPKVSY	KGAPPKVSY
QAQTDRVSL	QAQTDRVSL
LDELRDEGK	LDELRDEGK
HGAEPLPYY	HGAEPLPYY
ISYKDSSRQAL	KDSSR-QAL
VITNQPEI	VITNQ-PEI
GHFSISIPVK	FSISI-PVK
NAMDGYRTL	NAMDGYRTL
SSHARPVSL	SSHARPVSL
AAFDGGFTV	AAFDGGFTV
IAQERKTQL	IAQERKTQL
IAVSIVRAL	IAVSIVRAL
LNTPENREY	LNTPENREY
SDVVYTDWK	SDVVYTDWK
KISPWTGRFY	ISPWTGRFY
TAQGNREVF	TAQGNREVF
FSNDIPHVV	FSNDIPHVV
AAVNRIHSF	AAVNRIHSF
LSSNRLEV	LSSNR-LEV
AASEQARQL	AASEQARQL
SAMLQPLL	SAMLQ-PLL
DWFERPDSF	DWFERPDSF
FAVIKEAF	FAVIK-EAF
QAINPKLLQL	AINPKLLQL
FATPQYRGV	FATPQYRGV
AAVAVGHRVY	VAVGH-RVY
FATEVFKAM	FATEVFKAM
VAKTQPVV	VAKTQ-PVV
YVTDVLYRVM	VTDVLYRVM
FASYMEQHLM	FASYMEQHL
NPANPVQR	NPANP-VQR
KLSHLNNVL	KLSHLNNVL
YSTAPRPSL	YSTAPRPSL
SAAPPRQF	SAAPP-RQF
FATVRETL	FATVR-ETL
FVNPTSFVY	FVNPTSFVY
MTNPHNHLY	MTNPHNHLY
FSESHLVII	FSESHLVII
FGIYRFLPF	FGIYRFLPF
YTVDGFRYF	YTVDGFRYF
KATAYILSVQ	KATAYILSV
RRQEAIYEM	RRQEAIYEM
FTSNAFRKL	FTSNAFRKL
QAAASHRVL	QAAASHRVL
RAAEGVRAW	RAAEGVRAW
QAVASTREL	QAVASTREL
ASNIMIVTL	ASNIMIVTL
AFALAGNQDKR	FALAGNQDK
AASAIYRLF	AASAIYRLF
MASIRLQGL	MASIRLQGL
LAAVRLWL	LAAVR-LWL
TAAEEARQM	TAAEEARQM
ISLEGKPL	ISLEG-KPL
YAVDAYFREAL	DAYFR-EAL
VFTDVKRPGY	FTDVKRPGY
KTLERMKKFVF	KTLERMKKF
LSTTKPFEY	LSTTKPFEY
RAILRIIYF	RAILRIIYF
FAHLRLEVL	FAHLRLEVL
YTGKRIAL	YTGKR-IAL
YAISPGLDITF	YAISPGLDI
VAAPKHWML	VAAPKHWML
SFFNRLWEV	SFFNRLWEV
LAAHRELL	LAAHR-ELL
LATFDRQEL	LATFDRQEL
HGPIRTAL	HGPIR-TAL
VAQIRMAF	VAQIR-MAF
FSTPPRQVL	FSTPPRQVL
IATEKKNSL	IATEKKNSL
FVIRPSRFY	FVIRPSRFY
FTTSNIRKV	FTTSNIRKV
FIMDRAQAL	FIMDRAQAL
SARNYIQSL	SARNYIQSL
LAAIKNAM	LAAIK-NAM
FQRPNALAV	FQRPNALAV
SAHSHFISL	SAHSHFISL
FATLRWIDY	FATLRWIDY
KATFIIKII	KATFIIKII
NATPLTIER	NATPLTIER
LSTEALRLW	LSTEALRLW
NTSEPQHLLVM	NTSEPQHLL
ELALRLTEY	ELALRLTEY
ATFVKEITY	ATFVKEITY
KNQAKLIEF	KNQAKLIEF
SAITRPFPF	SAITRPFPF
NSLINPFIY	NSLINPFIY
SSTPVVLVR	SSTPVVLVR
AAKEHQQAL	AAKEHQQAL
VSQLIQREF	VSQLIQREF
ATMFPRREF	ATMFPRREF
TFSQRKVEF	TFSQRKVEF
KSFVKVYNY	KSFVKVYNY
YAFLHRTL	YAFLH-RTL
LSVAPSKAREY	VAPSKAREY
VANPRLDTF	VANPRLDTF
ISPTGHSL	ISPTG-HSL
SAVDFIRTL	SAVDFIRTL
ISAPQERLY	ISAPQERLY
SATVKIIQM	SATVKIIQM
AAGKKLSM	AAGKK-LSM
FSNPFFVNY	FSNPFFVNY
GLSPARLAV	GLSPARLAV
VAIKGSVAY	VAIKGSVAY
SAHVSGRVV	SAHVSGRVV
KSTSRVTAF	KSTSRVTAF
SNYAKLIEM	SNYAKLIEM
LELSVDGAK	LELSVDGAK
AAMYKSLEL	AAMYKSLEL
LAAYHPWVV	LAAYHPWVV
SAGPVHPLV	SAGPVHPLV
FAGEATHRTF	FAGEATRTF
SSQVHPLAV	SSQVHPLAV
YTSPNVRSL	YTSPNVRSL
ISRVGQAM	ISRVG-QAM
HWLVGMVY	HWLVG-MVY
IASPVQPVL	IASPVQPVL
KVMSIPDVI	KVMSIPDVI
LAQDLEKTF	LAQDLEKTF
VQALRTVSL	VQALRTVSL
AAVPLYRLY	AAVPLYRLY
FANYIDKV	FANYI-DKV
LANGSILVY	LANGSILVY
VASNQHEV	VASNQ-HEV
VALLRLLLL	VALLRLLLL
IAPGVTHEL	IAPGVTHEL
RLPAFTLSHL	LPAFTLSHL
HAFDGRPSV	HAFDGRPSV
NATEWVREH	NATEWVREH
LTLLRFLEY	LTLLRFLEY
AATPAVRTV	AATPAVRTV
EGYYGYTGAFR	YGYTG-AFR
LASLKSLTY	LASLKSLTY
RAAPAAAAR	RAAPAAAAR
YAAIRDNYF	YAAIRDNYF
QTSEFIRAL	QTSEFIRAL
LAVEPKTETY	LAVEPKETY
QFALRLLAF	QFALRLLAF
YAALHHRIL	YAALHHRIL
FASFSDYYY	FASFSDYYY
FQRQFVLTL	FQRQFVLTL
FSITRPLTY	FSITRPLTY
VAVGRALYY	VAVGRALYY
IVSLRLLSL	IVSLRLLSL
IPYPRPIHL	IPYPRPIHL
YAFNMKATV	YAFNMKATV
TATDIRVAF	TATDIRVAF
VAAAISHGRVF	AAISHGRVF
SAKDFEVAM	SAKDFEVAM
AAAPALPFY	AAAPALPFY
SGFVNPVL	SGFVN-PVL
FASTHLIL	FASTH-LIL
KSGLKVSEY	KSGLKVSEY
YADYRENSY	YADYRENSY
YGIDTIRLY	YGIDTIRLY
TASLNSREY	TASLNSREY
YAKNSLPEL	YAKNSLPEL
NSTYRVVSV	NSTYRVVSV
FTKEQIREL	FTKEQIREL
RAVEPLRTF	RAVEPLRTF
FATNRDDF	FATNR-DDF
VGAALRPAF	VGAALRPAF
TAIELIPSV	TAIELIPSV
QAQERLQHY	QAQERLQHY
TAAQVARVL	TAAQVARVL
QALPWVRYI	QALPWVRYI
SAALPLPVL	SAALPLPVL
VMAPRALLL	VMAPRALLL
SAAQRQQL	SAAQR-QQL
FTHSQFIVV	FTHSQFIVV
AAVEDPRVL	AAVEDPRVL
FAQEALTVL	FAQEALTVL
YVVEPYRKY	YVVEPYRKY
VLRVTHEL	VLRVT-HEL
LAKNFNLEV	LAKNFNLEV
YAATRATL	YAATR-ATL
TARISQLEM	TARISQLEM
AAMASLGALAL	MASLGALAL
TSTADYAMFK	TSTAD-YAM
SAVNIIRTF	SAVNIIRTF
YFDEHYEY	YFDEH-YEY
TNTLRILAL	TNTLRILAL
AAAPLRPGM	AAAPLRPGM
MSVEVRQTL	MSVEVRQTL
RANNQKVYM	RANNQKVYM
RGLLRTSL	RGLLR-TSL
VALPPGLAV	VALPPGLAV
SSSPTHSLY	SSSPTHSLY
AVKLNGVVL	AVKLNGVVL
AACQKTVY	AACQK-TVY
AAAEVRISF	AAAEVRISF
VSQMRQEL	VSQMR-QEL
VVSVPQRIM	VVSVPQRIM
STFLLTREL	STFLLTREL
FSSPPLSL	FSSPP-LSL
FASKRYEM	FASKR-YEM
YSKLKKERPDF	YSKLK-KER
NAAFKDVAL	NAAFKDVAL
NALVHLIEV	NALVHLIEV
VSSNKTGF	VSSNK-TGF
KTMKGFEY	KTMKG-FEY
LALAIAQEL	LALAIAQEL
MTQLRIIFY	MTQLRIIFY
KAVSRELNF	KAVSRELNF
VASIRQHL	VASIR-QHL
LETPDFQLFK	LETPDFQLF
YSAPVIHVL	YSAPVIHVL
MAYLKIQKY	MAYLKIQKY
FANFANFSK	FANFANFSK
DELRDEGK	DELRD-EGK
ITSSRTFY	ITSSR-TFY
FVQQRYLSY	FVQQRYLSY
YAAGAKLVL	YAAGAKLVL
TANGTPKVY	TANGTPKVY
NYNLVESLK	NYNLVESLK
FAADIISVL	FAADIISVL
VASEHFYF	VASEH-FYF
NASESKLEL	NASESKLEL
FSTVKGVEL	FSTVKGVEL
YATVHQSY	YATVH-QSY
TATKRRIL	TATKR-RIL
YASSWFLTL	YASSWFLTL
FALYRQAY	FALYR-QAY
IASIHSFEL	IASIHSFEL
FTSAAFHEL	FTSAAFHEL
KARNIFKEL	KARNIFKEL
AAALPPPAY	AAALPPPAY
FAHEHEEM	FAHEH-EEM
TALRRGPLL	TALRRGPLL
DSAHGFLK	DSAHG-FLK
YSTPHAFTF	YSTPHAFTF
YVKDIYQYL	YVKDIYQYL
AASEMARAL	AASEMARAL
AAAVRHVL	AAAVR-HVL
LASGKYRTF	LASGKYRTF
RATVHVRLV	RATVHVRLV
LASKLSRKY	LASKLSRKY
FSLGSKGFYY	FSLGSKGFY
KVVSPLQL	KVVSP-LQL
NATDALRCV	NATDALRCV
FARSFTLML	FARSFTLML
YSAVRPFGCSF	YSAVRPCSF
FALPFGRTA	FALPFGRTA
AAALWRTFF	AAALWRTFF
RSQKPVMV	RSQKP-VMV
FSAVIDAKSF	SAVIDAKSF
VSKNTFFVL	VSKNTFFVL
SAYVKKIQF	SAYVKKIQF
FAQEAISVLAL	FAQEAISVL
INTFKLLSY	INTFKLLSY
YSDPYVKTY	YSDPYVKTY
VSMLKQDY	VSMLK-QDY
FATDRNDF	FATDR-NDF
MSSLRPLAI	MSSLRPLAI
VQHIQLLQK	VQHIQLLQK
IASTSWRHF	IASTSWRHF
VGDANPALQK	VGDAN-PAL
RAQEKVHEM	RAQEKVHEM
KANIRTVM	KANIR-TVM
AAASLIRLV	AAASLIRLV
EFNAETFTFH	FNAET-FTF
FGMDDREIM	FGMDDREIM
RNFSRYIAY	RNFSRYIAY
LAAESNFRIY	LAAESNRIY
AAIKAFIAV	AAIKAFIAV
FSSVHKPVF	FSSVHKPVF
FTGPLRPFF	FTGPLRPFF
AAAQLPSL	AAAQL-PSL
IALLRNAL	IALLR-NAL
REEAPSLR	REEAP-SLR
VAGFNPAL	VAGFN-PAL
SDIAPVAR	SDIAP-VAR
LNNGEITQHR	LNNGEITQH
FQTSRYKLH	FQTSRYKLH
VTTGLLTYL	VTTGLLTYL
YAITRKAL	YAITR-KAL
AAAFQPLII	AAAFQPLII
VAAPYSKPSM	VAAPYSPSM
KATHVEKQL	KATHVEKQL
FALSQPRAM	FALSQPRAM
RTQKALIL	RTQKA-LIL
YSAAKSWVF	YSAAKSWVF
ISSEGREL	ISSEG-REL
GSESGIFTNTK	ESGIFTNTK
RTNSTFNQV	RTNSTFNQV
AASDVTKHY	AASDVTKHY
AANPFFKLL	AANPFFKLL
TARDYYTFL	TARDYYTFL
LTCLVPAAL	LTCLVPAAL
YAAAQLRQY	YAAAQLRQY
AAANAIRVY	AAANAIRVY
VGTKSTRFF	VGTKSTRFF
FALLTTPEM	FALLTTPEM
NALGVILQV	NALGVILQV
FVRDMIREV	FVRDMIREV
IFMENRNEF	IFMENRNEF
AANDGRIY	AANDG-RIY
SAVEKKPTF	SAVEKKPTF
VSNDKALMV	VSNDKALMV
SAAEPTPAV	SAAEPTPAV
YAYETKDAL	YAYETKDAL
VSNVKPLSL	VSNVKPLSL
YATASLRKL	YATASLRKL
FASIGLHVF	FASIGLHVF
LSQDSFYRVL	LSQDSFRVL
MARKINFLM	MARKINFLM
YFVMTRQEY	YFVMTRQEY
KSLWKHHEY	KSLWKHHEY
RAAERLQY	RAAER-LQY
VASVPKELY	VASVPKELY
IASQGREL	IASQG-REL
SGLVRLYSF	SGLVRLYSF
SAAAAPHLL	SAAAAPHLL
AAIGLVIYY	AAIGLVIYY
KSNGKETVV	KSNGKETVV
RAAVRETVM	RAAVRETVM
SAMPRDILIV	SAMPR-DIL
VSTPISEVY	VSTPISEVY
VANVFLEAY	VANVFLEAY
LSDHHIYL	LSDHH-IYL
IANYRPTL	IANYR-PTL
KVPQLEIVPN	KVPQL-EIV
YAGLQPYL	YAGLQ-PYL
VWNMRLVFF	VWNMRLVFF
KPLLSALDF	KPLLSALDF
KAMELIREL	KAMELIREL
YALYNNWEH	YALYNNWEH
LSKNPYLSV	LSKNPYLSV
AALPNVYEV	AALPNVYEV
YSNGNIKKL	YSNGNIKKL
YVIVRAYQY	YVIVRAYQY
ATKTFREF	ATKTF-REF
FLQQPRPLM	FLQQPRPLM
FSTSLVHSI	FSTSLVHSI
LTADFLREY	LTADFLREY
LTVLVPRVW	LTVLVPRVW
SQPLGPRII	SQPLGPRII
AGILENGAVR	AGILENGAV
GSFLRIYSL	GSFLRIYSL
FSTVHEKF	FSTVH-EKF
DSGFQMNQLR	SGFQM-NQL
YGLEHLAY	YGLEH-LAY
RAKDFSLIL	RAKDFSLIL
LAALPRPQL	LAALPRPQL
LAAPSRFVL	LAAPSRFVL
KSHFRNHKF	KSHFRNHKF
LSSERHEF	LSSER-HEF
ELAAQTIK	ELAAQ-TIK
AAAALRRQM	AAAALRRQM
IAALRASF	IAALR-ASF
YSSPLFRSL	YSSPLFRSL
HSAERLAL	HSAER-LAL
VAALLTRTF	VAALLTRTF
YTMPNFRQY	YTMPNFRQY
VASPALRAV	VASPALRAV
FSTSRQTL	FSTSR-QTL
YVTAIEDRQY	VTAIEDRQY
VALVHPDL	VALVH-PDL
KQFEKCGLQV	KQFEKCLQV
RALKQLVL	RALKQ-LVL
FGFVRFTEY	FGFVRFTEY
KAIEYVHGYF	KAIEYVHGY
SAMSRYILIM	SAMSR-YIL
SAYDGKDYIAL	SAYDG-KDY
LLYEKGISL	LLYEKGISL
SIPEKNRPL	SIPEKNRPL
QFTSSTSYNR	FTSSTSYNR
SGAPNLPVY	SGAPNLPVY
HAHLRQQSY	HAHLRQQSY
SSAQAREF	SSAQA-REF
LTATREEF	LTATR-EEF
FAASVAHLY	FAASVAHLY
VTSSKPRTM	VTSSKPRTM
SAATGRFSL	SAATGRFSL
FSIEKRFAY	FSIEKRFAY
MAADGRLVF	MAADGRLVF
FTTAQKRVY	FTTAQKRVY
ASTARHLYL	ASTARHLYL
QLMLRVNEY	QLMLRVNEY
TIMPRGPTL	TIMPRGPTL
SAAPLQPVL	SAAPLQPVL
FTSYWIHWV	FTSYWIHWV
LAQTTRTAY	LAQTTRTAY
HGWLRPEM	HGWLR-PEM
GSNSKTLRV	GSNSKTLRV
SMLLRLIQY	SMLLRLIQY
ITDLPIKL	ITDLP-IKL
LSQYRDQHF	LSQYRDQHF
SAVADVRLY	SAVADVRLY
FLSIGARYY	FLSIGARYY
FSNWGHPEY	FSNWGHPEY
YAHFPINVV	YAHFPINVV
FAAVIQAL	FAAVI-QAL
HDNEETFLK	HDNEETFLK
KSLIGVEY	KSLIG-VEY
NSSPISHQF	NSSPISHQF
VASNRHLL	VASNR-HLL
YALLGRTL	YALLG-RTL
LSLERPTM	LSLER-PTM
LAHQRKVSY	LAHQRKVSY
LSHPSLLL	LSHPS-LLL
GFQVRMFEF	GFQVRMFEF
YTFPAGVSV	YTFPAGVSV
FARWLFIGL	FARWLFIGL
ASALKAVNY	ASALKAVNY
VATVTRIL	VATVT-RIL
VNNPHFLIM	VNNPHFLIM
FTEKEWPLL	FTEKEWPLL
FSNPNIQKI	FSNPNIQKI
SKEQLTPLIK	KEQLTPLIK
LTIFTARLY	LTIFTARLY
TATQAIRIF	TATQAIRIF
AAAAERGEM	AAAAERGEM
AAQFIPKFF	AAQFIPKFF
RATPAERQM	RATPAERQM
SLNEEAVKK	SLNEEAVKK
SARTPGPAV	SARTPGPAV
VAKSRFWYF	VAKSRFWYF
FASTILHLV	FASTILHLV
NATVKGVNF	NATVKGVNF
RVRPGETLLIH	RVRPGETLL
FFMERSWSV	FFMERSWSV
KAAEMRRIY	KAAEMRRIY
AAAPPLTL	AAAPP-LTL
FGTIRDSL	FGTIR-DSL
KLINSQISL	KLINSQISL
NIYIRRYVF	NIYIRRYVF
KSFSRYVSF	KSFSRYVSF
TATERQYEL	TATERQYEL
VAIQAVLSLY	VAIQAVLSL
LSKDYTLIV	LSKDYTLIV
AAIKAIKLY	AAIKAIKLY
MAASAAETRVF	SAAET-RVF
LSANRHSL	LSANR-HSL
LASKGRTM	LASKG-RTM
FAAASREV	FAAAS-REV
MSSTRAQSL	MSSTRAQSL
KASIGYTY	KASIG-YTY
AASTLVHKF	AASTLVHKF
YADRHAEL	YADRH-AEL
KSNEGKELLV	KSNEG-KEL
EAARVAEQL	EAARVAEQL
NSALRQMSY	NSALRQMSY
YSNGRPAL	YSNGR-PAL
FATFLSHVL	FATFLSHVL
FSHLQPTL	FSHLQ-PTL
HPDYSVVLLLR	YSVVL-LLR
KVTELLRTF	KVTELLRTF
NATLNNMRVY	ATLNNMRVY
YATQSHQWY	YATQSHQWY
YIIDFGLAK	YIIDFGLAK
IFSPEGRLY	IFSPEGRLY
IAVGLVRAY	IAVGLVRAY
FANTRIENF	FANTRIENF
NALLTPEL	NALLT-PEL
LSEVTFRPL	LSEVTFRPL
KAKILLVL	KAKIL-LVL
FSAVREDF	FSAVR-EDF
NGTYRLLEF	NGTYRLLEF
YSWERQAAF	YSWERQAAF
FACPSKATF	FACPSKATF
MAMEKRRAV	MAMEKRRAV
IATPFIKLFQ	IATPFIKLF
LDGSVDFKK	LDGSVDFKK
ASRVIREL	ASRVI-REL
ATRWAKKI	ATRWA-KKI
YSSSRYDDY	YSSSRYDDY
KAMPLVEET	KAMPLVEET
IANVAHTF	IANVA-HTF
RVRESLPEL	RVRESLPEL
ISQVGRVY	ISQVG-RVY
NAWHRVHVY	NAWHRVHVY
FAIQKGLQA	FAIQKGLQA
MAVEDEGLRVF	VEDEGLRVF
FAVGSFHTL	FAVGSFHTL
FTMEMVRQY	FTMEMVRQY
AAAPQRPAV	AAAPQRPAV
VATTFTHSY	VATTFTHSY
KADISEIRVF	KADISERVF
KAVIRVNVF	KAVIRVNVF
DAINDANLL	DAINDANLL
SATTSLRVL	SATTSLRVL
RANVNARTF	RANVNARTF
HASDRIIAL	HASDRIIAL
FSFVMPSL	FSFVM-PSL
NSAVLPEM	NSAVL-PEM
SAGLRLFAL	SAGLRLFAL
LARAALQEL	LARAALQEL
AARPATSTL	AARPATSTL
KANAFLKEF	KANAFLKEF
ISNPVTKEM	ISNPVTKEM
SAADREASL	SAADREASL
RSSGRVYYF	RSSGRVYYF
KVYHLASVRL	LASVR---L
EALKLEEK	EALKL-EEK
HGHQRPVAF	HGHQRPVAF
YTYLRINFY	YTYLRINFY
YAAVTPEL	YAAVT-PEL
FVNPSLRVL	FVNPSLRVL
MQTVYLREI	MQTVYLREI
YAVTGDVKM	YAVTGDVKM
KASGIIHSY	KASGIIHSY
SAREHIYDL	SAREHIYDL
YGKIAVMEL	YGKIAVMEL
DAFSKDHQL	DAFSKDHQL
VSSIWHRNY	VSSIWHRNY
ETWAGSHSMRY	TWAGS-HSM
EFGNTLEDK	EFGNTLEDK
YSMPISIEF	YSMPISIEF
VAAEILEI	VAAEI-LEI
IAQGSYIAL	IAQGSYIAL
ASTARHLY	ASTAR-HLY
FSWWPGRIV	FSWWPGRIV
ITTVIQHVF	ITTVIQHVF
FTADVRSVL	FTADVRSVL
ISLLQPQV	ISLLQ-PQV
VINGNIKTV	VINGNIKTV
KSQDNVIKV	KSQDNVIKV
YSFYLPIAA	YSFYLPIAA
SANVRTVNL	SANVRTVNL
KAYLKKISM	KAYLKKISM
DTVQIHDITGK	VQIHDITGK
SASTGKPPL	SASTGKPPL
YAAVPLYRLY	AAVPLYRLY
AAMELAQMV	AAMELAQMV
GANDFHRIY	GANDFHRIY
HSGPLRVAM	HSGPLRVAM
WSSDKAHKV	WSSDKAHKV
TAKGGDISV	TAKGGDISV
EQLTPLIK	EQLTP-LIK
HSSERPYM	HSSER-PYM
IASEVLKLF	IASEVLKLF
TTSERIIAY	TTSERIIAY
YANAKGIGY	YANAKGIGY
VATSFIRTI	VATSFIRTI
VTKEFFLLL	VTKEFFLLL
FASPGRLF	FASPG-RLF
RRLDIVRSL	RRLDIVRSL
AANLRETF	AANLR-ETF
RAVEPGRPPL	RAVEPGPPL
AANDKLKKM	AANDKLKKM
TTTSLLRSL	TTTSLLRSL
WAMDLRPEL	WAMDLRPEL
NSTPWVKEV	NSTPWVKEV
STIVQVLEV	STIVQVLEV
RSTQYMKEY	RSTQYMKEY
MSMVGYII	MSMVG-YII
ASSSAFRLM	ASSSAFRLM
AAADLERFF	AAADLERFF
GAAIRQTSF	GAAIRQTSF
LALLNNVSY	LALLNNVSY
FAFSPDGRHL	FAFSPDRHL
YTKPLVLEI	YTKPLVLEI
MSTNRQQF	MSTNR-QQF
TFNLRPNEF	TFNLRPNEF
RLFVGARIY	RLFVGARIY
FATVRWIDY	FATVRWIDY
SAGATRVY	SAGAT-RVY
KATGFLKNF	KATGFLKNF
VASVMQEY	VASVM-QEY
ISASAEELR	ISASAEELR
MAAPKVRFM	MAAPKVRFM
FAFESDLHSL	FAFESDHSL
FTSEPRLIVI	FTSEPRLIV
SASQPRLSY	SASQPRLSY
FTATRPGVY	FTATRPGVY
ETEGLRQEMSK	TEGLR-QEM
TANEKILMM	TANEKILMM
VASEMNRIY	VASEMNRIY
RFVEVGRVAY	FVEVGRVAY
SATLRNVEL	SATLRNVEL
SAMEVVPAL	SAMEVVPAL
RALDHYLTL	RALDHYLTL
FSQVIPVSL	FSQVIPVSL
AAIFHYLII	AAIFHYLII
MTCRGFREY	MTCRGFREY
SASMNQRVL	SASMNQRVL
FSCVKNEL	FSCVK-NEL
IAAIPRLI	IAAIP-RLI
NAPLVHATL	NAPLVHATL
TFQLRGLEF	TFQLRGLEF
YAKDYTKAL	YAKDYTKAL
FAMNGKSF	FAMNG-KSF
NAQLRNINF	NAQLRNINF
FFAERYESW	FFAERYESW
FTADPLSL	FTADP-LSL
YARVSVRTV	YARVSVRTV
YSALSHPYF	YSALSHPYF
SANIRLTAM	SANIRLTAM
FAADVRLMF	FAADVRLMF
YASLHRTL	YASLH-RTL
RLTPIDRVF	RLTPIDRVF
RASFIFISV	RASFIFISV
LAIEHVRFF	LAIEHVRFF
HSSVKQEY	HSSVK-QEY
EAVEHLQK	EAVEH-LQK
YSLSSVVTV	YSLSSVVTV
LSSPWYHTY	LSSPWYHTY
LLPSHPLEL	LLPSHPLEL
SSAFRPVM	SSAFR-PVM
FAREALRAL	FAREALRAL
AAVTSLFAK	AAVTSLFAK
FALDSGLEI	FALDSGLEI
VAIEVDGRVY	VAIEVDRVY
YSFQDKRNL	YSFQDKRNL
FASEYPLIL	FASEYPLIL
SLARMPPPL	SLARMPPPL
IVSPYTSRIL	VSPYTSRIL
FAMPHSIM	FAMPH-SIM
YAMDIVKGL	YAMDIVKGL
LSMSGNIY	LSMSG-NIY
NSSIRPIF	NSSIR-PIF
IAIDVIDAY	IAIDVIDAY
FVTPHPRRI	FVTPHPRRI
IANTRTHTY	IANTRTHTY
LAHLDNLKGTF	LAHLD-NLK
FAYLRDLL	FAYLR-DLL
LTAKVFRTY	LTAKVFRTY
RAAPPPLFLL	RAAPPPLFL
VTVLGQPK	VTVLG-QPK
YAQQWNQYY	YAQQWNQYY
AATHPRAF	AATHP-RAF
SAPGIISAL	SAPGIISAL
ISENGWVEDY	SENGWVEDY
YAAQLPAL	YAAQL-PAL
LAAEPRLL	LAAEP-RLL
VAYVSSVAL	VAYVSSVAL
ATDWRLIL	ATDWR-LIL
STSTGRVY	STSTG-RVY
NSAGQREEY	NSAGQREEY
VAGERNVL	VAGER-NVL
YASNHPIM	YASNH-PIM
WLWLLLSL	WLWLL-LSL
IATLRKYTY	IATLRKYTY
ISDEANSNF	ISDEANSNF
MSGSREVM	MSGSR-EVM
KAYLREDFF	KAYLREDFF
HVLVGAVLAF	VLVGAVLAF
LAIDKRFRVF	LAIDKRRVF
YTSGDVRVW	YTSGDVRVW
AAQGKTRTL	AAQGKTRTL
ALFVSEEEKK	ALFVSEEEK
WSSAQAREF	WSSAQAREF
NSSTGRTAL	NSSTGRTAL
IAFFDVRTF	IAFFDVRTF
KWQEEMELYR	KWQEE-MEL
FATIKSASL	FATIKSASL
MFLTRSEY	MFLTR-SEY
KISSFIRKY	KISSFIRKY
TTNGGILTV	TTNGGILTV
FSTIREKL	FSTIR-EKL
FASLAEGRLY	FASLAERLY
RATKLLKAL	RATKLLKAL
KATNVVMNY	KATNVVMNY
TVVLPLDERAF	VLPLDERAF
LASPPWRVL	LASPPWRVL
DFDFVPPVVR	FDFVP-PVV
ALVQQMEQLR	ALVQQMEQL
SAYGSVKAY	SAYGSVKAY
HAIGTVKCL	HAIGTVKCL
FNYQKRVSF	FNYQKRVSF
VAFSPDGRYL	FSPDG-RYL
AAVAVGRIL	AAVAVGRIL
AAAGGARLL	AAAGGARLL
RTGPTQQQV	RTGPTQQQV
AAAAPRLW	AAAAP-RLW
LSKGPGLEV	LSKGPGLEV
FAKVHILY	FAKVH-ILY
VASPSPKEV	VASPSPKEV
TLNERFTSY	TLNERFTSY
AALVGFLY	AALVG-FLY
KSAVKNEEY	KSAVKNEEY
VEYGFQVK	VEYGF-QVK
QVAERVEAL	QVAERVEAL
FSAAQHRSY	FSAAQHRSY
RSMEAHNIL	RSMEAHNIL
YAIFRILLY	YAIFRILLY
TVLHQDWLNGK	TVLHQ-DWL
ASSLAIREW	ASSLAIREW
LANVSTVL	LANVS-TVL
ISASGRPPL	ISASGRPPL
FFLLRIHF	FFLLR-IHF
KAADLRAAY	KAADLRAAY
RLNDRYPKKL	RLNDRYKKL
MATPTPGHIM	MATPTPHIM
FSASHRLY	FSASH-RLY
AAQEAVKLY	AAQEAVKLY
RVSGLVPSRF	VSGLVPSRF
LASPVRAEM	LASPVRAEM
FFKDRHWLF	FFKDRHWLF
TASSRIHIY	TASSRIHIY
KTEDKVRVM	KTEDKVRVM
YTTDFIYQL	YTTDFIYQL
RASQLARKM	RASQLARKM
FAAQGEPKVY	FAAQGEKVY
HANYKVTL	HANYK-VTL
WATSRITAY	WATSRITAY
FVRDYMAVL	FVRDYMAVL
AAFVKKLVY	AAFVKKLVY
YGAEALER	YGAEA-LER
AAREGHEEM	AAREGHEEM
VFALRPVGF	VFALRPVGF
YAGSKNRL	YAGSK-NRL
VANPSHLEA	VANPSHLEA
SSQGTVRFF	SSQGTVRFF
YAFDKYRDQY	YAFDKYDQY
KTIDNQRVY	KTIDNQRVY
SAANIQPIF	SAANIQPIF
RAGSFSRFY	RAGSFSRFY
VSSGVQRVL	VSSGVQRVL
IAPTGIESL	IAPTGIESL
FAMEIDPSL	FAMEIDPSL
AAAAALWL	AAAAA-LWL
YAVNSKRML	YAVNSKRML
TAGRVLEL	TAGRV-LEL
FAKLPNLLQL	FAKLPNLQL
YTSPGRQM	YTSPG-RQM
AAAPHLLLL	AAAPHLLLL
FSHERLEEY	FSHERLEEY
NTSLPRPAL	NTSLPRPAL
NATFRILEV	NATFRILEV
FSYAFPKEF	FSYAFPKEF
TAVALLRLL	TAVALLRLL
ISAPHMHAY	ISAPHMHAY
FALDGQWIL	FALDGQWIL
IASNYHLEV	IASNYHLEV
VAAMPRPVSY	AAMPRPVSY
YIMDWMDEM	YIMDWMDEM
KTGHVIAV	KTGHV-IAV
FFMEKRAKY	FFMEKRAKY
FAVDNVGNRTL	FAVDNVRTL
FATIRTASL	FATIRTASL
TTTFRPEL	TTTFR-PEL
TSHKRLVM	TSHKR-LVM
FSTLGRVL	FSTLG-RVL
SFFTRSFF	SFFTR-SFF
LTNDWEDHL	LTNDWEDHL
VQAIRITSY	VQAIRITSY
FASGGGREL	FASGGGREL
ATTVIPRVY	ATTVIPRVY
VASEKESVM	VASEKESVM
KSRDYLLTL	KSRDYLLTL
NSSVRNEL	NSSVR-NEL
AATSRIAEL	AATSRIAEL
LIKSYFLIV	LIKSYFLIV
KVFERAVQY	KVFERAVQY
AAAPLLPMI	AAAPLLPMI
YAIGNAPEL	YAIGNAPEL
FSTVVIHFL	FSTVVIHFL
IAMPLHMIF	IAMPLHMIF
VAIPLKYEV	VAIPLKYEV
KRQEAIFEL	KRQEAIFEL
TVLKRAVEL	TVLKRAVEL
YISFRHHVY	YISFRHHVY
NVVFVIDK	NVVFV-IDK
SAILDLPVL	SAILDLPVL
FFIAGRYEF	FFIAGRYEF
VQPYLDDFQK	VQPYL-DDF
NAKDFFRVL	NAKDFFRVL
FSVDSPRIY	FSVDSPRIY
VASPQVHFI	VASPQVHFI
IAGLRFWNY	IAGLRFWNY
YTSSQIREM	YTSSQIREM
SAMQGWRVSM	SAMQGWVSM
TATALAIIY	TATALAIIY
VMAPRTLLL	VMAPRTLLL
NATDLLRKM	NATDLLRKM
KVGQKVNVVV	VGQKVNVVV
ATAQGRYY	ATAQG-RYY
YAIDNPLHY	YAIDNPLHY
YGNPRTNGM	YGNPRTNGM
FSSDLQKTF	FSSDLQKTF
ATTLRLSAY	ATTLRLSAY
QSTDIIRYL	QSTDIIRYL
LATERRYNY	LATERRYNY
GHMLENHVER	HMLENHVER
AFFSRVETF	AFFSRVETF
YTVEKREGY	YTVEKREGY
KPLISTPL	KPLIS-TPL
FSAGEPRVL	FSAGEPRVL
FSSENVKVF	FSSENVKVF
LTAFVVTL	LTAFV-VTL
YARLLALDM	YARLLALDM
RLFSRLYTY	RLFSRLYTY
FTSSRLFF	FTSSR-LFF
RFTEWLHEV	RFTEWLHEV
NFGLRTDMY	NFGLRTDMY
FSLVNQIYY	FSLVNQIYY
IAASQHVM	IAASQ-HVM
FATDSGLEF	FATDSGLEF
YSSLRVVGV	YSSLRVVGV
THLAPYSDELR	HLAPYSDEL
VLPERYSSL	VLPERYSSL
SASDLTWDNLK	SASDLTDNL
IFLIRHSQY	IFLIRHSQY
VSSTKLVSF	VSSTKLVSF
YANYFIRLL	YANYFIRLL
LLPTGLSSL	LLPTGLSSL
SVVFHSTVI	SVVFHSTVI
DASPVQAVF	DASPVQAVF
TFDLLRNSY	TFDLLRNSY
AASLRQEL	AASLR-QEL
CAATPKHAL	CAATPKHAL
IAIDWEPEM	IAIDWEPEM
FLTELTRLF	FLTELTRLF
YAGIRCENF	YAGIRCENF
FITGLIRIM	FITGLIRIM
LTERGYSF	LTERG-YSF
AAQLRELQL	AAQLRELQL
FTSDRGFQF	FTSDRGFQF
KTTNVRQTY	KTTNVRQTY
FASLQPSL	FASLQ-PSL
AAEKGVRTL	AAEKGVRTL
FALAMKDTL	FALAMKDTL
ILTLIPRLF	ILTLIPRLF
KTSSRPAM	KTSSR-PAM
VASGMILVM	VASGMILVM
LAKVGIAL	LAKVG-IAL
ISLPESLKR	ISLPESLKR
TTTSRAEF	TTTSR-AEF
LAFLRGLSY	LAFLRGLSY
IISEFALEY	IISEFALEY
FTHPSRLTY	FTHPSRLTY
AANLKNVM	AANLK-NVM
FTNEAREM	FTNEA-REM
LAQIRQQQY	LAQIRQQQY
LSNENHGIAQR	LSNEN-HGI
FTREHYMEL	FTREHYMEL
ISIDGSRSY	ISIDGSRSY
FAVNPLLRVI	FAVNPLLRV
MTDPIRILV	MTDPIRILV
LMAKPRPPL	LMAKPRPPL
MAIVGGMAL	MAIVGGMAL
FAYTARISV	FAYTARISV
SNTLRPLTY	SNTLRPLTY
FSNPRALYL	FSNPRALYL
NSSVMHCM	NSSVM-HCM
MSCTRSVY	MSCTR-SVY
KAAQKAAAF	KAAQKAAAF
GYTQQLAFR	GYTQQLAFR
FGSNIAHMY	FGSNIAHMY
FAAVAAAAY	FAAVAAAAY
AATLFPRKM	AATLFPRKM
FTPFVDPRVY	FTPFVDRVY
FARMKPRKI	FARMKPRKI
LSSVLPREY	LSSVLPREY
FAAEHTIF	FAAEH-TIF
KVLDTIMATKL	LDTIMATKL
AAAPGSRSL	AAAPGSRSL
AATSATHEL	AATSATHEL
VAAYRRAL	VAAYR-RAL
AAAATGRLL	AAAATGRLL
IAPTGHSL	IAPTG-HSL
LTPLRNFL	LTPLR-NFL
FAKAIYERL	FAKAIYERL
LANGEVRIY	LANGEVRIY
AAIKAIKFY	AAIKAIKFY
RAARGAPPL	RAARGAPPL
RGDLGGPQIQM	LGGPQ-IQM
AANLRMHIF	AANLRMHIF
NLSIRIAAY	NLSIRIAAY
NAHIQNEL	NAHIQ-NEL
IIREPLTEL	IIREPLTEL
SSSPERHIF	SSSPERHIF
YAEGVRVL	YAEGV-RVL
FAGQGIVY	FAGQG-IVY
RSAQPLPLKI	SAQPLPLKI
NAAPFRSEV	NAAPFRSEV
FSHAQTVVL	FSHAQTVVL
KSCDPKGPL	KSCDPKGPL
VAADTVKEL	VAADTVKEL
SAAHNKPSL	SAAHNKPSL
RATETSRPSL	RATETSPSL
NATGPRPAL	NATGPRPAL
KSSARAIVF	KSSARAIVF
YASNQREEY	YASNQREEY
SAADIYIREY	AADIYIREY
SSSTRSVL	SSSTR-SVL
AASNYFRAM	AASNYFRAM
NTTVKEQAF	NTTVKEQAF
EDVYVVGTVLR	DVYVVGTVL
FTDEYQLF	FTDEY-QLF
AAVPLVRLF	AAVPLVRLF
SAFVHVPPL	SAFVHVPPL
FANERCLQL	FANERCLQL
VTYPGELLL	VTYPGELLL
YAQTTQAY	YAQTT-QAY
KQQQALLL	KQQQA-LLL
LTSVRLQF	LTSVR-LQF
LAGPLRPAA	LAGPLRPAA
FATPFLVVR	FATPFLVVR
YAAIRYDTV	YAAIRYDTV
MSSPQSRTV	MSSPQSRTV
FAKMVVDAV	FAKMVVDAV
VTDPRVVDL	VTDPRVVDL
SAAVHSFAF	SAAVHSFAF
KATQASQEY	KATQASQEY
VSQEVTRSL	VSQEVTRSL
AAHIMVKEY	AAHIMVKEY
VSHLRPLL	VSHLR-PLL
AALGFAQML	AALGFAQML
LLSLRILSF	LLSLRILSF
SASTVFIAL	SASTVFIAL
AVSAVVHEY	AVSAVVHEY
LARIYSFQM	LARIYSFQM
FAALHGPAL	FAALHGPAL
VSLVASRVI	VSLVASRVI
AAGTKKQFQKF	AAGTK-KQF
SSSLRSIAL	SSSLRSIAL
VAAWLKKIF	VAAWLKKIF
NFAYRLEL	NFAYR-LEL
SNMIKTIAF	SNMIKTIAF
IATTRLWL	IATTR-LWL
QINDYVEK	QINDY-VEK
YSSVKAEM	YSSVK-AEM
VAQITQRFY	VAQITQRFY
FSKPPNPAL	FSKPPNPAL
FAFSHEQL	FAFSH-EQL
VLPTLPFHVL	LPTLPFHVL
AACGRNHTL	AACGRNHTL
LSIQRLWYF	LSIQRLWYF
VSTNKLTF	VSTNK-LTF
YSSARKCL	YSSAR-KCL
ISAQGRDF	ISAQG-RDF
TAAPTIGVL	TAAPTIGVL
VSSFVLRAM	VSSFVLRAM
VAAMQPRML	VAAMQPRML
QAAKELREY	QAAKELREY
KSSWKRVSF	KSSWKRVSF
VAQNRNSL	VAQNR-NSL
DGYLFQLLR	DGYLFQLLR
IQRTPKIQV	IQRTPKIQV
YAVLDIREF	YAVLDIREF
RARDARVV	RARDA-RVV
FSTDVSHCV	FSTDVSHCV
KAGSGLRQY	KAGSGLRQY
YAINTVYVY	YAINTVYVY
FIFQKVGKL	FIFQKVGKL
FAPEKLQEL	FAPEKLQEL
RAAEMEHLL	RAAEMEHLL
RGNVGFVF	RGNVG-FVF
AASLHNTPM	AASLHNTPM
LSIPYRLIF	LSIPYRLIF
TSSSKNIAY	TSSSKNIAY
STIRKQEY	STIRK-QEY
VAVGQLGVRVF	VGQLGVRVF
VAVNYIPEV	VAVNYIPEV
GSTTVFHSL	GSTTVFHSL
FSVEQITAM	FSVEQITAM
FAALIARTA	FAALIARTA
ILGGHLDAK	ILGGHLDAK
YAYLRDSL	YAYLR-DSL
YTLMHKAHT	YTLMHKAHT
LTSDPREL	LTSDP-REL
AATLATHEL	AATLATHEL
ASTQTTHEL	ASTQTTHEL
KEEVVTVET	KEEVVTVET
FAYLGRLAH	FAYLGRLAH
ATNPISRVL	ATNPISRVL
TASEWERFI	TASEWERFI
SSAGGKPAM	SSAGGKPAM
IANVPILIL	IANVPILIL
YRNAYTMVL	YRNAYTMVL
FSYVTPRAF	FSYVTPRAF
AARSFYYKL	AARSFYYKL
ISAQQNRVV	ISAQQNRVV
SAQGKPLAL	SAQGKPLAL
NAFHHPSAV	NAFHHPSAV
SAALRAVY	SAALR-AVY
AAKFKTPEL	AAKFKTPEL
NAAEEPRVL	NAAEEPRVL
VSVTHRPPL	VSVTHRPPL
KVNQGLESL	KVNQGLESL
YAGTPRFF	YAGTP-RFF
ESDEETQIK	ESDEETQIK
YAGLKEEF	YAGLK-EEF
NASPINRIV	NASPINRIV
YSNFHPLLV	YSNFHPLLV
VASAREAL	VASAR-EAL
FLREWVESM	FLREWVESM
IATLRAVL	IATLR-AVL
YTSPYFYAL	YTSPYFYAL
FINQNLRTY	FINQNLRTY
KSFEGLFYF	KSFEGLFYF
MQIAWSREF	MQIAWSREF
FAVASRKTF	FAVASRKTF
AASLRKVSM	AASLRKVSM
HSTIFENLANK	HSTIF-ENL
AAAMAPIK	AAAMA-PIK
AAVAELPVL	AAVAELPVL
LSQERIQSL	LSQERIQSL
SAVTNNRQL	SAVTNNRQL
ILDDLSPR	ILDDL-SPR
IAPVRAVL	IAPVR-AVL
AASAAQREL	AASAAQREL
AASSIQRVL	AASSIQRVL
QAIKHLKQY	QAIKHLKQY
VSASCRHEY	VSASCRHEY
AASPYFRAM	AASPYFRAM
RAFLKRKEY	RAFLKRKEY
AAHNKDVL	AAHNK-DVL
TTSIPLRL	TTSIP-LRL
YFSSRPAL	YFSSR-PAL
GSHSMRYFY	GSHSMRYFY
SIYKPGQTVK	SIYKPGQTV
IAQVHQAF	IAQVH-QAF
FTSPAVKRL	FTSPAVKRL
HTGERPFM	HTGER-PFM
RQLALVKGL	RQLALVKGL
YALPAGLEV	YALPAGLEV
ALSVRPNDY	ALSVRPNDY
HIRESLPAL	HIRESLPAL
SQLNKATVKM	SQLNKATVK
RLYGSSLTRF	YGSSL-TRF
YSIQNLYSY	YSIQNLYSY
IASEVARKL	IASEVARKL
FALVMQQL	FALVM-QQL
IGHVTGFLL	IGHVTGFLL
YATGIRYTL	YATGIRYTL
SSAPKDFAI	SSAPKDFAI
TFLNHPAL	TFLNH-PAL
YAGEGLRTL	YAGEGLRTL
AASEQHVF	AASEQ-HVF
TAVYKVSEY	TAVYKVSEY
FATRRWIEY	FATRRWIEY
HAAPFSKVL	HAAPFSKVL
ISMEVPVM	ISMEV-PVM
IIKNIWIPM	IIKNIWIPM
FTAEQRQEL	FTAEQRQEL
SASILPEM	SASIL-PEM
YSGLKPTM	YSGLK-PTM
FASSFKIVL	FASSFKIVL
AAAERGEM	AAAER-GEM
YFLEHLAF	YFLEH-LAF
AASDVFKHY	AASDVFKHY
VSGPGRPEL	VSGPGRPEL
VFHPRQEL	VFHPR-QEL
ESFLRSQFY	ESFLRSQFY
TASLPREL	TASLP-REL
STSQRPKL	STSQR-PKL
FLENEDRR	FLENE-DRR
VALLQPFL	VALLQ-PFL
KASDVLARFL	KASDVLRFL
YSNVIFLEV	YSNVIFLEV
DGYNRTAL	DGYNR-TAL
FSSNPKVQV	FSSNPKVQV
NATKLERVF	NATKLERVF
TSTPNAKTV	TSTPNAKTV
FAYDPSNYEY	FAYDPSYEY
RAAPGARVA	RAAPGARVA
YAYLYIRML	YAYLYIRML
MSTSVTRGY	MSTSVTRGY
FSQEHEEM	FSQEH-EEM
NAIWRAWYM	NAIWRAWYM
FAMDVYKNLY	FAMDVYKNL
FIISRTQAL	FIISRTQAL
VAYWRQAGLSY	VAYWRQAGL
LANEKTEM	LANEK-TEM
HGYVKQSL	HGYVK-QSL
HAVGPSTAM	HAVGPSTAM
SIPGGYNAL	SIPGGYNAL
KAFERINSL	KAFERINSL
QSFTGSRTY	QSFTGSRTY
FAASGLEF	FAASG-LEF
VAVDPSGRLL	VAVDPSRLL
FSEEHPVL	FSEEH-PVL
FSTLYGRVL	FSTLYGRVL
VLQQRLIAL	VLQQRLIAL
FSKVGREL	FSKVG-REL
NSNGIKPVM	NSNGIKPVM
VAQLQFQL	VAQLQ-FQL
FVNDIFERIA	FVNDI-FER
AAAQKAVSAL	AAQKAVSAL
TAMKKGETL	TAMKKGETL
LSAPARLY	LSAPA-RLY
KLFDHAVSKF	KLFDHAVSK
AASLLPVL	AASLL-PVL
RVTNWNRKL	RVTNWNRKL
LAQQYYLVY	LAQQYYLVY
FQNALIVR	FQNAL-IVR
HTAPARTMF	HTAPARTMF
FAQERRWKV	FAQERRWKV
YALTSPLQL	YALTSPLQL
FATRFDQVM	FATRFDQVM
FSRGSILVM	FSRGSILVM
DAYDRPEL	DAYDR-PEL
AAISHGRVF	AAISHGRVF
VSSVRKNL	VSSVR-KNL
TAFFGDVVL	TAFFGDVVL
ASNTKLIAM	ASNTKLIAM
YSKDSMFSL	YSKDSMFSL
FSSIEREEY	FSSIEREEY
FASLPQVER	FASLPQVER
YSMYREFWA	YSMYREFWA
AAVWKGHVM	AAVWKGHVM
FADLNLAEF	FADLNLAEF
MVSAIVRTM	MVSAIVRTM
IAYSRPVYF	IAYSRPVYF
YAQVKPDGTY	YAQVKPGTY
FTVETASREY	FTVETAREY
FAYPAIRYL	FAYPAIRYL
VASFSKRFF	VASFSKRFF
ASSQKQHSF	ASSQKQHSF
YATFIVTNY	YATFIVTNY
SAFVPSSGRIY	FVPSSGRIY
RSAPPLNL	RSAPP-LNL
FLANVRKAF	FLANVRKAF
LSMERMVPA	LSMERMVPA
FAARSKEV	FAARS-KEV
SATARPNTF	SATARPNTF
YNAVGFTY	YNAVG-FTY
RATNHRVL	RATNH-RVL
SAFYRKYEL	SAFYRKYEL
ASSLRLYLY	ASSLRLYLY
FAAIQKEQL	FAAIQKEQL
IIAEPGRYY	IIAEPGRYY
SANGNGKTF	SANGNGKTF
VATAQGRYY	VATAQGRYY
VAGKKPVV	VAGKK-PVV
AQSDIEHLF	AQSDIEHLF
ITDPRTVFV	ITDPRTVFV
YGYDNVKEY	YGYDNVKEY
VTSGKIIEY	VTSGKIIEY
FAKEVSHEM	FAKEVSHEM
IGIVQPEL	IGIVQ-PEL
DIFTGLIGPMK	FTGLIGPMK
ASSGALRSY	ASSGALRSY
FSQGGALSL	FSQGGALSL
HAVLRVVDF	HAVLRVVDF
AQHPLRPEF	AQHPLRPEF
LAAEFLKQV	LAAEFLKQV
VASSIAHEL	VASSIAHEL
YAISAGVSL	YAISAGVSL
KAASTFKHY	KAASTFKHY
VGAIRNAAF	VGAIRNAAF
VAWNPSPAV	VAWNPSPAV
SSSHPKEV	SSSHP-KEV
TAVVKFIDY	TAVVKFIDY
YGSEGRFTF	YGSEGRFTF
FVRPYSDYL	FVRPYSDYL
AAQEPLQL	AAQEP-LQL
YAAFKRWHF	YAAFKRWHF
SATWLALSR	SATWLALSR
AASPPRPLL	AASPPRPLL
ILTERGYSF	ILTERGYSF
IASNSKIYF	IASNSKIYF
YSVDRLYEL	YSVDRLYEL
DNEQHVFK	DNEQH-VFK
ATEEPGESF	ATEEPGESF
VVALSRTY	VVALS-RTY
TFFSRGLSF	TFFSRGLSF
VTTTWERLY	VTTTWERLY
FAQSQQKVF	FAQSQQKVF
KAVPPSKRFL	KAVPPSRFL
VSSSKISL	VSSSK-ISL
VAYDSKQYY	VAYDSKQYY
AQSFRPAM	AQSFR-PAM
RVEPYGENFNK	RVEPYGENF
STAIREISL	STAIREISL
YANAKIYKL	YANAKIYKL
FSSSHPKEV	FSSSHPKEV
SASFREEY	SASFR-EEY
YGTIKIGTY	YGTIKIGTY
VAGQRWTF	VAGQR-WTF
GSEMVVAGK	GSEMVVAGK
FSFVRVISL	FSFVRVISL
LSTIREVAV	LSTIREVAV
HASMGNRPY	HASMGNRPY
AAQDRVLSL	AAQDRVLSL
IATLRAYVL	IATLRAYVL
SAAYYLNDL	SAAYYLNDL
FAYYRDLVF	FAYYRDLVF
IFSIREVSF	IFSIREVSF
YATLREESL	YATLREESL
VAPVTHVSV	VAPVTHVSV
VAFLRLEDF	VAFLRLEDF
AAFAHNYDL	AAFAHNYDL
FLAKSRPEL	FLAKSRPEL
SAFPHLRVL	SAFPHLRVL
IATTALAIY	IATTALAIY
AAREFILKM	AAREFILKM
VAKDYVRLM	VAKDYVRLM
VASIRLFGF	VASIRLFGF
RAGERPEL	RAGER-PEL
LARELEEL	LAREL-EEL
FTSLRPLL	FTSLR-PLL
TATVRSVHF	TATVRSVHF
AVTHIGRVY	AVTHIGRVY
QAIEPDVLRQF	QAIEP-DVL
SARDAALAY	SARDAALAY
LAVENLPSL	LAVENLPSL
LATWATKEL	LATWATKEL
LATSGRCY	LATSG-RCY
NAFGKKYPL	NAFGKKYPL
VIPTNVPEL	VIPTNVPEL
FAGDLVRNL	FAGDLVRNL
KMAEVIGSKL	MAEVIGSKL
VSSWGGYVF	VSSWGGYVF
NAGEREISL	NAGEREISL
FASFPHMVL	FASFPHMVL
FGGQRLTL	FGGQR-LTL
YAQLHSFTL	YAQLHSFTL
PARLAVPAV	PARLAVPAV
FAHEGQQY	FAHEG-QQY
ISVGSKPGM	ISVGSKPGM
SASGYTKEM	SASGYTKEM
YASQYIARY	YASQYIARY
FSIADSIEL	FSIADSIEL
YVGGQEHFAH	YVGGQ-EHF
YLPYRDYNY	YLPYRDYNY
VAKPIPEEL	VAKPIPEEL
YATKERIEY	YATKERIEY
FTTKRPNTF	FTTKRPNTF
TAASRLVTL	TAASRLVTL
AAFLILPEL	AAFLILPEL
KVLLDGVQNPR	VLLDGVNPR
FTTNKKVSF	FTTNKKVSF
VTMTASRML	VTMTASRML
KFDLRIYVY	KFDLRIYVY
FAFDPSVNY	FAFDPSVNY
FAQEALTVLSL	FAQEALTVL
AAVLVLREL	AAVLVLREL
LATPLHHTW	LATPLHHTW
FAMEFVKYY	FAMEFVKYY
HYEGSTVPEK	YEGSTVPEK
SPELQAEAK	SPELQAEAK
LSSMRLPL	LSSMR-LPL
SSSIKTVYF	SSSIKTVYF
KSSVKAVIL	KSSVKAVIL
ISNVKKVSL	ISNVKKVSL
STTLPRSSY	STTLPRSSY
ASFSDRGVY	ASFSDRGVY
FTIFRTISV	FTIFRTISV
FSSDNRQIV	FSSDNRQIV
VTNDNFREF	VTNDNFREF
FVNIRPAKL	FVNIRPAKL
FAIDLNGKKY	FAIDLNKKY
ISQIQPEV	ISQIQ-PEV
RIASSQLSPRL	ASSQLSPRL
INLQMVNASL	NLQMVNASL
YSSPEILRV	YSSPEILRV
EPQVYTLPPSR	QVYTLPPSR
VAMPGVPAF	VAMPGVPAF
KAANAFHVY	KAANAFHVY
AASQRSSSL	AASQRSSSL
AMALRNKSF	AMALRNKSF
ISSVPHGEL	ISSVPHGEL
TFTERMMAY	TFTERMMAY
RATPAERQL	RATPAERQL
VSNLRLYL	VSNLR-LYL
AAQTLRAAF	AAQTLRAAF
FAAYGNVF	FAAYG-NVF
RAAPHRISL	RAAPHRISL
TIIDTKGVTAL	IDTKGVTAL
TFGERVVAF	TFGERVVAF
YAHLTPREL	YAHLTPREL
SAADKAEEF	SAADKAEEF
LLLDNSEILL	LLLDNSEIL
QTVSWAVTPK	TVSWAVTPK
YSMPVHAAV	YSMPVHAAV
KVALTVKL	KVALT-VKL
GGYDGYRPSF	YDGYR-PSF
ITTTVTRVL	ITTTVTRVL
FFLDHVRTSF	FFLDHVTSF
AACQIARAY	AACQIARAY
FVNDYILYY	FVNDYILYY
SIVEPKPTL	SIVEPKPTL
NSVIKPTQY	NSVIKPTQY
VSSSAVKTV	VSSSAVKTV
YALETLTM	YALET-LTM
DLGEENFK	DLGEE-NFK
NSTNKLFQY	NSTNKLFQY
AASFINLLY	AASFINLLY
HDNEETFLKK	HDNEE-TFL
EAWERHHL	EAWER-HHL
KTPESGRGAF	KTPESGGAF
YSNTRAYYF	YSNTRAYYF
ILYIRNLPY	ILYIRNLPY
MISEPRISY	MISEPRISY
KAMEKSSL	KAMEK-SSL
TALERRIEY	TALERRIEY
ISIVRPFSI	ISIVRPFSI
TASPVAVSL	TASPVAVSL
TAKGFATVL	TAKGFATVL
SSSGHPTF	SSSGH-PTF
VSSVRWISY	VSSVRWISY
FAQYLISEL	FAQYLISEL
KAIDYIKYL	KAIDYIKYL
NSAIGRAM	NSAIG-RAM
YGMDSRPPM	YGMDSRPPM
NAMPHIKTY	NAMPHIKTY
KSLSRISL	KSLSR-ISL
FSSGAIQVV	FSSGAIQVV
FAVEAENREM	FAVEAEREM
KSTSYVRTL	KSTSYVRTL
RPYEKGRL	RPYEK-GRL
LAFLRFVVY	LAFLRFVVY
VSKSVRFY	VSKSV-RFY
FYNNRLQAY	FYNNRLQAY
FSGNPIKV	FSGNP-IKV
SLHTLFGDK	SLHTLFGDK
LATAYIHRF	LATAYIHRF
AAAWPLLL	AAAWP-LLL
AAAQPSGRFF	AAQPSGRFF
KACDYIREL	KACDYIREL
KSGGTALHV	KSGGTALHV
QSTKVNLLY	QSTKVNLLY
IAQAVPHIL	IAQAVPHIL
IIQEGRIL	IIQEG-RIL
QAREYVLEM	QAREYVLEM
LTDPAIVKV	LTDPAIVKV
SAFVFPQL	SAFVF-PQL
ASDGFKANLVF	ASDGFKANL
RTFKRLYQY	RTFKRLYQY
NAFKEITTM	NAFKEITTM
SAVVHEYAL	SAVVHEYAL
FASNPQRPGY	ASNPQRPGY
AAAKALRIL	AAAKALRIL
YAFPKSITV	YAFPKSITV
FADPFAFIH	FADPFAFIH
LSKDPDPIPL	LSKDPDIPL
FSSNPISL	FSSNP-ISL
TAHPRVLTV	TAHPRVLTV
SAVDRQREY	SAVDRQREY
FSQKIRYVF	FSQKIRYVF
AAYPQVRCY	AAYPQVRCY
SARSVILIF	SARSVILIF
AANERQQL	AANER-QQL
YATLYYREH	YATLYYREH
IQMGRFISF	IQMGRFISF
FSNITGIDY	FSNITGIDY
YSATHPTV	YSATH-PTV
AAALRDLSF	AAALRDLSF
VQPYLDDFQKK	YLDDF-QKK
IAGYRPFL	IAGYR-PFL
FSAPPGSEL	FSAPPGSEL
FANPFPAAV	FANPFPAAV
SAQLLPVL	SAQLL-PVL
FATNGFTY	FATNG-FTY
SASEVEVQL	SASEVEVQL
SASDYFKAM	SASDYFKAM
MAQRLVRVL	MAQRLVRVL
IMTFRPTM	IMTFR-PTM
YAKDGRVSY	YAKDGRVSY
FTSPFCLQV	FTSPFCLQV
ASTLRVVVF	ASTLRVVVF
YARPSSEVI	YARPSSEVI
KTTECSNTF	KTTECSNTF
NSSVGRKY	NSSVG-RKY
IASSLSKEL	IASSLSKEL
LATDNHVAY	LATDNHVAY
FSAEFLKVF	FSAEFLKVF
NILTSNNIDVK	LTSNNIDVK
AAASREVL	AAASR-EVL
QLEQVIAK	QLEQV-IAK
SARNAFFLL	SARNAFFLL
RWPDYVREL	RWPDYVREL
VSTEAARTF	VSTEAARTF
NAMGYVRMI	NAMGYVRMI
QLSLRTVSL	QLSLRTVSL
FSFHHVLSL	FSFHHVLSL
ASVYIYRYF	ASVYIYRYF
IAQLYGRLY	IAQLYGRLY
NATSRILDM	NATSRILDM
LASANLRVL	LASANLRVL
ASTTRISL	ASTTR-ISL
FALVSQAY	FALVS-QAY
FTAFKEEY	FTAFK-EEY
FALPSPQHI	FALPSPQHI
AAISTSRVL	AAISTSRVL
FSADPRHIL	FSADPRHIL
IASAIVNEL	IASAIVNEL
ALGVRDLSY	ALGVRDLSY
KVCNPIITKL	KVCNPIITK
HLPETKFSEL	LPETKFSEL
AAIDPRVQYL	AAIDPRVQY
YANDVTRVL	YANDVTRVL
IFVARLYYF	IFVARLYYF
SPNAEIHIL	SPNAEIHIL
LSDLALHFL	LSDLALHFL
VNLPINGNGKQ	NLPINGNGK
VSNPKSFEY	VSNPKSFEY
SVAVRVLSY	SVAVRVLSY
LSYEGEVTK	LSYEGEVTK
LASPGHISV	LASPGHISV
FAAFFTRAF	FAAFFTRAF
ESTGTVRVF	ESTGTVRVF
YSTAQRVTY	YSTAQRVTY
LSAVGERVF	LSAVGERVF
VLVDHFGYTK	VLVDH-FGY
AACGGGGRVY	AACGGGRVY
SVMHEALHNR	VMHEALHNR
ITQERIVF	ITQER-IVF
NSSPSRTSL	NSSPSRTSL
FVITKPDVY	FVITKPDVY
ASNERIAL	ASNER-IAL
YMGIRNESF	YMGIRNESF
YSVPEILRV	YSVPEILRV
LSKERVEAF	LSKERVEAF
SAAERDVY	SAAER-DVY
KTTSDLLLVM	TTSDLLLVM
YIIGVFRKF	YIIGVFRKF
IAFVRLPSL	IAFVRLPSL
HARFYFLFH	HARFYFLFH
MSAGPKYEY	MSAGPKYEY
AAAFEKQVL	AAAFEKQVL
KSTSNITKL	KSTSNITKL
AANLFAQTY	AANLFAQTY
KTVYALPTIAF	YALPT-IAF
HTQTRLLSM	HTQTRLLSM
AAARRFYQY	AAARRFYQY
KSTTKMSL	KSTTK-MSL
FSATFPRAM	FSATFPRAM
TAAQAKPAL	TAAQAKPAL
GMLLRLEEF	GMLLRLEEF
ISNSHPLSL	ISNSHPLSL
VAVWNGRQV	VAVWNGRQV
KSKNPGEAL	KSKNPGEAL
YTLLGHEF	YTLLG-HEF
TNFIKAEY	TNFIK-AEY
LATQMVRMI	LATQMVRMI
IFFTRAVQF	IFFTRAVQF
YANNHPSM	YANNH-PSM
FFNGLRTEL	FFNGLRTEL
YALLNLYEH	YALLNLYEH
ASLVHLSL	ASLVH-LSL
FSSTKEEF	FSSTK-EEF
SALTRLASF	SALTRLASF
IIHYRHQEF	IIHYRHQEF
SAADGPRVF	SAADGPRVF
FIRPFMLLL	FIRPFMLLL
VAYHQPTL	VAYHQ-PTL
KAALGRAL	KAALG-RAL
HSIVRLVAF	HSIVRLVAF
RVDTVDPPYPR	RVDTVDPPY
NSTFKKSSY	NSTFKKSSY
KQTALVELVK	QTALVELVK
FAEVTENFAF	FAEVTEFAF
VAKDYPFYL	VAKDYPFYL
VSSLRMML	VSSLR-MML
FASTYLLLL	FASTYLLLL
SVLGQLGITK	VLGQLGITK
KATGRYYAM	KATGRYYAM
VATEKAVEL	VATEKAVEL
VSSERHKL	VSSER-HKL
YITSVSRLY	YITSVSRLY
SANIRQNL	SANIR-QNL
YATYPREL	YATYP-REL
LSDDHVLIL	LSDDHVLIL
TLTDVAHEY	TLTDVAHEY
FAQETFGKQY	FAQETFKQY
AAKSYIQSL	AAKSYIQSL
YTALGRLL	YTALG-RLL
AATTVLQEL	AATTVLQEL
YTDFHVDF	YTDFH-VDF
IAFPDEQAEAL	FPDEQAEAL
VTSEVNRLL	VTSEVNRLL
SATSLLHTV	SATSLLHTV
SSQTQPLKV	SSQTQPLKV
KSKEFVQKV	KSKEFVQKV
IATKDVRIF	IATKDVRIF
ISLVGTVL	ISLVG-TVL
TVSEWLRLL	TVSEWLRLL
KAKWPDRITL	KAKWPDITL
KAAVMVHQL	KAAVMVHQL
RVTALLKVY	RVTALLKVY
TSSVRESSF	TSSVRESSF
VGGVQPVSI	VGGVQPVSI
VVTFPRAY	VVTFP-RAY
FGKPYFIKL	FGKPYFIKL
YSQTGNYEL	YSQTGNYEL
VAFKKTFSY	VAFKKTFSY
ISNPIPIKV	ISNPIPIKV
ALLLIRLPY	ALLLIRLPY
IDQNVEELK	IDQNVEELK
VSQVGKEL	VSQVG-KEL
SAKATYLEM	SAKATYLEM
RAIDALREF	RAIDALREF
MANIPLPEY	MANIPLPEY
FAMVKGYF	FAMVK-GYF
YAGKNAVAY	YAGKNAVAY
YAAQAHLKL	YAAQAHLKL
FTATQPEV	FTATQ-PEV
ETLFSVMPGLK	LFSVM-PGL
YARLYPVLL	YARLYPVLL
FAVGVGRPSF	FAVGVGPSF
YFAFRNFLY	YFAFRNFLY
VSTPRSSFY	VSTPRSSFY
SATDTIRKM	SATDTIRKM
QQTLRTVAF	QQTLRTVAF
FAALQLEY	FAALQ-LEY
DRVYIHPFHL	RVYIHPFHL
RPSLAASAL	RPSLAASAL
LSYLRESSL	LSYLRESSL
FATTYRQLL	FATTYRQLL
AANLKSIDF	AANLKSIDF
FSEPFHLIV	FSEPFHLIV
KTPDFILQV	KTPDFILQV
IAAGTLRQM	IAAGTLRQM
FAIEREFFF	FAIEREFFF
LFQSRISL	LFQSR-ISL
GANYGHVY	GANYG-HVY
VTQLRPIM	VTQLR-PIM
FARVGGRLF	FARVGGRLF
AAQNRQEF	AAQNR-QEF
NATLGRAY	NATLG-RAY
QNVARRIEF	QNVARRIEF
SAQKAARVL	SAQKAARVL
FASVFEKYF	FASVFEKYF
IANDRFINM	IANDRFINM
LAQEIVKAL	LAQEIVKAL
QVASRVLAM	QVASRVLAM
VSSVRLSGY	VSSVRLSGY
YFNPHLVF	YFNPH-LVF
FAASGGFLH	FAASGGFLH
FAATHSLEF	FAATHSLEF
FASDVQFVL	FASDVQFVL
ISNLRDVF	ISNLR-DVF
TATMHILVV	TATMHILVV
YSSSFPKEF	YSSSFPKEF
IAASYVKYL	IAASYVKYL
LSNNNQAL	LSNNN-QAL
LPPNVVEESAR	NVVEE-SAR
FSAVMVRLM	FSAVMVRLM
YASQHSQL	YASQH-SQL
AGLAKVVSL	AGLAKVVSL
TSSSISRHY	TSSSISRHY
ISSEHARTY	ISSEHARTY
FASKEIAENAL	ASKEIANAL
FSSERLFSW	FSSERLFSW
ALPEDDFLSL	ALPEDDLSL
VAAEWRSTF	VAAEWRSTF
FVRNLANTV	FVRNLANTV
YSAMRDQY	YSAMR-DQY
LSALEEYTK	LSALEEYTK
FTQDTRSL	FTQDT-RSL
LSAGATKVY	LSAGATKVY
YAVEGRDL	YAVEG-RDL
KIREEYPDRIM	KIREEYPDR
FSQINLREY	FSQINLREY
SLSTMFRVEY	LSTMFRVEY
FLLINCSI	FLLIN-CSI
SSAPTARVF	SSAPTARVF
FIVDARPAM	FIVDARPAM
TFMNRVEV	TFMNR-VEV
VSNPQTVGV	VSNPQTVGV
SASEVLKEW	SASEVLKEW
QATTLNVAF	QATTLNVAF
LVPPWTRVY	LVPPWTRVY
FSHNRNHL	FSHNR-NHL
VSAKREAL	VSAKR-EAL
ISKIREEY	ISKIR-EEY
ASSPVLRQM	ASSPVLRQM
YAKKRGWVL	YAKKRGWVL
YAAPWFLTL	YAAPWFLTL
MSADRVVAF	MSADRVVAF
SSVTVTRSY	SSVTVTRSY
SAAERPLEI	SAAERPLEI
FAYHYPYTY	FAYHYPYTY
YSSLSRFLM	YSSLSRFLM
TSFERALSL	TSFERALSL
FALGVYRTL	FALGVYRTL
SANEKPAL	SANEK-PAL
KAVKERYSY	KAVKERYSY
AAAPAGRAM	AAAPAGRAM
LALDPSLVPTF	LALDP-SLV
YTVENSRVY	YTVENSRVY
VATAMARVL	VATAMARVL
FSASKIIVF	FSASKIIVF
SAKDFIDLTL	SAKDFILTL
NAADQSRMM	NAADQSRMM
LAYTLARVY	LAYTLARVY
FNSVRSVF	FNSVR-SVF
FVAEQKVEY	FVAEQKVEY
VLLDGVQNPR	VLLDGVNPR
FSVDARAL	FSVDA-RAL
LVRPEVDVM	LVRPEVDVM
IALTRAEM	IALTR-AEM
TGTHGLLVK	TGTHGLLVK
VANPEDTRSL	VANPEDRSL
AALVNHESY	AALVNHESY
AAVLRNIKF	AAVLRNIKF
KSNCKPSTF	KSNCKPSTF
ASNEPKPAV	ASNEPKPAV
SAYPLSVEW	SAYPLSVEW
SAVEKAHSY	SAVEKAHSY
VAQYRPEEY	VAQYRPEEY
FAKDFMTYL	FAKDFMTYL
RMSGMIRLY	RMSGMIRLY
SKLPGIVAEGR	SKLPG-IVA
NSLLRENSF	NSLLRENSF
YAQIRTIAI	YAQIRTIAI
VARGTITTL	VARGTITTL
TAKQKALEV	TAKQKALEV
VASCGRLY	VASCG-RLY
FTSGYVRFY	FTSGYVRFY
GSGNYNDFGNY	GSGNY-NDF
SAIIDGKIF	SAIIDGKIF
TSFIRTIEL	TSFIRTIEL
IASQRLTPL	IASQRLTPL
FQRDYYDRM	FQRDYYDRM
RSFLRGLPA	RSFLRGLPA
VAHVDDMPNAL	HVDDMPNAL
LAVLKLYQF	LAVLKLYQF
VAGTHIEM	VAGTH-IEM
FSHVEGWSF	FSHVEGWSF
PAAPAHPPL	PAAPAHPPL
LFQTRQEM	LFQTR-QEM
YAYEKPHVV	YAYEKPHVV
LGQYASPTAK	YASPT--AK
MAGPLRAPL	MAGPLRAPL
YSGLRVQAM	YSGLRVQAM
YSQIKQEV	YSQIK-QEV
YSNLRPVHF	YSNLRPVHF
KAVFVARVL	KAVFVARVL
SIPILASAL	SIPILASAL
RAAQFLRKM	RAAQFLRKM
DDNPNLPR	DDNPN-LPR
VSDPVTVHF	VSDPVTVHF
VASEALARVV	VASEALRVV
FQSQFERLV	FQSQFERLV
SSGTSYPDVLK	SGTSYPDVL
NAQFNREEL	NAQFNREEL
LANDSIFEY	LANDSIFEY
QATQVLQEM	QATQVLQEM
TAAFNKDAL	TAAFNKDAL
FVTFSTRAM	FVTFSTRAM
FSAPSALRVY	SAPSALRVY
AALPDASPGNL	ALPDASGNL
QIDDIDVR	QIDDI-DVR
KATQNFKVM	KATQNFKVM
YAIREEIVL	YAIREEIVL
RANIQAVSL	RANIQAVSL
TSAEKRAEM	TSAEKRAEM
AAALRIQNM	AAALRIQNM
AASTKYDVF	AASTKYDVF
FFMLRSLSL	FFMLRSLSL
NFYNRPIL	NFYNR-PIL
VAVGHRVYSF	VAVGH-RVY
TAAAAVRQM	TAAAAVRQM
FSNDALKTY	FSNDALKTY
FARLSLTY	FARLS-LTY
AAKEYPFIL	AAKEYPFIL
VTNDHQHML	VTNDHQHML
FAKNMYEL	FAKNM-YEL
SAWERNLVY	SAWERNLVY
SSTSRLEF	SSTSR-LEF
SISDVFRQY	SISDVFRQY
VVDKPSSIPV	VDKPSSIPV
LGEFVSETESR	FVSET-ESR
ISRLLEEL	ISRLL-EEL
NAAEGRSFM	NAAEGRSFM
EAGGRFVAF	EAGGRFVAF
FVSERKPAL	FVSERKPAL
YAQIKEEV	YAQIK-EEV
AATEATHVV	AATEATHVV
VACGSAHTL	VACGSAHTL
AASEAGRAM	AASEAGRAM
VAMKFAQVF	VAMKFAQVF
KTAKPKVEM	KTAKPKVEM
FAEPGRVPF	FAEPGRVPF
FALVRTIRY	FALVRTIRY
YSSGHNRLY	YSSGHNRLY
FNSVRLWDF	FNSVRLWDF
TSSAVSKEL	TSSAVSKEL
EFDHNSNIR	EFDHNSNIR
MIKEGDYNPL	KEGDY-NPL
TYGERVVAF	TYGERVVAF
NARETELEL	NARETELEL
ISVERVIEY	ISVERVIEY
FVIETARQL	FVIETARQL
LAAARLAAA	LAAARLAAA
FSIPDSLLI	FSIPDSLLI
YMIDPSGVSY	YMIDPSVSY
SAATGRPY	SAATG-RPY
FAYDGKDYI	FAYDGKDYI
LSSPVQRTL	LSSPVQRTL
VIIDDHPEV	VIIDDHPEV
FSRSDHLAL	FSRSDHLAL
FSFYFHEAL	FSFYFHEAL
FTEDHYVEF	FTEDHYVEF
RVYIHPFHL	RVYIHPFHL
GIYNINVTTLV	YNINV-TTL
MANERISM	MANER-ISM
LAMINRFQF	LAMINRFQF
FSFKKPFKL	FSFKKPFKL
ISNEKPEV	ISNEK-PEV
YSISRKYDY	YSISRKYDY
KIQDIGSGRIL	IQDIGSRIL
YQILRGLAY	YQILRGLAY
AAVPEIMDRIY	AAVPEIMDR
YAGSKSAM	YAGSK-SAM
YAAQQAASY	YAAQQAASY
IVTERLVAL	IVTERLVAL
ETTEESLRNY	TTEESLRNY
FFYQRLVEF	FFYQRLVEF
VSHTMHCF	VSHTM-HCF
VGFYESDVMGR	VGFYESDVM
VASPRIISL	VASPRIISL
YSTELKKLY	YSTELKKLY
VANNRLFV	VANNR-LFV
ATSGIRHAM	ATSGIRHAM
YVKIGLTNL	YVKIGLTNL
NAFTMPLHM	NAFTMPLHM
IAYIRDLAL	IAYIRDLAL
YASKVDHVM	YASKVDHVM
SAASLRNFY	SAASLRNFY
AAKGYTEVL	AAKGYTEVL
FASVLIRRI	FASVLIRRI
TITEPYRTL	TITEPYRTL
FASQPKVV	FASQP-KVV
MTAVRAWEF	MTAVRAWEF
FSTNLQRLM	FSTNLQRLM
ASQPKHVL	ASQPK-HVL
KLHQRVEQL	KLHQRVEQL
YSYPTGNHTY	YSYPTGHTY
VQMQREWSF	VQMQREWSF
IASVGSREM	IASVGSREM
LGVAPPSFVAI	VAPPSFVAI
AASSAHVAL	AASSAHVAL
FARSFHPML	FARSFHPML
ATYHRAIKV	ATYHRAIKV
LAQLQQEF	LAQLQ-QEF
FTSPQRVY	FTSPQ-RVY
RSEEVFLQV	RSEEVFLQV
TTISKVSQV	TTISKVSQV
ATVVYQGER	ATVVYQGER
SATYSNRAL	SATYSNRAL
YIATPRVW	YIATP-RVW
KSIKNVTEL	KSIKNVTEL
FLYPFPLAL	FLYPFPLAL
RLAEWKATKL	LAEWKATKL
VALTHLTL	VALTH-LTL
TSTVKQAL	TSTVK-QAL
FSYAGFEM	FSYAG-FEM
TLNGSLTLEL	NGSLT-LEL
HAAPFQNIL	HAAPFQNIL
AALFAPYGTVM	LFAPYGTVM
FAKPENIDL	FAKPENIDL
VALYNPVSF	VALYNPVSF
FFKDRNWL	FFKDR-NWL
VAMSKEQY	VAMSK-EQY
LSMTRTEL	LSMTR-TEL
AVSYRQVAF	AVSYRQVAF
YAKVCLYL	YAKVC-LYL
HTDTTVKF	HTDTT-VKF
FSQALQHAL	FSQALQHAL
KQFHRIVTY	KQFHRIVTY
VATTRDYYF	VATTRDYYF
AAAPSLLIL	AAAPSLLIL
TANSHLSNLVL	NSHLSNLVL
TASSRHVHF	TASSRHVHF
HAAGFAYTY	HAAGFAYTY
FANDLKPKVY	FANDLKKVY
VAIESTPMI	VAIESTPMI
FANNPREL	FANNP-REL
LAIPVFLTL	LAIPVFLTL
SSGFRDFL	SSGFR-DFL
AAVDFFRPSA	AAVDFFPSA
TAVWLPRYY	TAVWLPRYY
AASAKDIYY	AASAKDIYY
VSPYTEIHL	VSPYTEIHL
SAIVGFIY	SAIVG-FIY
AAAMTLRTV	AAAMTLRTV
FSIEPWLKV	FSIEPWLKV
LSFIRSTEL	LSFIRSTEL
FVKPAVVTV	FVKPAVVTV
IAVLRGLAY	IAVLRGLAY
SAPVGVTAL	SAPVGVTAL
ISTKTNKVY	ISTKTNKVY
FSVEGQLEF	FSVEGQLEF
ADFAKVLEL	ADFAKVLEL
VAAVGNRLY	VAAVGNRLY
YVSDLGKVF	YVSDLGKVF
KTKEGVREV	KTKEGVREV
RAVMRNTVY	RAVMRNTVY
ASLVFPLLV	ASLVFPLLV
VAIDRGLAF	VAIDRGLAF
AAYAGGLVL	AAYAGGLVL
HASNRPAL	HASNR-PAL
LTTDISLIF	LTTDISLIF
QAINPKLMQL	AINPKLMQL
VSALEHRVY	VSALEHRVY
VSHTHLAF	VSHTH-LAF
SAMSSPKVV	SAMSSPKVV
TVIGPDGHK	TVIGPDGHK
HTGCMFRVQF	TGCMFRVQF
AATQLRHFF	AATQLRHFF
LSSSREEL	LSSSR-EEL
SATNALRSM	SATNALRSM
VAQTNQNQL	VAQTNQNQL
LSQIRIDAL	LSQIRIDAL
FAVNKKIEF	FAVNKKIEF
NLSQRVVSY	NLSQRVVSY
RSSTYEVRL	RSSTYEVRL
SSGSLLNNAIK	SGSLLNNAI
LTTEVHPEL	LTTEVHPEL
FAMMSHHEM	FAMMSHHEM
FAFDRKKRHY	FAFDRKRHY
YAAEGQRLM	YAAEGQRLM
MWLPVVRTW	MWLPVVRTW
AARVFYLLL	AARVFYLLL
FFQIRDDY	FFQIR-DDY
YAARARLL	YAARA-RLL
FNHILPYFY	FNHILPYFY
FTSKLHRMY	FTSKLHRMY
IAIEPGAAL	IAIEPGAAL
VAKVEPAV	VAKVE-PAV
AAAKNIRVW	AAAKNIRVW
FTHLYTLIV	FTHLYTLIV
FAKEHQEF	FAKEH-QEF
AAASHFFNL	AAASHFFNL
KAAAKRQVL	KAAAKRQVL
GSTDHIIRV	GSTDHIIRV
SAVADKHEL	SAVADKHEL
NAKGKILVL	NAKGKILVL
LANIRSEY	LANIR-SEY
AARSVFLHL	AARSVFLHL
VSYVRSVYL	VSYVRSVYL
KACDPAARQF	KACDPARQF
IGYARQYVY	IGYARQYVY
DASGPDPQL	DASGPDPQL
IALGFYRFW	IALGFYRFW
VASNGRTLF	VASNGRTLF
SALDMTRYW	SALDMTRYW
LLSAARLLTSF	LSAARLTSF
YTSEMRSEL	YTSEMRSEL
YAGSRRSM	YAGSR-RSM
SSAVRALEL	SSAVRALEL
LLFYETSASF	LFYETSASF
RVQGTPVASKL	QGTPVASKL
SASNFYRQF	SASNFYRQF
AAAVGLEL	AAAVG-LEL
FQAPTAKEM	FQAPTAKEM
VSLVQLTL	VSLVQ-LTL
LHYPIDSLT	LHYPIDSLT
LIAPPRYVM	LIAPPRYVM
SAGPLLRPY	SAGPLLRPY
FSVNLFRTL	FSVNLFRTL
IMNTRHIAF	IMNTRHIAF
SAIGYIHSL	SAIGYIHSL
KASEVFLQRL	KASEVFLQR
YASLRKDTL	YASLRKDTL
HARLAPPSL	HARLAPPSL
AASGLTRMF	AASGLTRMF
VAATLLKQL	VAATLLKQL
IANESKKLY	IANESKKLY
HSNLQPVHM	HSNLQPVHM
RTTTWTRPIM	TTTWTRPIM
LSAERLQM	LSAER-LQM
YANNVQRVM	YANNVQRVM
SAAVNREY	SAAVN-REY
ALPAPIEK	ALPAP-IEK
ETWTANVGK	ETWTANVGK
KAAFKTSY	KAAFK-TSY
VVKLLASAL	VVKLLASAL
KASELYKKF	KASELYKKF
MSSHGRVL	MSSHG-RVL
VVPPFLQPEV	VVPPFLPEV
FAVNMFRTL	FAVNMFRTL
RARFALGL	RARFA-LGL
KTDIQIAL	KTDIQ-IAL
AISHGRVF	AISHG-RVF
VAYGKGTYF	VAYGKGTYF
LVAASQAALG	VAASQ-AAL
TVYLRDIAL	TVYLRDIAL
IAYIRITQY	IAYIRITQY
NASEHIVY	NASEH-IVY
VTKPPHFIL	VTKPPHFIL
NAVDQARVF	NAVDQARVF
TSYVRPVKF	TSYVRPVKF
VARLLEVPV	VARLLEVPV
SAFDRKVQF	SAFDRKVQF
IAVPEARFL	IAVPEARFL
KAAIRKEL	KAAIR-KEL
HYEGSTVPEKK	YEGSTVPEK
QSTTRLTEM	QSTTRLTEM
FITYVEHVL	FITYVEHVL
NSSQRVEL	NSSQR-VEL
KATNVVRLLLG	KATNVVRLL
IIVDPAREL	IIVDPAREL
FATDAILAT	FATDAILAT
ITPNTLKTL	ITPNTLKTL
AAGEGKPAL	AAGEGKPAL
IAVIKGLTY	IAVIKGLTY
FALGAALQL	FALGAALQL
IMMNTPVI	IMMNT-PVI
AFALAGNQDK	FALAGNQDK
KSKLRSLSY	KSKLRSLSY
DEYGRPFLII	YGRPF-LII
AATAVTNLY	AATAVTNLY
VGSFRSNSF	VGSFRSNSF
SATHYVAEL	SATHYVAEL
QEAFDISK	QEAFD-ISK
FTTTAEREI	FTTTAEREI
HGYPRQAL	HGYPR-QAL
HAAHFARAF	HAAHFARAF
FARYPNGVVV	FARYPNVVV
LAREWFFLL	LAREWFFLL
AASALNRLL	AASALNRLL
YSREAYVEL	YSREAYVEL
KATTHEIM	KATTH-EIM
YAYPYSYYY	YAYPYSYYY
FAIPMIHAV	FAIPMIHAV
FAADLAEEL	FAADLAEEL
VAWPNPREI	VAWPNPREI
MTTAFIHAL	MTTAFIHAL
VAKEDQPAV	VAKEDQPAV
VMAPRTVLL	VMAPRTVLL
KATFHYRTL	KATFHYRTL
YSSAFTNRIF	SSAFTNRIF
ISSESARNY	ISSESARNY
GRTGPRAPL	GRTGPRAPL
TASYVRAQY	TASYVRAQY
SALEEYTK	SALEE-YTK
SATAVAQLY	SATAVAQLY
FSSDKHAQLIL	FSSDKHAQL
AVSSWFRQL	AVSSWFRQL
LSSDHVKVF	LSSDHVKVF
KTVEGREL	KTVEG-REL
ISAQHPEL	ISAQH-PEL
VASVRKTTV	VASVRKTTV
KTQKELVL	KTQKE-LVL
AQTLRHYGY	AQTLRHYGY
KTLKEIRTL	KTLKEIRTL
AAGLRLLPM	AAGLRLLPM
SASALAVAL	SASALAVAL
SSTSRPAL	SSTSR-PAL
YAIVRFNQY	YAIVRFNQY
KSFGGSHVM	KSFGGSHVM
KAKDNFNFL	KAKDNFNFL
LAAEGRVL	LAAEG-RVL
AAIKIIRQL	AAIKIIRQL
KAIGLFISF	KAIGLFISF
LMSPVKPFY	LMSPVKPFY
YALLLQEL	YALLL-QEL
FANDDRHVM	FANDDRHVM
FEVQVTVPK	FEVQVTVPK
FAQIALQL	FAQIA-LQL
FASTKEVL	FASTK-EVL
LASVRMEL	LASVR-MEL
AAAAGRIAI	AAAAGRIAI
FVITFPRAY	FVITFPRAY
KTLDPKAVF	KTLDPKAVF
NASVFGRVM	NASVFGRVM
AALARLLAA	AALARLLAA
FIYHLPQEF	FIYHLPQEF
VASKILKTF	VASKILKTF
VLITAETFTL	ITAET-FTL
QASWYIHKY	QASWYIHKY
YSDLRKESM	YSDLRKESM
MISTMRPDIDN	ISTMR-PDI
SSAFTNRIF	SSAFTNRIF
KAKYHGNVM	KAKYHGNVM
RALDYALQI	RALDYALQI
FVGLRLEL	FVGLR-LEL
LAAGKPRVL	LAAGKPRVL
VSAFKTEY	VSAFK-TEY
TTDDHCQEF	TTDDHCQEF
VANPAFLKY	VANPAFLKY
MAPLKMLAL	MAPLKMLAL
VSSIQNQM	VSSIQ-NQM
AASTREMAM	AASTREMAM
AIADAKLSF	AIADAKLSF
AANPDPKKL	AANPDPKKL
NAKAALFAL	NAKAALFAL
NMASRPLTF	NMASRPLTF
VQSIRPPY	VQSIR-PPY
SAAEHFSM	SAAEH-FSM
TAQTLVRIL	TAQTLVRIL
FTTEQVTAM	FTTEQVTAM
QASTTERVF	QASTTERVF
FAVGSSRFW	FAVGSSRFW
KSSSIYSI	KSSSI-YSI
LAVLGRAL	LAVLG-RAL
AAAERDVVY	AAAERDVVY
ITTLRQVL	ITTLR-QVL
TAMDAQEAL	TAMDAQEAL
YATTVIPRVY	YATTVIRVY
YAKNFQPFAL	YAKNFQFAL
SAVQGPPER	SAVQGPPER
FASSEKHSY	FASSEKHSY
SSAEKVAL	SSAEK-VAL
RSVDVTNTTF	RSVDVTTTF
NIRLRLEEY	NIRLRLEEY
SAIYRLFDY	SAIYRLFDY
VAYLRFLEL	VAYLRFLEL
SASVQNHEF	SASVQNHEF
ALSFVQRTF	ALSFVQRTF
KASLPHGPM	KASLPHGPM
VWWYRPFQY	VWWYRPFQY
TAASLFKEM	TAASLFKEM
LSLVSKTEI	LSLVSKTEI
SSNWQKEAM	SSNWQKEAM
MAQLKCYYF	MAQLKCYYF
IGALRENTF	IGALRENTF
KVYERAVEF	KVYERAVEF
YVTILPEL	YVTIL-PEL
VTDGKEVLL	VTDGKEVLL
ELLESYIDGR	LLESYIDGR
FAFSRQAL	FAFSR-QAL
VAAVLVKKY	VAAVLVKKY
AAAMNWRLF	AAAMNWRLF
VVPEPGQPL	VVPEPGQPL
AAVAQNRIY	AAVAQNRIY
VAAEWRNTF	VAAEWRNTF
LSSSVIREL	LSSSVIREL
DNDGWLTSDPR	LTSDP----
TVTDVVRFI	TVTDVVRFI
LSSGKLQEF	LSSGKLQEF
RTGKPIAVKL	TGKPIAVKL
VAIPVSIFY	VAIPVSIFY
FAQHGTFEY	FAQHGTFEY
FASPNMHSV	FASPNMHSV
FFYNLIHPEY	FYNLIHPEY
NAPLVNVTL	NAPLVNVTL
FAMSYVKLM	FAMSYVKLM
FATQQFVAL	FATQQFVAL
FAAERDEY	FAAER-DEY
LSNEGHIY	LSNEG-HIY
VLQAPLPPM	VLQAPLPPM
AACGERPTV	AACGERPTV
VGLIRNLAL	VGLIRNLAL
KASEWVQQV	KASEWVQQV
HGFLRQAL	HGFLR-QAL
LSSERQEL	LSSER-QEL
LQQPRPLM	LQQPR-PLM
LTRGYFLEH	LTRGYFLEH
ELYQRIYAF	ELYQRIYAF
FSNKRTTL	FSNKR-TTL
LWLESVRLEY	LESVR-LEY
VAVIHQSL	VAVIH-QSL
FSNFWYHSY	FSNFWYHSY
LATVRSDL	LATVR-SDL
LSQERELPL	LSQERELPL
AAALRQAL	AAALR-QAL
MNSLRKSNT	MNSLRKSNT
LAVDGRLSL	LAVDGRLSL
GAAGVHFIY	GAAGVHFIY
KATTKIQEY	KATTKIQEY
YASQWFLTL	YASQWFLTL
NAQVRGDSY	NAQVRGDSY
YTNTKLEV	YTNTK-LEV
WLQGSQELPR	WLQGS-QEL
LTSERKEM	LTSER-KEM
FSRFKDTAY	FSRFKDTAY
LAIPITNTY	LAIPITNTY
FAYTSRHEI	FAYTSRHEI
LFYERFRAY	LFYERFRAY
FASYRTSF	FASYR-TSF
ASHLGLAR	ASHLG-LAR
AVTASIHVY	AVTASIHVY
VAVWEGRIY	VAVWEGRIY
QSHQRTFVL	QSHQRTFVL
VARLPLLL	VARLP-LLL
ISLEIPQV	ISLEI-PQV
KFHLRPEL	KFHLR-PEL
HTTILRPSY	HTTILRPSY
SLFFRKVPF	SLFFRKVPF
RAGEKGVAY	RAGEKGVAY
FAVSAVVHEY	VSAVV-HEY
RAQDKVHYY	RAQDKVHYY
SSSSRFLEV	SSSSRFLEV
FIQTRGGTF	FIQTRGGTF
RAKDHGLEV	RAKDHGLEV
KSLERATQL	KSLERATQL
YFHDRFLEL	YFHDRFLEL
FAKYWHIIL	FAKYWHIIL
VSVTQRTAF	VSVTQRTAF
KTTKFIKSF	KTTKFIKSF
LFLPGRMAY	LFLPGRMAY
TVFLRSDSY	TVFLRSDSY
SAINEVVTREY	AINEVVREY
YAVNSQFTM	YAVNSQFTM
AASFAVKLF	AASFAVKLF
ASTVRILEV	ASTVRILEV
NIFSEVRVY	NIFSEVRVY
ANMFRFYAL	ANMFRFYAL
NAMGFHVIL	NAMGFHVIL
ASSPHGLVM	ASSPHGLVM
YSRYQTLEL	YSRYQTLEL
LAVSLVKVF	LAVSLVKVF
LFDERKYPY	LFDERKYPY
ISKNMLSL	ISKNM-LSL
ILSPPRPPT	ILSPPRPPT
SASVLPEL	SASVL-PEL
LASESRVY	LASES-RVY
SSSFDPSRTF	SSFDPSRTF
QAVQVRPSL	QAVQVRPSL
VAIAGLMEV	VAIAGLMEV
CSSKPRVEY	CSSKPRVEY
VAFFRENGF	VAFFRENGF
YMADRLLSF	YMADRLLSF
SRIEVLKR	SRIEV-LKR
NLAVSQVVHK	LAVSQVVHK
YSKDRIYTY	YSKDRIYTY
YANLHSKEY	YANLHSKEY
KASVMRLTISY	KASVMRLTI
NAKKILLEM	NAKKILLEM
VATQTDQREM	VATQTDREM
FAKAREAL	FAKAR-EAL
KSHQGVVI	KSHQG-VVI
YAQVARLF	YAQVA-RLF
SSVPGVRLL	SSVPGVRLL
GLEVTITAR	GLEVTITAR
RSRTIVHTL	RSRTIVHTL
LSGRPLKV	LSGRP-LKV
ISNLRDVFY	ISNLRDVFY
TASENTSRVM	TASENTRVM
FADGFVLVY	FADGFVLVY
ISSKREIL	ISSKR-EIL
MASDELKEM	MASDELKEM
NTIDPSHPM	NTIDPSHPM
ITSSSTREY	ITSSSTREY
THLPEVFLSK	HLPEVFLSK
FVKFFIIGV	FVKFFIIGV
DGPLTGTYR	DGPLTGTYR
YSLSSTLTL	YSLSSTLTL
AASFVGYSY	AASFVGYSY
KSQERSMSY	KSQERSMSY
FADYPCHTV	FADYPCHTV
MAVKQGRFY	MAVKQGRFY
YARQGGHHEL	YARQGGHEL
STDVAKTF	STDVA-KTF
SITHVFSLNK	SITHV-FSL
YTIPPGHQV	YTIPPGHQV
YYTYLIMNK	YYTYLIMNK
AAQLRPISL	AAQLRPISL
VSAIKENF	VSAIK-ENF
YSIYVYKVL	YSIYVYKVL
AMAVRIQAY	AMAVRIQAY
TSQFRPVEL	TSQFRPVEL
TSSLRSVCF	TSSLRSVCF
AATPVGKVM	AATPVGKVM
YATQLQNTY	YATQLQNTY
KAHAKAIEM	KAHAKAIEM
YAQEDPRML	YAQEDPRML
FIRKVFLVL	FIRKVFLVL
VAIAKVKLY	VAIAKVKLY
GTAPSKPPL	GTAPSKPPL
ASESISRAY	ASESISRAY
AAYLRIHAV	AAYLRIHAV
TSSKKPAF	TSSKK-PAF
YGLVTYATYPK	YGLVTYATY
VQLKNNPL	VQLKN-NPL
SSAPVPKVM	SSAPVPKVM
TATYGQTAY	TATYGQTAY
FSFGGKLVTF	FSFGGKVTF
VAASLVREF	VAASLVREF
ATPLSTLSL	ATPLSTLSL
YADGESFL	YADGE-SFL
VAQPATAAAY	VAQPATAAY
LATLRNYDY	LATLRNYDY
YAKCQNAL	YAKCQ-NAL
YFQHREFSF	YFQHREFSF
KVASHTPSLL	VASHTPSLL
VASVRPAV	VASVR-PAV
FSASARLY	FSASA-RLY
RAHIKEYFY	RAHIKEYFY
YASNVRRVM	YASNVRRVM
RARGKPMEL	RARGKPMEL
KSLVNLNLL	KSLVNLNLL
RSSPPGHYY	RSSPPGHYY
LSTTVKREL	LSTTVKREL
FSDVEAHF	FSDVE-AHF
IIHEIAVLEL	IIHEIALEL
YLKQDPLEM	YLKQDPLEM
VTHIGRVY	VTHIG-RVY
VSSSHVRVL	VSSSHVRVL
VSQQRALAF	VSQQRALAF
VAAATYKTM	VAAATYKTM
FAYDGKDYLTL	FAYDGKDYL
SAAEVGFVRFF	SAAEVGFVR
MAAEAAALRVY	MAAEA-AAL
SSLSRFLMV	SSLSRFLMV
TAMDWFIAV	TAMDWFIAV
VASNGRTL	VASNG-RTL
TIFSPEGRLY	FSPEG-RLY
KSSDIAKTF	KSSDIAKTF
YGAEIRPSL	YGAEIRPSL
FSSHRDEL	FSSHR-DEL
IASSYMYEM	IASSYMYEM
MAPERVASL	MAPERVASL
YAAQNRQEF	YAAQNRQEF
KAFVFSVAL	KAFVFSVAL
MALVRFVNL	MALVRFVNL
YAYPGVLLI	YAYPGVLLI
SSADIRKAY	SSADIRKAY
VASEVRSGY	VASEVRSGY
FTTDLFGRDL	FTTDLFRDL
VAAVRDAF	VAAVR-DAF
LTGIKHEL	LTGIK-HEL
LSLTRPSM	LSLTR-PSM
AAMTRSSV	AAMTR-SSV
KVMERLIEF	KVMERLIEF
IAISLGKIF	IAISLGKIF
ASKHRIYEY	ASKHRIYEY
RASRGGQVY	RASRGGQVY
IANAVVKEL	IANAVVKEL
SASEAAKKY	SASEAAKKY
FALGSPIAM	FALGSPIAM
LVPFATELHER	FATEL-HER
AAKAALAAF	AAKAALAAF
KLVAASQAALG	VAASQ-AAL
VSTPTLVEVSR	VSTPTLVEV
EHSSLAFWK	EHSSLAFWK
IASATHNIY	IASATHNIY
YAIESQLQL	YAIESQLQL
ISMSHMDL	ISMSH-MDL
KASSVLVI	KASSV-LVI
YSFTHIVPY	YSFTHIVPY
LTVLSQPK	LTVLS-QPK
KSIARVLTV	KSIARVLTV
FGNNKLTTF	FGNNKLTTF
YAAAQKTSL	YAAAQKTSL
AAATHLEV	AAATH-LEV
KTAENFRQF	KTAENFRQF
SASDAIKFV	SASDAIKFV
TPEVDDEALEK	EVDDEALEK
SFLQRITEY	SFLQRITEY
ATSPGRLF	ATSPG-RLF
FAFFDPVMY	FAFFDPVMY
YAVGGRNEL	YAVGGRNEL
FAHDSTRVI	FAHDSTRVI
FAADIPRIL	FAADIPRIL
IANQQQVL	IANQQ-QVL
STFSPDGRVF	FSPDG-RVF
FAHIQAVF	FAHIQ-AVF
VSAAPRTVAL	SAAPRTVAL
NAGIKLENY	NAGIKLENY
FSAMFEHEM	FSAMFEHEM
VAAERATSV	VAAERATSV
AAVAAHRFF	AAVAAHRFF
SAIPVTYVF	SAIPVTYVF
YSLLKSEAL	YSLLKSEAL
VSVHPDYR	VSVHP-DYR
FYAPELLFFAK	YAPEL-LFF
FFQDKARFY	FFQDKARFY
VWKLRIVSY	VWKLRIVSY
LFVQRPEF	LFVQR-PEF
KTNLRRTTY	KTNLRRTTY
YAIHGVLEV	YAIHGVLEV
TAADIFKQY	TAADIFKQY
IAQDFKTDL	IAQDFKTDL
KLPLPLPPRL	LPLPLPPRL
FAIYKMSF	FAIYK-MSF
KAAEAKATL	KAAEAKATL
YSNLGNVY	YSNLG-NVY
YTAVVPLVY	YTAVVPLVY
FTFTRVEL	FTFTR-VEL
SANIGPFL	SANIG-PFL
AFNLRISF	AFNLR-ISF
AAGHRAEL	AAGHR-AEL
FAMDVYKNL	FAMDVYKNL
QANTIFHLF	QANTIFHLF
VAQNSGLTL	VAQNSGLTL
FAQFGHVR	FAQFG-HVR
FARFLNYQL	FARFLNYQL
VSREVSLEL	VSREVSLEL
LFASTILHL	LFASTILHL
FQAFLRTEF	FQAFLRTEF
VAMPYQWEY	VAMPYQWEY
YAFQTEGKLY	FQTEG-KLY
IAAPARSF	IAAPA-RSF
SAKDNQPVL	SAKDNQPVL
AAADRVGPAA	AAADRVPAA
AAGYRVVAL	AAGYRVVAL
FSTVRKEM	FSTVR-KEM
YQTPFNKEV	YQTPFNKEV
TFLTRQAF	TFLTR-QAF
SANNVYLVM	SANNVYLVM
FVGFQPVL	FVGFQ-PVL
LAPLAEDVR	LAPLAEDVR
LSFPTTKTYF	LSFPTTKTY
FFGTHETAF	FFGTHETAF
KSLDQAISRF	KSLDQAISR
LTVQVARVY	LTVQVARVY
MATLLRTSF	MATLLRTSF
RGALRTLSL	RGALRTLSL
FWFFREAF	FWFFR-EAF
KASSPGHPAF	ASSPGHPAF
FSFGYALVY	FSFGYALVY
AVLLRFWAF	AVLLRFWAF
EMMELREAF	EMMELREAF
KAYERNEL	KAYER-NEL
FAQPGSFEY	FAQPGSFEY
ISAARLYYY	ISAARLYYY
FQREFALRL	FQREFALRL
QAGEGRVY	QAGEG-RVY
FSHFYIISV	FSHFYIISV
TTSWIHPVM	TTSWIHPVM
VAVEAVRLL	VAVEAVRLL
YAAPYKSDF	YAAPYKSDF
FSGSRLKL	FSGSR-LKL
FAYDGKDYIAL	FAYDG-KDY
GKWERPFEVK	GKWERPFEV
LTTLRVWCY	LTTLRVWCY
YSFIHEAL	YSFIH-EAL
LSDRFLGF	LSDRF-LGF
KASGPPVSEL	ASGPPVSEL
AAAERMIL	AAAER-MIL
VARVESLEM	VARVESLEM
AACDPRHGRYL	AACDPRHGR
AASNVRGSL	AASNVRGSL
VAAPRWVL	VAAPR-WVL
YITFVKPAF	YITFVKPAF
MSGKKDLY	MSGKK-DLY
ASAKRAQSF	ASAKRAQSF
SAATRNSL	SAATR-NSL
IDSLLENDR	IDSLLENDR
FAGSILAV	FAGSI-LAV
TFIDPRIPL	TFIDPRIPL
ELPEHTVK	ELPEH-TVK
TLQERLLAF	TLQERLLAF
FASQGKTV	FASQG-KTV
HAKMIFMEL	HAKMIFMEL
AAAPQLLIV	AAAPQLLIV
VAQATGRQL	VAQATGRQL
SATGLERTL	SATGLERTL
KAAGVRDVF	KAAGVRDVF
ATEHLSTLSEK	ATEHL-STL
YSTPPHRTV	YSTPPHRTV
LSAMKEFAY	LSAMKEFAY
QGYGRVNVV	QGYGRVNVV
YASKGYRGY	YASKGYRGY
KAADPVPSF	KAADPVPSF
SAVAAIRTL	SAVAAIRTL
YASDEGRVQM	ASDEGRVQM
FGNLRPVL	FGNLR-PVL
VSALFSRIF	VSALFSRIF
RSFPSVREL	RSFPSVREL
FTDDSARTF	FTDDSARTF
FSMEALEL	FSMEA-LEL
KAQDFYVEM	KAQDFYVEM
GSDPRVTQL	GSDPRVTQL
SAAYLPRMW	SAAYLPRMW
LVAASQAALGL	AASQAALGL
GGYTLVSGYPK	YTLVSGYPK
SSVEVRMEF	SSVEVRMEF
AVSNVFKIL	AVSNVFKIL
AAHWRSVNY	AAHWRSVNY
ISTEFIHKL	ISTEFIHKL
TAAMGRVL	TAAMG-RVL
VAVTKSQF	VAVTK-SQF
LSLFRDEVF	LSLFRDEVF
KACVVKREF	KACVVKREF
AADGRLVF	AADGR-LVF
IATSQNRIYL	IATSQNRIY
FAMAGHENL	FAMAGHENL
SVSTITRIY	SVSTITRIY
LSSFRGQEF	LSSFRGQEF
FAGSRSQL	FAGSR-SQL
VSQVLDEL	VSQVL-DEL
FLPARFYQAL	FLPARFQAL
NNATKTFREF	NATKTFREF
YQRDYSLIM	YQRDYSLIM
VELEDWNGR	VELEDWNGR
FIVEETLPL	FIVEETLPL
SATHLNISF	SATHLNISF
YSISERLEM	YSISERLEM
FSNPYSIEY	FSNPYSIEY
SIVHPSYN	SIVHP-SYN
RLTDLVKEY	RLTDLVKEY
VAFSRTDKY	VAFSRTDKY
SARHKAVEF	SARHKAVEF
YTLIGASGQR	TLIGASGQR
YALPHAIL	YALPH-AIL
FAIGVQQL	FAIGV-QQL
FAEDDRIEL	FAEDDRIEL
FAVTVEGKVY	FAVTVEKVY
YARWLPLGL	YARWLPLGL
FTNEGRAL	FTNEG-RAL
YVADPVYRTF	VADPVYRTF
AALPVYQEL	AALPVYQEL
TSSFQPVSM	TSSFQPVSM
TAAPGQKVM	TAAPGQKVM
YAKAVELLV	YAKAVELLV
MASHFDRHY	MASHFDRHY
GTYSTTVTGR	YSTTV-TGR
FGTSHPRYY	FGTSHPRYY
KGLKVMNLL	KGLKVMNLL
RATDYVFRI	RATDYVFRI
AACVKELVF	AACVKELVF
FAIPYAIDV	FAIPYAIDV
RASTQIRAF	RASTQIRAF
RAYPTVKFY	RAYPTVKFY
AARQPIELLSM	AARQPIELL
SISERLEM	SISER-LEM
VIGDVIRVY	VIGDVIRVY
KLVTDLTK	KLVTD-LTK
RANQKLVEY	RANQKLVEY
LSTALSLLY	LSTALSLLY
YFHDRVASF	YFHDRVASF
GKEAFAPL	GKEAF-APL
SIVHPSYNSN	IVHPSYNSN
IAAERWIKF	IAAERWIKF
FLSPLFRFY	FLSPLFRFY
VAIKGAFKVY	VAIKGAKVY
IWFEKRLAY	IWFEKRLAY
LARNNAEVY	LARNNAEVY
ISTVRPQL	ISTVR-PQL
SIIGRLLEV	SIIGRLLEV
YARSVHEEF	YARSVHEEF
FAFEGIGDEDL	FAFEGIEDL
MAMRIPVL	MAMRI-PVL
AANVRKESL	AANVRKESL
KSTTVSHEM	KSTTVSHEM
YSKLGLQY	YSKLG-LQY
VNALRPFYF	VNALRPFYF
AASQPKHVL	AASQPKHVL
RSHPFIKEY	RSHPFIKEY
TYETTLEK	TYETT-LEK
FANNVQLSL	FANNVQLSL
ITLLREISL	ITLLREISL
ATISYILTL	ATISYILTL
LESGVPSR	LESGV-PSR
QTDHTPVHL	QTDHTPVHL
AAVLRHISV	AAVLRHISV
TAHNKVAL	TAHNK-VAL
ITGERLSAY	ITGERLSAY
QIPEIKQTL	QIPEIKQTL
VWFDRRTNY	VWFDRRTNY
VAVDVAVPK	VAVDVAVPK
FTLDPLYREL	FTLDPLREL
CAADQAKQL	CAADQAKQL
EALQGVGDMGR	EALQGVGDM
FLVLRQQQF	FLVLRQQQF
EASPFSRSL	EASPFSRSL
YAIEKVREI	YAIEKVREI
ASYERLDVF	ASYERLDVF
SASHVSKTV	SASHVSKTV
LASEKSEM	LASEK-SEM
KAQLTGGILL	KAQLTGILL
ALALRFLAL	ALALRFLAL
TVALRAAAY	TVALRAAAY
ISSTVQRQL	ISSTVQRQL
FANMLGVSL	FANMLGVSL
KANITFEY	KANIT-FEY
FAGNFERTV	FAGNFERTV
SASGVAKQM	SASGVAKQM
FSIPYIISY	FSIPYIISY
SSNGAKPEL	SSNGAKPEL
MMSEVIRIL	MMSEVIRIL
VVEESELAR	VVEESELAR
SSASLVLKR	SSASLVLKR
AAMPRIYEL	AAMPRIYEL
YSSIQPEEY	YSSIQPEEY
RVKEKADAL	RVKEKADAL
IATTFEHYY	IATTFEHYY
VAAHYLHSL	VAAHYLHSL
RAKELFHEL	RAKELFHEL
VLAIRQQSF	VLAIRQQSF
SAAPAKKPY	SAAPAKKPY
AAASAKLAF	AAASAKLAF
AAKAVANTM	AAKAVANTM
FALVGHLL	FALVG-HLL
KAYHNSPAY	KAYHNSPAY
TASYDTRVY	TASYDTRVY
LGPLVEQGR	LGPLVEQGR
VKSPELQAEAK	KSPELQAEA
GAFERKMSY	GAFERKMSY
MASLLPQL	MASLL-PQL
FAYSSPRTF	FAYSSPRTF
FSSPGGLSL	FSSPGGLSL
VLFLRTFQF	VLFLRTFQF
VALPMVLVL	VALPMVLVL
AAALHYAL	AAALH-YAL
RATFYLNVL	RATFYLNVL
FADREVQL	FADRE-VQL
SASSRMVL	SASSR-MVL
TATRPGVYY	TATRPGVYY
FAPYNKPSL	FAPYNKPSL
FASFIVQYY	FASFIVQYY
VATSFIRTIEL	TSFIRTIEL
TAPLRAEL	TAPLR-AEL
RSNFGYNIPL	RSNFGYIPL
MSTNRQQFY	MSTNRQQFY
LATTERRFY	LATTERRFY
LASYVHYVF	LASYVHYVF
YQQELEREL	YQQELEREL
SAALVSRTF	SAALVSRTF
FAHHGRSL	FAHHG-RSL
AAANPTLAF	AAANPTLAF
SATGLARYY	SATGLARYY
HVLIHNTL	HVLIH-NTL
HNALRILTF	HNALRILTF
AAKFYSFLV	AAKFYSFLV
MAYMRGMYF	MAYMRGMYF
FATIKTVNY	FATIKTVNY
RAREWAKSM	RAREWAKSM
AATLLHLEL	AATLLHLEL
FAAEGCRSL	FAAEGCRSL
YSTSAKVVY	YSTSAKVVY
CTNPNRHQM	CTNPNRHQM
VADPYVVIM	VADPYVVIM
LQSQWLRAY	LQSQWLRAY
LPINGNGKQ	LPINGNGKQ
RAFVGFEY	RAFVG-FEY
YAAIRDNY	YAAIR-DNY
YASENVNKL	YASENVNKL
MTTEILRSM	MTTEILRSM
TSQLIPEM	TSQLI-PEM
MATRVLSM	MATRV-LSM
YAHWKGQVL	YAHWKGQVL
AAAAAALLY	AAAAAALLY
GATKTSRVY	GATKTSRVY
ASAVTVRFY	ASAVTVRFY
FAVTGRSY	FAVTG-RSY
VSSLRLAY	VSSLR-LAY
ATTLLHKVF	ATTLLHKVF
KAIATTVTY	KAIATTVTY
YAMDELRSL	YAMDELRSL
AARPFTQTL	AARPFTQTL
TSMTRVIEV	TSMTRVIEV
RARDLFFAL	RARDLFFAL
LGVYELLLK	LGVYELLLK
KSKDFVQVM	KSKDFVQVM
KTDHRNVEL	KTDHRNVEL
NAMMPGAPL	NAMMPGAPL
SAQDAARIL	SAQDAARIL
YMQFIRLL	YMQFI-RLL
VANNQDKL	VANNQ-DKL
LSDHHVYL	LSDHH-VYL
TSTTRALTF	TSTTRALTF
RAAEPLLTL	RAAEPLLTL
SAKDYFFKA	SAKDYFFKA
LAAQGKEL	LAAQG-KEL
FTDEESRVFL	FTDEESRVF
YANMYSSILTM	YANMYSSIL
RAFGIPIRVY	AFGIPIRVY
TASNWLHLI	TASNWLHLI
IAAVSQEL	IAAVS-QEL
FAIFKVTAY	FAIFKVTAY
ISAPDKRIY	ISAPDKRIY
YFVTREVM	YFVTR-EVM
SISDFFRLF	SISDFFRLF
NASFPKVFI	NASFPKVFI
LFYQRQDTF	LFYQRQDTF
KTFTAAGI	KTFTA-AGI
LARSFFWQV	LARSFFWQV
FAPIQPLAM	FAPIQPLAM
SAPYGRITL	SAPYGRITL
YAYDGKDYL	YAYDGKDYL
KAAGGNLLI	KAAGGNLLI
ASHLRRSQY	ASHLRRSQY
RVLSKAFSRL	VLSKAFSRL
FSRFLNKQPY	FSRFLNQPY
MSRSVALAV	MSRSVALAV
VSNVKSVY	VSNVK-SVY
STSTRTVM	STSTR-TVM
ADREDDPNFFK	ADREDDPNF
LSAEVYRIL	LSAEVYRIL
QAAAVRHVL	QAAAVRHVL
LAAIWFRTY	LAAIWFRTY
IAYIRLTQY	IAYIRLTQY
FTTHILEV	FTTHI-LEV
SGNTFRPEVH	SGNTFRPEV
FAQTLHPSL	FAQTLHPSL
TASTRPSV	TASTR-PSV
QSCGTYLRV	QSCGTYLRV
AFYDPTHAW	AFYDPTHAW
KAKWRQVVL	KAKWRQVVL
SAQFALRLL	SAQFALRLL
VNTEKLTAF	VNTEKLTAF
YAASSYLSL	YAASSYLSL
LSSFVGGLSV	SSFVGGLSV
SSMTRPQEL	SSMTRPQEL
FQVDNNNR	FQVDN-NNR
LASFKILAL	LASFKILAL
FITEIPEL	FITEI-PEL
NSAVRTCGF	NSAVRTCGF
SSMVRDWVM	SSMVRDWVM
VAKEIIYTL	VAKEIIYTL
YFHDATRVY	YFHDATRVY
KAVPEGHEY	KAVPEGHEY
IALPSLRIL	IALPSLRIL
IATPGRLIDFL	IATPG-RLI
IAIPVTVAF	IAIPVTVAF
GDSGGPLIVHK	DSGGP-LIV
YGFEKPSAI	YGFEKPSAI
IAQKKRLTV	IAQKKRLTV
HATFNDPVM	HATFNDPVM
KLADSSRTL	KLADSSRTL
TLLERLFSY	TLLERLFSY
LSGQRPAL	LSGQR-PAL
FISIPKMEV	FISIPKMEV
AAFCKLIVY	AAFCKLIVY
IAMDLILKM	IAMDLILKM
YSSERSVL	YSSER-SVL
IARNYYPMV	IARNYYPMV
LALLGTIY	LALLG-TIY
ISIYRPIDY	ISIYRPIDY
FAYEGPMYL	FAYEGPMYL
AAADIFKHY	AAADIFKHY
AELQEGAR	AELQE-GAR
FQNPFRSEL	FQNPFRSEL
LQSEVIRHY	LQSEVIRHY
KMFLRGTFY	KMFLRGTFY
YSLTKSHEM	YSLTKSHEM
ISNLGKVM	ISNLG-KVM
VASFPRTV	VASFP-RTV
HSCFRFITF	HSCFRFITF
RISGVDRYY	RISGVDRYY
SAARLTMM	SAARL-TMM
STTTGHLIY	STTTGHLIY
AGSALPRLY	AGSALPRLY
IASPVIAAV	IASPVIAAV
RRFLAARTL	RRFLAARTL
AASPNAEIHIL	AASPN-AEI
TSSPNRLVY	TSSPNRLVY
SLAPTAAAK	SLAPTAAAK
HGGLYHENMR	HGGLYHENM
ISIHRPLAY	ISIHRPLAY
YSYAGGRGSY	YAGGR-GSY
LSYTRFSL	LSYTR-FSL
FAYDGKDYL	FAYDGKDYL
VAIAAARVW	VAIAAARVW
ISTPNVNAL	ISTPNVNAL
FAAEAIAL	FAAEA-IAL
IAQNRRLTL	IAQNRRLTL
FSYVSPEL	FSYVS-PEL
VACGSHHSM	VACGSHHSM
SAISSVRLY	SAISSVRLY
TSSKPRTM	TSSKP-RTM
KARLPLRL	KARLP-LRL
YANLMLLTL	YANLMLLTL
FFKDRHWL	FFKDR-HWL
YSYVRPERL	YSYVRPERL
AWRRRAALGL	AWRRR-AAL
FANERLQHY	FANERLQHY
NATRRPQM	NATRR-PQM
VARPAPVAV	VARPAPVAV
VTSPLTVEW	VTSPLTVEW
AASLRCQNY	AASLRCQNY
QELSEAEQATR	LSEAEQATR
RVKGPGISKF	RVKGPGISK
HSFFKISY	HSFFK-ISY
AAASERLQL	AAASERLQL
MQAPGRGPL	MQAPGRGPL
LSNMGTRGSY	LSNMGTGSY
SVTELDRVY	SVTELDRVY
FGLARIYSF	FGLARIYSF
LANQRKEM	LANQR-KEM
RATSFLLAL	RATSFLLAL
VAIQSVRCY	VAIQSVRCY
AASRQPEL	AASRQ-PEL
NSKVGNEF	NSKVG-NEF
KLADRVLAL	KLADRVLAL
FTNPKVREW	FTNPKVREW
SAAAFYYVF	SAAAFYYVF
NSFTHEAL	NSFTH-EAL
TSTGVIRDF	TSTGVIRDF
RLHLRPVAF	RLHLRPVAF
IAKNVFLHL	IAKNVFLHL
FAMPSSTPL	FAMPSSTPL
FARVPLAL	FARVP-LAL
YTSEGVRYF	YTSEGVRYF
SGSGLVGR	SGSGL-VGR
SANNRAEYY	SANNRAEYY
FGLARAFSL	FGLARAFSL
EFQLFSSPHGK	LFSSP-HGK
FYVEHPEV	FYVEH-PEV
MAAAPRTVLI	AAAPR-TVL
AVILRALSL	AVILRALSL
FSSERIDW	FSSER-IDW
SSLVHPEL	SSLVH-PEL
NSTVRKQAM	NSTVRKQAM
SAIAVFLVL	SAIAVFLVL
LLPHANEVSQK	HANEV-SQK
KSMFQRTTY	KSMFQRTTY
HQRTFVLEV	HQRTFVLEV
AGYYRKYFY	AGYYRKYFY
FSSVGEEF	FSSVG-EEF
VATELPCHHY	VATELPHHY
SSSRPLKV	SSSRP-LKV
STNIHELRV	STNIHELRV
AMYSRKAMY	AMYSRKAMY
FAAYWKPVL	FAAYWKPVL
FMSRTNRPPL	MSRTNRPPL
IAINISRNL	IAINISRNL
FSTKHFQEY	FSTKHFQEY
LSSTLTLK	LSSTL-TLK
IAAQKREEY	IAAQKREEY
SAAPLPRLA	SAAPLPRLA
YAGKISQM	YAGKI-SQM
ATPAGDIMEL	PAGDI-MEL
LAVALNRSY	LAVALNRSY
VLHVKTESL	VLHVKTESL
VAFIRAEY	VAFIR-AEY
MALPEEYRDY	ALPEEYRDY
NAKHNVHVM	NAKHNVHVM
AAAHTHPVY	AAAHTHPVY
VAVMTVREL	VAVMTVREL
LAAAVHKEM	LAAAVHKEM
VFHDRRLQY	VFHDRRLQY
RATTREVM	RATTR-EVM
VSALRQEL	VSALR-QEL
KATEYGLAY	KATEYGLAY
SARFRPFTF	SARFRPFTF
YARYHRPEF	YARYHRPEF
YFINRSWEW	YFINRSWEW
FALHKTLEF	FALHKTLEF
IASERAAAL	IASERAAAL
VSMLRILFL	VSMLRILFL
RAGSRVAY	RAGSR-VAY
FGSLPKVAL	FGSLPKVAL
YARSSNLIM	YARSSNLIM
FAGLVPRL	FAGLV-PRL
LGNVRPLL	LGNVR-PLL
KPELNIIAL	KPELNIIAL
GGYAEVGR	GGYAE-VGR
VASEKPSF	VASEK-PSF
KAFLLVQDI	KAFLLVQDI
KAADACRYL	KAADACRYL
MFPLVKSAL	MFPLVKSAL
VAGTPGRVF	VAGTPGRVF
AASLRLTL	AASLR-LTL
FSKDWSFYL	FSKDWSFYL
GAYPTQPGQGY	YPTQPGQGY
TGMVRETVF	TGMVRETVF
FAEAVKTVF	FAEAVKTVF
FGAVQVTPL	FGAVQVTPL
VASVHQDL	VASVH-QDL
VAALSKIF	VAALS-KIF
KLPGNISSL	KLPGNISSL
LSSCYSRVY	LSSCYSRVY
AFFVREALF	AFFVREALF
VSTWRPVEL	VSTWRPVEL
IASTLVHKF	IASTLVHKF
RSATREPPY	RSATREPPY
AVAERLWEY	AVAERLWEY
YAHFRRLDY	YAHFRRLDY
FATTNQISL	FATTNQISL
QAAMRLYVM	QAAMRLYVM
IAISGTFAY	IAISGTFAY
NTLFRFWSF	NTLFRFWSF
SSQKRHWTF	SSQKRHWTF
YSTIRPYL	YSTIR-PYL
IFKERESF	IFKER-ESF
LADRESAL	LADRE-SAL
YTRPDRPEY	YTRPDRPEY
FAKEHQEFL	FAKEHQEFL
VAAPQLPVL	VAAPQLPVL
QAMERYVSM	QAMERYVSM
FAQIVLPAL	FAQIVLPAL
LLAARLVTF	LLAARLVTF
SAQTTSHEL	SAQTTSHEL
FAISILQQI	FAISILQQI
LSPLGEEMR	LSPLGEEMR
HNSWQVVAM	HNSWQVVAM
AALWRFAEL	AALWRFAEL
MSMTGVSF	MSMTG-VSF
LSTFRKHSL	LSTFRKHSL
VATWFNQPA	VATWFNQPA
FSPVGSVL	FSPVG-SVL
AASLQVLEM	AASLQVLEM
YAAEGQKL	YAAEG-QKL
LASFIPAV	LASFI-PAV
IFSQKPEF	IFSQK-PEF
FACEQNLL	FACEQ-NLL
TTWTRPIM	TTWTR-PIM
VATDHKAFY	VATDHKAFY
KSSGKFFTY	KSSGKFFTY
NVRPVPLEL	NVRPVPLEL
YSTTSIASV	YSTTSIASV
VLPEHVSVL	VLPEHVSVL
LEALKENGGAR	ALKENGGAR
TIREFFILL	TIREFFILL
MARANARLF	MARANARLF
KAYHEQLSV	KAYHEQLSV
MANGEIHIY	MANGEIHIY
VAVILMRVL	VAVILMRVL
FAIDKTIAY	FAIDKTIAY
IAAHGVRVL	IAAHGVRVL
YATKPKKM	YATKP-KKM
SAASRPVL	SAASR-PVL
YAQFLREM	YAQFL-REM
FVKPEFLLL	FVKPEFLLL
LAGLQQEL	LAGLQ-QEL
ASLGKNPTDEY	LGKNPTDEY
FSATPRYM	FSATP-RYM
VAKGPSHSL	VAKGPSHSL
ASVDKVLEL	ASVDKVLEL
QGYLRSVF	QGYLR-SVF
YGTPRAATV	YGTPRAATV
FIRPGNAL	FIRPG-NAL
QALPQVRLY	QALPQVRLY
KRFSGTVRL	KRFSGTVRL
TVWAYFRVM	TVWAYFRVM
SAALKTSSF	SAALKTSSF
SAASEQHVF	SAASEQHVF
LALLGQTF	LALLG-QTF
YASPADRQL	YASPADRQL
FTTLKPEL	FTTLK-PEL
YGNERFIQY	YGNERFIQY
RPATLLGCLL	ATLLG-CLL
FAGQMAAL	FAGQM-AAL
MIRAAPPPL	MIRAAPPPL
FALDMKYAL	FALDMKYAL
KSQDVRQAL	KSQDVRQAL
AAQSPYRAV	AAQSPYRAV
YAKIYPDPEL	YAKIYPPEL
LFSERIDVF	LFSERIDVF
NTAVPREM	NTAVP-REM
GSFDVADRMF	SFDVADRMF
VATCRPDEF	VATCRPDEF
LGVERASSL	LGVERASSL
SVRPVPLEV	SVRPVPLEV
AASEVLKHL	AASEVLKHL
YAGGRGSY	YAGGR-GSY
LVEPEGIEK	LVEPEGIEK
YSSSRTLLF	YSSSRTLLF
ISSPPFRAI	ISSPPFRAI
FLYGRLYEF	FLYGRLYEF
AASVSLHLL	AASVSLHLL
VSVTHPEL	VSVTH-PEL
FITNPRTL	FITNP-RTL
HATQAIFEI	HATQAIFEI
HLPSGVKSL	HLPSGVKSL
KGSSAVRVY	KGSSAVRVY
FAGDRDQYIL	FAGDR-DQY
AAVDYQKVV	AAVDYQKVV
KSNPKPLVL	KSNPKPLVL
YVPDQPHPEI	YVPDQPPEI
AATDIARQV	AATDIARQV
RLFPNLPEL	RLFPNLPEL
RTSTAKPAL	RTSTAKPAL
TITSYIKEM	TITSYIKEM
VMAPRTLIL	VMAPRTLIL
SAIPHPLIM	SAIPHPLIM
FSGARNQL	FSGAR-NQL
HATTYIPLM	HATTYIPLM
VANLKETGY	VANLKETGY
RSIEKSNSV	RSIEKSNSV
QAIGAIRTL	QAIGAIRTL
FVIQLGRIY	FVIQLGRIY
ASGLIHRV	ASGLI-HRV
SASPWALTI	SASPWALTI
QANSPRPAM	QANSPRPAM
VSLLREVQY	VSLLREVQY
SASESILEL	SASESILEL
ESQLRSYSF	ESQLRSYSF
IATEIILEI	IATEIILEI
RASEVERQL	RASEVERQL
SFMTHPEF	SFMTH-PEF
ATYVFLHTV	ATYVFLHTV
ILLCVLIL	ILLCV-LIL
RTSPALKTTRL	SPALKTTRL
TAQSHQRTF	TAQSHQRTF
MNVVRNLTY	MNVVRNLTY
ISTASGDGRHY	TASGDGRHY
SASNMAIVDVK	ASNMAIVDV
YGQFRVVSW	YGQFRVVSW
ILSGVIRSV	ILSGVIRSV
SAADASRVL	SAADASRVL
VATFRQIL	VATFR-QIL
YYHARVYEF	YYHARVYEF
HAHNMRVM	HAHNM-RVM
YSQEVRDLF	YSQEVRDLF
AAAVLFRM	AAAVL-FRM
ALTEWLRFY	ALTEWLRFY
HSSIRSLEV	HSSIRSLEV
VDGVEVHNAK	DGVEVHNAK
AARLRAVDF	AARLRAVDF
VNIMRTYTY	VNIMRTYTY
LAEFAFSLYR	LAEFAFSLY
FAGQQQQF	FAGQQ-QQF
AATRWAKKI	AATRWAKKI
HAAAYRNAL	HAAAYRNAL
AAATHPRAF	AAATHPRAF
FATSVLRWI	FATSVLRWI
LSAFLPARFY	SAFLPARFY
FSYTGRVAV	FSYTGRVAV
DISEVVTPR	DISEVVTPR
FWAPVPRVL	FWAPVPRVL
HMTAVVKLF	HMTAVVKLF
FFFSHVGW	FFFSH-VGW
FTGEKELEF	FTGEKELEF
HSHPRVVEL	HSHPRVVEL
LAFGDRIAL	LAFGDRIAL
AVRPKVLM	AVRPK-VLM
MAVLLGKVY	MAVLLGKVY
VTIVKPIVY	VTIVKPIVY
KASEPKEVM	KASEPKEVM
TAAPPAQPL	TAAPPAQPL
YSQEPIKTF	YSQEPIKTF
YMREPILDL	YMREPILDL
AWMDNIREW	AWMDNIREW
QALKHLKQY	QALKHLKQY
RVYKEVKNRL	VYKEVKNRL
VAYMNPIAM	VAYMNPIAM
FFAERLYY	FFAER-LYY
ITFEGKVAF	ITFEGKVAF
IASDGLKGRVF	ASDGLKRVF
VATWFNQPAR	VATWFNPAR
VAKPNFVVM	VAKPNFVVM
AAVDLKPTL	AAVDLKPTL
QAALRRTM	QAALR-RTM
VADPIIYVL	VADPIIYVL
NTTDRPHAF	NTTDRPHAF
LVAASQAAL	LVAASQAAL
FAQVFHLIL	FAQVFHLIL
IATLRVAL	IATLR-VAL
DAVPHPRFY	DAVPHPRFY
KAVTKEEF	KAVTK-EEF
GSFPWQAK	GSFPW-QAK
KTKEVYELL	KTKEVYELL
TTQKARFEM	TTQKARFEM
SSSLRVLVY	SSSLRVLVY
FYHPEKEDGK	YHPEKEDGK
HAGNKLAM	HAGNK-LAM
VTIKPAPETEK	VTIKPAPET
YAQSKGIYY	YAQSKGIYY
YASPAKLESI	YASPAKLES
HSCPKTIVF	HSCPKTIVF
LAKPPVVSV	LAKPPVVSV
SITERYRIY	SITERYRIY
VASTTRKEL	VASTTRKEL
YFLNRKLVY	YFLNRKLVY
ISLYFFSYI	ISLYFFSYI
RAIVRQAM	RAIVR-QAM
FAFLRFVVY	FAFLRFVVY
FAMQLVKIL	FAMQLVKIL
NFHWRDWTY	NFHWRDWTY
KACVKTYHY	KACVKTYHY
AAAELRAV	AAAEL-RAV
AAAYGRSPM	AAAYGRSPM
TSAPTGHTF	TSAPTGHTF
NASRKLEM	NASRK-LEM
FACEKNENL	FACEKNENL
AAAEPKLF	AAAEP-KLF
VADGYPVRL	VADGYPVRL
HFNPKIESY	HFNPKIESY
VATTRIETM	VATTRIETM
AAQAHTREL	AAQAHTREL
VSTFGSRAY	VSTFGSRAY
TSLVHPVM	TSLVH-PVM
AAGKPRVL	AAGKP-RVL
LARPLVLAL	LARPLVLAL
DHAVDLIQK	DHAVDLIQK
AAHTRQEL	AAHTR-QEL
FTSQVIRNL	FTSQVIRNL
SAAFQREV	SAAFQ-REV
AASEEARSL	AASEEARSL
LSQAREHQL	LSQAREHQL
MAAYQLEL	MAAYQ-LEL
MASQRTEL	MASQR-TEL
IITAFIRAL	IITAFIRAL
TANNDHTVL	TANNDHTVL
VFQLRDSVY	VFQLRDSVY
YTTFVKPAF	YTTFVKPAF
FFTDAERRSV	FTDAERRSV
VAAEKKVV	VAAEK-KVV
FLTVTRLYF	FLTVTRLYF
FAIETELIY	FAIETELIY
DRVYIHPF	DRVYI-HPF
FFSDARELESF	FFSDA-REL
FSQIGELY	FSQIG-ELY
YASDFHNVL	YASDFHNVL
YASFTRAY	YASFT-RAY
YGADALRLY	YGADALRLY
TGIARVPL	TGIAR-VPL
SQSLRVDSF	SQSLRVDSF
FAANHQEF	FAANH-QEF
RAELVQLV	RAELV-QLV
FSSEACREL	FSSEACREL
VATDFFTVL	VATDFFTVL
SQTPVLREL	SQTPVLREL
QALDYFLKM	QALDYFLKM
SATTRMVL	SATTR-MVL
NSTVRLYEW	NSTVRLYEW
FNFVGKIL	FNFVG-KIL
HFNTRLSF	HFNTR-LSF
SITRLIKKY	SITRLIKKY
QSNPKVMNL	QSNPKVMNL
TASEMILVL	TASEMILVL
RIAEFAFEY	RIAEFAFEY
KASDLYITL	KASDLYITL
FSGVKDVY	FSGVK-DVY
FASPTQVFF	FASPTQVFF
FGTIRTIDY	FGTIRTIDY
YAVPSAGLRLF	YAVPSALRL
ISARGPSPL	ISARGPSPL
PTTKTYFPHF	TTKTYFPHF
SITSVFITK	SITSVFITK
SAAGLHRAL	SAAGLHRAL
VAAVKWVM	VAAVK-WVM
LAAVKAIAW	LAAVKAIAW
VLGNGSSLSL	LGNGSSLSL
YVHELSLEM	YVHELSLEM
MGYIRNVAY	MGYIRNVAY
FTPAVHASL	FTPAVHASL
HARTITVAL	HARTITVAL
HIQKEDVPSER	IQKEDVSER
IALVHTDSY	IALVHTDSY
AAAAVARLW	AAAAVARLW
YSMVGRTV	YSMVG-RTV
VATMRSVNY	VATMRSVNY
VSHLQPLM	VSHLQ-PLM
RTTPGTLARF	RTTPGTLAR
AAKQVLLYL	AAKQVLLYL
YAFSKLTY	YAFSK-LTY
FTYLEINPL	FTYLEINPL
SALDVGLTM	SALDVGLTM
ITTLRTVL	ITTLR-TVL
SAAAIFKIY	SAAAIFKIY
FSVISVVSY	FSVISVVSY
TSYVRTTI	TSYVR-TTI
VTSTSLTIKS	VTSTSLTIK
FALTNGIYPH	FALTN-GIY
YSRTPGQVL	YSRTPGQVL
YAANPHSF	YAANP-HSF
FTSSMRGMDAV	FTSSM-RGM
LARFNAREF	LARFNAREF
VAAAVVRAL	VAAAVVRAL
KTKDGVREV	KTKDGVREV
AAAAAQSVY	AAAAAQSVY
RAAEQQRAY	RAAEQQRAY
SALFLGVAY	SALFLGVAY
VSTVLTSKY	VSTVLTSKY
YVTTSTRTY	YVTTSTRTY
MASPGKDNY	MASPGKDNY
YAVNSRPPL	YAVNSRPPL
TALPRIFSL	TALPRIFSL
VASALWRHF	VASALWRHF
VAAPPTAVGSL	VAAPP-TAV
KSSLRNAAY	KSSLRNAAY
AAAYGRCV	AAAYG-RCV
LFIIAGFNTL	FIIAGFNTL
ISNPYSRKV	ISNPYSRKV
AAKIGNLEM	AAKIGNLEM
RLALRTVYY	RLALRTVYY
