Data	Data aligned
QPWRGGAGA	QPWRGGAGA
KPKVMEGTVAA	KVMEGTVAA
RPALVEQTAA	RPALEQTAA
YPNFSLPAA	YPNFSLPAA
RPWKGVLMV	RPWKGVLMV
TPMPPISSV	TPMPPISSV
KAQLQQVEA	KAQLQQVEA
GPFPGKFNEV	GPFPKFNEV
TPHLRNLAVA	TPHLNLAVA
VPAPSPLSA	VPAPSPLSA
HPSHVQLKVVA	HPSHQLKVV
LPRRPLPPAA	LPRRLPPAA
NPFGGASHA	NPFGGASHA
SPVTLTKGTSA	SPVTKGTSA
NPLFIPVAV	NPLFIPVAV
RPSHFLNFA	RPSHFLNFA
IPLYLKGGVA	IPLYKGGVA
SPFGLKPRSA	SPFGKPRSA
RPYSHALVA	RPYSHALVA
RPVLPRTEAA	RPVLPRTEA
APVAVEPGAAV	APVAVEPGA
APAPVIISSSA	APAPVIISS
RPRFVSLRA	RPRFVSLRA
LPTKDLLSA	LPTKDLLSA
KPVEVTESA	KPVEVTESA
LPFRVIPLV	LPFRVIPLV
APFQTSQASA	APFQSQASA
APSKATLIEA	APSKTLIEA
HPFYTRAA	HPF-YTRAA
KPKPPPVRA	KPKPPPVRA
RPRTEVSLSA	RPRTVSLSA
LPVDKAFYEA	LPVDAFYEA
RPLPGALGVAA	LPGALGVAA
MPLHVAPLLAA	MPLHPLLAA
KPMEGWIAVTV	KPMEGWIAV
RPQSETNVA	RPQSETNVA
HPIHIIPAS	HPIHIIPAS
KPMEIARIVA	KPMEARIVA
QPSEVLRTV	QPSEVLRTV
KPLKEFVEA	KPLKEFVEA
VPSPVAISA	VPSPVAISA
VPVGIAGFAA	VPVGAGFAA
SPLLHNPSA	SPLLHNPSA
YPRTPEERAA	YPRTEERAA
VPSYPSKSA	VPSYPSKSA
MPFPNIRSA	MPFPNIRSA
MPQIPVASV	MPQIPVASV
QVHPDTGISSK	QVHPTGISS
RPPGFSPFR	RPPGFSPFR
YPFKNLPTA	YPFKNLPTA
NHPYLFPVAA	HPYLFPVAA
APTAIKAA	APT-AIKAA
AAVPTNIIAA	AAVPNIIAA
SPFPDIPKV	SPFPDIPKV
VPIKPLPNV	VPIKPLPNV
TPQGHVAVA	TPQGHVAVA
SPFGTITSA	SPFGTITSA
SPVGNRVTV	SPVGNRVTV
RPLQDYGISV	RPLQYGISV
RPWLRPAA	RPW-LRPAA
SPTFQHAV	SPT-FQHAV
MPNPQLNIKA	MPNPLNIKA
SPQAPTLQV	SPQAPTLQV
RPRDLEDFFSA	RPRDDFFSA
HPLLRPPPSA	HPLLPPPSA
RPRDEVQEV	RPRDEVQEV
VPIRLIINA	VPIRLIINA
APNLQNQQV	APNLQNQQV
IAPTGHSL	IAP-TGHSL
KPGSPYRSV	KPGSPYRSV
VPLFVQHDA	VPLFVQHDA
RPHPLPAER	RPHPLPAER
LVAPPLPAA	LVAPPLPAA
TPRPLTSARA	TPRPTSARA
MPVQFKPKSA	MPVQKPKSA
SPAALKPPA	SPAALKPPA
APITGQVSA	APITGQVSA
SPIENIQRVAA	SPIEIQRVA
KPATLTTTSA	KPATTTTSA
KPALKIPQT	KPALKIPQT
IPFSKPVKV	IPFSKPVKV
IPFGIFSRA	IPFGIFSRA
LPHGAISEDQA	LPHGAISED
VPAGGAVAV	VPAGGAVAV
KPTETLLNTV	KPTELLNTV
IPVTEIAIAA	IPVTIAIAA
KPKPIGKLA	KPKPIGKLA
LPAQSGSHAA	LPAQGSHAA
IPMKIRNVSA	IPMKRNVSA
KPVEAAVVA	KPVEAAVVA
VPQAKPVAV	VPQAKPVAV
VPIVPQAPAA	VPIVQAPAA
VPAGSGLSA	VPAGSGLSA
VPTPIHPIF	VPTPIHPIF
LPRDVLTRA	LPRDVLTRA
MPQSGTGVSV	MPQSTGVSV
RPNSLVGITS	RPNSVGITS
HPTEDLVVSA	HPTELVVSA
AAGPPLVAA	AAGPPLVAA
YSFYLPIAA	YSFYLPIAA
QPFESYITA	QPFESYITA
MPSKVNYQA	MPSKVNYQA
APRTPEVRAA	APRTEVRAA
IPAQISPEGRA	IPAQISPEG
QVMQGMGVSA	QVMQMGVSA
APSRVVVVA	APSRVVVVA
APGYSYTAA	APGYSYTAA
MPRDILIVV	MPRDILIVV
RPWEKTDKGA	RPWETDKGA
QPLPVILHV	QPLPVILHV
SPSTVIHGA	SPSTVIHGA
TPIGVQAEA	TPIGVQAEA
APVNVTTEV	APVNVTTEV
VPHRSYVST	VPHRSYVST
LVGPVLGAA	LVGPVLGAA
KPFYQKREV	KPFYQKREV
SPRPPLISV	SPRPPLISV
RPAEKLSTA	RPAEKLSTA
RASLEVTQQQA	ASLETQQQA
IPQLMKEEA	IPQLMKEEA
RPQDIIVFV	RPQDIIVFV
SPLPAHPSV	SPLPAHPSV
FPPTFAIPQA	PPTFAIPQA
KPLEPVSTV	KPLEPVSTV
RPAPHFERTA	RPAPFERTA
APMPTASTA	APMPTASTA
SPSEPGRAV	SPSEPGRAV
TPMSVLQQA	TPMSVLQQA
QPQAPGVEA	QPQAPGVEA
FPGEQFKPA	FPGEQFKPA
RPWYSHPVYA	RPWYHPVYA
HPREVVILA	HPREVVILA
VPLIAIMA	VPL-IAIMA
APTSAGKTLVA	APTSGKTLV
SPLSTPTSAQA	SPLSTPTSA
LPVDAVISV	LPVDAVISV
APDGSLILVSA	APDGILVSA
RPVHPALPFA	RPVHALPFA
ASPHAHISEQA	SPHAISEQA
TPTPVPVV	TPT-PVPVV
APGPAPPVSA	APGPPPVSA
APFPFPQLA	APFPFPQLA
VPSLFSKSA	VPSLFSKSA
RPAPVAVAAAA	RPAPVAVAA
KPQNILVTS	KPQNILVTS
HPYLFPVAAM	HPYLFPVAA
VPAVTLVA	VPA-VTLVA
HPSPVVLKV	HPSPVVLKV
APGPATREA	APGPATREA
RPRTAGPAV	RPRTAGPAV
LPFSSMPTA	LPFSSMPTA
KPVVTPFGQVA	VVTPFGQVA
KPKGTFKDYV	KPKGFKDYV
SPHPSPLGA	SPHPSPLGA
KPTHFTVNA	KPTHFTVNA
LPHSHDVSA	LPHSHDVSA
APHDFANIKA	APHDANIKA
VPWMPPGKSSA	MPP-GKSSA
VPSPRLAAA	VPSPRLAAA
SPHGYLSDVA	SPHGLSDVA
APAAAVVRAA	APAAVVRAA
APGKNFQQA	APGKNFQQA
IPVESIEEV	IPVESIEEV
HPWETVTTA	HPWETVTTA
MPLSVFPYYA	MPLSFPYYA
TPHFSGLAA	TPHFSGLAA
KPFLLPVEA	KPFLLPVEA
KPQPSILQA	KPQPSILQA
TPFTGPFISV	TPFTPFISV
SPESPVLAA	SPESPVLAA
LPHPIIVSI	LPHPIIVSI
KPMQPGPHVV	KPMQPGPHV
PSLSSLPAGAA	LSSLPAGAA
MPTRPGEQA	MPTRPGEQA
GPWVGTGLAA	GPWVTGLAA
VPKAQKETV	VPKAQKETV
KPLYLARVT	KPLYLARVT
TQARAPVTAA	QARAPVTAA
KPHDIFEAN	KPHDIFEAN
MPAGSFITA	MPAGSFITA
TAYKPKYFTSA	KPK-YFTSA
RPFKGEVVDA	RPFKEVVDA
APAAPLQVHA	APAALQVHA
TPFKGVRKA	TPFKGVRKA
IPATPGIGA	IPATPGIGA
TPTKGGWKV	TPTKGGWKV
LPAPPAVSA	LPAPPAVSA
RPITPPRNSA	RPITPRNSA
MPQSIVEA	MPQ-SIVEA
ISPTGHSL	ISP-TGHSL
SPFENTENA	SPFENTENA
SVPSNPVAA	SVPSNPVAA
KPHAEGAAVVA	KPHAEGAAV
YPIALTRA	YPI-ALTRA
VPNDKYYGA	VPNDKYYGA
KPLKGARIA	KPLKGARIA
LPASNLAGKEA	LPASAGKEA
VPYPPLLRA	VPYPPLLRA
KPSELLKAEA	KPSELKAEA
VPHRATVYA	VPHRATVYA
APRTVALTA	APRTVALTA
KPYAHILSV	KPYAHILSV
QPFSKPVSV	QPFSKPVSV
MPNHIHMGA	MPNHIHMGA
SPLDMKDGFLA	SPLDMKDGF
TPYNYPVPV	TPYNYPVPV
KPSVNSFISA	KPSVSFISA
RPRPGTGLG	RPRPGTGLG
LAAARLAAA	LAAARLAAA
HPLFQAKSA	HPLFQAKSA
RPKPPNVRT	RPKPPNVRT
SPHPAIQPLQA	HPAIQPLQA
SPILVATAVAA	SPILVATAV
KPFAYVSEA	KPFAYVSEA
TPMSAQGVQA	TPMSQGVQA
KPSDPAPKV	KPSDPAPKV
RPYFPKDEA	RPYFPKDEA
FPWPQPLST	FPWPQPLST
YPHGWVETA	YPHGWVETA
NPFKGSSGA	NPFKGSSGA
APAEPGWKA	APAEPGWKA
QPQPQPYAV	QPQPQPYAV
VPNAGILPLV	VPNAILPLV
APFVPVGIAG	APFVPVGIA
VPSAVLIVA	VPSAVLIVA
VPIEVLPTVL	VPIEVLPTV
RPVQRLPSV	RPVQRLPSV
KPKIPKGVS	KPKIPKGVS
GPWVGTGLAAA	GPWVTGLAA
APVVLVGDHA	APVVVGDHA
SPFHFQPSAA	SPFHFQPSA
SPYAAMLAA	SPYAAMLAA
RPYVHKILV	RPYVHKILV
HPFDLGLYNEA	HPFDLYNEA
LVYQGYLAA	LVYQGYLAA
RPVHHVVPP	RPVHHVVPP
SPLSAAAATAA	SPLSAAATA
YPAAVPQALSA	AAVPQALSA
SPFSGLQKA	SPFSGLQKA
YPSTAVRHMA	YPSTVRHMA
KPRPPPPPP	KPRPPPPPP
APHVPATGA	APHVPATGA
APNPVVFVA	APNPVVFVA
SPKQILDSAA	SPKQILDSA
AVPRPGAPA	AVPRPGAPA
MPAGLIAGA	MPAGLIAGA
KPLDLRPKKT	KPLDRPKKT
IPKHINPVA	IPKHINPVA
MPILIDFHA	MPILIDFHA
SPRVPNSSV	SPRVPNSSV
SPAQVIPLA	SPAQVIPLA
SPMSQTETV	SPMSQTETV
RALLQAQQA	RALLQAQQA
SPAHVLLAA	SPAHVLLAA
APNRFWASVEP	APNRFWASV
RPHSASAARP	RPH-SASAA
HPYRLILTVA	HPYRILTVA
RPLSGSGISA	RPLSSGISA
KPAGPLGATA	KPAGLGATA
LPHSAGRYAA	LPHSGRYAA
MPTQPQVQA	MPTQPQVQA
SPLPTPFGA	SPLPTPFGA
APELQGVEV	APELQGVEV
KPKEPPKVP	KPKEPPKVP
MPYSGMTGA	MPYSGMTGA
SPSAAITVQRV	SPS-AAITV
KAINVFVSA	KAINVFVSA
MPHSIMRVDIA	MPH-SIMRV
RPSFVHPGA	RPSFVHPGA
LPHNTHRVV	LPHNTHRVV
KPANVFITA	KPANVFITA
RPLSRLQAA	RPLSRLQAA
HPHLVAEA	HPH-LVAEA
KPPPPPPAP	KPPPPPPAP
AVKKNPGIAA	AVKKPGIAA
RPFVAINYA	RPFVAINYA
APVTGMVSG	APVTGMVSG
KPFQPALPLVV	KPFQALPLV
RPYEPINSI	RPYEPINSI
SPILVATAV	SPILVATAV
KVNENLTKFIA	KVNENLTKF
MPYLIGVHA	MPYLIGVHA
HPWLFIEEA	HPWLFIEEA
MPYFLLTQA	MPYFLLTQA
IPYQDYFYTA	IPYQYFYTA
TVTEKPEVID	TVTEKPEVI
NPYFPGQAIA	NPYFGQAIA
IPYDQSGFVSA	IPYDGFVSA
ETQITQIEHEV	QITQIEHEV
VPTEPLPAP	VPTEPLPAP
YPLEKVAEA	YPLEKVAEA
NSVPSNPVAA	VPS-NPVAA
APQPAAPVGA	APQPAPVGA
APMPYLIGVHA	MPYLIGVHA
KPAPVIHPA	KPAPVIHPA
IPTEVRSKA	IPTEVRSKA
PYLFPVAA	PYL-FPVAA
APYTHFTQA	APYTHFTQA
HPLASFSFTSA	LASFSFTSA
SPRPVVVET	SPRPVVVET
VAVLQEVAA	VAVLQEVAA
SPKDVILKV	SPKDVILKV
VPVSTINHA	VPVSTINHA
RPYDKNISP	RPYDKNISP
HPYKHSFRA	HPYKHSFRA
SPHPPSEVTA	SPHPSEVTA
KPKIFIIQA	KPKIFIIQA
KPNPNQIISV	KPNPQIISV
TPAKAIAAV	TPAKAIAAV
VPNYKLITPA	VPNYLITPA
TPFTAIREA	TPFTAIREA
KPVLPHKVA	KPVLPHKVA
HPQPGSANSL	HPQPSANSL
LPELLGLEA	LPELLGLEA
NPGVPVPAA	NPGVPVPAA
APHPGLSEA	APHPGLSEA
APYAKGFGVAA	APYAFGVAA
IPYRVIHNA	IPYRVIHNA
KPSGISTIV	KPSGISTIV
RPRPPPVEQV	RPRPPVEQV
SPRNLQPQRAA	SPRNQPQRA
KGYFFPTSA	KGYFFPTSA
IINEPTAAA	IINEPTAAA
TSLLVQPISA	TSLLQPISA
FPHFDLSHGSA	FPHFSHGSA
RPRNLAAA	RPR-NLAAA
VPNKFLVTA	VPNKFLVTA
APTAIKAAA	APTAIKAAA
SPVPSHWMVA	SPVPHWMVA
TPVKGGTVA	TPVKGGTVA
TPVLPAPTA	TPVLPAPTA
SPARLYAIAA	SPARYAIAA
KPKEPQPEV	KPKEPQPEV
LPKPPKPVS	LPKPPKPVS
VPLDHRVHA	VPLDHRVHA
SPVPSHWMV	SPVPSHWMV
SPNLPHRDA	SPNLPHRDA
LPVSNVVSV	LPVSNVVSV
LPSPPAVAV	LPSPPAVAV
IPIKKSDPV	IPIKKSDPV
LPRPQGAAA	LPRPQGAAA
SPYHGFTIV	SPYHGFTIV
RPRHQGVMV	RPRHQGVMV
SPNPARGHSV	SPNPRGHSV
KPYPNSEAA	KPYPNSEAA
HPHLRKVSV	HPHLRKVSV
SPKTTISVA	SPKTTISVA
SPNKTGGFGA	SPNKGGFGA
APRIALHTA	APRIALHTA
VPTKELARQA	VPTKLARQA
SPHPSAAVPAA	SPHPAAVPA
VPYLVGQVV	VPYLVGQVV
KPNEFASQINL	KPNEFASQI
KPTVQPWIA	KPTVQPWIA
VPDSSGPERIL	VPDSSGPER
APLEEARQFAA	APLEARQFA
VPVVVVPEGSA	VPVVVVPEG
RPHTVLTVIQA	RPHTVLTVI
RPAAAPPAGA	RPAAPPAGA
TPAPVEKSPA	TPAPEKSPA
TPYEAFDPAA	TPYEFDPAA
TIRTPMAAA	TIRTPMAAA
SPSVPKTSA	SPSVPKTSA
APMPPIIHA	APMPPIIHA
RPKGFYVET	RPKGFYVET
NPNQYNYIA	NPNQYNYIA
HPTKGFASV	HPTKGFASV
RVREIIINA	RVREIIINA
TPHAIVILP	TPHAIVILP
RPGLRLWKA	RPGLRLWKA
VVRPAHISA	VVRPAHISA
MPIYPTYNEV	MPIYTYNEV
MPQNPHIIA	MPQNPHIIA
LPVWLENHTA	LPVWENHTA
TPYRPPAAA	TPYRPPAAA
SPDSPVTSA	SPDSPVTSA
RPVLPRTEA	RPVLPRTEA
TPLLLRGLTGS	TPLLRGLTG
HPTWALKEA	HPTWALKEA
TPSIPVLTA	TPSIPVLTA
TPITGAKPSA	TPITAKPSA
TPSEKHMLLKV	TPSEKHMLL
SPSPPSVAV	SPSPPSVAV
APAERRQRAA	APAERQRAA
VPVEPVLTV	VPVEPVLTV
VPKNSDPWAA	VPKNDPWAA
TPQLNAIIAA	TPQLAIIAA
MPAEHVAVQV	MPAEVAVQV
APARPSVPP	APARPSVPP
QPWPQPVPAL	QPWPQPVPA
IPSYIRDSAA	IPSYIRDSA
SPTSVRQMA	SPTSVRQMA
RPLPVTFHRA	RPLPTFHRA
IPFWRNTAV	IPFWRNTAV
LPWWGAIAA	LPWWGAIAA
APHGGDLQPPA	APHGLQPPA
KPAPPQTEQV	KPAPQTEQV
RVYIHPFHL	RVYIHPFHL
SPIVKSTEA	SPIVKSTEA
HPNPPVVHSA	HPNPVVHSA
QPFGAAVST	QPFGAAVST
APQLRPAGTA	APQLPAGTA
VPAPAHLVAT	VPAPAHLVA
APFPHGDSA	APFPHGDSA
SPRTPVSPVKF	SPRTPVSPV
IPRSFMMEV	IPRSFMMEV
APFQNILPRV	APFQILPRV
APTKALVNQV	APTKLVNQV
IPTENSMTA	IPTENSMTA
QPTSVLDKA	QPTSVLDKA
KPHPAEGQWRA	HPAEGQWRA
APSPPPAPV	APSPPPAPV
NVKVDPEIQ	NVKVDPEIQ
MPLLKSEVA	MPLLKSEVA
SPKAALRYAA	SPKALRYAA
KPLANRIKEA	KPLARIKEA
APMGREGVTA	APMGEGVTA
MAAANGIGRL	MAAANGIGR
PLSPMLYSSSA	SPMLYSSSA
SPALLRAE	SPA-LLRAE
APLNLGMIAA	APLNGMIAA
IFFNVHSA	IFF-NVHSA
APVPTAPAA	APVPTAPAA
KPYTLMSMVA	KPYTMSMVA
AAAAAVDPH	AAAAAVDPH
RPLSGLMETA	RPLSLMETA
HPQFLKNQV	HPQFLKNQV
KPIFSLNTV	KPIFSLNTV
SPFSSFISV	SPFSSFISV
RPAGVGVVVEA	RPAGVGVVV
APGTLKTLA	APGTLKTLA
KPREAFGFEQA	KPREGFEQA
SPHRPILQA	SPHRPILQA
APSSSFAAA	APSSSFAAA
HPTASLIAKVA	HPTALIAKV
HPIEPVLITA	HPIEVLITA
SPREVFFRV	SPREVFFRV
VPHQPDNLAA	VPHQDNLAA
TPSMSTITHSA	TPSMITHSA
SPVPIAPTA	SPVPIAPTA
VPFSIPAA	VPF-SIPAA
KPAPPFNVTV	KPAPFNVTV
HPKPEGLAAA	HPKPEGLAA
LPMLQTVA	LPM-LQTVA
APFAAHGYGA	APFAHGYGA
IPVPVSPISA	IPVPSPISA
HPLLVKVKA	HPLLVKVKA
RPSPPVQSV	RPSPPVQSV
AVAPPSTSA	AVAPPSTSA
MPQLNAIIAA	MPQLAIIAA
IPFGITEEA	IPFGITEEA
SPAHAVDAV	SPAHAVDAV
LPSDFTPAVHA	LPSDFTPAV
SPKTTITMA	SPKTTITMA
VPIMPYPPA	VPIMPYPPA
APSNGLSVRSA	APSNSVRSA
RPALPVSYLQA	RPALSYLQA
ITAPPGTAA	ITAPPGTAA
SPLATSTTA	SPLATSTTA
RISSIQATTAA	SSIQATTAA
RPISLGHVVVA	RPISLGHVV
RPYTGKVGA	RPYTGKVGA
MPAFPLPYA	MPAFPLPYA
VPRQPTVTSV	VPRQTVTSV
RPFTNLESA	RPFTNLESA
RPIPNQPPTAA	IPNQPPTAA
RPVKIRKI	RPV-KIRKI
HPIQTSFQEA	HPIQSFQEA
VPWGGAAA	VPW-GGAAA
SPAPPLLHV	SPAPPLLHV
APIRLPEHVTV	APIRLPEHV
LPNAVITRI	LPNAVITRI
LPFYLIPPSA	LPFYIPPSA
APAAGMNAA	APAAGMNAA
TPVSYMHTA	TPVSYMHTA
APASVPAQA	APASVPAQA
APDEKYVAA	APDEKYVAA
IPKKEIHTV	IPKKEIHTV
RPNDSRMLVA	RPNDRMLVA
SPLSAARAA	SPLSAARAA
RPAFVIPEV	RPAFVIPEV
SPKPVSSTV	SPKPVSSTV
IPADLRIISA	IPADRIISA
SPFHFQPSA	SPFHFQPSA
IPQLVSNISA	IPQLSNISA
RPNGVITGLAA	RPNGTGLAA
HPREPLPPIQ	HPREPLPPI
TPLLMQALP	TPLLMQALP
APAAGSAPAA	APAASAPAA
VPAPGGPAA	VPAPGGPAA
RPVPGYEPG	RPVPGYEPG
HAGLNAVAA	HAGLNAVAA
KPNKPLILA	KPNKPLILA
LPAEFPDKVFA	LPAEFPDKV
IPHLVTHDA	IPHLVTHDA
LPYKWVVEA	LPYKWVVEA
MPMERQMSV	MPMERQMSV
VPAPSPLSAA	VPAPPLSAA
RPSELLAGVKA	RPSELLAGV
FPANVMDVIA	FPANMDVIA
TPYPKLKTA	TPYPKLKTA
SPLASGAVA	SPLASGAVA
QPLEVLEAV	QPLEVLEAV
TPLRPLDPT	TPLRPLDPT
MPADSGYPA	MPADSGYPA
SPKPALRYAA	SPKPLRYAA
QPLYQPSHA	QPLYQPSHA
RPFSGRRLPV	RPFSRRLPV
AEQRGENALKD	AEQRGENAL
SPRTAEGVLAA	SPRTEGVLA
MPFGNVISA	MPFGNVISA
KPQEVFWAS	KPQEVFWAS
SPMDTVTEA	SPMDTVTEA
MPTTLEGA	MPT-TLEGA
RVRDVFEAKA	RVRDFEAKA
SPAGILVDA	SPAGILVDA
VPAPAPAAA	VPAPAPAAA
RVRLSTGREA	RVRLTGREA
APAVLLGGVA	APAVLGGVA
HPKKPGVGV	HPKKPGVGV
YPAPQVSTA	YPAPQVSTA
TPKTPEEKAVA	TPKTPEEKA
LPKAGKFGPA	LPKAKFGPA
TPLASFTTV	TPLASFTTV
IPAGGRPPAA	IPAGRPPAA
IPHPLIMGV	IPHPLIMGV
VPAKKITAA	VPAKKITAA
VPTTAAATA	VPTTAAATA
TPSPVIRSTA	TPSPIRSTA
NPLETRNIA	NPLETRNIA
SPFQTPVQSSA	SPFQVQSSA
QPYQPLREV	QPYQPLREV
LPASETPKA	LPASETPKA
RPYLLVHV	RPY-LLVHV
KPMASFVTT	KPMASFVTT
VPSPGLPVSA	VPSPLPVSA
HPIYLATGTSA	HPIYTGTSA
APVHPPNRSA	APVHPNRSA
RPFEGFQRKA	RPFEFQRKA
LPVLPVAAA	LPVLPVAAA
SPLPQYVTV	SPLPQYVTV
IPLPDEKSRVA	LPDEKSRVA
APHIIVGTPG	APH-IIVGT
TPYTGILYA	TPYTGILYA
FPSAAATAA	FPSAAATAA
YPTHVKVTA	YPTHVKVTA
KPAPPFNVT	KPAPPFNVT
LPQEIKANVA	LPQEKANVA
RPAGALVALVV	RPAGALVAL
IPAALPVAA	IPAALPVAA
IPAFRGHFIAA	IPAFHFIAA
RPFQNQTHA	RPFQNQTHA
AAVPASRGITA	VPASRGITA
HPKVNVPGSQA	KVNVPGSQA
TPLPAIVPAA	TPLPIVPAA
FPFFNPIQT	FPFFNPIQT
QPYRFPQA	QPY-RFPQA
QAAAPVLTPA	AAAPVLTPA
APRPPPKPM	APRPPPKPM
QVFDAKNMMAA	QVFDKNMMA
TPSKVWGSSA	TPSKWGSSA
RPLQDEPAA	RPLQDEPAA
IVNEVLKSVVA	IVNEVLKSV
KPNEGAIVEV	KPNEAIVEV
IPYLSKHRA	IPYLSKHRA
TPFYPRSPYGA	YPR-SPYGA
IIRDEGISA	IIRDEGISA
NPKEFYHEV	NPKEFYHEV
QPLLPYSAV	QPLLPYSAV
FPAPILRAV	FPAPILRAV
LPRGAAKAIA	LPRGAKAIA
VPRTVSSTTA	VPRTSSTTA
APVAEVPTA	APVAEVPTA
NPLHELKAAA	NPLHELKAA
KPLQPLPNTA	KPLQLPNTA
VPVSLESKKAA	VPVSESKKA
RPRPVVTTT	RPRPVVTTT
IPAEKIDGV	IPAEKIDGV
SPGLQKEAV	SPGLQKEAV
APWPPKGLVPA	APWPGLVPA
FKQYANDNGVD	KQYANDNGV
SPILVATAVA	SPILVATAV
LPHSGYSDSA	LPHSYSDSA
RPMKVGHVT	RPMKVGHVT
SPHGLVMVGV	SPHGVMVGV
QPYMPTVSA	QPYMPTVSA
VPYGTPLSV	VPYGTPLSV
RPFTIPYLTA	RPFTPYLTA
TPTPPFQQA	TPTPPFQQA
RPKPPNVRTA	RPKPNVRTA
RPSDIKFKP	RPSDIKFKP
MPTTLEGAEA	MPTTEGAEA
LPAAKGFVA	LPAAKGFVA
FPRPVTVEP	FPRPVTVEP
QPPSLPAVSA	QPPSPAVSA
APVLPHTAV	APVLPHTAV
LPRKPVAGA	LPRKPVAGA
LPKSSSQEVEA	LPKSSSQEV
SPYSGPKFNSA	SPYSKFNSA
TPQEKIFIAA	TPQEIFIAA
RPAPLPAAVV	RPAPLPAAV
VPAGGAVAVSA	VPAGGAVAV
LPMDYVQRV	LPMDYVQRV
LPVDVVVNA	LPVDVVVNA
KPLQPARPV	KPLQPARPV
LPNANYPSA	LPNANYPSA
QPIFAVTSA	QPIFAVTSA
RVNEVNQFAA	RVNENQFAA
IPKDYKTMAA	IPKDKTMAA
QPYAPPRDFAA	QPYAPRDFA
APFGKISDA	APFGKISDA
RPLFGETSA	RPLFGETSA
RPRVTEPISA	RPRVEPISA
LPHSQLPQA	LPHSQLPQA
HPLTGGGMTVA	HPLTGGMTV
QPGEALAEA	QPGEALAEA
IAHTPGVAA	IAHTPGVAA
SPHAHISEQA	SPHAISEQA
VPYPLPKIDLI	VPYPPKIDL
LPAHREGISA	LPAHEGISA
RAFQQSTAA	RAFQQSTAA
AAFAGRATA	AAFAGRATA
APKAGPGVV	APKAGPGVV
RPGPGLSQEAA	RPGPLSQEA
DPPSNPVAA	DPPSNPVAA
MPRFTEQVEA	MPRFEQVEA
KVYDNRVSVAA	KVYDNRVSV
AAGPVGMAA	AAGPVGMAA
LPVQLQRAMA	LPVQQRAMA
KPMLQQGIELL	KPMLQGIEL
KPLPLGVRA	KPLPLGVRA
PAKKITAA	PAK-KITAA
ASFHNGVAA	ASFHNGVAA
RIFDRAVAA	RIFDRAVAA
SPQPVGQQA	SPQPVGQQA
RPNERVDTV	RPNERVDTV
KPRPPLHLL	KPRPPLHLL
SPAKTLPGA	SPAKTLPGA
LPLLQPRGASA	LPLLQPRGA
MPAHFSDSA	MPAHFSDSA
RPRIAGITA	RPRIAGITA
SPNLASGLAA	SPNLSGLAA
SPKSPGLKA	SPKSPGLKA
SPAKLQAA	SPA-KLQAA
SPKPAIKSISA	KPAIKSISA
VPTNIIAAKAA	VPT-NIIAA
LPHEILEMT	LPHEILEMT
TPNRATFVV	TPNRATFVV
LPNLQTVTV	LPNLQTVTV
SPNEVKVVA	SPNEVKVVA
RPLLPSENITA	RPLLENITA
RPAPPPPTV	RPAPPPPTV
LPSASITSTSA	LPSASITST
KPFKEFVEA	KPFKEFVEA
SPTGGFVDA	SPTGGFVDA
APGPPLHIGA	APGPLHIGA
SPNSYFMDV	SPNSYFMDV
APHIVVGTPG	APHIVVGTP
KPMNEYRSV	KPMNEYRSV
SPLLQAHHA	SPLLQAHHA
NPNELSVSA	NPNELSVSA
APGPGPASA	APGPGPASA
APAPGLGAAA	APAPLGAAA
SPHAHISEQAV	SPHAISEQA
TPHPVLTPVA	TPHPLTPVA
APAAATVAVA	APAAATVAV
HPVHPFLAV	HPVHPFLAV
TPWFKIIAA	TPWFKIIAA
FPYPVGVHA	FPYPVGVHA
SPRLLGAAA	SPRLLGAAA
LPWQGLKAA	LPWQGLKAA
LVRPPTEQA	LVRPPTEQA
FPKPYPNSEA	FPKPPNSEA
TPTEFFFHA	TPTEFFFHA
APVAVWAA	APV-AVWAA
IPKGKISIVEA	IPKGKISIV
RPHTVLTVI	RPHTVLTVI
APFQGLLQA	APFQGLLQA
VPKPIGGVVVF	VPKPGGVVV
SPSPRWVAA	SPSPRWVAA
PVRQGALQGG	PVRQGALQG
HPVLLQPVA	HPVLLQPVA
SPKQILDPA	SPKQILDPA
HPVEPVTSV	HPVEPVTSV
RPSQAAPAV	RPSQAAPAV
HPMPHPPQA	HPMPHPPQA
APRPASGPIRP	RPASGPIRP
RNQLQSVAA	RNQLQSVAA
KPKVPLKSA	KPKVPLKSA
LPHPNRIQA	LPHPNRIQA
SPVMVSNPA	SPVMVSNPA
YPKNPHLRA	YPKNPHLRA
VPQTPLHTA	VPQTPLHTA
TPVGGLLMA	TPVGGLLMA
RPFNTYPRA	RPFNTYPRA
YPGFNPFRA	YPGFNPFRA
RPSTDFTQAA	RPSTFTQAA
KPVPLNSGVRF	KPVPLNSGV
LPHDRMTSQEA	LPHDRMTSQ
SPTGKEFVSA	SPTGEFVSA
KPFLFDTKP	KPFLFDTKP
KPGGSLASHVA	KPGGLASHV
SPNMANTVNAA	SPNMNTVNA
HPVAKILHA	HPVAKILHA
RPALFSSSA	RPALFSSSA
SPNGKYILAA	SPNGYILAA
LVYQEPIPTA	LVYQPIPTA
NPFRSKLAA	NPFRSKLAA
VPMTPLRTV	VPMTPLRTV
KPIEMQLTSA	KPIEQLTSA
KPRPIIPMLY	KPRPIIPML
KPKPAGVLGA	KPKPGVLGA
RPSSLPVGPVL	RPSSPVGPV
LPNFLPYNV	LPNFLPYNV
KPLPPIQVA	KPLPPIQVA
KPTGGLPET	KPTGGLPET
YPVHLAVRA	YPVHLAVRA
KPMEGWIAV	KPMEGWIAV
LPSSPAAAA	LPSSPAAAA
LSELEAALQR	SELEAALQR
KPMKSVLVVA	KPMKVLVVA
KPLDAPAVNKA	KPLDAVNKA
TPHTVILFA	TPHTVILFA
RPKSAFKVQ	RPKSAFKVQ
KPPAILPVA	KPPAILPVA
APRQPGLMA	APRQPGLMA
RPFHGISTV	RPFHGISTV
APTPPTLVA	APTPPTLVA
APLDAYFQV	APLDAYFQV
TPHLRNLAV	TPHLRNLAV
LPTTMGVVA	LPTTMGVVA
SPHVQVKAA	SPHVQVKAA
SLVNLGGSK	SLVNLGGSK
SPAAPVITA	SPAAPVITA
TPAHVLPSA	TPAHVLPSA
RPRYLEIRA	RPRYLEIRA
MPWFKGWKV	MPWFKGWKV
TPHVPYRES	TPHVPYRES
LPAAMPITA	LPAAMPITA
IPKHINPVAA	IPKHNPVAA
SPFPPAKSA	SPFPPAKSA
IPKDKSWKA	IPKDKSWKA
TPMYTHSIAA	TPMYHSIAA
NPYYGGESA	NPYYGGESA
RPNDIMAEV	RPNDIMAEV
RPHSSLRELLA	RPHSSLREL
TPTSYIIEA	TPTSYIIEA
MPVPAQPKA	MPVPAQPKA
QPINLIFRY	QPINLIFRY
LPFDRFSEV	LPFDRFSEV
LPLAVTKEA	LPLAVTKEA
RPRAPIIAVT	RPRAPIIAV
MPHLVNGDAA	MPHLNGDAA
PSLSRPGPAAP	SLSRPGPAA
SPHISSQTA	SPHISSQTA
VPAEGAPTA	VPAEGAPTA
IPTNTMHYGS	IPTNTMHYG
TPLGGIQAA	TPLGGIQAA
QPRDPVRPP	QPRDPVRPP
RPLAQLREV	RPLAQLREV
IPLDKRLAA	IPLDKRLAA
RPHPLRPEA	RPHPLRPEA
SPLYLAHEV	SPLYLAHEV
SPVLPLTSA	SPVLPLTSA
SPLHLAVEA	SPLHLAVEA
SPTRPPVAA	SPTRPPVAA
FPFKPPQRIEA	FPFKQRIEA
RPISGQKEV	RPISGQKEV
MAMESTATAA	MAMETATAA
IPSTELAKQVI	IPSTLAKQV
TPFKPILEA	TPFKPILEA
MPATLARAA	MPATLARAA
LPSRFIESA	LPSRFIESA
QPITPGPSI	QPITPGPSI
APTGSGKTVAA	APTGGKTVA
RPNGVITGL	RPNGVITGL
RPIRKGDIFLV	RPIRKGDIF
RPRITHPPP	RPRITHPPP
QFPAPKSAST	FPAPKSAST
RPFQSIIHA	RPFQSIIHA
LPNQPVEKA	LPNQPVEKA
QPYYATRVNAA	QPYYTRVNA
NPSPSTSISA	NPSPTSISA
KPEEQWWSA	KPEEQWWSA
SPLFSQHTAA	SPLFQHTAA
QPYGGFLDI	QPYGGFLDI
IPMVNKVLV	IPMVNKVLV
GPHANPVAV	GPHANPVAV
KPQSINTVSA	KPQSNTVSA
RPHSVPSSV	RPHSVPSSV
SPPEVIRAA	SPPEVIRAA
LPHPYAIAVF	LPHPYAIAV
IPRPVDGVEV	IPRPDGVEV
APRPAPVA	APR-PAPVA
SPDEGALVRAA	SPDEALVRA
VPRPASVSA	VPRPASVSA
LPIGTLPLA	LPIGTLPLA
LPLSAHGIVV	LPLSHGIVV
LPQSREKIIA	LPQSEKIIA
GPRLSAEAA	GPRLSAEAA
APKDVKIRISA	APKDIRISA
ASAPPGPPA	ASAPPGPPA
RPHAPHSPIKF	RPHAPHSPI
LPLSLLKTA	LPLSLLKTA
KAIFTGHSA	KAIFTGHSA
TPFGPLSSRSA	TPFGPLSSR
LPSELIVHI	LPSELIVHI
RPFRLGTGA	RPFRLGTGA
RPKIPGSREAA	RPKIGSREA
AAFSHPQAA	AAFSHPQAA
MPSDVLEVT	MPSDVLEVT
RPGPVLPAVAV	RPGPVLPAV
SPREPGYKA	SPREPGYKA
TVTEKPEVIDA	TVTEKPEVI
KPYNVYITVA	KPYNYITVA
IPAQGHFGISA	IPAQFGISA
SPLRSPIRSA	SPLRPIRSA
APRPPVSAA	APRPPVSAA
IPMELVNEV	IPMELVNEV
VPKPEEEVA	VPKPEEEVA
SPYIPPHAA	SPYIPPHAA
RPWLDPAAA	RPWLDPAAA
RPFPAAHHA	RPFPAAHHA
SPFRVNVGA	SPFRVNVGA
APTGDLPRA	APTGDLPRA
SPFFPLVSA	SPFFPLVSA
TPRAATVKA	TPRAATVKA
NPIAQPLA	NPI-AQPLA
KPYNVYITV	KPYNVYITV
KPIDFVLNKV	KPIDVLNKV
TPWPRGRLLTA	WPRGRLLTA
TPLSKLMKA	TPLSKLMKA
HPNQPLTITA	HPNQLTITA
TPAAAAAMNLA	TPA--AAAA
RPYLSAVRA	RPYLSAVRA
SPSKNYVMA	SPSKNYVMA
TPFKLTTEA	TPFKLTTEA
APTSFLPPEA	APTSLPPEA
TPAPSAPAAA	TPAPSAPAA
RPSQVVAET	RPSQVVAET
TPTSADKLRAA	TPTSDKLRA
RPFIGMSSA	RPFIGMSSA
VPVETPEA	VPV-ETPEA
FPHLQDAQV	FPHLQDAQV
SPKLPSLEA	SPKLPSLEA
APGLPTARA	APGLPTARA
APYDPHFPAPA	APYDPHFPA
MPFGNVVSA	MPFGNVVSA
EPTDTLSKHQA	TDTLSKHQA
LPKEKQPVA	LPKEKQPVA
SPVSSLPTA	SPVSSLPTA
LPTKPTQGA	LPTKPTQGA
TPYGYFLISA	TPYGFLISA
AAGGPQRIPA	AAGGQRIPA
VPNPYIISA	VPNPYIISA
RPSTGGLGFSV	RPSTLGFSV
MPVGLIAGA	MPVGLIAGA
IPQVMAIA	IPQ-VMAIA
RPKPESQGI	RPKPESQGI
LPRRPLPPA	LPRRPLPPA
TPQPPLLKA	TPQPPLLKA
RPQEIDEAA	RPQEIDEAA
MPKAEKNAV	MPKAEKNAV
TPAGAAVSA	TPAGAAVSA
RPNPPPVSV	RPNPPPVSV
KPIFSLNTVA	KPIFLNTVA
VPIPNSPFKVA	IPNSPFKVA
SPLNTHAA	SPL-NTHAA
APHEILIQIV	APHELIQIV
QPWTPVPQA	QPWTPVPQA
LALHQKITA	LALHQKITA
TPSAGAVAA	TPSAGAVAA
RARPPPPPP	RARPPPPPP
RPKLNEGVVEF	RPKLNEGVV
SPHFPHTAA	SPHFPHTAA
TPFYFKEPSL	TPFYKEPSL
HPYLFPVAA	HPYLFPVAA
VPAHPSGNMA	VPAHSGNMA
LPKPPGRGV	LPKPPGRGV
EITALAPSTMK	ITA-LAPST
LPLRPIIPLVA	LPLRIIPLV
YPQELIVPA	YPQELIVPA
KPAMPMQQA	KPAMPMQQA
VPRPPSNPPA	VPRPSNPPA
MPAPPPKENA	MPAPPKENA
LPYAITIVA	LPYAITIVA
RPISLGHVVV	RPISLGHVV
APSEARTTPA	APSERTTPA
APFPKTQIA	APFPKTQIA
RPYLAFAA	RPY-LAFAA
LPHSAGRYA	LPHSAGRYA
APASGQLPSA	APASQLPSA
VPLSHLINA	VPLSHLINA
VPRQPTVTS	VPRQPTVTS
APSPSHPISA	APSPHPISA
VPYGVGKAA	VPYGVGKAA
IPRNTVVPT	IPRNTVVPT
IPWGISATA	IPWGISATA
APAPTPVSA	APAPTPVSA
VPKSAVQQVA	VPKSVQQVA
RPGPVLPAVA	RPGPVLPAV
ATNKERLFAA	TNKERLFAA
HPYQRIVTA	HPYQRIVTA
IPRSFLQEA	IPRSFLQEA
APFDTVHIPEA	APFDHIPEA
APAPPKAEA	APAPPKAEA
VPAPAHLVA	VPAPAHLVA
WRRIPGGYSA	RRIPGGYSA
SPLKHFVTA	SPLKHFVTA
MQPPVPGP	MQP-PVPGP
SPIENIQRV	SPIENIQRV
RPAAQPSFHQA	AAQPSFHQA
APSGGRLLSA	APSGRLLSA
RPSPSIAVKA	RPSPIAVKA
IPVRFIEA	IPV-RFIEA
IPHPLIMGVI	IPHPLIMGV
AGLQFPVGR	AGLQFPVGR
HPFPGPGLAI	HPFPPGLAI
LPRLIDMSA	LPRLIDMSA
RPVGGGPSA	RPVGGGPSA
GPFGQIFRP	GPFGQIFRP
IPVQLQRSMA	IPVQQRSMA
IPFYGILGA	IPFYGILGA
GPYGGAQPSA	GPYGAQPSA
SPYGGGRPG	SPYGGGRPG
KPPAILPVAA	KPPALPVAA
IPLGFGVAA	IPLGFGVAA
VPQGLLKAA	VPQGLLKAA
RPADYLFML	RPADYLFML
TPKMPGQSV	TPKMPGQSV
SPAYRDLAA	SPAYRDLAA
IPQEAYNAV	IPQEAYNAV
HPSPVVLKVY	HPSPVVLKV
RPEDRMFHIRA	RPEDRMFHI
HPYLPINSA	HPYLPINSA
RPAPLSAELQA	APLSAELQA
MPWGDPNYRSA	MPWGNYRSA
FPMSPVTSV	FPMSPVTSV
TPHYIYPPAIV	TPHYIYPPA
IIKEVLLEA	IIKEVLLEA
RPIASGPVV	RPIASGPVV
VPWGGAAAV	VPWGGAAAV
NPAPPIDAV	NPAPPIDAV
LPRTVIRGSQA	LPRTVIRGS
SPVVPQISA	SPVVPQISA
RPGPGVPAT	RPGPGVPAT
APSTIIFHL	APSTIIFHL
YPSAPFLAA	YPSAPFLAA
AAAAPAAPAA	AAAPAAPAA
MPHSIMRIDIA	MPHSRIDIA
LPHAILRLDLA	LPHARLDLA
RPSSLHGLAA	RPSSHGLAA
NPLGMPVPAA	NPLGPVPAA
RPAPPLRPSAA	RPAPLRPSA
APAPPVYEA	APAPPVYEA
MPTDVLEVT	MPTDVLEVT
SPKQILDPAA	SPKQLDPAA
VPVWSGMNVA	VPVWGMNVA
TPNTSLGMVQA	TPNTSLGMV
VPTDYSVSA	VPTDYSVSA
KPTAVPSIFHL	KPT-AVPSI
VPMSALKSV	VPMSALKSV
SPVDPGARQA	SPVDGARQA
MPLHTIIPLL	MPLHTIIPL
SPLWTSIGA	SPLWTSIGA
RPDSTHMVEA	RPDSHMVEA
RPPEPRHIPA	RPPERHIPA
RPGPVLPAV	RPGPVLPAV
RPKSAFKVQNA	RPKSAFKVQ
LPFGGVPTV	LPFGGVPTV
VPLAIVNKA	VPLAIVNKA
RPFDLPLQP	RPFDLPLQP
LPHGFTNMA	LPHGFTNMA
KPQATVVSA	KPQATVVSA
IPVNGGLAA	IPVNGGLAA
HPFKGFLLEA	HPFKFLLEA
APQSLGSSA	APQSLGSSA
VPFQNAATA	VPFQNAATA
SPTTSHVGA	SPTTSHVGA
TPHYIYPPA	TPHYIYPPA
LPASIPHVIA	LPASPHVIA
HPSQELLAS	HPSQELLAS
SPMIPSIVV	SPMIPSIVV
MPHKFVIAV	MPHKFVIAV
EPAPPSQGAEA	APPSQGAEA
SPEAHTVEA	SPEAHTVEA
IPIKFSEKQQA	IPIKEKQQA
KPAEFTVDA	KPAEFTVDA
MPNGDHIVSA	MPNGHIVSA
SPMPGTLTA	SPMPGTLTA
LPAASQPQVF	LPAASQPQV
FPVGVFVVA	FPVGVFVVA
RPSQGLYSSSA	RPSQGLYSS
IPQELNNIT	IPQELNNIT
SPHSQVLTA	SPHSQVLTA
KPTASPSSIAA	TASPSSIAA
KPLRPLGKAA	KPLRLGKAA
NPYTIFHQA	NPYTIFHQA
QPVKLQEA	QPV-KLQEA
RPYLQRKDV	RPYLQRKDV
VPHWDPKISA	VPHWPKISA
RPAAPLIGA	RPAAPLIGA
RPSLNIATV	RPSLNIATV
SPILVATA	SPI-LVATA
VPFLNPYTV	VPFLNPYTV
HPWETVTTAA	HPWEVTTAA
MPNGTPHPTA	MPNGPHPTA
ATVLQAVSA	ATVLQAVSA
SIPEKNRPL	SIPEKNRPL
APAPAAHVA	APAPAAHVA
RPHSALLAV	RPHSALLAV
LPYNGVVLA	LPYNGVVLA
SPQSSQPPTA	SPQSQPPTA
RPGPGVPATW	RPGPGVPAT
RPRAPIIAV	RPRAPIIAV
TPFLLVGT	TPF-LLVGT
APSPVQHQA	APSPVQHQA
APALLLIPA	APALLLIPA
QPYYATRVNA	QPYYTRVNA
VPNKIINRA	VPNKIINRA
RPLTLFHTV	RPLTLFHTV
TAAPSLKNAA	TAAPLKNAA
RPRDSQLYA	RPRDSQLYA
TPMAASVVA	TPMAASVVA
SPFPLEAV	SPF-PLEAV
HPTDASMIEA	HPTDSMIEA
VPTNIIAA	VPT-NIIAA
RVAYRPISA	RVAYRPISA
APRSFHPPAA	APRSHPPAA
SPLQKALLA	SPLQKALLA
KPSESIYSA	KPSESIYSA
TPVPPPSAA	TPVPPPSAA
APTKPQSPA	APTKPQSPA
PITPRAAPL	PITPRAAPL
VPAGGAVA	VPA-GGAVA
LPSDIAAEA	LPSDIAAEA
MPQPVPTA	MPQ-PVPTA
APAPAEKTPV	APAPEKTPV
GPYKIILTA	GPYKIILTA
IPYTGPFNLL	IPYTPFNLL
TPNKPSVAV	TPNKPSVAV
RVKIQTVAA	RVKIQTVAA
YPISIFIKP	YPISIFIKP
HPSQELLASA	HPSQLLASA
KPQGHIGVDA	KPQGIGVDA
YPNFAGPHA	YPNFAGPHA
LPVAFKVVA	LPVAFKVVA
VPFAAPATA	VPFAAPATA
APASLTSA	APA-SLTSA
SPSPPQAEA	SPSPPQAEA
VIRNIVEAA	VIRNIVEAA
APIWLEHAA	APIWLEHAA
APRFGGSRA	APRFGGSRA
MPNGTPHPTAA	MPNGPHPTA
KVLLIENVA	KVLLIENVA
TPSSASTVSV	TPSSSTVSV
APAPPKAEAKA	APAPPKAEA
RPKMQEVVA	RPKMQEVVA
QPFPAHIGRSA	FPAHIGRSA
APGVLPSA	APG-VLPSA
APSAKGTISA	APSAGTISA
SAPVNFISA	SAPVNFISA
RPAPPRAPA	RPAPPRAPA
RPALAVGVTAV	RPALVGVTA
SPKGTIENI	SPKGTIENI
RPPPIGAEV	RPPPIGAEV
HPAAFPLPVV	HPAAPLPVV
MPNPSLAQVKI	MPNPSLAQV
RPRTAGPAVHL	RPRTAGPAV
KPHSGFHVA	KPHSGFHVA
VPYRLLPGIF	VPYRLLPGI
KPASSSFGSEA	KPASFGSEA
TPGRAQISA	TPGRAQISA
TPVLIPKGA	TPVLIPKGA
APGKGILAA	APGKGILAA
QPLPATHAA	QPLPATHAA
VPLPEHGVSV	VPLPHGVSV
VPYEIQKGQA	VPYEQKGQA
LPYHHVIHA	LPYHHVIHA
QPAPAIHSA	QPAPAIHSA
KPQPLINHA	KPQPLINHA
APVAVEPGAA	APVAVEPGA
RPADVIFATV	RPADIFATV
RPAPLPAAV	RPAPLPAAV
IPYHSEVPVSL	IPYHSEVPV
QPANKGFRA	QPANKGFRA
RPASYQSVSV	RPASQSVSV
KPKITPVTV	KPKITPVTV
RPHAPGRPA	RPHAPGRPA
RPAVVMQGSA	RPAVMQGSA
RPSPAPPAA	RPSPAPPAA
HPSKALIASA	HPSKLIASA
HPMPVLPKA	HPMPVLPKA
RPYLGYDWIA	RPYLYDWIA
LPNQSFPHSV	LPNQFPHSV
RVKVSQAAA	RVKVSQAAA
RPLDKLPGL	RPLDKLPGL
RPKPSSSPVIF	RPKPSSSPV
TPRPPLRPGA	TPRPLRPGA
HPHPFLNSV	HPHPFLNSV
PARFKNTEAI	PARFKNTEA
LPSPLPAHPSV	SPLPAHPSV
VPAKWIHEA	VPAKWIHEA
VPHQPFSQA	VPHQPFSQA
TPKPVEPAA	TPKPVEPAA
VPAPFFLPA	VPAPFFLPA
MPAAALNAA	MPAAALNAA
RPADVIFAT	RPADVIFAT
SPSAGVPRA	SPSAGVPRA
RPSLLRPVSA	RPSLRPVSA
VPSSPPTKR	VPSSPPTKR
RPALVEQTA	RPALVEQTA
TPFYFKEPS	TPFYFKEPS
TPYSGKLMSA	TPYSKLMSA
YPRPGTPAA	YPRPGTPAA
LVKDVFISA	LVKDVFISA
VPFPTPLEA	VPFPTPLEA
TPLLSGKAA	TPLLSGKAA
TPTFTYKAA	TPTFTYKAA
SPQEAQIIQA	SPQEQIIQA
SPFAEGTSA	SPFAEGTSA
VPKKPGPPVL	VPKKPGPPV
APTAITEA	APT-AITEA
VVAPSIIAA	VVAPSIIAA
VPAHAVVVRA	VPAHVVVRA
LPKHLLHSV	LPKHLLHSV
SPRNLAMEA	SPRNLAMEA
RPNSLVGITSA	RPNSGITSA
APGGEFREA	APGGEFREA
SPVTDFREA	SPVTDFREA
HPQVNIYSV	HPQVNIYSV
RPLATAYKA	RPLATAYKA
AGFAGDDAPR	AGFAGDDAP
APIRLLAA	API-RLLAA
IPQQVFQEV	IPQQVFQEV
YPLDLLLKL	YPLDLLLKL
SPLSSHPVV	SPLSSHPVV
VPTPAPISA	VPTPAPISA
SPAEVAKITA	SPAEAKITA
QPHDPLVPLSA	QPHDVPLSA
IPAGTVTVNAA	IPAGVTVNA
VPRLPATAA	VPRLPATAA
RPSSTFNTV	RPSSTFNTV
LPIPDPGVSV	LPIPPGVSV
IPTTIYKA	IPT-TIYKA
HAAEYGAEALE	HAAEYGAEA
KPPPPPPPP	KPPPPPPPP
NPYSEFILA	NPYSEFILA
RPVTPPRTA	RPVTPPRTA
RPAPPLRPSA	RPAPLRPSA
SPYYFLTSA	SPYYFLTSA
SPSPPFGHSA	SPSPFGHSA
SPTSPNALPPA	SPN-ALPPA
HPLPPTPSV	HPLPPTPSV
AVFFQSHSA	AVFFQSHSA
IPHSLPGAVAA	IPHSPGAVA
APNPIHLTV	APNPIHLTV
YPLLLKELA	YPLLLKELA
SPNPFSVHTA	SPNPSVHTA
TPIRGLLMA	TPIRGLLMA
RPWPNPNSA	RPWPNPNSA
QPILLELEA	QPILLELEA
SPIEFLENA	SPIEFLENA
KPKEVTTVKV	KPKETTVKV
AAAAAAKVPA	AAAAAKVPA
LVRPVVPSA	LVRPVVPSA
IPTVNPVAI	IPTVNPVAI
LPKEDPTAVA	LPKEPTAVA
APMALFYPATF	APMALFYPA
YPNYPNPAV	YPNYPNPAV
RPHRGILAV	RPHRGILAV
RPKPIITSV	RPKPIITSV
IPKKLMHQA	IPKKLMHQA
RPFLNSISKA	RPFLSISKA
AAPAPAAHVA	APAPAAHVA
APYPGFLSV	APYPGFLSV
NPMGIGVTA	NPMGIGVTA
HPAPVRGPP	HPAPVRGPP
TPHDFIEHI	TPHDFIEHI
TPIRRDFSA	TPIRRDFSA
QPHSSALTA	QPHSSALTA
APYVTFPVA	APYVTFPVA
LPYDIPHRA	LPYDIPHRA
MPRWAERLFPA	RWAERLFPA
LPVRLATA	LPV-RLATA
IPRNQLQSV	IPRNQLQSV
RPLFPSTGAA	RPLFPSTGA
SPYKDLLDPA	SPYKLLDPA
VPSLQGEKA	VPSLQGEKA
APIAPLKITV	APIALKITV
APRLQSEVA	APRLQSEVA
RPRDSQLYAV	RPRDQLYAV
IPYHIVNIV	IPYHIVNIV
TPRSIHDGVAA	TPRSIHDGV
KPYTVVDVSA	KPYTVDVSA
VPAPSVPSV	VPAPSVPSV
RPVKLFRV	RPV-KLFRV
VPAKGLATSV	VPAKLATSV
SPHTKMDVA	SPHTKMDVA
IPHKKFTFA	IPHKKFTFA
IPNSIMTILEA	IPNSTILEA
GYSFTTTAER	YSFTTTAER
MPTLPPPSV	MPTLPPPSV
SPHLGPAPA	SPHLGPAPA
RPRPPVSST	RPRPPVSST
APHEILIQI	APHEILIQI
SPYHNFDSV	SPYHNFDSV
RPYAPINANA	RPYAINANA
VPHNVQVAA	VPHNVQVAA
SPMAERSMMSA	SPMASMMSA
VPVDTGVAA	VPVDTGVAA
NAPWAVTSL	NAPWAVTSL
IVNVPQPAA	IVNVPQPAA
APQPLKESA	APQPLKESA
MPQDLRSPA	MPQDLRSPA
RPYQPLGALVV	RPYQLGALV
LPNHQVIHTA	LPNHVIHTA
APGNPVLAV	APGNPVLAV
TPAHVLPSAA	TPAHVLPSA
RPLFPLPAAF	RPLFPLPAA
RPYLHEFLTSA	RPYLFLTSA
APYDAIHVGA	APYDIHVGA
TPFQGQGHGA	TPFQQGHGA
VPANPYHTA	VPANPYHTA
RPSTDFTQA	RPSTDFTQA
SPLSVVKQEA	SPLSVKQEA
APVAAHTVTA	APVAHTVTA
APWGGPAA	APW-GGPAA
RPVNDMNIA	RPVNDMNIA
KPVYIPEVEL	KPV-YIPEV
IPAHDSPLAA	IPAHSPLAA
IPLKHLADRVA	IPLKLADRV
AGPARLSPAA	GPARLSPAA
RPLHEFITA	RPLHEFITA
QPTPVNIRA	QPTPVNIRA
QPYSKLPGV	QPYSKLPGV
SPFGSITSA	SPFGSITSA
QPHTILRVV	QPHTILRVV
TPQSIFIFA	TPQSIFIFA
RPNLIKPAA	RPNLIKPAA
SPITGEKIPA	SPITEKIPA
LLFHNAVSA	LLFHNAVSA
TPTGTHPLA	TPTGTHPLA
RPRAPIIAVTR	RPRAPIIAV
RPLGAGQEV	RPLGAGQEV
SPLFSQHTA	SPLFSQHTA
GPFDEFQIA	GPFDEFQIA
SPRPALPALLV	SPRPALPAL
VPFKPQIPEA	VPFKQIPEA
IPASGDYVA	IPASGDYVA
IPSGTILKA	IPSGTILKA
TVSPVLPLTSA	SPVLPLTSA
KPLSSLTPLIA	KPLSSLTPL
RPIWLRESTV	RPIWLREST
KPTLVILRI	KPTLVILRI
VPQQPTYVQA	VPQQTYVQA
KPSPFTPVSA	KPSPTPVSA
KPMKSVLVV	KPMKSVLVV
