Data	Data aligned
NFPNIRDAI	NFPNIRDAI
AYPLVGHAL	AYPLVGHAL
YYVNRDTL	YYVNR-DTL
RFPEELTQTF	RFPEETQTF
ALPEIFTEL	ALPEIFTEL
VFPDDMPTL	VFPDDMPTL
VYYFSKGTL	VYYFSKGTL
AYPYYASAF	AYPYYASAF
SFPHYGFPTY	SFPHYFPTY
RFLYSNIAF	RFLYSNIAF
GYMEKIKPM	GYMEKIKPM
AFADYRPTEV	AFADYPTEV
SFILKANEL	SFILKANEL
AFQAALAL	AFQAA-LAL
ATPLSTLSL	ATPLSTLSL
RYPPAANEL	RYPPAANEL
LYPHEPTAVF	LYPHETAVF
NYFPGGVAL	NYFPGGVAL
SFMIMKTNF	SFMIMKTNF
FFYTHLINF	FFYTHLINF
TYLVAFAY	TYLVA-FAY
RYMEVSGNL	RYMEVSGNL
VFQLRDSVY	VFQLRDSVY
RFQDLIREL	RFQDLIREL
RFPELSLAL	RFPELSLAL
QFYDNKGITY	FYDNKGITY
RFIGATANF	RFIGATANF
FIAPTGHSL	FIAPTGHSL
AFFTSKALNM	AFFTS-KAL
IYYTGKYQSL	IYYTGYQSL
FYSPNIMAL	FYSPNIMAL
SYQRAFNEF	SYQRAFNEF
SYVQVTSNF	SYVQVTSNF
FYQDTFGQQWK	FYQDTGQQW
SFGARAEL	SFGAR-AEL
LYQSPVKEL	LYQSPVKEL
TYIKRVIAH	TYIKRVIAH
YYVDTFVSVY	YYVDTVSVY
IYLIKGSAL	IYLIKGSAL
AFITIQVAQM	AFITIVAQM
YFLIGKVY	YFLIG-KVY
IYATEAHVF	IYATEAHVF
FYHFVQIVH	FYHFVQIVH
AFADYVSTM	AFADYVSTM
NFPGIVTSF	NFPGIVTSF
YYFVTREVM	YYFVTREVM
VYHEPSSIGSM	VYHEP-SSI
NFPEHIFPA	NFPEHIFPA
VYVKHSISF	VYVKHSISF
HFYRSLVAH	HFYRSLVAH
FYPAKVTAV	FYPAKVTAV
SYQNNITHL	SYQNNITHL
VYQYMHETI	VYQYMHETI
LFTENVLAH	LFTENVLAH
NFIKAIQAY	NFIKAIQAY
LLPSHPLEL	LLPSHPLEL
YYFDSYAHF	YYFDSYAHF
LYDQISLPF	LYDQISLPF
IYNIGTNF	IYNIG-TNF
VFHVSNLEF	VFHVSNLEF
YYYDPTTGLYY	YYYDPTTGL
KFYNAGLAY	KFYNAGLAY
MYIYSGNSL	MYIYSGNSL
YFIAPTGHSL	YFIAPGHSL
VFQPVAEL	VFQPV-AEL
FYPEEVSSM	FYPEEVSSM
NYPGLSISL	NYPGLSISL
NYVDLVSSL	NYVDLVSSL
HYLYIQMEY	HYLYIQMEY
KYFEGVSPKSL	KYFEGVSPK
SYNIGRAW	SYNIG-RAW
FYPPPRITL	FYPPPRITL
VFSVRGTSF	VFSVRGTSF
LFVGSIPK	LFVGS-IPK
LYPDLLPTDY	LYPDLPTDY
MFNNANVL	MFNNA-NVL
SIPGGYNAL	SIPGGYNAL
IWPEKVLDI	IWPEKVLDI
YFEGGVSSV	YFEGGVSSV
VYNEAGVTF	VYNEAGVTF
VYISSRPPL	VYISSRPPL
RYPDNLKHL	RYPDNLKHL
FYLPHGLSI	FYLPHGLSI
VYLPGVIAA	VYLPGVIAA
KYQHTGAVL	KYQHTGAVL
YYFDAAEAEAW	YYFDA-AEA
FYYNTSEQNVM	YYNTSQNVM
RFPDTVSTV	RFPDTVSTV
FYQEHPDL	FYQEH-PDL
VYALVVVSY	VYALVVVSY
MFNIHRGF	MFNIH-RGF
AYSHIYSSY	AYSHIYSSY
HFIRPGNAL	HFIRPGNAL
NYYNLQGISH	YYNLQGISH
LFMPRSTEF	LFMPRSTEF
AFIITINSF	AFIITINSF
AFVTFTTRAM	AFVTFTRAM
YYHGPTPIQSL	YYHGPIQSL
IYIDRHVMQPY	IYIDR-HVM
AFQHVGKAF	AFQHVGKAF
RYYDVPIATL	RYYDVIATL
YYYDPQTGLY	YYYDPQTGL
GYFAGKLSY	GYFAGKLSY
MFQHIEESF	MFQHIEESF
FYVVVTEGY	FYVVVTEGY
LFIHFANVY	LFIHFANVY
LFLTGESY	LFLTG-ESY
YYLNEQGDRVY	YLNEQDRVY
HFYLKALSL	HFYLKALSL
IYQEGWRTVF	IYQEGRTVF
YYTDFVMEL	YYTDFVMEL
VFIDGPLAL	VFIDGPLAL
GFMPGAHVF	GFMPGAHVF
LYLDESNAL	LYLDESNAL
YLPNQLFRTF	YLPNQFRTF
QFQFGHAL	QFQFG-HAL
NYIDKVRFL	NYIDKVRFL
FYQVGILY	FYQVG-ILY
NFPEYELPEL	NFPEYLPEL
FYYGGQVNY	FYYGGQVNY
VYMNRVKEI	VYMNRVKEI
SPGAAVVML	SPGAAVVML
IYQYVLNSM	IYQYVLNSM
AFNISSNL	AFNIS-SNL
KYMSVIAEL	KYMSVIAEL
SFPIFISAL	SFPIFISAL
YFITQDSAF	YFITQDSAF
YFIPNKEF	YFIPN-KEF
YYVDFFKTL	YYVDFFKTL
IIHEIAVLEL	IIHEIVLEL
IYLPAAQTM	IYLPAAQTM
NFFPSGIDF	NFFPSGIDF
IYHNPTANSF	IYHNPANSF
YFPENVKAM	YFPENVKAM
YYYDTHTNTY	YYYDTTNTY
LFPGKVHSL	LFPGKVHSL
RYRPGTVAL	RYRPGTVAL
ASPVRLLSL	ASPVRLLSL
VFVDRTLDL	VFVDRTLDL
EHDYFEFFSND	FFSND----
VYQPMEKLY	VYQPMEKLY
IYQELVTKY	IYQELVTKY
YFPTQALNF	YFPTQALNF
RFLPEALFL	RFLPEALFL
AYTLGVKQL	AYTLGVKQL
YYITNDTVQTY	YYITNVQTY
MYKVGPVL	MYKVG-PVL
NFHASNTHL	NFHASNTHL
NVDYFFNF	NVDYF-FNF
AYYGNISHF	AYYGNISHF
YWVPRNAL	YWVPR-NAL
IYQIHKEYL	IYQIHKEYL
YFLQRHEL	YFLQR-HEL
SYYAVAHAV	SYYAVAHAV
SAPYGRITL	SAPYGRITL
QDGSVDFGR	QDGSVDFGR
AFLTGVGL	AFLTG-VGL
SWIQGVLSH	SWIQGVLSH
LFVDKIREY	LFVDKIREY
SFSHSFSAL	SFSHSFSAL
VYQEIWIGM	VYQEIWIGM
TYYVSTVLF	TYYVSTVLF
LYLPATTPY	LYLPATTPY
VYLPTREY	VYLPT-REY
GFGGGGYGGF	GFGGGYGGF
HYQPVDVSL	HYQPVDVSL
IFPEGRPVV	IFPEGRPVV
SFHNIHNTF	SFHNIHNTF
SYIYGAQHL	SYIYGAQHL
SYYEEALEL	SYYEEALEL
VYNASNNEL	VYNASNNEL
KFMDASAL	KFMDA-SAL
LSHLQYFYP	LSHLQYFYP
FFFTARTSFF	FFFTARTSF
HFYRSLVSH	HFYRSLVSH
FYYENENVKGL	FYYEN-ENV
LFPVPGSGL	LFPVPGSGL
FTMVGKTF	FTMVG-KTF
RYIPTAAAF	RYIPTAAAF
LFMDNKNEL	LFMDNKNEL
FFLSQQASL	FFLSQQASL
NYIHVGAQL	NYIHVGAQL
SYMEVPTYL	SYMEVPTYL
SYYQSSVQY	SYYQSSVQY
SWPTYPQLY	SWPTYPQLY
VYIDKVRSL	VYIDKVRSL
AYAPAAATV	AYAPAAATV
MYIARQLSF	MYIARQLSF
YFPGQAIAM	YFPGQAIAM
HFQPSTVEM	HFQPSTVEM
AFIGVASNF	AFIGVASNF
RFPEHVREI	RFPEHVREI
IYPDSFTVL	IYPDSFTVL
TYNYPVHYF	TYNYPVHYF
FFLPAAAF	FFLPA-AAF
LFPDTPLAL	LFPDTPLAL
KFIDTTSKF	KFIDTTSKF
YYFDGKGKAF	YYFDGGKAF
LYFGSAFATPF	YFGSAATPF
SYPDFLHKM	SYPDFLHKM
SYQESTKQL	SYQESTKQL
FFHQENVRAL	FFHQEVRAL
KFFTGDVF	KFFTG-DVF
TYFIVGTAM	TYFIVGTAM
IYHISLEY	IYHIS-LEY
FYIFDRDVF	FYIFDRDVF
SFYSLTSSNIS	FYSLTSSNI
LYQLQVNTL	LYQLQVNTL
SMPTIPALAL	SMPTIALAL
FYYIRISEL	FYYIRISEL
VLPSERYKEL	VLPSEYKEL
SYLHSLLEM	SYLHSLLEM
FLYPFPLAL	FLYPFPLAL
HYYQKALEL	HYYQKALEL
VYIAYSTFY	VYIAYSTFY
LFLEKAMQL	LFLEKAMQL
AYITQKVEF	AYITQKVEF
SYADNILSF	SYADNILSF
YYLHDVLDL	YYLHDVLDL
ILPKYVQQV	ILPKYVQQV
FYPHHPQML	FYPHHPQML
TYLVGNSL	TYLVG-NSL
RYVWDYTEL	RYVWDYTEL
VYMLAASL	VYMLA-ASL
RLMVHTVATF	RLMVHVATF
VYFPQISSV	VYFPQISSV
VAPVASAL	VAPVA-SAL
HFYDFERDAY	HFYDFRDAY
SFPQPAAVY	SFPQPAAVY
IFQDPRSWF	IFQDPRSWF
FFVGYGVTL	FFVGYGVTL
LYFQSKENL	LYFQSKENL
AFKNRMEV	AFKNR-MEV
SYISRTNQL	SYISRTNQL
YWPTYTPMEV	YWPTY-TPM
GYLISGSSY	GYLISGSSY
RYMKPGKEL	RYMKPGKEL
SFLATITSF	SFLATITSF
RYWNSYTEF	RYWNSYTEF
LLPEFPRGPL	LLPEFRGPL
TYFAVNANY	TYFAVNANY
VYVMGGVAM	VYVMGGVAM
VFQSVKSL	VFQSV-KSL
LYMPAVGFL	LYMPAVGFL
RYQEKISAL	RYQEKISAL
RYYAFDEAF	RYYAFDEAF
FYSGSPTSY	FYSGSPTSY
AFKAIGTAY	AFKAIGTAY
FFFSLSSSL	FFFSLSSSL
NYYPYTITEY	YYPYTITEY
YYNKVSTVF	YYNKVSTVF
YYNGKIHAY	YYNGKIHAY
MYKYPSDISY	KYPSD-ISY
AYLEALSH	AYLEA-LSH
WYMDNPQNL	WYMDNPQNL
NFISLGPSIS	NFISLGPSI
YYPLVAQHY	YYPLVAQHY
VYIDTESAF	VYIDTESAF
RFQSSAVMAL	RFQSSVMAL
AYYDPKTRAM	AYYDPTRAM
VVPEPGQPL	VVPEPGQPL
VYNFSLVAL	VYNFSLVAL
KYLTAEAF	KYLTA-EAF
SFYEKGPLTF	SFYEKPLTF
SFSNAARVL	SFSNAARVL
VYIPSKTDL	VYIPSKTDL
MMPPMGGPPM	MMPPMGPPM
NFLVSEAL	NFLVS-EAL
FYNEYVREL	FYNEYVREL
AYQLAFRY	AYQLA-FRY
FFFAPASSY	FFFAPASSY
AFPYGNVAF	AFPYGNVAF
VFRNAASF	VFRNA-ASF
KFPIVNAEL	KFPIVNAEL
LYSPQYISY	LYSPQYISY
YYTDFLITL	YYTDFLITL
GYVVVTSSM	GYVVVTSSM
FYMIGSEV	FYMIG-SEV
SYHLVGISF	SYHLVGISF
YYEDNKQFF	YYEDNKQFF
LFPGPSKPF	LFPGPSKPF
RYPDTIALTF	RYPDTALTF
EFPAAAREL	EFPAAAREL
FYISPRITF	FYISPRITF
VYTYIQEFY	VYTYIQEFY
LYTVTGQSW	LYTVTGQSW
HYPDYSWSA	HYPDYSWSA
FYVIGSSY	FYVIG-SSY
VTNLFNLDF	VTNLFNLDF
AYMAAFNSI	AYMAAFNSI
VFYGFAVHM	VFYGFAVHM
YYSPTKNEI	YYSPTKNEI
TYPSNILSH	TYPSNILSH
TYGERVVAF	TYGERVVAF
YYFPVREL	YYFPV-REL
TYLPAGQSV	TYLPAGQSV
SFPELNAAF	SFPELNAAF
YFQDGRAVL	YFQDGRAVL
YYQYMETYM	YYQYMETYM
NYITPVNSL	NYITPVNSL
IFQIHTSRM	IFQIHTSRM
AFFAAPNSI	AFFAAPNSI
IYADPTKRLEL	IYADPTKRL
FFPMHFQAF	FFPMHFQAF
TYQRSVLAL	TYQRSVLAL
AFLPTLQTL	AFLPTLQTL
AYMPPTSEA	AYMPPTSEA
IFIAGSKQY	IFIAGSKQY
AYQFFREAL	AYQFFREAL
FFFNGQHM	FFFNG-QHM
FFYEKISAW	FFYEKISAW
RYTFYVLEF	RYTFYVLEF
FFFTGPLSHF	FFFTGPLSH
NFLLHVTAL	NFLLHVTAL
IYPEVVHMF	IYPEVVHMF
SFYTAIAQAF	SFYTAAQAF
NYVNGKTF	NYVNG-KTF
QFQKVITEY	QFQKVITEY
YFYVIGSSY	YFYVIGSSY
HYPDFHQEL	HYPDFHQEL
RYIEKLTNEM	RYIEKTNEM
LFLTSLHSM	LFLTSLHSM
MYFDWGPGEM	YFDWGPGEM
SYLDFTNPK	SYLDFTNPK
QYPDFNNYL	QYPDFNNYL
YYDGDVGNYYY	YYDGDVGNY
FFVPHGYL	FFVPH-GYL
YYIYSKVQL	YYIYSKVQL
AFNTTVAAL	AFNTTVAAL
SYFPKILTF	SYFPKILTF
YFINGDISSL	YFINGISSL
FYAKGALQY	FYAKGALQY
AYQLAGHSF	AYQLAGHSF
YYTVAHAI	YYTVA-HAI
FFYPGWKVL	FFYPGWKVL
SLHTLFGDK	SLHTLFGDK
VFHAGTAL	VFHAG-TAL
EYYDKHFTEF	YYDKHFTEF
FFPFNPLDF	FFPFNPLDF
SYYNSHDSL	SYYNSHDSL
FYIPKIQDL	FYIPKIQDL
SYMVKGMAF	SYMVKGMAF
VYFQMQTTY	VYFQMQTTY
YYLVKREDY	YYLVKREDY
NFQWPVLAF	NFQWPVLAF
LFMPSTSSM	LFMPSTSSM
TYPPYVPEY	TYPPYVPEY
VFYELAHQL	VFYELAHQL
LYPWGVVEV	LYPWGVVEV
IFYEHLTRSL	IFYEHTRSL
KYMNNITY	KYMNN-ITY
HLPETKFSEL	HLPETFSEL
FYQGIVQQF	FYQGIVQQF
RYMVHLLEL	RYMVHLLEL
TFMNRVEV	TFMNR-VEV
YFPSWLSQL	YFPSWLSQL
SYEAQITAL	SYEAQITAL
LFQENSVLSSL	LFQEN-SVL
AYYEFKKQFF	AYYEFKKQF
VFPTRTARF	VFPTRTARF
IFMEKSTRDF	IFMEKTRDF
NYMMRNAVL	NYMMRNAVL
YFLDKIDVI	YFLDKIDVI
AYQYTIRAH	AYQYTIRAH
YFPEYAEKI	YFPEYAEKI
TYIGYLPLAH	TYIGY-LPL
FFLIVKTLY	FFLIVKTLY
VFPDFYLHL	VFPDFYLHL
AFPFNMQEL	AFPFNMQEL
NFLNRTSL	NFLNR-TSL
SFQDFVSHF	SFQDFVSHF
YYFAVDTM	YYFAV-DTM
YFHEFGHVM	YFHEFGHVM
KYFIRDEF	KYFIR-DEF
SYEFMRRSL	SYEFMRRSL
RYLVRAIL	RYLVR-AIL
QYYALEVSY	QYYALEVSY
LYFTGEAI	LYFTG-EAI
VFMTHLEF	VFMTH-LEF
FYTPQNPSSL	FYTPQPSSL
FSSFIYFASL	SFIYF-ASL
VFPEFAAAH	VFPEFAAAH
AYHELAQVY	AYHELAQVY
NFYEGHITSL	NFYEGITSL
FYNTSIEEM	FYNTSIEEM
FYLDTVSAL	FYLDTVSAL
IFQDPTAMM	IFQDPTAMM
FYIDPYKLLPL	FYIDPYKLL
HFYYFVKEF	HFYYFVKEF
LFGPGAGGL	LFGPGAGGL
TYVTEVREL	TYVTEVREL
YFTDKAASY	YFTDKAASY
YFFAVSTL	YFFAV-STL
YVSLDNAVL	YVSLDNAVL
SYFGSFSSL	SYFGSFSSL
KAPAPRPSL	KAPAPRPSL
NYPHFFLDF	NYPHFFLDF
YYTPITPHL	YYTPITPHL
AFYEHAQTYY	AFYEHAQTY
RYLSKVLEL	RYLSKVLEL
FYVASSRQL	FYVASSRQL
VYNNIMRHY	VYNNIMRHY
AFFNIPLMAY	FFNIPLMAY
FFEDEKPAL	FFEDEKPAL
VFVVGTER	VFVVG-TER
IYVTGITNH	IYVTGITNH
RFFAQSQSL	RFFAQSQSL
FFPEYTHQLF	FFPEYTHQL
AFEDYVQSM	AFEDYVQSM
AFYDWDNTEL	AFYDWNTEL
KYFPSRVSI	KYFPSRVSI
IFMENRNEF	IFMENRNEF
LYHEHIIKY	LYHEHIIKY
AFIQQNISF	AFIQQNISF
FFHNVDVPF	FFHNVDVPF
AYYERALQL	AYYERALQL
VFMPHVTEAY	VFMPHTEAY
TLPHEILEM	TLPHEILEM
YFMVGTAF	YFMVG-TAF
FFQGGIPRAL	FFQGGPRAL
AYYEFREEAY	AYYEFEEAY
SYFMATNSL	SYFMATNSL
YYALEVSYF	YYALEVSYF
VFVVGESY	VFVVG-ESY
IFIDEIDSF	IFIDEIDSF
SYMAYMTQY	SYMAYMTQY
FFLVVDAY	FFLVV-DAY
SYHPALNAI	SYHPALNAI
KYLAVRLAL	KYLAVRLAL
AFMAAESL	AFMAA-ESL
FYLNPDQSGEF	LNPDQSGEF
FYSNKEIFL	FYSNKEIFL
NFYGDLRKAL	FYGDLRKAL
HYHPSKVAA	HYHPSKVAA
MAPERVASL	MAPERVASL
YYQSGRMLL	YYQSGRMLL
NFQAIRVTL	NFQAIRVTL
IFQGNVHNF	IFQGNVHNF
IFLNLKTAL	IFLNLKTAL
FYQDTYGQQWK	FYQDTGQQW
IYIVHDEV	IYIVH-DEV
LYQTINSL	LYQTI-NSL
KFPEIVAPL	KFPEIVAPL
FYYFPDSGFF	YFPDS-GFF
VYALPTIAF	VYALPTIAF
AYNFPVTAM	AYNFPVTAM
YYYDTHTNTYY	YYYDTTNTY
YYFSAHAL	YYFSA-HAL
YFRPIDTTM	YFRPIDTTM
IYFADGKVY	IYFADGKVY
HYNLQNAF	HYNLQ-NAF
YYPPSQIAQL	YYPPSIAQL
AYQIAEQF	AYQIA-EQF
VYLERLLTY	VYLERLLTY
SAPVGVTAL	SAPVGVTAL
MYPKAVQDL	MYPKAVQDL
QFLPRTITL	QFLPRTITL
NYQAYRSYL	NYQAYRSYL
SYLDRTEQL	SYLDRTEQL
FYPGASPTEF	FYPGAPTEF
NMNTMGHMM	NMNTMGHMM
IYQLQDVF	IYQLQ-DVF
LFPEGPARAF	LFPEGARAF
VYIGVHVPF	VYIGVHVPF
VYQNHVQHL	VYQNHVQHL
IYTDYRPTPL	IYTDYPTPL
AFIEESRQL	AFIEESRQL
QYMERLQL	QYMER-LQL
NFLNMSRSM	NFLNMSRSM
IFQPVAEL	IFQPV-AEL
GFIDSFRPL	GFIDSFRPL
IYQNAATSF	IYQNAATSF
LFALHASQF	LFALHASQF
AFQFFAEEY	AFQFFAEEY
AFIERLEM	AFIER-LEM
LFLPTAAAY	LFLPTAAAY
YWPHQPIENL	YWPHQIENL
YYYVGFAY	YYYVG-FAY
QYMERLQLL	QYMERLQLL
IPEEDAGKL	IPEEDAGKL
FWPEAFSEV	FWPEAFSEV
IYSSKTLEL	IYSSKTLEL
IFPTLTSPL	IFPTLTSPL
VYYGHTNYIY	VYYGHTNYI
VFMDSNGIRQF	VFMDS-NGI
YYQTIGNHASY	YYQTIGNHA
KWPETPLLL	KWPETPLLL
IFIPKTEEM	IFIPKTEEM
IFIKDSNSL	IFIKDSNSL
VPDTITEWK	VPDTITEWK
LYPKSTHAL	LYPKSTHAL
FFPTQGHDY	FFPTQGHDY
AFQNVLTH	AFQNV-LTH
IFHNNWREM	IFHNNWREM
YFLEMQEKL	YFLEMQEKL
YYQSSVQYL	YYQSSVQYL
YYSPTKNEIVF	YYSPTKNEI
YYINYTTIEL	YYINYTIEL
YYITTRVQF	YYITTRVQF
RYPGYMNNDL	RYPGYNNDL
AYNPMARDL	AYNPMARDL
IYTVGKRF	IYTVG-KRF
YYPDPTFPAM	YYPDPFPAM
TYFFKRTQYF	YFFKRTQYF
VFITDKISSF	VFITDISSF
FYIIEREPL	FYIIEREPL
QYYSYFTSH	QYYSYFTSH
AYLSKAMEI	AYLSKAMEI
SLPAYLNSL	SLPAYLNSL
YYPEYKLLF	YYPEYKLLF
VYQAVLSL	VYQAV-LSL
VGPAAFLYF	VGPAAFLYF
YYKPDSPEY	YYKPDSPEY
HFFEFLTKEL	HFFEFTKEL
YWPEGKRVAM	YWPEGRVAM
FFFPFDTRQM	FFPFDTRQM
AYLQSYLSY	AYLQSYLSY
SYPFLVLQM	SYPFLVLQM
KFISGILAA	KFISGILAA
YIPEITSVL	YIPEITSVL
AYALAGVSF	AYALAGVSF
TFPLEAITAF	TFPLEITAF
AYLPNGAAL	AYLPNGAAL
FFLVSREL	FFLVS-REL
YVHMVTHF	YVHMV-THF
AYRDWFSSQL	AYRDWSSQL
QFYGLTPLVR	QFYGL-TPL
RYYSSEYHY	RYYSSEYHY
SYNISEVM	SYNIS-EVM
IYPTAPPRSY	IYPTAPRSY
FYQTAEEL	FYQTA-EEL
TFTNHMVF	TFTNH-MVF
YYLAQIPIAM	YYLAQPIAM
HYYGPALEF	HYYGPALEF
FYFAAEHL	FYFAA-EHL
NYLVVAAM	NYLVV-AAM
LFYTGKQSYY	LFYTGKQSY
LYSTHAAL	LYSTH-AAL
FFSEYEKLL	FFSEYEKLL
FYGKAIEL	FYGKA-IEL
KFNVTTVDM	KFNVTTVDM
FFYSEIMEL	FFYSEIMEL
TYLPRIKEY	TYLPRIKEY
TFVEPVSAF	TFVEPVSAF
LYINHTPPPL	LYINHPPPL
SYAVGHFL	SYAVG-HFL
AFLDSQTATF	AFLDSTATF
FYLPIAAAMY	FYLPIAAAM
TFPASVLQF	TFPASVLQF
TFMEQKITY	TFMEQKITY
VFTNRTVL	VFTNR-TVL
HAPFTATSL	HAPFTATSL
GYVLYASAM	GYVLYASAM
SFQEVREYM	SFQEVREYM
AYFDAASEI	AYFDAASEI
LFQEAEEF	LFQEA-EEF
VFHPKRAVF	VFHPKRAVF
AFGTRDAL	AFGTR-DAL
EYIPGTTSL	EYIPGTTSL
RYAEAVQLL	RYAEAVQLL
NYNTIFQYY	NYNTIFQYY
VFLNGNKL	VFLNG-NKL
AFQQQIQTL	AFQQQIQTL
MWFDKTPLSY	MWFDKPLSY
RFIAVVHPL	RFIAVVHPL
AYLTLTSRM	AYLTLTSRM
YYPGFNPFRAY	YYPGF-NPF
HYFSQGLSV	HYFSQGLSV
LFYFSNEKY	LFYFSNEKY
YYFSTISSSF	YYFSTSSSF
TYSLGSAL	TYSLG-SAL
FFYDGIKAIF	FFYDGIKAI
VYQPKRSVL	VYQPKRSVL
VYLHYLPSYY	VYLHYLPSY
KFLASDVVF	KFLASDVVF
VFINVPTVSF	VFINVTVSF
AYVDKYRHM	AYVDKYRHM
IYMESLAL	IYMES-LAL
VYLVHDEL	VYLVH-DEL
KYPNFDVEY	KYPNFDVEY
VYQSMVLFF	VYQSMVLFF
VYHNVKPAAL	VYHNVPAAL
FFQQTTTSF	FFQQTTTSF
NFFTKATPL	NFFTKATPL
IFQAVETAI	IFQAVETAI
PYYASAFSM	PYYASAFSM
SFLTAAHM	SFLTA-AHM
FYFDNILNSF	FYFDNLNSF
IYAVNGIAF	IYAVNGIAF
IFPYAFKEV	IFPYAFKEV
FYPGSIEVRWF	FYPGS-IEV
FFVENVSEL	FFVENVSEL
YYQEYPMSI	YYQEYPMSI
YFIDTDLNQL	YFIDTLNQL
IYMDTLNIFM	IYMDTLNIF
AFVLSSNSL	AFVLSSNSL
NFLESKFSL	NFLESKFSL
KYFDKRRDYL	KYFDKRRDY
YYYNGKAVY	YYYNGKAVY
FFANHPDL	FFANH-PDL
IFEAKKSFY	IFEAKKSFY
HYNNIMALY	HYNNIMALY
IYLLIHNNF	IYLLIHNNF
IFNNSSHF	IFNNS-SHF
AYVSGLSF	AYVSG-LSF
AYYGYPYNAL	AYYGYYNAL
IYPEAVTMF	IYPEAVTMF
SYAVMQISM	SYAVMQISM
YFRVMVDSL	YFRVMVDSL
HYQLQTTSL	HYQLQTTSL
FYHPETTQL	FYHPETTQL
KFMQDVNTL	KFMQDVNTL
FFLLGKTL	FFLLG-KTL
IFQALNVYY	IFQALNVYY
SFMSGADSF	SFMSGADSF
NFIKAMVSY	NFIKAMVSY
FYIENQKEY	FYIENQKEY
FYITPSTSL	FYITPSTSL
TYPDWIGQSY	TYPDWGQSY
VFNTTSYL	VFNTT-SYL
AFADNVSGL	AFADNVSGL
LFPEPEHSSF	LFPEPHSSF
QYYQNDIPY	QYYQNDIPY
FLPLFDRVL	FLPLFDRVL
SFPPETQAL	SFPPETQAL
VYITRAQL	VYITR-AQL
KYPASSSVF	KYPASSSVF
YFQALVNNM	YFQALVNNM
MYPDQVQLL	MYPDQVQLL
RYHTGSLAF	RYHTGSLAF
SYFEIPTKEF	SYFEITKEF
IFNVSQQM	IFNVS-QQM
IFPTSTISF	IFPTSTISF
QYLSQKKTI	QYLSQKKTI
SMIENVLAF	SMIENVLAF
IYQELLGLAF	IYQELGLAF
QFQPKLTDF	QFQPKLTDF
SYFDAIPVTM	SYFDAPVTM
VFNSMLVSI	VFNSMLVSI
RYSEAVFYY	RYSEAVFYY
FYPKANIVAY	FYPKAIVAY
FFTARTSFF	FFTARTSFF
VFIHQPRAL	VFIHQPRAL
SFLPLAHMF	SFLPLAHMF
VYQTYVNAM	VYQTYVNAM
FWPPQPKLY	FWPPQPKLY
YYQLSEEL	YYQLS-EEL
YYIRFFITY	YYIRFFITY
RVYIHPFHL	RVYIHPFHL
TFAEIVTPF	TFAEIVTPF
FYPPLTSSL	FYPPLTSSL
FYEPYSREL	FYEPYSREL
FFYVTETTF	FFYVTETTF
YFQAHKAVL	YFQAHKAVL
RYQDAIRVF	RYQDAIRVF
IFIARSQM	IFIAR-SQM
VVNIQTIAM	VVNIQTIAM
YFEPKDITA	YFEPKDITA
FFIAGRYEF	FFIAGRYEF
FYHLGVRESF	FYHLGRESF
SFAAVIQAL	SFAAVIQAL
SYGLNIEM	SYGLN-IEM
AFSFSKTPK	AFSFSKTPK
VFPEDMAKY	VFPEDMAKY
KFISSVTSH	KFISSVTSH
YLPENQVLPH	YLPEN-QVL
AYYPAQGVQQF	YYPAQVQQF
AYLALRISY	AYLALRISY
YFIAPSGHGL	YFIAPGHGL
QFRNAPPF	QFRNA-PPF
NYIDLPVLAI	NYIDLVLAI
NFLGAENAF	NFLGAENAF
AFIFRSLNL	AFIFRSLNL
VFSHRLSVY	VFSHRLSVY
SFQEVREY	SFQEV-REY
LFFVGNQL	LFFVG-NQL
RFNSITSAY	RFNSITSAY
MFHWQATIM	MFHWQATIM
TYVGGHVEAL	TYVGGVEAL
SYYSPSIGF	SYYSPSIGF
QYYVGQSF	QYYVG-QSF
VNLPINGNGKQ	NLPINGNGK
FYQDTYGQQW	FYQDTGQQW
KFISGILAAL	KFISGLAAL
SFPVRGTPM	SFPVRGTPM
VFQKPSGVSA	VFQKPGVSA
LYLDGHVF	LYLDG-HVF
RYPDIQASYL	RYPDIQASY
KYMDVQFDF	KYMDVQFDF
SYQIPTENSM	SYQIPENSM
FYLSGTYY	FYLSG-TYY
SFISVIKEM	SFISVIKEM
VFFVGQSA	VFFVG-QSA
SFYNLLTRTF	FYNLLTRTF
AYLEALSHL	AYLEALSHL
FFPDGHVMML	FFPDGVMML
FYVDTVRAF	FYVDTVRAF
YFPEEKFESL	YFPEEFESL
YFKGDTIAL	YFKGDTIAL
NYLNQGVVH	NYLNQGVVH
VMAPRTLIL	VMAPRTLIL
FFQETKTGEL	FFQETTGEL
LYYPQQAIVF	YYPQQAIVF
FFLQVKEGIL	FFLQVEGIL
YYVRAVLHL	YYVRAVLHL
RYVDRVTEF	RYVDRVTEF
AYQSIQNYL	AYQSIQNYL
NFNTSVQAL	NFNTSVQAL
SYFEKETLTF	SYFEKTLTF
AYGASFLSF	AYGASFLSF
AYQVGAVL	AYQVG-AVL
AYVHMVTHF	AYVHMVTHF
RIIEETLAL	RIIEETLAL
SFFGNVMSM	SFFGNVMSM
IFIDRDPAAF	IFIDRPAAF
RYMSINTHL	RYMSINTHL
LYLPMAQSV	LYLPMAQSV
VYMIRVYL	VYMIR-VYL
NYMPGQLTI	NYMPGQLTI
VLPERYSSL	VLPERYSSL
FFLAAKEL	FFLAA-KEL
VFIDKQTNL	VFIDKQTNL
SYIFPSSISAM	IFPSSISAM
NFQEPVQPL	NFQEPVQPL
KYNIMLVRL	KYNIMLVRL
VYQETSEM	VYQET-SEM
VFTIQSIVM	VFTIQSIVM
VFLPRALAL	VFLPRALAL
HYNNIMAL	HYNNI-MAL
IYHTIAYL	IYHTI-AYL
NYPIGTNAI	NYPIGTNAI
VFQTKIQEF	VFQTKIQEF
AFPGGPLGAL	AFPGGLGAL
YFISHVLAF	YFISHVLAF
FYYDEFGFRVY	FYYDE-FGF
AFPDGRSSF	AFPDGRSSF
KYKASITAL	KYKASITAL
VFFVHEGY	VFFVH-EGY
KYMPNVKVA	KYMPNVKVA
NFPQYVMDV	NFPQYVMDV
YFVDDRLVM	YFVDDRLVM
SFLATGSNL	SFLATGSNL
AYYQFINEL	AYYQFINEL
SFQFAHLEF	SFQFAHLEF
NYNFQYISL	NYNFQYISL
TYVSWAIAY	TYVSWAIAY
NYYDLVRTEI	NYYDLRTEI
VFYYFVSAL	VFYYFVSAL
LYQTVTGL	LYQTV-TGL
SFPEHMANV	SFPEHMANV
LGHSPLGGLR	LGHSPLGGL
AYFTTPIFY	AYFTTPIFY
VYFGTSHPRYY	YFGTSPRYY
AYYEHRLQL	AYYEHRLQL
QFPELMGVF	QFPELMGVF
FFPSGIDF	FFPSG-IDF
AYFGTGFPH	AYFGTGFPH
IYVTGGYSY	IYVTGGYSY
FFLEALDF	FFLEA-LDF
SFYNKRTLTF	FYNKRTLTF
IYLNWSPEAY	IYLNWPEAY
KFYYSKIEY	KFYYSKIEY
YFFPRADL	YFFPR-ADL
VFPETVPSL	VFPETVPSL
IYHAVAAL	IYHAV-AAL
YFKGAIPL	YFKGA-IPL
YYQTPRLWL	YYQTPRLWL
TYLTGDQF	TYLTG-DQF
PIRLLAAAA	PIRLLAAAA
YFQHREFSF	YFQHREFSF
IAYDVTYSL	IAYDVTYSL
NYTDRIQVL	NYTDRIQVL
AYIAVGSISF	AYIAVSISF
YFHDRVASFY	YFHDRVASF
FYNPVQEF	FYNPV-QEF
IFQELVEGVFY	IFQELVEGV
VYVERAEVL	VYVERAEVL
FYPIYFRPL	FYPIYFRPL
FYPDEIQRPPV	FYPDE-IQR
FTPAVHASL	FTPAVHASL
TFGTMGVGL	TFGTMGVGL
YFEDVANAM	YFEDVANAM
MFFFSRLEY	MFFFSRLEY
HFNTVLEAY	HFNTVLEAY
FYITSRTQF	FYITSRTQF
GFPEAASSF	GFPEAASSF
VFNPAKEL	VFNPA-KEL
NFNWGRVV	NFNWG-RVV
MFLTRSEY	MFLTR-SEY
FFPEYTHQL	FFPEYTHQL
IAPTGHSL	IAPTG-HSL
FYFDLNSEQM	FYFDLSEQM
FFYGHSAF	FFYGH-SAF
SFNSSFTSL	SFNSSFTSL
TYPEFLANAL	TYPEFANAL
VYIDRVRSL	VYIDRVRSL
YYQPYEIPAV	YYQPYIPAV
VYLYYKLAY	VYLYYKLAY
TYASFTRAY	TYASFTRAY
SFGYQITSF	SFGYQITSF
LYYNANRAF	LYYNANRAF
RYIANTVEL	RYIANTVEL
AYIDPIAMEYY	AYIDPAMEY
NFIEKVEAL	NFIEKVEAL
KFPTYPVPH	KFPTYPVPH
FFMPGFAPL	FFMPGFAPL
VYNYAEQTL	VYNYAEQTL
NYQVQFVTL	NYQVQFVTL
RYLYMVMEY	RYLYMVMEY
AYLIMISAL	AYLIMISAL
FFYEGSRVL	FFYEGSRVL
RYPEEDYESF	RYPEEYESF
AYNAVVRYF	AYNAVVRYF
FFNSVRSVF	FFNSVRSVF
LYQARIVSH	LYQARIVSH
RFPDVANGF	RFPDVANGF
YYINKISSTL	YYINKSSTL
IFQEPVSKY	IFQEPVSKY
HFPDLFHVM	HFPDLFHVM
YFLPDTAHF	YFLPDTAHF
SFIKEANTL	SFIKEANTL
FYPPKVELF	FYPPKVELF
AYGRMGLAL	AYGRMGLAL
AFPGASLYL	AFPGASLYL
IYPPEVAEF	IYPPEVAEF
SYPSVVSTL	SYPSVVSTL
SYHPSGLSL	SYHPSGLSL
FFYDGIKAIL	FFYDGIKAI
NYSPYVNYF	NYSPYVNYF
FYFWPRTVPM	YFWPRTVPM
AFHDNLRSL	AFHDNLRSL
MYPAFAEEY	MYPAFAEEY
NFIATVREV	NFIATVREV
SYQEHVKQL	SYQEHVKQL
RYIGKTMDY	RYIGKTMDY
YFHTMVESL	YFHTMVESL
TFATMVSSL	TFATMVSSL
YYQDTPKQI	YYQDTPKQI
VYPEYVIQY	VYPEYVIQY
AYSIRGQL	AYSIR-GQL
VFHPRQEL	VFHPR-QEL
YYFFTPYVY	YYFFTPYVY
YYLTHGLYL	YYLTHGLYL
VYKNPSEYHY	VYKNP-SEY
AYKPPGFSL	AYKPPGFSL
VYVVHDSL	VYVVH-DSL
FFSPKVVSL	FFSPKVVSL
KYQEVTNNL	KYQEVTNNL
HYINEVLFL	HYINEVLFL
AFISLAKTL	AFISLAKTL
EYLEKALEY	EYLEKALEY
FLPSHYNYL	FLPSHYNYL
VFVEDVDSF	VFVEDVDSF
TFQSTKAVY	TFQSTKAVY
FIRVSGSEL	FIRVSGSEL
HFGIHEEM	HFGIH-EEM
LYHWSVESY	LYHWSVESY
AFYEHAQTY	AFYEHAQTY
AFIRVVGSEF	AFIRVGSEF
VFQEPSLLSSL	VFQEP-SLL
YYFVFDHAL	YYFVFDHAL
YYIQNGIQSF	YYIQNIQSF
EWPPFVVTL	EWPPFVVTL
YFFDNDSKSF	YFFDNSKSF
FWPPYVELL	FWPPYVELL
LYYQYMETY	LYYQYMETY
AYLEAHETF	AYLEAHETF
LYQVGKEF	LYQVG-KEF
SFMDVSNPF	SFMDVSNPF
YLNENPLRAL	YLNENLRAL
QFPDFNNYL	QFPDFNNYL
SFPQYSPKM	SFPQYSPKM
LYPYWISAL	LYPYWISAL
HFPMQSREF	HFPMQSREF
AFHTASVL	AFHTA-SVL
HYHPIVQRF	HYHPIVQRF
SVPAFASSL	SVPAFASSL
KFMTHVASQF	KFMTHASQF
AFPGEARISNV	AFPGEARIS
FYLRDPIDL	FYLRDPIDL
NYIEFTRIL	NYIEFTRIL
YYTPDRMVL	YYTPDRMVL
RYQATGLHF	RYQATGLHF
KYYIPEVVY	KYYIPEVVY
LYQHAVEYF	LYQHAVEYF
YFQLHRAL	YFQLH-RAL
VYTTNIQEL	VYTTNIQEL
FYNLSIQSF	FYNLSIQSF
FYQPKIQQF	FYQPKIQQF
VYITGKEVF	VYITGKEVF
MTQIMFETF	MTQIMFETF
TFIQRVQSL	TFIQRVQSL
RYINPAKLTPY	RYINP-AKL
FFHNGRYL	FFHNG-RYL
LFVPRRAPF	LFVPRRAPF
SFISFANSR	SFISFANSR
YYYNKRILH	YYYNKRILH
FFYEGSRVLF	FFYEGSRVL
HFGGGGFLAF	HFGGGFLAF
GYQLTGHAY	GYQLTGHAY
NYIDRFLSSM	NYIDRLSSM
AFIDRKDSYY	AFIDRKDSY
FLPKGYLAL	FLPKGYLAL
SFYDSQGIHF	SFYDSGIHF
FFPLHPMMI	FFPLHPMMI
HYTVNLNTY	HYTVNLNTY
IYITGSSI	IYITG-SSI
RFPEEPHVPL	RFPEEHVPL
SLIGGAASL	SLIGGAASL
KYFGRSLEL	KYFGRSLEL
SYHVKTAFF	SYHVKTAFF
AFQVLVKSL	AFQVLVKSL
FFNDTTTAF	FFNDTTTAF
NYYTPITPH	NYYTPITPH
AYLNVVGM	AYLNV-VGM
FYALVSQEL	FYALVSQEL
AYALGATVL	AYALGATVL
VFRVSSSL	VFRVS-SSL
RFQSLGVAF	RFQSLGVAF
IYQSMPRML	IYQSMPRML
TYTTRIHL	TYTTR-IHL
NYPDYMPSNIF	NYPDYPSNI
FLPTYPPSAY	FLPTYPSAY
VYNVQYSFI	VYNVQYSFI
SFPGFHGSEM	SFPGFGSEM
TYLETKGAAL	TYLETGAAL
YYFNQHIF	YYFNQ-HIF
AFIDGGGSVL	AFIDGGSVL
AFNVSSHL	AFNVS-SHL
YYLTFVQEL	YYLTFVQEL
MYFVIAAM	MYFVI-AAM
SYLELVKSL	SYLELVKSL
VYPNWAIGL	VYPNWAIGL
VYMTEPIDEY	VYMTEIDEY
FYPDLGPEL	FYPDLGPEL
AYLVRWEY	AYLVR-WEY
FFKERVMEI	FFKERVMEI
LYHAGAVAF	LYHAGAVAF
YYQVLNFAM	YYQVLNFAM
FTIFRTISV	FTIFRTISV
RYYDDPREY	RYYDDPREY
AYILDTLVF	AYILDTLVF
HFYNVKSSL	HFYNVKSSL
VYQETRERLAM	VYQETRERL
SYMPTILWL	SYMPTILWL
AYVSPRAPF	AYVSPRAPF
YYHPARLGA	YYHPARLGA
YYLGKILEM	YYLGKILEM
FFIQDQIAL	FFIQDQIAL
RFVEVGRVAY	RFVEVRVAY
VFITKPPM	VFITK-PPM
MYFIVRSL	MYFIV-RSL
IFIPSSIAF	IFIPSSIAF
IYWDGPLAL	IYWDGPLAL
AFQNAYLEL	AFQNAYLEL
YFHTLTSEY	YFHTLTSEY
LYQFNPAFF	LYQFNPAFF
TYQVLAVTF	TYQVLAVTF
YYFNRKTF	YYFNR-KTF
SFYSGLTPTEF	FYSGLPTEF
RYVAIARAL	RYVAIARAL
LLPTGLSSL	LLPTGLSSL
FYPDKIDYA	FYPDKIDYA
HFYSSIPSM	HFYSSIPSM
EFNHYLTSM	EFNHYLTSM
RYIMGSGESF	RYIMGGESF
AYLAALTQL	AYLAALTQL
SYSPYVTEL	SYSPYVTEL
KYHVSEKPY	KYHVSEKPY
HYPSQPVFAPM	HYPSQ-PVF
HFITPVSTL	HFITPVSTL
LFLEGMHY	LFLEG-MHY
SFPENLRHL	SFPENLRHL
LYYPGSNL	LYYPG-SNL
LYQTALHL	LYQTA-LHL
LFIPRETTY	LFIPRETTY
YYMEGRDSMQL	YYMEGRDSM
VYPPGFMGL	VYPPGFMGL
FYFVDDRLVM	YFVDDRLVM
VFPEVGASVW	VFPEVGASV
LYNIGLTY	LYNIG-LTY
VFGTAISAF	VFGTAISAF
YFLSRAQSL	YFLSRAQSL
VYINTAQEF	VYINTAQEF
YFIPFLPLEY	YFIPFPLEY
VYTEKVLEA	VYTEKVLEA
SYPLNSYEL	SYPLNSYEL
NYQEVSRTL	NYQEVSRTL
YFPVQVVTH	YFPVQVVTH
SFLEDARAY	SFLEDARAY
YYFDNVSSTEL	YYFDNVSST
SYFSSTKTL	SYFSSTKTL
SYSVGVAY	SYSVG-VAY
KLPDYNNRL	KLPDYNNRL
SYMESVVTF	SYMESVVTF
KFSPNTSQF	KFSPNTSQF
YFHDGVRVAA	YFHDGVRVA
YYYDKNIIHK	YYYDKNIIH
LFNVGNKL	LFNVG-NKL
VFYPSSLAF	VFYPSSLAF
YFYPFPVPPLL	FYPFPVPPL
FYEERLTWH	FYEERLTWH
NGMIGLVTSL	GMIGLVTSL
KFIEKAQNM	KFIEKAQNM
LLPPYLRVI	LLPPYLRVI
AYPDFAPQKF	AYPDFPQKF
AYTPFHAVL	AYTPFHAVL
IFLSASEL	IFLSA-SEL
AVNIMHSSL	AVNIMHSSL
LYMVSKEL	LYMVS-KEL
QFPLYNNDI	QFPLYNNDI
VFNPMSQDL	VFNPMSQDL
KFPDGFEKF	KFPDGFEKF
VYIEFTEYY	VYIEFTEYY
IFYDRAEYL	IFYDRAEYL
FYYDGKVM	FYYDG-KVM
IYFLGHIF	IYFLG-HIF
VYHEILIGY	VYHEILIGY
IYLNGESL	IYLNG-ESL
IFQTAKETL	IFQTAKETL
VYNNSRML	VYNNS-RML
AYFPQIVSV	AYFPQIVSV
FYHEAVVLF	FYHEAVVLF
TFMDRAGSL	TFMDRAGSL
YFPGYFPNEL	YFPGYPNEL
VFQYRLVEY	VFQYRLVEY
FFSEREASF	FFSEREASF
AFFEEERSAL	AFFEERSAL
AYNYYTKAI	AYNYYTKAI
VYLVIRAL	VYLVI-RAL
VFLDYEAGVL	VFLDYAGVL
AFVAKFMAL	AFVAKFMAL
VYIGYLPLAH	VYIGY-LPL
FYIVGLIL	FYIVG-LIL
FYQGHVEGY	FYQGHVEGY
YYQPGLLY	YYQPG-LLY
TFPNNPVEL	TFPNNPVEL
GYMDLASRL	GYMDLASRL
AFMEKVRVL	AFMEKVRVL
QFPDMILSA	QFPDMILSA
NYPFPGETF	NYPFPGETF
FFQFGGQSL	FFQFGGQSL
AYQEAVRTL	AYQEAVRTL
VFPSSAATY	VFPSSAATY
AFQNDVYEW	AFQNDVYEW
HFPATPLLDY	HFPATLLDY
GYLAANSRF	GYLAANSRF
YFYDGVSRDA	YFYDGSRDA
IYLTADNL	IYLTA-DNL
SYLIARIAL	SYLIARIAL
KFPEVIINF	KFPEVIINF
VFYPYPQYF	VFYPYPQYF
RYPDIQASY	RYPDIQASY
AFPGGAKEL	AFPGGAKEL
NFMLHLVSM	NFMLHLVSM
TFGERVVAF	TFGERVVAF
IYFDHDLQSY	IYFDHLQSY
IYPYAAISY	IYPYAAISY
IYIDRGVVF	IYIDRGVVF
TFIRNSRPL	TFIRNSRPL
HYLYVRAH	HYLYV-RAH
SYADGYSPPL	SYADGSPPL
SFFGAASQY	SFFGAASQY
NYIRDRLAL	NYIRDRLAL
KYQPRIAVF	KYQPRIAVF
VANTMRTSL	VANTMRTSL
YYIFRVANH	YYIFRVANH
LYLSSKTEL	LYLSSKTEL
MYSIMVHAL	MYSIMVHAL
VFFTHVQEL	VFFTHVQEL
KFLNAESYY	KFLNAESYY
AFNVMGEQF	AFNVMGEQF
VFMDKPEEF	VFMDKPEEF
MFQTAVGHSF	MFQTAGHSF
SYYPTSSSTSF	YYPTSSTSF
SFIERLVEM	SFIERLVEM
SYPLFSQEF	SYPLFSQEF
QYPEGYLEA	QYPEGYLEA
AYSDLFRSL	AYSDLFRSL
LFTFRPAL	LFTFR-PAL
NYETMGRAL	NYETMGRAL
FFRVVSEY	FFRVV-SEY
KLPGNISSL	KLPGNISSL
VYNIHLAV	VYNIH-LAV
QFPAWISQF	QFPAWISQF
RSNFGYNIPL	NFGYN-IPL
RYVDQVLQL	RYVDQVLQL
IFYLGEAL	IFYLG-EAL
VYIDQTMVL	VYIDQTMVL
TPEVDDEALEK	TPEVDDEAL
LYYVGGEVY	LYYVGGEVY
NFLAQTEAL	NFLAQTEAL
RYQEALHL	RYQEA-LHL
VYTLTSLY	VYTLT-SLY
YIPHGYMEL	YIPHGYMEL
YFPDKVALL	YFPDKVALL
FFPDFIWTV	FFPDFIWTV
IFHIVENDL	IFHIVENDL
SYQEMIANL	SYQEMIANL
AFKEVGIEF	AFKEVGIEF
AFVTFSTRAM	AFVTFTRAM
VYQPVRYYY	VYQPVRYYY
QYLTFKPQTF	QYLTFPQTF
IYVVQGIYGY	IYVVQ-GIY
VLPHQPLATY	VLPHQLATY
YYEVHKEL	YYEVH-KEL
LYHYYIMEL	LYHYYIMEL
FYLSKMISM	FYLSKMISM
VYVVGTAHF	VYVVGTAHF
IYLIGHVAA	IYLIGHVAA
NFYDRYRGDY	NFYDRRGDY
NYPAFMMEM	NYPAFMMEM
LSPMSVNAV	LSPMSVNAV
HFQPSVLDF	HFQPSVLDF
MYPGIADRM	MYPGIADRM
IYPVLPKLL	IYPVLPKLL
SFPEVFTTY	SFPEVFTTY
IYHVIMSV	IYHVI-MSV
TVGVFIVSI	TVGVFIVSI
LFMSSFQSY	LFMSSFQSY
TMPDTPRLFA	TMPDTPRLF
FYPPDPAQL	FYPPDPAQL
VFVEATHVL	VFVEATHVL
TSPEAFLAL	TSPEAFLAL
HYIDRVRAL	HYIDRVRAL
IFQIGVLGF	IFQIGVLGF
LYHFSSSEL	LYHFSSSEL
VAPVTHVSV	VAPVTHVSV
TYYGSFVTR	TYYGSFVTR
IFQTGLVAY	IFQTGLVAY
IFQELVEGVF	IFQELVEGV
KLPEYNPRTL	KLPEYPRTL
YYISPRITF	YYISPRITF
VWPSSRLEA	VWPSSRLEA
IFIDRDPTVF	IFIDRPTVF
NYMAHLVEV	NYMAHLVEV
VYFTQGLGL	VYFTQGLGL
YFMTYHTVL	YFMTYHTVL
VFPLKVFGY	VFPLKVFGY
IYFLGNSL	IYFLG-NSL
SYYSVAEL	SYYSV-AEL
TFLVISHY	TFLVI-SHY
AFFTGQIF	AFFTG-QIF
QYYNGKIHAY	YYNGKIHAY
AFSQFVRPL	AFSQFVRPL
MYQDKLASL	MYQDKLASL
KFMDKKLSL	KFMDKKLSL
NYHATTEFL	NYHATTEFL
NFPNGVTDF	NFPNGVTDF
AYFAWKATAM	YFAWKATAM
AFGAALEAF	AFGAALEAF
AFLGEANVM	AFLGEANVM
ATAEGALK	ATAEG-ALK
YFNDIAVGAV	YFNDIVGAV
HFLEHMVF	HFLEH-MVF
KFPDYKSTW	KFPDYKSTW
VFFVAHSY	VFFVA-HSY
AYFPYFITY	AYFPYFITY
FYMDTSHLFNT	FYMDT-SHL
LFVPRPVL	LFVPR-PVL
SYYKKALAL	SYYKKALAL
FYPSGGLEV	FYPSGGLEV
NFPIKARSL	NFPIKARSL
RTPDAFISSF	RTPDAISSF
KYIEGVSDF	KYIEGVSDF
FYFPAAYY	FYFPA-AYY
INKPPIAK	INKPP-IAK
FYLFHPLAY	FYLFHPLAY
YYIDADLLREI	YYIDA-DLL
AFATPTISL	AFATPTISL
IYALNENVSSF	ALNENVSSF
SAQGSESHSL	SAQGSSHSL
SYMTTVIEY	SYMTTVIEY
YYPEHTSVL	YYPEHTSVL
IWPLYLRFL	IWPLYLRFL
AFGVGSEL	AFGVG-SEL
TYLNISQV	TYLNI-SQV
YFYDRRRIYL	YFYDRRIYL
SFFPKVLEM	SFFPKVLEM
AFFEAASMM	AFFEAASMM
IYPGYHQSSY	IYPGYQSSY
SYHSYVIGF	SYHSYVIGF
FFTSKALNM	FFTSKALNM
FFESFGDL	FFESF-GDL
MYYGLSNFY	MYYGLSNFY
YFYDSTRNVY	YFYDSRNVY
KYYDKLFKEY	KYYDKFKEY
VGDANPALQK	VGDAN-PAL
FFIDQANYF	FFIDQANYF
RYSEYAEEF	RYSEYAEEF
SFEDAKEAL	SFEDAKEAL
VFIPHGLIM	VFIPHGLIM
YYYDPQTGLYY	YYYDPQTGL
SYIGSHREL	SYIGSHREL
AYMNHIMV	AYMNH-IMV
FYIIGAITL	FYIIGAITL
YYIPEITSV	YYIPEITSV
IFLVATSF	IFLVA-TSF
IYVVGGAM	IYVVG-GAM
FYSEVHPHY	FYSEVHPHY
AFLEAADNL	AFLEAADNL
YYPDHIKGL	YYPDHIKGL
NYNPAQQAF	NYNPAQQAF
YFIRDVKSL	YFIRDVKSL
YFYDPDVGNF	YFYDPVGNF
LFQSRISL	LFQSR-ISL
NYIMQSHSL	NYIMQSHSL
TFPKEIQML	TFPKEIQML
KYMAEVKKY	KYMAEVKKY
YYPFHYAPF	YYPFHYAPF
RFPLNILPM	RFPLNILPM
TYLFTYSSV	TYLFTYSSV
VFMHVSTAY	VFMHVSTAY
SFNKMSIEY	SFNKMSIEY
FHPEAHAITL	FHPEAAITL
YYTRLGNDF	YYTRLGNDF
YYITRAKL	YYITR-AKL
LYPDHFHLL	LYPDHFHLL
VFMFPVGLYY	MFPVG-LYY
FYPTFKEGM	FYPTFKEGM
IYAIRNLT	IYAIR-NLT
KYYAKKILY	KYYAKKILY
SFHQPTQPV	SFHQPTQPV
YYQFINEL	YYQFI-NEL
FFNNRIIAI	FFNNRIIAI
NYLTRIHY	NYLTR-IHY
SFQDQKIASM	SFQDQIASM
FFNYTVRTL	FFNYTVRTL
SYIFPSSISA	SYIFP-SSI
AYAIQVGSL	AYAIQVGSL
IYSPEGHVL	IYSPEGHVL
TYPPFVNFF	TYPPFVNFF
KYPHYFPLL	KYPHYFPLL
FYILTSKEL	FYILTSKEL
FYQDTFGQQW	FYQDTGQQW
YYKERLLYL	YYKERLLYL
YFYDVEALRDY	YFYDV-EAL
IYPETAAIL	IYPETAAIL
FYVGEIIGK	FYVGEIIGK
HFQPSAASL	HFQPSAASL
SYQSYQSPTM	SYQSYSPTM
FYIESISY	FYIES-ISY
FYPIYFRPLM	FYPIYFRPL
AFLKTALEM	AFLKTALEM
AYPHNLMTF	AYPHNLMTF
FFLVQTKEV	FFLVQTKEV
RFMEETANF	RFMEETANF
KYLTSNVAY	KYLTSNVAY
YLPESRRPL	YLPESRRPL
YAAIQIFL	YAAIQ-IFL
YFLSHIPITL	YFLSHPITL
TYQDIQNTI	TYQDIQNTI
FYIIVPPLTL	FYIIVPLTL
TYGFRGEAL	TYGFRGEAL
VFIWKISDF	VFIWKISDF
YFYPFPVPPL	FYPFPVPPL
ADREDDPNFFK	ADREDPNFF
SFGSGFSSF	SFGSGFSSF
LHVDPENFR	LHVDPENFR
HYYSITINY	HYYSITINY
NFIRVLVSY	NFIRVLVSY
SYLPGSTAF	SYLPGSTAF
VFPWHKNLL	VFPWHKNLL
YYLKALRSL	YYLKALRSL
GFPFYGKPM	GFPFYGKPM
SFIQGTTTM	SFIQGTTTM
AFDNMVTSM	AFDNMVTSM
AFPDSVNSL	AFPDSVNSL
AFTSHPQEL	AFTSHPQEL
YYLPKLLSY	YYLPKLLSY
IFIDEIDSI	IFIDEIDSI
SFYNGLSF	SFYNG-LSF
VYPPPHQVF	VYPPPHQVF
VYTTTVHWL	VYTTTVHWL
FYVPFAKAL	FYVPFAKAL
YFGSFSSL	YFGSF-SSL
TYSEFAREL	TYSEFAREL
YYYDPLAGTY	YYYDPAGTY
AYLEQLESL	AYLEQLESL
IYFEYSHAF	IYFEYSHAF
FFLESIAM	FFLES-IAM
TYNILTHDY	TYNILTHDY
SFLETNVPL	SFLETNVPL
VFYPGETVVH	VFYPGETVV
FYPYGLQTF	FYPYGLQTF
VYADQPHIF	VYADQPHIF
NAPLVHATL	NAPLVHATL
RFPNFTNQL	RFPNFTNQL
HFQEKVESL	HFQEKVESL
RFFDTNTSVL	RFFDTTSVL
YFITPTGHSL	YFITPGHSL
LFHPSNVEM	LFHPSNVEM
NYHFGVTY	NYHFG-VTY
SMIDPPRAAV	SMIDPRAAV
AYMPHTFFI	AYMPHTFFI
KFQIGDYL	KFQIG-DYL
TIIDTKGVTAL	IDTKGVTAL
VLDALDSIK	VLDALDSIK
NFQPFALNH	NFQPFALNH
RFIPYTEEF	RFIPYTEEF
HYYRGNYMTF	YYRGNYMTF
MFPEHAVKAY	MFPEHVKAY
SYISEVKEV	SYISEVKEV
IFIDEVDSL	IFIDEVDSL
HLPSDFTPAVH	HLPSDTPAV
TFFFQPRPL	TFFFQPRPL
GFVNHALEL	GFVNHALEL
VMINKATPY	VMINKATPY
KFMDQHPEMDF	KFMDQHPEM
FYEETKVKF	FYEETKVKF
SYVNLPTIAL	SYVNLTIAL
LFNVAHTL	LFNVA-HTL
LFPKHFVEY	LFPKHFVEY
RFIGLTNSF	RFIGLTNSF
SFLEKTAVL	SFLEKTAVL
SFAAEAIAM	SFAAEAIAM
FYPFAGHDL	FYPFAGHDL
AYYYSLQIY	AYYYSLQIY
IYMQKVIYY	IYMQKVIYY
VLPEHVSVL	VLPEHVSVL
VYIPFSAIY	VYIPFSAIY
SYISKVDVL	SYISKVDVL
AFLNNQEY	AFLNN-QEY
YYYDPTTGL	YYYDPTTGL
FFHWVNNVL	FFHWVNNVL
FYEDNVLYM	FYEDNVLYM
SYVTFPREL	SYVTFPREL
ISPTGHSL	ISPTG-HSL
LYLNRTSL	LYLNR-TSL
LYPPFMIAL	LYPPFMIAL
LYQKEVSHL	LYQKEVSHL
HFIQAGLLSAL	FIQAGLSAL
VYPERSTSY	VYPERSTSY
SYGAAGLAF	SYGAAGLAF
LFQDKASEL	LFQDKASEL
NFYDKKTAIH	NFYDKKTAI
FFPYYVYNII	FFPYYVYNI
LYIGSSKTF	LYIGSSKTF
FFMLRSLSL	FFMLRSLSL
NFYTVAVTSL	FYTVAVTSL
SFFNLTVKEM	FFNLTVKEM
VYQYWNTKA	VYQYWNTKA
RFPEHRAAEI	RFPEHAAEI
YVRDLRSIV	YVRDLRSIV
AFNIAEAF	AFNIA-EAF
PYNTSLVEM	PYNTSLVEM
YYQDQVDDF	YYQDQVDDF
FYPPAHQLSL	FYPPAQLSL
QYYIFIPSKF	YYIFIPSKF
GKEIIEYYL	GKEIIEYYL
FFQNAFIFF	FFQNAFIFF
GFPEQATAF	GFPEQATAF
AYFQSIKAIAL	YFQSIAIAL
VYPQYVIEY	VYPQYVIEY
SFMEGAIIY	SFMEGAIIY
SFMYAHLAF	SFMYAHLAF
YYFPDSGFF	YYFPDSGFF
FFMEKRAKY	FFMEKRAKY
QFLEQALQM	QFLEQALQM
KYYDEIINAL	KYYDEINAL
FFLSHQTAL	FFLSHQTAL
AFLTSGTQF	AFLTSGTQF
VYFAERVTSL	YFAERVTSL
RFLENALAV	RFLENALAV
LYYDTDPFLFY	LYYDTDPFL
VFPPLTQRTY	VFPPLQRTY
KYYSADINL	KYYSADINL
LFIEHSVEV	LFIEHSVEV
QFPGFPAAAY	QFPGFAAAY
SFLDLARNI	SFLDLARNI
AYIENAKQV	AYIENAKQV
YYLNEIQSF	YYLNEIQSF
KYMLTHQEL	KYMLTHQEL
YFHIGSNAL	YFHIGSNAL
VFQQVGVSM	VFQQVGVSM
HFNVTNTTF	HFNVTNTTF
VYNVTQHAV	VYNVTQHAV
AFISKVSTH	AFISKVSTH
SYTIQSEL	SYTIQ-SEL
LYLFHLITM	LYLFHLITM
NFMKPTQEM	NFMKPTQEM
PGMKSPRPHLL	GMKSPRPHL
AFFGSYRNAL	FFGSYRNAL
FFFAGYYL	FFFAG-YYL
HYQQAELAL	HYQQAELAL
FFPSNVEQF	FFPSNVEQF
KYPKGAGRVAF	KYPKGAGRV
WYPLLKNISM	WYPLLNISM
IYQWINEL	IYQWI-NEL
AFSVRSSL	AFSVR-SSL
LFKEREKPL	LFKEREKPL
AFPDYSTYL	AFPDYSTYL
FFKDRNWL	FFKDR-NWL
SFLPSGSEM	SFLPSGSEM
HYRYYVREM	HYRYYVREM
GFLGGAKAM	GFLGGAKAM
HYQAIVTAY	HYQAIVTAY
LYQENKREY	LYQENKREY
SFIPAVNDL	SFIPAVNDL
IYMDTLNIF	IYMDTLNIF
SYNDYVREF	SYNDYVREF
RYTVSNLSM	RYTVSNLSM
VFQFKVDY	VFQFK-VDY
KFIDKQLEL	KFIDKQLEL
VFIDEIDAI	VFIDEIDAI
SYFDKMSNEM	SYFDKSNEM
RFMDGHITF	RFMDGHITF
AYLIVKEL	AYLIV-KEL
HFLLGSIY	HFLLG-SIY
RYFDHALTL	RYFDHALTL
VYMEEVPLAL	VYMEEPLAL
IFNVAGYSH	IFNVAGYSH
HFPLFESHM	HFPLFESHM
VYQIAMVHY	VYQIAMVHY
YFHDRVASF	YFHDRVASF
VYQAVQALY	VYQAVQALY
NYPDTTIDL	NYPDTTIDL
IYMFNMTGL	IYMFNMTGL
VYIVLDKAEY	VYIVLKAEY
RFIGAVNNM	RFIGAVNNM
AYFPDARDM	AYFPDARDM
LFMIEIMEM	LFMIEIMEM
VYQNQIAEL	VYQNQIAEL
NYVPEVSAL	NYVPEVSAL
GFPFYDKPM	GFPFYDKPM
TYYDLVKAFM	TYYDLVKAF
FFFPTQGHDY	FFPTQGHDY
LYYIGGEVF	LYYIGGEVF
YFQVAKTV	YFQVA-KTV
VFVDRAGEW	VFVDRAGEW
LYLIARVM	LYLIA-RVM
SFPQLRATM	SFPQLRATM
IYGPHAVSL	IYGPHAVSL
VFRVGISF	VFRVG-ISF
IYDNRIVL	IYDNR-IVL
VYQAVRQF	VYQAV-RQF
NYPSAFHSV	NYPSAFHSV
FFQDKELRSM	FFQDKLRSM
HYFERHLEF	HYFERHLEF
AFQISKEY	AFQIS-KEY
FLPEMMVDH	FLPEMMVDH
FFPQYPDKEL	FFPQYDKEL
LFPEYKNNKL	LFPEYNNKL
RFYDPTAGVVM	RFYDPTAGV
LFLEHAHNL	LFLEHAHNL
LFFDSKQSL	LFFDSKQSL
MYFTYKVRY	MYFTYKVRY
FYLERSNL	FYLER-SNL
FYLNALEW	FYLNA-LEW
YYFLTNLSF	YYFLTNLSF
NFQTAKEAL	NFQTAKEAL
VFMPHVTEA	VFMPHVTEA
HYIIAARAL	HYIIAARAL
NFQALAAEF	NFQALAAEF
HFPGLASEL	HFPGLASEL
YFLEWRSVL	YFLEWRSVL
AYLGSAIQL	AYLGSAIQL
VYMTGKEL	VYMTG-KEL
VYSTGLAM	VYSTG-LAM
VYWDYMKAI	VYWDYMKAI
FYQLSHFL	FYQLS-HFL
RYPDSILEH	RYPDSILEH
QFLFSLVEH	QFLFSLVEH
SYMISVNM	SYMIS-VNM
AFIHISTAY	AFIHISTAY
AYINRASLL	AYINRASLL
RYQVSWSL	RYQVS-WSL
VYMGLLAVF	VYMGLLAVF
QFLRGARAM	QFLRGARAM
YYLISRSL	YYLIS-RSL
RYQFIEEAF	RYQFIEEAF
RYTVQFTTM	RYTVQFTTM
AYHAVVLSY	AYHAVVLSY
AYMSIMTQM	AYMSIMTQM
TFPLQVLGF	TFPLQVLGF
FALNTKTSY	FALNTKTSY
HYVFEAKEF	HYVFEAKEF
FYADFGPLNL	FYADFPLNL
VFQPSVKSL	VFQPSVKSL
LYQNTRSY	LYQNT-RSY
YWPTYVPMEV	YWPTYPMEV
VYALQQTAL	VYALQQTAL
FFYHPETQQY	FYHPETQQY
HFPEFSQIL	HFPEFSQIL
GGLRAELL	GGLRA-ELL
FYQRFPLSF	FYQRFPLSF
HLPSGVKSL	HLPSGVKSL
TFPAYPGSSSM	AYPGS-SSM
VFQEVGINY	VFQEVGINY
LYKERMTEL	LYKERMTEL
AYATFIVTNY	AYATFVTNY
SFYVPSGNYY	FYVPSGNYY
AYMELQQKAEF	AYMELQQKA
IYADYARSL	IYADYARSL
HAPLTNIPL	HAPLTNIPL
AYISQVPTQM	AYISQPTQM
SFQGMVTSF	SFQGMVTSF
LYGPKYTFF	LYGPKYTFF
LLPHYPNWF	LLPHYPNWF
HYIQMVKEL	HYIQMVKEL
TFASRVSSL	TFASRVSSL
SYYPAENLIEY	YYPAELIEY
GFPWKTSDF	GFPWKTSDF
FYHISLEH	FYHIS-LEH
LYITGAAL	LYITG-AAL
KYYDKNAIAI	KYYDKAIAI
NFQDTVNTL	NFQDTVNTL
VYNLVKETM	VYNLVKETM
YFQYVGTDF	YFQYVGTDF
TYITYFVRAM	TYITYVRAM
LRPLLAAAA	LRPLLAAAA
YFQYLSKTY	YFQYLSKTY
VFQPETSTL	VFQPETSTL
YFLQQRDTL	YFLQQRDTL
NYIEGTKML	NYIEGTKML
FFIPGVSVV	FFIPGVSVV
HYQNALYL	HYQNA-LYL
RFFESFGDL	RFFESFGDL
VYPGIAVFF	VYPGIAVFF
IFPLETPAF	IFPLETPAF
FFLQKRLQL	FFLQKRLQL
VFLDHNAL	VFLDH-NAL
IYPLGSKSL	IYPLGSKSL
LYSDRISEL	LYSDRISEL
AFYTLVREI	AFYTLVREI
TFINNVISH	TFINNVISH
FFYNLIHPEY	FYNLIHPEY
YYIPGQGRSTY	YYIPGRSTY
FYHDAKEIF	FYHDAKEIF
AYQYQNIF	AYQYQ-NIF
VYLFTEAY	VYLFT-EAY
RYFGPAAAL	RYFGPAAAL
RFYEGVVEL	RFYEGVVEL
YFEEIKQFY	YFEEIKQFY
LYPLVAKSL	LYPLVAKSL
PPYTVVYFPVR	YFPVR----
LFHEVVQAF	LFHEVVQAF
IFLETNMSM	IFLETNMSM
IFMERIKNM	IFMERIKNM
IFATVREL	IFATV-REL
IFQNIKQEY	IFQNIKQEY
LFEGRRIEF	LFEGRRIEF
LYILTGHQSTY	YILTGQSTY
VYPMPRVIF	VYPMPRVIF
KYAMMFAEL	KYAMMFAEL
VFTNAEVY	VFTNA-EVY
HYYNAISV	HYYNA-ISV
VFQLGKKY	VFQLG-KKY
SYQLWADNL	SYQLWADNL
QYPENILSF	QYPENILSF
KFPDSVEEL	KFPDSVEEL
KIVKWDRDM	KIVKWDRDM
VYFKGKWKTPF	YFKGKKTPF
VYHAVSVM	VYHAV-SVM
KYQSPVRVY	KYQSPVRVY
IYVNYPTF	IYVNY-PTF
YYEIRYQFY	YYEIRYQFY
RFPDTVKQM	RFPDTVKQM
AFPKSITVF	AFPKSITVF
LFPANYVEL	LFPANYVEL
YFIIILNHM	YFIIILNHM
AYFTAAQL	AYFTA-AQL
FYEGHITSL	FYEGHITSL
RFYESGSSL	RFYESGSSL
TYPAGFMDV	TYPAGFMDV
VFLSTGSEL	VFLSTGSEL
RLPPYSSQL	RLPPYSSQL
TYPSLPKSL	TYPSLPKSL
IYMERAEDLPL	IYMERAEDL
TFNEDVQAL	TFNEDVQAL
GFQTGTSSL	GFQTGTSSL
YFIVTRQDY	YFIVTRQDY
KFLVAVESM	KFLVAVESM
SYHVSAQNL	SYHVSAQNL
FKDLGEEHFK	FKDLGEEHF
AYYAGHVL	AYYAG-HVL
FFKLPGGEL	FFKLPGGEL
RFPNFTNQLL	RFPNFTNQL
HFPSNLVTEM	HFPSNVTEM
SFYPEEVSSM	FYPEEVSSM
AFIEYEHERDM	AFIEYEHER
FFHIQAQKL	FFHIQAQKL
YMIDPSGVSY	YMIDPGVSY
RFLDKALEL	RFLDKALEL
DRVYIHPFHL	VYIHP-FHL
YFKPMMKEF	YFKPMMKEF
LLVVYPWTQR	VYPWT----
YFLTTRQTL	YFLTTRQTL
YFYHGVHKI	YFYHGVHKI
AYQDRLAYL	AYQDRLAYL
VYPNFRPTPK	VYPNFPTPK
KYYFYDNYF	KYYFYDNYF
IWPEIQQEL	IWPEIQQEL
IYILTNVAY	IYILTNVAY
SFQENIAQL	SFQENIAQL
VYITPMEAL	VYITPMEAL
YFDEHYEY	YFDEH-YEY
SFMKNTKSV	SFMKNTKSV
HYMSINDSF	HYMSINDSF
VFLPRVTEL	VFLPRVTEL
SFPDDATSPL	SFPDDTSPL
FYVLSTLAF	FYVLSTLAF
LYIQRTKSM	LYIQRTKSM
SYPNPVAHL	SYPNPVAHL
IWVDYINFL	IWVDYINFL
FYNLIHPEY	FYNLIHPEY
KYIHSANVL	KYIHSANVL
YNMPYPPVY	YNMPYPPVY
SYNAIRTGL	SYNAIRTGL
FFPGFPLAL	FFPGFPLAL
AYQLMTDVF	AYQLMTDVF
FYIPQRPYM	FYIPQRPYM
FFHLVNSEM	FFHLVNSEM
AFYTTDRVM	AFYTTDRVM
LFYFRVPF	LFYFR-VPF
QFLAAIESL	QFLAAIESL
KYLALRIAL	KYLALRIAL
SYMPTVSHL	SYMPTVSHL
YFHDATRVY	YFHDATRVY
LFHTIGVEF	LFHTIGVEF
AFYVPFAKAL	FYVPFAKAL
YYQPLVHLL	YYQPLVHLL
HFIEKAHTL	HFIEKAHTL
YYNANRAF	YYNAN-RAF
YYQHIVTTL	YYQHIVTTL
TYLDPALEL	TYLDPALEL
YYINSPEL	YYINS-PEL
HFVPGTTAV	HFVPGTTAV
VYTDWIMAL	VYTDWIMAL
LFPESERPEM	LFPESRPEM
SYLAESLEL	SYLAESLEL
NYQVTNSMF	NYQVTNSMF
RFPDLTVEL	RFPDLTVEL
FFLPGGARSEM	FLPGGRSEM
YYIDDVFHA	YYIDDVFHA
FYFEGTFY	FYFEG-TFY
HFYGKAIEL	HFYGKAIEL
GYAPYVNRI	GYAPYVNRI
FYIYGVSDL	FYIYGVSDL
KYFSSMAEF	KYFSSMAEF
YYNTAVKL	YYNTA-VKL
IYIDRHVM	IYIDR-HVM
IYPLVGTM	IYPLV-GTM
SFVDQVREI	SFVDQVREI
RYMLTAGLTAF	RYMLT-AGL
AFLEARQSL	AFLEARQSL
SFVDSVGVM	SFVDSVGVM
IFQVAQEL	IFQVA-QEL
HFIFFVQEF	HFIFFVQEF
FFQVGSDL	FFQVG-SDL
VYQHGLTGF	VYQHGLTGF
YYLWMLHSV	YYLWMLHSV
HYITIVKSH	HYITIVKSH
VYYPELFVW	VYYPELFVW
RMMEIAKAM	RMMEIAKAM
SFISEAESL	SFISEAESL
SFIENSSAL	SFIENSSAL
AFTEKVSTF	AFTEKVSTF
VFKERISDM	VFKERISDM
AFAHHGRSL	AFAHHGRSL
RFLVGTQSL	RFLVGTQSL
YFHEALRAF	YFHEALRAF
AFLTQSSQL	AFLTQSSQL
FYISPVNKL	FYISPVNKL
YYYPKQQGL	YYYPKQQGL
YYPIMVTQL	YYPIMVTQL
RYPTSIASL	RYPTSIASL
IYHNGVLEF	IYHNGVLEF
IYNEVNQTY	IYNEVNQTY
SFPVNYKSL	SFPVNYKSL
SYLTSASSL	SYLTSASSL
VFVTVKEL	VFVTV-KEL
SYMDPMNEY	SYMDPMNEY
KYIQEAEML	KYIQEAEML
SYYGRDRSPL	SYYGRRSPL
AWIDGVLDM	AWIDGVLDM
IFPPSVGEF	IFPPSVGEF
HLPEGALNSL	HLPEGLNSL
FYVDSDMVNEF	FYVDSVNEF
VYYEVAGHL	VYYEVAGHL
VYQLRFQF	VYQLR-FQF
HGLIRKYGL	HGLIRKYGL
LYLTGGVW	LYLTG-GVW
VFLSTRQVL	VFLSTRQVL
YFSSRPAL	YFSSR-PAL
NFYNFASSF	NFYNFASSF
RYNVMHVAA	RYNVMHVAA
LYLLRLAL	LYLLR-LAL
VFNEATSSF	VFNEATSSF
VFYNPVQEF	VFYNPVQEF
SFMQHDVQEL	SFMQHVQEL
SWIDDTSAF	SWIDDTSAF
LYPSIIQEF	LYPSIIQEF
FMLPKALAL	FMLPKALAL
NFPVGQRVL	NFPVGQRVL
AYVDYKTVL	AYVDYKTVL
KYMPSVKVSVF	YMPSVVSVF
YYASFLEV	YYASF-LEV
QYPWGVAEV	QYPWGVAEV
AYYLGKILEM	YYLGKILEM
NFPEHIFPAL	NFPEHFPAL
RYQEDVQQL	RYQEDVQQL
YFADRLYDSM	YFADRYDSM
VYAFSARPL	VYAFSARPL
FYPVVKEGRTL	FYPVVGRTL
LYQIQQVTM	LYQIQQVTM
SFLFTVITF	SFLFTVITF
YFSPYPQEL	YFSPYPQEL
YYPAKIEAI	YYPAKIEAI
YYQETLQQL	YYQETLQQL
YFFPDDPPTF	FFPDDPPTF
FAPYERRAM	FAPYERRAM
NYYPGSLFL	NYYPGSLFL
VFQTMVQM	VFQTM-VQM
SYYAYVVEL	SYYAYVVEL
YYIGDIHPSDL	YYIGDPSDL
FFYQRLVEF	FFYQRLVEF
YYITTRAQF	YYITTRAQF
RYMNHMQSL	RYMNHMQSL
AYFTETEKF	AYFTETEKF
TYIGSVEPL	TYIGSVEPL
FYLFHVQEV	FYLFHVQEV
YFFDRSSQAF	YFFDRSQAF
FYQFVNNL	FYQFV-NNL
LYATVHQSY	LYATVHQSY
NAPLVNVTL	NAPLVNVTL
VFAPTPSAM	VFAPTPSAM
FFPHVPHPSM	FFPHVHPSM
VYSPHVLNL	VYSPHVLNL
FFDEKLNSL	FFDEKLNSL
VFFEVSPVSF	VFFEVPVSF
SYMVGMIASF	SYMVGIASF
FYSFQDKL	FYSFQ-DKL
SFPEHRVLSF	SFPEHVLSF
IFLGVSTV	IFLGV-STV
TFIDDISAY	TFIDDISAY
YYSVAKAL	YYSVA-KAL
SYQDLVQRL	SYQDLVQRL
LFPEGIKGM	LFPEGIKGM
AYFELVSAL	AYFELVSAL
IFMDEIDSI	IFMDEIDSI
IYLDMLNVY	IYLDMLNVY
YYYHARVYEF	YYHARVYEF
VGHVMGSAL	VGHVMGSAL
YYFDRDDVAL	YYFDRDVAL
KYMYFTVVM	KYMYFTVVM
RWPDLHKNEL	RWPDLKNEL
FYQDKLKSL	FYQDKLKSL
SYLPHAPPF	SYLPHAPPF
MYNFQLVTL	MYNFQLVTL
AYIMKRMDM	AYIMKRMDM
AYVPVSRAV	AYVPVSRAV
TYFQDERHPY	YFQDERHPY
FYNAGLAY	FYNAG-LAY
LYPEYGAAF	LYPEYGAAF
AYNLHSAY	AYNLH-SAY
YLPEAGQYSSF	YLPEA-GQY
RYYPSGDAF	RYYPSGDAF
IYQYMEEIY	IYQYMEEIY
VAPLPRSAL	VAPLPRSAL
YFAERVTSL	YFAERVTSL
VYPTAVHVL	VYPTAVHVL
AYIDPIAMEY	AYIDPAMEY
RFPEAFSSI	RFPEAFSSI
SYMWTINNF	SYMWTINNF
QYFDSRGMFI	QYFDSRGMF
SFYDGYRHEM	SFYDGRHEM
RFQSSAVM	RFQSS-AVM
FYQPMPLKA	FYQPMPLKA
LFQEMNIEL	LFQEMNIEL
IYAPKLQEF	IYAPKLQEF
SYYGPLNLLTF	SYYGPLNLL
YYQRMLVVL	YYQRMLVVL
SYIQGGRPF	SYIQGGRPF
SVPLAATSM	SVPLAATSM
AYINKVEEL	AYINKVEEL
RYPEYDGRGVL	RYPEYGRGV
SIPILASAL	SIPILASAL
AYIHLVADY	AYIHLVADY
YYFLGRML	YYFLG-RML
VFMISSHEL	VFMISSHEL
VYPDGIRHI	VYPDGIRHI
RFPDQPFIAL	RFPDQFIAL
FYPDAVEEW	FYPDAVEEW
SFIFGVTNF	SFIFGVTNF
TFLVQLENY	TFLVQLENY
FYSVNVDY	FYSVN-VDY
FYVVNSEL	FYVVN-SEL
FFAKQATEL	FFAKQATEL
SYQILTRQL	SYQILTRQL
FYMDTSHLF	FYMDTSHLF
SFFLGKEL	SFFLG-KEL
VYFEGSDF	VYFEG-SDF
IFPAKTITY	IFPAKTITY
IFDEFRTVL	IFDEFRTVL
SYAVGLAAL	SYAVGLAAL
LYNIAFMY	LYNIA-FMY
SYFDRYRDSF	SYFDRRDSF
LFPGSNATF	LFPGSNATF
RFQDQVLDL	RFQDQVLDL
KYIDFTSDY	KYIDFTSDY
FFAVRESL	FFAVR-ESL
IITNETAGAL	ITNETAGAL
FVYITDNAY	FVYITDNAY
VYFLIGKVY	VYFLIGKVY
IFVSFQLSV	IFVSFQLSV
LYQPRASEM	LYQPRASEM
SFFDNISSEL	SFFDNSSEL
FFTEQNLSY	FFTEQNLSY
NYIEKVVAI	NYIEKVVAI
IYFDSSATY	IYFDSSATY
YYFDYKEQL	YYFDYKEQL
TYQEKITHL	TYQEKITHL
IYHIQYDEY	IYHIQYDEY
PRIASNAGSIA	RIASNAGSI
AYGPPTRAV	AYGPPTRAV
FFLSKIRSH	FFLSKIRSH
KYIGYARQY	KYIGYARQY
VFADYEAYM	VFADYEAYM
AYYKKALEL	AYYKKALEL
YYLLTKLES	YYLLTKLES
HFHTQTQSL	HFHTQTQSL
VFAPPAEAY	VFAPPAEAY
SFPELGAAL	SFPELGAAL
VFQGAVESI	VFQGAVESI
QFLDAAKAL	QFLDAAKAL
LLHQAGEI	LLHQA-GEI
RFPDFVRDF	RFPDFVRDF
YYLARLLGL	YYLARLLGL
KYISGPHEL	KYISGPHEL
AYALMAHAM	AYALMAHAM
HFVEKAAAV	HFVEKAAAV
YFLPLANTL	YFLPLANTL
SFVDKTVLPF	SFVDKVLPF
NYFQQANEL	NYFQQANEL
KYQIQQVDM	KYQIQQVDM
YFISYGIEH	YFISYGIEH
RYFISHVL	RYFIS-HVL
WFHYTLVAF	WFHYTLVAF
RYNSQLLSF	RYNSQLLSF
YYYDPTTGLY	YYYDPTTGL
VYFGIAASL	VYFGIAASL
KYYFAVDTM	KYYFAVDTM
VYLVSAML	VYLVS-AML
VYVAAVREF	VYVAAVREF
SYFSAPNSY	SYFSAPNSY
FYVPAEPKLAF	FYVPAEPKL
YWPEAKRAAL	YWPEARAAL
FYSGSPTSYF	FYSGSPTSY
FYHAYDSYL	FYHAYDSYL
AYYPSDVSSL	YYPSDVSSL
AYLGAKPRSL	AYLGAPRSL
TYIDKSTQL	TYIDKSTQL
IYQQIIQTY	IYQQIIQTY
VYLFTEAYY	VYLFTEAYY
SYLLQSTEL	SYLLQSTEL
YYNTEKVSI	YYNTEKVSI
RYFSTAVSR	RYFSTAVSR
FFLPKGAY	FFLPK-GAY
AFPIGSSGF	AFPIGSSGF
SYIEFPAVM	SYIEFPAVM
YYYNGKAVYA	YYYNGKAVY
YFPELIANF	YFPELIANF
FFPDKPITQY	FFPDKITQY
YYLQHPPISF	YYLQHPISF
YYIAGSLST	YYIAGSLST
FFPEAAQVAY	FFPEAAQVA
HFNPTGSAF	HFNPTGSAF
TFIGRANHF	TFIGRANHF
YYQTAPKAGY	YYQTAKAGY
YFPDYSIGNL	YFPDYIGNL
AFQTILTEI	AFQTILTEI
IYVALLRVTPF	VALLRVTPF
YYINKISST	YYINKISST
IYYFAAVAH	IYYFAAVAH
TWPDGWTAV	TWPDGWTAV
HYMNPYQLNAY	HYMNP-YQL
VYFASLLTV	VYFASLLTV
VFGGQRLTL	VFGGQRLTL
VFRTDLITAM	VFRTDITAM
KYIESPVLFL	KYIESVLFL
FYLDNVIGH	FYLDNVIGH
TYQFSGVYV	TYQFSGVYV
YFYNYPAV	YFYNY-PAV
FYHPETQQY	FYHPETQQY
LFNLGSAY	LFNLG-SAY
HYLVSVMAV	HYLVSVMAV
SYWNHREL	SYWNH-REL
YYPQQAIVF	YYPQQAIVF
VFIQRSEL	VFIQR-SEL
NFIPTGSAF	NFIPTGSAF
FYVETVVTY	FYVETVVTY
RYIQGILNV	RYIQGILNV
NFKTPRGPV	NFKTPRGPV
YYVWTVKEV	YYVWTVKEV
LYMVRTML	LYMVR-TML
YYLWVKSV	YYLWV-KSV
AFIYDAAVL	AFIYDAAVL
VYISNGQVL	VYISNGQVL
HFPEFPATRAY	HFPEFTRAY
IYQQQVSSL	IYQQQVSSL
SYSFDYPSDM	YSFDYPSDM
NYPVTGLAF	NYPVTGLAF
SFPTTKTYFPH	SFPTTKTYF
YFLEHLAF	YFLEH-LAF
SFIHAAMGM	SFIHAAMGM
LFLPGRMAY	LFLPGRMAY
SYYWNAQRH	SYYWNAQRH
SYFDPREAY	SYFDPREAY
SFFDATDRVSF	SFFDARVSF
HYMSPYQLNAY	HYMSP-YQL
FFMEELNTY	FFMEELNTY
FFWPGIDL	FFWPG-IDL
YYQSGTRSL	YYQSGTRSL
FFLARPTTF	FFLARPTTF
VFSLSSEF	VFSLS-SEF
LFLDTVSTF	LFLDTVSTF
IYQSASVF	IYQSA-SVF
VWPRRPTGEVY	VWPRRTGEV
IFQEQVEKL	IFQEQVEKL
RFPQHYKSL	RFPQHYKSL
FYFPHYEV	FYFPH-YEV
VSPVVRVAV	VSPVVRVAV
FYFASKLVL	FYFASKLVL
VFNAVTSF	VFNAV-TSF
RFHTITTSY	RFHTITTSY
IYSFHTLSF	IYSFHTLSF
SFFSTPSEL	SFFSTPSEL
IYLTFPVAM	IYLTFPVAM
AYPEIVAVY	AYPEIVAVY
FFQRVRAL	FFQRV-RAL
FFNNQIEEL	FFNNQIEEL
AYQQRVTAL	AYQQRVTAL
FFYDQAFAIY	FFYDQAFAI
RYWSAVTSH	RYWSAVTSH
NYIPEVRIM	NYIPEVRIM
YYFALAHTV	YYFALAHTV
HYQLGLAY	HYQLG-LAY
YYQIRSSQL	YYQIRSSQL
LFPLWPAEM	LFPLWPAEM
ILPEMVGSM	ILPEMVGSM
AFIPHSIVL	AFIPHSIVL
FYISWAEEY	FYISWAEEY
SQPLGPRII	SQPLGPRII
LYAISAVYF	LYAISAVYF
VYVDLGGSHVF	VYVDLGGSH
KFNVLLTTY	KFNVLLTTY
NFAYRLEL	NFAYR-LEL
AFQAVTEFY	AFQAVTEFY
AYQSVRIL	AYQSV-RIL
TFMDHVLRY	TFMDHVLRY
VYQNIFTAM	VYQNIFTAM
YYFAQQNSGHF	YYFAQNSGH
SYYGNRAATL	YYGNRAATL
HYNTGWVL	HYNTG-WVL
YFIPATGHSL	YFIPAGHSL
FFQDKARFY	FFQDKARFY
YFPDRENQQF	YFPDRNQQF
RYHIAKVY	RYHIA-KVY
IYLEGSAF	IYLEG-SAF
FYGRHAEL	FYGRH-AEL
YFQTTSTNL	YFQTTSTNL
FYQLQPAM	FYQLQ-PAM
QYFTARTSL	QYFTARTSL
VYPGYYLTF	VYPGYYLTF
FYPELKLAY	FYPELKLAY
FYFDRDDVAL	FYFDRDVAL
VYLTGYNF	VYLTG-YNF
KYLNMRSTY	KYLNMRSTY
YYFSVDNL	YYFSV-DNL
VFQQIALSY	VFQQIALSY
YFRDNPSEL	YFRDNPSEL
AYQLGSVY	AYQLG-SVY
FFGTHETAF	FFGTHETAF
SFLSEARSL	SFLSEARSL
FFYNEHTNDF	FYNEHTNDF
SFPHMVLSL	SFPHMVLSL
TVYVSMIAL	TVYVSMIAL
KYTEGVQSL	KYTEGVQSL
SYQVASTL	SYQVA-STL
KWISITEAL	KWISITEAL
IYLEGKIDY	IYLEGKIDY
YFIPTPPSSY	YFIPTPSSY
SYPDNFLHI	SYPDNFLHI
FYIESISYL	FYIESISYL
SIPEKNRPL	SIPEKNRPL
NAPWAVTSL	NAPWAVTSL
TFMPVASGL	TFMPVASGL
RYIPDAMNL	RYIPDAMNL
YLPDGTASL	YLPDGTASL
IFIAAASEI	IFIAAASEI
IFHITLVSL	IFHITLVSL
AYFDVKEY	AYFDV-KEY
FLPARFYQAL	FLPARYQAL
YFYDPDVGNFH	YFYDPVGNF
VAYVSSVAL	VAYVSSVAL
SFADFGSAL	SFADFGSAL
GYIGAALVL	GYIGAALVL
SYYKDALRF	SYYKDALRF
FLPDHPIVL	FLPDHPIVL
FFEVRRVV	FFEVR-RVV
FYDNKGITY	FYDNKGITY
SFHAAGLQM	SFHAAGLQM
SFKNQIATH	SFKNQIATH
NYVESIMHY	NYVESIMHY
YFFAVDTAY	YFFAVDTAY
QFTTRSEL	QFTTR-SEL
IYPGHGMMF	IYPGHGMMF
AFFPGFPLAL	FFPGFPLAL
YFGARAIL	YFGAR-AIL
VYPLYTIVF	VYPLYTIVF
YYHSYWHSM	YYHSYWHSM
HFLDRHLVF	HFLDRHLVF
FSPVGSVL	FSPVG-SVL
AYPPGVKEI	AYPPGVKEI
FYQHNVEKL	FYQHNVEKL
RFQNYMVAL	RFQNYMVAL
LFIFSVANM	LFIFSVANM
RFFTSSTSL	RFFTSSTSL
HYFFAVSTL	HYFFAVSTL
IFNTVNTSL	IFNTVNTSL
RYAEFSSAL	RYAEFSSAL
AFHPFIAGPY	AFHPFAGPY
IFVPARNNM	IFVPARNNM
TFIDPRIPL	TFIDPRIPL
LAPTDVKEL	LAPTDVKEL
RFSLNTVEL	RFSLNTVEL
RFNVAKSL	RFNVA-KSL
SWPDGMLSM	SWPDGMLSM
YYEFREEAY	YYEFREEAY
AYADFYRNY	AYADFYRNY
IYLPGRPTSM	IYLPGPTSM
RFPDGTNGL	RFPDGTNGL
AYYVSNEEL	AYYVSNEEL
VFAEKITSL	VFAEKITSL
FYGFQIAM	FYGFQ-IAM
SFPASSGVSH	SFPASGVSH
IYTLGRYL	IYTLG-RYL
HYITPMMEL	HYITPMMEL
SFIAFARVF	SFIAFARVF
VYFYTFNSL	VYFYTFNSL
AFALLFSEL	AFALLFSEL
KYQEYTNEL	KYQEYTNEL
YYYDKNIMTK	YYYDK-NIM
YYYDPLAGTYY	YYYDPAGTY
FYFDRNPYF	FYFDRNPYF
IYYQSPLSL	IYYQSPLSL
IYVNMKTDF	IYVNMKTDF
YYIEGINQL	YYIEGINQL
AFHLRVLAH	AFHLRVLAH
YYLPKDDEY	YYLPKDDEY
NFPKVATSF	NFPKVATSF
TFQSRTLAL	TFQSRTLAL
VYWVARKPM	VYWVARKPM
RYMELYTHVY	RYMELTHVY
YYGLSNFY	YYGLS-NFY
TYLEKAVEV	TYLEKAVEV
RYLGGSMDL	RYLGGSMDL
IMPEEEYSEF	IMPEEYSEF
FFPVHFQEF	FFPVHFQEF
KFLAAGTHL	KFLAAGTHL
SFYDHALHL	SFYDHALHL
FYNQVSTPL	FYNQVSTPL
RWPDYVREL	RWPDYVREL
LFYEAAQEL	LFYEAAQEL
ATQVGIEW	ATQVG-IEW
VYFPALTSL	VYFPALTSL
AFQIMQEEL	AFQIMQEEL
YYPAQGVQQF	YYPAQVQQF
YFQDERHPY	YFQDERHPY
FYPGLGLAL	FYPGLGLAL
RFYAFGRVF	RFYAFGRVF
YFHDNVRVAA	YFHDNVRVA
TSEAAVKEGK	TSEAAVKEG
VSPYTEIHL	VSPYTEIHL
YMPQNPHII	YMPQNPHII
FYPGWKVLVF	FYPGWVLVF
VFPDKGYSF	VFPDKGYSF
IFPNQTEEL	IFPNQTEEL
YYYDKNIIH	YYYDKNIIH
SFLNRYLSL	SFLNRYLSL
YYENRMYL	YYENR-MYL
SFMINNVY	SFMIN-NVY
VYIEAAIRF	VYIEAAIRF
AFFGGSNPF	AFFGGSNPF
TYYGSFVTRAL	YYGSFTRAL
AYYPSSFPK	AYYPSSFPK
LYPEGLAQL	LYPEGLAQL
AYYFHLQTF	AYYFHLQTF
TFLEAGVEM	TFLEAGVEM
YYMDYLAAL	YYMDYLAAL
VYEIGRQF	VYEIG-RQF
RFFDGAKDV	RFFDGAKDV
VFQDRTLHV	VFQDRTLHV
LYAAAAGVL	LYAAAAGVL
IFINLPRSM	IFINLPRSM
IYPYVIQEL	IYPYVIQEL
SFYLFHPLAY	FYLFHPLAY
FFHYAVDNL	FFHYAVDNL
SYYSPSIGFSY	SYYSPSIGF
VYYKDDTHYF	YYKDDTHYF
YYPSDVSSL	YYPSDVSSL
RFQEADSPTL	RFQEASPTL
AFPKAVSVF	AFPKAVSVF
KFLPDAQAL	KFLPDAQAL
LYIDDTLTM	LYIDDTLTM
SYLPEAGQY	SYLPEAGQY
YYVDTAVRHV	YYVDTVRHV
FFLIGPPL	FFLIG-PPL
KFYSVNVDY	KFYSVNVDY
FYHKGIASL	FYHKGIASL
FFNGLRTEL	FFNGLRTEL
TYMAMYLTY	TYMAMYLTY
SFMGMVISH	SFMGMVISH
VFNFTIHEI	VFNFTIHEI
FYQNHRRY	FYQNH-RRY
QFIDGRLDL	QFIDGRLDL
WYYSTKVQL	WYYSTKVQL
NVPVGKVL	NVPVG-KVL
WYQRVYQSL	WYQRVYQSL
LFAPYGTVM	LFAPYGTVM
VFRVGSVL	VFRVG-SVL
AYIGFIQSL	AYIGFIQSL
VFMPQHIMAI	VFMPQIMAI
IYNTAGFY	IYNTA-GFY
SYPDAILQA	SYPDAILQA
FFHEYLVSV	FFHEYLVSV
TWPKEVRQL	TWPKEVRQL
SYIHTSASL	SYIHTSASL
SMITGVAAL	SMITGVAAL
IYAIRQSI	IYAIR-QSI
AYLQRIAL	AYLQR-IAL
LSWNKTVEL	LSWNKTVEL
GYSFSLTTF	GYSFSLTTF
IYVISAETF	IYVISAETF
VFIDTEGSFM	VFIDTEGSF
SYLPHSSEY	SYLPHSSEY
FFTDNVPAL	FFTDNVPAL
VYITRAQLM	VYITRAQLM
SFVDVMEF	SFVDV-MEF
RFHEMHVAL	RFHEMHVAL
YFYDDVTTLY	YFYDDVTTL
VFVVDSAAF	VFVVDSAAF
YYIDDVFHAL	YYIDDFHAL
AFGGLTRAL	AFGGLTRAL
VFLLGKVM	VFLLG-KVM
RYQEVIQEL	RYQEVIQEL
LFHIGVAF	LFHIG-VAF
YYFDVSHEHL	YYFDVSHEH
LYFIAPSGH	LYFIAPSGH
FFFTARTSF	FFFTARTSF
NYHWQETAY	NYHWQETAY
AYLWTKQVL	AYLWTKQVL
VFKLAQAY	VFKLA-QAY
GFPSSVAAL	GFPSSVAAL
AFPNLARVL	AFPNLARVL
KLPANHPLL	KLPANHPLL
SMPLYAVMY	SMPLYAVMY
GFFNGLRTEL	FFNGLRTEL
VFLEAAKAL	VFLEAAKAL
LYASKIISY	LYASKIISY
IFSIREVSF	IFSIREVSF
VYIEHRLMM	VYIEHRLMM
YYQALSSSSIM	YYQALSSSI
VFPEKGYSF	VFPEKGYSF
AFIETPSSL	AFIETPSSL
LFINTSSY	LFINT-SSY
IYTSSVNRL	IYTSSVNRL
TYLGVAASL	TYLGVAASL
HFGGGKTTGF	HFGGGTTGF
IFYHPETTQL	FYHPETTQL
YYLQIHPQEL	YYLQIPQEL
SYMISVNMH	SYMISVNMH
VFSFKMVSY	VFSFKMVSY
HYINGSLF	HYING-SLF
AYGKGTYF	AYGKG-TYF
SFLNKASAV	SFLNKASAV
FFPFDTRQM	FFPFDTRQM
SYNLTVREL	SYNLTVREL
VYFENSSSNPY	VYFENSSSN
FIVEETLPL	FIVEETLPL
AYFTHSNL	AYFTH-SNL
AYMELVNNML	AYMELVNNM
FFINEAMEL	FFINEAMEL
LFPIHVQTSL	LFPIHQTSL
RYVPRASYF	RYVPRASYF
IYYWHVIAA	IYYWHVIAA
VFIGANPLAV	VFIGA-NPL
VYFVQKNSL	VYFVQKNSL
YYYGDISSL	YYYGDISSL
FYAHSLVEL	FYAHSLVEL
LFRVITEV	LFRVI-TEV
IFPEGFVEL	IFPEGFVEL
FLYPFFGVL	FLYPFFGVL
VYHVVGVDV	VYHVVGVDV
LYIHHAIDL	LYIHHAIDL
FMHVQLEVM	FMHVQLEVM
SFPNYGLSH	SFPNYGLSH
FYYDGKVMKL	FYYDGVMKL
YYHYSYSVV	YYHYSYSVV
NYMMGIEF	NYMMG-IEF
SYPHHATQL	SYPHHATQL
YYIDTLGRIM	YYIDTGRIM
LYPAVSAVY	LYPAVSAVY
AFIQEAAAF	AFIQEAAAF
AYHTQTTPL	AYHTQTTPL
VFMPPSSSSEL	FMPPSSSEL
IFPSSISAM	IFPSSISAM
FFITLPLSL	FFITLPLSL
PNYFLSIPI	PNYFLSIPI
LYQDTHQEY	LYQDTHQEY
KYFSSLTTH	KYFSSLTTH
VYFPWVSQY	VYFPWVSQY
AWPEKRGEI	AWPEKRGEI
TFLAQHASL	TFLAQHASL
TFLNHPAL	TFLNH-PAL
VYLNVMEL	VYLNV-MEL
AFQERLNSY	AFQERLNSY
GYYSHALYL	GYYSHALYL
AFYPEEISSM	FYPEEISSM
YYQLMKTAL	YYQLMKTAL
YFISPTGHSL	YFISPGHSL
KYMNSLLIGEL	KYMNSIGEL
SFVIRALGF	SFVIRALGF
YFLPEAPAEL	FLPEAPAEL
TYPDVNNSI	TYPDVNNSI
SYFEKGPLTF	SYFEKPLTF
FFYPLDFTF	FFYPLDFTF
VFSVTIHM	VFSVT-IHM
LYPTPSNPF	LYPTPSNPF
RYPEETLSL	RYPEETLSL
AYLPKNTHPF	AYLPKTHPF
TYQKLARAL	TYQKLARAL
FFWIQNVSL	FFWIQNVSL
VYFSAAHAL	VYFSAAHAL
AFALVSQAY	AFALVSQAY
VYFIVREV	VYFIV-REV
RFIPSAYPY	RFIPSAYPY
AFNTQVTAL	AFNTQVTAL
FYIPYRPKDF	FYIPYPKDF
SFAAKQREL	SFAAKQREL
FYKDVLEV	FYKDV-LEV
KFKEVGEAF	KFKEVGEAF
VYKVGIAF	VYKVG-IAF
AYGLSREV	AYGLS-REV
VFLLDLGKV	VFLLDLGKV
KFVEKMTSF	KFVEKMTSF
RFINGSAL	RFING-SAL
FYYFVKEF	FYYFV-KEF
FYVPEIVDEL	FYVPEVDEL
YYIDGKIQTN	YYIDGKIQT
FYPEDVAEEL	FYPEDAEEL
LLIENVASL	LLIENVASL
FFPALHESL	FFPALHESL
VYQARPQL	VYQAR-PQL
GYLAASQSF	GYLAASQSF
SYLVGSHM	SYLVG-SHM
TFQNDIHVY	TFQNDIHVY
VFPAIAQEI	VFPAIAQEI
YYPELAFQF	YYPELAFQF
RYQEFVRAL	RYQEFVRAL
GGYDGYRPSF	GYDGYRPSF
KAPEPLSSL	KAPEPLSSL
IYMGHVKGY	IYMGHVKGY
IWPNARISVM	IWPNARISV
SYYKNGWIV	SYYKNGWIV
LFQNGSVL	LFQNG-SVL
KYQAQDNFM	KYQAQDNFM
IYIINVHSM	IYIINVHSM
LYYTTVRAL	LYYTTVRAL
VFAEGKPLAL	VFAEGPLAL
YYLDMHSLPH	YYLDM-HSL
SYPTTTISY	SYPTTTISY
AYMKSLLSL	AYMKSLLSL
TYKEALEK	TYKEA-LEK
NFPTNLHPM	NFPTNLHPM
FFQEAVSH	FFQEA-VSH
RYQVGVHY	RYQVG-VHY
YFYPYGLQTF	FYPYGLQTF
RYMFSRPF	RYMFS-RPF
FYNTAQSPSAL	FYNTAPSAL
FIMDRAQAL	FIMDRAQAL
FYTVAVTSL	FYTVAVTSL
FYAEALRAV	FYAEALRAV
YEATLGLS	YEATL-GLS
SFFTNANSY	SFFTNANSY
VFQDMVIVF	VFQDMVIVF
YYKPGLLM	YYKPG-LLM
LFPEADKVRTM	LFPEAVRTM
SYPDFLRMM	SYPDFLRMM
YFLETSRDV	YFLETSRDV
VFIEDAIQY	VFIEDAIQY
YYYDPQEEVYL	YYYDPQEEV
YYYDGDVGNY	YYYDGVGNY
KFYATLVRY	KFYATLVRY
NYQIVVSNL	NYQIVVSNL
NYQTLKTSL	NYQTLKTSL
FYFNTKYF	FYFNT-KYF
IFFFGTHETAF	FFGTHETAF
AYIFNSNVM	AYIFNSNVM
SFFGGSNPF	SFFGGSNPF
MYTVAMAY	MYTVA-MAY
VFPMEKLSSF	VFPMELSSF
AFLAIIHAL	AFLAIIHAL
HFLQQPRPL	HFLQQPRPL
VYQEMPAQL	VYQEMPAQL
YFISILQHL	YFISILQHL
NFQAIVISL	NFQAIVISL
SVPEAQSAL	SVPEAQSAL
IFVVASSSY	IFVVASSSY
LYQDFVRDY	LYQDFVRDY
RYSVFVNEL	RYSVFVNEL
FYHPAQEY	FYHPA-QEY
YYHARVYEF	YYHARVYEF
GPPPPPGKPQ	GPPPPGKPQ
LYYEVEILSH	LYYEVILSH
FYVPGVAPINF	FYVPGVAPI
YFMDHTVAF	YFMDHTVAF
DFFNGKEL	DFFNG-KEL
QYQDNIKEL	QYQDNIKEL
YFYAAIVAV	YFYAAIVAV
RFPDPRMHY	RFPDPRMHY
YFISHILAF	YFISHILAF
SYHDGALVV	SYHDGALVV
YYFSKLIEF	YYFSKLIEF
FFPEIDLEKY	FFPEIDLEK
LWPDSVPSAL	LWPDSPSAL
FFWTARLAF	FFWTARLAF
LFNDSRVTF	LFNDSRVTF
FVRDMIREV	FVRDMIREV
AYFDLQTHVI	AYFDLQTHV
KYLTSLNY	KYLTS-LNY
VYSNPVSSL	VYSNPVSSL
YFLHRLLHH	YFLHRLLHH
FYPEELDQLL	FYPEELDQL
AFMEGIAL	AFMEG-IAL
YYFAVRAK	YYFAV-RAK
GGLPERSVSL	GLPERSVSL
FFFYGKSL	FFFYG-KSL
FYPEDEILHF	FYPEDILHF
FYNITLAF	FYNIT-LAF
VYFHTLTSEY	YFHTLTSEY
LFQNIRPL	LFQNI-RPL
AVLASGATF	AVLASGATF
FFQETNIPY	FFQETNIPY
SFHTHVKEL	SFHTHVKEL
HHPDYNNEL	HHPDYNNEL
HFFDGKTAL	HFFDGKTAL
ALPEDDFLSL	ALPEDFLSL
YYKPGLLMM	YYKPGLLMM
LFAPFIVYY	LFAPFIVYY
VYITGKEV	VYITG-KEV
AFTNRIFF	AFTNR-IFF
AFYDPTHAW	AFYDPTHAW
RYNLQSAL	RYNLQ-SAL
KFLERFTSM	KFLERFTSM
TYSPALNKM	TYSPALNKM
YYIPEITSVL	YYIPETSVL
YYRDYPTLV	YYRDYPTLV
LLPQHQVPAY	LLPQHVPAY
SFVWHALDY	SFVWHALDY
LFPELPKSAL	LFPELKSAL
LFPGSPAIY	LFPGSPAIY
VFLLGHSM	VFLLG-HSM
RWMDEAQAL	RWMDEAQAL
IFLDSKGLEY	IFLDSGLEY
YFQAKIRAL	YFQAKIRAL
MYLHRPEEY	MYLHRPEEY
NFSIHMAL	NFSIH-MAL
RYLGKVLEL	RYLGKVLEL
VFSDGAVSL	VFSDGAVSL
LYAIRTQEY	LYAIRTQEY
FYVRLIDSM	FYVRLIDSM
YFADGVLSL	YFADGVLSL
KFLANVSTV	KFLANVSTV
FFLSHPAY	FFLSH-PAY
AFEFMQRAL	AFEFMQRAL
WFIPFVQSL	WFIPFVQSL
SFPAHRAVL	SFPAHRAVL
YAPGARLAL	YAPGARLAL
AFIDQSQSL	AFIDQSQSL
IYELMQTEF	IYELMQTEF
SYLEKVSEV	SYLEKVSEV
KYQAVTATL	KYQAVTATL
AFADIIHSL	AFADIIHSL
FYIVDRDAF	FYIVDRDAF
FYPEEISSM	FYPEEISSM
LYFIAPTGH	LYFIAPTGH
MYYYNGKAVY	YYYNGKAVY
AFLEQAVSY	AFLEQAVSY
FTADPLSL	FTADP-LSL
YYHVYKLTL	YYHVYKLTL
FWPAVVKSV	FWPAVVKSV
YMNVMLENY	YMNVMLENY
AFALKALQF	AFALKALQF
IFQEPTEPK	IFQEPTEPK
LFPDQATQL	LFPDQATQL
QYLELAHSL	QYLELAHSL
VFMTPGNSF	VFMTPGNSF
SFHHNVAAL	SFHHNVAAL
YYDGDIGNYYY	YYDGDIGNY
SFNAYENHL	SFNAYENHL
YYSPHGHIL	YYSPHGHIL
NFITGVGIL	NFITGVGIL
QYYSGELVSY	YYSGELVSY
LYNIGNVY	LYNIG-NVY
MFPLVKSAL	MFPLVKSAL
MFNIHRGFY	MFNIHRGFY
SFSEFTSSL	SFSEFTSSL
TYNTQVNFM	TYNTQVNFM
SYFEGKQVSV	SYFEGQVSV
IFASGSEL	IFASG-SEL
FYGDLRKAL	FYGDLRKAL
YYNLQGISH	YYNLQGISH
AFMSQVHSV	AFMSQVHSV
IYQEIRNTDM	IYQEINTDM
HFHITNTTF	HFHITNTTF
FFPGISVKSV	FFPGIVKSV
VALLRVTPF	VALLRVTPF
YFNEGTVL	YFNEG-TVL
YFVTGNHEY	YFVTGNHEY
YFPDRNVAL	YFPDRNVAL
FFYNAIKSY	FFYNAIKSY
KFPAYERVL	KFPAYERVL
FYDDKKYTY	FYDDKKYTY
GYMSPHPSPL	GYMSPPSPL
YYEEQHPEL	YYEEQHPEL
TYFQRAQSL	TYFQRAQSL
FFNLTVKEM	FFNLTVKEM
AYPHFMSIL	AYPHFMSIL
FFNAVMQNL	FFNAVMQNL
HFQTMYEHL	HFQTMYEHL
YYFNRKTFSF	YYFNRTFSF
RFIDDVVSAV	RFIDDVSAV
SYIDRLISVF	SYIDRISVF
SFPHTTPSM	SFPHTTPSM
IFEGGATEL	IFEGGATEL
LYMNGMYAF	LYMNGMYAF
FFFDSAMESY	FFFDSMESY
FYAFGRVF	FYAFG-RVF
TYIGPSTVF	TYIGPSTVF
VYNTVSEGTHF	VYNTVGTHF
IYYFKANVF	IYYFKANVF
AFIDTAQHM	AFIDTAQHM
VYLVTEVY	VYLVT-EVY
AYFEGHHL	AYFEG-HHL
AYMDAPKAAL	AYMDAKAAL
YYMRDVTAI	YYMRDVTAI
VYFEGSIY	VYFEG-SIY
AYQAKVLQL	AYQAKVLQL
QYQPPAPAL	QYQPPAPAL
VYFVVTVY	VYFVV-TVY
NYFFDAAKL	NYFFDAAKL
YYQLGDHEL	YYQLGDHEL
YYTVRQLEL	YYTVRQLEL
YYLYNHVAM	YYLYNHVAM
AYQLMVDVF	AYQLMVDVF
TFQENLSAF	TFQENLSAF
FFKDGLEM	FFKDG-LEM
AYQGVLVEL	AYQGVLVEL
IYLEGTLL	IYLEG-TLL
IFFPGVSEF	IFFPGVSEF
NYYVRAVL	NYYVR-AVL
TYPENWRAF	TYPENWRAF
KYMNNITYY	KYMNNITYY
IYQEKVLDL	IYQEKVLDL
AYHGLTVPL	AYHGLTVPL
YYRYPTGESY	RYPTG-ESY
YYHWALSF	YYHWA-LSF
FYRPLAPEL	FYRPLAPEL
LYPEVPPEEF	LYPEVPEEF
FYWARKTSH	FYWARKTSH
YYFEGIKQTF	YYFEGKQTF
IFQPHVRHL	IFQPHVRHL
SFSPGAGAF	SFSPGAGAF
VFQVKTLSL	VFQVKTLSL
SYIIGTSSV	SYIIGTSSV
FYHHEAGVTAL	YHHEAVTAL
YYQNHIMNL	YYQNHIMNL
NFQEYVTFL	NFQEYVTFL
IYMEPEKQVM	IYMEPKQVM
VYFVHPTF	VYFVH-PTF
LYQPSAESL	LYQPSAESL
NFYSTEVSV	NFYSTEVSV
IYLNVESV	IYLNV-ESV
AAPGYAPPPF	AAPGYPPPF
VYIPSRVAL	VYIPSRVAL
AYLPVNESF	AYLPVNESF
VFPKVRITA	VFPKVRITA
AFMDQVRAF	AFMDQVRAF
FYNNRLQAY	FYNNRLQAY
IFNAVKASL	IFNAVKASL
AFFTSKAL	AFFTS-KAL
SYMPARVVVF	SYMPAVVVF
VFSIGPVF	VFSIG-PVF
RYTLQASTF	RYTLQASTF
AWIDAEVTEF	AWIDAVTEF
YFPKKISEL	YFPKKISEL
RYQEALSEL	RYQEALSEL
AWAEYVVEW	AWAEYVVEW
KYQIINEEF	KYQIINEEF
AWPGPLADM	AWPGPLADM
LYPIKNLEM	LYPIKNLEM
YFMTMIVSL	YFMTMIVSL
SYIPYNPQQF	SYIPYPQQF
IYMVHIQV	IYMVH-IQV
NFLSTLTSF	NFLSTLTSF
TYMEYETLTL	TYMEYTLTL
GYPEVALHF	GYPEVALHF
KFQAMDISL	KFQAMDISL
AFQFSYTAV	AFQFSYTAV
NFIEDVLGY	NFIEDVLGY
SYNLFSREF	SYNLFSREF
SFYIPPPATH	FYIPPPATH
RMPPFTQAF	RMPPFTQAF
YFISHVLAFF	YFISHVLAF
NFLPEALDF	NFLPEALDF
RYADRVKEL	RYADRVKEL
SWPTYPQLYV	SWPTYPQLY
FYMEDYLTV	FYMEDYLTV
IYKIGQGY	IYKIG-QGY
IFTMGIAL	IFTMG-IAL
FFPIAGLEF	FFPIAGLEF
VYLTHLDY	VYLTH-LDY
SFMDPASAL	SFMDPASAL
LFHNAVSAY	LFHNAVSAY
LYPENIVPSF	LYPENVPSF
AYPYNFSNL	AYPYNFSNL
SFFPKSPAL	SFFPKSPAL
NYHAMTEFL	NYHAMTEFL
LYHLLRQEL	LYHLLRQEL
SYPDWGSNYY	SYPDWGSNY
AFLAEASVM	AFLAEASVM
YFHDRFLEL	YFHDRFLEL
YMPAKIGAF	YMPAKIGAF
AYVPGFAHI	AYVPGFAHI
TFNNPTTEF	TFNNPTTEF
VFLERGEVM	VFLERGEVM
NYYTKAIDM	NYYTKAIDM
AFIITGQTY	AFIITGQTY
SFIKRNTPL	SFIKRNTPL
IYHQTASIL	IYHQTASIL
FYVNGLTL	FYVNG-LTL
KYPDYEVTW	KYPDYEVTW
AYYESEINSL	AYYESINSL
RYIEQATVH	RYIEQATVH
IFFNVHSA	IFFNV-HSA
YFSPFRPY	YFSPF-RPY
LSSLDFISSI	SSLDFISSI
MAPSETQFSHL	MAPSE-TQF
FFENHPYF	FFENH-PYF
FFNEDGVIRPY	FFNED-GVI
VYLPTHTSL	VYLPTHTSL
NYYNKVSTVF	NYYNKVSTV
HYFSPFRPY	HYFSPFRPY
VFLTTRQTL	VFLTTRQTL
HYSFYIETF	HYSFYIETF
YYALRAAGF	YYALRAAGF
VYYASPRSY	VYYASPRSY
SYSSIASEF	SYSSIASEF
VYQAVQAL	VYQAV-QAL
