Data	Data aligned
SYPDFLHKM	SYPDFLHKM
VYKGVVTEY	VYKGVVTEY
TYDVQKLSL	TYDVQKLSL
FRVPTANVS	FRVPTANVS
FRPQQTEIY	FRPQQTEIY
NYRHVANTL	NYRHVANTL
VRPSYWLVL	VRPSYWLVL
KYGFYTHVF	KYGFYTHVF
TYQVLAVTF	TYQVLAVTF
NRPPSSTEL	NRPPSSTEL
YRPLQSTEF	YRPLQSTEF
TYGDAGLTY	TYGDAGLTY
ARPSSTITY	ARPSSTITY
KRLDVEFVL	KRLDVEFVL
TRPPKLVL	TRPP-KLVL
FSNPYSIEY	FSNPYSIEY
YRPHTITLL	YRPHTITLL
SYPGGQLVF	SYPGGQLVF
FRTGNPTGTY	FRTGNTGTY
SYHSYVIGF	SYHSYVIGF
IRPENVIIY	IRPENVIIY
YRNVHAVVF	YRNVHAVVF
YRNEFTAWY	YRNEFTAWY
VRPPQIKSL	VRPPQIKSL
VRSPHPYQL	VRSPHPYQL
FKIADPFVL	FKIADPFVL
IRGPTYVWTF	IRGPTVWTF
FRPALPVSY	FRPALPVSY
YRVFTTQEL	YRVFTTQEL
FRPEWQSVY	FRPEWQSVY
TRGPVVRL	TRGP-VVRL
KYFDEHYEY	KYFDEHYEY
FYDQRQVLL	FYDQRQVLL
YRGPSHTY	YRGP-SHTY
FYNEYVREL	FYNEYVREL
SRNKDTYFL	SRNKDTYFL
FRQQRPLEF	FRQQRPLEF
LLPSHPLEL	LLPSHPLEL
FKSNVTKTM	FKSNVTKTM
VRPDDAIEL	VRPDDAIEL
YYFFTPYVY	YYFFTPYVY
NRLFHKTVY	NRLFHKTVY
ARAPIIRV	ARAP-IIRV
NYDETISTL	NYDETISTL
RRIEIAHSL	RRIEIAHSL
KRQEVIYEL	KRQEVIYEL
FRPPNPWTM	FRPPNPWTM
ARSDKPIFTL	ARSDKIFTL
KYFEKQFEL	KYFEKQFEL
YRAPEIML	YRAP-EIML
HYVEKPSTF	HYVEKPSTF
NRVVTHEL	NRVV-THEL
FRPDVTSSSF	FRPDVSSSF
YRLEYMRVL	YRLEYMRVL
FYEERALYL	FYEERALYL
YRNPKGFSTL	YRNPKFSTL
LYDGEFREF	LYDGEFREF
VYPPIRHHL	VYPPIRHHL
SRKTFSHEL	SRKTFSHEL
FYDPTAGVVML	FYDPTGVVM
LRPDMVLEL	LRPDMVLEL
FSPSSDSL	FSPS-SDSL
RYNDITKVY	RYNDITKVY
NSPLGEAL	NSPL-GEAL
AYPDKNFTL	AYPDKNFTL
HYLNVAFDL	HYLNVAFDL
YYSPHGHIL	YYSPHGHIL
NRLSFFFDF	NRLSFFFDF
SRFLNKQPY	SRFLNKQPY
HRNFKPVVY	HRNFKPVVY
RRGEYVLTF	RRGEYVLTF
NRPNDVYAY	NRPNDVYAY
VYVQHPITF	VYVQHPITF
RRIDFVLVY	RRIDFVLVY
VYHEILIGY	VYHEILIGY
KYFLWVVKF	KYFLWVVKF
FRVHLQYEF	FRVHLQYEF
RRQEAIYEM	RRQEAIYEM
HRPGIVVDY	HRPGIVVDY
FKNPEPELL	FKNPEPELL
NRVPAGNWVL	NRVPANWVL
DKFLASVSTVL	FLASVSTVL
SYDPLVIYL	SYDPLVIYL
YRQPPVPQY	YRQPPVPQY
YRVPGQFML	YRVPGQFML
PRKIEEIKDF	RKIEEIKDF
SYVTTSTRTY	SYVTTTRTY
ARNERIYVY	ARNERIYVY
SFEDAKEAL	SFEDAKEAL
NRPGLSYHY	NRPGLSYHY
SRKESSEVY	SRKESSEVY
LRVAPEEHPVL	VAPEEHPVL
FRNPKTSFY	FRNPKTSFY
FRAPQVMTY	FRAPQVMTY
HRFEQAFYTY	HRFEQFYTY
LYDTHITVL	LYDTHITVL
VYRTVIEYY	VYRTVIEYY
FYVEHPEV	FYVE-HPEV
SRKGPAPEL	SRKGPAPEL
VRPDTVRNL	VRPDTVRNL
NRLLLPHAF	NRLLLPHAF
YYDLQEVLL	YYDLQEVLL
FRVGNVQEL	FRVGNVQEL
YKYVGMIL	YKYV-GMIL
TRSFYKHIL	TRSFYKHIL
VRSGYYKVL	VRSGYYKVL
FRPDEPYYYGY	FRPDEPYYY
SYDDTVKL	SYDD-TVKL
YKNPSEYHY	YKNPSEYHY
SYPDFLRMM	SYPDFLRMM
LYSSSDDVIEL	SSSDDVIEL
FYVVNSEL	FYVV-NSEL
TYYGSFVTR	TYYGSFVTR
RRPPILEDY	RRPPILEDY
IYDLFQKSF	IYDLFQKSF
YYDDFLQRL	YYDDFLQRL
SAPYGRITL	SAPYGRITL
FRQPVVDTF	FRQPVVDTF
GKIDFLNNY	GKIDFLNNY
HYLPVKIIL	HYLPVKIIL
VRPPVQVY	VRPP-VQVY
FRNERAIRF	FRNERAIRF
TRNPVSEEL	TRNPVSEEL
SRYDPSISF	SRYDPSISF
VYKDLVLLL	VYKDLVLLL
VRPLVTEL	VRPL-VTEL
YRAQPSVSL	YRAQPSVSL
FKPPVLVF	FKPP-VLVF
FRGQVYSEL	FRGQVYSEL
VYDITNVNSF	VYDITVNSF
LYPPVPQVY	LYPPVPQVY
YYELAQVLL	YYELAQVLL
SAPDKSLEL	SAPDKSLEL
FKFVEQQSY	FKFVEQQSY
YRPVRQYVY	YRPVRQYVY
FRLDTPLYF	FRLDTPLYF
IRVDKITEY	IRVDKITEY
TRLYPVFFL	TRLYPVFFL
FYPPKVEL	FYPP-KVEL
SYREKPIVF	SYREKPIVF
ARPSVLWCY	ARPSVLWCY
HYDEQQNFF	HYDEQQNFF
SRKSFVFEL	SRKSFVFEL
YYYARPQTL	YYYARPQTL
NYIEFTRIL	NYIEFTRIL
NRLLEATSY	NRLLEATSY
ARSRFPQTF	ARSRFPQTF
NHPPGHVL	NHPP-GHVL
SYDSKLVWF	SYDSKLVWF
SSPAPRTAL	SSPAPRTAL
NRFPWPKVL	NRFPWPKVL
FRTITSSY	FRTI-TSSY
SRPPLLGF	SRPP-LLGF
SYPYFVIQY	SYPYFVIQY
YYGNRAATL	YYGNRAATL
HRPPASEYTM	HRPP-ASEY
ARLDHKFDLMY	ARLDHKFDL
YRGQFPEL	YRGQ-FPEL
FRGPVVPAF	FRGPVVPAF
VYDISYLL	VYDI-SYLL
IYGEKTYAF	IYGEKTYAF
TRPAAQPSF	TRPAAQPSF
TRTPVAKEL	TRTPVAKEL
FYYDGKVMKL	YYDGKVMKL
YKPPGFSL	YKPP-GFSL
YRAPEILL	YRAP-EILL
SRAPSTYTY	SRAPSTYTY
VVPEPGQPL	VVPEPGQPL
ARYSGSYNDY	RYSGSYNDY
KRPPVLRA	KRPP-VLRA
VKSDYVVKY	VKSDYVVKY
FRSEPALYF	FRSEPALYF
NKTDVILIL	NKTDVILIL
VRKKFVTEL	VRKKFVTEL
ERPPAYNL	ERPP-AYNL
GRNQEVHTL	GRNQEVHTL
TRYDLYHTF	TRYDLYHTF
KYFLRGYRY	KYFLRGYRY
TYDAHHSAF	TYDAHHSAF
EYPDLIHIY	EYPDLIHIY
VYDVTPPEL	VYDVTPPEL
YKGPGFEY	YKGP-GFEY
KRYKSIVKY	KRYKSIVKY
KYPENFFLL	KYPENFFLL
TRPPVRLV	TRPP-VRLV
GRKGIYEIY	GRKGIYEIY
RKGQVIQF	RKGQ-VIQF
VAPVASAL	VAPV-ASAL
MAPERVASL	MAPERVASL
FRLLQETMY	FRLLQETMY
FYEDNVLYM	FYEDNVLYM
AYLEAHETF	AYLEAHETF
IRKPYIWEY	IRKPYIWEY
VRTPYTMSY	VRTPYTMSY
ARNTVTQVL	ARNTVTQVL
KYAGSALQY	KYAGSALQY
TRWPGFYIL	TRWPGFYIL
AAPVSATVL	AAPVSATVL
YYFVFDHAL	YYFVFDHAL
HYDHVLIEL	HYDHVLIEL
KKNPFHLEL	KKNPFHLEL
FRPEHVSRL	FRPEHVSRL
LSPTPATAL	LSPTPATAL
SYLEYQKVM	SYLEYQKVM
HRNGGLITL	HRNGGLITL
ARNPSTVCL	ARNPSTVCL
KYPSYIHKM	KYPSYIHKM
AYKNVKFVL	AYKNVKFVL
VRPPQQVVY	VRPPQQVVY
VRPEQPFIVL	VRPEQFIVL
NRRPSVYLP	NRRPSVYLP
NRHAVVMEL	NRHAVVMEL
KRPDTTESL	KRPDTTESL
FYQPKIQQF	FYQPKIQQF
LYDPVISKL	LYDPVISKL
SRSLLESTY	SRSLLESTY
IYDLVDRHL	IYDLVDRHL
SKGPVVQY	SKGP-VVQY
MKASGTLREY	KASGTLREY
IAPPERKY	IAPP-ERKY
IAPETRRSI	IAPETRRSI
YRPGHYDIL	YRPGHYDIL
VRHIFTAF	VRHI-FTAF
YRAPELLF	YRAP-ELLF
ARPLEGTSF	ARPLEGTSF
MYPAFAEEY	MYPAFAEEY
FYHPAQEY	FYHP-AQEY
GKFMKPGKVVL	MKPG-KVVL
AAPATRAAL	AAPATRAAL
VRPPPGPEL	VRPPPGPEL
HRAEVTEEF	HRAEVTEEF
YRGPANGF	YRGP-ANGF
IYPGHGMMF	IYPGHGMMF
GRFEDVYQL	GRFEDVYQL
SRFELYQIF	SRFELYQIF
HYRPPEVILEL	YRPPEILEL
FRTPFPLAF	FRTPFPLAF
VRAWVVFKL	VRAWVVFKL
IRGNVGFVF	IRGNVGFVF
FRSILSWEL	FRSILSWEL
IYDVQHANL	IYDVQHANL
IYELMQTEF	IYELMQTEF
ARADFQKVL	ARADFQKVL
NYDEALRLL	NYDEALRLL
AYIPTPIYF	AYIPTPIYF
NRPGTVSSL	NRPGTVSSL
FFKELIQEF	FFKELIQEF
LRSGVIVRL	LRSGVIVRL
VRSPVVHSV	VRSPVVHSV
TRNPLVAVY	TRNPLVAVY
VRNDIYITL	VRNDIYITL
QRNEVVVEL	QRNEVVVEL
TRTIYQFHY	TRTIYQFHY
IRTDFNILY	IRTDFNILY
LYRNCVYTY	LYRNCVYTY
LYDVTWEEM	LYDVTWEEM
HRVAQAWEL	HRVAQAWEL
VYDGKIYTL	VYDGKIYTL
KRQEAIFEL	KRQEAIFEL
ARYVFSNF	ARYV-FSNF
YYHVYKLTL	YYHVYKLTL
KKTEVVITL	KKTEVVITL
AFKDVSFSL	AFKDVSFSL
VYPLYTIVF	VYPLYTIVF
LRNQSVFNF	LRNQSVFNF
SYKGHVDIL	SYKGHVDIL
RRFDAMPFTL	RRFDAPFTL
VKGPLLLY	VKGP-LLLY
SRNEIIQSY	SRNEIIQSY
SRNAYMLVY	SRNAYMLVY
FYSEVHPHY	FYSEVHPHY
FYRPHTITL	FYRPHTITL
YRPPPVLDAL	YRPPPLDAL
YRPISASVL	YRPISASVL
FYGTFDVHL	FYGTFDVHL
KRSNYITRL	KRSNYITRL
NRPGAYEL	NRPG-AYEL
FRHLIEFTY	FRHLIEFTY
NYDETLSTL	NYDETLSTL
VYDIAAKF	VYDI-AAKF
YYYGQGHPM	YYYGQGHPM
QYGSEGRFTF	YGSEGRFTF
HLPEGALNSL	HLPEGLNSL
RYNGLSFVY	RYNGLSFVY
NRGPAYGL	NRGP-AYGL
FYNERVVIM	FYNERVVIM
YRMNAERIL	YRMNAERIL
KYPPVNRKY	KYPPVNRKY
RYPAEIRKY	RYPAEIRKY
KKEDLVFIF	KKEDLVFIF
AGPLRKSSL	AGPLRKSSL
AKFSLPVSL	AKFSLPVSL
NRPEFITEF	NRPEFITEF
YRVVFPLEL	YRVVFPLEL
SRPPIQNA	SRPP-IQNA
ARAIYAYAL	ARAIYAYAL
HRQGFSYDY	HRQGFSYDY
SGPVPGTAI	SGPVPGTAI
LYSSYVIFY	LYSSYVIFY
SRLFQPVQY	SRLFQPVQY
SRGDFVVEY	SRGDFVVEY
FYPPEIYM	FYPP-EIYM
FRLLGNVL	FRLL-GNVL
KYPDVIQEL	KYPDVIQEL
IYDVLIRL	IYDV-LIRL
YRVHSIFVL	YRVHSIFVL
MKPLVVFVL	MKPLVVFVL
RRFTEIYEF	RRFTEIYEF
NYFMHCVAF	NYFMHCVAF
VYDGEHLGSF	VYDGELGSF
LYDHTTILF	LYDHTTILF
TRPPIRVT	TRPP-IRVT
YRNPKEWTK	YRNPKEWTK
KYQDVYVEL	KYQDVYVEL
FRPPGTSDL	FRPPGTSDL
KRPAGPLVL	KRPAGPLVL
NYRTPNFQSY	YRTPNFQSY
FRGPTVSNI	FRGPTVSNI
YRDPRERTL	YRDPRERTL
LYDEAIRHF	LYDEAIRHF
NYPPGFSY	NYPP-GFSY
VRGDGPWYYY	VRGDGPWYY
HRHPDAFYL	HRHPDAFYL
KAPVTKVAA	KAPVTKVAA
TRNDYVMMY	TRNDYVMMY
SRADQFEYVM	SRAD-QFEY
FYDSELFRM	FYDSELFRM
AYPTYPVGF	AYPTYPVGF
FYAGGFAIVY	YAGGFAIVY
HRRPPIGY	HRRP-PIGY
YYEEQHPEL	YYEEQHPEL
VKSDVEINY	VKSDVEINY
SREGRPIWQL	SREGRIWQL
MAPLKMLAL	MAPLKMLAL
LRPAVGYEL	LRPAVGYEL
SRPPAQTSL	SRPPAQTSL
FYDDTYNTL	FYDDTYNTL
ARPLVETIF	ARPLVETIF
NRTDTEYVL	NRTDTEYVL
SYNDYVREF	SYNDYVREF
IRHPNIITL	IRHPNIITL
GKVGAHAGEY	KVGAHAGEY
WYDPNASLL	WYDPNASLL
RRNPGVVIY	RRNPGVVIY
IYPEVVHMF	IYPEVVHMF
ARFGSVNEL	ARFGSVNEL
ARSLKVFEL	ARSLKVFEL
ARPDEKAIMTY	ARPDEKAIM
FYDLQEADL	FYDLQEADL
SSPQPGSAL	SSPQPGSAL
LYDVPANSM	LYDVPANSM
VYDLSIRGF	VYDLSIRGF
YRPETGSWVF	YRPETSWVF
YRGAHGIIVVY	YRGAHGIIV
NRIPVISL	NRIP-VISL
NRVLVVHDGF	NRVLVHDGF
LRADLAEEY	LRADLAEEY
LYDPCTVMF	LYDPCTVMF
MRSLLRTPF	MRSLLRTPF
NRVVFQEF	NRVV-FQEF
FRSDNSFSF	FRSDNSFSF
YYEERTCIL	YYEERTCIL
YYFSKLIEF	YYFSKLIEF
AYDVLIKM	AYDV-LIKM
SRPNIFIL	SRPN-IFIL
FYHPETTQL	FYHPETTQL
FRNIPGITL	FRNIPGITL
QRPFFPILY	QRPFFPILY
KRFSFRSF	KRFS-FRSF
VHVDVHSHY	VHVDVHSHY
VRPPKQLL	VRPP-KQLL
FYGRHAEL	FYGR-HAEL
IYDEVVKL	IYDE-VVKL
NTVDILLHHI	NTVDILLHH
MRYVASYLL	MRYVASYLL
AYFPYFITY	AYFPYFITY
VGPPGRSSL	VGPPGRSSL
VYPQYVIEY	VYPQYVIEY
ARGAFSEEY	ARGAFSEEY
YRAQPSASL	YRAQPSASL
VRANLPQSF	VRANLPQSF
LYHEHIIKY	LYHEHIIKY
KRFADFTVY	KRFADFTVY
HRFYMFHSF	HRFYMFHSF
YRHGKAYRF	YRHGKAYRF
YRPAYLVTL	YRPAYLVTL
YRPLTVLTF	YRPLTVLTF
RRQNVAYEY	RRQNVAYEY
FKNPIIEKY	FKNPIIEKY
RRNPEPLRF	RRNPEPLRF
NRGQFFTVY	NRGQFFTVY
AYPEYLITF	AYPEYLITF
YKLDNQFEL	YKLDNQFEL
NRHGLIRKY	NRHGLIRKY
AYKDFLWFF	AYKDFLWFF
YYDTHTNTY	YYDTHTNTY
SRVHAALVY	SRVHAALVY
AYKEPPLAL	AYKEPPLAL
AYMDAPKAAL	AYMDAKAAL
VRNNVIIVM	VRNNVIIVM
LYWSHPRKFG	LYWSHPRKF
VREIAQDF	VREI-AQDF
KRYVFDTH	KRYV-FDTH
YRADTQTYQPY	YRAD-TQTY
LRPPIMIMM	LRPPIMIMM
ARPEALYY	ARPE-ALYY
YRTDMIQAL	YRTDMIQAL
YRAPELLL	YRAP-ELLL
VKGPTQEF	VKGP-TQEF
SIPGGYNAL	SIPGGYNAL
AYPEVRIVL	AYPEVRIVL
FRPPLLEML	FRPPLLEML
KYMDVQFDF	KYMDVQFDF
NRRDSEYIF	NRRDSEYIF
SYPERPIIFL	SYPERPIIF
QRKAVVLEY	QRKAVVLEY
YRTTTVIFY	YRTTTVIFY
AHPPLLVL	AHPP-LLVL
VYDPLFSQL	VYDPLFSQL
KRVEDAYIL	KRVEDAYIL
SYIGLGHIY	SYIGLGHIY
RRKDGVFLY	RRKDGVFLY
SRNSNTVVF	SRNSNTVVF
AYKDAIYVF	AYKDAIYVF
NYRDTFFNL	NYRDTFFNL
FRQDHPSSM	FRQDHPSSM
TYKDPITEF	TYKDPITEF
HYRPPEVIL	HYRPPEVIL
VRENVPRVL	VRENVPRVL
HRYPAVHVY	HRYPAVHVY
YYDVPIATL	YYDVPIATL
NYPAFMMEM	NYPAFMMEM
KYFLQQWEL	KYFLQQWEL
FRTDGHPVM	FRTDGHPVM
VYDPSLKTLL	VYDPSLKTL
SRFIFNYVY	SRFIFNYVY
HRPEATPSM	HRPEATPSM
ARGLLEEQY	ARGLLEEQY
NRTETVTSF	NRTETVTSF
VRNAVTQEF	VRNAVTQEF
SYPDIHFDM	SYPDIHFDM
ARIPLNPVL	ARIPLNPVL
TRPDMIRIL	TRPDMIRIL
NYSQQLQVY	NYSQQLQVY
SRPALPFIL	SRPALPFIL
FYDWDNTEL	FYDWDNTEL
HRLPPVTSF	HRLPPVTSF
RYSEAVFYY	RYSEAVFYY
SRPSTYYEL	SRPSTYYEL
YYTDFLITL	YYTDFLITL
YRREIFIAF	YRREIFIAF
NRSNFPVVL	NRSNFPVVL
YLPDGTASL	YLPDGTASL
QYNPLPIEY	QYNPLPIEY
NKGPSYGL	NKGP-SYGL
LYDLLRNTNF	LYDLLNTNF
FKSPVKTIR	FKSPVKTIR
YKLEVLYVL	YKLEVLYVL
VYGPLPQSF	VYGPLPQSF
FRLAQEGIYTL	LAQEGIYTL
VRVPVTSNL	VRVPVTSNL
IKADHVSTY	IKADHVSTY
FRSFVVSKF	FRSFVVSKF
VYPQPPFSY	VYPQPPFSY
LRNKVIIEY	LRNKVIIEY
VRSGIVEYL	VRSGIVEYL
FRFDPQFAL	FRFDPQFAL
TYKDYVDLF	TYKDYVDLF
FYPPDPAQL	FYPPDPAQL
KRIDIIHNL	KRIDIIHNL
SRVLQNVAF	SRVLQNVAF
YRPLYPFSL	YRPLYPFSL
FRPPLLEM	FRPP-LLEM
YFAERVTSL	YFAERVTSL
TYDYAKTIL	TYDYAKTIL
QYDEAVAQF	QYDEAVAQF
ARPERPMAF	ARPERPMAF
KRPVFIFEW	KRPVFIFEW
SRGDVKVIM	SRGDVKVIM
AYDSTMETM	AYDSTMETM
LYGTITEF	LYGT-ITEF
MRAENFFIL	MRAENFFIL
NYDEALRL	NYDE-ALRL
TYDLPGNFL	TYDLPGNFL
VRSALAFEL	VRSALAFEL
YKAPITNEF	YKAPITNEF
FRNPDTIFIL	FRNPDIFIL
YRNAYTMVL	YRNAYTMVL
SRSHYSPIY	SRSHYSPIY
VRPLATLSY	VRPLATLSY
FRYGGAPQAL	RYGGAPQAL
IKPPIIHY	IKPP-IIHY
NRLGYTHLY	NRLGYTHLY
QRPETAATL	QRPETAATL
IRPEYAWIV	IRPEYAWIV
VYGTRLVVL	VYGTRLVVL
YRVYQPVRY	YRVYQPVRY
NRKEFVNLY	NRKEFVNLY
YRMDGHIQL	YRMDGHIQL
NYRTSNYIY	NYRTSNYIY
YRNDQRNRPY	YRNDQNRPY
VAPVAQVAL	VAPVAQVAL
HRGPDAFRF	HRGPDAFRF
YYNKVSTVF	YYNKVSTVF
FKAPITSEF	FKAPITSEF
VVPEPGTSL	VVPEPGTSL
KYFDSGDYNM	KYFD-SGDY
YYINSPEL	YYIN-SPEL
WRPPPLNPY	WRPPPLNPY
KAPAPRPSL	KAPAPRPSL
YKIPYTTVL	YKIPYTTVL
FRSLSTTNVF	FRSLSTNVF
RRGDFIHVM	RRGDFIHVM
IKPETILYY	IKPETILYY
SRAFQPSVSL	SRAFQSVSL
VSPYTEIHL	VSPYTEIHL
NRPTNSIVF	NRPTNSIVF
AYATYPREL	AYATYPREL
GRSEYVEKF	GRSEYVEKF
TRTEIIIL	TRTE-IIIL
FRSSIDYQY	FRSSIDYQY
NRPDIIDPAIL	NRPDIPAIL
LYRPGSVAY	LYRPGSVAY
YRPPELLL	YRPP-ELLL
VKTDTVLIL	VKTDTVLIL
VHADVYRVL	VHADVYRVL
VRFDSDVGEY	VRFDSVGEY
VAPRSGLAA	VAPRSGLAA
FFMPGFAPL	FFMPGFAPL
FKGTAVVNGEF	FKGTAVVNG
IRHYEGLSY	IRHYEGLSY
KRVTWIVEF	KRVTWIVEF
RYDLGGLVM	RYDLGGLVM
FYMPQQVAY	FYMPQQVAY
VYDTVFKHF	VYDTVFKHF
NRFNYPFEL	NRFNYPFEL
SYDPLRIYL	SYDPLRIYL
SKSPFIVHL	SKSPFIVHL
YRPENYLLY	YRPENYLLY
IRSSYIRVL	IRSSYIRVL
VRPLRLFVY	VRPLRLFVY
HYYSITINY	HYYSITINY
FRNSLGLIY	FRNSLGLIY
RRSDPGHYSF	RRSDPHYSF
VRPPKRDL	VRPP-KRDL
LRPSTSRSL	LRPSTSRSL
ISPSRTEAL	ISPSRTEAL
FYQRFPLSF	FYQRFPLSF
NRPVEVYQY	NRPVEVYQY
IYACVCRIF	IYACVCRIF
RYHGLSSL	RYHG-LSSL
VHAFPELFL	VHAFPELFL
NKKGEIFEL	NKKGEIFEL
SYPNVFLVF	SYPNVFLVF
HRKPMFNIH	HRKPMFNIH
TYRLFAVVY	TYRLFAVVY
HAAEYGAEALE	HAAEYAEAL
SYLESFYHM	SYLESFYHM
RYREAIIKY	RYREAIIKY
WRSDTPLIY	WRSDTPLIY
SYPTTTISY	SYPTTTISY
SRYDGQIAVF	RYDGQIAVF
FRHNPYTAF	FRHNPYTAF
YYHARVYEF	YYHARVYEF
IRNDYYLNL	IRNDYYLNL
SRVGYPAQVY	SRVGYAQVY
AKADGIVSKNF	AKADGIVSK
FRQLPARTL	FRQLPARTL
AEQRGENALKD	QRGENALKD
VRPDNTYEV	VRPDNTYEV
SRPEANEAL	SRPEANEAL
ENAGEDPGLAR	NAGE-DPGL
VYKAFVDNY	VYKAFVDNY
VYDLLKTNL	VYDLLKTNL
FYDIVAEL	FYDI-VAEL
AYHELAQVY	AYHELAQVY
NRPPFGQGY	NRPPFGQGY
IRKGSITEY	IRKGSITEY
VHAPYYKL	VHAP-YYKL
KRFGKAYNL	KRFGKAYNL
NRYAGEVY	NRYA-GEVY
YYDPMISKL	YYDPMISKL
KKSDPVVSY	KKSDPVVSY
YRGQPGNAY	YRGQPGNAY
YKIAFPYLY	YKIAFPYLY
SRFTYPYLL	SRFTYPYLL
APSTAVSV	APST-AVSV
TYDDGATKL	TYDDGATKL
TIIDTKGVTAL	IIDTKVTAL
RYHPQALIY	RYHPQALIY
TRMRHVISY	TRMRHVISY
SRSPVYSHF	SRSPVYSHF
YRYDGQHFSL	RYDGQHFSL
HRTDLNPIL	HRTDLNPIL
YYDVAKQL	YYDV-AKQL
RYLTVAAVF	RYLTVAAVF
SFYFFFSSF	SFYFFFSSF
TYDNVHQQF	TYDNVHQQF
GRNPFVHEL	GRNPFVHEL
HRYPNQVYY	HRYPNQVYY
QRVDYIMQL	QRVDYIMQL
HRNEVTVEL	HRNEVTVEL
YRDEHIYPY	YRDEHIYPY
KYEDGIALL	KYEDGIALL
YKSPVILL	YKSP-VILL
KRSTYNYSL	KRSTYNYSL
QRKGAGSVF	QRKGAGSVF
HRPPGPFPIM	HRPPGFPIM
VYPGIAVFF	VYPGIAVFF
FRQEYLDTL	FRQEYLDTL
VHPPHYFF	VHPP-HYFF
VYPPIRHH	VYPP-IRHH
WRRGQEVLL	WRRGQEVLL
SRPELLEY	SRPE-LLEY
AAPEGAGAL	AAPEGAGAL
NYHAQHYHL	NYHAQHYHL
GSLRVLVLR	GSLRVLVLR
SRFIKFQEM	SRFIKFQEM
KRINWRTVL	KRINWRTVL
IYATRLIQM	IYATRLIQM
FRNLHTIVL	FRNLHTIVL
FKQPFLEL	FKQP-FLEL
SVPEAQSAL	SVPEAQSAL
IYDEAISSF	IYDEAISSF
VRPVTLNM	VRPV-TLNM
YYINHPLY	YYIN-HPLY
LRPPLLQL	LRPP-LLQL
FKSPLLQL	FKSP-LLQL
HRNPLPEYL	HRNPLPEYL
YYYDGDIGNY	YYDGDIGNY
TSPEAFLAL	TSPEAFLAL
AKSDVTNQL	AKSDVTNQL
FRPPTRAEL	FRPPTRAEL
GKVKVGVNGF	VKVG-VNGF
NYYVRAVL	NYYV-RAVL
YYNTITNF	YYNT-ITNF
VRNEHFWTL	VRNEHFWTL
YYTEFPTVL	YYTEFPTVL
NRIHYNIFY	NRIHYNIFY
YYDEKVVKL	YYDEKVVKL
KYFGGVLEY	KYFGGVLEY
YRNIEPVYL	YRNIEPVYL
FRKSMVEHY	FRKSMVEHY
NYDPNQRPF	NYDPNQRPF
FSPTGEIL	FSPT-GEIL
VYPEYVIQY	VYPEYVIQY
KRNDYVHAL	KRNDYVHAL
VYPERSTSY	VYPERSTSY
SRKESYSVYVY	SRKESYSVY
GYFLRAWNY	GYFLRAWNY
SYPGSSYIF	SYPGSSYIF
KYREMYEEF	KYREMYEEF
VRVPYFIDL	VRVPYFIDL
MRYVASYL	MRYV-ASYL
AYLESFYKF	AYLESFYKF
RRFEYKYSF	RRFEYKYSF
TYPPAIVVY	TYPPAIVVY
IYDTHSLM	IYDT-HSLM
KAPSAARSL	KAPSAARSL
TRPPEPRHI	TRPPEPRHI
YKNPWVQIM	YKNPWVQIM
FKSPAASSF	FKSPAASSF
FYLGQVAILL	FYLGQVAIL
HYFLHISL	HYFL-HISL
IAPGVTHEL	IAPGVTHEL
FYRVTTEQY	FYRVTTEQY
GAEAKPAE	GAEA-KPAE
RYIDRIHIFF	RYIDRIHIF
FYETLPAEM	FYETLPAEM
NVPVRDIPA	NVPVRDIPA
FYDPDTVEL	FYDPDTVEL
NRPDLLDPALL	NRPDLDPAL
FYDLYGGEKF	FYDLYGEKF
NRAEYYHLL	NRAEYYHLL
VRTIVINY	VRTI-VINY
FRPEWTQRY	FRPEWTQRY
IYPDSFTVL	IYPDSFTVL
RRNDKIIVF	RRNDKIIVF
IRMTYIKEL	IRMTYIKEL
SKAPVLTY	SKAP-VLTY
VYRTPTEAL	VYRTPTEAL
RRPKTLRL	RRPK-TLRL
RKNPNYDL	RKNP-NYDL
SYDPVLNPVL	SYDPVNPVL
VYNIYIRRY	VYNIYIRRY
VAPGKRPAL	VAPGKRPAL
VRANVPEEL	VRANVPEEL
FKPETYWVL	FKPETYWVL
SRPLHISTF	SRPLHISTF
FRVNLRTL	FRVN-LRTL
ARLDLPYEL	ARLDLPYEL
ARADFIEEF	ARADFIEEF
NRPDILDPALL	NRPDIDPAL
IYPSVDKREY	IYPSVKREY
YRYPGGESY	YRYPGGESY
LYHYYIMEL	LYHYYIMEL
FRKVDVDEY	FRKVDVDEY
NRNLVSPAY	NRNLVSPAY
FRFIYPVL	FRFI-YPVL
QRPPTRETF	QRPPTRETF
KRKGYSYEL	KRKGYSYEL
LRLPLQDVY	LRLPLQDVY
YKEQLAKL	YKEQ-LAKL
SKPPVISL	SKPP-VISL
YHIGIPLTY	YHIGIPLTY
HRKDYINAY	HRKDYINAY
IYDSVKVYF	IYDSVKVYF
NRPITVSY	NRPI-TVSY
FRTPHVLVL	FRTPHVLVL
LRVDPVNFKLL	LRVD-PVNF
GGYRDFFPEY	GYRDFFPEY
FRYTAGTPY	FRYTAGTPY
YRQEREGFL	YRQEREGFL
SRFNRYYSL	SRFNRYYSL
FRSDSSFNF	FRSDSSFNF
KYLDEDTIYHL	KYLDEDTIY
GAPVAAAAL	GAPVAAAAL
YKVPHPLEH	YKVPHPLEH
YYVVAHFHY	YYVVAHFHY
YKGQYILTL	YKGQYILTL
YYDVEPFLF	YYDVEPFLF
IRPQVVTTF	IRPQVVTTF
SRQVGERTL	SRQVGERTL
VRRDDPGEF	VRRDDPGEF
AYHGLTVPL	AYHGLTVPL
IRPDNMSEY	IRPDNMSEY
LYPGIPVIF	LYPGIPVIF
ARPLVQTIF	ARPLVQTIF
VYQEMPAQL	VYQEMPAQL
KNGSPYGL	KNGS-PYGL
FYADHPFIF	FYADHPFIF
AYDPYLIAM	AYDPYLIAM
TYDDRAYSSF	TYDDRYSSF
AYPEYLITY	AYPEYLITY
YYPEYKLLF	YYPEYKLLF
YYRAIQFYL	YYRAIQFYL
VRTDITYPAGF	VRTDITYPA
FYSNREQY	FYSN-REQY
MRTIATALEY	MRTIAALEY
ARVIFITEY	ARVIFITEY
MRDGHYTTF	MRDGHYTTF
SYRDSYDSY	SYRDSYDSY
YYDPKHVIF	YYDPKHVIF
VYDVTLNF	VYDV-TLNF
FRAPELLF	FRAP-ELLF
TRVKAVRIL	TRVKAVRIL
YKFDFPVSY	YKFDFPVSY
NAPLVNVTL	NAPLVNVTL
YRVTLNPPGTF	YRVTLPGTF
ARPVLLQVY	ARPVLLQVY
SRPDGSASF	SRPDGSASF
AKNNVVINY	AKNNVVINY
LYPSIIQEF	LYPSIIQEF
MRPNNLVHF	MRPNNLVHF
GYRDFFPEY	GYRDFFPEY
RKAPVLQY	RKAP-VLQY
VYPPPHQVF	VYPPPHQVF
NRGDFFMTL	NRGDFFMTL
ARHVVKVEY	ARHVVKVEY
SYWNHREL	SYWN-HREL
HRSWWVYTL	HRSWWVYTL
YHSPYPEEY	YHSPYPEEY
AYPEIVAVY	AYPEIVAVY
YRNPVSQCM	YRNPVSQCM
RYDDMATCM	RYDDMATCM
SRPPGQGEF	SRPPGQGEF
VRDHWVHVL	VRDHWVHVL
YRLHHVVVY	YRLHHVVVY
IYYFKANVF	IYYFKANVF
NYGPGPSL	NYGP-GPSL
NYYGKYIAL	NYYGKYIAL
MKHYEVEIL	MKHYEVEIL
MRPDLELQF	MRPDLELQF
AYRQGHFTY	AYRQGHFTY
KYKDAIHFY	KYKDAIHFY
AYLPVNESF	AYLPVNESF
FYGSHPWHW	FYGSHPWHW
IYRWFNISF	IYRWFNISF
HRSPLVLAY	HRSPLVLAY
SRHSGPFFTF	SRHSGFFTF
RKNPFVYKV	RKNPFVYKV
KYKERGTVL	KYKERGTVL
YRVTTEQY	YRVT-TEQY
NRFYHEEL	NRFY-HEEL
NRQTALYTL	NRQTALYTL
SRPKLSFSL	SRPKLSFSL
IYPVNAISF	IYPVNAISF
NRLPLVVSF	NRLPLVVSF
TYEGKPIFL	TYEGKPIFL
FYNLIHPEY	FYNLIHPEY
YRADGIRIY	YRADGIRIY
RRGPCIIY	RRGP-CIIY
KKIPGIYVL	KKIPGIYVL
HKFSDCEFPY	KFSDCEFPY
KRPPGYYSY	KRPPGYYSY
SYDLANRDF	SYDLANRDF
ARADSYYEY	ARADSYYEY
FRKEAGDFYY	FRKEAGDFY
VYFVHPTF	VYFV-HPTF
QRAPGGLSY	QRAPGGLSY
FRLPTAEVM	FRLPTAEVM
LRPLLAAAA	LRPLLAAAA
ARYSGSYNDYL	RYSGSYNDY
ARAPRKVL	ARAP-RKVL
YRRLSESQL	YRRLSESQL
LRHDRPYTL	LRHDRPYTL
YRNQLLNIF	YRNQLLNIF
YRGPAGDATVA	YRGPADATV
KYPSPFFVF	KYPSPFFVF
FRGPSGLLVY	FRGPSLLVY
SRSVMTEEY	SRSVMTEEY
AAPVPTTTL	AAPVPTTTL
ARPEPATGY	ARPEPATGY
TRNNFAVGY	TRNNFAVGY
YRKPKWNHL	YRKPKWNHL
KYGNQLVRL	KYGNQLVRL
SRFEKEFSF	SRFEKEFSF
YRPGPWMKY	YRPGPWMKY
KRKELVTLY	KRKELVTLY
AKQDVVLNY	AKQDVVLNY
SYGGQQQSY	SYGGQQQSY
VHGPPVQL	VHGP-PVQL
AKAPHYVL	AKAP-HYVL
KRVFPKWTY	KRVFPKWTY
YKVEYPIMY	YKVEYPIMY
FRPVPLEQTY	FRPVPEQTY
ARVPHSLDL	ARVPHSLDL
NRPAPVEVSY	NRPAPEVSY
NSPLPGSEL	NSPLPGSEL
TFRDVVIEF	TFRDVVIEF
SRGPGTSFEF	SRGPGSFEF
HRPPPIKL	HRPP-PIKL
YRAPEIIL	YRAP-EIIL
QYPVFPWVL	QYPVFPWVL
KAPGSTSNL	KAPGSTSNL
MYRDYPLEL	MYRDYPLEL
VYPGYYLTF	VYPGYYLTF
FYPLFVHMY	FYPLFVHMY
YRATENDIYNF	YRATENDIY
KRYIFADAY	KRYIFADAY
TYPEVVRMV	TYPEVVRMV
AAPTAQKSL	AAPTAQKSL
RRPARCYRY	RRPARCYRY
NYGVLLHEL	NYGVLLHEL
FYDNKGITYL	FYDNKGITY
FYQPTCIVL	FYQPTCIVL
IYDEAISSFF	IYDEAISSF
MYRSYVEML	MYRSYVEML
TKNGHVYKY	TKNGHVYKY
TRPPALLLL	TRPPALLLL
NKADVILKY	NKADVILKY
YKPDVKIEY	YKPDVKIEY
VYNENLVHM	VYNENLVHM
NRYYSHVDY	NRYYSHVDY
YRTQSSASL	YRTQSSASL
FRQIIAVVL	FRQIIAVVL
FYDGHENM	FYDG-HENM
KRSPALQIL	KRSPALQIL
KKATAYIL	KKAT-AYIL
HGPGPVGAL	HGPGPVGAL
ARSVHEEF	ARSV-HEEF
SNPGGRPAL	SNPGGRPAL
FYDDKKYTY	FYDDKKYTY
SYDPTIENTF	SYDPTENTF
ARSPGSISY	ARSPGSISY
GRSEAVVEY	GRSEAVVEY
YYYDGDVGNY	YYDGDVGNY
SRPPHLVF	SRPP-HLVF
MRPLDIVEL	MRPLDIVEL
HYDLFIERF	HYDLFIERF
VRPDTNIFTVY	VRPD-TNIF
HRPSHFLNF	HRPSHFLNF
VYVLHPQY	VYVL-HPQY
FRFQPFESY	FRFQPFESY
NYNQQPSNY	NYNQQPSNY
GYSNRVVDL	GYSNRVVDL
FRHEVGYVL	FRHEVGYVL
FRTVGQLY	FRTV-GQLY
ARPPSVDSL	ARPPSVDSL
LYDSTRVSF	LYDSTRVSF
VRVDRDYVL	VRVDRDYVL
SRPLSAVVL	SRPLSAVVL
YRIPSTPDSF	YRIPSPDSF
KRADLQSTF	KRADLQSTF
VFRDLVIKY	VFRDLVIKY
SRFSNVYHL	SRFSNVYHL
TRSAIILHL	TRSAIILHL
NRYSHDFNF	NRYSHDFNF
VRNYEQWQL	VRNYEQWQL
FRPEEIELL	FRPEEIELL
NRMTVEYVY	NRMTVEYVY
FRQYAKDIGF	FRQYADIGF
DYDPLVVKL	DYDPLVVKL
NRSQFFITF	NRSQFFITF
FRADDADEF	FRADDADEF
IRVVGSEF	IRVV-GSEF
FYPPPRITL	FYPPPRITL
NRPADVYSY	NRPADVYSY
IKSDVHLNF	IKSDVHLNF
HYSPIYLSF	HYSPIYLSF
RRFMQTFVL	RRFMQTFVL
ARHVVAVVL	ARHVVAVVL
YRHDAVKIL	YRHDAVKIL
YRDIPELQGF	YRDIPLQGF
ARAHSIQIM	ARAHSIQIM
VYNPVIYVF	VYNPVIYVF
IYDLATQTL	IYDLATQTL
SRGEQAWTL	SRGEQAWTL
KYDYVGRLL	KYDYVGRLL
FRPLYTHEY	FRPLYTHEY
YRIESYWTY	YRIESYWTY
HRFSYDTFVDY	SYDT-FVDY
AYKPPGFSL	AYKPPGFSL
YYDDYRVQL	YYDDYRVQL
NYPGFLTIL	NYPGFLTIL
YYPQQAIVF	YYPQQAIVF
QRPTIYYVM	QRPTIYYVM
QYPVFPWIL	QYPVFPWIL
NYFGAQPHY	NYFGAQPHY
SYANYFIRL	SYANYFIRL
NYPGLSISL	NYPGLSISL
YYDVAKQLL	YYDVAKQLL
LYDPASGTISL	LYDPATISL
FYRDWKQY	FYRD-WKQY
NYKKFYEQF	NYKKFYEQF
SRVVTVSEY	SRVVTVSEY
ARFLFTTGF	ARFLFTTGF
TRAQWFYEY	TRAQWFYEY
KKGPQSLF	KKGP-QSLF
MRPVSRVL	MRPV-SRVL
VHAPPMQL	VHAP-PMQL
YRPGTVALR	YRPGTVALR
KKANITFEY	KKANITFEY
IYDFIGEFM	IYDFIGEFM
IRPGTAFEL	IRPGTAFEL
KRGDVIYIL	KRGDVIYIL
FYAYHYRF	FYAY-HYRF
NRPDVLDTAL	NRPDVDTAL
YYISPRITF	YYISPRITF
FYVDTVRAF	FYVDTVRAF
YRDPHVDQY	YRDPHVDQY
SRSPYSPVL	SRSPYSPVL
RRFFPYYVY	RRFFPYYVY
FRKNFATSL	FRKNFATSL
TRVDTILEF	TRVDTILEF
YRDAYLFLL	YRDAYLFLL
IYDDQGHIHL	IYDDQHIHL
MRMATPLLM	MRMATPLLM
VRPAEPAFL	VRPAEPAFL
IYKDLPFET	IYKDLPFET
SYRDSYESY	SYRDSYESY
NKTDVVLIL	NKTDVVLIL
HRFYMHHSF	HRFYMHHSF
ARDPGARVL	ARDPGARVL
AKADVPYIL	AKADVPYIL
AAPEGKRSL	AAPEGKRSL
LRELAVGSL	LRELAVGSL
FRAFLGEL	FRAF-LGEL
YRHFFGHTF	YRHFFGHTF
RYDEMVESM	RYDEMVESM
HYPPVQVLF	HYPPVQVLF
YRKPTYESY	YRKPTYESY
KRADAGFVY	KRADAGFVY
HAPFTATSL	HAPFTATSL
SRKESYSVY	SRKESYSVY
NYDIAIAEL	NYDIAIAEL
FKGQNPFEL	FKGQNPFEL
YRSPLASRY	YRSPLASRY
IYAVNGIAF	IYAVNGIAF
IIHEIAVLEL	IHEIAVLEL
SRSYTPEY	SRSY-TPEY
NRHSYPNVY	NRHSYPNVY
AAPAYSRAL	AAPAYSRAL
ARPTAPFTL	ARPTAPFTL
IHPVVITSF	IHPVVITSF
FYHEAVVLF	FYHEAVVLF
VYDNIGIL	VYDN-IGIL
TYDLMSSAYL	TYDLMSSAY
VRQDVINTL	VRQDVINTL
RRMEVYNEF	RRMEVYNEF
YRGPCHTY	YRGP-CHTY
FRPDEPYYY	FRPDEPYYY
NRVVSNLL	NRVV-SNLL
LRPPIMIM	LRPP-IMIM
YLNENPLRAL	YLNENLRAL
LRPGIHHSL	LRPGIHHSL
FRNVEVLIY	FRNVEVLIY
KYHGFGNVH	KYHGFGNVH
ILTERGYSF	ILTERGYSF
SYQDAAFTY	SYQDAAFTY
ARSENLIYTY	ARSENIYTY
VRPLLSASY	VRPLLSASY
KYGTRYGASL	KYGTRGASL
AYQEAVRTL	AYQEAVRTL
KRFSGTVRL	KRFSGTVRL
ARMEFAWIY	ARMEFAWIY
SYFGSFSSL	SYFGSFSSL
YRAPEVIL	YRAP-EVIL
FYKDSGITY	FYKDSGITY
NRGVIITM	NRGV-IITM
YYVNRDTL	YYVN-RDTL
YYGHTNYIY	YYGHTNYIY
LYFARPVPL	LYFARPVPL
YYRPLHDEY	YYRPLHDEY
NRYWGTPIPL	RYWGTPIPL
SRYVLDDEY	SRYVLDDEY
IREEYPDRIM	IREEYDRIM
YYDKHFTEF	YYDKHFTEF
NYIPRFWTF	NYIPRFWTF
NKELDPIQKL	NKELDIQKL
KAFARPWSL	KAFARPWSL
NIPEKTTAL	NIPEKTTAL
PIRLLAAAA	PIRLLAAAA
QYYFNQHIF	QYYFNQHIF
HLPSGVKSL	HLPSGVKSL
VAPTSGPAL	VAPTSGPAL
SYDDVQQSF	SYDDVQQSF
FREGKGHEY	FREGKGHEY
NRIGGRIFTY	NRIGGIFTY
VRPTYCLEY	VRPTYCLEY
NAPWAVTSL	NAPWAVTSL
ARAGVSQVL	ARAGVSQVL
AYPPPAPAY	AYPPPAPAY
NRAFVSMVY	NRAFVSMVY
NRPRNIMVY	NRPRNIMVY
KYIGYARQY	KYIGYARQY
FYDTSEENY	FYDTSEENY
SRTPYHVNL	SRTPYHVNL
QYNTYPIKL	QYNTYPIKL
AYREHPYGRY	AYREHYGRY
MRKEFTLEF	MRKEFTLEF
SYDHVELTF	SYDHVELTF
YAPSGNYV	YAPS-GNYV
LRVAPEEHPTL	VAPEEHPTL
FRKSTVEHF	FRKSTVEHF
VKSPVQVIL	VKSPVQVIL
LYWSHPRKF	LYWSHPRKF
ARFDSDVEVY	ARFDSVEVY
FRPDLSSASF	FRPDLSASF
YRSPHSPFY	YRSPHSPFY
IYDIFQKL	IYDI-FQKL
SRVAFFEEL	SRVAFFEEL
RYRPGTVAL	RYRPGTVAL
FRSIRPLSY	FRSIRPLSY
GGSYRDSYDSY	SYRDSYDSY
YYDLYGGEKF	YYDLYGEKF
SYLENPTSY	SYLENPTSY
FYQEHPDL	FYQE-HPDL
FAPYERRAM	FAPYERRAM
VYPTAVHVL	VYPTAVHVL
SRPPIIVSEF	SRPPIVSEF
IYDKFIAQL	IYDKFIAQL
SRPNSPQL	SRPN-SPQL
AYDLAKALL	AYDLAKALL
NKKTVSIPSY	KKTVSIPSY
KRKGQVIQF	KRKGQVIQF
YRPNETFHL	YRPNETFHL
YAGLSMEGG	YAGLSMEGG
MRTRVNKEM	MRTRVNKEM
YRGIFPVL	YRGI-FPVL
AYHTQTTPL	AYHTQTTPL
ARPPVLAKL	ARPPVLAKL
ARWWAVVVL	ARWWAVVVL
NYDFGPIHM	NYDFGPIHM
YYNSHDSL	YYNS-HDSL
TYGERVVAF	TYGERVVAF
SRPVIINM	SRPV-IINM
NRFAGFGIGL	NRFAGGIGL
FRNDFLELL	FRNDFLELL
SRVEAVYVL	SRVEAVYVL
IAPTGHSL	IAPT-GHSL
AKQDVVLNYPM	AKQDVVLNY
LYDELRNLL	LYDELRNLL
HYKPTPLYF	HYKPTPLYF
FYSNKEIFL	FYSNKEIFL
HYPDYSWSA	HYPDYSWSA
YYGNISHF	YYGN-ISHF
VYDVAMKL	VYDV-AMKL
LYDFIHTSF	LYDFIHTSF
SRPYAFLEF	SRPYAFLEF
AYDKAVASF	AYDKAVASF
YYYGKFMPVG	YYYGKFMPV
NRPNLYYEV	NRPNLYYEV
SRHLDSYEF	SRHLDSYEF
YYEVAGHL	YYEV-AGHL
KYKDIYTEL	KYKDIYTEL
AYAGTGIQY	AYAGTGIQY
GSYRDSYDSY	SYRDSYDSY
SRAIFEEVY	SRAIFEEVY
VYDALNVLM	VYDALNVLM
AAQDRDQIY	AAQDRDQIY
NRPAPVEVTY	NRPAPEVTY
SRAMLLTSY	SRAMLLTSY
NAPLVHATL	NAPLVHATL
VLSAADKGNV	SAAD-KGNV
YRRNKSYSF	YRRNKSYSF
FRHDSGYEVHH	FRHDSGYEV
ARPELLEVF	ARPELLEVF
YREILVKEL	YREILVKEL
HYPDFHQEL	HYPDFHQEL
VYDLLKNHL	VYDLLKNHL
FYRSYFSQF	FYRSYFSQF
VRVEPLVTM	VRVEPLVTM
IYAPKLQEF	IYAPKLQEF
NRYDGQVAVF	RYDGQVAVF
YYEDGNVQL	YYEDGNVQL
TYDPETQEF	TYDPETQEF
TVMDKTRAL	TVMDKTRAL
YYPNPPLVL	YYPNPPLVL
AYYEEQHPEL	YYEEQHPEL
FRKEAGDFY	FRKEAGDFY
IYDNAVQGL	IYDNAVQGL
RRAEVELEY	RRAEVELEY
IYDPFAGM	IYDP-FAGM
NYDVSHTF	NYDV-SHTF
SRPESFAIY	SRPESFAIY
VYDPSLKTL	VYDPSLKTL
HYDPATEEF	HYDPATEEF
AYSDVAKRL	AYSDVAKRL
VAPVTHVSV	VAPVTHVSV
IRPPTRTA	IRPP-TRTA
LYDLVTEKM	LYDLVTEKM
YKQVLEPSF	YKQVLEPSF
TAPTGHTL	TAPT-GHTL
NRGEVVTSF	NRGEVVTSF
HLPETKFSEL	HLPETFSEL
NYFHLAVAF	NYFHLAVAF
YRPEFLPQVF	YRPEFPQVF
YAPKGSSL	YAPK-GSSL
IYPGYHQSSY	IYPGYQSSY
RYDDMASAM	RYDDMASAM
FKLLSHSL	FKLL-SHSL
SRKESYSIYVY	SRKESYSIY
FYEENGFL	FYEE-NGFL
FRHEVMYSF	FRHEVMYSF
SKADALFEL	SKADALFEL
FRNFFSNMF	FRNFFSNMF
SAPKGSVL	SAPK-GSVL
YYDLQGHLF	YYDLQGHLF
YRAPELIF	YRAP-ELIF
KRNGVIIAGY	KRNGVIAGY
SRKTFTETF	SRKTFTETF
VYDVVELKF	VYDVVELKF
IKLLNENSY	IKLLNENSY
RRWEQALTF	RRWEQALTF
FRFEEPVVL	FRFEEPVVL
YYSGLIYTY	YYSGLIYTY
KYFAKHPRL	KYFAKHPRL
FRDAFTQEL	FRDAFTQEL
VRGPPTLEY	VRGPPTLEY
GKIDFLNNYAL	GKIDFLNNY
YYKPDSPEY	YYKPDSPEY
HRHGKPFVF	HRHGKPFVF
SRPPKLVM	SRPP-KLVM
IRQTGVIVL	IRQTGVIVL
NYDEMKDFL	NYDEMKDFL
KYKDNPFSL	KYKDNPFSL
EYAHLFEVF	EYAHLFEVF
SYMEVPTYL	SYMEVPTYL
FRVPFIYGH	FRVPFIYGH
SRPENAIIY	SRPENAIIY
FRRPVLQVL	FRRPVLQVL
NRGINITIY	NRGINITIY
FRVVDTEF	FRVV-DTEF
IRVDHAGEY	IRVDHAGEY
YRQQQSQTAY	YRQQQQTAY
FRMPVLREY	FRMPVLREY
VRPGILVL	VRPG-ILVL
SVPLAATSM	SVPLAATSM
NKKDDGISF	NKKDDGISF
FYDERGDQF	FYDERGDQF
ARPPGYEF	ARPP-GYEF
TVTEKPEVID	TVTEKPEVI
RYKDLRTAY	RYKDLRTAY
FRVDFTEAL	FRVDFTEAL
ARYPKKIHY	ARYPKKIHY
YRQKQVVIL	YRQKQVVIL
TKIDVSYEY	TKIDVSYEY
SRNGKSYTF	SRNGKSYTF
SRSWLSYSY	SRSWLSYSY
IRMPSLPSY	IRMPSLPSY
MYHGAAFQL	MYHGAAFQL
GSYRDSYESY	SYRDSYESY
ITPTGTHPL	ITPTGTHPL
GRAKTPVTL	GRAKTPVTL
SAPSSSTPF	SAPSSSTPF
YYPAENLIEY	YYPAELIEY
FRMQEGSEVY	FRMQESEVY
RRFDTAFFL	RRFDTAFFL
IYKELLISL	IYKELLISL
HYDVQSILF	HYDVQSILF
AYTPFHAVL	AYTPFHAVL
AYDDLGNSGHF	AYDDLGNSG
SYYDRGYDRGY	SYYDRGYDR
VYPGLAVFF	VYPGLAVFF
SIPILASAL	SIPILASAL
LKAEAHHAEL	LKAEAHAEL
SRFAKVHIL	SRFAKVHIL
LYYLHPVL	LYYL-HPVL
NKNPNIVNY	NKNPNIVNY
IYPYVIQEL	IYPYVIQEL
KRYLFRSF	KRYL-FRSF
SIPEKNRPL	SIPEKNRPL
FRSDISEEL	FRSDISEEL
KRPVGGFLL	KRPVGGFLL
SRSLLQTTF	SRSLLQTTF
YYTDFVMEL	YYTDFVMEL
LRDHSVRVL	LRDHSVRVL
FRHPHIIKL	FRHPHIIKL
NYVEFTRIL	NYVEFTRIL
QRQDIAFAY	QRQDIAFAY
FYHPFPTPY	FYHPFPTPY
SRLFFVIEY	SRLFFVIEY
ARPPAAPEL	ARPPAAPEL
YRPSYSYDY	YRPSYSYDY
YYLTFVQEL	YYLTFVQEL
GRHGVFLEL	GRHGVFLEL
TYDPTYSDF	TYDPTYSDF
LRPPERQAL	LRPPERQAL
FRKDSSYEL	FRKDSSYEL
KRPPLQSL	KRPP-LQSL
NYLPFIMEL	NYLPFIMEL
FYNSFLEQL	FYNSFLEQL
ERPPNPIEF	ERPPNPIEF
AYSSYVHQY	AYSSYVHQY
NKIEKIYIM	NKIEKIYIM
VAPPVSGDL	VAPPVSGDL
IYDKYGSL	IYDK-YGSL
FVEIKGSV	FVEI-KGSV
YYYTKEEQF	YYYTKEEQF
SYDHTVKM	SYDH-TVKM
YLPYRDYNY	YLPYRDYNY
VAPVGSGSAL	VAPVGGSAL
YRAVVQIF	YRAV-VQIF
MRRDVQEIF	MRRDVQEIF
YRAPEVLL	YRAP-EVLL
ERVPFILTY	ERVPFILTY
FKIHQPYTL	FKIHQPYTL
VYPWTQRFF	VYPWTQRFF
GRAPGGLSL	GRAPGGLSL
AYRDARVEL	AYRDARVEL
TRPEKALIL	TRPEKALIL
ARSPALQVL	ARSPALQVL
NYGQYFTL	NYGQ-YFTL
IRQVQPEGPY	IRQVQEGPY
VYDVTDQESF	VYDVTQESF
IAPTGIESL	IAPTGIESL
IRDNFVIIY	IRDNFVIIY
YREHPYGRY	YREHPYGRY
FYRNYDVM	FYRN-YDVM
SKNPHIVSF	SKNPHIVSF
YRAPELML	YRAP-ELML
AAPTSAAAL	AAPTSAAAL
YYTEFPTV	YYTE-FPTV
FYSGSPTSY	FYSGSPTSY
KRPPLQEY	KRPP-LQEY
LRVDPVNFKL	LRVD-PVNF
FYDVQFKEL	FYDVQFKEL
YRKGSISVF	YRKGSISVF
AKGPNIVL	AKGP-NIVL
IRQDNERVL	IRQDNERVL
YRVPNMRFL	YRVPNMRFL
GRPGPIGPA	GRPGPIGPA
YYDEIINAL	YYDEIINAL
YYPELAFQF	YYPELAFQF
FYMDTSHLF	FYMDTSHLF
YRNPCYVSY	YRNPCYVSY
ARAYEPQEL	ARAYEPQEL
TRYQGVNLY	TRYQGVNLY
AYDDKIYYF	AYDDKIYYF
IYATIPVY	IYAT-IPVY
NRSNTVVIM	NRSNTVVIM
YRPLFDYFL	YRPLFDYFL
KKSPVLQY	KKSP-VLQY
RAGLPAPTI	RAGLPAPTI
LRFLFNEL	LRFL-FNEL
MRPPIIIH	MRPP-IIIH
IYDKTSVLF	IYDKTSVLF
KYPHYFPVM	KYPHYFPVM
TYMEFLWQY	TYMEFLWQY
RRNPYCRTL	RRNPYCRTL
SRFPEALRL	SRFPEALRL
NTPSGTNAL	NTPSGTNAL
YRLESTLNY	YRLESTLNY
NRVLHYWTM	NRVLHYWTM
YKGPRIVL	YKGP-RIVL
HYDPMIAKL	HYDPMIAKL
HRNLIEIGY	HRNLIEIGY
YYRAWQEYY	YYRAWQEYY
SHAPSFNF	SHAP-SFNF
FYDECLRKY	FYDECLRKY
NYDPALHPF	NYDPALHPF
IRAPIMRM	IRAP-IMRM
SAPGIISAL	SAPGIISAL
YRRVFEEY	YRRV-FEEY
TAPQGNVDL	TAPQGNVDL
ARVPSSLAY	ARVPSSLAY
ESGPSIVH	ESGP-SIVH
KRLNFITEY	KRLNFITEY
SRPHFLIEL	SRPHFLIEL
VYDTNPAKF	VYDTNPAKF
FYYGGQVNY	FYYGGQVNY
AYPHPHFAL	AYPHPHFAL
IHSPVVNEL	IHSPVVNEL
FSPVGSVL	FSPV-GSVL
NYDLALKYF	NYDLALKYF
YRRPVLLLH	YRRPVLLLH
YYDNADKL	YYDN-ADKL
FRFENVNGY	FRFENVNGY
FYRPLAPEL	FYRPLAPEL
QYKDVPITY	QYKDVPITY
VYGVVPISL	VYGVVPISL
AVEAKKTYVRD	AVEA-KKTY
HRYENVSIL	HRYENVSIL
IYDEDEVLL	IYDEDEVLL
YRAPGTPTY	YRAPGTPTY
NYDEHISNF	NYDEHISNF
YAPSGNFV	YAPS-GNFV
RRSPVKVVF	RRSPVKVVF
IYLTFPVAM	IYLTFPVAM
KRPPLRGV	KRPP-LRGV
HRAQVIYTR	HRAQVIYTR
YYPPSIGF	YYPP-SIGF
IRFTSPVSL	IRFTSPVSL
NRLVFSVM	NRLV-FSVM
LYDVVDVKY	LYDVVDVKY
YYDGDVGNYYY	YYDGDVGNY
NRTIVITSH	NRTIVITSH
IYDPNLAFL	IYDPNLAFL
AAPTSSAL	AAPT-SSAL
KYFDKASYRVY	KYFD-KASY
RYPDLELKY	RYPDLELKY
VSPLATSAL	VSPLATSAL
TYRAIAETY	TYRAIAETY
VRPPKKVL	VRPP-KKVL
SGPGPAAAL	SGPGPAAAL
KYPEGIRKY	KYPEGIRKY
IRHDVPYLF	IRHDVPYLF
FYRTLITLL	FYRTLITLL
SRPEAPNEF	SRPEAPNEF
AYRLSVEIY	AYRLSVEIY
FRPLDVSLY	FRPLDVSLY
QYYALEVSY	QYYALEVSY
IYQELVTKY	IYQELVTKY
HRPPYHLL	HRPP-YHLL
AYSEAIFEL	AYSEAIFEL
SAPVGVTAL	SAPVGVTAL
LYDVRTILL	LYDVRTILL
LYDTHQNL	LYDT-HQNL
TRSPHIETY	TRSPHIETY
FYIESISYL	FYIESISYL
YRFDPRSGP	YRFDPRSGP
YYDGKVMKL	YYDGKVMKL
SRSHSVFQL	SRSHSVFQL
ARTPVTSTY	ARTPVTSTY
LRVDPVNF	LRVD-PVNF
VYKKSIFVF	VYKKSIFVF
AYQELLQHY	AYQELLQHY
GRPLFPHVL	GRPLFPHVL
VYDDGKHVYL	VYDDGKHVY
VKPPVRKL	VKPP-VRKL
FRVDYILSV	FRVDYILSV
GRQIKPYTL	GRQIKPYTL
VRPHIDISF	VRPHIDISF
FYQSLGIPY	FYQSLGIPY
FRNIQNMIL	FRNIQNMIL
SRPISPLL	SRPI-SPLL
RYWFHYTL	RYWF-HYTL
LYSPQYISY	LYSPQYISY
SYDYSGRYL	SYDYSGRYL
FRKLSSETY	FRKLSSETY
YYRYPTGESY	YRYPTGESY
KYKDSYNVF	KYKDSYNVF
ARAPGTRTL	ARAPGTRTL
AQVTVVVAQ	AQVTVVVAQ
NRTDVVLIL	NRTDVVLIL
