Data	Data aligned
NLDLTERQV	NLDLTERQV
AYDTLPVLI	AYDTLPVLI
VSDPVTVHF	VSDPVTVHF
KYDSTAIYL	KYDSTAIYL
RYDLSPITV	RYDLSPITV
IWDETPLYF	IWDETPLYF
MFDDIGRNF	MFDDIGRNF
SFDNIKNWI	SFDNIKNWI
FTEKEWPLL	FTEKEWPLL
SFDAHLTEL	SFDAHLTEL
QFDVQRKYF	QFDVQRKYF
HFDLSVIEL	HFDLSVIEL
RFEDSPSYV	RFEDSPSYV
YFDSRGMFI	YFDSRGMFI
HPESERISM	HPESERISM
SYDNVLIKW	SYDNVLIKW
NFDEKPVII	NFDEKPVII
LFDKTPVLL	LFDKTPVLL
IMDATNILV	IMDATNILV
NHDMTLTEF	NHDMTLTEF
VYDPSLKTL	VYDPSLKTL
FFEGPPFKF	FFEGPPFKF
EDDDDNDIM	EDDDDNDIM
TYDEIGVMF	TYDEIGVMF
AFDNVLNYI	AFDNVLNYI
LYDIILKNF	LYDIILKNF
SFDETLTAL	SFDETLTAL
FFDMAYQGF	FFDMAYQGF
FAYDGKDYI	FAYDGKDYI
AFLESVKKL	AFLESVKKL
FFEVFTPVF	FFEVFTPVF
VWEEMKTTL	VWEEMKTTL
YFDEPVELR	YFDEPVELR
RFDNADRMF	RFDNADRMF
FFDSVQVVF	FFDSVQVVF
SWDRAPTFL	SWDRAPTFL
LYDTHITVL	LYDTHITVL
IFYATATLI	IFYATATLI
AWDEADVRF	AWDEADVRF
HVTQEDFEM	HVTQEDFEM
VFDEWVSKL	VFDEWVSKL
FFDYSGRDL	FFDYSGRDL
IWDWKTTKL	IWDWKTTKL
FTDEESRVF	FTDEESRVF
SEDFRENIF	SEDFRENIF
IYELAVASF	IYELAVASF
TYDEAIHSV	TYDEAIHSV
VFDEVVQIF	VFDEVVQIF
EFDPVMVIL	EFDPVMVIL
IYEEFLAAF	IYEEFLAAF
TFDEVLELM	TFDEVLELM
FWDPSVNLF	FWDPSVNLF
FFPEDPVKI	FFPEDPVKI
YFDPKQTDV	YFDPKQTDV
FYDPDVGNF	FYDPDVGNF
TFDNVTSYL	TFDNVTSYL
KFDGDSAYV	KFDGDSAYV
NYDEALRLL	NYDEALRLL
AFDRHMVLL	AFDRHMVLL
FYDSELFRM	FYDSELFRM
NFDTIDQQF	NFDTIDQQF
FWDNVVYIL	FWDNVVYIL
FWDKLQAEL	FWDKLQAEL
DAAIRVWSL	DAAIRVWSL
NFDFTRSYL	NFDFTRSYL
FFDEVVKQM	FFDEVVKQM
YFDVEPFVF	YFDVEPFVF
SMDPLPVFL	SMDPLPVFL
IFDEILVNA	IFDEILVNA
GWDEALLTM	GWDEALLTM
TFESLVAKL	TFESLVAKL
TYEGKPIFL	TYEGKPIFL
FFDLNDTKL	FFDLNDTKL
KTDVTVVRF	KTDVTVVRF
FPDSGHFNV	FPDSGHFNV
LYDKDAVYV	LYDKDAVYV
MVDPFHTLF	MVDPFHTLF
HYDLAFTDV	HYDLAFTDV
HFDFIQSHI	HFDFIQSHI
AFDLDVVKL	AFDLDVVKL
WYDPKVTRV	WYDPKVTRV
FWDDAVKEV	FWDDAVKEV
RWENIATIL	RWENIATIL
YFDGDLSKV	YFDGDLSKV
VFDMVVAHI	VFDMVVAHI
TWDDAFATF	TWDDAFATF
IMDVSLRSF	IMDVSLRSF
NFDPPIEEF	NFDPPIEEF
SFDLAIKGV	SFDLAIKGV
TFDNEIVMM	TFDNEIVMM
NFDVRFETF	NFDVRFETF
TFDDLKIQT	TFDDLKIQT
NAEPEPRSL	NAEPEPRSL
TFDPVTKML	TFDPVTKML
LYDNDIYFI	LYDNDIYFI
AFDIAEKEL	AFDIAEKEL
VWPLQIILL	VWPLQIILL
TYDQSQSPM	TYDQSQSPM
TFDIEAVTL	TFDIEAVTL
EFDAGIIEL	EFDAGIIEL
TFDIASDAF	TFDIASDAF
FFDHSTRIV	FFDHSTRIV
TVPVRLSSL	TVPVRLSSL
KFDSEYERM	KFDSEYERM
VFDETGHFV	VFDETGHFV
YFHEALRAF	YFHEALRAF
VFDVGGLLE	VFDVGGLLE
IFDQSGTYL	IFDQSGTYL
DNTIKLTSL	DNTIKLTSL
TFDAHLTEL	TFDAHLTEL
TFDLAAPTV	TFDLAAPTV
YMDTLNIFM	YMDTLNIFM
VFDLQWLEL	VFDLQWLEL
RFDGMLLAM	RFDGMLLAM
DFDPALGMM	DFDPALGMM
RFDEGPVRL	RFDEGPVRL
NQDIRFQAV	NQDIRFQAV
AFDNMVTSM	AFDNMVTSM
MVDGTLLLL	MVDGTLLLL
NFEDEPPLL	NFEDEPPLL
YFDDALEDF	YFDDALEDF
TFDDLPARF	TFDDLPARF
GFDLQETLV	GFDLQETLV
LYQYYLDHL	LYQYYLDHL
VLDGKIVAL	VLDGKIVAL
VFDKFSNKV	VFDKFSNKV
VFDVESREL	VFDVESREL
GFDERVTVM	GFDERVTVM
KFDYVMQFL	KFDYVMQFL
KYDDAERRF	KYDDAERRF
VPEEKAAEL	VPEEKAAEL
RFPDLTVEL	RFPDLTVEL
MPDHTDVSL	MPDHTDVSL
YWEEEPAEV	YWEEEPAEV
TYDQMYNDL	TYDQMYNDL
YYAYLPAKL	YYAYLPAKL
FFDDVTVYL	FFDDVTVYL
YYDVSQEVL	YYDVSQEVL
EFDSMMNTV	EFDSMMNTV
FFDTSVPLM	FFDTSVPLM
HFDASLSTY	HFDASLSTY
YFDLQTHVI	YFDLQTHVI
SFDEFIKIF	SFDEFIKIF
LYDLLGNVW	LYDLLGNVW
LFDTKPLIV	LFDTKPLIV
VWPLPPAVL	VWPLPPAVL
EFDHLPALL	EFDHLPALL
VFDLQWMEV	VFDLQWMEV
NLDPLVYLL	NLDPLVYLL
ITDEQIQEM	ITDEQIQEM
NFEVAESDF	NFEVAESDF
KFDDIRIYF	KFDDIRIYF
MQDPMEVFV	MQDPMEVFV
RYDDLKEEM	RYDDLKEEM
VWELLPTTL	VWELLPTTL
DQTIRIHGL	DQTIRIHGL
FVDDYTVRV	FVDDYTVRV
FYEGRPVRL	FYEGRPVRL
VYDQAQSVM	VYDQAQSVM
TFDDVAVTF	TFDDVAVTF
NEELRNLSL	NEELRNLSL
ILDNSPAFL	ILDNSPAFL
FSPFHASVL	FSPFHASVL
FLDLTEQEF	FLDLTEQEF
FLDLSSNQL	FLDLSSNQL
VYDMNLREM	VYDMNLREM
DGTVRLWSL	DGTVRLWSL
FFNYKVVLL	FFNYKVVLL
NAPWAVTSL	NAPWAVTSL
NFDLDRGVF	NFDLDRGVF
VFDESTRKI	VFDESTRKI
FSEEHPVLL	FSEEHPVLL
LFDDKAVEI	LFDDKAVEI
NYDEHISNF	NYDEHISNF
NFMLHLVSM	NFMLHLVSM
VWDLAQQVV	VWDLAQQVV
IWDLTTATL	IWDLTTATL
SFDAAMKGL	SFDAAMKGL
FFDVTYRHF	FFDVTYRHF
SFDIQLTSV	SFDIQLTSV
AFDEAKADF	AFDEAKADF
AYDPYLIAM	AYDPYLIAM
YFEYFGPDF	YFEYFGPDF
TFDQKIVEW	TFDQKIVEW
RFDCSDRQF	RFDCSDRQF
FHYDYIDLL	FHYDYIDLL
LWEPTPVKL	LWEPTPVKL
KSDPSIVRL	KSDPSIVRL
IYDPNLAFL	IYDPNLAFL
SFEEKPVYI	SFEEKPVYI
KYFLWVVKF	KYFLWVVKF
LFDYTDTLV	LFDYTDTLV
WFDPAIFTI	WFDPAIFTI
HFDLFLRFL	HFDLFLRFL
VFDEADRMF	VFDEADRMF
EFDAVLADF	EFDAVLADF
VYDVTPPEL	VYDVTPPEL
TFDEIASGF	TFDEIASGF
VFDPALNLF	VFDPALNLF
HYDAVEAEL	HYDAVEAEL
TFEDVAVYF	TFEDVAVYF
LFDTLVNFF	LFDTLVNFF
RFDPVRVDI	RFDPVRVDI
TFQPYLDTL	TFQPYLDTL
HIIAGAGEL	HIIAGAGEL
IFDSVSVQV	IFDSVSVQV
IYDFIGEFM	IYDFIGEFM
LFDANKAEL	LFDANKAEL
VFDDTLGSF	VFDDTLGSF
TLDVQTQQM	TLDVQTQQM
NAPLVNVTL	NAPLVNVTL
YFEGSIYEI	YFEGSIYEI
SYDTFVVRV	SYDTFVVRV
TFDETVSTY	TFDETVSTY
AGDGPPRSF	AGDGPPRSF
MFDEKLVTV	MFDEKLVTV
RYDLGGLVM	RYDLGGLVM
YMDYAQARF	YMDYAQARF
LFDASGHGL	LFDASGHGL
MFDKDVVML	MFDKDVVML
KYDNMAELF	KYDNMAELF
LFDARTSLV	LFDARTSLV
FYDGIKAIL	FYDGIKAIL
FPEGKGVAV	FPEGKGVAV
IYDKFIAQL	IYDKFIAQL
EYEKLPAYL	EYEKLPAYL
FLDENVVSF	FLDENVVSF
IFDEAALEV	IFDEAALEV
EFDGTKVFL	EFDGTKVFL
FYDGVVQTV	FYDGVVQTV
LWEYDPVKL	LWEYDPVKL
TFDAQIVII	TFDAQIVII
YFDWGPGEM	YFDWGPGEM
RFDPLGHYL	RFDPLGHYL
MFDNALSTL	MFDNALSTL
VFDNKVLTI	VFDNKVLTI
FFDALDHVI	FFDALDHVI
SFDNIRNWI	SFDNIRNWI
FFDAQEVLL	FFDAQEVLL
AYDLAKALL	AYDLAKALL
LYDLTLEYL	LYDLTLEYL
SYDHVELTF	SYDHVELTF
YYEVHKELF	YYEVHKELF
HFDETVNRY	HFDETVNRY
WFDNSNMTF	WFDNSNMTF
ILDAQTAFV	ILDAQTAFV
VFDSVNARL	VFDSVNARL
EYDNAIITM	EYDNAIITM
TWDPLGQYV	TWDPLGQYV
ILDPHVVLL	ILDPHVVLL
DFDEVRQEI	DFDEVRQEI
VLPERYSSL	VLPERYSSL
RFDESMQVF	RFDESMQVF
KYDEGLYRF	KYDEGLYRF
VFEVSLADL	VFEVSLADL
FYPPKVELF	FYPPKVELF
VFDTSIAQL	VFDTSIAQL
LLDGKLVLL	LLDGKLVLL
VTDPRVVDL	VTDPRVVDL
LFELNTPEF	LFELNTPEF
YYDVAKQLL	YYDVAKQLL
KFDPMGKYF	KFDPMGKYF
YVDFEGINF	YVDFEGINF
SWDEHVFEL	SWDEHVFEL
VYQEMPAQL	VYQEMPAQL
NYDVLANEI	NYDVLANEI
VWDLHNQTL	VWDLHNQTL
IFDPLEIIL	IFDPLEIIL
IYDEDEVLL	IYDEDEVLL
TFDVSPKAV	TFDVSPKAV
LPDGQVITI	LPDGQVITI
FFDNISSEL	FFDNISSEL
LFDIFSQQV	LFDIFSQQV
TVDFLSLDL	TVDFLSLDL
FPDKVAIQL	FPDKVAIQL
NYDETISTL	NYDETISTL
YYDDYRVQL	YYDDYRVQL
TADGRVVKL	TADGRVVKL
NFDNILNSF	NFDNILNSF
RYDEMVESM	RYDEMVESM
RFDSDVGEF	RFDSDVGEF
KYDPNVYSI	KYDPNVYSI
RWDAIVAEV	RWDAIVAEV
VFYPFVDLI	VFYPFVDLI
LLPPPMKEL	LLPPPMKEL
FFDEKLNSL	FFDEKLNSL
GMDVAASEF	GMDVAASEF
TYDNVHQQF	TYDNVHQQF
VTEEFGVHL	VTEEFGVHL
VMDVAFVQF	VMDVAFVQF
FFDVLIKSM	FFDVLIKSM
SWDKILALV	SWDKILALV
FYIESISYL	FYIESISYL
AFDSTLTHL	AFDSTLTHL
VFDKMSSLL	VFDKMSSLL
FTDPLGVQI	FTDPLGVQI
AFEDDAIQL	AFEDDAIQL
TPEGYYMFI	TPEGYYMFI
VMDVQYNKF	VMDVQYNKF
VFDIVIHRF	VFDIVIHRF
VFDLIQELF	VFDLIQELF
FYETLPAEM	FYETLPAEM
AYDDLSPLL	AYDDLSPLL
VPDPFFVEL	VPDPFFVEL
LFDKSINEF	LFDKSINEF
LFDEIDQAL	LFDEIDQAL
RFDPTWESL	RFDPTWESL
SFDLNTIQI	SFDLNTIQI
TWEAQPVKV	TWEAQPVKV
KADGVPVYL	KADGVPVYL
NFDKIGKEF	NFDKIGKEF
KYDATMIEI	KYDATMIEI
HFDPEAPFL	HFDPEAPFL
IYDKVSGDM	IYDKVSGDM
HPESTPKSL	HPESTPKSL
DFDMTLSRF	DFDMTLSRF
IFSEKPVFV	IFSEKPVFV
TYDLQESNV	TYDLQESNV
HFDTIFEVF	HFDTIFEVF
FADYPCHTV	FADYPCHTV
VYDLSKGLA	VYDLSKGLA
LFDEVAIYF	LFDEVAIYF
WFDGKLVTV	WFDGKLVTV
KFDEGRNNF	KFDEGRNNF
WPDDKVHKL	WPDDKVHKL
YWENKIVRI	YWENKIVRI
EIGVLAKAF	EIGVLAKAF
IFWFFREAF	IFWFFREAF
FLDSTSPLL	FLDSTSPLL
HYEGAVVIL	HYEGAVVIL
SYDVRIENF	SYDVRIENF
AHDVDPIEL	AHDVDPIEL
VLDNPTPEM	VLDNPTPEM
NFDERPISV	NFDERPISV
FFDLWEEHI	FFDLWEEHI
MLDLAKIIF	MLDLAKIIF
FFDNLVYYI	FFDNLVYYI
TYDYAKTIL	TYDYAKTIL
NYEDVATFL	NYEDVATFL
NFDYLRKEM	NFDYLRKEM
AWDLYYHVF	AWDLYYHVF
YYDVEPFLF	YYDVEPFLF
VYDALNVLM	VYDALNVLM
LHYPIDSLT	LHYPIDSLT
AFDVAEKYL	AFDVAEKYL
YSDNSNGSF	YSDNSNGSF
VLDLAETMV	VLDLAETMV
MFNPMYALF	MFNPMYALF
NFDESLNSL	NFDESLNSL
DWDLHQSLF	DWDLHQSLF
LFDVQRNNI	LFDVQRNNI
VFDRFTVVL	VFDRFTVVL
NFDVGHVPI	NFDVGHVPI
HFDIVIRNL	HFDIVIRNL
KFDPVGEIL	KFDPVGEIL
LPDKTLIDL	LPDKTLIDL
LLDQLHTLL	LLDQLHTLL
YYDGKVMKL	YYDGKVMKL
ITDPRTVFV	ITDPRTVFV
LFDITGQDF	LFDITGQDF
MFDHIPVGV	MFDHIPVGV
SFDETVTHF	SFDETVTHF
MVDPAINLF	MVDPAINLF
YSPYYNTID	YSPYYNTID
TFEDVAIDF	TFEDVAIDF
DYDPQTVRL	DYDPQTVRL
LPDKGAQRL	LPDKGAQRL
SFDKSIRIF	SFDKSIRIF
RFDLSAQQM	RFDLSAQQM
NLDQPPAFF	NLDQPPAFF
MWDTRIAKL	MWDTRIAKL
HFYYFVKEF	HFYYFVKEF
TFDDIVHSF	TFDDIVHSF
NFDDIKNGL	NFDDIKNGL
FWESSIVYL	FWESSIVYL
TPESGKQTL	TPESGKQTL
NYDLALKYF	NYDLALKYF
MPEQWARLL	MPEQWARLL
VWDHQGVEL	VWDHQGVEL
LWDKIAAQL	LWDKIAAQL
MWDQRLVRL	MWDQRLVRL
LFDLGGQYL	LFDLGGQYL
VFDDMINLL	VFDDMINLL
SFDEIHQLF	SFDEIHQLF
NVEIDPEIQ	NVEIDPEIQ
IFDRVLTEL	IFDRVLTEL
SYWEWLPLL	SYWEWLPLL
TFDLQMKFV	TFDLQMKFV
FYDSQGIHF	FYDSQGIHF
TWDYTNPNL	TWDYTNPNL
FFNLTVKEM	FFNLTVKEM
HYDPATEEF	HYDPATEEF
SFDEYSSEL	SFDEYSSEL
LFDAFVSVL	LFDAFVSVL
YFDPQYFEF	YFDPQYFEF
TYDLIKDAL	TYDLIKDAL
LLIENVASL	LLIENVASL
DFDSVSSIM	DFDSVSSIM
IYDLLSITL	IYDLLSITL
KYDTALNLL	KYDTALNLL
SYDYSGRYL	SYDYSGRYL
VFETLEARM	VFETLEARM
ATDEFASYF	ATDEFASYF
IFDAVGFTF	IFDAVGFTF
FYDSQPTLI	FYDSQPTLI
FFDHVTHRV	FFDHVTHRV
LLDPDTAVL	LLDPDTAVL
KYDYVGRLL	KYDYVGRLL
HFYEHLNQM	HFYEHLNQM
VWDTKEVQM	VWDTKEVQM
SLDAFMSEM	SLDAFMSEM
IADPNIAKL	IADPNIAKL
LFDHVVNRV	LFDHVVNRV
VVDAIPVFL	VVDAIPVFL
AYDDKIYYF	AYDDKIYYF
VYDTVFKHF	VYDTVFKHF
HFSEQLLNL	HFSEQLLNL
YYDLVRTEI	YYDLVRTEI
FLDWPQGTF	FLDWPQGTF
HFDASHVAL	HFDASHVAL
FFPAFITLL	FFPAFITLL
NPDDVFREF	NPDDVFREF
VYDTNPAKF	VYDTNPAKF
IFDWLGRSL	IFDWLGRSL
SYDLANRDF	SYDLANRDF
SQISFIDYF	SQISFIDYF
SFDFRTSEI	SFDFRTSEI
IIDEQPLIF	IIDEQPLIF
TWEGKGTYV	TWEGKGTYV
LWDSAVSHF	LWDSAVSHF
NFDDSKNGL	NFDDSKNGL
HFDLHEEML	HFDLHEEML
SYDVFQLEF	SYDVFQLEF
VFDNSIKTF	VFDNSIKTF
TFDLMQILL	TFDLMQILL
VLDPESVEL	VLDPESVEL
SFDKLEAVV	SFDKLEAVV
VFDVIIRCF	VFDVIIRCF
EWEATSIYL	EWEATSIYL
TFDTTFSHF	TFDTTFSHF
IYEQKIAEL	IYEQKIAEL
NMDLMRADM	NMDLMRADM
LYDYAKDLF	LYDYAKDLF
HFDSPPHLL	HFDSPPHLL
AWDIAIATM	AWDIAIATM
EFDPIPVLI	EFDPIPVLI
ASDDKTVKL	ASDDKTVKL
ILDRMHCIL	ILDRMHCIL
VFDGSGTDM	VFDGSGTDM
FFEHERTFL	FFEHERTFL
VFENIVAVL	VFENIVAVL
MMDVAFVQF	MMDVAFVQF
VVPDHPVLL	VVPDHPVLL
VFDARELEL	VFDARELEL
FLLDKKIGV	FLLDKKIGV
SYDPLVIYL	SYDPLVIYL
NFYVFPKPF	NFYVFPKPF
VVFVLCWMP	VVFVLCWMP
VYDLSIRGF	VYDLSIRGF
HFDYSPAGL	HFDYSPAGL
SFDGIIAMM	SFDGIIAMM
IFDSSDLSF	IFDSSDLSF
NFEVSTVIF	NFEVSTVIF
VMDLSIVRL	VMDLSIVRL
MYEQQVVKL	MYEQQVVKL
RYDGQVAVF	RYDGQVAVF
KFDAELLEI	KFDAELLEI
VFDYSINSV	VFDYSINSV
FADFERHFL	FADFERHFL
KFDNKTVTF	KFDNKTVTF
TYDVTDSRI	TYDVTDSRI
DFDVAVVTF	DFDVAVVTF
IFDANESGF	IFDANESGF
IYDVNKNEW	IYDVNKNEW
TFDSSGAFL	TFDSSGAFL
FADLNLAEF	FADLNLAEF
YYDVAKILI	YYDVAKILI
NFYPFLQRF	NFYPFLQRF
RFDYTNSEF	RFDYTNSEF
FWDYGRIAL	FWDYGRIAL
MFDELRTWL	MFDELRTWL
ATDDPAARF	ATDDPAARF
LYDVPANSM	LYDVPANSM
FWDTSPLLL	FWDTSPLLL
TLDELPAML	TLDELPAML
IWDFVSGSF	IWDFVSGSF
SYDEAILRL	SYDEAILRL
VFDDSGSIF	VFDDSGSIF
LLDGRVALL	LLDGRVALL
KFDLAARTL	KFDLAARTL
VFDTAIAHL	VFDTAIAHL
LPDFERESL	LPDFERESL
FFSPKVVSL	FFSPKVVSL
NFEAATESF	NFEAATESF
FYEERALYL	FYEERALYL
VFDQPQEYF	VFDQPQEYF
TYDIVITTY	TYDIVITTY
LFEVISHSF	LFEVISHSF
LLMDRVDEM	LLMDRVDEM
ITDFHPDTW	ITDFHPDTW
NTDEHARVM	NTDEHARVM
HYDHVLIEL	HYDHVLIEL
VFEDVPLFL	VFEDVPLFL
ITDTAYRSM	ITDTAYRSM
ILDSHAATL	ILDSHAATL
RMPEKVTWM	RMPEKVTWM
KFDFPVSYL	KFDFPVSYL
FTEDQTAEF	FTEDQTAEF
YFDEILNKL	YFDEILNKL
KTDGSVVKL	KTDGSVVKL
YCDERITEL	YCDERITEL
KYDQLKVYL	KYDQLKVYL
LFDASPTFF	LFDASPTFF
IFHHFAPLL	IFHHFAPLL
YFDEKELEL	YFDEKELEL
AFESEPLFL	AFESEPLFL
IFDWVEANL	IFDWVEANL
IWDVSVNSV	IWDVSVNSV
AYDPTAPTL	AYDPTAPTL
AFDKPKVEL	AFDKPKVEL
HMDPSGTFV	HMDPSGTFV
SFDITGRFL	SFDITGRFL
IVNSVILIL	IVNSVILIL
HLDPGPIYM	HLDPGPIYM
VLDALDSIK	VLDALDSIK
AFDISKKEM	AFDISKKEM
IFDGLLEYL	IFDGLLEYL
FPEHIFPAL	FPEHIFPAL
YLLESVNKL	YLLESVNKL
QYDEAVAQF	QYDEAVAQF
LFDGSPTYV	LFDGSPTYV
SYEYPEYFL	SYEYPEYFL
GFDAVTGEF	GFDAVTGEF
LYDEIKKYV	LYDEIKKYV
NFDTTEEKL	NFDTTEEKL
SFDETCTRF	SFDETCTRF
VYDVVEEKL	VYDVVEEKL
SVDLTEVEV	SVDLTEVEV
NFDDFEEDF	NFDDFEEDF
ALPEIFTEL	ALPEIFTEL
FFDEESYSL	FFDEESYSL
SIPERPAQL	SIPERPAQL
IHDGLTVHL	IHDGLTVHL
LLPDIISRL	LLPDIISRL
ITDPEVVFV	ITDPEVVFV
TRDPLVIEL	TRDPLVIEL
YYDVPIATL	YYDVPIATL
FFDTELENL	FFDTELENL
AFDLIEHYF	AFDLIEHYF
YFPPGIVEV	YFPPGIVEV
KLDVALKEM	KLDVALKEM
VGDGYVVHL	VGDGYVVHL
KWSWYLDYL	KWSWYLDYL
LYDVRTILL	LYDVRTILL
AVDPLLALL	AVDPLLALL
VWDVPVEEF	VWDVPVEEF
LFDEIRMTY	LFDEIRMTY
HFDMNIISM	HFDMNIISM
IFDNSDNRL	IFDNSDNRL
QYDLATKRV	QYDLATKRV
IVDGAVVKF	IVDGAVVKF
YYDPKHVIF	YYDPKHVIF
YFDDLKGEM	YFDDLKGEM
FLDEKSGSF	FLDEKSGSF
NYDNKQVRI	NYDNKQVRI
IYDVQHANL	IYDVQHANL
TMDLAEHHM	TMDLAEHHM
RYDEFLVHM	RYDEFLVHM
MPEKLSHKL	MPEKLSHKL
LYDVTWEEM	LYDVTWEEM
FFDAAKLMF	FFDAAKLMF
TYDLMSSAY	TYDLMSSAY
SFDPLLITL	SFDPLLITL
FYEETKVKF	FYEETKVKF
SYDGRAYVI	SYDGRAYVI
NYDIAIAEL	NYDIAIAEL
IFDLQKTSL	IFDLQKTSL
VFDQYLNFI	VFDQYLNFI
IFDGFIVSL	IFDGFIVSL
RWEEYISKV	RWEEYISKV
LFDATLTQY	LFDATLTQY
SFDVFHRAF	SFDVFHRAF
YYDEKVVKL	YYDEKVVKL
YFPEEIAKL	YFPEEIAKL
TFDLLFVTL	TFDLLFVTL
RTDPVPVTI	RTDPVPVTI
IFDLPRTNI	IFDLPRTNI
SYDTWVSRV	SYDTWVSRV
FVDPAQITM	FVDPAQITM
HFDDFVTNL	HFDDFVTNL
FFDNRPGKL	FFDNRPGKL
NYDNLLSQF	NYDNLLSQF
AFDSSSAVF	AFDSSSAVF
RYDMAQLRF	RYDMAQLRF
AFDLKAAVL	AFDLKAAVL
VFDIGVRVV	VFDIGVRVV
TYDLPGNFL	TYDLPGNFL
SVDVTNTTF	SVDVTNTTF
LFDVLHEPF	LFDVLHEPF
NFDGKFANL	NFDGKFANL
IYDNQGNFM	IYDNQGNFM
YYDMMDLKV	YYDMMDLKV
HFDLASTTI	HFDLASTTI
IADLMEEKF	IADLMEEKF
NTDEPPMVF	NTDEPPMVF
FLPELPADL	FLPELPADL
YFDLAADVL	YFDLAADVL
HFDLSHGSA	HFDLSHGSA
MAPLKMLAL	MAPLKMLAL
IFDSKVTEI	IFDSKVTEI
SAPKYIDYL	SAPKYIDYL
IADGLPVAV	IADGLPVAV
TFDPIHQWL	TFDPIHQWL
WFDNQIHEA	WFDNQIHEA
SWDEPGVDF	SWDEPGVDF
HYDMNTASL	HYDMNTASL
SFDHVPALV	SFDHVPALV
VFEPTIVKV	VFEPTIVKV
SYDHVIYSL	SYDHVIYSL
HFDNLFSKM	HFDNLFSKM
FYDPDTVEL	FYDPDTVEL
YFETEAVEI	YFETEAVEI
YFDESFFHF	YFDESFFHF
AFDVVERSF	AFDVVERSF
QFDNYGEEF	QFDNYGEEF
LYDHTTILF	LYDHTTILF
SFDVVTKCV	SFDVVTKCV
IFDPVKQQF	IFDPVKQQF
FWDKKVTHF	FWDKKVTHF
FFVENVSEL	FFVENVSEL
FYDRTVRVF	FYDRTVRVF
IYDYAIVLF	IYDYAIVLF
QFDDVLIYL	QFDDVLIYL
NFDGSHVYM	NFDGSHVYM
VFDDIETNM	VFDDIETNM
KIEDYFPEF	KIEDYFPEF
LFDIFLETV	LFDIFLETV
FYDGIKAIF	FYDGIKAIF
TFEDFVAII	TFEDFVAII
YYDEIINAL	YYDEIINAL
TFDPSLAYY	TFDPSLAYY
SFDDKILEV	SFDDKILEV
FTDVIGHYI	FTDVIGHYI
ILDSQTVVL	ILDSQTVVL
VFDVSHNAV	VFDVSHNAV
IVDLPVHQL	IVDLPVHQL
LFDLIQSEL	LFDLIQSEL
FPDTGSLNL	FPDTGSLNL
YFPELIANF	YFPELIANF
VFPDKEVML	VFPDKEVML
AWEERETIL	AWEERETIL
MPEKEPSVL	MPEKEPSVL
TFEDVAVTF	TFEDVAVTF
KADLGKIVL	KADLGKIVL
ITDHLIAML	ITDHLIAML
IYDLATQTL	IYDLATQTL
FFDTNTSVL	FFDTNTSVL
TSDGRPAWM	TSDGRPAWM
NFDVTYNWI	NFDVTYNWI
HFDTPVQFL	HFDTPVQFL
IWDMGLELF	IWDMGLELF
SFDVADRMF	SFDVADRMF
FLDEPTNHL	FLDEPTNHL
FYEDNVLYM	FYEDNVLYM
KFDDGAVFL	KFDDGAVFL
TYDVQKLSL	TYDVQKLSL
HFDDIGPSV	HFDDIGPSV
AFGLHLIDF	AFGLHLIDF
ISDEANSNF	ISDEANSNF
RVYEFLDKL	RVYEFLDKL
SFDEINKAF	SFDEINKAF
SFDVTQSPF	SFDVTQSPF
EWDPLDVRF	EWDPLDVRF
AFDLSQVLF	AFDLSQVLF
NYDFGPIHM	NYDFGPIHM
NYDAASGTM	NYDAASGTM
VYDLLKNHL	VYDLLKNHL
LWDEVLSHL	LWDEVLSHL
VFPTTEVLL	VFPTTEVLL
LFDSTLTAF	LFDSTLTAF
FYETLPVAI	FYETLPVAI
FYDKRAASF	FYDKRAASF
LLPSHASYL	LLPSHASYL
SLIEQTTAL	SLIEQTTAL
IFDRAVAAY	IFDRAVAAY
RFDMAVMFM	RFDMAVMFM
EYDPVIILI	EYDPVIILI
TFDFVHNVM	TFDFVHNVM
LFDAETVAL	LFDAETVAL
YFDVSHEHL	YFDVSHEHL
DLQARITSL	DLQARITSL
SYDLFVNSF	SYDLFVNSF
TFDLTVVSY	TFDLTVVSY
VADPYVVIM	VADPYVVIM
FPDEKIPTL	FPDEKIPTL
IAPGVTHEL	IAPGVTHEL
LLDGGVINL	LLDGGVINL
VYDNNSSTL	VYDNNSSTL
TYYLWVKSV	TYYLWVKSV
SFDLGRQFL	SFDLGRQFL
YFLPDTAHF	YFLPDTAHF
WFDKSFTFV	WFDKSFTFV
IYSSLPVEV	IYSSLPVEV
VFDGKPPQL	VFDGKPPQL
AFDPAAAAF	AFDPAAAAF
VFDAFLNMM	VFDAFLNMM
FAPYNKPSL	FAPYNKPSL
NVDDPTGNF	NVDDPTGNF
TWDLTGLLL	TWDLTGLLL
VYDPLFSQL	VYDPLFSQL
YFIKPPVYV	YFIKPPVYV
FLDSEVSEL	FLDSEVSEL
VMDSKIVQV	VMDSKIVQV
YFDLLGELM	YFDLLGELM
HWDWKIALL	HWDWKIALL
AFDEAFAEF	AFDEAFAEF
NYDASAARV	NYDASAARV
IFDSKTVSI	IFDSKTVSI
GFDPVSTVL	GFDPVSTVL
DFDLLNNSL	DFDLLNNSL
YFDDSNVSL	YFDDSNVSL
RWDDSVTYI	RWDDSVTYI
KWDPTGNLL	KWDPTGNLL
KMDKTGASF	KMDKTGASF
PAPPPPPPP	PAPPPPPPP
LFDNLIEFL	LFDNLIEFL
YWDNSIQVM	YWDNSIQVM
IFSPNVVNL	IFSPNVVNL
IFDEMKKKF	IFDEMKKKF
RYDDMAAAM	RYDDMAAAM
AYDSTMETM	AYDSTMETM
FLDGYVSQL	FLDGYVSQL
PLLSASIAL	PLLSASIAL
KFDADPVEL	KFDADPVEL
YYDKHFTEF	YYDKHFTEF
VFDHPWETV	VFDHPWETV
VWDVTMQDL	VWDVTMQDL
VFDWIEANL	VFDWIEANL
VYDIAQVNL	VYDIAQVNL
FFSEREASF	FFSEREASF
IWEPLAVKL	IWEPLAVKL
TFDSDPPLL	TFDSDPPLL
FFEDDVNEF	FFEDDVNEF
YFEAMFRSF	YFEAMFRSF
FLDLARNIF	FLDLARNIF
VLPEHVSVL	VLPEHVSVL
SYDESKVEF	SYDESKVEF
YYEERTCIL	YYEERTCIL
SFDLAKVLL	SFDLAKVLL
FFEEHISSV	FFEEHISSV
NYDEFPTMV	NYDEFPTMV
REDLVGPEV	REDLVGPEV
TWDPALAQI	TWDPALAQI
HFDLNLRQF	HFDLNLRQF
VFDPVPVGV	VFDPVPVGV
YFDAIPVTM	YFDAIPVTM
TFEKTPVEV	TFEKTPVEV
KMDFTAARL	KMDFTAARL
LEADRMAAL	LEADRMAAL
FLDSQTATF	FLDSQTATF
HYDLFIERF	HYDLFIERF
IYELMQTEF	IYELMQTEF
AYDEALAEL	AYDEALAEL
TFVSPEVFL	TFVSPEVFL
VVPEPGQPL	VVPEPGQPL
NFDMLYNHV	NFDMLYNHV
HPDAFDNEL	HPDAFDNEL
TVEEVFLNL	TVEEVFLNL
SADPNVVDL	SADPNVVDL
VTDGKEVLL	VTDGKEVLL
YYDLQGHLF	YYDLQGHLF
FYEAAIPEM	FYEAAIPEM
MFDEPSSYL	MFDEPSSYL
VFDDLESKM	VFDDLESKM
HFDQMFQRF	HFDQMFQRF
KWDTANNPL	KWDTANNPL
IVDEAIYYF	IVDEAIYYF
VYDFVGLLV	VYDFVGLLV
LYDPVISKL	LYDPVISKL
KYDPSYIEF	KYDPSYIEF
AFDLTKTNM	AFDLTKTNM
YLDLILNDF	YLDLILNDF
LYDGTYITL	LYDGTYITL
LLDLALEGM	LLDLALEGM
NFDEALVDY	NFDEALVDY
LFDHAVSKF	LFDHAVSKF
EFDIFTRLF	EFDIFTRLF
HFDTPPHLF	HFDTPPHLF
LYQIYIDEL	LYQIYIDEL
IRDSENGAF	IRDSENGAF
AFDPTSTLL	AFDPTSTLL
KFWDYLHEI	KFWDYLHEI
NYDYLKGFL	NYDYLKGFL
IWDPVLSVM	IWDPVLSVM
SPDEHEPLL	SPDEHEPLL
TYDEVKARL	TYDEVKARL
SYEDRVTFL	SYEDRVTFL
IFDMHSPYF	IFDMHSPYF
MMDVSGVGF	MMDVSGVGF
LFDPINLVF	LFDPINLVF
WWEDMVAEF	WWEDMVAEF
HFWTWINHL	HFWTWINHL
GFDLSEEKF	GFDLSEEKF
VFDPKVFTF	VFDPKVFTF
TFDISILEI	TFDISILEI
LFDPMTGTF	LFDPMTGTF
VYDLLKTNL	VYDLLKTNL
FFDGELTKV	FFDGELTKV
VADPIIYVL	VADPIIYVL
VFDEAIIAI	VFDEAIIAI
YFDTVPVAA	YFDTVPVAA
LYDVVDVKY	LYDVVDVKY
HLDLIEAKF	HLDLIEAKF
IFDQLLEFV	IFDQLLEFV
FFEPWVYSF	FFEPWVYSF
LFDYTDTFL	LFDYTDTFL
IFDEFRTVL	IFDEFRTVL
QFDTDAVRL	QFDTDAVRL
AYDYNKAQV	AYDYNKAQV
HYDIPKISM	HYDIPKISM
YYDIHRSYL	YYDIHRSYL
YFEDKLTEI	YFEDKLTEI
MWDQRLVKL	MWDQRLVKL
SYDDQLAQI	SYDDQLAQI
VFEDVAVYF	VFEDVAVYF
LYDLVTEKM	LYDLVTEKM
IADLGLIRV	IADLGLIRV
TYDYGGFTM	TYDYGGFTM
IYDDGITSL	IYDDGITSL
MPEPDAQRF	MPEPDAQRF
VWDIVGTEL	VWDIVGTEL
FPDAREQEI	FPDAREQEI
LLDPLMPEL	LLDPLMPEL
LYDVLGIEL	LYDVLGIEL
MMDFFNAQM	MMDFFNAQM
VFDFAGEEV	VFDFAGEEV
FPEALARLL	FPEALARLL
VFSTVVIHF	VFSTVVIHF
YMDLASRLV	YMDLASRLV
VFDLTKEIF	VFDLTKEIF
IYDLVDRHL	IYDLVDRHL
IFDLGGGTF	IFDLGGGTF
LPEKKGNTL	LPEKKGNTL
EPDPEEWQL	EPDPEEWQL
TFDIGYGSF	TFDIGYGSF
LYDIVFKHF	LYDIVFKHF
FYPEEVSSM	FYPEEVSSM
AFEDVAVNF	AFEDVAVNF
YFESVRTFV	YFESVRTFV
TFDVSILTI	TFDVSILTI
KFDTEIQAF	KFDTEIQAF
FYDGYRHEM	FYDGYRHEM
YLDEYIARM	YLDEYIARM
NFDALISKI	NFDALISKI
IPDGHTKEM	IPDGHTKEM
YPEKIQASL	YPEKIQASL
FPEKSLLLL	FPEKSLLLL
AFDEAIAEL	AFDEAIAEL
HWDPQEVTL	HWDPQEVTL
VADLQLIDF	VADLQLIDF
MYDSFWRQF	MYDSFWRQF
VYDPTTNAW	VYDPTTNAW
MFDLAVDAL	MFDLAVDAL
YLDALDLLI	YLDALDLLI
LFDDSEVKV	LFDDSEVKV
FLDENVHFF	FLDENVHFF
AFDEKLFTF	AFDEKLFTF
NMDMSLHSM	NMDMSLHSM
KFDVQWIFV	KFDVQWIFV
YFDLNSEQM	YFDLNSEQM
TFDAGLQAF	TFDAGLQAF
IFDNTFSRF	IFDNTFSRF
FFDGLQVIF	FFDGLQVIF
EWDVLIAHF	EWDVLIAHF
LWDQSILGF	LWDQSILGF
LPDERTISL	LPDERTISL
IWDYHVVLL	IWDYHVVLL
FPEYELPEL	FPEYELPEL
SWPTKIIYL	SWPTKIIYL
SFDYSNTVM	SFDYSNTVM
LNDPNPIWL	LNDPNPIWL
FMDKKTVVL	FMDKKTVVL
AFDYAYVVL	AFDYAYVVL
VLDDKLVFV	VLDDKLVFV
FYDTKVTVM	FYDTKVTVM
TFDPQRQTV	TFDPQRQTV
RFDDGLVHL	RFDDGLVHL
NYDRGYSSL	NYDRGYSSL
YYEEQHPEL	YYEEQHPEL
VADLAESIM	VADLAESIM
IFDNAMAGV	IFDNAMAGV
FFDIPVDNL	FFDIPVDNL
DRYDSFIEL	DRYDSFIEL
MLPSEPVLL	MLPSEPVLL
NYDDIRTEL	NYDDIRTEL
SWDPVGTSL	SWDPVGTSL
HYDPMIAKL	HYDPMIAKL
VYDDAHNML	VYDDAHNML
VFMDKPEEF	VFMDKPEEF
RTDPIPIVV	RTDPIPIVV
SYDSKLVWF	SYDSKLVWF
NFDEFSKHL	NFDEFSKHL
LFSSPPVIL	LFSSPPVIL
ITDPDVVHI	ITDPDVVHI
TWDKIAVSL	TWDKIAVSL
KFDDSLVHI	KFDDSLVHI
TFDLLRNSY	TFDLLRNSY
ILPEYADIF	ILPEYADIF
KTDVVVNSV	KTDVVVNSV
HYDEQQNFF	HYDEQQNFF
SFDSVPVSL	SFDSVPVSL
RFDEAYIYM	RFDEAYIYM
HYDVQSILF	HYDVQSILF
FTDFDPHHF	FTDFDPHHF
KFDHADRTF	KFDHADRTF
FPEEVIATI	FPEEVIATI
KFDIYTIAF	KFDIYTIAF
LPDPQNISL	LPDPQNISL
QWDLVENYL	QWDLVENYL
RFWTWINHF	RFWTWINHF
SFDPKDIFL	SFDPKDIFL
FYDVQFKEL	FYDVQFKEL
SQPLGPRII	SQPLGPRII
GFDHHVVRV	GFDHHVVRV
FYDQRQVLL	FYDQRQVLL
YYEEFPINL	YYEEFPINL
IMDSTEAQL	IMDSTEAQL
AFEQLVVEL	AFEQLVVEL
RFWYFVSQL	RFWYFVSQL
VFDNYAVTV	VFDNYAVTV
IFDPNILTI	IFDPNILTI
SYDFFSGEF	SYDFFSGEF
AFDDVVKYF	AFDDVVKYF
AWDEVGDEF	AWDEVGDEF
YFPKKISEL	YFPKKISEL
LMDGRDAFL	LMDGRDAFL
TYDPETQEF	TYDPETQEF
YFAERVTSL	YFAERVTSL
AAPIRLLAA	AAPIRLLAA
SYDPLRIYL	SYDPLRIYL
LFDLTPAKV	LFDLTPAKV
NFDEENAYF	NFDEENAYF
KIVKWDRDM	KIVKWDRDM
HPETRSAFL	HPETRSAFL
FFEVSPVSF	FFEVSPVSF
SWDSRDVVL	SWDSRDVVL
SVPEAQSAL	SVPEAQSAL
DGTIRIWDL	DGTIRIWDL
SFDEVEGVF	SFDEVEGVF
TMDIHLNEM	TMDIHLNEM
VYDPQQKTL	VYDPQQKTL
KYDLAIKDL	KYDLAIKDL
QIPEIKQTL	QIPEIKQTL
NFDLTKNYL	NFDLTKNYL
LFDLPPALL	LFDLPPALL
TAMDVVYAL	TAMDVVYAL
TYDDFRNVL	TYDDFRNVL
TFDASRTTF	TFDASRTTF
FLPEAPAEL	FLPEAPAEL
AYDTTTATV	AYDTTTATV
MPEPASRCL	MPEPASRCL
FPESQTKEL	FPESQTKEL
SFDKTASVF	SFDKTASVF
AFDDAIAEL	AFDDAIAEL
NFDVLMVKL	NFDVLMVKL
VADPVEAVL	VADPVEAVL
NADAIVVKL	NADAIVVKL
FWDGKIVLV	FWDGKIVLV
YYPAFLDMV	YYPAFLDMV
FSDENVPRL	FSDENVPRL
SFDTGFTSF	SFDTGFTSF
LPDGSRVEL	LPDGSRVEL
SDGLRLIAL	SDGLRLIAL
VFDPVQKTL	VFDPVQKTL
AYDKAVASF	AYDKAVASF
FHDATRVYL	FHDATRVYL
YYDPHQATF	YYDPHQATF
AMPGVPAFL	AMPGVPAFL
QFHMQLNEM	QFHMQLNEM
AFDASRTSF	AFDASRTSF
ILDVASLEV	ILDVASLEV
TTDDHCQEF	TTDDHCQEF
ALSNLEVKL	ALSNLEVKL
YIDDLVVIL	YIDDLVVIL
YWEPAEVFL	YWEPAEVFL
NYDHSLVKV	NYDHSLVKV
QFDGTNSAF	QFDGTNSAF
AWWEWDTKF	AWWEWDTKF
IFDENELEL	IFDENELEL
TFDNIYLHV	TFDNIYLHV
HPDQAQAIL	HPDQAQAIL
YYELAQVLL	YYELAQVLL
MWDETELGL	MWDETELGL
TIPITPAFL	TIPITPAFL
LLDLQSALF	LLDLQSALF
TFDPMTRQI	TFDPMTRQI
VTDVGQILL	VTDVGQILL
FLPPFPAHL	FLPPFPAHL
LFPGQVVIM	LFPGQVVIM
KFPVKPADL	KFPVKPADL
RFEEETVLL	RFEEETVLL
HPDEPLYSF	HPDEPLYSF
RYDEIKEEF	RYDEIKEEF
SVDGIPARL	SVDGIPARL
KFWQFLETV	KFWQFLETV
TFDRSVTLL	TFDRSVTLL
YFDPTIVSV	YFDPTIVSV
VFDEAIRAV	VFDEAIRAV
SFDSGIAGL	SFDSGIAGL
EFDPLLREI	EFDPLLREI
LLDPKLCYL	LLDPKLCYL
GFDTRVTVL	GFDTRVTVL
MTDPEMVEV	MTDPEMVEV
FFSEKIYKL	FFSEKIYKL
FIDEAGHCM	FIDEAGHCM
MLDPLEVHL	MLDPLEVHL
IFDAVLKGV	IFDAVLKGV
QWDPMITTL	QWDPMITTL
LFDANRAEL	LFDANRAEL
IYDNAVQGL	IYDNAVQGL
TADPSHQTM	TADPSHQTM
YYDPDYSFL	YYDPDYSFL
VWDESASFL	VWDESASFL
FADPIAANL	FADPIAANL
SADFPALVV	SADFPALVV
SQDARFYAL	SQDARFYAL
LAPTDVKEL	LAPTDVKEL
VFDTAKEDV	VFDTAKEDV
FYPPDPAQL	FYPPDPAQL
FTDEESYSF	FTDEESYSF
STDNGRIFL	STDNGRIFL
YYEHEFVEL	YYEHEFVEL
LSDEHAREM	LSDEHAREM
MVDGKPVNL	MVDGKPVNL
MPETYQARL	MPETYQARL
QTDHTPVHL	QTDHTPVHL
EFDNAGGMM	EFDNAGGMM
FFEVFDNSM	FFEVFDNSM
NFDKIRVWL	NFDKIRVWL
ITSMLNPLI	ITSMLNPLI
IYDHNPKVF	IYDHNPKVF
GYDTRVTVL	GYDTRVTVL
FYEVVDARL	FYEVVDARL
TYDPWIGKL	TYDPWIGKL
FPDREENAV	FPDREENAV
LYDLAAVVV	LYDLAAVVV
SYMPVIDVF	SYMPVIDVF
MWDPAAQAF	MWDPAAQAF
SIPGGYNAL	SIPGGYNAL
VFDEADRLF	VFDEADRLF
FFDDLGDEL	FFDDLGDEL
IFDGNVAHI	IFDGNVAHI
SMETKVQFL	SMETKVQFL
SLPDIPAHL	SLPDIPAHL
SWDIVVQRV	SWDIVVQRV
FFIPDIEYL	FFIPDIEYL
NYFLWTEKF	NYFLWTEKF
HWDVTEAVF	HWDVTEAVF
FYEEKEVDL	FYEEKEVDL
IYDLFQKSF	IYDLFQKSF
LFDEEMEQM	LFDEEMEQM
LFDAISIAV	LFDAISIAV
FYEETTQEL	FYEETTQEL
TFDVAPSRL	TFDVAPSRL
VSPVVRVAV	VSPVVRVAV
LYDEYMYYL	LYDEYMYYL
KYFLWEEKF	KYFLWEEKF
DAALRKITF	DAALRKITF
GFDFSGAEI	GFDFSGAEI
YFDPANGKF	YFDPANGKF
FADGAPHYV	FADGAPHYV
VFDNLIISL	VFDNLIISL
VLDQVEARL	VLDQVEARL
AFEDVAVYF	AFEDVAVYF
SWEARTTNL	SWEARTTNL
KYDEVLHMV	KYDEVLHMV
RFDVSLVYL	RFDVSLVYL
FFDHSGTLV	FFDHSGTLV
KFDDKFAYL	KFDDKFAYL
YFDNILNSF	YFDNILNSF
SFDFHGRRM	SFDFHGRRM
EPAIFNLSI	EPAIFNLSI
TWDYVAPFL	TWDYVAPFL
EFDLLDVRF	EFDLLDVRF
SYDDPATKM	SYDDPATKM
VFPNNVVFV	VFPNNVVFV
TYDIGHVLL	TYDIGHVLL
RYDDMAACM	RYDDMAACM
DFDLIEENL	DFDLIEENL
VMDVVVKSV	VMDVVVKSV
FYDNGKVVI	FYDNGKVVI
LLDEVLNVM	LLDEVLNVM
VFQPSLAVF	VFQPSLAVF
QFDNFKRVF	QFDNFKRVF
VLDLMKVDM	VLDLMKVDM
NFDRFSEMM	NFDRFSEMM
LTRSPFEII	LTRSPFEII
FFEEVFTEM	FFEEVFTEM
KDDIATIET	KDDIATIET
IFDSTAVLL	IFDSTAVLL
TFDFQNDFL	TFDFQNDFL
VFDKTYQFL	VFDKTYQFL
TLEMNLNSF	TLEMNLNSF
FWEPNIAIV	FWEPNIAIV
SIDSEPALV	SIDSEPALV
VVDGNVARV	VVDGNVARV
FFDHASAAL	FFDHASAAL
FWADKVASL	FWADKVASL
VFDDTITEM	VFDDTITEM
FFDDLLVVL	FFDDLLVVL
SYNLFSREF	SYNLFSREF
IWEEWPLLI	IWEEWPLLI
QFDFVVRMM	QFDFVVRMM
AFDIAEELV	AFDIAEELV
IVDGRVYYI	IVDGRVYYI
LWDFQGSTM	LWDFQGSTM
VIPTNVPEL	VIPTNVPEL
LWDTSPSYI	LWDTSPSYI
VVDKPPSTM	VVDKPPSTM
FYDSTAGKF	FYDSTAGKF
LYDEAIRHF	LYDEAIRHF
SFDDTNEKF	SFDDTNEKF
VYDQVVEDL	VYDQVVEDL
IFTPIVEHL	IFTPIVEHL
VFEHDSVEL	VFEHDSVEL
FLDPTLSLF	FLDPTLSLF
TFDLQRIGF	TFDLQRIGF
VFEPSWAEF	VFEPSWAEF
MPETTETVL	MPETTETVL
RFDGRVVLV	RFDGRVVLV
SALPLLSAL	SALPLLSAL
AYDEATDEF	AYDEATDEF
SYDWFPAEL	SYDWFPAEL
IYDSVKVYF	IYDSVKVYF
LLPEEQVYL	LLPEEQVYL
EFDKLVALL	EFDKLVALL
IFPEPVAFL	IFPEPVAFL
TWDRTPVSM	TWDRTPVSM
FFDPDTNIV	FFDPDTNIV
WFDAEITTL	WFDAEITTL
DYDPLVVKL	DYDPLVVKL
YFWEYSEQL	YFWEYSEQL
YYDYEIERF	YYDYEIERF
RFDKEVALF	RFDKEVALF
LRDLLVQTL	LRDLLVQTL
FFDPHQSTF	FFDPHQSTF
TPEQQAAIL	TPEQQAAIL
YFDAVIPKM	YFDAVIPKM
KTDIIDHSF	KTDIIDHSF
RYDNVTILF	RYDNVTILF
QFDPQPLAM	QFDPQPLAM
FMDDKRVYI	FMDDKRVYI
TFDPVTKVL	TFDPVTKVL
NRFPAVNSL	NRFPAVNSL
SVPVSLQTL	SVPVSLQTL
SMDEALEKF	SMDEALEKF
FFDDLSDSF	FFDDLSDSF
LWDLQDRVL	LWDLQDRVL
AYDPQTNEW	AYDPQTNEW
FPEQIAEKL	FPEQIAEKL
HFDYQSLLM	HFDYQSLLM
HFSELLDEF	HFSELLDEF
FFNYTVRTL	FFNYTVRTL
LFDVSIMAV	LFDVSIMAV
KADSVVVLL	KADSVVVLL
IFDIPGRLY	IFDIPGRLY
EVSPEVVEI	EVSPEVVEI
IYDKTSVLF	IYDKTSVLF
RYDGQIAVF	RYDGQIAVF
LSFDPLLIT	LSFDPLLIT
HFDADGNYF	HFDADGNYF
VFPKEPVEL	VFPKEPVEL
ITDPSVIVM	ITDPSVIVM
YLDRIGQLF	YLDRIGQLF
AFDASGTKL	AFDASGTKL
VWDHGGRIF	VWDHGGRIF
AFDITYVRL	AFDITYVRL
FFDPSLLHL	FFDPSLLHL
IFDIATGKL	IFDIATGKL
FPDEKEDNL	FPDEKEDNL
KSDERPVHI	KSDERPVHI
MPEPTVLSL	MPEPTVLSL
YVPDSPALL	YVPDSPALL
VFEDVAIHF	VFEDVAIHF
VADDTPVLL	VADDTPVLL
KYDENMVLV	KYDENMVLV
NFEPHESFF	NFEPHESFF
SFDEGKTTM	SFDEGKTTM
RQDPFTVHM	RQDPFTVHM
YFEELITML	YFEELITML
IFAPYVDIF	IFAPYVDIF
EFDEVSRIV	EFDEVSRIV
YLPDFLDYF	YLPDFLDYF
HFDEVHRGL	HFDEVHRGL
AFDRKVQFL	AFDRKVQFL
FLDALIVSM	FLDALIVSM
IFEVADTHL	IFEVADTHL
TFEDVAVHF	TFEDVAVHF
KFDAEFRRF	KFDAEFRRF
FFDSIEKGF	FFDSIEKGF
YFDQVLVNI	YFDQVLVNI
IFDNWIPLL	IFDNWIPLL
SYDEAILHL	SYDEAILHL
SFDSALQSV	SFDSALQSV
AFDFQDVTL	AFDFQDVTL
MWPLVAALL	MWPLVAALL
AYDEHQTLL	AYDEHQTLL
NFDAHHTAM	NFDAHHTAM
KFDQVTVFL	KFDQVTVFL
VFDPDSTQV	VFDPDSTQV
IFDIIDREA	IFDIIDREA
YFDKELIQL	YFDKELIQL
IFDVLPNFF	IFDVLPNFF
KFDVSPVKI	KFDVSPVKI
MYDKDIIML	MYDKDIIML
YLDNGVVFV	YLDNGVVFV
FFHLVNSEM	FFHLVNSEM
VFDTPEEAF	VFDTPEEAF
VWDYAGDNY	VWDYAGDNY
LWDPVIELI	LWDPVIELI
VAPVTHVSV	VAPVTHVSV
FYNTSIEEM	FYNTSIEEM
IYDIMNELM	IYDIMNELM
KLPGNISSL	KLPGNISSL
FFGTHETAF	FFGTHETAF
FLDFAPHYF	FLDFAPHYF
VFDEAILAA	VFDEAILAA
DFDGQVVQV	DFDGQVVQV
LFDHVTVRI	LFDHVTVRI
IFPNQTEEL	IFPNQTEEL
YHDKNIVLL	YHDKNIVLL
SFDPNLSEL	SFDPNLSEL
VNDFRSVSL	VNDFRSVSL
SFDLLVKNL	SFDLLVKNL
HWFVWVTQM	HWFVWVTQM
HFITPVSTL	HFITPVSTL
IYDFTDTVI	IYDFTDTVI
LLPERPSYL	LLPERPSYL
IYDMIGQAI	IYDMIGQAI
HFEELETIM	HFEELETIM
FFDEGTINF	FFDEGTINF
HTDLPVSVF	HTDLPVSVF
DGSIRIFSL	DGSIRIFSL
VFDFMETDL	VFDFMETDL
YLPDGTASL	YLPDGTASL
HPEKLATVL	HPEKLATVL
IFDLQNKVL	IFDLQNKVL
KWPETPLLL	KWPETPLLL
KYEDGIALL	KYEDGIALL
YVQDYEDFM	YVQDYEDFM
SWEDAAILL	SWEDAAILL
FYDRRRIYL	FYDRRRIYL
FLPDHPIVL	FLPDHPIVL
TPEEGAQAL	TPEEGAQAL
TFPQNPVEL	TFPQNPVEL
AFDLTEQRY	AFDLTEQRY
FFDFSTKEF	FFDFSTKEF
LPDIVSKVL	LPDIVSKVL
FFYTHLINF	FFYTHLINF
LYDLLVNEI	LYDLLVNEI
IFDKIHSLL	IFDKIHSLL
SVPLAATSM	SVPLAATSM
PIRLLAAAA	PIRLLAAAA
TYDTAGLTM	TYDTAGLTM
STDSRPVSV	STDSRPVSV
NFEDFLTIM	NFEDFLTIM
FYDERIVVV	FYDERIVVV
VLDEQLNEF	VLDEQLNEF
LYDLSKVVL	LYDLSKVVL
TTDDKAVVL	TTDDKAVVL
KFWDYLQEF	KFWDYLQEF
QFPTPEAVL	QFPTPEAVL
AWDKEPVLV	AWDKEPVLV
SFPSEPVKL	SFPSEPVKL
RWEEHRSLL	RWEEHRSLL
LYDQQEQHM	LYDQQEQHM
AYDFLYNYL	AYDFLYNYL
SFDLVAQMI	SFDLVAQMI
RWEDTPLVI	RWEDTPLVI
VFEDLSVTL	VFEDLSVTL
LLDPVPPVL	LLDPVPPVL
HYDETYREV	HYDETYREV
TFEDVAVHL	TFEDVAVHL
VLDVVERSL	VLDVVERSL
LFDDIDHNM	LFDDIDHNM
RWEDKESKI	RWEDKESKI
IYDALDVSL	IYDALDVSL
SWDLPGSHV	SWDLPGSHV
IWPLHPSLL	IWPLHPSLL
VYDVVELKF	VYDVVELKF
DWDLMERFM	DWDLMERFM
NFDMTSKFL	NFDMTSKFL
IFSPSVEDF	IFSPSVEDF
VADGYPVRL	VADGYPVRL
LFDMFPNQF	LFDMFPNQF
IFDSIIVTL	IFDSIIVTL
YWDWSDSEF	YWDWSDSEF
LGASRTLSL	LGASRTLSL
YLDVAEAFL	YLDVAEAFL
AWDYVQAQV	AWDYVQAQV
SFDLLPREF	SFDLLPREF
YFPDKVALL	YFPDKVALL
RYPDRITLI	RYPDRITLI
SYDDVQQSF	SYDDVQQSF
AFDTSSADV	AFDTSSADV
TYDDIENKV	TYDDIENKV
LFDAFHAGF	LFDAFHAGF
TFDDLLNRL	TFDDLLNRL
SYDTHWITM	SYDTHWITM
FLDLSENLI	FLDLSENLI
AFDLYEQRY	AFDLYEQRY
RIIEETLAL	RIIEETLAL
KVDFTEYLL	KVDFTEYLL
LMDREVALL	LMDREVALL
IFDPSPEDI	IFDPSPEDI
SLDGRPPSL	SLDGRPPSL
FFNQHIITF	FFNQHIITF
TYDDGATKL	TYDDGATKL
LLDPPLIAL	LLDPPLIAL
IYDEVVKLL	IYDEVVKLL
ILDDTVQRF	ILDDTVQRF
LFEEVISKM	LFEEVISKM
LFEEAFAIF	LFEEAFAIF
NAPLVHATL	NAPLVHATL
GWDVAELQL	GWDVAELQL
YPENGVVQM	YPENGVVQM
VFDREIAQM	VFDREIAQM
RFDLLKRIL	RFDLLKRIL
FPDLFSEQL	FPDLFSEQL
VMAPRTLIL	VMAPRTLIL
VYDEPGHAV	VYDEPGHAV
YFDQHFGPF	YFDQHFGPF
LFDVQILNY	LFDVQILNY
LFDLALRGL	LFDLALRGL
TYDAHHSAF	TYDAHHSAF
HWDGNMSLV	HWDGNMSLV
FFDQKPEEL	FFDQKPEEL
VYDGKIYTL	VYDGKIYTL
AMDLVKNHL	AMDLVKNHL
FFDKKYSNM	FFDKKYSNM
KWDSNICEL	KWDSNICEL
LFDTTNQLF	LFDTTNQLF
EFDEQGREL	EFDEQGREL
VYDPATETW	VYDPATETW
YYEDGNVQL	YYEDGNVQL
FFDDCIEKL	FFDDCIEKL
ALDVMVSTF	ALDVMVSTF
VYDRTTVLI	VYDRTTVLI
RFSDHVALL	RFSDHVALL
KFDALITTF	KFDALITTF
DFDEVQYQM	DFDEVQYQM
SFDEMNAEL	SFDEMNAEL
VFDLGGGTF	VFDLGGGTF
MPDDLLTTL	MPDDLLTTL
QWDLRLTAV	QWDLRLTAV
RWDEAFRKF	RWDEAFRKF
VWDDVGNLI	VWDDVGNLI
SIPILASAL	SIPILASAL
NFDQTLRNV	NFDQTLRNV
VFDNVKDFF	VFDNVKDFF
IFDVASIIL	IFDVASIIL
SRELDALLI	SRELDALLI
HFNPTGSAF	HFNPTGSAF
HMDTFIETF	HMDTFIETF
EFDKNIALL	EFDKNIALL
LYDELRNLL	LYDELRNLL
FMDFQMQRM	FMDFQMQRM
TADGAHFEL	TADGAHFEL
LWDNAFSEM	LWDNAFSEM
KFPSPPAFI	KFPSPPAFI
YFELVQHEY	YFELVQHEY
HPESVSQSL	HPESVSQSL
GYDTRVTIL	GYDTRVTIL
HFDLLHEDV	HFDLLHEDV
YFISHVLAF	YFISHVLAF
TFPNNPVEL	TFPNNPVEL
YIDLPPPRL	YIDLPPPRL
TFEDVAVLL	TFEDVAVLL
KFDNKTVSF	KFDNKTVSF
VFDTYMLFF	VFDTYMLFF
IFDDPLNAF	IFDDPLNAF
AVDAVIAEL	AVDAVIAEL
AFDPELRIM	AFDPELRIM
GFDRNAVIV	GFDRNAVIV
SFDTMQQEL	SFDTMQQEL
MFDQQEIQV	MFDQQEIQV
YFDVGLHNF	YFDVGLHNF
EYDTVTREV	EYDTVTREV
HADHSSLTL	HADHSSLTL
VADLVGFLL	VADLVGFLL
VLVLDTDYK	VLVLDTDYK
AFDVHLNAF	AFDVHLNAF
FYDDTYNTL	FYDDTYNTL
FFDSAYQGF	FFDSAYQGF
VFDPIGHFT	VFDPIGHFT
IWDLASGKL	IWDLASGKL
YFDKMSNEM	YFDKMSNEM
MFDIVGTHL	MFDIVGTHL
SYDLAIKAI	SYDLAIKAI
TWDELVEHL	TWDELVEHL
HPDDSVKIL	HPDDSVKIL
VYDPQKATV	VYDPQKATV
IWDLLKNAI	IWDLLKNAI
AFDVAEREF	AFDVAEREF
TFDDVAVHF	TFDDVAVHF
IFENNVVHL	IFENNVVHL
LWDLETQGM	LWDLETQGM
AFDEYGRPF	AFDEYGRPF
AYEPLASFL	AYEPLASFL
LFDLFRGFF	LFDLFRGFF
VSPYTEIHL	VSPYTEIHL
VWPLLPALL	VWPLLPALL
YYDQTGALV	YYDQTGALV
HFDPEVVQI	HFDPEVVQI
YFEGKQVSV	YFEGKQVSV
YYDEIAVPF	YYDEIAVPF
YYDDFLQRL	YYDDFLQRL
SFDNSDLVM	SFDNSDLVM
LEAERFENL	LEAERFENL
NYSDAIVWL	NYSDAIVWL
YYDPMISKL	YYDPMISKL
LFHPSNVEM	LFHPSNVEM
YFFTWDTEY	YFFTWDTEY
RFEDGAVFL	RFEDGAVFL
HFPDMEIFL	HFPDMEIFL
SFDPLASFI	SFDPLASFI
YYDLQEVLL	YYDLQEVLL
VFSEMEANF	VFSEMEANF
FFKELIQEF	FFKELIQEF
FIDENPELF	FIDENPELF
SYDPVTNTW	SYDPVTNTW
NFDMSSLVV	NFDMSSLVV
IYDKCITEL	IYDKCITEL
FFDAIFTQL	FFDAIFTQL
SPEAQPKTL	SPEAQPKTL
IADLVVAVF	IADLVVAVF
LFDDMFEDM	LFDDMFEDM
IFDNKEIKL	IFDNKEIKL
YFEGGVSSV	YFEGGVSSV
GFDPHFSYM	GFDPHFSYM
NYDEMKDFI	NYDEMKDFI
LVTVYAFPF	LVTVYAFPF
YFDLPGALL	YFDLPGALL
HGLIRKYGL	HGLIRKYGL
ILDVIVRSF	ILDVIVRSF
FLYPFPLAL	FLYPFPLAL
LYDGEFREF	LYDGEFREF
EAEKSQLIM	EAEKSQLIM
RFDGTHSNF	RFDGTHSNF
VWDEVSGQW	VWDEVSGQW
KWPDRITLL	KWPDRITLL
YFDALYNIM	YFDALYNIM
YYDYGHGEV	YYDYGHGEV
TPDEIDHVF	TPDEIDHVF
SLDPLPPYI	SLDPLPPYI
IFDEDAGFL	IFDEDAGFL
DFDPALLEF	DFDPALLEF
FLDEYMNEF	FLDEYMNEF
IWEQYTVTL	IWEQYTVTL
HFDVVQLLV	HFDVVQLLV
NFDDYTVNL	NFDDYTVNL
VFEPSWEEF	VFEPSWEEF
SYMEVPTYL	SYMEVPTYL
NRDLATPVM	NRDLATPVM
NWFVWVTQM	NWFVWVTQM
YVDTAVRHV	YVDTAVRHV
HYIYPPAIV	HYIYPPAIV
IWDVTILEY	IWDVTILEY
VWDVIGRSL	VWDVIGRSL
EFDNAGAMM	EFDNAGAMM
VYDVRQAYV	VYDVRQAYV
YFDVEPAQV	YFDVEPAQV
NFDVLDLHF	NFDVLDLHF
YYDPKTCGF	YYDPKTCGF
SIPEKNRPL	SIPEKNRPL
NFDRSSSTF	NFDRSSSTF
HFDGFVVEV	HFDGFVVEV
NYDAALRKI	NYDAALRKI
VFDKTLAEL	VFDKTLAEL
DGSVRIWEL	DGSVRIWEL
FWDDSIVEF	FWDDSIVEF
HWDAAIHGF	HWDAAIHGF
MYDEQVTSL	MYDEQVTSL
SLAVRVNSL	SLAVRVNSL
YFDSGDYNM	YFDSGDYNM
TFDSTIHFY	TFDSTIHFY
IFDVHVHEV	IFDVHVHEV
SFDYQKTGM	SFDYQKTGM
AFDLVNIHL	AFDLVNIHL
LYDLEARGF	LYDLEARGF
ITDVQLAIF	ITDVQLAIF
VFDESLSMF	VFDESLSMF
FYSNKEIFL	FYSNKEIFL
TYETKTALL	TYETKTALL
IWQAYLDYL	IWQAYLDYL
MYPGLPSRL	MYPGLPSRL
TFDSEVELM	TFDSEVELM
SFDYAASIL	SFDYAASIL
LYDICFRTL	LYDICFRTL
EPEPAPNSV	EPEPAPNSV
FYESLPPEM	FYESLPPEM
FTDDSARTF	FTDDSARTF
ISDHYPVEV	ISDHYPVEV
NSDTHSSTF	NSDTHSSTF
APEEHPVLL	APEEHPVLL
AYDNGINLF	AYDNGINLF
SYLLFFPAL	SYLLFFPAL
FHPARPFLL	FHPARPFLL
FYDWDNTEL	FYDWDNTEL
YPEELKPVL	YPEELKPVL
AIEALLHDL	AIEALLHDL
LELFPAPIL	LELFPAPIL
LFDSLSQML	LFDSLSQML
LFDLALQGL	LFDLALQGL
LPDPIIIHL	LPDPIIIHL
NYDEMKDFL	NYDEMKDFL
RFDGVTSML	RFDGVTSML
VLPNDPVFL	VLPNDPVFL
IYEYVESRM	IYEYVESRM
FLDLSIIRF	FLDLSIIRF
SFDAMFREA	SFDAMFREA
SWDEAVQAL	SWDEAVQAL
FWEQKPLLI	FWEQKPLLI
TFDPTNQWL	TFDPTNQWL
YLNQTSRSF	YLNQTSRSF
TAEGHPKSL	TAEGHPKSL
LFDQTRHSL	LFDQTRHSL
AYDASLAML	AYDASLAML
DDTVRYTSL	DDTVRYTSL
AFADSSYLL	AFADSSYLL
SWDGRYALV	SWDGRYALV
MFNDTLELF	MFNDTLELF
FDAVFLDPF	FDAVFLDPF
SYDPQMRAI	SYDPQMRAI
LYDLGISKV	LYDLGISKV
YFPTKPMFV	YFPTKPMFV
AFTSDPALL	AFTSDPALL
ILDRHLAIL	ILDRHLAIL
FMDESTQCF	FMDESTQCF
FYDPRSLDI	FYDPRSLDI
YVDDGLISL	YVDDGLISL
VSDHFPVEF	VSDHFPVEF
SLDDGWIRF	SLDDGWIRF
PFDLQSVIF	PFDLQSVIF
AFELHGVFL	AFELHGVFL
IWDDPDAGF	IWDDPDAGF
KFDSQERMF	KFDSQERMF
LFDLSVLKL	LFDLSVLKL
TFWLLLRQF	TFWLLLRQF
LWDISEVMV	LWDISEVMV
IHDLLTIFV	IHDLLTIFV
KYDPINSML	KYDPINSML
FVDFEGISL	FVDFEGISL
MFDELTATY	MFDELTATY
HYDRSGRSL	HYDRSGRSL
KIDEKTAEL	KIDEKTAEL
ALDANIARL	ALDANIARL
DYDFSYHQM	DYDFSYHQM
ILDVTVVYL	ILDVTVVYL
NYDPLPMWI	NYDPLPMWI
IYDLLDTAM	IYDLLDTAM
IFDEDHDEM	IFDEDHDEM
WFEAQVVRV	WFEAQVVRV
NPEHASVAM	NPEHASVAM
NYDYAVYLL	NYDYAVYLL
YFDGNLEKL	YFDGNLEKL
YFWEALNNF	YFWEALNNF
FFDPAIRVL	FFDPAIRVL
HYDPDYEFL	HYDPDYEFL
TFDFRTGKM	TFDFRTGKM
YYDLVKAFM	YYDLVKAFM
RFDVHDVTL	RFDVHDVTL
HYDGSYSTF	HYDGSYSTF
SAPYGRITL	SAPYGRITL
NYTDNELEK	NYTDNELEK
VMAPRTLLL	VMAPRTLLL
FPELDSPQL	FPELDSPQL
IFDDEPTII	IFDDEPTII
MPDGKIQKL	MPDGKIQKL
VFDAKSTIV	VFDAKSTIV
FYDERGDQF	FYDERGDQF
MVDSKPVNL	MVDSKPVNL
FYNERVVIM	FYNERVVIM
LYDFIHTSF	LYDFIHTSF
AFDSQNNTV	AFDSQNNTV
LYDPCTVMF	LYDPCTVMF
DYDIVILEV	DYDIVILEV
MYEEFLSKV	MYEEFLSKV
FPERKEREM	FPERKEREM
LVDLEPGTM	LVDLEPGTM
MPEDLVEAL	MPEDLVEAL
HWVDLLDRF	HWVDLLDRF
AFSLAEAKF	AFSLAEAKF
LFDVPVLNL	LFDVPVLNL
VFDASSIQY	VFDASSIQY
IYDIVRNSW	IYDIVRNSW
VLMTEDIKL	VLMTEDIKL
RLDVTVQSF	RLDVTVQSF
MFEELSDIF	MFEELSDIF
WYDPNASLL	WYDPNASLL
HWDEVKEEM	HWDEVKEEM
HFPGLASEL	HFPGLASEL
TWDELGEAL	TWDELGEAL
FYERGVAVL	FYERGVAVL
NADPQAVTM	NADPQAVTM
LQGERIVSL	LQGERIVSL
SWENIPVTF	SWENIPVTF
LFPLWPAEM	LFPLWPAEM
FWPLIPQFV	FWPLIPQFV
NAFKEITTM	NAFKEITTM
AYDHSYVEL	AYDHSYVEL
ALDKATVLL	ALDKATVLL
DFDFNFQEF	DFDFNFQEF
EWDQVTVYL	EWDQVTVYL
FYDDETVTV	FYDDETVTV
YYDYISPRF	YYDYISPRF
IWDQDIQFL	IWDQDIQFL
VWTELLDVL	VWTELLDVL
VWPSEPSRV	VWPSEPSRV
RFAARPVLL	RFAARPVLL
LYENLGEYF	LYENLGEYF
QYDSTHGKF	QYDSTHGKF
ISDEGIAYL	ISDEGIAYL
TWDEYNIQM	TWDEYNIQM
NFDRLVSNL	NFDRLVSNL
FYDENDSKL	FYDENDSKL
TFEDVAIYF	TFEDVAIYF
TYDLIANIV	TYDLIANIV
FYDLQEADL	FYDLQEADL
SFDGIYANM	SFDGIYANM
LFDGAEVVL	LFDGAEVVL
IIDQVNPEL	IIDQVNPEL
ILPGFIDFI	ILPGFIDFI
VWDRFLSTM	VWDRFLSTM
QLDPLVVEL	QLDPLVVEL
VYDLGGGTF	VYDLGGGTF
AFDFAAREM	AFDFAAREM
NFPNTPVKM	NFPNTPVKM
NPDEAEKAL	NPDEAEKAL
LYDEFGNYI	LYDEFGNYI
SFDDLSVDF	SFDDLSVDF
YLDSPLVRF	YLDSPLVRF
SFNDTFVHV	SFNDTFVHV
DVQLRLNSI	DVQLRLNSI
IYDPACLTI	IYDPACLTI
LTDPAIVKV	LTDPAIVKV
VFDRMKVAL	VFDRMKVAL
NFDEILRVV	NFDEILRVV
HFDSRSVIF	HFDSRSVIF
NYDNLLEAF	NYDNLLEAF
YPDATPEEL	YPDATPEEL
AFDPVLNRW	AFDPVLNRW
VFFLFDHQM	VFFLFDHQM
AYDVSSFSF	AYDVSSFSF
HYDPAELKL	HYDPAELKL
IYDNQGIEL	IYDNQGIEL
FTEDHYVEF	FTEDHYVEF
TWYLDESTL	TWYLDESTL
VYDSQAEAM	VYDSQAEAM
VFDNTPAAL	VFDNTPAAL
TFDDVAVYF	TFDDVAVYF
HYDRFVIFL	HYDRFVIFL
NLDVHTSVM	NLDVHTSVM
FWPPYVELL	FWPPYVELL
FVDTNLYFL	FVDTNLYFL
SAPVGVTAL	SAPVGVTAL
ATDPFASVF	ATDPFASVF
MTDPIRILV	MTDPIRILV
HYWTWINHF	HYWTWINHF
AFDPSGQRL	AFDPSGQRL
SFDATGSGF	SFDATGSGF
IFEDKTVKL	IFEDKTVKL
RYDLQIRYL	RYDLQIRYL
YFPEFLDML	YFPEFLDML
VFDPVTKLW	VFDPVTKLW
VWDLRNMGY	VWDLRNMGY
NFDMFVSHY	NFDMFVSHY
HFDTEETRV	HFDTEETRV
EFDSTVTHV	EFDSTVTHV
MFSDFLQSF	MFSDFLQSF
NFVEETVYL	NFVEETVYL
QYDMTLTSF	QYDMTLTSF
FYDEIKIEL	FYDEIKIEL
EVDLPISYL	EVDLPISYL
IYDEAISSF	IYDEAISSF
HIDVITAEM	HIDVITAEM
NYDTTESKL	NYDTTESKL
VWDETSNKV	VWDETSNKV
HFDFFSVNF	HFDFFSVNF
SFDTIPTYL	SFDTIPTYL
YFEDVANAM	YFEDVANAM
VWEETIILL	VWEETIILL
ITDKGIIAL	ITDKGIIAL
YFENLLSHF	YFENLLSHF
SYIELPAYL	SYIELPAYL
EGFSLFVKI	EGFSLFVKI
LWPEKTSFL	LWPEKTSFL
IYDEGNFSF	IYDEGNFSF
TFDKSSTTV	TFDKSSTTV
YLDHYPPYL	YLDHYPPYL
NPDEVHAIL	NPDEVHAIL
RYDDMATCM	RYDDMATCM
TWDERFSAL	TWDERFSAL
YVDVAVGAF	YVDVAVGAF
WFDATIGYL	WFDATIGYL
RYDDMASAM	RYDDMASAM
LFDTMQHHL	LFDTMQHHL
LFDLVCHEF	LFDLVCHEF
KAPEPLSSL	KAPEPLSSL
TSEPSRDSF	TSEPSRDSF
DSAFRGVGL	DSAFRGVGL
KTDDPGTHV	KTDDPGTHV
SFEASVALL	SFEASVALL
TLDVGGLVF	TLDVGGLVF
HFNVTNTTF	HFNVTNTTF
SYDSVLALV	SYDSVLALV
VYDDGTNTF	VYDDGTNTF
NQDARILAM	NQDARILAM
VFDERAANF	VFDERAANF
YIPEITSVL	YIPEITSVL
NYDETLSTL	NYDETLSTL
TNTLRILAL	TNTLRILAL
LLPTGLSSL	LLPTGLSSL
IWDRAITTL	IWDRAITTL
KWDALVIKL	KWDALVIKL
SLPNEIAYL	SLPNEIAYL
TYDTSFLDF	TYDTSFLDF
NLDVSDEKM	NLDVSDEKM
IGDEPPKVF	IGDEPPKVF
RYDNTESEF	RYDNTESEF
IFDPTRECM	IFDPTRECM
KTDLAKALM	KTDLAKALM
SFDAVLEAL	SFDAVLEAL
NFDCFGDKL	NFDCFGDKL
SPDSGVYEM	SPDSGVYEM
IYDLHESTY	IYDLHESTY
TFEDVAVLF	TFEDVAVLF
NFPEMATYL	NFPEMATYL
KFDAQGKSF	KFDAQGKSF
KFDETEQAL	KFDETEQAL
TLDEGLIEF	TLDEGLIEF
NIDIDPVYL	NIDIDPVYL
LRPLLAAAA	LRPLLAAAA
LFDAVSSLI	LFDAVSSLI
QFDMTRNLF	QFDMTRNLF
TFDVSLLTI	TFDVSLLTI
NYDPALHPF	NYDPALHPF
FFDHQDQVW	FFDHQDQVW
YFDMGAAVL	YFDMGAAVL
SSDPATRQM	SSDPATRQM
LFPEWPSYL	LFPEWPSYL
HPDKDVRLL	HPDKDVRLL
VVDVPFASF	VVDVPFASF
NYDACLQHL	NYDACLQHL
ILDNPVVQL	ILDNPVVQL
IYDTQTLGV	IYDTQTLGV
RFDPFGPIG	RFDPFGPIG
MFPLVKSAL	MFPLVKSAL
TMDLAGRKV	TMDLAGRKV
ATEEPGESF	ATEEPGESF
SYDEAIANL	SYDEAIANL
VFDKVKVKI	VFDKVKVKI
RFDEARARF	RFDEARARF
RFDESTTGF	RFDESTTGF
EISANFEAL	EISANFEAL
SVDLQTRIM	SVDLQTRIM
DYVDSALLM	DYVDSALLM
HFHPSVALF	HFHPSVALF
FTDNVPALV	FTDNVPALV
YYDKLMPMV	YYDKLMPMV
LFDDCTQQF	LFDDCTQQF
DFDLVDALL	DFDLVDALL
IFDLMDAKA	IFDLMDAKA
HFDFQGCNF	HFDFQGCNF
HFDVQSMLF	HFDVQSMLF
RFDYVPSFL	RFDYVPSFL
NLPIGFLEL	NLPIGFLEL
RFMDLATYI	RFMDLATYI
SFPEHPAFL	SFPEHPAFL
YYTEFPTVL	YYTEFPTVL
AWDLGTNFF	AWDLGTNFF
AFIEPPERM	AFIEPPERM
VYDEGPLYV	VYDEGPLYV
VMAPRTLVL	VMAPRTLVL
