Data	Data aligned
TEQQSGAFDRW	TEQ-QSGAF
EEMEAEHRL	EEMEAEHRL
MEAKVENEY	MEAKVENEY
QEAASLLGKKY	QEAALGKKY
NEVRKVKKY	NEVRKVKKY
EEAEWQTRW	EEAEWQTRW
NELENFTKQF	NELEFTKQF
AEAQQFLRY	AEAQQFLRY
AEASALYGRAL	AEASYGRAL
EELRHIHSRY	EELRIHSRY
EEPEGGFSKW	EEPEGFSKW
AEQQVPLVLW	AEQQVPLVL
HEAEVLKQL	HEAEVLKQL
AEQESGLYRY	AEQEGLYRY
EEASLLHQF	EEASLLHQF
CETQLPVSF	CETQLPVSF
AENGLTVRL	AENGLTVRL
EEGNPLLKHY	EEGNLLKHY
KELFEGVQKW	KELFGVQKW
AEVFPLKVFGY	AEVFPLKVF
KENGGKFSF	KENGGKFSF
GEVNSRPTY	GEVNSRPTY
QEVPQDKDGY	QEVPDKDGY
SELDLAVPF	SELDLAVPF
QEIQQAGERL	QEIQAGERL
SEFALRPTF	SEFALRPTF
AEIDDKLNKI	AEIDKLNKI
AELPGVSRW	AELPGVSRW
AENDPTRQY	AENDPTRQY
GELNGQLKYY	GELNGQLKY
IEHGIVTNW	IEHGIVTNW
EVDLVKGGHW	EVDLKGGHW
QENEEAVKKM	QENEAVKKM
EEQRLVQQAF	EEQRVQQAF
NEVFLAKLI	NEVFLAKLI
AESGSSLRYY	AESGSSLRY
EEVQFLKTL	EEVQFLKTL
TENQRPKTGF	TENQPKTGF
AEIEDIRVL	AEIEDIRVL
DENPQQLKL	DENPQQLKL
QELQEINRVY	QELQINRVY
AEEESKGSATY	EESKGSATY
VEAALDSRKNY	VEAASRKNY
SEAPFLHYL	SEAPFLHYL
AEFVGVSHL	AEFVGVSHL
KEMKTITGKTF	KEMKTGKTF
AETHIVLLF	AETHIVLLF
EEIPKNYSI	EEIPKNYSI
GELLKTVSY	GELLKTVSY
EEIAQLARQY	EEIALARQY
AEAGHLEGHCL	AEAGHLEGH
SEDFSLPAY	SEDFSLPAY
SENNGGEGIHY	SENNGGEGI
KEAKMVKKF	KEAKMVKKF
SEPDFVAKFY	SEPDVAKFY
REGEIAQFL	REGEIAQFL
AELEENQRSY	AELENQRSY
EEEPHLVEQF	EEEPLVEQF
KEIFTTNNGY	KEIFTNNGY
EEVDVKDPNY	EEVDKDPNY
LSEVNIPLS	LSEVNIPLS
AEAFVRAFL	AEAFVRAFL
DEINHVQKTY	DEINVQKTY
SEALALTQTW	SEALLTQTW
AEYGEIKNIHL	AEYGEIKNI
EEEFIERCF	EEEFIERCF
IEALMEKPF	IEALMEKPF
SEFLATKAKQF	SEFLKAKQF
GENPASHSY	GENPASHSY
EENPSLNIQF	EENPLNIQF
AEQRKTVTY	AEQRKTVTY
REIEGSQVTF	REIESQVTF
EELNLKTTW	EELNLKTTW
AESPEYVHMY	AESPYVHMY
EEVTELLARY	EEVTLLARY
QEQEIEQRL	QEQEIEQRL
NEISERVVQHF	NEISVVQHF
EESDIKWASRW	EESDIKWAS
GEEGVSRIY	GEEGVSRIY
EEHPLVFLFL	EEHPLVFLF
SEFEIVKAI	SEFEIVKAI
NEDNGIIKAF	NEDNIIKAF
EEVLIHGVSY	EEVLHGVSY
GKLAQLKL	GKL-AQLKL
EEFFGDLNNF	EEFFDLNNF
EETVVPKTF	EETVVPKTF
NEVDPGDWQKF	NEVDDWQKF
KESYELRYF	KESYELRYF
HEGPVWQVAW	HEGPWQVAW
AESHIILVL	AESHIILVL
EEVKEEVKKF	EEVKEVKKF
TENDIANFF	TENDIANFF
EESLRVLAF	EESLRVLAF
AESGDSVKMY	AESGSVKMY
GEWIRQNGGW	GEWIQNGGW
QEFDSGLLHW	QEFDGLLHW
AEDLNSRVSYW	AEDLSRVSY
EEFPAEDW	EEF-PAEDW
RENTVGLHRF	RENTGLHRF
AEGSMPGNRLY	AEGSPGNRL
EETLLDQSF	EETLLDQSF
QEDLRTFSW	QEDLRTFSW
MEPSTAARAW	MEPSAARAW
EEIAFLKKL	EEIAFLKKL
HEIESAGQTW	HEIEAGQTW
AEAFLEHLW	AEAFLEHLW
EEFEKLYASY	EEFELYASY
AENLFRAFL	AENLFRAFL
RENLPLIVW	RENLPLIVW
REHGPLPQKF	REHGLPQKF
QELDGVFQKL	QELDVFQKL
KEIEILRNLY	KEIELRNLY
IEFDIPITY	IEFDIPITY
SEDDPILQI	SEDDPILQI
AEWQLDQPSW	AEWQDQPSW
NEPYIFKVF	NEPYIFKVF
EEVGDFIQRY	EEVGFIQRY
TEINRSFKEY	TEINSFKEY
AEQESARQL	AEQESARQL
DEIDAIGTKRY	DEIDGTKRY
EETSAIRVGF	EETSIRVGF
EEVSPQLFTF	EEVSQLFTF
WEVDVTGKEAW	EVDVGKEAW
QEFEEKSGRTF	QEFESGRTF
SEEAEIIRKY	EEAEIIRKY
AEAPPPQKRYY	AEAPPQKRY
EEPESFFTW	EEPESFFTW
TEIEILKKL	TEIEILKKL
AEIIKEDLW	AEIIKEDLW
AENDEVKFKSY	AENDKFKSY
SENDTYFKKY	SENDYFKKY
AEQDFISKFF	AEQDFISKF
EEEKNFKAF	EEEKNFKAF
QELETSIKKI	QELESIKKI
NEIEDTFRQF	NEIETFRQF
SEFELLRSY	SEFELLRSY
AEGPPRLAI	AEGPPRLAI
SEIKDFANHF	SEIKFANHF
AEIRHVLVTL	AEIRVLVTL
QEVFRFAYY	QEVFRFAYY
AEITDKLGL	AEITDKLGL
AEFLQKLLPGY	AEF-LQKLL
MEEYMNKPTF	EEYMNKPTF
KETLSLTL	KET-LSLTL
QEQLIRSLY	QEQLIRSLY
NEVKVEESSW	NEVKEESSW
EEVSIEVLKTY	EEVSVLKTY
GEPRFISVGY	GEPRISVGY
KEFSAENVTFW	KEFSENVTF
WEVEVGDRTSW	VEVGDRTSW
TEIELAKQI	TEIELAKQI
AEGDLIEHF	AEGDLIEHF
QEWDQPERSF	QEWDPERSF
TENDIYNFF	TENDIYNFF
AEIPADPKLY	AEIPDPKLY
QEVPIIIVF	QEVPIIIVF
SERGSFSLY	SERGSFSLY
AETARLTSF	AETARLTSF
EELPTLLHF	EELPTLLHF
KEFEPLLNW	KEFEPLLNW
AEIWEKLNF	AEIWEKLNF
GEIDQQYSRF	GEIDQYSRF
QELDARHDKY	QELDRHDKY
SEIKISNPTEF	SEIKNPTEF
EEIKTLERY	EEIKTLERY
EEIPKIFQI	EEIPKIFQI
AELIISEVF	AELIISEVF
SEFNFSSKTY	SEFNSSKTY
AESPPRFYF	AESPPRFYF
AEAVVLTLL	AEAVVLTLL
KESDIIYKKI	KESDIYKKI
EEEALAKKF	EEEALAKKF
GEEGSARMW	GEEGSARMW
QEVERILYF	QEVERILYF
KEMESIDQY	KEMESIDQY
QENPFPHSHTF	QENPFPHSH
EEALKQLAEW	EEALQLAEW
GEIDLAKLK	GEIDLAKLK
SEIASQGREL	SEIAQGREL
TEATRILFF	TEATRILFF
QEYEEQFKF	QEYEEQFKF
RELEALKQRF	RELELKQRF
AESDLDYIQY	AESDDYIQY
HEGEILQAF	HEGEILQAF
EEASIDFRF	EEASIDFRF
EELEGQIKKL	EELEQIKKL
HEAITKVKY	HEAITKVKY
NEAVKIIHDF	NEAVIIHDF
EEMEAFPEKF	EEMEFPEKF
TESQVVITL	TESQVVITL
NEDEPIRVSY	NEDEIRVSY
EETTRISY	EET-TRISY
EEVLIPDQKY	EEVLPDQKY
KEMDEEDKAF	KEMDEDKAF
TEYPVQRNY	TEYPVQRNY
AEIVSLRL	AEI-VSLRL
DELPQSVLKW	DELPSVLKW
LEDQQGGREF	LEDQGGREF
KEDEETLARRF	DEETLARRF
SEDHSGSYW	SEDHSGSYW
AEAFLLRLY	AEAFLLRLY
QEVLWPLPAY	QEVLPLPAY
FAPYNKPSL	FAPYNKPSL
AEEKEDGRRW	AEEKDGRRW
SEFKEFSQSF	SEFKFSQSF
DEFHLILEY	DEFHLILEY
EEARGVVENY	EEARVVENY
SEIRSISVNQW	SEIRSVNQW
LEADVNIKL	LEADVNIKL
SEKQFSKRY	SEKQFSKRY
IEDPQIQAHW	IEDPIQAHW
SEAPEAPLL	SEAPEAPLL
AEIEEDKARRI	AEIEKARRI
KEQELTKKL	KEQELTKKL
EEGSNKRLF	EEGSNKRLF
REMENYEKIY	REMEYEKIY
SEIRHTADRW	SEIRTADRW
AENVAKKW	AEN-VAKKW
VEVAEESGRLW	VEVAESGRL
AEIEQKIKEY	AEIEKIKEY
RETDVAKKI	RETDVAKKI
SEFGAPIKF	SEFGAPIKF
QEVNFQEYVTF	QEV-NFQEY
NEIPSLILW	NEIPSLILW
AETITRVLY	AETITRVLY
GENHLTVTW	GENHLTVTW
SEDGTVRIW	SEDGTVRIW
VEVSPATERQW	VEVSTERQW
SELQVLLGY	SELQVLLGY
QELELRSLGY	QELERSLGY
QESNVQLKL	QESNVQLKL
AESGFPVFAW	AESGPVFAW
VEIQFPAEHGW	VEIQAEHGW
EEAYNAVVRY	EEAYAVVRY
AEGGYPLRF	AEGGYPLRF
QEHTQGFIITF	QEHTFIITF
SEEDLKVLF	SEEDLKVLF
EEIGTPRKF	EEIGTPRKF
SEPKILTHY	SEPKILTHY
EEFVIVKALY	EEFVIVKAL
QEDAARLQAAY	QEDALQAAY
QEFNLPVRY	QEFNLPVRY
REIDYKTAF	REIDYKTAF
KENSYVKKF	KENSYVKKF
QEMEGTVKSKY	MEGTVKSKY
EEVFETIIHSY	EEVFIIHSY
EEWGKLIYQW	EEWGLIYQW
TEFYFAQARW	TEFYAQARW
SEHVFQILF	SEHVFQILF
MEVEVDGQKF	MEVEDGQKF
GEKEPDPKTW	GEKEDPKTW
NEDLIKHGW	NEDLIKHGW
TEDEAIHKY	TEDEAIHKY
SEELLSLKY	SEELLSLKY
AEVEENKKM	AEVEENKKM
SEYARPHVM	SEYARPHVM
AELAARKY	AEL-AARKY
EESRLLQLL	EESRLLQLL
VELTNIQKKY	VELTIQKKY
EELTLEGIKQF	EELTGIKQF
HESDINSVRY	HESDNSVRY
SEVLQDLRF	SEVLQDLRF
EEIEILLRY	EEIEILLRY
QELADLFVNY	QELALFVNY
SEFGLKISF	SEFGLKISF
YEVAGHLRTY	YEVAHLRTY
AENVAGHQI	AENVAGHQI
AEDNLIHKF	AEDNLIHKF
SEETVSGLKGY	EETVGLKGY
AEAAASAYY	AEAAASAYY
KEFLDKKKY	KEFLDKKKY
EELGKEIRPTY	EELGIRPTY
NEWARYLYY	NEWARYLYY
TEALHFVAAAW	TEALVAAAW
HEHPDLIVGF	HEHPLIVGF
AEGEVVQVRW	AEGEVQVRW
RETLINKGF	RETLINKGF
QENIDRLVY	QENIDRLVY
TEVKVEPMTY	TEVKEPMTY
CEVEQVKGVTY	VEQVKGVTY
AESLRYKLL	AESLRYKLL
TEHGDLGNSRF	TEHGGNSRF
SEGELVELRW	SEGEVELRW
AEAEQTLRF	AEAEQTLRF
REQEKLNRQY	REQELNRQY
EEFCLPTKKY	EEFCPTKKY
AEFKEAFQLF	AEFKAFQLF
EEEKYAFVNW	EEEKAFVNW
SENDVIRLI	SENDVIRLI
SEASRLAHY	SEASRLAHY
TESQIFISRTY	TESQISRTY
NESGVLLHF	NESGVLLHF
TELDQVRKW	TELDQVRKW
VEVEGDNRY	VEVEGDNRY
VESELLHTY	VESELLHTY
EESPYINGRYY	EESPINGRY
KEQNTQRSF	KEQNTQRSF
QEAQHVLFL	QEAQHVLFL
AEQDLIREL	AEQDLIREL
REFQEGSREY	REFQGSREY
KENSLITQF	KENSLITQF
EESRIQIWF	EESRIQIWF
IETILVQSW	IETILVQSW
NEFSEVAKTL	NEFSVAKTL
AENRQGTLTEY	AENRTLTEY
AEVSLMEVRF	AEVSMEVRF
QENHFVEGLLY	QENHFVEGL
KENPLQFKF	KENPLQFKF
AELEDDFKEGY	LEDDFKEGY
EEAECRDQY	EEAECRDQY
AEIVEGENHTY	AEIVENHTY
GEIDTRFSF	GEIDTRFSF
EEWEAEFQRY	EEWEEFQRY
EEFIKSIFY	EEFIKSIFY
GESGAGKTW	GESGAGKTW
SELTAEKLGF	SELTEKLGF
SEAATAQREEW	SEAATAQRE
NEITIPVTF	NEITIPVTF
SENSAYRW	SEN-SAYRW
AELDPSIAVGF	AELDIAVGF
AEVIAKNNSF	AEVIKNNSF
QEFVKAFYL	QEFVKAFYL
EELTLEGIRQF	EELTGIRQF
AEEKAIVQQW	AEEKIVQQW
EEEGRFLKAY	EEEGFLKAY
EETEFHGLRF	EETEHGLRF
SEQQHSAQAMF	SEQQSAQAM
ESYLLQVL	ESY-LLQVL
SENVVCHFY	SENVVCHFY
EETHTNEFITW	EETHTNEFI
AELTTLLEQW	AELTLLEQW
EETLNILIY	EETLNILIY
GELQLIKIF	GELQLIKIF
AEIQDGRFNLF	AEIQGRFNL
VEHGPLDVW	VEHGPLDVW
EEMGKEIRPTY	EEMGIRPTY
AEPLEIILHL	AEPLIILHL
QEGDIILVL	QEGDIILVL
RELQPSEEVTW	RELQPSEEV
EEICRAIHTF	EEICAIHTF
AEHSTITAW	AEHSTITAW
GEIDLAKLKKF	GEIDKLKKF
SEAQVQKFL	SEAQVQKFL
GENSGIGKLF	GENSIGKLF
SEPDFVAKF	SEPDFVAKF
KEINTQILFW	KEINTQILF
REFKLSKVW	REFKLSKVW
REVDQVKRL	REVDQVKRL
DEIVCTQHW	DEIVCTQHW
EEFYNLVRF	EEFYNLVRF
NEILGSLRW	NEILGSLRW
DEFSEAIKAF	DEFSAIKAF
AEADLRALL	AEADLRALL
EEANVGRGY	EEANVGRGY
EEPDVIFQNF	EEPDIFQNF
EEAQVRKENQW	EEAQVRKEN
SEEEFLRTY	SEEEFLRTY
EENDLGLFGYW	EENDGLFGY
GELALKKKI	GELALKKKI
EESAVPKRSW	EESAPKRSW
VEVQLLESKTY	VEVQESKTY
DEEETYRLW	DEEETYRLW
GEFYCKPHF	GEFYCKPHF
KEYEPEMGKVY	YEPEMGKVY
YEVEIDGKTY	YEVEDGKTY
TEIQLVQSL	TEIQLVQSL
NENLGTVKKEW	NENLVKKEW
EEQVLDVKGY	EEQVDVKGY
QEHIDLGIKY	QEHILGIKY
EEISNMIHSY	EEISMIHSY
SEFDFFERL	SEFDFFERL
TEQPPPRSW	TEQPPPRSW
AEHPNVTLTI	AEHPVTLTI
GEGEATKGY	GEGEATKGY
EELGELLQQF	EELGLLQQF
KEFEDGIINW	KEFEGIINW
KEAEGSSAEY	KEAESSAEY
SEFDSISKNTW	SEFDSISKN
MEQVIFKYL	MEQVIFKYL
AEVGAAGKGY	AEVGAGKGY
EEDKLEQIKKW	EEDKQIKKW
AELAIFRVF	AELAIFRVF
EEVAELFQRL	EEVALFQRL
YEMEVSQRL	YEMEVSQRL
QEGSVTRLW	QEGSVTRLW
EEWLPRELW	EEWLPRELW
SEINERVVQHF	SEINVVQHF
AEVFPLKVF	AEVFPLKVF
GEGKGTKAF	GEGKGTKAF
AEAGVAVFAW	AEAGAVFAW
NENHSGELW	NENHSGELW
KEYEGEAILW	KEYEEAILW
AEGDLVRLL	AEGDLVRLL
QELDLTATHL	QELDTATHL
EEQQEISKKL	EEQQISKKL
QEDRPGLHAY	QEDRGLHAY
AELDPHILAVF	AELDHILAV
VENNLILKM	VENNLILKM
EEHGQGGNYF	EEHGGGNYF
REIQEVQAF	REIQEVQAF
KELDSPFRLY	KELDPFRLY
SEEEEALQKKF	EEEELQKKF
TELGRPDAEYW	TELGPDAEY
QETPLPRSW	QETPLPRSW
EEEEALQKKF	EEEELQKKF
SESHTDLTF	SESHTDLTF
AELAEALRV	AELAEALRV
REVLLLKSL	REVLLLKSL
QELPGLSHQY	QELPLSHQY
AEFKQIRSI	AEFKQIRSI
SEVESILNQSF	VESILNQSF
EEIAIIPSKKL	EEIAPSKKL
SEGKILTTGF	SEGKLTTGF
SEAEQTLRF	SEAEQTLRF
AELPAKILVEF	AELPAKILV
YEFDFSKVYW	YEFDFSKVY
REELQQITW	REELQQITW
AEILKERGAY	AEILERGAY
DEVQVVRGHY	DEVQVRGHY
AESVVLEHRSY	AESVEHRSY
AEEEFVQRF	AEEEFVQRF
TEADYYHTELW	TEADYHTEL
IEFQPPEAKKF	IEFQEAKKF
SEYDQIRYI	SEYDQIRYI
KEGKIEGIVW	KEGKEGIVW
AEEEGVNKF	AEEEGVNKF
GEADVPFYY	GEADVPFYY
EEVTEFLKF	EEVTEFLKF
AEGSVAREEW	AEGSAREEW
AEAFLVHLF	AEAFLVHLF
SESKDRKLY	SESKDRKLY
AEDLNSRVSY	AEDLSRVSY
DEEGRALLHW	EEGRALLHW
AELGGLLKY	AELGGLLKY
EEANLMKTL	EEANLMKTL
EERIPNNTQW	EERINNTQW
VEVPEKEGY	VEVPEKEGY
GEDSSVIHY	GEDSSVIHY
AETDFEKRDF	AETDEKRDF
QEVDASIFKAW	QEVDIFKAW
EEIDEKIGF	EEIDEKIGF
QEFEKHEVHQY	QEFEEVHQY
AERQLQVQW	AERQLQVQW
SEASQGFRF	SEASQGFRF
QELLTVSERW	QELLVSERW
EEDFPSLREY	EEDFSLREY
SEHISSSGKKY	SEHISGKKY
QENEIRGLCL	QENERGLCL
EEFGRFASF	EEFGRFASF
AEGGGAKFKKY	AEGGKFKKY
KEYERFSKY	KEYERFSKY
QEADGQKISW	QEADQKISW
AEALLSDLHAF	AEALDLHAF
QEELALQHF	QEELALQHF
EELYGLALRF	EELYLALRF
EEFPNTCKM	EEFPNTCKM
SEGQEPALRSW	SEGQALRSW
EEQKIVVKVL	EEQKVVKVL
DETEAVKRY	DETEAVKRY
EEPDSASVKTY	EEPDSVKTY
GEWTPTLQHY	GEWTTLQHY
EETHSIFLWY	EETHSIFLW
EEFIGKIGI	EEFIGKIGI
SENEKNAAYY	SENEKNAAY
AENEAETKL	AENEAETKL
TEIEAEKSM	TEIEAEKSM
EENAVDVKQY	EENADVKQY
TEQSQIKGY	TEQSQIKGY
QERGINESY	QERGINESY
EEEAARLF	EEE-AARLF
KEIEANEW	KEI-EANEW
EENTNILKF	EENTNILKF
AEVDKLELMF	AEVDLELMF
SEHLTYLEF	SEHLTYLEF
TEGDSAKTL	TEGDSAKTL
SEIEQNHLHNY	SEIEQNHLH
GEDVETSKKW	GEDVTSKKW
TELELKWQHW	TELEKWQHW
REHDIAIKFF	REHDIAIKF
TEAPVLNIQF	TEAPLNIQF
TEQTAPKIF	TEQTAPKIF
TEMLPSILNQL	EMLPILNQL
QEHRGHHTF	QEHRGHHTF
IEAELNKHW	IEAELNKHW
QEIRLLNV	QEI-RLLNV
AEAPSQVRL	AEAPSQVRL
EELQQKVSY	EELQQKVSY
REDHLFRKF	REDHLFRKF
SEPESIRKW	SEPESIRKW
AENSYVKMT	AENSYVKMT
VETSSLKCF	VETSSLKCF
AEIAAKDKL	AEIAAKDKL
GELKIADFGW	GELKADFGW
AEDPSLERHF	AEDPLERHF
EELQHLLQW	EELQHLLQW
EEIFSLHGF	EEIFSLHGF
SEHAGSSNAF	SEHASSNAF
EENIYKIDF	EENIYKIDF
SENVLQVHL	SENVLQVHL
SEAFVIKGL	SEAFVIKGL
EEVDLSKDIQH	EEVDLSKDI
TEVTGHRW	TEV-TGHRW
AEIKQIVSEY	AEIKIVSEY
REDPDTPMSF	REDPTPMSF
KEIDMLLKEY	KEIDLLKEY
SESLLRGIYAY	SESLLRGIY
REEHIDKVF	REEHIDKVF
SEEDARKNF	SEEDARKNF
IEKETKEYF	IEKETKEYF
GEDTFVHIW	GEDTFVHIW
SEYHPADGYAF	SEYHPADGY
NEQPRQLFW	NEQPRQLFW
EELPHIHAF	EELPHIHAF
EEVGAERAPEY	EEVGRAPEY
TEGVQSLNW	TEGVQSLNW
AEYLILHLI	AEYLILHLI
TEAMRVIGF	TEAMRVIGF
TENTEENRRFY	TENTENRRF
EEIEKENKRF	EEIEENKRF
AEIEIVKEEF	AEIEVKEEF
SEGPITHQW	SEGPITHQW
AEIDARNDSF	AEIDRNDSF
AEGILLPRY	AEGILLPRY
AEHDQLLLNY	AEHDLLLNY
QEIPGEFIY	QEIPGEFIY
RELEKDMHYY	RELEDMHYY
VEEVVNDRSW	EEVVNDRSW
AETDLPVVF	AETDLPVVF
TEETHPVSW	TEETHPVSW
VEQSFFNDW	VEQSFFNDW
RETDLQELF	RETDLQELF
KEIESRVVF	KEIESRVVF
QEREEAQRQY	QEREAQRQY
KELELLRQVY	KELELRQVY
GEVLRTNQF	GEVLRTNQF
EEVTKKHQY	EEVTKKHQY
KELPSGKKY	KELPSGKKY
AEIEKKKEM	AEIEKKKEM
HEIAPGIIRKY	EIAPIIRKY
AEFKEAFSLF	AEFKAFSLF
TEADAQQAYKY	TEADAQQAY
SEEELKKAY	SEEELKKAY
SEIREELEQY	SEIRELEQY
EEAEVINQKL	EEAEINQKL
DEIDAIATKRF	DEIDATKRF
SEISQVFEI	SEISQVFEI
AEIPDQLVSY	AEIPQLVSY
ALAPILDDGW	ALAPLDDGW
AEFEDTLKTF	AEFETLKTF
EEYQGVIAW	EEYQGVIAW
AENESKARVRF	NESKARVRF
NELDLKLVSF	NELDKLVSF
GEAPVIQRL	GEAPVIQRL
DESDVKDLAF	DESDKDLAF
IENPALLRW	IENPALLRW
SEAPNEKLF	SEAPNEKLF
MEQPIKVTEW	MEQPKVTEW
AELPLRLFL	AELPLRLFL
QESVVPVRY	QESVVPVRY
KESPLLFKF	KESPLLFKF
AEVVEGSRY	AEVVEGSRY
AEVGFVRFF	AEVGFVRFF
EELASWGHEY	EELAWGHEY
SEGQVPNLKRY	SEGQNLKRY
NEFVLTTKNY	NEFVTTKNY
AEVADEKML	AEVADEKML
SEDNRILLW	SEDNRILLW
IESGPGCTW	IESGPGCTW
KEIGDVENW	KEIGDVENW
REHTALLKI	REHTALLKI
QEIDILRTLY	QEIDILRTL
EELDFQKNI	EELDFQKNI
TESLLRLEW	TESLLRLEW
VEIGKTVKAY	VEIGTVKAY
EEIANYRPTL	EEIAYRPTL
AEIAAQRTINW	AEIAAQRTI
RENSRLLSY	RENSRLLSY
EEDRVVVIRF	EEDRVVIRF
EEIGNILAF	EEIGNILAF
TENDIRVMF	TENDIRVMF
KEDGTVNRDF	KEDGVNRDF
EELPGLDSQW	EELPLDSQW
EEPPYAIKAGW	EEPPYAIKA
EEFKDVLLTAW	EEFKVLLTA
SELDLTYGNRY	SELDYGNRY
AEKLITQTF	AEKLITQTF
KEIQLLLRE	KEIQLLLRE
EEFDARWVTYF	EEFDRWVTY
SENPGQTHF	SENPGQTHF
AEALPRPNWEL	AEALPRPNW
RELPEPLLTF	RELPPLLTF
SEINKPNFY	SEINKPNFY
AENQLALEL	AENQLALEL
EEFHQSLQW	EEFHQSLQW
NEVAEDESRRY	AED-ESRRY
AIIPSKKL	AII-PSKKL
REDKSNAKLW	REDKNAKLW
KEAEDGIIAY	KEAEGIIAY
EEATDLLAYW	EEATDLLAY
QELPGLSHQYW	QELPLSHQY
AELLQKVITLY	AELLKVITL
AEFKEAFQL	AEFKEAFQL
EELKELKEY	EELKELKEY
NEVEQLLYY	NEVEQLLYY
SEGKSILLF	SEGKSILLF
VETSFRKLSF	VETSRKLSF
KEYDLAKKY	KEYDLAKKY
EEHPNPGKRY	EEHPPGKRY
AEYIQKNVQLY	AEYIKNVQL
AETDAIRFL	AETDAIRFL
AEQDIVIITY	AEQDVIITY
QEAASQGLKF	QEAAQGLKF
TETEALEGRIY	TEALEGRIY
SEYKEGGQRNW	SEYKGGQRN
EEFETIERF	EEFETIERF
AEAIAMNRQL	AEAIMNRQL
EEGHDFIQEF	EEGHFIQEF
KEFSEENVLFW	KEFSENVLF
SEASPSREAI	SEASSREAI
AEVAGQFVI	AEVAGQFVI
EEALQTIFNRW	EEALIFNRW
AESLIAKKI	AESLIAKKI
SEGFSHSRW	SEGFSHSRW
AEILQESRM	AEILQESRM
AEALAQRTY	AEALAQRTY
REVGPKNSY	REVGPKNSY
TELLLKEGF	TELLLKEGF
NEAVLHLRF	NEAVLHLRF
NEHLAGVLKDY	NEHLVLKDY
KEAADIIQKL	KEAAIIQKL
REYEIPSNL	REYEIPSNL
FENPVLQQHF	FENPLQQHF
YEILATHPTW	YEILTHPTW
AEEKQTKSF	AEEKQTKSF
QEQDLEKTRQY	QEQDKTRQY
EEWNDPPAVKW	EEWNPAVKW
QEVCGLRW	QEV-CGLRW
SEFQKAVKL	SEFQKAVKL
EEDRFYLVF	EEDRFYLVF
EEAYFERCGY	EEAYERCGY
AEMGKGSFKY	AEMGGSFKY
AEIGSNIKNL	AEIGNIKNL
IELEETIKVW	IELETIKVW
EEFDEKIATKY	EEFDIATKY
EETLDTIKQY	EETLTIKQY
SEVSTVLKL	SEVSTVLKL
EEGPDVLRW	EEGPDVLRW
LEADLPRSW	LEADLPRSW
DENLGSVKQY	DENLSVKQY
KEIGLLKQL	KEIGLLKQL
SEVVVNSVF	SEVVVNSVF
AEHIAQGLRLY	AEHIQGLRL
SELDRINAQY	SELDINAQY
KEGFIPSNY	KEGFIPSNY
REEDAALFKAW	EEDALFKAW
KEWETIRSF	KEWETIRSF
KELELAHRY	KELELAHRY
TEVLKNMGY	TEVLKNMGY
SESQLELNW	SESQLELNW
REQSNDIARGF	REQSIARGF
EEIRKVVQSL	EEIRVVQSL
SESKTVVTY	SESKTVVTY
AELPDQKQLRY	AELPDQKQL
EETQTLVREY	EETQLVREY
KEHGDRVFF	KEHGDRVFF
VEYNALFKKY	VEYNLFKKY
TESSQNGKQY	TESSNGKQY
EELDPESREYW	EELDESREY
EEHITKIYY	EEHITKIYY
REAEARSSF	REAEARSSF
RENYDIIKTY	RENYIIKTY
SEIDQINKVF	SEIDINKVF
QERDPSKIKW	QERDSKIKW
REEEAARLF	REEEAARLF
EEYDTQAMKY	EEYDQAMKY
TEIDGRSISLY	TEIDRSISL
SEFEGHKRI	SEFEGHKRI
AEHSPVPAGF	AEHSVPAGF
SEIYIHGLGL	SEIYHGLGL
EEIEAERQIL	EEIEAERQI
EEAPKFLAF	EEAPKFLAF
QENQELGRQL	QENQLGRQL
EEIVKEVSTY	EEIVEVSTY
EETEELMRKY	EETELMRKY
EEVPTQESVKW	EEVPTQESV
KEDIIQGFRY	KEDIQGFRY
SESEPGSRQW	SESEGSRQW
EEIPVHEEF	EEIPVHEEF
TEHKSPDGRTY	TEHKDGRTY
VELPIEANLVW	VELPIEANL
TESPLVKAIF	TESPLVKAI
REVGNAILF	REVGNAILF
EELYTKKLW	EELYTKKLW
MEEEIPKNY	MEEEIPKNY
EELGLVTHL	EELGLVTHL
SEAHVNTCY	SEAHVNTCY
AETAVQLFI	AETAVQLFI
AENPFLTHL	AENPFLTHL
SETPEIRKY	SETPEIRKY
EELQKIYKTY	EELQIYKTY
SESPEPGQRTF	SESPGQRTF
EEFEYQRSY	EEFEYQRSY
EEFSRAAEKLY	EEFSAAEKL
SETADANRVF	SETAANRVF
AENIPENPLKY	AENINPLKY
VEGSSKIQY	VEGSSKIQY
AEGENKTSKSW	GENKTSKSW
SEEQLSRAY	SEEQLSRAY
EEDEDAYKKQF	DEDAYKKQF
KEFLKPEKF	KEFLKPEKF
SEVELEQRRY	SEVEEQRRY
AEARLLLDNF	AEARLLDNF
QEIVETTKMY	QEIVTTKMY
SELIAKIPNFW	SELIKIPNF
MEEALFQHF	MEEALFQHF
TEFPNPLISKY	TEFPLISKY
EEAIIEPVIKW	EEAIIEPVI
RESEYKQVY	RESEYKQVY
KEIINASKAI	KEIIASKAI
EETQIGGERY	EETQGGERY
AEIDFRLVSF	AEIDRLVSF
EEFELLGKAY	EEFELGKAY
AENIQPGEQKY	AENIGEQKY
LEHVPNSVRLW	LEHVNSVRL
SQPLGPRII	SQPLGPRII
SEAGSAARF	SEAGSAARF
AEHHEVLTEY	AEHHVLTEY
AEHDVTVKY	AEHDVTVKY
EEVYAGSHQY	EEVYGSHQY
EELLGDGHSY	EELLDGHSY
QEINFAWV	QEI-NFAWV
QEAGIKTAF	QEAGIKTAF
AEVLNFLLRY	AEVLFLLRY
AEGKFWTHW	AEGKFWTHW
AENKAKINM	AENKAKINM
IESVIKELW	IESVIKELW
TEFRNFIVW	TEFRNFIVW
TEAAHPIRLF	TEAAPIRLF
EEGEIPWLQY	EEGEPWLQY
KEQEFGKLF	KEQEFGKLF
SESQDQVFLRW	SESQDQVFL
AEIDLQELQGY	AEIDELQGY
KEAEQVLQKF	KEAEVLQKF
SEKSEMQRHY	SEKSMQRHY
EEAPAQLLQ	EEAPAQLLQ
SEIPQTERM	SEIPQTERM
HEINGLLVGF	HEINLLVGF
TELERKLTF	TELERKLTF
TEFKGRSY	TEF-KGRSY
AEVQIARKL	AEVQIARKL
EEFVPGVKRY	EEFVGVKRY
REATGKITF	REATGKITF
SEAQINTAKRL	SEAQTAKRL
EETPNILRI	EETPNILRI
REFNLNELY	REFNLNELY
AENNIQPIF	AENNIQPIF
AENISRVLY	AENISRVLY
AELAVILKF	AELAVILKF
SEESEAYKSL	EESEAYKSL
AEIRQQIPVF	AEIRQIPVF
AEQDLVQTL	AEQDLVQTL
SEVDLTRSF	SEVDLTRSF
AEILLSNHY	AEILLSNHY
RESSLALNY	RESSLALNY
SEGDITQKGY	SEGDTQKGY
EEMPLNVADLI	EEMPNVADL
KEVLHGKKW	KEVLHGKKW
NEFPVPEQF	NEFPVPEQF
KELGTAGLYL	KELGAGLYL
KELTDVQYY	KELTDVQYY
KEAFVVEEW	KEAFVVEEW
EEINLQRNI	EEINLQRNI
AEMEVKRESY	AEMEKRESY
SETSVPDHVVW	SETSVPDHV
EEFDFHVRW	EEFDFHVRW
AEHIKSLLI	AEHIKSLLI
EEFDARWVTY	EEFDRWVTY
QESGPSAEKY	QESGSAEKY
EEMDLFTKY	EEMDLFTKY
EELGLIEQAY	EELGIEQAY
QEPWLHSMY	QEPWLHSMY
AEGKLISVEY	AEGKISVEY
SEKGVIQVY	SEKGVIQVY
SEPFHLIVSY	SEPFLIVSY
SETGALKTF	SETGALKTF
SEEENVVLKF	SEEEVVLKF
LEINDVTRAW	LEINVTRAW
EENILVSRY	EENILVSRY
AEPIDIQTW	AEPIDIQTW
QEVSPKVYF	QEVSPKVYF
KEGPSPKVEY	KEGPPKVEY
GEDNIVRKY	GEDNIVRKY
PPSKQILALKQ	SKQILALKQ
IEVNGKQSW	IEVNGKQSW
EEDAALFKAW	EEDALFKAW
EEFTDPLSF	EEFTDPLSF
QESEDTAKAGF	SEDTAKAGF
VEAPSFLNGVW	VEAPFLNGV
EELDPESREY	EELDESREY
SEHAVNKQL	SEHAVNKQL
EEIGQLVKQM	EEIGLVKQM
AENSSLIKHL	AENSLIKHL
RETGSSKGF	RETGSSKGF
AEELPHIHAF	EELPHIHAF
NEDPQLKSLW	NEDPQLKSL
RELPNPLLTY	RELPPLLTY
HEILLHPRYF	HEILLHPRY
GEWASGGVRSF	EWASGVRSF
AEDAIRNLHHY	AED-AIRNL
IEIAGVKLLY	IEIAVKLLY
DEFSHQVQEW	DEFSQVQEW
AEDLNTRVAYW	AEDLTRVAY
QEIDILEDW	QEIDILEDW
SEDEVKLAL	SEDEVKLAL
TEFEDIKSGY	TEFEIKSGY
VEELFERKY	VEELFERKY
AEPDESNARYF	AEPDSNARY
VEQATKPSF	VEQATKPSF
QETREILHF	QETREILHF
LEIEAENHY	LEIEAENHY
SESSPPKAM	SESSPPKAM
TEHYDIPKVSW	TEHYPKVSW
SENGAGKPW	SENGAGKPW
IEVFDPDANTW	EVFDDANTW
QEALNLFKSIW	QEALLFKSI
EEADGGLKSW	EEADGLKSW
EEIYPPKLHQF	EEIYKLHQF
GEIEGLNDTF	GEIELNDTF
SEGVSMRFF	SEGVSMRFF
AEDFLEKLAF	AEDFEKLAF
VEFSEPTIILF	VEFSPTIIL
KESIAQRSY	KESIAQRSY
TENNVIKSL	TENNVIKSL
SELEYDMKKY	SELEDMKKY
QELQTAKKY	QELQTAKKY
AEIMESIKRL	AEIMSIKRL
GETEVLKVI	GETEVLKVI
QEAGTFRHTLW	QEAGFRHTL
AEIPGLSINF	AEIPLSINF
AELGTFPRAF	AELGFPRAF
EEGDRVITY	EEGDRVITY
AEDKENYKKF	AEDKNYKKF
EENDQSTHKW	EENDSTHKW
AEDEGVSQRKF	DEGVSQRKF
IVEPPTDLN	IVEPPTDLN
EEHPLVFLF	EEHPLVFLF
VEPQEDTRLW	VEPQDTRLW
QEWAAQTEKSY	QEWATEKSY
DTALSLKDMV	DTALSLKDM
LEKQLIEL	LEK-QLIEL
AEWKDGLNEA	AEWKGLNEA
EEISTLVQKL	EEISLVQKL
EESLRNYYEQW	EES-LRNYY
VEMYDPTRNEW	EMYDTRNEW
KEAETRAEF	KEAETRAEF
QEESLRQDY	QEESLRQDY
SETDMVRQI	SETDMVRQI
EELGNHKAF	EELGNHKAF
QEARNIYQEF	QEARIYQEF
AEDPLGAIHL	AEDPGAIHL
DEYIERLVW	DEYIERLVW
EEIGDLKRRL	EEIGLKRRL
REEDGHTHQW	EEDGHTHQW
AEIRAINEAY	AEIRINEAY
QEQLPRDCF	QEQLPRDCF
AENAEFMRNF	AENAFMRNF
QELETTQKHL	QELETQKHL
VEVDLEHEW	VEVDLEHEW
GEVPFNHEI	GEVPFNHEI
KENGFTQHVY	KENGTQHVY
AELEKHGY	AEL-EKHGY
SENAERILY	SENAERILY
KENPGLVEQY	KENPLVEQY
AEINYGIRF	AEINYGIRF
EEIKKNYRY	EEIKKNYRY
KEGATAKF	KEG-ATAKF
DEIDAIGGARF	DEIDGGARF
AEWEWKAGF	AEWEWKAGF
VENTEENRRLY	VENTENRRL
LESFIDTQKF	LESFDTQKF
AERNICSKY	AERNICSKY
AEEEIGTPRKF	EEIGTPRKF
EEPPPVKIAW	EEPPVKIAW
KESYSVYVY	KESYSVYVY
AEPLPSNILEW	AEPLPSNIL
KEGYGLSW	KEG-YGLSW
SENELKKAY	SENELKKAY
LEEPTVIKKY	EEPTVIKKY
KERQLELLL	KERQLELLL
AEIDAHLVAL	AEIDHLVAL
QESAQNTKF	QESAQNTKF
GETELREYF	GETELREYF
EEPTVIKKY	EEPTVIKKY
TEQNFISKSGY	TEQNSKSGY
AETDLAKRF	AETDLAKRF
SEAVVEYVF	SEAVVEYVF
SEVPFSKRY	SEVPFSKRY
SEFVIPSVY	SEFVIPSVY
EESDLSRQY	EESDLSRQY
SEQETLQKY	SEQETLQKY
EELTVQVARVY	EELTVARVY
QELFLAHIL	QELFLAHIL
SEEDQVRKW	SEEDQVRKW
EEELGSKAKF	EELGSKAKF
QEAIDEVKRQW	QEAIVKRQW
TEANVVRKF	TEANVVRKF
REISYLKKL	REISYLKKL
QENLTDLHQY	QENLDLHQY
TEQEIRSLF	TEQEIRSLF
QEIGVLDQREY	QEIGDQREY
KEGDLPPLWW	KEGDLPPLW
KEGLDIYKKF	KEGLIYKKF
MEIDIPHVWL	MEIDIPHVW
QETELSQRI	QETELSQRI
REYEAQQQY	REYEAQQQY
MENVNKPQLW	MENVKPQLW
HEGDIILKI	HEGDIILKI
VENGDSGSRYY	VENGSGSRY
EEVFQNANF	EEVFQNANF
AENDAQKPSL	AENDQKPSL
SEVTEEGVRF	SEVTEGVRF
AELELQRFLY	AELELQRFL
EEFGRAFSF	EEFGRAFSF
AEFTKSIAKF	AEFTSIAKF
SEIGQKQKL	SEIGQKQKL
KESDPSKLQF	KESDSKLQF
EEVKSFRVL	EEVKSFRVL
NEPILYGRSY	NEPIYGRSY
KEIQKLETEL	KEIQLETEL
EEAHLNTSF	EEAHLNTSF
NEFIDASRLVY	NEFIDASRL
QEAAPEKSSF	QEAAEKSSF
AEDLVANFF	AEDLVANFF
SEEPPSKPSF	SEEPSKPSF
AEEKTISAKY	AEEKISAKY
GEIRLLQSY	GEIRLLQSY
KEFSIDVGY	KEFSIDVGY
LEIEAENHYW	LEIEAENHY
AELLHGQPAL	AELLGQPAL
EEMGDYIRSY	EEMGYIRSY
QENNTKQLRF	QENNKQLRF
EESDLERGY	EESDLERGY
LESVVQERF	LESVVQERF
QESAPVHNSF	QESAVHNSF
EEIEGFRY	EEI-EGFRY
REREEETPAY	REREETPAY
HELGNVFLKF	HELGVFLKF
AELDIPQSV	AELDIPQSV
DEITGKKGY	DEITGKKGY
KEFDKKYNPTW	KEF--DKKY
EELFHLLNF	EELFHLLNF
REIEELRQRY	REIELRQRY
NEEGFVRLY	NEEGFVRLY
LENDIRTFF	LENDIRTFF
KEEQVIQVW	KEEQVIQVW
VESPLSVSF	VESPLSVSF
QEVTHSVRIGF	QEVTHSVRI
NESEPIVVY	NESEPIVVY
REMDCSVLKRL	REMDVLKRL
EEASFDGTFLW	EEASFDGTF
IENQNSRQY	IENQNSRQY
EETTDLLAHW	EETTLLAHW
AEDGLIRQY	AEDGLIRQY
SEGPSTSRW	SEGPSTSRW
HEVILKNITW	HEVIKNITW
GEDGYVRIHY	GEDGVRIHY
EEGNLLRSW	EEGNLLRSW
TESDDLHTF	TESDDLHTF
EEQKNLHFF	EEQKNLHFF
IEFNKPQYF	IEFNKPQYF
AETPDIKLF	AETPDIKLF
EESRKHINTW	EESRHINTW
SENGCLSRF	SENGCLSRF
QEQFLELSY	QEQFLELSY
DELKIPIRSW	DELKPIRSW
NEYESRSLW	NEYESRSLW
AEDELFNRY	AEDELFNRY
SELDLISRL	SELDLISRL
EEGPSSVRF	EEGPSSVRF
KEGGVQLLL	KEGGVQLLL
QEREDQKVKW	QEREQKVKW
DEAVGVQKW	DEAVGVQKW
KETADFKVY	KETADFKVY
AEKEVKGAVY	AEKEKGAVY
TEAERSLLF	TEAERSLLF
QEGKLDRTF	QEGKLDRTF
KEIDEIHSKY	KEIDIHSKY
EEFRHVIAW	EEFRHVIAW
EETQVILREY	EETQILREY
AELPLDYKF	AELPLDYKF
TEVIHADRW	TEVIHADRW
VEQQIQKKY	VEQQIQKKY
AELPLIRLDF	AELPIRLDF
QEIQLKEAKHI	QEIQLKEAK
AEIGRNYSM	AEIGRNYSM
SEDTVNKATY	SEDTNKATY
EELIVVTSY	EELIVVTSY
REIEELLNNF	REIELLNNF
TEGGEPYRLY	TEGGPYRLY
AEGPVVEKI	AEGPVVEKI
KEQGQNLARQW	KEQGLARQW
SENAERILF	SENAERILF
RESETNKGAF	RESENKGAF
QEYAQVIKM	QEYAQVIKM
EEMPATKGGF	EEMPTKGGF
SEDGTVRLW	SEDGTVRLW
IERDGTESY	IERDGTESY
SEIADPTRF	SEIADPTRF
EENEISEHCF	EENESEHCF
AEGTLSKKL	AEGTLSKKL
VEVPEGPRTW	VEVPGPRTW
IEEQPKNYQVW	EEQPNYQVW
AEHDRIARQW	AEHDIARQW
EESYFTTRTY	EESYTTRTY
AEFPDEPKW	AEFPDEPKW
HEHLVDCARKY	HEHLCARKY
TEQSQIKGYVW	TEQSQIKGY
EEDKFLLLY	EEDKFLLLY
HESPALILLF	HESPLILLF
SENAIVWKI	SENAIVWKI
TEASSATSKAY	TEASTSKAY
SEFTGVWKY	SEFTGVWKY
EESISQLRHY	EESIQLRHY
EEIQTVFNKY	EEIQVFNKY
IIHEIAVLEL	HEI-AVLEL
EEQELEKSM	EEQELEKSM
TEVSLLRVGW	TEVSLRVGW
EEYQAFLVY	EEYQAFLVY
AEEVARLW	AEE-VARLW
SEFKYNKPAF	SEFKNKPAF
QESLPPVQFDW	QESLPPVQF
FEADSTVIEKW	FEADVIEKW
NEEGEAQKF	NEEGEAQKF
SELRLDSVVQW	SELRSVVQW
NEFPVIVRL	NEFPVIVRL
SEVNIPLSL	SEVNIPLSL
QESTKQLTM	QESTKQLTM
EEKEAIYKERW	KEAIYKERW
RENVEAAQSY	RENVAAQSY
NEVQYDQRL	NEVQYDQRL
DENSVIKSF	DENSVIKSF
AEVISVLQKY	AEVIVLQKY
QELDKKKEEF	QELDKKEEF
AEFIVAKAI	AEFIVAKAI
SEYRQSLHTY	SEYRSLHTY
KEYEKALKY	KEYEKALKY
EEEEKAKAY	EEEEKAKAY
EEVDSSVKKI	EEVDSVKKI
SELNPNAEVW	SELNNAEVW
AELPDQKQL	AELPDQKQL
AEDIAKIKKF	AEDIKIKKF
AEVFNYREF	AEVFNYREF
AEESRKHINTW	EESRHINTW
GEANGVWKY	GEANGVWKY
RENNAVYAF	RENNAVYAF
DEAKILKSL	DEAKILKSL
VELGQVKQY	VELGQVKQY
EEEGNLLRSW	EEEGLLRSW
EELVTGTVRTF	EELVTVRTF
EELDLPAVF	EELDLPAVF
AEIIKGELW	AEIIKGELW
AEKAPTNIVY	AEKATNIVY
QEVGYSIRF	QEVGYSIRF
NELNIIHKF	NELNIIHKF
TEVTYQFI	TEV-TYQFI
KETIIAFAW	KETIIAFAW
AEQERDKLQRY	QERDKLQRY
YENPVVSRI	YENPVVSRI
EEIKKSKSF	EEIKKSKSF
SETFHHSSNW	SETFHSSNW
SEVILPVPAF	SEVIPVPAF
SETVLNLAF	SETVLNLAF
EELNDLIQRF	EELNLIQRF
AEIEIVKDL	AEIEIVKDL
EETPVVLQL	EETPVVLQL
GENAERLKKTY	AER-LKKTY
AEQDFISKF	AEQDFISKF
IEISELPVRTW	SEL-PVRTW
SETNGRIPKTY	SETNIPKTY
SEGGPPLRI	SEGGPPLRI
EELFFDYRY	EELFFDYRY
EEINKIIRDLW	EEINIIRDL
SENTAIHHY	SENTAIHHY
TENDHVLLF	TENDHVLLF
AEAFEAIPRAL	AEAFIPRAL
AELKDPTDHY	AELKPTDHY
DEIENVAKQF	DEIEVAKQF
AERDGKNNVAF	AERDGKNNV
NELEQKMLL	NELEQKMLL
RELPLVLL	REL-PLVLL
AEFEVPKLVQY	AEFEVPKLV
DEALIGKKF	DEALIGKKF
EEFLSKVSI	EEFLSKVSI
EEVGVEHLL	EEVGVEHLL
REMDEQIRL	REMDEQIRL
IEVTPGDRSW	IEVTGDRSW
EEIPLIKSAY	EEIPIKSAY
AENGGNSHSL	AENGNSHSL
AEIAALRFL	AEIAALRFL
AEDMTSKDY	AEDMTSKDY
IESGEVLERW	IESGVLERW
NENARLLTF	NENARLLTF
SESLPKEAF	SESLPKEAF
QEDPEAFLLY	QEDPAFLLY
AELTPHQTF	AELTPHQTF
EELDGLFRRY	EELDLFRRY
AESYRIQTY	AESYRIQTY
TEALPVKLI	TEALPVKLI
EEIDGDTNKY	EEIDDTNKY
AEVPKEHW	AEV-PKEHW
SEEPLGRQLW	SEEPLGRQL
QEYLDTLYRY	QEYLTLYRY
RELELAVFW	RELELAVFW
AEGDTGLPRVW	AEGDLPRVW
SENPANRYSF	SENPNRYSF
EELPEKLKLY	EELPKLKLY
EEVFPLAMNY	EEVFLAMNY
QEALAAARL	QEALAAARL
TEEKTMKSF	TEEKTMKSF
TEADVKIVI	TEADVKIVI
AETPDIKLFG	AETPDIKLF
SEDRPFAVGY	SEDRFAVGY
VEVGDKAKW	VEVGDKAKW
FENEIILKL	FENEIILKL
QESLAQARL	QESLAQARL
AEPDESNARY	AEPDSNARY
REVDVEKVTTF	REVDKVTTF
QESNVRLKL	QESNVRLKL
QEIPVNVRF	QEIPVNVRF
AEAPPPQKRY	AEAPPQKRY
NEGQTALHY	NEGQTALHY
SEVILHHEY	SEVILHHEY
SEEGPDVLRW	EEGPDVLRW
SESRMVVTF	SESRMVVTF
SEHPNSMIPAF	SEHPMIPAF
SESPIVVVL	SESPIVVVL
SEALPGDNVGF	SEALDNVGF
AEDMETKIKNY	MET-KIKNY
NEASVLHNL	NEASVLHNL
SERDVYLTY	SERDVYLTY
AEDSVMDHHF	AEDSMDHHF
AEVPIIAIDW	AEVPIAIDW
EELAENILKW	EELANILKW
SEMPAAKRL	SEMPAAKRL
KEADRAQQY	KEADRAQQY
TEDEFKRLF	TEDEFKRLF
LEISAEDAERW	EISADAERW
KENSDVIALW	KENSVIALW
EEEQAVRPKY	EEEQVRPKY
EEVRQVGSY	EEVRQVGSY
SEGSFLLTTF	SEGSLLTTF
EETVFYGLQY	EETVYGLQY
EEMSVPLKEL	EEMSPLKEL
EENNNFSKM	EENNNFSKM
QEQEIEQRLL	QEQEIEQRL
EETFQLSRW	EETFQLSRW
EEIEAKNREL	EEIEKNREL
SEDGTLRLW	SEDGTLRLW
SEQEYQLYL	SEQEYQLYL
EEADKLVRQY	EEADLVRQY
REIGVQRSY	REIGVQRSY
EEYIHKPKY	EEYIHKPKY
EENTCLRNQY	EENTLRNQY
VEVQLPELF	VEVQLPELF
VELRILTNW	VELRILTNW
NEFPEPIKL	NEFPEPIKL
AEFEVVRTI	AEFEVVRTI
SEDLPLPTF	SEDLPLPTF
AEMLRSISF	AEMLRSISF
SEGPLKGILGY	SEGPLKGIL
EEFDRLVKEY	EEFDLVKEY
SEALGDNVKQY	SEALNVKQY
AENIDAQLKRM	AENIAQLKR
AEFSKKCSERW	AEFSCSERW
QEIEEIRQKY	QEIEIRQKY
QEAIGFIDW	QEAIGFIDW
TENIDIKKY	TENIDIKKY
SEIGRSAKSY	SEIGSAKSY
VEFHEPETW	VEFHEPETW
SEVVTVFQYY	SEVVTVFQY
SESETLISMV	SESETLISM
KESQAKEQY	KESQAKEQY
DEAPVLDVRY	DEAPLDVRY
AETGVGKTV	AETGVGKTV
RELLEIVKKNF	RELLIVKKN
KEADRAQQYF	KEADRAQQY
AEDGLLFKF	AEDGLLFKF
SEIDQLFRIF	SEIDLFRIF
SEVFVDLKW	SEVFVDLKW
NEGTVKRW	NEG-TVKRW
AEAAAAAKF	AEAAAAAKF
AEHNSKIKYW	AEHNSKIKY
AEVDNRSPQKF	AEVDSPQKF
LEFEGVKEKF	LEFEVKEKF
QENQDTSSRRF	QENQSSRRF
HEILIGYLEY	HEILGYLEY
RELPGHTGY	RELPGHTGY
AEINNIIKI	AEINNIIKI
EEIQQQLLHY	EEIQQLLHY
TELEIEKSL	TELEIEKSL
EETLNTLRY	EETLNTLRY
QEVGYTIRF	QEVGYTIRF
DEAPCVNGRW	DEAPVNGRW
AEDEDLRVHF	AEDELRVHF
SESHPNATF	SESHPNATF
SEAKEFAKQF	SEAKFAKQF
EELERDKRVTW	EELERDKRV
LEHEYIQNF	LEHEYIQNF
AETGIAVPSY	AETGAVPSY
EEFQKELSQW	EEFQELSQW
AEDAMRLYY	AEDAMRLYY
EELFARKF	EEL-FARKF
AEMLESVIKNY	AEMLVIKNY
AEIPVGICRY	AEIPGICRY
SEDEIKKAY	SEDEIKKAY
METNLVGSDKY	ETNLGSDKY
EESEIRYSTW	EESERYSTW
EESSDDGKKY	EESSDGKKY
KELASRLRY	KELASRLRY
SEISSATKL	SEISSATKL
REAGFQVKAY	REAGQVKAY
SEIVQNGRLI	SEIVNGRLI
EEIDLRSVGW	EEIDRSVGW
REAESLIAKKI	AESLIAKKI
KEIEDAAQF	KEIEDAAQF
KEIERPFETY	KEIEPFETY
AEIEKLGQKY	AEIELGQKY
QEIDLTGVKL	QEIDTGVKL
SELDNVTFSF	SELDVTFSF
EELDVLKFL	EELDVLKFL
EEIDLSGNKL	EEIDSGNKL
SEVKSKIASKY	SEVKIASKY
GEVLISRVY	GEVLISRVY
EEYEREGITW	EEYEEGITW
AEAQLRFIQAW	AEA--QLRF
SELKDFFQSY	SELKFFQSY
SENEEGKRSI	SENEGKRSI
EELERILVY	EELERILVY
EELLFSHKL	EELLFSHKL
QENQSNRQF	QENQSNRQF
KEQGPYETY	KEQGPYETY
SEGPPLTSF	SEGPPLTSF
AENPFLTHLI	AENPFLTHL
SEEGLLRLY	SEEGLLRLY
DEIAGCIEKAY	EIAGIEKAY
AELAISKCQF	AELASKCQF
EEVDVTPTF	EEVDVTPTF
TETPLEGDFAW	TETPLEGDF
NEQTLQRSW	NEQTLQRSW
EEAQPIVTKY	EEAQIVTKY
SEVPDSVYQHL	SEVPVYQHL
AEHIESRTL	AEHIESRTL
EEVPVYENKY	EEVPYENKY
EEIDTSRLFEW	EEIDTSRLF
AEVEGAGVKAW	VEGAGVKAW
AEGTSARTF	AEGTSARTF
AELLVKGYEI	AEL-LVKGY
KEQETALRVY	KEQEALRVY
HENSPRKEVY	HENSRKEVY
EEYSNTRAY	EEYSNTRAY
VENAVQKEL	VENAVQKEL
AESDIMKRQ	AESDIMKRQ
TESDTAVRL	TESDTAVRL
TEINKKHCW	TEINKKHCW
GETPQTDVRW	GETPTDVRW
TEVNMARVY	TEVNMARVY
EESFAEHLGY	EESFEHLGY
AELAERLGL	AELAERLGL
SESELTRLL	SESELTRLL
AEGAYQVRL	AEGAYQVRL
TEYTPDPNHGF	TEYTPNHGF
AENSPTRQQF	AENSTRQQF
DELEIKAYY	DELEIKAYY
SETGRSKGY	SETGRSKGY
KEVKTSLTF	KEVKTSLTF
TEVTLPKSI	TEVTLPKSI
EESPSGRGW	EESPSGRGW
GENDRGVSF	GENDRGVSF
KEIGTKQSF	KEIGTKQSF
EEIKSFREL	EEIKSFREL
WEVDVQGSKAY	EVDVGSKAY
TEHQVVSSDF	TEHQVSSDF
NEFGLTSLRW	NEFGTSLRW
KEFPSILRF	KEFPSILRF
EEVEQGVKF	EEVEQGVKF
KESTLHLVL	KESTLHLVL
RENDCIVRI	RENDCIVRI
AEANRALAHY	AEANALAHY
LESGVPSRF	LESGVPSRF
KEIEDAEKYSF	KEIEDAEKY
EENPIVLEF	EENPIVLEF
REVSGIKAAY	REVSIKAAY
SESTNQRVLW	SESTNQRVL
EEQVARESY	EEQVARESY
HEFPLILIF	HEFPLILIF
EEFHIYTQY	EEFHIYTQY
NETLIVSKF	NETLIVSKF
RELTAVVQKRF	RELTVQKRF
EEEKTGKVKY	EEEKGKVKY
EEDQAAELRAY	EEDQELRAY
EEIKQIWQQY	EEIKIWQQY
EEIDENFKALF	EEIDNFKAL
AELGPLNKY	AELGPLNKY
AEIRSLVTW	AEIRSLVTW
SEIINSKNF	SEIINSKNF
AERDLYRDTW	AERDYRDTW
AENENGSRCF	AENEGSRCF
KENSIITKY	KENSIITKY
AEYPDSFGHY	AEYPSFGHY
EEVLIKNGEI	EEVLKNGEI
GEAKIKSDY	GEAKIKSDY
KEVEEISLL	KEVEEISLL
AEMNRGSNEW	AEMNGSNEW
NESAIFHGW	NESAIFHGW
QELASELNKQY	QELALNKQY
KEQIERLGY	KEQIERLGY
RERELAEKY	RERELAEKY
SESNLRKAF	SESNLRKAF
MESTESRHY	MESTESRHY
KEGEFSTCF	KEGEFSTCF
EELDVKHAL	EELDVKHAL
HEIITPEQF	HEIITPEQF
LEPEELYQTF	LEPELYQTF
AEVEPGVHL	AEVEPGVHL
SEVVAIKKM	SEVVAIKKM
EENISEVKSY	EENIEVKSY
YLPDGTASL	YLPDGTASL
REGAITFTW	REGAITFTW
VEINIDHKF	VEINIDHKF
SEISQQVRF	SEISQQVRF
DEQTPIHISW	DEQTIHISW
SEAAHQGVITW	SEAAHQGVI
EELNKLIQEF	EELNLIQEF
AETGSVKDF	AETGSVKDF
AEVNLKKKSY	AEVNKKKSY
KEFGSSQQY	KEFGSSQQY
EELVERLQSY	EELVRLQSY
SESARQLFL	SESARQLFL
EEHPSVTLF	EEHPSVTLF
VENEVIKSL	VENEVIKSL
QEIATLDNKI	QEIALDNKI
KEENTRFRGW	EENTRFRGW
TETDLRNHF	TETDLRNHF
FEYEYSQRW	FEYEYSQRW
SEQPFLLVTY	SEQPLLVTY
KEWVTPKEF	KEWVTPKEF
SELPGNPNAVW	SELPNPNAV
GENSAVLHY	GENSAVLHY
QEQQADLQRRL	QEQQLQRRL
TEVRICPVEF	TEVRCPVEF
SELLSDVRF	SELLSDVRF
VEVGDRTSW	VEVGDRTSW
SELVPIATQTY	SELVATQTY
AEMEVLLASKA	AEMEVLLAS
EEQLIAAKF	EEQLIAAKF
QEVEAKELSF	QEVEKELSF
REVSPAHQY	REVSPAHQY
EEAQIGKRGY	EEAQGKRGY
SEGYPGQRY	SEGYPGQRY
EEVKSAASY	EEVKSAASY
DESNALGKKF	DESNLGKKF
TELDLYKKM	TELDLYKKM
REGDVVRIY	REGDVVRIY
SEAPARQGF	SEAPARQGF
REKEDGAFSF	REKEGAFSF
EEARPLVEFY	EEARLVEFY
CEKNPTDAY	CEKNPTDAY
QELASLLRTY	QELALLRTY
HEIYTVGKRF	HEIYVGKRF
GETSYIRVY	GETSYIRVY
AEFELPKTM	AEFELPKTM
AEGTEEGARW	AEGTEGARW
AEHADTVQL	AEHADTVQL
EEIRNIILKL	EEIRIILKL
AEIDSIHQL	AEIDSIHQL
YEWSVKLNW	YEWSVKLNW
AENPVENHI	AENPVENHI
AELGGLLKYV	AELGGLLKY
AEWEERISAW	AEWERISAW
RENNNPVEF	RENNNPVEF
AEFIVGGKY	AEFIVGGKY
LEQANDDARTF	EQANDARTF
RENPIIKNL	RENPIIKNL
SESRIFNEL	SESRIFNEL
REEGAVDKSY	EEGAVDKSY
QEDFGIFQAW	QEDFIFQAW
EEYFGFIEQY	EEYFFIEQY
QEGDTTRKY	QEGDTTRKY
AEYVSAREW	AEYVSAREW
EEDNPVIRSYF	EEDNVIRSY
AEVDYLEQF	AEVDYLEQF
EEVLSGKLF	EEVLSGKLF
AESLYEIRF	AESLYEIRF
SELQSQVRY	SELQSQVRY
RETNPLYKDY	RETNLYKDY
KEFTGIDNLW	KEFTIDNLW
EELEVDFKKL	EELEDFKKL
GEVDYKKKY	GEVDYKKKY
AELAVGSRW	AELAVGSRW
AEELLRIGL	AEELLRIGL
EESYSRMGY	EESYSRMGY
DEIERKFDKW	DEIEKFDKW
TEEEALKHF	TEEEALKHF
KEIHLYQTF	KEIHLYQTF
AEADEIFQEL	AEADIFQEL
REIENGNSF	REIENGNSF
EENKLVKKI	EENKLVKKI
REAEFTKSI	REAEFTKSI
SESNFARAY	SESNFARAY
QELPGRLSF	QELPGRLSF
TENIIAANHW	TENIAANHW
AESVVKKTGF	AESVKKTGF
KELWAVLNGW	KELWVLNGW
QETQAKPGY	QETQAKPGY
HEQEAILHNF	HEQEILHNF
AEVEAQKAQQL	VEAQKAQQL
MEGKINKQL	MEGKINKQL
VEIQTPKII	VEIQTPKII
KEQESKKGF	KEQESKKGF
SEEPILKWY	SEEPILKWY
AEWLFPLAF	AEWLFPLAF
SESTNQRVLWW	SESTNQRVL
AEAEAASVRM	AEAEASVRM
AEHPNPGVRY	AEHPPGVRY
EEIYPPEVAEF	EEIYEVAEF
EELDSLIKATI	EELDLIKAT
AELMQTLRF	AELMQTLRF
EEVFLIGKNF	EEVFIGKNF
QENSRVIVM	QENSRVIVM
NEIRSVKRL	NEIRSVKRL
EEMDLKVLQF	EEMDKVLQF
SEAGSHTLQW	SEAGHTLQW
MEANVKSQY	MEANVKSQY
DEVFFSEKIY	DEVFSEKIY
NEILDLCHSF	NEILLCHSF
LGCDHILVI	LGCDHILVI
QEIEVRPGI	QEIEVRPGI
EEFEKNKGKGF	EEFEKGKGF
AELAEVRAL	AELAEVRAL
AEAEKLGGQSY	AEKLGGQSY
KEDGKVICW	KEDGKVICW
SEYDRGVNTF	SEYDGVNTF
TELPKAEKW	TELPKAEKW
SESSHKGFHY	SESSKGFHY
NEIQEALSRSY	QEA-LSRSY
KEAAQEAVKLY	KEAAEAVKL
EEAPLAASCGL	EEAPLAASC
SEGTKAVTKY	SEGTAVTKY
VEAARGAGW	VEAARGAGW
KEQYQQQQQW	KEQYQQQQW
SESELGRKW	SESELGRKW
AEIQNVEGQNL	AEIQNVEGQ
SEHGGDVQKW	SEHGDVQKW
AEIDDRKQL	AEIDDRKQL
EEEIGTPRKF	EEIGTPRKF
AEAEIIQLL	AEAEIIQLL
VIESPPEIN	VIESPPEIN
AEADGLSTNHW	AEADGLSTN
GENGDPKAF	GENGDPKAF
FENVKEKW	FEN-VKEKW
SETNTSDKSF	SETNSDKSF
AENGFLPIHL	AENGLPIHL
TENKLRLHY	TENKLRLHY
RELLPVKKF	RELLPVKKF
TEAYIAQRF	TEAYIAQRF
VEDERGNVFLW	VEDERGNVF
QESFIWVRY	QESFIWVRY
DEARSLKAY	DEARSLKAY
SEACRELGF	SEACRELGF
QEWDKYCHY	QEWDKYCHY
QETSFTKEAY	QETSTKEAY
EEVESRAY	EEV-ESRAY
NELDIKKRL	NELDIKKRL
QEKLLKKSY	QEKLLKKSY
AEYPFSSEQKW	AEYPSEQKW
EEVEKYEKQY	EEVEYEKQY
EETEQINKHF	EETEINKHF
AELDRQIKSF	AELDQIKSF
HEFDGDEQFY	HEFDGDEQF
AELSEQIKSF	AELSQIKSF
QELEARQQL	QELEARQQL
QENEEAVKKML	QENEAVKKM
KEVTDEIVKEF	KEVTIVKEF
SELEAARML	SELEAARML
MEAPAQLLF	MEAPAQLLF
READQPLRTY	READPLRTY
TENEMTTIHY	TENETTIHY
DEVHTIPAKMF	DEVHIPAKM
KEKDERILW	KEKDERILW
EEYITTSKQSL	EEYISKQSL
KEVSTYIKKI	KEVSYIKKI
AEPRHGELW	AEPRHGELW
QELNFLLRY	QELNFLLRY
CEIERIHFF	CEIERIHFF
FEDENGQRW	FEDENGQRW
AEVDKVARL	AEVDKVARL
AEWASRFWLW	AEWASRFWL
AENRSAFSY	AENRSAFSY
HEGPALYY	HEG-PALYY
KESHATLVF	KESHATLVF
AEDGLLFKFL	AEDGLLFKF
QEVKNLHQRL	QEVKLHQRL
QEGMVFTRF	QEGMVFTRF
TELTTAIRTY	TELTAIRTY
IEITGAGGKKY	EITGGGKKY
WEVEVGDRSEW	VEVGDRSEW
EEAQKAQKHF	EEAQAQKHF
REIEQRHTM	REIEQRHTM
QEIYGIENKY	QEIYIENKY
AEFYHPAQEY	AEFYPAQEY
DEFHNPLAY	DEFHNPLAY
AENVPASKF	AENVPASKF
FEYDGKINAW	FEYDKINAW
EETECPLRL	EETECPLRL
AEHFLEQQM	AEHFLEQQM
LEVDLKNGY	LEVDLKNGY
KEELAQYQKW	EELAQYQKW
REGIIPANY	REGIIPANY
TEHDLLGTEAW	TEHDLGTEA
AEHPELRSY	AEHPELRSY
SEIILKKCF	SEIILKKCF
AEHDSELSF	AEHDSELSF
VELSPARSW	VELSPARSW
EELSKKSQKW	EELSKSQKW
SELDKLLSSF	SELDLLSSF
EEIQQRLAQF	EEIQRLAQF
SEVPKDSTHQW	SEVPSTHQW
GENRAVIHY	GENRAVIHY
AEDDIRQNF	AEDDIRQNF
QEKDVFERY	QEKDVFERY
IGGTDTLEGGW	GGTDLEGGW
RESETLKGSF	RESELKGSF
TEADVNPKAY	TEADNPKAY
QEFLDRNSQF	QEFLRNSQF
GESVIGKTY	GESVIGKTY
REIESSPQY	REIESSPQY
QEGLIPGSQFW	QEGLPGSQF
TEIAGMQRF	TEIAGMQRF
VEADDVRAW	VEADDVRAW
TEADAEKTF	TEADAEKTF
SEENVIREF	SEENVIREF
NESDGKSRW	NESDGKSRW
KELESIKETY	KELEIKETY
QEVQITEARCF	QEVQITEAR
NESEEVRQF	NESEEVRQF
AESSGQKSF	AESSGQKSF
EEGQLRPKTY	EEGQRPKTY
REDKIFQKF	REDKIFQKF
SIPGGYNAL	SIPGGYNAL
EEYLLRQVF	EEYLLRQVF
VEVAIGKGY	VEVAIGKGY
TEHEPTKMFY	TEHEPTKMF
EETLTTLRY	EETLTTLRY
VEATHVLPLHW	VEATHVLPL
REFSPEEGLYY	REFSPEEGL
EESPSHFTA	EESPSHFTA
AEVGGMQLRF	AEVGMQLRF
SEADQLGKIF	SEADLGKIF
TEITDDLHFY	TEITDLHFY
AEVEQKKKRTF	VEQKKKRTF
SENKMVPSEF	SENKVPSEF
VEEPSRPSASW	EEPSPSASW
TEYGLTFTEKW	TEYGFTEKW
NELVSTHGY	NELVSTHGY
EEVHDLERKY	EEVHLERKY
EEALHASHGF	EEALASHGF
RENTLLKTL	RENTLLKTL
EEEDRKHTW	EEEDRKHTW
NEDEIKKAY	NEDEIKKAY
RENTQTTIKLF	RENTTTIKL
IEADISKRY	IEADISKRY
AEGSAVKRM	AEGSAVKRM
EEAAVAIKAM	EEAAAIKAM
EELDLPAVFL	EELDLPAVF
NENPLRALY	NENPLRALY
FEIEELNRKY	FEIELNRKY
KEIKDVFAVY	KEIKVFAVY
SELEKTFGW	SELEKTFGW
HECASINRIY	HECAINRIY
QEVTQDLHY	QEVTQDLHY
EEQRPVQMMY	EEQRVQMMY
LEHPVLHVSW	LEHPLHVSW
EETAIGKKI	EETAIGKKI
AESASEAAKKY	AESAAAKKY
SELGSETRY	SELGSETRY
RELPDPLLTY	RELPPLLTY
REALPGPHYY	REALPGPHY
AEVLIQQGGL	AEVLQQGGL
EEPPTTLLW	EEPPTTLLW
NEFEATQKL	NEFEATQKL
TEEEKNFKAF	EEEKNFKAF
AEIDVIFKDF	AEIDIFKDF
DEIEEHNIKIY	DEIEHNIKI
SEHNTPVRSEW	SEHNPVRSE
EEDSSGHTRAY	EEDSHTRAY
EEPIYIITEY	EEPIIITEY
REQEAGLLQF	REQEGLLQF
EEFAEGSKI	EEFAEGSKI
CEAVNKQSF	CEAVNKQSF
LELGFSKVF	LELGFSKVF
AEWAIENPAVF	AEWANPAVF
REIQDEELKKF	REIQELKKF
AEEFVNVYY	AEEFVNVYY
AEKAVTKEEF	AEKATKEEF
RESKKIDRHMY	RESKIDRHM
TEIERLITW	TEIERLITW
HEVETAQGQRF	VETAQGQRF
AEAKESGPTTY	AEAKGPTTY
QEELAGLQRHW	EELALQRHW
VEGDPIVALSW	VEGDPIVAL
KELEDLNKW	KELEDLNKW
NENDIRVMF	NENDIRVMF
TENNIVKEEL	TENNVKEEL
KENEENQKSY	KENENQKSY
RESCDSALRAY	SCDSALRAY
KEFRKVVEY	KEFRKVVEY
AEFQGYNVLL	AEFQYNVLL
GENLPPLTY	GENLPPLTY
HESRQITQVY	HESRITQVY
SEVDEKRQVF	SEVDKRQVF
GEFAKVLEL	GEFAKVLEL
AEQELANLEKW	QELANLEKW
EEFPGGLTI	EEFPGGLTI
EHVLIPTLPPH	EHV-LIPTL
TEARCFYGF	TEARCFYGF
EEDEACGRQY	EEDECGRQY
RENDEEKVTF	RENDEKVTF
EELSPTAKF	EELSPTAKF
REAEGTAGGW	REAETAGGW
GEVLIDTHLF	GEVLDTHLF
HEILLHPRY	HEILLHPRY
KETISKKEF	KETISKKEF
LEAHETFNEW	LEAHTFNEW
QENEHIYNLW	QENEIYNLW
YEKNPDSHGY	YEKNDSHGY
EEWREAQRGF	EEWRAQRGF
EEAPLVTKAF	EEAPVTKAF
AEGGANKGY	AEGGANKGY
NEIADQVSREY	EIADVSREY
HEHPGNLNAW	HEHPNLNAW
QEQLPDLHSHF	QEQLDLHSH
MEDLGDKAVY	MEDLDKAVY
AERDVYTGDAL	AERDVYTGD
SETTAAHSL	SETTAAHSL
TESALEVVRKY	TESAVVRKY
EEEPEGGFSKW	EEPEGFSKW
GESSFTYRAY	GESSTYRAY
EEIERHLAY	EEIERHLAY
EETVSGLKGY	EETVGLKGY
DEARNLHSKW	DEARLHSKW
RESERAFTY	RESERAFTY
REAEGVIVGHW	AEGVIVGHW
NELPSAIKF	NELPSAIKF
KEADQKEQF	KEADQKEQF
QEISEIEKRY	QEISIEKRY
TENDHVLLFW	TENDHVLLF
DENEHQLSL	DENEHQLSL
AEVGDTIQVVF	AEVGTIQVV
EEVLAVFKSY	EEVLVFKSY
DEARDLIQRY	DEARLIQRY
REYELRKNNF	REYERKNNF
NELERNITI	NELERNITI
SEGYPGQRYY	SEGYPGQRY
AEAHAKVRL	AEAHAKVRL
QEYTEDLRKY	QEYTDLRKY
NEFLLPPVF	NEFLLPPVF
REIAEVNKKL	REIAVNKKL
NEASATKCI	NEASATKCI
DESDYALRY	DESDYALRY
LEELYTKKLW	EELYTKKLW
RENDTITIY	RENDTITIY
KELAEFLTF	KELAEFLTF
AEFEQKINRL	AEFEKINRL
QELLAEHY	QEL-LAEHY
AEASHVSRY	AEASHVSRY
AEPRPAEPPAW	AEPREPPAW
SEILYNNHKF	SEILNNHKF
SEIAQSRHY	SEIAQSRHY
DELYRVSKEY	DELYVSKEY
TEAARELGY	TEAARELGY
EEDPNTHILY	EEDPTHILY
NEVSVIKEGW	NEVSIKEGW
EEQSHPARLY	EEQSPARLY
SEFPGAQHY	SEFPGAQHY
MEVPTYLNF	MEVPTYLNF
SEHGGGAGNNW	SEHGAGNNW
EEYAEEFRTY	EEYAEFRTY
EELKETIKKL	EELKTIKKL
QEIEDKMKGF	QEIEKMKGF
EEALILDNKY	EEALLDNKY
YEEGSNKRLF	EEGSNKRLF
REAVTHIGRVY	REAVIGRVY
HEVPYTTSF	HEVPYTTSF
AEDLNTRVAY	AEDLTRVAY
EEVKPLEGRRY	EEVKEGRRY
EEFQILANSW	EEFQLANSW
GELSLPVHL	GELSLPVHL
AESAPAWRL	AESAPAWRL
AEQYTPKAKY	AEQYPKAKY
KENIQTTNY	KENIQTTNY
SEYSKQMQRF	SEYSQMQRF
DELELHQRF	DELELHQRF
VEGTIGDFKAY	VEGTDFKAY
GQPNYLLS	GQP-NYLLS
EENQVKKYH	EENQVKKYH
EEFLQVFDNDI	EEF--LQVF
GEHGDSSVAVW	GEHGSSVAV
VEVPFDLHRY	VEVPDLHRY
EEKERSASY	EEKERSASY
NELDAVQREY	NELDVQREY
VEAYNIKSNEW	VEAYNIKSN
EEADQLRALGW	EEADQLRAL
SEFVIPSVYW	SEFVIPSVY
SEGNRISGATF	SEGNSGATF
SEADAAAATF	SEADAAATF
SEIELFRVF	SEIELFRVF
REQHDAQVRLY	REQHAQVRL
KETYELRYF	KETYELRYF
YEDGSIRIF	YEDGSIRIF
NEHGNVPLHY	NEHGVPLHY
REWKEQGSKTF	KEQ-GSKTF
AEEKPIEIQW	AEEKIEIQW
QEVHPLLTL	QEVHPLLTL
GESSSRLGY	GESSSRLGY
TEIRIECKAY	TEIRECKAY
AENDFVHRI	AENDFVHRI
SELQARETF	SELQARETF
SETELKDTY	SETELKDTY
QESEVLERQM	QESELERQM
EEQAVRPKY	EEQAVRPKY
HEDPEVKFNW	HEDPVKFNW
EEFQKLQRQY	EEFQLQRQY
LEMTPQRGDVY	EMTPRGDVY
AEYDEEWAKKI	AEYDWAKKI
LEGNPDTHSW	LEGNDTHSW
AEAAEKLKNRY	AEAALKNRY
SEPVGIYQGF	SEPVIYQGF
AEVNSSGKTI	AEVNSGKTI
QEAPESATVIF	QEAPSATVI
SEEDGDHNRTF	EEDGHNRTF
DEHGYISRCF	DEHGISRCF
TETETIAKY	TETETIAKY
SEVQAILAF	SEVQAILAF
AEGLNLHTI	AEGLNLHTI
EEASIPKKL	EEASIPKKL
VEYEDESGHRY	YEDESGHRY
AESPAGHSF	AESPAGHSF
SEILLKEFL	SEILLKEFL
VESPVICKI	VESPVICKI
AEVDASVVREI	AEVDSVVRE
AEPPPSTVKTY	AEPPTVKTY
AEALSKMKL	AEALSKMKL
SEFLQPNRQF	SEFLPNRQF
LEDSVAKTF	LEDSVAKTF
RESPSVKRM	RESPSVKRM
SEEDYRTLTNY	EEDYTLTNY
REEQSHPARLY	EEQSPARLY
CEVTGGRSY	CEVTGGRSY
RELEGKTGF	RELEGKTGF
EEVKLIKKM	EEVKLIKKM
EEFDEVSRI	EEFDEVSRI
SEELDGLFRRY	EELDLFRRY
SEVRDPLVTY	SEVRPLVTY
QENIFPNRY	QENIFPNRY
SEMNTDKQY	SEMNTDKQY
QESPGAPSRTY	QESPPSRTY
SEADARIFKAW	SEADIFKAW
EEFLQQYNHY	EEFLQYNHY
SELAEDKENY	SELADKENY
GEHLPVGGFTY	GEHLPVGGF
QELTEAQKGF	QELTAQKGF
AEAITLAERKY	AEAIAERKY
EEYPLTRAF	EEYPLTRAF
SEEEYKKTY	SEEEYKKTY
SEAALEKKL	SEAALEKKL
QEENITRAL	QEENITRAL
AENPHSEYGL	AENPSEYGL
EEQLLKHGW	EEQLLKHGW
AETEPIVKM	AETEPIVKM
EEQVSTTERVF	EEQVTTERV
QEVIKAYGF	QEVIKAYGF
SEFDDEPKF	SEFDDEPKF
KEGIVFKSL	KEGIVFKSL
AEADKTIKVY	AEADTIKVY
TENELKFHY	TENELKFHY
EEIYAPKLQEF	EEIYKLQEF
AETVQTVRY	AETVQTVRY
KEVVFPLDI	KEVVFPLDI
EEFLRQEHF	EEFLRQEHF
QEQSYFVRL	QEQSYFVRL
EEFGRVKGHF	EEFGVKGHF
AEAELLNLRKI	AELLNLRKI
SEEQRFNNF	SEEQRFNNF
QEFEESLRL	QEFEESLRL
AELLNSKLPRW	AEL-LNSKL
EEINNMKTKF	EEINMKTKF
GEEEALRQY	GEEEALRQY
EETNIPKRLY	EETNPKRLY
NEFPNPAAHAL	NEFPAAHAL
FEAPIKLVF	FEAPIKLVF
EELLGLVVW	EELLGLVVW
KETDLLILF	KETDLLILF
MEIDIPHVW	MEIDIPHVW
QQSSLSLRW	QQSSLSLRW
QEERETQVAAW	EEREQVAAW
SEESAVPKRSW	EESAPKRSW
KETEIVKKL	KETEIVKKL
QEVYAQVARLF	QEVYQVARL
TEISELSHNF	TEISLSHNF
DEVLTSKGDAW	DEVLTSKGD
TEIAEERQY	TEIAEERQY
TENDQSTRF	TENDQSTRF
QEEAQYQREY	EEAQYQREY
SEEGAEDRTF	SEEGEDRTF
AETHYQLGL	AETHYQLGL
SEIGREKSQDW	SEIGREKSQ
REANQQQQF	REANQQQQF
HEVEQGIDAKW	VEQGIDAKW
IELGTACGKYY	IELGACGKY
AESVVPARM	AESVVPARM
SEINIAPRI	SEINIAPRI
EEAQYQREY	EEAQYQREY
EEVDQVARAY	EEVDVARAY
KEDLVFIFW	KEDLVFIFW
SEVTASSRHY	SEVTSSRHY
EEIKEKVHKY	EEIKKVHKY
AEIKIIREAY	AEIKIREAY
AESVGAKHY	AESVGAKHY
REAANFKLKY	REAAFKLKY
SEALKDRHW	SEALKDRHW
EEDGEIISHQY	EEDGISHQY
QEQESEAQRY	QEQEEAQRY
QEIDEQRTKY	QEIDQRTKY
AENSSKSNQY	AENSKSNQY
LEIASLYIL	LEIASLYIL
AEDKENYKKFY	AEDKNYKKF
VENILAKRL	VENILAKRL
REQELDQHKVW	QELDQHKVW
DENGLIIVW	DENGLIIVW
SEAGSHTLQSM	SEA-GSHTL
EESQPAKKTY	EESQAKKTY
MELDGPKGTGY	MELDGPKGT
AEALSQAVARY	AEALAVARY
VENTDEAQKKF	VENTAQKKF
EEIFGTIGM	EEIFGTIGM
AEKVIGAGKSW	AEKVAGKSW
AELRGVEGF	AELRGVEGF
QEIERLNKLL	QEIELNKLL
AENKDEIAL	AENKDEIAL
QELNDRFANY	QELNRFANY
VEDGSVKMF	VEDGSVKMF
REGEGSDKW	REGEGSDKW
QELLIYEAF	QELLIYEAF
EELQAVQKI	EELQAVQKI
EEAPKVFKM	EEAPKVFKM
AEGEPRYAL	AEGEPRYAL
NELIYKRGY	NELIYKRGY
VEITELPVRTW	TEL-PVRTW
EEAQIIQRRL	EEAQIQRRL
TESQLQSHF	TESQLQSHF
SEIGGITIAW	SEIGITIAW
SEAPSGESRKF	SEAPESRKF
VEYENVRQEY	VEYEVRQEY
EEQQRLLLY	EEQQRLLLY
EEYRGFTQDF	EEYRFTQDF
AEVIILPKKH	AEVILPKKH
AEAEAVREVY	AEAEVREVY
SEAEHQRAY	SEAEHQRAY
KEVDVSKQL	KEVDVSKQL
NELPGLKW	NEL-PGLKW
AEAIRKIGF	AEAIRKIGF
SEAPNEKLFF	SEAPNEKLF
EEHTAVYTAW	EEHTVYTAW
AEEKATGKLF	AEEKTGKLF
EEIDHAVHL	EEIDHAVHL
SEHLDPKLL	SEHLDPKLL
AEALGIVPLQY	AEALVPLQY
EEHLESHKKY	EEHLSHKKY
SESNIIRHY	SESNIIRHY
NELGVGGTSQW	NELGGTSQW
REAPEELLAY	REAPELLAY
AEIRYEGILY	AEIREGILY
EEVSEKKSY	EEVSEKKSY
AELVHFLLL	AELVHFLLL
VEAVSFQHF	VEAVSFQHF
SEVTDPEKGF	SEVTPEKGF
SEAAINRQI	SEAAINRQI
TEVQVFKKY	TEVQVFKKY
AEFEEPRVI	AEFEEPRVI
RESDQLFKQY	RESDLFKQY
QELLTIAERW	QELLIAERW
EEEHITKIYY	EEEHITKIY
TEVITGTLW	TEVITGTLW
QEVTNNLEF	QEVTNNLEF
KEDAEKFRQW	KEDAKFRQW
EEHIHIQQW	EEHIHIQQW
RESGTIQRY	RESGTIQRY
QEAEAAQRL	QEAEAAQRL
EESFIPLTI	EESFIPLTI
HENNVSRSL	HENNVSRSL
AEDLVVTKY	AEDLVVTKY
IEFPGGKETW	IEFPGKETW
SELLGLLKTY	SELLLLKTY
EETGVRVEL	EETGVRVEL
SEGYPGKRY	SEGYPGKRY
RELNGTYAI	RELNGTYAI
EEVGPSDHF	EEVGPSDHF
DEAAISKLY	DEAAISKLY
DDQENTLKY	DDQENTLKY
EEVVSVLHVF	EEVVVLHVF
EEIPVSSHYF	EEIPVSSHY
TEASASNRF	TEASASNRF
EELIESPKL	EELIESPKL
EEVESLNRKY	EEVELNRKY
SENGSRNTY	SENGSRNTY
QEEPGKGSFW	QEEPGKGSF
AERLADKY	AER-LADKY
GFSMLDFLSER	SMLDFLSER
EESILSRNY	EESILSRNY
DEDTGTFRIY	DEDTTFRIY
GEVDDSREHSF	GEVDDSREH
RELNEKLEY	RELNEKLEY
MEHANQQTGF	MEHAQQTGF
DEHEGPALY	DEHEGPALY
REAERLVKY	REAERLVKY
DEMVSLKDY	DEMVSLKDY
NENSLFKSL	NENSLFKSL
EEPQHVLLRY	EEPQVLLRY
TEFRAQPLAY	TEFRQPLAY
QETGIRTGY	QETGIRTGY
QEKDVFERYY	QEKDVFERY
DETGVLKGF	DETGVLKGF
HEVDKSELKDF	HEVDELKDF
KEHDILSQL	KEHDILSQL
KETPLVDTL	KETPLVDTL
EESFFILKY	EESFFILKY
NENNITALVT	NENNITALV
TESPLVKAI	TESPLVKAI
REQILMKRF	REQILMKRF
SEDGLLKLW	SEDGLLKLW
EEGLVNNKY	EEGLVNNKY
AEASMISKL	AEASMISKL
EELRVSKVF	EELRVSKVF
REANLQALI	REANLQALI
AEAHARIHL	AEAHARIHL
GEGDTVRCF	GEGDTVRCF
EEVGYAIRF	EEVGYAIRF
REGDPLILQY	REGDLILQY
AEDGTTSKY	AEDGTTSKY
KESDIITAF	KESDIITAF
NEDEDSPNKLY	NEDESPNKL
SELLDKFTW	SELLDKFTW
EEHQSALEL	EEHQSALEL
TENDKEYQEY	TENDEYQEY
YESPRKICY	YESPRKICY
ENPEYLSEF	ENPEYLSEF
QENDDVLLKRL	QENDLLKRL
HEFDGDEQF	HEFDGDEQF
HENQTKPSI	HENQTKPSI
EELPSEKNLEY	EELPSEKNL
EEIDDVTRQL	EEIDVTRQL
EENIQTLLI	EENIQTLLI
RELSAPARLY	RELSPARLY
EEAQFETKKLY	EEAQETKKL
QELNKILRSW	QELNILRSW
EEIPVSSHY	EEIPVSSHY
VEAYNIRTDSW	VEAYNIRTD
QEQEIEHHL	QEQEIEHHL
SEGTPEKPLY	SEGTEKPLY
SENKIVGIGY	SENKVGIGY
SENQNAQRI	SENQNAQRI
EERVINEEY	EERVINEEY
AEKEISLWF	AEKEISLWF
KESGICTGW	KESGICTGW
NEIKDSVVAGF	NEIKVVAGF
SESQSSKSAY	SESQSKSAY
AEVTLKTYW	AEVTLKTYW
EEIGSRNFF	EEIGSRNFF
EEIDEIRKSY	EEIDIRKSY
AEGIGTGW	AEG-IGTGW
TEFTPTEKDEY	TEFTEKDEY
MEPDIIRMY	MEPDIIRMY
AEFPDHLGGGY	AEFPLGGGY
TELERAFGYY	TELERAFGY
PPYTVVYFPVR	TVV-----Y
GEVDVRSAY	GEVDVRSAY
REIGSQAVW	REIGSQAVW
REAAYTKRL	REAAYTKRL
AEVNQETIQRL	AEVNTIQRL
QEILNQNFSEV	QEI-LNQNF
NEAPGPINF	NEAPGPINF
EESGARINI	EESGARINI
SEIESNRSF	SEIESNRSF
VETAQNHQW	VETAQNHQW
AEPDFVVTDF	AEPDVVTDF
DEMSQDIVKY	DEMSDIVKY
AESAQSNRL	AESAQSNRL
QEEGANTRAW	EEGANTRAW
VCNRFHAFLLY	NRFHAFLLY
EENKIDRTF	EENKIDRTF
AENPSIQLL	AENPSIQLL
KELAEAASKW	KELAAASKW
EESQIRIEL	EESQIRIEL
DELDAIGTKRF	DELDGTKRF
EEILKVEQKY	EEILVEQKY
RELDKVLQKF	RELDVLQKF
SEKAGIIQDTW	SEKAIQDTW
IEKPPVGTW	IEKPPVGTW
AEVLGLILRY	AEVLLILRY
TEIDHWLEF	TEIDHWLEF
QEIFTEKVL	QEIFTEKVL
EESSRDASRKW	EESSASRKW
VEDELVKKY	VEDELVKKY
KEEQFKQVF	KEEQFKQVF
REFEQLNRNF	REFELNRNF
GEHGDSSVPVW	GEHGSVPVW
REAQTLQQY	REAQTLQQY
QELLQTQDF	QELLQTQDF
EEAVGNIVKF	EEAVNIVKF
EEVRQGLKAY	EEVRGLKAY
EEEEGAVRW	EEEEGAVRW
SEFIINNRNY	SEFINNRNY
KELISGHGF	KELISGHGF
AEVTTDDRAY	AEVTDDRAY
AEIGYRNSL	AEIGYRNSL
AEAKARAEI	AEAKARAEI
EELQAVDSQKY	EELQDSQKY
NEVQYDQRLF	NEVQDQRLF
RELEESKYQY	RELESKYQY
SEAYIDARTL	SEAYDARTL
EEMETDARSSL	METDARSSL
QENPFFRKL	QENPFFRKL
QELDLSNNHL	QELDSNNHL
REEQKNLHFF	REEQKNLHF
RELDLSGQGF	RELDSGQGF
DEVSPLLKQY	DEVSLLKQY
AESIVVHTY	AESIVVHTY
DEFDGKVTY	DEFDGKVTY
SELDEEQHL	SELDEEQHL
KEIDSVKYL	KEIDSVKYL
EELGFRPEY	EELGFRPEY
REDEVRLLKY	REDERLLKY
AEDCEFIQRF	AEDCFIQRF
AENESKARV	AENESKARV
TEAALLKKL	TEAALLKKL
AEQAAQRY	AEQ-AAQRY
AELRYDLPASY	AELRLPASY
TEHPNTIQEY	TEHPTIQEY
DEVSFIKKL	DEVSFIKKL
QEFEHVNGRW	QEFEVNGRW
EEIRNLTVKDF	EEIRTVKDF
KEERAVIKAY	KEERVIKAY
QEESLRTYLF	EESLRTYLF
AETDTPNRATF	AETDNRATF
AEVRGAEIEY	AEVRAEIEY
TEHQQLEGWRW	TEHQQLEGW
AEHGDQDYIW	AEHGDQDYI
AEHLGDFHRTY	AEHLFHRTY
QELIGKKEY	QELIGKKEY
SESLFVSNHAY	SESLSNHAY
AEIDLRQGRLL	AEIDRQGRL
QESLDRPSY	QESLDRPSY
SENQSLLR	SEN-QSLLR
EEQLKVHGF	EEQLKVHGF
AEDAIYGRNGY	AEDAGRNGY
REAWASKDATY	AWASKDATY
SEEEMARTF	SEEEMARTF
AELGIRHVL	AELGIRHVL
SEIVGKRI	SEI-VGKRI
KESEVKREF	KESEVKREF
AEALLHPFF	AEALLHPFF
VNLPINGNGKQ	VNLPNGNGK
VETAQGQRF	VETAQGQRF
EERADLIAY	EERADLIAY
LEQDPEGLHLW	LEQDEGLHL
DEIYDCKVEHW	DEIYCKVEH
AEVAAKNQSL	AEVAKNQSL
KELERLTSLY	KELELTSLY
SEIDKRVQY	SEIDKRVQY
EEAQFETKKY	EEAQETKKY
AEDENGKIVGY	DENGKIVGY
KEDGIVPLRY	KEDGVPLRY
KEFEGATLRY	KEFEATLRY
AEHSTVITF	AEHSTVITF
QEIEEFKERL	QEIEFKERL
CEQIVRKDF	CEQIVRKDF
EEVIFPNNF	EEVIFPNNF
EEMDASIKKM	EEMDSIKKM
EEVQVDPRKY	EEVQDPRKY
NETSTGKTF	NETSTGKTF
LPDTQTARVW	LPDTTARVW
MENIHSEMY	MENIHSEMY
KENDFDRLVL	KENDDRLVL
SEGNKSLSF	SEGNKSLSF
REVEIQSHL	REVEIQSHL
AEFEVHEVY	AEFEVHEVY
SEDTAKAGF	SEDTAKAGF
EEVQRKLGF	EEVQRKLGF
REAFLVPAY	REAFLVPAY
SENNRIFTL	SENNRIFTL
SEIEKLSAAF	SEIELSAAF
GEAGGESTKGY	GEAGSTKGY
GEIKVLQGF	GEIKVLQGF
KEALQKAREW	KEALKAREW
EEIPKRETY	EEIPKRETY
SEAAAPRAF	SEAAAPRAF
REALAGRAY	REALAGRAY
AEAYLGKKV	AEAYLGKKV
AEESDLSRQY	EESDLSRQY
GENGTGKTTF	GENGGKTTF
YEHEKDLVW	YEHEKDLVW
REQGQPWKW	REQGQPWKW
AESELSLPEK	AESESLPEK
AEMETQKEKI	AEMEQKEKI
KEGDFVLRF	KEGDFVLRF
SEALGRAVGQW	SEALRAVGQ
EEFGAMREQY	EEFGMREQY
NEVDGEYRY	NEVDGEYRY
EEAAIAVEKY	EEAAAVEKY
EEAKAKGTF	EEAKAKGTF
GEVEQQRTY	GEVEQQRTY
EEEPLNIHSF	EEEPNIHSF
QEDQGLTKDY	QEDQLTKDY
RENLSKDLY	RENLSKDLY
EDLEKKYANET	EDL--EKKY
AEIEQAASRL	AEIEAASRL
VENNPAIKW	VENNPAIKW
TESQQIRYF	TESQQIRYF
AEERAEAKKKF	EERAAKKKF
SEDEPLWKKY	SEDELWKKY
SESDLNHSF	SESDLNHSF
HEIYTRDGNSY	HEIYDGNSY
EEFDRFTGY	EEFDRFTGY
TEHSVLIHEY	TEHSLIHEY
DETDSGAGLKW	DETDSGAGL
AELGLEIPAY	AELGEIPAY
KESEVFYEL	KESEVFYEL
KEVDETRKCY	KEVDTRKCY
SEDNIMQVW	SEDNIMQVW
DEHEGPALYY	DEHEPALYY
QELDRVFQKL	QELDVFQKL
TEATEVSKKF	TEATVSKKF
KEDLLQADF	KEDLLQADF
NEEEVEKRF	NEEEVEKRF
AEYVHGSQAW	AEYVGSQAW
SEEPGIIPRF	SEEPIIPRF
HLPETKFSEL	SEL------
NEHNVALFKHF	NEHNLFKHF
TEAEVRGLCI	TEAERGLCI
QEAESAVRL	QEAESAVRL
AEDRELLKAY	AEDRLLKAY
QEIDEMNQKL	QEIDMNQKL
REENDQSTHKW	EENDSTHKW
EEVKVSREM	EEVKVSREM
TEEDIHRAF	TEEDIHRAF
GEVNDIKTRSW	EVNDKTRSW
KEISNVSSF	KEISNVSSF
EEMLEIRQL	EEMLEIRQL
EEFEKALVWY	EEFEKALVW
AETRAGLTL	AETRAGLTL
QEIYGGSDSRF	QEIYSDSRF
EERAVIKAY	EERAVIKAY
SEIDQRDKY	SEIDQRDKY
EEFNELLSKY	EEFNLLSKY
NESNSRISW	NESNSRISW
AESPERVLL	AESPERVLL
VEILQEREY	VEILQEREY
KEWEQDLKSL	KEWEDLKSL
SESSVKVRL	SESSVKVRL
SEDVIARTY	SEDVIARTY
AELMNRPEVTY	AELMNRPEV
EEIPNLENSNF	EEIPLENSN
EEHPELQQF	EEHPELQQF
SEPDNLVITW	SEPDLVITW
AEGEIYTKL	AEGEIYTKL
VENPTSIKL	VENPTSIKL
AEELFARKF	AEELFARKF
REFPDRLVGY	REFPRLVGY
FEDETVRKF	FEDETVRKF
AELTKVFEI	AELTKVFEI
SEIEAKVRY	SEIEAKVRY
AEDGPTTRF	AEDGPTTRF
KEDATKGKFAF	KEDATKGKF
AENPDTPAL	AENPDTPAL
AEGAPQKEVY	AEGAQKEVY
TEAGLKVVGY	TEAGKVVGY
AEGTAQQRL	AEGTAQQRL
KEFEEARKW	KEFEEARKW
HEERFLKNIGW	EERFKNIGW
QEKPEGRPSF	QEKPGRPSF
RELDLQRNY	RELDLQRNY
AEIKADKEKGF	AEIKKEKGF
QEHARHISF	QEHARHISF
AEKPLETRTY	AEKPETRTY
EESTAFRY	EES-TAFRY
QEIGGPRSY	QEIGGPRSY
SEGYPGKRYY	SEGYPGKRY
SEIENVHGF	SEIENVHGF
SEQDVQKAL	SEQDVQKAL
SENSRVSHY	SENSRVSHY
AEAGSGGPGF	AEAGGGPGF
SEYAAQDQKF	SEYAQDQKF
AEQQDSGRLY	AEQQSGRLY
QEQEQLLKEGF	QEQLLKEGF
GEAALNDPKMY	GEAANDPKM
EEIKQSHSF	EEIKQSHSF
KEVSSVSRM	KEVSSVSRM
REEELKELKEY	EELKELKEY
AEGQTSINKTF	AEGQINKTF
GEFLGNRQKQF	GEFLRQKQF
AENEKLKAQL	AENELKAQL
LEHSFIKRY	LEHSFIKRY
SEAKAFHDY	SEAKAFHDY
AEQAVFILF	AEQAVFILF
EEDNPVIRSY	EEDNVIRSY
EEVVNDRSW	EEVVNDRSW
AEALHAHGY	AEALHAHGY
QEIDSGISTHL	QEIDSGIST
KEINNPESVYY	KEINPESVY
DEIGLPKIF	DEIGLPKIF
KEFVTHPKW	KEFVTHPKW
YEWDVAEARKI	AEA---RKI
VEQGIDAKW	VEQGIDAKW
SEDNPQTLLF	SEDNQTLLF
EEEQENGKAY	EEQENGKAY
GEAVVNRVF	GEAVVNRVF
KESENVVCHFY	KESEVVCHF
KEIGDQKLLL	KEIGQKLLL
TEQSVDYRHKF	TEQSYRHKF
HEQWVNEDRHY	NED---RHY
QEHTPVALEAY	QEHTALEAY
SENPAKRLY	SENPAKRLY
KESSTVFEL	KESSTVFEL
TELLIRKLPF	TEL-LIRKL
DESQVVTRY	DESQVVTRY
AEQEDRALRSF	QEDRALRSF
NEVEKCTKY	NEVEKCTKY
EETLSTLRY	EETLSTLRY
RENPLELRL	RENPLELRL
LEEGGIRAY	LEEGGIRAY
AEVAAEKSF	AEVAAEKSF
DESIIPKKY	DESIIPKKY
RESETTKGAY	RESETKGAY
REQDAEGQDY	REQDEGQDY
SESAQSKML	SESAQSKML
AEQDIREEI	AEQDIREEI
QEDEVMRAY	QEDEVMRAY
QENGPTAKAY	QENGTAKAY
TEADVGITKF	TEADGITKF
EELNLSGNKL	EELNSGNKL
