Data	Data aligned
KTFEEIWKF	KTFEEIWKF
KANPGYKW	KANP-GYKW
RAAPFSLEY	RAAPFSLEY
KSMYGVYNTF	KSMYVYNTF
RGGPFQRW	RGGP-FQRW
KAIEENNNF	KAIEENNNF
YMDPTGKTRTW	PTGK-TRTW
KAMVFLEYF	KAMVFLEYF
KSFPDTGSLNL	KSFPDTGSL
YAGPEVDIW	YAGPEVDIW
SASEVLKEW	SASEVLKEW
SAQGSESHSL	SAQGESHSL
HTFFDHQDQVW	HTFFQDQVW
RSLPDPNLITF	RSLPDPNLI
RAADVLVYL	RAADVLVYL
HTSSTTSAW	HTSSTTSAW
SSSSIEVHW	SSSSIEVHW
KSIPVTQEL	KSIPVTQEL
VGLPAAGKTTW	LPAAGKTTW
RTTDLLTDW	RTTDLLTDW
VTIRDYGVSW	VTIRYGVSW
KTRWIIEKY	KTRWIIEKY
KSNEDLHKLW	KSNELHKLW
KTFTGHREW	KTFTGHREW
RVENVKGAVW	RVENKGAVW
ISEKQHEVYW	ISEKQHEVY
HSDMIYNVSW	HSDMYNVSW
ATLKNPILW	ATLKNPILW
QSDPSGAYFAW	QSDPSGAYF
FVAVEREEW	FVAVEREEW
SAAPTFMI	SAAP-TFMI
ITNHIHVRI	ITNHIHVRI
DPDEVARRW	DPDEVARRW
RGADIDQQW	RGADIDQQW
KILPFSPEF	KILPFSPEF
VSSDVQSVF	VSSDVQSVF
RSYDYQFRY	RSYDYQFRY
RSLGVHLSF	RSLGVHLSF
LSHKGNEFW	LSHKGNEFW
KVLPIIQRW	KVLPIIQRW
KAAKDKGFAKW	KAAKGFAKW
VSAPAGGKASW	VSAPGKASW
AAFNKDALLNW	AFNKALLNW
RSTQITVRF	RSTQITVRF
ATGHHYTW	ATGH-HYTW
SSPTSPNAL	SSPTSPNAL
RVHPETYEW	RVHPETYEW
TSLPDTDTW	TSLPDTDTW
VSNRNKLKW	VSNRNKLKW
SAIRYQEVW	SAIRYQEVW
KSFDNIRNW	KSFDNIRNW
SSAKTILKY	SSAKTILKY
RSIGWGEEF	RSIGWGEEF
KALSMPEKW	KALSMPEKW
HSNGTVSLW	HSNGTVSLW
MTWSHNDMW	MTWSHNDMW
QATGTSRW	QATG-TSRW
HSGPFFTF	HSGP-FFTF
RIILDKLNW	RIILDKLNW
VSLEWLQKW	VSLEWLQKW
KTVEPLEYY	KTVEPLEYY
VSHPNEVSW	VSHPNEVSW
YSGLSVSW	YSGL-SVSW
RLFVGEPVW	RLFVGEPVW
ITAGAHRLW	ITAGAHRLW
KTLTDISNQW	KTLTISNQW
FSFKKSFKL	FSFKKSFKL
GTDGHPFGW	GTDGHPFGW
LAASVISKW	LAASVISKW
RTLMENQHW	RTLMENQHW
KITDVIIGF	KITDVIIGF
QTVSPAEKW	QTVSPAEKW
RSGQNGNQTW	RSGQGNQTW
GLSSILDAARW	SSILDAARW
KAIEKNVLF	KAIEKNVLF
ASIKDPKDLKF	ASIKKDLKF
KTLPDILTF	KTLPDILTF
GGLPERSVSL	GGLPRSVSL
RSVTQAGVQW	RSVTAGVQW
RGFGSFRF	RGFG-SFRF
RSVLHHFHF	RSVLHHFHF
SSSSVRVEW	SSSSVRVEW
KSTDVAKTF	KSTDVAKTF
LSDSPGPTW	LSDSPGPTW
KSLPEEDVAEI	KSLPDVAEI
RTLRDIETF	RTLRDIETF
AREGNHKPIDY	REGNKPIDY
LVHAVQALW	LVHAVQALW
KSIEERVTI	KSIEERVTI
RAIFLPQAW	RAIFLPQAW
KANHFLILF	KANHFLILF
HAATIRLIF	HAATIRLIF
KSAPELKTGI	KSAPLKTGI
KTNQVKMKY	KTNQVKMKY
LTAPSSPGSSW	PSSP-GSSW
ATNVNNWHW	ATNVNNWHW
RSSTPLPTI	RSSTPLPTI
KSQPLVHLM	KSQPLVHLM
HSMDPPTFTF	HSMDPTFTF
QTIRLPAQSIW	IRLPAQSIW
RVVELQQTL	RVVELQQTL
ATNRITVTW	ATNRITVTW
ISADTHQF	ISAD-THQF
KMAPPDLPHW	KMAPDLPHW
HSFNQSSSSQW	SFNQSSSQW
ISMPAQNLW	ISMPAQNLW
MTNGFHMTW	MTNGFHMTW
ITTSLTTKW	ITTSLTTKW
NSGPVVAMVW	NSGPVAMVW
RMAPPQNQW	RMAPPQNQW
KISLISEKW	KISLISEKW
KIETVNESW	KIETVNESW
RAVGLVSTW	RAVGLVSTW
QSVHFQTIF	QSVHFQTIF
LTNKGELFVW	LTNKELFVW
YTVGAPHTW	YTVGAPHTW
ITLPTEASTW	ITLPEASTW
LSNKISPLM	LSNKISPLM
KTNEMLLNF	KTNEMLLNF
KSFADINLY	KSFADINLY
DTGRPSTTVRY	TGRPTTVRY
HTNEVNAIKW	HTNENAIKW
TTSKTDQRW	TTSKTDQRW
VSVDKQQQW	VSVDKQQQW
HSYPNPEYDNW	HSYP-NPEY
SSTPIAPVF	SSTPIAPVF
KSIVQVETL	KSIVQVETL
KSTSGLTDITW	TSGLTDITW
MAFQNDVYEW	MAFQDVYEW
RMFLENETW	RMFLENETW
RTAKLQVTL	RTAKLQVTL
KSFENISKW	KSFENISKW
ITNKYQLVF	ITNKYQLVF
KVINETWAW	KVINETWAW
RSNNINTLF	RSNNINTLF
ISDPDVRHTW	ISDPVRHTW
AVNPRDPPSW	AVNPDPPSW
ASVTEIQEKW	ASVTIQEKW
VAVTKDPNW	VAVTKDPNW
QALISQHLW	QALISQHLW
VSMIFPFHW	VSMIFPFHW
KAGQTVTIW	KAGQTVTIW
HSTKLIQEW	HSTKLIQEW
FSLPNIPRW	FSLPNIPRW
RSMGLPLQF	RSMGLPLQF
KSSDKQLRI	KSSDKQLRI
FSTKSDVW	FSTK-SDVW
YTNRVVTLW	YTNRVVTLW
KAIELLQEF	KAIELLQEF
VSVPYVFRY	VSVPYVFRY
KSFPHPIDKW	KSFPPIDKW
AVMTPQELW	AVMTPQELW
RSNPKLKDLYI	RSNPLKDLY
KSLPEFPDSGF	KSLPFPDSG
HSGPGLLQLW	HSGPLLQLW
ISAKNGVQW	ISAKNGVQW
RMLSFQQMTW	LSFQ-QMTW
RVHKDGSLW	RVHKDGSLW
RLFDEGTISKW	LFDETISKW
RSYSESEKQW	RSYSSEKQW
RSAPPGPFAW	RSAPGPFAW
MSESELGRKW	MSESLGRKW
LSVPSPFTW	LSVPSPFTW
LVAEVPKEHW	LVAEPKEHW
KSIDDTSNF	KSIDDTSNF
VSLQASSGHMW	QASS-GHMW
LAVGDNNSKW	LAVGNNSKW
SADRFVYVW	SADRFVYVW
KAYDRVEQEW	KAYDVEQEW
ASTLIVGHW	ASTLIVGHW
RSFFHQHYL	RSFFHQHYL
KVLELFESF	KVLELFESF
KAVEAAHTF	KAVEAAHTF
RGVGDIKILW	RGVGIKILW
RTAHVILRY	RTAHVILRY
ATYMKPEMW	ATYMKPEMW
SAVKVLMKF	SAVKVLMKF
KSVIDYQTHF	KSVIYQTHF
LTSPDSEKW	LTSPDSEKW
MSLPYRLVF	MSLPYRLVF
TFTKIVNKW	TFTKIVNKW
KTNSLPLRF	KTNSLPLRF
YAPKGSSL	YAPK-GSSL
PAASSFGSPG	AASSFGSPG
RTMEIESTF	RTMEIESTF
KSFVLPSW	KSFV-LPSW
KLIDVTNIYW	KLIDTNIYW
LSSPDYQIRW	LSSPYQIRW
KFIEIDQAW	KFIEIDQAW
STLRELGQTW	STLRLGQTW
RAIAALSFW	RAIAALSFW
KALKGQFNF	KALKGQFNF
RTNPNSGDFRF	RTNPNSGDF
YAPSGNYV	YAPS-GNYV
AVGPTFSF	AVGP-TFSF
KSFIQKKMQNW	KSFI-QKKM
RSIPVWIKI	RSIPVWIKI
HSVDQSWSW	HSVDQSWSW
KSLLKIFAW	KSLLKIFAW
NSASSHNW	NSAS-SHNW
KAVEVHVLL	KAVEVHVLL
RSVAQAGVQW	RSVAAGVQW
FSLSVFHHW	FSLSVFHHW
KLPVHTEISW	KLPVTEISW
IAAPDSRRW	IAAPDSRRW
LSTTVQPNL	LSTTVQPNL
YSVKGQEDGW	YSVKQEDGW
RTMNIKSATW	RTMNKSATW
ISSQTTERF	ISSQTTERF
FSFAEVHSW	FSFAEVHSW
QINAKVAEW	QINAKVAEW
LTGPWKLW	LTGP-WKLW
AAWRDEDDYTW	AAWRDDYTW
LMDPSGNAHKW	PSGN-AHKW
RSSDSWEVW	RSSDSWEVW
HSMSDPGVSY	HSMSPGVSY
RTAKALQAHW	RTAKLQAHW
LSFGDAAQTLW	LSFGAAQTL
KASGFEESMKW	ASGFESMKW
YSLMSSEKW	YSLMSSEKW
TTLVDNNTW	TTLVDNNTW
KSINDYNTW	KSINDYNTW
RAIQINPAF	RAIQINPAF
KAGLTHII	KAGL-THII
VVMPIAHEF	VVMPIAHEF
MTDPKLITW	MTDPKLITW
LSQPKIVKW	LSQPKIVKW
RTFPDPTSW	RTFPDPTSW
HSYFWPLEW	HSYFWPLEW
KSFNSVHLL	KSFNSVHLL
LSGATVTLW	LSGATVTLW
SAGQAWKW	SAGQ-AWKW
IVDPNGLARLW	IVDPGLARL
RAAIMQALW	RAAIMQALW
ITYDKLNKW	ITYDKLNKW
KTDPVDIYKSW	KTDPIYKSW
KSEEITTGSAW	KSEETGSAW
SIHLQHKF	SIHL-QHKF
LAHGADVNW	LAHGADVNW
RSLKDHKVSF	RSLKHKVSF
KIIEDLGVHF	KIIELGVHF
ATIKEIVVW	ATIKEIVVW
RVLPYPFTHHW	RVLPYPFTH
MAIVGTHKF	MAIVGTHKF
PQTLLQMS	PQTL-LQMS
TAAETHYTY	TAAETHYTY
SSLKKKQIW	SSLKKKQIW
KANSSVGKW	KANSSVGKW
LTIATGTGNW	LTIAGTGNW
KSLGVHYVF	KSLGVHYVF
ATDGKVLLW	ATDGKVLLW
RSVDVTNTTF	RSVDTNTTF
HTLDDRTQLW	HTLDRTQLW
AVSTIETVPYW	STIETVPYW
HSISPQMW	HSIS-PQMW
LANKLYERW	LANKLYERW
VSDPLSDLKW	VSDPSDLKW
LADKVNSSW	LADKVNSSW
RGYPDSESTW	RGYPSESTW
TSDPLARLQMF	TSDP-LARL
RALGWGSLYAW	RALGWGSLY
RVFLMDPAW	RVFLMDPAW
LSNLESTHW	LSNLESTHW
RAVKVLQLF	RAVKVLQLF
RTRNEELAQTW	RNEELAQTW
ASYSGKAADVW	YSGKAADVW
VSIRDILSW	VSIRDILSW
SSDTTVKVW	SSDTTVKVW
ITTVIQHVF	ITTVIQHVF
HAGPIVSVW	HAGPIVSVW
STAPGYYSW	STAPGYYSW
VSFPDVEKAEW	VSFPEKAEW
VLDPHTSHSW	VLDPTSHSW
SVTEIQEKW	SVTEIQEKW
GTAPAYSF	GTAP-AYSF
RSLPIVFDEF	RSLPVFDEF
QSAKTQIKL	QSAKTQIKL
YSESLVHESW	YSESVHESW
KSNNVEMDW	KSNNVEMDW
ASTQPTHSW	ASTQPTHSW
HSNPGDPALW	HSNPDPALW
KSDDFGQTW	KSDDFGQTW
KSMPTVTQI	KSMPTVTQI
SASKPLASW	SASKPLASW
KSIDAGPVDAW	KSIDPVDAW
KGWRDVTTF	KGWRDVTTF
KAWKALEI	KAWK-ALEI
KTHEITQLESW	KTHEQLESW
HTAPNVPHY	HTAPNVPHY
GSASVNSRW	GSASVNSRW
KTAAEQFKF	KTAAEQFKF
AVSAVASQW	AVSAVASQW
RVFDLPLTW	RVFDLPLTW
KAGLASRW	KAGL-ASRW
HTNQDHVHAVW	HTNQVHAVW
KAASVRPVL	KAASVRPVL
KSSDVYVSY	KSSDVYVSY
MSERQVALW	MSERQVALW
RTINDQDFFLY	RTINDQDFF
FSQPEVQLW	FSQPEVQLW
ISASSLTSKW	ISASLTSKW
RAAKPEQIQKW	AAKPQIQKW
HSNPEGSSW	HSNPEGSSW
ASRDTVIVW	ASRDTVIVW
ISSSDLVSKW	ISSSLVSKW
SIPEKNRPL	SIPEKNRPL
KVNKIEIHY	KVNKIEIHY
VTSPLTVEW	VTSPLTVEW
ASINPLNDHW	SINPLNDHW
SSFASHKW	SSFA-SHKW
KTVYTGIDHHW	TVYTIDHHW
KAGPGLKRW	KAGPGLKRW
ITFAPTYRF	ITFAPTYRF
RSQVVLYTL	RSQVVLYTL
RSYSQQLFL	RSYSQQLFL
KSTVNGVSW	KSTVNGVSW
VSILESLDKW	VSILSLDKW
RSFLTKLEW	RSFLTKLEW
KALKEKEKASW	KALKEKEKA
ATGPSIKI	ATGP-SIKI
ASFSDYYYKW	ASFSYYYKW
VAGKTYRW	VAGK-TYRW
KGFTDADNTW	KGFTADNTW
IAPTGHSL	IAPT-GHSL
KSYPNEEKDAW	KSYPNEEKD
KSKGSQTEEW	KSKGQTEEW
ATVKDDLTKW	ATVKDLTKW
KAGQVVTIW	KAGQVVTIW
SINPNNHSW	SINPNNHSW
KATPIKLIW	KATPIKLIW
KSTTESYVF	KSTTESYVF
TTYKLVINGK	TTYKLVING
KTLPFYKDYF	KTLPYKDYF
RTTLVDNNTW	RTTLDNNTW
ASGNVSWLW	ASGNVSWLW
RSLNQTGVQW	RSLNTGVQW
TVYVDDASW	TVYVDDASW
TTAIAEAW	TTAI-AEAW
ASLDLMIRLLE	ASLDLMIRL
LSTTIQEEF	LSTTIQEEF
LSQKGYSW	LSQK-GYSW
KILSNQEEW	KILSNQEEW
QAIKLLVRW	QAIKLLVRW
FAYKDQNENRW	FAYKNENRW
LSTHDPNITW	LSTHPNITW
TAVKIAPRY	TAVKIAPRY
KTILPLINF	KTILPLINF
HTAPVLDIAW	HTAPLDIAW
RTIEDFNKF	RTIEDFNKF
ASNKYLVEF	ASNKYLVEF
SSNPEQLFF	SSNPEQLFF
LLSPVSVEW	LLSPVSVEW
ISAEDAERW	ISAEDAERW
ISNPVTKEM	ISNPVTKEM
VSGPSGSDLW	VSGPGSDLW
KTFVQKQTL	KTFVQKQTL
GTHSLDIKW	GTHSLDIKW
KSSKIMESF	KSSKIMESF
RSHDTLVRW	RSHDTLVRW
ITTDVLYTI	ITTDVLYTI
RSNIMTLLF	RSNIMTLLF
ASNPVLDAW	ASNPVLDAW
HSMLDINALF	HSMLINALF
KVVKVYQEW	KVVKVYQEW
TAVTPQQTW	TAVTPQQTW
VAPRSGLAA	VAPRSGLAA
KVASALEKW	KVASALEKW
KIMADNPSW	KIMADNPSW
LTLQQTQRW	LTLQQTQRW
KTLAEINQKW	KTLAINQKW
KSTTTGHLI	KSTTTGHLI
LSTSIPEAQW	LSTSPEAQW
KVGPNATY	KVGP-NATY
RTLPVLLLY	RTLPVLLLY
RTTQIYTYF	RTTQIYTYF
ISYSEHDSLW	ISYSHDSLW
KSGELLATW	KSGELLATW
SAPVGVTAL	SAPVGVTAL
ATVKYLSEKW	ATVKLSEKW
HSDNPSQLIW	HSDNSQLIW
KSALVFITF	KSALVFITF
AAANAQLHW	AAANAQLHW
KINKVDMQW	KINKVDMQW
KTLSDIFLLF	KTLSIFLLF
KSWPEGHFATI	KSWP-EGHF
ISAPDKRIYQF	ISAPDKRIY
YSASEYRW	YSAS-EYRW
VTIHEKQKESW	VTIHQKESW
RSVPLKATF	RSVPLKATF
KTVAIHTLW	KTVAIHTLW
RVVDGAVGAQW	VVDGVGAQW
SALRGEPLW	SALRGEPLW
KSIEDFAHSSF	KSIEFAHSS
FSKSSDVW	FSKS-SDVW
HIWPDDITKW	HIWPDITKW
KSVDWLLVF	KSVDWLLVF
HSAVVEDVAW	SAVVEDVAW
HSVTQAGVQW	HSVTAGVQW
RVIEFAAKF	RVIEFAAKF
KSLFDRKHYF	KSLFRKHYF
HSMRQAELAQW	RQAE-LAQW
RSDGLLQLW	RSDGLLQLW
KAINFNFGY	KAINFNFGY
SSGPSDKMKW	SSGPDKMKW
ISAIPEQRW	ISAIPEQRW
RAADAVEDLRW	AADAEDLRW
LSSFVGGLSV	SSFVGGLSV
KAGISFII	KAGI-SFII
SAAPKPTSW	SAAPKPTSW
LATTILQHW	LATTILQHW
KAMTGVEQW	KAMTGVEQW
RSMDQGSTW	RSMDQGSTW
KSFDFHFGF	KSFDFHFGF
RVSQLQIQF	RVSQLQIQF
QSITSGKHYW	QSITGKHYW
HSFLYQPDW	HSFLYQPDW
RVIDVGSEW	RVIDVGSEW
KTGLVSSTW	KTGLVSSTW
KVLDDMEGNQW	KVLDEGNQW
ASNKLQIVF	ASNKLQIVF
ISFPPRDEW	ISFPPRDEW
GTSPEVQTW	GTSPEVQTW
KSSVTVYRW	KSSVTVYRW
KAFSTRWNW	KAFSTRWNW
RSIPAITRYWF	RSIPITRYW
LTMSDVQIHW	LTMSVQIHW
QAAQPTRW	QAAQ-PTRW
KSEALKDRHW	KSEAKDRHW
RTAPFHLDLW	RTAPHLDLW
VAAQSYLY	VAAQ-SYLY
KTNGLSEDLIW	KTNGLSEDL
KTSVVVGTW	KTSVVVGTW
KSTIGVEF	KSTI-GVEF
TANKYQVFF	TANKYQVFF
HVIWFHPTW	HVIWFHPTW
ISVPIFKQF	ISVPIFKQF
GTGKTFSF	GTGK-TFSF
KAISKNVLF	KAISKNVLF
KVFAEDQDMQY	KVFAEDQDM
KVYENEDQLLW	KVYEDQLLW
KTLPADVQNYY	KTLPDVQNY
IFNAVSLRW	IFNAVSLRW
KLMPGRIQLW	KLMPRIQLW
LSGRSTPKL	LSGRSTPKL
KVMPYVDILF	KVMPVDILF
KTPEKEPPLW	KTPEEPPLW
FTLREVQERW	FTLRVQERW
QSAKEQIKW	QSAKEQIKW
RVVDFDETW	RVVDFDETW
SAYVDSHKW	SAYVDSHKW
QATRTVPVF	QATRTVPVF
ISQRAPVHW	ISQRAPVHW
FSSKSDVW	FSSK-SDVW
TANGIALLW	TANGIALLW
SDPDEVARRW	SDPDVARRW
PSSSPTHLW	PSSSPTHLW
KTSDSTFLVF	KTSDTFLVF
VSIFPDSGHF	SIFPDSGHF
KTSQTVATF	KTSQTVATF
RSDPSIMNW	RSDPSIMNW
HSSVVNYEF	HSSVVNYEF
SADNTVILW	SADNTVILW
RVGKAFKY	RVGK-AFKY
RSAQAIHKF	RSAQAIHKF
KTSVVIKW	KTSV-VIKW
LEDALQQAKED	LEDALQQAK
KSIYPTLEI	KSIYPTLEI
ATGPRPALF	ATGPRPALF
RALEAEKRALW	RALEKRALW
KSAQPADGW	KSAQPADGW
HSITSDNHKW	HSITDNHKW
LSTLHTVLW	LSTLHTVLW
RTIQELFEVY	RTIQLFEVY
RSVEDLKERY	RSVELKERY
KSNELFTTF	KSNELFTTF
AAGQVFSW	AAGQ-VFSW
KVGKTYEL	KVGK-TYEL
MVLDIVQHW	MVLDIVQHW
KSSIAGSSTW	KSSIGSSTW
RSIPVLAKW	RSIPVLAKW
ITYTFHSTW	ITYTFHSTW
RINQTVTFW	RINQTVTFW
KSVTAHLAAKW	VTAHLAAKW
ITARPVLW	ITAR-PVLW
HSNPGDYAW	HSNPGDYAW
IALPPIAKW	IALPPIAKW
TSVLENHHW	TSVLENHHW
RGNPLVVRF	RGNPLVVRF
VTIRLLETI	VTIRLLETI
ASFHQDSAW	ASFHQDSAW
YLFKGNNRW	YLFKGNNRW
RSMQLDYTTW	RSMQDYTTW
ASSTAHLW	ASST-AHLW
KTYSNEVVTLW	YSNEVVTLW
HTVPDMGKW	HTVPDMGKW
GTLKERVQW	GTLKERVQW
LSSPDDAVIW	LSSPDAVIW
QSFITSSW	QSFI-TSSW
RVMPSSFFL	RVMPSSFFL
RVINEEYKIW	RVINEYKIW
RSSNVSYKY	RSSNVSYKY
RIIYIREQW	RIIYIREQW
KAIKELEEW	KAIKELEEW
ATVPNTIVVNW	ATVPIVVNW
KSVEQYYGW	KSVEQYYGW
ESLRSHFEQW	ESLRHFEQW
ASARGSGATW	ASARSGATW
KAWRGTLARW	KAWRTLARW
YSVRVSPQM	YSVRVSPQM
KLSSALQKW	KLSSALQKW
SSLGAPVHLW	SSLGPVHLW
RSRDISREEW	RSRDSREEW
KTYSLLHQW	KTYSLLHQW
KTHLMSEEEW	KTHLSEEEW
KSADWVSDW	KSADWVSDW
HTAPPENKTW	HTAPENKTW
ISVPPIQKW	ISVPPIQKW
HTAVVEDVSW	TAVVEDVSW
KSALALRW	KSAL-ALRW
RAVEYNALF	RAVEYNALF
KAIADRGWRF	KAIARGWRF
IAIKGVARF	IAIKGVARF
RMISLIESGW	ISLI-ESGW
RIINRFHSF	RIINRFHSF
HSYPGASGW	HSYPGASGW
RSGPFGQIF	RSGPFGQIF
LTMTRNAVW	LTMTRNAVW
KSLENAIEW	KSLENAIEW
IAQRYLLQY	IAQRYLLQY
VTQRLNSQW	VTQRLNSQW
KANIVHLML	KANIVHLML
KSNPKPLVL	KSNPKPLVL
KSLPKATVESW	KSLPTVESW
KLEDRQTSW	KLEDRQTSW
RIVEPYIAW	RIVEPYIAW
KTLVNPANVTF	LVNPANVTF
NVKVDPEIQ	NVKVDPEIQ
KTLPADVQNY	KTLPDVQNY
LAVPEEHVW	LAVPEEHVW
KVVNIVPVI	KVVNIVPVI
GTAGLLEQW	GTAGLLEQW
ATVEQQEHW	ATVEQQEHW
SKVLAEVNTSW	KVLAVNTSW
MSTEHRGPV	MSTEHRGPV
RSNSFNSTF	RSNSFNSTF
HSSVGQVTW	HSSVGQVTW
SSAYEFVTW	SSAYEFVTW
RVLPPSHRVTW	RVLPHRVTW
RVHAFLEQW	RVHAFLEQW
ISEHESNLVW	ISEHSNLVW
KVLEEHGEWW	KVLEEHGEW
RTGHTVLTW	RTGHTVLTW
ITAHPERW	ITAH-PERW
LSQKLQMIL	LSQKLQMIL
KTETEPVFW	KTETEPVFW
RVLISTDVW	RVLISTDVW
LSLRDITSSW	LSLRITSSW
KSIDEMNNAW	KSIDMNNAW
MSLPLTARW	MSLPLTARW
VTARLVGVLW	VTARVGVLW
RSEVILEKW	RSEVILEKW
KANDLDVRW	KANDLDVRW
STIETVPYW	STIETVPYW
ASAPSWEWA	ASAPSWEWA
QAIRNDETGLW	IRNDETGLW
KSNKLLYTF	KSNKLLYTF
RMYPLKPTWW	RMYPLKPTW
KVIAEDEVLW	KVIADEVLW
SPSSVTGNALW	SSVTGNALW
KAIWNVINW	KAIWNVINW
RVYPQAVYF	RVYPQAVYF
RLFGAVVRW	RLFGAVVRW
KSLSAERERW	KSLSERERW
SMHFLVAEW	SMHFLVAEW
LVDPLNMHVTW	LVDPMHVTW
RASQVQSKL	RASQVQSKL
RSSYLANEILW	SSYLNEILW
GTFEYEYSQRW	GTFEYSQRW
RAIAAHERQAW	IAAHERQAW
RAFQAHKEENW	QAHK-EENW
LSAAEVMQW	LSAAEVMQW
KAFDQRLTF	KAFDQRLTF
KAYKAYRL	KAYK-AYRL
HVNRNGDVHW	HVNRGDVHW
ITQKEFMNQHW	ITQKMNQHW
KTLYHITLW	KTLYHITLW
KSHYDEAYKW	KSHYEAYKW
LANDVAEQW	LANDVAEQW
RTVALTALL	RTVALTALL
ITVKVNAPY	ITVKVNAPY
RAIEALLQYW	RAIELLQYW
KSVTLGYLF	KSVTLGYLF
RVDPDVAQHW	RVDPVAQHW
KILSEEPRW	KILSEEPRW
SAGHAYHW	SAGH-AYHW
TAQSDNKITW	TAQSNKITW
RSIPVNEKDTL	RSIPVNEKD
KSAFVRTQW	KSAFVRTQW
KSSSSYHTW	KSSSSYHTW
KTAPFDSRF	KTAPFDSRF
VVDERQYIW	VVDERQYIW
MAAKILEEF	MAAKILEEF
RSLPHITDVSW	RSLPTDVSW
ISHYPDYSW	ISHYPDYSW
ISLPTSKNWTF	ISLPTSKNW
KTFRDKNTL	KTFRDKNTL
KAAISNKI	KAAI-SNKI
RSLTTLSEQW	RSLTLSEQW
RTATFQQRF	RTATFQQRF
QSGLVHIW	QSGL-VHIW
RSIQLDGLVW	RSIQDGLVW
AAVKTYRW	AAVK-TYRW
IGYVDTTHW	IGYVDTTHW
KSVKVSENF	KSVKVSENF
KSLAVKEFF	KSLAVKEFF
KTAEEIKQIW	KTAEIKQIW
SSDSHQPLW	SSDSHQPLW
AALPAAALW	AALPAAALW
RTSPSGGTW	RTSPSGGTW
IVDIGRQDW	IVDIGRQDW
HSVAQAGVQW	SVAQAGVQW
LSQVEGEHQLW	QVEGEHQLW
RSMEDFVTW	RSMEDFVTW
LAGPPLEI	LAGP-PLEI
LEVDNKEALW	LEVDKEALW
YSNEVVTLW	YSNEVVTLW
RSADEPMTTF	RSADPMTTF
RTAHTFESW	RTAHTFESW
MTDPDEVARRW	MTDPVARRW
FGDPASSLFRW	FGDPASSLF
GSDTSDIVHIW	DTSDIVHIW
KAATIGQIGW	KAATGQIGW
ASTHMSPSW	ASTHMSPSW
RSAKWRPG	RSAK-WRPG
RTLDFDPLL	RTLDFDPLL
LPINGNGKQ	LPINGNGKQ
RSIKEKISMW	RSIKKISMW
RAAEPVRVVW	RAAEVRVVW
KTNIQKEATW	KTNIKEATW
ISSKTAAKL	ISSKTAAKL
QAFPNTNRW	QAFPNTNRW
ASAIDISKW	ASAIDISKW
LTSTLQQDW	LTSTLQQDW
RSVRLYHLL	RSVRLYHLL
RVFPHEVNW	RVFPHEVNW
FSEKFPTLW	FSEKFPTLW
KLTSTQVKIW	LTSTQVKIW
KSWRDVYW	KSWR-DVYW
RSAPSEGDEW	RSAPEGDEW
RAVGHEPEHW	RAVGEPEHW
ASLPEAQVW	ASLPEAQVW
KIIPKTLTW	KIIPKTLTW
ITFPNKEIAW	ITFPKEIAW
KSVGKIEHSFW	KSVGIEHSF
SSSDLMSKW	SSSDLMSKW
IIGPYASW	IIGP-YASW
HTNPVGTEW	HTNPVGTEW
KASNLLLGF	KASNLLLGF
KTMTDTYLL	KTMTDTYLL
RGISVENSW	RGISVENSW
ASITSEVFNKF	ITSEVFNKF
AAPEGKRSL	AAPEGKRSL
HASTSWYW	HAST-SWYW
VSWDEKGMTW	VSWDKGMTW
LSVKEPQLVW	LSVKPQLVW
VTNKSVSVW	VTNKSVSVW
IAANEENRKW	AANEENRKW
SQPLGPRII	SQPLGPRII
RVDGAVSSW	RVDGAVSSW
ITPTGTHPL	ITPTGTHPL
RVSNIRQVF	RVSNIRQVF
ASNPAMLLY	ASNPAMLLY
HSLESQVTF	HSLESQVTF
LTWPEGKVLW	LTWPGKVLW
HGVQSWSW	HGVQ-SWSW
TSLVSDGETW	TSLVDGETW
HSAQELQEW	HSAQELQEW
KTFLHDPLVEW	KTFLPLVEW
VSIKAIGW	VSIK-AIGW
KSFVKVYNY	KSFVKVYNY
LATKIQAAW	LATKIQAAW
KTYHYVPEF	KTYHYVPEF
ITVDGKPPTW	ITVDKPPTW
LAALSWQY	LAAL-SWQY
KVWYNVENW	KVWYNVENW
LSDPDEVARRW	LSDPVARRW
AALPDQSFLW	AALPQSFLW
RSLGFNTQI	RSLGFNTQI
AVLQKVALW	AVLQKVALW
YFAERVTSL	YFAERVTSL
VSLDETQHIW	VSLDTQHIW
VTVAEGGVA	VTVAEGGVA
KSNTWSPKY	KSNTWSPKY
HTMTDDVTFW	HTMTDVTFW
RSIQADGLVW	RSIQDGLVW
KAAGEKVYW	KAAGEKVYW
HTIQIRQDW	HTIQIRQDW
TIPDIKKDRW	TIPDKKDRW
RSLSTTNVF	RSLSTTNVF
SPSSSPTHLW	SSSP-THLW
KAYSVQGDKW	KAYSQGDKW
LLNPVIYTW	LLNPVIYTW
VNLPINGNGKQ	VNLPINGNG
VSVPTFSW	VSVP-TFSW
HLNPIILPLW	HLNPILPLW
ISIRTSSQTF	ISIRSSQTF
RSWDHNEFF	RSWDHNEFF
LSFLGGIRW	LSFLGGIRW
VTNKSQIRTW	VTNKQIRTW
KGFGKEHAKW	KGFGEHAKW
RTDSSHQAW	RTDSSHQAW
LIVTTPEKW	LIVTTPEKW
ITAQELDRW	ITAQELDRW
STDKTVAVW	STDKTVAVW
KSRPEVITF	KSRPEVITF
VVVPAEWIKNW	VVVP--AEW
RSDKPKLF	RSDK-PKLF
KVADPVVTF	KVADPVVTF
VTDNAVYHW	VTDNAVYHW
ASSPDGFFW	ASSPDGFFW
RLIPQPAFQW	RLIPPAFQW
VSHPDAGAAW	VSHPAGAAW
YQSKYEEL	YQSK-YEEL
HSGPVVAMVW	HSGPVAMVW
RIAPSGDQW	RIAPSGDQW
KSYPETHII	KSYPETHII
KTTNTVSKF	KTTNTVSKF
KIIFIDSTW	KIIFIDSTW
RSARDTAQIF	RSARTAQIF
VSDASKPSW	VSDASKPSW
ISTPFPAVW	ISTPFPAVW
RAQETFMQW	RAQETFMQW
FSYRDVNSW	FSYRDVNSW
RILVDQQVW	RILVDQQVW
YTIKDTVAW	YTIKDTVAW
SSSSSFRW	SSSS-SFRW
RLAPNFRW	RLAP-NFRW
KSFEGNVFMYY	KSFE-GNVF
YTNHFTQEQW	YTNHTQEQW
KAGKSFDL	KAGK-SFDL
TSENITQKVVW	TSENITQKV
LAGVSFEI	LAGV-SFEI
KTPVDGQYVW	KTPVGQYVW
ITTEGKLW	ITTE-GKLW
KALPVNVKW	KALPVNVKW
LVNNTPLNW	LVNNTPLNW
FAARSFYY	FAAR-SFYY
ITQKALQSQSW	KALQ-SQSW
KLLDLKEPTW	KLLDKEPTW
RSISDKQQW	RSISDKQQW
ASAWALERW	ASAWALERW
KSLDTTLQF	KSLDTTLQF
LTYENVERW	LTYENVERW
KSYELPDGQVI	KSYELPDGQ
KVQDFQGNLW	KVQDQGNLW
LALPPGAEHW	LALPGAEHW
AIESGQHYW	AIESGQHYW
RSFPGFQAF	RSFPGFQAF
VAIRDGAYSLF	VAIRGAYSL
GSNKTLLSF	GSNKTLLSF
NTTAIAEAW	NTTAIAEAW
ISSGVVSIW	ISSGVVSIW
RTAQEVETY	RTAQEVETY
RTTHLHNDLW	RTTHHNDLW
LSGPRLLF	LSGP-RLLF
SSPQPGSAL	SSPQPGSAL
KIISTLPSW	KIISTLPSW
YGFRPDEPYYY	YGFRPDEPY
RLNPLVLLL	RLNPLVLLL
KVTRIVLLW	KVTRIVLLW
ISTKTSAKL	ISTKTSAKL
MSNKHGWTW	MSNKHGWTW
LASKELAAW	LASKELAAW
HSGPVIPVY	HSGPVIPVY
HAFDGFEVNW	HAFDFEVNW
NSIKELNERW	NSIKLNERW
KTIKLWNTL	KTIKLWNTL
KVLPPNHRVVW	KVLPPNHRV
KTLDVDATY	KTLDVDATY
YATQSHQW	YATQ-SHQW
GTDPNSAAW	GTDPNSAAW
KFIDPIYQVW	FIDPIYQVW
GAVRENYTW	GAVRENYTW
KTLEEHSHW	KTLEEHSHW
KGASSFKI	KGAS-SFKI
KTITQIEEF	KTITQIEEF
VSKPDLITW	VSKPDLITW
ISPSRTEAL	ISPSRTEAL
YTNKVITLW	YTNKVITLW
RAIYTIMRW	RAIYTIMRW
RVNPVEYSI	RVNPVEYSI
ISAPDSQVRF	ISAPSQVRF
IAIPLRRSS	IAIPLRRSS
AAYKTFSW	AAYK-TFSW
ITIPDIKKDRW	ITIPKKDRW
KSFEGNVFMY	KSFE-GNVF
KSSAVQQLL	KSSAVQQLL
KSVDDHIVRF	KSVDHIVRF
KNINIPTLFQW	INIPTLFQW
ASYQDRRQSW	ASYQRRQSW
MTVKEQQEW	MTVKEQQEW
KTQGGHVYMW	KTQGHVYMW
TVTEKPEVID	TVTEKPEVI
RSVDLQTRI	RSVDLQTRI
RSNILTLMY	RSNILTLMY
MTLKDIYTW	MTLKDIYTW
TAHSEPSLW	TAHSEPSLW
RVFDNQDTW	RVFDNQDTW
IVPRLLFEDW	IVPRLFEDW
VSEHQPTTW	VSEHQPTTW
RSAEALAF	RSAE-ALAF
RSLAYIHSF	RSLAYIHSF
KSIEEIVSF	KSIEEIVSF
KSTPTGLFGYW	KSTP-TGLF
ATILGNTERW	ATILNTERW
LSALESTKW	LSALESTKW
ISHIPASRW	ISHIPASRW
KSVTAFFTW	KSVTAFFTW
KSVRPGASY	KSVRPGASY
MTTRELQQYW	MTTRLQQYW
YAAKVENKW	YAAKVENKW
PDIKKDRW	PDIK-KDRW
ISPTGHSL	ISPT-GHSL
KSITEINANF	KSITINANF
ISNPVTKEMLF	ISNPVTKEM
GPPPPPGKPQ	GPPPPPGKP
ISMPDFDLHL	ISMPFDLHL
KSFGSAQEFAW	KSFGSAQEF
KSVTEVDTL	KSVTEVDTL
RSTVLTPMF	RSTVLTPMF
IIISTPEKW	IIISTPEKW
ISVRANTENW	ISVRNTENW
YSVDENGQRW	YSVDNGQRW
KAFPHSSSLRY	KAFPHSSSL
YSKYYKTID	YSKYYKTID
IIHEIAVLEL	IIHEAVLEL
SVIKNLQSRW	SVIKLQSRW
VSAPELGLW	VSAPELGLW
TILVDNNTW	TILVDNNTW
ISMANDLKEVW	MANDLKEVW
KSAPSDSLTY	KSAPDSLTY
KAFQATLRW	KAFQATLRW
HTAKISDFSW	HTAKSDFSW
KSSLTQHSW	KSSLTQHSW
MSTLPSKW	MSTL-PSKW
KSFGGEKW	KSFG-GEKW
RMEEEQHHW	RMEEEQHHW
ISQKTLSQW	ISQKTLSQW
QSLPDFGISY	QSLPFGISY
RSKQTKELW	RSKQTKELW
SGSSDGTIRLW	SSDGTIRLW
GTVITPDTW	GTVITPDTW
RARTIYERF	RARTIYERF
ALSPAVGSW	ALSPAVGSW
GTDKTLRTW	GTDKTLRTW
HSVEVHKW	HSVE-VHKW
RTYEHEAMW	RTYEHEAMW
AVSKDIANW	AVSKDIANW
KSVTADTEMW	KSVTDTEMW
KSEKVKLW	KSEK-VKLW
KAITTSLTTKW	ITTSLTTKW
RTVAALASW	RTVAALASW
RSFRPLLF	RSFR-PLLF
RATPENYLF	RATPENYLF
FSAPGVTSW	FSAPGVTSW
PPYTVVYFPVR	YTVVYFPVR
RSSSYLDNLVW	SSYLDNLVW
HSGPPIVI	HSGP-PIVI
RIIHLVHRF	RIIHLVHRF
KAITFVTQY	KAITFVTQY
KAHLTSAADIW	LTSA-ADIW
KALEYVFKF	KALEYVFKF
KVIPVVNSF	KVIPVVNSF
KSVRLDVTL	KSVRLDVTL
RSVDEVNYW	RSVDEVNYW
KTHPYNPLWA	KTHPYNPLW
RAFEDVKVFW	RAFEVKVFW
SSTPHNVSW	SSTPHNVSW
RTSTSQAVF	RTSTSQAVF
KSSATRLLY	KSSATRLLY
SAANIQPIF	SAANIQPIF
KISPKSDVW	KISPKSDVW
VFDPVTKLW	VFDPVTKLW
KSYPGSQSQLF	KSYPSQSQL
HTVWESEEW	HTVWESEEW
KSQIFQIFY	KSQIFQIFY
KSYVQGVTW	KSYVQGVTW
RTTPATELDAW	RTTPATELD
KSDQSYVI	KSDQ-SYVI
TTTVMNPKF	TTTVMNPKF
SVPEAQSAL	SVPEAQSAL
IANQVQLFY	IANQVQLFY
LSTPEGKWQW	LSTPGKWQW
IIMKDVPDW	IIMKDVPDW
VVSSIHSSW	VVSSIHSSW
LSVFSTSKW	LSVFSTSKW
RTLPVDSSHGF	RTLPVDSSH
LSNVQRLTF	LSNVQRLTF
RSIPAITRYW	RSIPITRYW
RSFLDDPIW	RSFLDDPIW
TIVKVFPTW	TIVKVFPTW
KVSVYLQNW	KVSVYLQNW
KSTPVTVVL	KSTPVTVVL
LTGPALQW	LTGP-ALQW
KTMVGHRTEVW	MVGHRTEVW
SSGPQSGW	SSGP-QSGW
HTQTGVSTW	HTQTGVSTW
KSVSFSDVF	KSVSFSDVF
RSWLSYSY	RSWL-SYSY
RIESVIKELW	RIESIKELW
LIGPTFSY	LIGP-TFSY
KIDPSTLQMW	KIDPTLQMW
KTAEAQLAY	KTAEAQLAY
KTSHTVKW	KTSH-TVKW
VSAETVEKW	VSAETVEKW
LSQRGYEW	LSQR-GYEW
KGIKVVGKW	KGIKVVGKW
AISDLQQLW	AISDLQQLW
RATHVTDFF	RATHVTDFF
ATRPDYISW	ATRPDYISW
AALDSRKNYNW	AALDSRKNY
RSYYSVQTAEW	YSVQ-TAEW
SVTEVQLRF	SVTEVQLRF
KAGLAYHL	KAGL-AYHL
KSTAISLFY	KSTAISLFY
KTFPYQHRY	KTFPYQHRY
ISAPVSERM	ISAPVSERM
LALVKPEVW	LALVKPEVW
ISTIFKSLW	ISTIFKSLW
KSVEEISTL	KSVEEISTL
RSMKGLRW	RSMK-GLRW
LTVKLPDGYEF	LTVKLPDGY
KATYFSEKW	KATYFSEKW
RFVPLPASAKW	VPLPASAKW
LSTIISPLF	LSTIISPLF
RAAPDPPPLF	RAAPPPPLF
RSFVEKHRW	RSFVEKHRW
ISVPGLQTNW	ISVPLQTNW
VTSKVIFFW	VTSKVIFFW
VSTTIDPFW	VSTTIDPFW
ISVAPEETW	ISVAPEETW
SAYDSKADIW	SAYDKADIW
HSGIAVHTW	HSGIAVHTW
SSTVTHLF	SSTV-THLF
HSFYPTPALQW	HSFYPTPAL
HTEMVAELW	HTEMVAELW
RSQMSMPFQQW	MSMP-FQQW
HSSGILPKW	HSSGILPKW
RGVPWNFTF	RGVPWNFTF
RSTDRVLQW	RSTDRVLQW
RTLPTNTLMGF	RTLPTNTLM
RSIEEVYYLW	RSIEVYYLW
RNLPFDFTW	RNLPFDFTW
TVIEKTESW	TVIEKTESW
ASLQEIGDRW	ASLQIGDRW
FSLPAQPLW	FSLPAQPLW
KSAKDALLLW	KSAKALLLW
KSLIEEGGDW	KSLIEGGDW
KSLELHEEF	KSLELHEEF
ISKKHTLGEVW	KKHTLGEVW
LGNSLLLKY	LGNSLLLKY
GSNPHLQTF	GSNPHLQTF
AAAPPSPAW	AAAPPSPAW
KTMEQLENVYF	KTMELENVY
RSTHEAVARW	RSTHAVARW
KVGKFYELY	KVGKFYELY
VTVPANVQRW	VTVPNVQRW
KSIDLIQKW	KSIDLIQKW
GSIPEDHEDW	GSIPDHEDW
KVYENDDQLLW	KVYEDQLLW
SSLKHLYKW	SSLKHLYKW
KSVTAFFKW	KSVTAFFKW
VTYKNVPNW	VTYKNVPNW
SKSVGQILLW	KSVGQILLW
IANVAHTF	IANV-AHTF
KSLPDTELM	KSLPDTELM
KFNPVSFTW	KFNPVSFTW
LADPWRQEW	LADPWRQEW
RSTELDSNWNW	RSTELDSNW
KSVTQQIHF	KSVTQQIHF
HSFLGFEW	HSFL-GFEW
KSSTVLHTF	KSSTVLHTF
FNEKSKEL	FNEK-SKEL
RALQASALNAW	RALQ-ASAL
KAVQEGNIQW	KAVQGNIQW
KFVDILTNW	KFVDILTNW
SAAPLFFSW	SAAPLFFSW
KASDVLARF	KASDVLARF
RSESHMEWTW	RSES-HMEW
RAYPFHWAW	RAYPFHWAW
ASHKGQKLW	ASHKGQKLW
KAVETVHNL	KAVETVHNL
LANKTPHTW	LANKTPHTW
RALPSLDIVVW	RALPDIVVW
ATSQAQAGW	ATSQAQAGW
GTMDVHHHW	GTMDVHHHW
LSSPEPLSW	LSSPEPLSW
VALQDHFKW	VALQDHFKW
AHSNLNGVWH	HSNL-NGVW
RTMELLTQNW	RTMELTQNW
RSVLDNRARF	RSVLNRARF
RSFGWDSSEAW	RSFGSSEAW
ISLKENRHW	ISLKENRHW
KGFSEEHNTW	KGFSEHNTW
KSTPYTAVRW	KSTPTAVRW
WSTKESPRW	WSTKESPRW
VAEKLNIPW	VAEKLNIPW
KSFPSIFKF	KSFPSIFKF
YSIRGQLSW	YSIRGQLSW
KSFEGLFYF	KSFEGLFYF
RSSSLSDFSW	RSSSSDFSW
SAASSYSF	SAAS-SYSF
IANQIQEDW	IANQIQEDW
KSLIIVHPSW	KSLIVHPSW
RTEAILKASW	RTEALKASW
KAVDIVKQVW	KAVDVKQVW
KVMPFANLM	KVMPFANLM
RSLEISQSY	RSLEISQSY
SSIKGAEEW	SSIKGAEEW
ATQPEVADW	ATQPEVADW
KSLPVSVPVW	KSLPSVPVW
YLPDGTASL	YLPDGTASL
RASPFLLQY	RASPFLLQY
KSRPLGAEDLW	RPLGAEDLW
ISKPVGFGEEF	KPVGFGEEF
GSFHGSPYEW	GSFHSPYEW
RSQSSELTKW	RSQSELTKW
ATDPNILGRTW	ATDPLGRTW
ISVAEVEKW	ISVAEVEKW
RVTSVVTGF	RVTSVVTGF
PSGAYFAW	PSGA-YFAW
RALGTEVIQLF	LGTEVIQLF
KSSVEVYAW	KSSVEVYAW
RAVQLQELW	RAVQLQELW
HAATTSLSW	HAATTSLSW
ASYDGTAQVW	ASYDTAQVW
KSLALLLNY	KSLALLLNY
TAVVEDVSW	TAVVEDVSW
KTSRTFFYW	KTSRTFFYW
KSMETHIMHTF	KSME-THIM
KLYPGNQVLW	KLYPNQVLW
TADITVLRW	TADITVLRW
KTLESQNLF	KTLESQNLF
KSNQTDAIKW	KSNQDAIKW
VVPEPGQPL	VVPEPGQPL
KTSKIELKF	KTSKIELKF
YTVRVIDVF	YTVRVIDVF
SADKTVKLW	SADKTVKLW
GSYWKEGRW	GSYWKEGRW
PINGNGKQ	PING-NGKQ
RLDPNVQKW	RLDPNVQKW
AILKKVIQW	AILKKVIQW
RAVDDGVNTF	RAVDGVNTF
LEEALQQAKED	EALQQAKED
HLAWVQEEW	HLAWVQEEW
KTIGLREVW	KTIGLREVW
RSLQLHLVF	RSLQLHLVF
YLNRHLHTW	YLNRHLHTW
RSDPGHYSF	RSDPGHYSF
AKNKLNDLED	AKNK-LNDL
VSNPYHVVI	VSNPYHVVI
FAVPDKVLW	FAVPDKVLW
TMSDVQIHW	TMSDVQIHW
KSLPAEINRM	KSLPEINRM
KAQAQVSEW	KAQAQVSEW
KSFEDIHHY	KSFEDIHHY
LAQRVLLTW	LAQRVLLTW
KSIGDIFLKY	KSIGIFLKY
RVSPALGITW	RVSPLGITW
KVRAELERW	KVRAELERW
QSLKSTAKW	QSLKSTAKW
FTIKSDVW	FTIK-SDVW
ISNPEHLTEW	ISNPHLTEW
LTPVVVTLW	LTPVVVTLW
FSDKESGKQKF	FSDKGKQKF
VTLHDQGTAQW	VTLHGTAQW
RVWNLNHLW	RVWNLNHLW
ISLSEPRMLW	ISLSPRMLW
RSSPVEYEF	RSSPVEYEF
IIFVPVPQL	IIFVPVPQL
SATDTSAKW	SATDTSAKW
MTGRAARW	MTGR-AARW
KAFPEHFTY	KAFPEHFTY
TYDDATKTF	TYDDATKTF
HADTTKWEW	HADTTKWEW
ITKADAAEFW	KADA-AEFW
RTEEMKWRQW	RTEE--MKW
AAPATRAAL	AAPATRAAL
ISVHDSVISQW	ISVHVISQW
RGAGPAPAW	RGAGPAPAW
KSLDEAIDMRF	KSLDIDMRF
KTNAIPLTL	KTNAIPLTL
KILSKVEKF	KILSKVEKF
KGFYDKDSSGW	FYDKDSSGW
QAWRAATLEGW	RAAT-LEGW
QSVALLEQKW	SVALLEQKW
SVTEIQEK	SVTE-IQEK
RTNNIELHY	RTNNIELHY
ASVPIMYSW	ASVPIMYSW
QSVPASTGLGW	QSVPASTGL
ISTPVIRTF	ISTPVIRTF
VSDPENTTW	VSDPENTTW
KSAQPIEKF	KSAQPIEKF
RTLGTPDEVVW	LGTPDEVVW
RSVQVIGGIW	RSVQIGGIW
KSIPSAEVEKW	KSIPEVEKW
QSGIVQLLW	QSGIVQLLW
RAIDTDSNLW	RAIDDSNLW
KSDASLLGSLW	ASLL-GSLW
ASLPSELIVHI	ASLP-SELI
VSFEEDDKIRW	VSFEDKIRW
KANPTFHHW	KANPTFHHW
AVEKNPAVW	AVEKNPAVW
KVDIIISEW	KVDIIISEW
RALKEITTF	RALKEITTF
LSEAVHWTW	LSEAVHWTW
VSFYNQNKW	VSFYNQNKW
LSIPDIKTAF	LSIPIKTAF
ISFHNIHNTF	ISFHIHNTF
HVNPYIGLFF	HVNPYIGLF
RSTQQTTEW	RSTQQTTEW
KSLYHSVEW	KSLYHSVEW
ATADVEWRW	ATADVEWRW
KSVKVFAEY	KSVKVFAEY
RSLDQQMYL	RSLDQQMYL
IAVPRNDEW	IAVPRNDEW
GAYKYIQELW	GAYKIQELW
RIEPSVSLW	RIEPSVSLW
HSFSGSQQKW	HSFSSQQKW
SSATDAAIRVW	ATDAAIRVW
MSTKAVLW	MSTK-AVLW
RVWQWDEKW	RVWQWDEKW
RIIAKLAAW	RIIAKLAAW
KTYGEIFEKF	KTYGIFEKF
SSSRIRAAW	SSSRIRAAW
ASLLHQVSW	ASLLHQVSW
KTIGGGDDSF	KTIGGDDSF
HTFPNATDYW	HTFPATDYW
KSIWNNRW	KSIW-NNRW
SSSQIILKW	SSSQIILKW
AAAKIQASF	AAAKIQASF
KAPAPRPSL	KAPAPRPSL
RAIQFYLEF	RAIQFYLEF
KVFLIYEGY	KVFLIYEGY
RSGPASTF	RSGP-ASTF
LTIDHVPIW	LTIDHVPIW
RSMVLKLTL	RSMVLKLTL
AEQRGELAIKD	LAIK-----
HSTLVPHEW	HSTLVPHEW
KTIDAMDTW	KTIDAMDTW
KSWVFGVHF	KSWVFGVHF
FSLKESIMKW	FSLKSIMKW
LSAPNLNSW	LSAPNLNSW
KSFEKAKESW	KSFEAKESW
ITDFHPDTW	ITDFHPDTW
KSIANQIQEDW	IANQIQEDW
ASFDGTFLW	ASFDGTFLW
YTYKKQVKI	YTYKKQVKI
VSAVASQW	VSAV-ASQW
RSISQGLTWTW	RSISQGLTW
ITDKAREF	ITDK-AREF
KAAELFSQW	KAAELFSQW
LSSTEILKW	LSSTEILKW
KSFGGSHVM	KSFGGSHVM
ISYSGHDSFW	ISYSGHDSF
RTTDIVIRI	RTTDIVIRI
KAVIDLNNRW	KAVILNNRW
KTFPSIHLW	KTFPSIHLW
VTMDDFRW	VTMD-DFRW
KVIHEQVNHRW	KVIHVNHRW
STDKTVRLW	STDKTVRLW
RTKEEVNEW	RTKEEVNEW
KANPALYVL	KANPALYVL
KSWADVVKL	KSWADVVKL
HSTIVYHW	HSTI-VYHW
HSSVAFMF	HSSV-AFMF
KVNVAKLRY	KVNVAKLRY
SAPSRATAL	SAPSRATAL
KVMPQNHSF	KVMPQNHSF
LSSQSRQW	LSSQ-SRQW
KALSDHHIYL	KALSDHHIY
LRNVSTGD	LRNV-STGD
VSGKPLLI	VSGK-PLLI
RILDLIDDAW	RILDIDDAW
NSSAFQHFW	NSSAFQHFW
KSVDVTEKL	KSVDVTEKL
IAIPVTVAF	IAIPVTVAF
VSFAEKNGW	VSFAEKNGW
KSVKEVLHF	KSVKEVLHF
KSFMDFGSW	KSFMDFGSW
KAFPFHIIF	KAFPFHIIF
RTFTDHVMLF	RTFTHVMLF
LSSDDANVLVW	SSDDNVLVW
HSSAVAATY	HSSAVAATY
ATATEKSEW	ATATEKSEW
HSNSVPLAL	HSNSVPLAL
KINTESSLW	KINTESSLW
VVVRDTAAW	VVVRDTAAW
TSVPDHVVW	TSVPDHVVW
RSILAPLAW	RSILAPLAW
KMNPQSAFF	KMNPQSAFF
LSALPADTQAW	SALPDTQAW
RMIDIQTRM	RMIDIQTRM
VSEPGDPKVTW	VSEPPKVTW
AAFPAEKESEW	AAFPKESEW
VSAPEVSRW	VSAPEVSRW
ISSSAGARW	ISSSAGARW
KSKAMTGVEQW	KAMTGVEQW
ASLQNERDHLW	ASLQERDHL
KALNHLREIW	KALNLREIW
AVIDLNNRW	AVIDLNNRW
LSAPIMSRF	LSAPIMSRF
KVQDITMQW	KVQDITMQW
KTIETSPSL	KTIETSPSL
KTVDKFNEW	KTVDKFNEW
RSFIFKGEDNW	FIFKGEDNW
KSSAISLHY	KSSAISLHY
HAIRLLLEY	HAIRLLLEY
MSERQLALW	MSERQLALW
VSAAEQQLW	VSAAEQQLW
VIVPADPTLW	VIVPDPTLW
IIWREENGTW	IIWRENGTW
ISGHHPETW	ISGHHPETW
KTIEDFQQK	KTIEDFQQK
TSFEQHVLW	TSFEQHVLW
ITTDVNPYY	ITTDVNPYY
KSVSFSDVFF	KSVSFSDVF
LSDETKNNW	LSDETKNNW
SADGTIKLW	SADGTIKLW
QTYYRIFTW	QTYYRIFTW
STAVSYAW	STAV-SYAW
RSRVDQEERW	RSRVQEERW
TSSSLPEAW	TSSSLPEAW
KAIATTVTY	KAIATTVTY
QSFKPETYW	QSFKPETYW
TVYPKPEEW	TVYPKPEEW
KSFSDTLKTYF	KSFSTLKTY
MTNPHNHLY	MTNPHNHLY
KSLLWTETF	KSLLWTETF
TSGPPLTM	TSGP-PLTM
ATLELTHNW	ATLELTHNW
KVLSPKYLGSW	LSPKYLGSW
KGLSTQAIW	KGLSTQAIW
LSLPADLTKM	LSLPDLTKM
VSTASHLL	VSTA-SHLL
HSILNPQKW	HSILNPQKW
RSIESTLDDLF	RSIETLDDL
RSVPTSTVF	RSVPTSTVF
KVDPAKDRELW	KVDPKDREL
KTYPVNTPERW	KTYPTPERW
RTDGKVFQF	RTDGKVFQF
KSHPFTNPRW	KSHPTNPRW
LSIVDRTTI	LSIVDRTTI
RGTVIVERW	RGTVIVERW
KLSPEELLLRW	LSPELLLRW
KTDKTLVLL	KTDKTLVLL
KSIHIVVTM	KSIHIVVTM
KSLPSEASEQY	KSLPASEQY
LVSDLQQVW	LVSDLQQVW
KILSSRVLK	KILSSRVLK
QALQDSRNYGW	QALQDSRNY
KSATDTSAKW	KSATTSAKW
ITSPTGETW	ITSPTGETW
RVFEDESGKHW	RVFESGKHW
SATEVDSRW	SATEVDSRW
RSTELDSNW	RSTELDSNW
KSITIIGGGF	KSITIGGGF
RTVYFSEQW	RTVYFSEQW
SAAKSWVF	SAAK-SWVF
LSSEVTKNW	LSSEVTKNW
ISATEVDSRW	ISATVDSRW
HVEDLNAKW	HVEDLNAKW
TVLTTHHHW	TVLTTHHHW
KSFSKSDLVNW	FSKSDLVNW
KSSEVFTTF	KSSEVFTTF
KANHAELIL	KANHAELIL
KSFGWPSFITY	KSFG-WPSF
KSAEKEISLW	KSAEEISLW
VSADVEERF	VSADVEERF
SSFASSHEVW	SSFASHEVW
KIEKEIQQKW	KIEKIQQKW
KSLDLLTMKN	KSLD-LLTM
HTSYEISAW	HTSYEISAW
IMFDGPEAW	IMFDGPEAW
HTTQSAQW	HTTQ-SAQW
RTSDKELYF	RTSDKELYF
RTVNVEDSW	RTVNVEDSW
KGDPQSPGRHW	KGDPPGRHW
STDRHIRLW	STDRHIRLW
ALAPILDDGW	ALAPLDDGW
FSDRSSLTF	FSDRSSLTF
KAVTHQVKF	KAVTHQVKF
VAIKDKQVKY	VAIKKQVKY
IITPIHEQW	IITPIHEQW
ASNGVLLLM	ASNGVLLLM
KSENAGAQGW	KSENGAQGW
VTNPHTDAW	VTNPHTDAW
VSEAGTHQEW	VSEATHQEW
LSAPIHTQM	LSAPIHTQM
RTAQLAKIKW	RTAQAKIKW
LSVKGTLQQF	LSVKTLQQF
VSAKEKYYVW	VSAKKYYVW
FSKSDLVNW	FSKSDLVNW
HAMGGVPAW	HAMGGVPAW
KAVTTNQW	KAVT-TNQW
RVLKEDKERW	RVLKDKERW
KTVAGGAWTY	KTVA-GGAW
RVFPDKGYSF	RVFPKGYSF
RAALSDTVALW	AALSTVALW
KSVSAAEQQLW	VSAAEQQLW
KADVVKVKW	KADVVKVKW
FSSREQPKL	FSSREQPKL
VSNKYGLVF	VSNKYGLVF
RSLVPAAVVW	RSLVAAVVW
KATTSTNW	KATT-STNW
QTFSSKTEW	QTFSSKTEW
KTNTFQGVIF	KTNTQGVIF
ISDSNPFLTQW	DSNPFLTQW
GSHRWQGETW	GSHRQGETW
LSNAKDVAHW	LSNADVAHW
KAFDEKKQKW	KAFDKKQKW
KTLEDNSEKW	KTLENSEKW
KVHPVIPAMW	KVHPIPAMW
KVSPEEITSLW	VSPEITSLW
ASVSEHQPTTW	VSEHQPTTW
SIPGGYNAL	SIPGGYNAL
KSIEFLSSKW	KSIELSSKW
RTTDEVYLF	RTTDEVYLF
KTVVNKDVF	KTVVNKDVF
KALKMTIFW	KALKMTIFW
RTVEDFNKF	RTVEDFNKF
SSSDLVSKW	SSSDLVSKW
RAYAKDVKF	RAYAKDVKF
STNKYQLSI	STNKYQLSI
ILSRLILLW	ILSRLILLW
QSLKDSEQKW	QSLKSEQKW
KTEASETRKW	KTEAETRKW
KSFSESGINY	KSFSSGINY
KVLIDIREYW	KVLIIREYW
LSMPASLGRM	LSMPSLGRM
KAIEEGVNHMW	KAIEVNHMW
RILPQDVILKF	RILPVILKF
KALPSPAATIW	KALPPAATI
ISMGDHLW	ISMG-DHLW
QAWTSHLW	QAWT-SHLW
RVVQQEEGW	RVVQQEEGW
KAWAEYVVEW	KAWAYVVEW
AVSLIREEW	AVSLIREEW
RSSQTGDWTW	RSSQGDWTW
RTIQTPIGSTW	IQTPIGSTW
LADPDEVARRW	LADPVARRW
RGIDIPEVNW	RGIDPEVNW
RAMQDMQLLW	RAMQMQLLW
KVVGKDYLL	KVVGKDYLL
ASAIIIQRW	ASAIIIQRW
TSYRDFLGTNW	TSYRLGTNW
IVTSTYGW	IVTS-TYGW
KLGPAIKL	KLGP-AIKL
RSQVDHVIW	RSQVDHVIW
KSVENLGVSY	KSVELGVSY
GSYNGQVGW	GSYNGQVGW
STAPQPVW	STAP-QPVW
RTSRTLLLL	RTSRTLLLL
KTQGPRALW	KTQGPRALW
NGGPSHLW	NGGP-SHLW
HVAPVTSVEW	HVAPTSVEW
TTVPNTIVVSW	VPNTIVVSW
LSNTVMPRF	LSNTVMPRF
VSIEERARW	VSIEERARW
RSLKDALFKW	RSLKALFKW
VSLPSHLNISY	VSLPSHLNI
RAIKQLDYEW	RAIKLDYEW
VSTRQTQSW	VSTRQTQSW
ITIPKNMHW	ITIPKNMHW
KSGPVVSLGW	KSGPVSLGW
KTFPFHFMF	KTFPFHFMF
KSLPASLSFL	KSLPASLSF
KIIDSKETW	KIIDSKETW
QSSWSHFGW	QSSWSHFGW
RTNAIKQTF	RTNAIKQTF
RTSETNTLF	RTSETNTLF
TVDIPENVDI	VDIPENVDI
KTIEGIYEKF	KTIEIYEKF
ASATERQEW	ASATERQEW
FSGEELDKLW	FSGELDKLW
VANLTNLVW	VANLTNLVW
SSGPVAESW	SSGPVAESW
KTKEVIQEW	KTKEVIQEW
KSLLVVHFW	KSLLVVHFW
LAGPAATSW	LAGPAATSW
KSLNIFGSSW	KSLNFGSSW
KTAEELMNF	KTAEELMNF
KAMGIMNSF	KAMGIMNSF
ASNGDVYAW	ASNGDVYAW
KTVIDSQTHY	KTVISQTHY
VSVLAGPRW	VSVLAGPRW
KTLSTFKESW	KTLSFKESW
RTYFVANEW	RTYFVANEW
ITYQHIDRW	ITYQHIDRW
ATAPVVALF	ATAPVVALF
KSLWKHHEY	KSLWKHHEY
LTSPIEASW	LTSPIEASW
SSLRVPSQW	SSLRVPSQW
QTVMITPTF	QTVMITPTF
KAISSIHSLW	KAISIHSLW
RTVIIEQSW	RTVIIEQSW
LIGPPLLI	LIGP-PLLI
KSYFSQKW	KSYF-SQKW
KSYLGSEADVW	KSYLEADVW
KAIPDTRLTI	KAIPTRLTI
KVWGEVGRW	KVWGEVGRW
KSNEDQSMGNW	KSNE-DQSM
LTSVVQTLL	LTSVVQTLL
KIIPLVVKF	KIIPLVVKF
KAGSSKYQW	KAGSSKYQW
KTIEDVREF	KTIEDVREF
KSFETDTNLNF	KSFETDTNL
HTGPAGDSW	HTGPAGDSW
SASPFQSAW	SASPFQSAW
KSSDPEMRW	KSSDPEMRW
RTGHILVQW	RTGHILVQW
RIFEDYTVSW	RIFEYTVSW
ISSDGQFAL	ISSDGQFAL
TTKAISRW	TTKA-ISRW
KSKLDAEVSKW	KLDAEVSKW
HSGPSKWNW	HSGPSKWNW
KSTQFEYAW	KSTQFEYAW
VAAPSWLH	VAAP-SWLH
ISHEDGTLW	ISHEDGTLW
HAGNINFKW	HAGNINFKW
ISSSAHHVT	ISSSAHHVT
ATNGVVVTW	ATNGVVVTW
YSARGWEW	YSAR-GWEW
KSWSTGKW	KSWS-TGKW
RVDTSPTPVSW	DTSPTPVSW
KVIGAGKSW	KVIGAGKSW
HVVEQHWEW	HVVEQHWEW
KTIVMGASF	KTIVMGASF
RSSVILLTY	RSSVILLTY
ITTKAISRW	ITTKAISRW
KAVEEKIEW	KAVEEKIEW
RIVSVDKQQQW	VSVDKQQQW
KIYENEDQLLW	KIYEDQLLW
SAGSSFVF	SAGS-SFVF
QSLKELLQNW	QSLKLLQNW
ISHGEVLEW	ISHGEVLEW
KSYSKAFTL	KSYSKAFTL
KSVQNSITQW	KSVQSITQW
ATIKDIREHEW	ATIKREHEW
VSYRNPAEGTW	YRNPAEGTW
ATSKVALVY	ATSKVALVY
RSDPNSESLYF	RSDPNSESL
RSQVVIPILQW	VVIP-ILQW
RTILVDNNTW	RTILDNNTW
RSLVPIQLW	RSLVPIQLW
KTFPHPIDKW	KTFPPIDKW
VSNPKSFEY	VSNPKSFEY
LSSTVTLEH	LSSTVTLEH
KAYSEAHEI	KAYSEAHEI
HATKAIYRW	HATKAIYRW
RVDPNGSRYLL	RVDPNGSRY
RSIVNQVRF	RSIVNQVRF
KSIKNIQKI	KSIKNIQKI
VSQKISKTRW	VSQKSKTRW
LQVSAKIGF	LQVSAKIGF
KSSQVQRRF	KSSQVQRRF
TSYLGKEHW	TSYLGKEHW
VSMIFPLHW	VSMIFPLHW
KVYFIYEGY	KVYFIYEGY
RSLWGPYAGW	RSLWPYAGW
RVAHFGYHW	RVAHFGYHW
VIEVKVPA	VIEV-KVPA
AASSISSPW	AASSISSPW
FRVPTANVS	FRVPTANVS
SSDTTVLIW	SSDTTVLIW
IVDFTQEEW	IVDFTQEEW
NAPWAVTSL	NAPWAVTSL
RSLLQENNW	RSLLQENNW
QTVKDSRTVY	QTVKSRTVY
KSFLPEVVNTW	SFLPVVNTW
RSLPRDTSNW	RSLPDTSNW
KSLSLNPFLW	KSLSNPFLW
KSIEPVSSW	KSIEPVSSW
KSQDILLKW	KSQDILLKW
KGSQLQERW	KGSQLQERW
VTTVVNPKY	VTTVVNPKY
ATAVAQLLW	ATAVAQLLW
VTNPHSSQW	VTNPHSSQW
HSHFQNIFW	HSHFQNIFW
KAFNLRISF	KAFNLRISF
KVNGKGSLW	KVNGKGSLW
VVSPHEDMRTW	VSPHDMRTW
LVWQVQEKW	LVWQVQEKW
KTLERSYLL	KTLERSYLL
LSAHGIVVAW	LSAHIVVAW
SSLPTVEKW	SSLPTVEKW
KANPHNYDAW	KANPNYDAW
NTTAVAEAW	NTTAVAEAW
RTVYPEEHSRW	TVYPEHSRW
RTFKGFQI	RTFK-GFQI
RVVDIYSKF	RVVDIYSKF
FKQYANDNGVD	YAND-NGVD
AALSWQYL	AALS-WQYL
NIPEKTTAL	NIPEKTTAL
KSSPQIPHQTY	KSSPQIPHQ
VSAPSSETF	VSAPSSETF
RTLPTKEFLW	RTLPKEFLW
KSDGKILVW	KSDGKILVW
LSDSQLKVW	LSDSQLKVW
SSYPNTFEW	SSYPNTFEW
RTVEKTWKL	RTVEKTWKL
HSVTASGAEHW	VTASGAEHW
ISGSSVQW	ISGS-SVQW
VSVPDTGSIW	VSVPTGSIW
LSFDAPGRLLW	LSFDAPGRL
KSTLINTLF	KSTLINTLF
GTISREHPW	GTISREHPW
SADHLIILW	SADHLIILW
RAIDSIHQLW	RAIDIHQLW
KSAQDVQKF	KSAQDVQKF
RSLPASQAW	RSLPASQAW
RTILQHLSEAW	TILQLSEAW
RITPEFSKW	RITPEFSKW
GSIPNSWKW	GSIPNSWKW
YADKNLIAKW	YADKLIAKW
KSVGVFEAF	KSVGVFEAF
HTVGLSSTW	HTVGLSSTW
KSVKYTVNF	KSVKYTVNF
LSIHLQHKF	LSIHLQHKF
VSSTNGHRW	VSSTNGHRW
HAAEYGAEALE	HAAEGAEAL
KSGSPVATF	KSGSPVATF
RVFPEKGYSF	RVFPKGYSF
RSYQDPSNAQF	RSYQSNAQF
LAADGKSTTW	LAADKSTTW
SADKTVALW	SADKTVALW
KTGPFVVHW	KTGPFVVHW
KSIEELQDW	KSIEELQDW
LSTLVRPVF	LSTLVRPVF
ASAPNWKW	ASAP-NWKW
VTATSSKW	VTAT-SSKW
RTLDNQLFF	RTLDNQLFF
NSSAVLLQW	NSSAVLLQW
LLGPTAQW	LLGP-TAQW
HPKLQPGIGLW	KLQPGIGLW
HTAPSGVGSSW	HTAPVGSSW
TSVPLPVTW	TSVPLPVTW
GSHGIEAAW	GSHGIEAAW
ASAHDQLLW	ASAHDQLLW
KVFESWMHHW	KVFEWMHHW
KSGLAEHW	KSGL-AEHW
VSAGIQTSF	VSAGIQTSF
TSTIVTLKW	TSTIVTLKW
KSSDIAKTF	KSSDIAKTF
KAADPVPSF	KAADPVPSF
KSLENQTYF	KSLENQTYF
KTLYFHIYY	KTLYFHIYY
ATIGHVEKF	ATIGHVEKF
GTDRNAYVW	GTDRNAYVW
RSVEEPREFW	RSVEPREFW
KMGPMEKFW	KMGPMEKFW
VGGEALELR	VGGEALELR
KTGETMIQW	KTGETMIQW
HAIPLRSSW	HAIPLRSSW
DTNADKQLSF	DTNAKQLSF
KFNETLMKF	KFNETLMKF
SSSKEHVKW	SSSKEHVKW
KSFNRHLHF	KSFNRHLHF
SSMPNAESW	SSMPNAESW
VAVGSGLSW	VAVGSGLSW
VTNPYQATI	VTNPYQATI
SVIEEHANW	SVIEEHANW
LAPTDVKEL	LAPTDVKEL
KLTNIVEKF	KLTNIVEKF
RTEVVQTLW	RTEVVQTLW
KSLEEAQEW	KSLEEAQEW
KQMPDVNVSW	KQMPVNVSW
RSQPQHFTY	RSQPQHFTY
AVNGVQLHY	AVNGVQLHY
RSVPTSTVFY	RSVPTSTVF
YSLPEFEEW	YSLPEFEEW
SADRTVKLW	SADRTVKLW
QTDPSGTYHAW	QTDP-SGTY
HSFPLQFTL	HSFPLQFTL
TTYKLVINGKT	TTYKLVING
IAAQTGTRW	IAAQTGTRW
SSTTVIPTL	SSTTVIPTL
GTFNPVSLW	GTFNPVSLW
AVSRILEEW	AVSRILEEW
RTVEKPPKF	RTVEKPPKF
ASVKVVSKF	ASVKVVSKF
IMDVTEEVW	IMDVTEEVW
KAINPINTF	KAINPINTF
KINELELRL	KINELELRL
SSVRAVAVW	SSVRAVAVW
ATFHQRGIALW	ATFHRGIAL
RAIRDFFW	RAIR-DFFW
TVHQGDTSW	TVHQGDTSW
ISQPASGNTF	ISQPSGNTF
KAQQDKLNTRW	KAQQLNTRW
TSSSSVRVEW	SSSSVRVEW
ITTTINPRF	ITTTINPRF
KTTESHMDW	KTTESHMDW
ATSKYLIGW	ATSKYLIGW
KTMKQQLQF	KTMKQQLQF
RTFSSLHVERW	FSSLHVERW
LSVQPYSQEW	LSVQYSQEW
RSLPEIWTL	RSLPEIWTL
KVIEINPYL	KVIEINPYL
RMNEVISLW	RMNEVISLW
ISNPKTAEF	ISNPKTAEF
LSTRPEKF	LSTR-PEKF
SAGHTFSW	SAGH-TFSW
RVVIFDPSW	RVVIFDPSW
KSIPLVESW	KSIPLVESW
KVIHELANERW	KVIHANERW
RTVPGALGAW	RTVPALGAW
LSGPFVQKW	LSGPFVQKW
LSALDKGSTH	LSALKGSTH
KAVFLVPKW	KAVFLVPKW
MTGPFFRY	MTGP-FFRY
HSEAKTSGLLW	KTSG--LLW
KSLGVTTKF	KSLGVTTKF
KVINAAHSF	KVINAAHSF
HADINLLYW	HADINLLYW
ISFYEERLTW	ISFYERLTW
GTYSPEISW	GTYSPEISW
AEQRGENALKD	RGEN-ALKD
KAGIIQDTW	KAGIIQDTW
KTFTTQETI	KTFTTQETI
KSLEAFFLY	KSLEAFFLY
KGFSDEDNTW	KGFSEDNTW
RGAQVEEIW	RGAQVEEIW
LSSVTQLHL	LSSVTQLHL
RTYPVQEYF	RTYPVQEYF
SATPSLVTW	SATPSLVTW
RLLDLHQSW	RLLDLHQSW
AVDSTVKVW	AVDSTVKVW
ILGPTFTL	ILGP-TFTL
KSGAIIEKW	KSGAIIEKW
SSNVVQLIM	SSNVVQLIM
KSSIGLNTW	KSSIGLNTW
YSLKKRHFF	YSLKKRHFF
VAAKPESW	VAAK-PESW
SIDPNTYITW	SIDPTYITW
HTWKELELW	HTWKELELW
ISAHDILSW	ISAHDILSW
HSHVAVAW	HSHV-AVAW
SASPDATIRIW	SASPATIRI
KMTILQTYF	KMTILQTYF
KSLEEIYLF	KSLEEIYLF
HTYQDHLW	HTYQ-DHLW
LSTIKQLLW	LSTIKQLLW
KLKPFIDREWW	KLKPIDREW
AAGHAELAWT	AAGHAELAW
YTVKISNYGW	YTVKSNYGW
ATEVTGHRW	ATEVTGHRW
SAARLYYYW	SAARLYYYW
ISTEVNPKL	ISTEVNPKL
TSGPGFHL	TSGP-GFHL
RSAVGFLFW	RSAVGFLFW
ASMGFDPRW	ASMGFDPRW
RSFKETTNRW	RSFKTTNRW
KSVLTNYRF	KSVLTNYRF
KILGKFYSW	KILGKFYSW
KVLPPLEQVW	KVLPLEQVW
LSGEAFDW	LSGE-AFDW
KLYEEKTGNAW	KLYETGNAW
RSDIGEFEW	RSDIGEFEW
KVSSINSRF	KVSSINSRF
HSSIVRSGW	HSSIVRSGW
PDEVARRW	PDEV-ARRW
ASAPSWEW	ASAP-SWEW
SAPYGRITL	SAPYGRITL
RSAAYAARW	RSAAYAARW
VSAEETEKW	VSAEETEKW
KAIETQPNF	KAIETQPNF
QSSHLNVHW	QSSHLNVHW
FSFRSFIW	FSFR-SFIW
NSLVDKTSW	NSLVDKTSW
RSLPEPLMTY	RSLPPLMTY
FMVPAQSSW	FMVPAQSSW
RSFQMQYNL	RSFQMQYNL
AAVVPLGTW	AAVVPLGTW
RTAITTPNF	RTAITTPNF
AANPIESQW	AANPIESQW
KVDDYSQEW	KVDDYSQEW
KTVVKELTW	KTVVKELTW
ASGIRGAQAGW	SGIRAQAGW
KKLEELQSMKQ	KKLEELQSM
KGGPPPPNW	KGGPPPPNW
KSLYAIFSQF	KSLYIFSQF
LSFIRDEVTW	LSFIDEVTW
VSLPAPGVPAW	LPAPGVPAW
KLLPGIEVLW	KLLPIEVLW
KSANVSSIW	KSANVSSIW
KIHPQTIIAGW	KIHP-QTII
KVSTSRQTW	KVSTSRQTW
QSVEPLTGW	QSVEPLTGW
IAVEPGNQW	IAVEPGNQW
LSLPDIKVYL	LSLPIKVYL
TSLPLDFGTW	TSLPDFGTW
