Data	Data aligned
ASPSSIRSL	ASPSSIRSL
RRGEFIQEI	RRGEFIQEI
KTVSVALVL	KTVSVALVL
YTDFHVDF	YTDFHV-DF
SRFGNAFHL	SRFGNAFHL
RRFLAARTL	RRFLAARTL
VRFDQVTVY	VRFDQVTVY
SRDKFIREL	SRDKFIREL
IRVDKITEY	IRVDKITEY
ARSENLIYTY	ARSENLYTY
RRGPGPLTL	RRGPGPLTL
ARNEYLLSL	ARNEYLLSL
KYLDEDTIYHL	KYLDEDTIY
KRGVLLML	KRGVLL-ML
ITSPVHVSF	ITSPVHVSF
RNYLHYSL	RNYLHY-SL
RRHMEFRKL	RRHMEFRKL
RRGILIRQL	RRGILIRQL
SIPEKNRPL	SIPEKNRPL
RTAHVILRY	RTAHVILRY
KRASYILRL	KRASYILRL
KRGPGFKY	KRGPGF-KY
TSGPPLTM	TSGPPL-TM
RSMGLPLQF	RSMGLPLQF
ASADTAYVL	ASADTAYVL
IRYPDSHQL	IRYPDSHQL
QRMNFLVTL	QRMNFLVTL
RNLDKAFSY	RNLDKAFSY
KYFDKASYRVY	KYFDKA-SY
YRAVVQIF	YRAVVQ-IF
SGGHPLEF	SGGHPL-EF
KRLTHVYDL	KRLTHVYDL
KSFYHVSY	KSFYHV-SY
AAPGVDLT	AAPGVD-LT
GNYFHHVVL	GNYFHHVVL
KRKDYYKIL	KRKDYYKIL
HRGLFIQQL	HRGLFIQQL
ASHLHIHVF	ASHLHIHVF
LRLSYPLEL	LRLSYPLEL
ARNERIYVY	ARNERIYVY
SRIKGWWVF	SRIKGWWVF
KRPVIVKVL	KRPVIVKVL
VRAWVVFKL	VRAWVVFKL
RRDGQILVY	RRDGQILVY
VYKAFVDNY	VYKAFVDNY
YTVKAILIL	YTVKAILIL
TRVYLILEY	TRVYLILEY
FRVDYILSV	FRVDYILSV
SRFIFNYVY	SRFIFNYVY
KRNKIFMEF	KRNKIFMEF
KRNGVIIAGY	KRNGVIAGY
KRNDYVHALV	KRNDYVHAL
LRSGVIVRL	LRSGVIVRL
RTFWHKISY	RTFWHKISY
KRFYARYSL	KRFYARYSL
RRLDIVRSL	RRLDIVRSL
HRGIELTL	HRGIEL-TL
RRLNFVRLL	RRLNFVRLL
KRFTDEESRVF	FTDEESRVF
ATSKVALVY	ATSKVALVY
RNLDIERPTY	RNLDIEPTY
GRNQEVHTL	GRNQEVHTL
TVTEKPEVID	TVTEKPEVI
RAAPFSLEY	RAAPFSLEY
RTSPYRTVL	RTSPYRTVL
RRIDFVLVY	RRIDFVLVY
SRPRVVIQL	SRPRVVIQL
RRHTDPVQL	RRHTDPVQL
HTLNQIDSVK	HTLNQIDSV
KRLNELREL	KRLNELREL
DSYVGDEAQSK	YVGDEAQSK
KRFEQQQKL	KRFEQQQKL
SRKSFVFEL	SRKSFVFEL
KRREPIPSL	KRREPIPSL
RRNKSYSF	RRNKSY-SF
SRIHPVSTM	SRIHPVSTM
HNVSFAFEL	HNVSFAFEL
FGGEPLSY	FGGEPL-SY
FRMPVLREY	FRMPVLREY
TYVSFPLEL	TYVSFPLEL
SSGPERIL	SSGPER-IL
KRLSVERIY	KRLSVERIY
SSGGFSGGSF	SSGGFSGSF
KMHPHPVAL	KMHPHPVAL
SRGDFVVEY	SRGDFVVEY
STNAYMLIY	STNAYMLIY
SREGRPIWQL	SREGRPWQL
RRAGYINEF	RRAGYINEF
KRYQEALHL	KRYQEALHL
LRNQSVFNF	LRNQSVFNF
RRAQPLVTL	RRAQPLVTL
TTYKLVINGK	TTYKLVING
QRNEVVVEL	QRNEVVVEL
TRNDYVMMY	TRNDYVMMY
TRSAIILHL	TRSAIILHL
RNLLHDNEL	RNLLHDNEL
ARPRFEPVHF	ARPRFEVHF
YSTPHAFTF	YSTPHAFTF
RRHTVYLDSY	RRHTVYLDS
RYSEAVFYY	RYSEAVFYY
RRSPFLQVF	RRSPFLQVF
RNLRTALIF	RNLRTALIF
SIEGRVAVEY	IEGRVAVEY
RSLAYIHSF	RSLAYIHSF
KTSDVYWVL	KTSDVYWVL
KRLKTVLEL	KRLKTVLEL
RRLGLALGL	RRLGLALGL
ATNPESKVF	ATNPESKVF
SNFLHPVIY	SNFLHPVIY
SSRSSSVDYIL	SRSSSVYIL
VSGPAMTL	VSGPAM-TL
KRFFEVRRV	KRFFEVRRV
KSAVGFDY	KSAVGF-DY
IRWSYGAGIVL	SYGAGI-VL
IRGPILSF	IRGPIL-SF
MRYVASYLL	MRYVASYLL
RRFTEIYEF	RRFTEIYEF
KRFVNDTL	KRFVND-TL
MRAENFFIL	MRAENFFIL
QRNLFILAY	QRNLFILAY
RRGEYVLTF	RRGEYVLTF
RRFPSPHYL	RRFPSPHYL
LRPSTSRSL	LRPSTSRSL
QQNPQPLIF	QQNPQPLIF
KYMPHAVL	KYMPHA-VL
VRPPTPREL	VRPPTPREL
STPSEPHPVL	STPSEPPVL
SRPKLSFSL	SRPKLSFSL
RSGPEFTLL	RSGPEFTLL
HRGPVLSL	HRGPVL-SL
SKAEAESLYQS	SKAEAE-SL
KRNPSSSTL	KRNPSSSTL
RRDTNVLVY	RRDTNVLVY
AQYEDIAQK	AQYEDIAQK
RRFDPKLFLVF	RRFDPKLFL
RRLENIRFL	RRLENIRFL
YLPDGTASL	YLPDGTASL
TRGWVQTL	TRGWVQ-TL
RSMEAHNIL	RSMEAHNIL
RAQTVVVEY	RAQTVVVEY
NRGDFFMTL	NRGDFFMTL
SRASPVRLL	SRASPVRLL
RNYLHYSLY	RNYLHYSLY
SRFSNVYHL	SRFSNVYHL
ATAPVVTF	ATAPVV-TF
RVVSYQIRY	RVVSYQIRY
RRMETIVFL	RRMETIVFL
LEDALQQAKED	DALQQAKED
RRSSSWRIL	RRSSSWRIL
IRNDYYLNL	IRNDYYLNL
RRKEVVVYL	RRKEVVVYL
ARGQYVKFL	ARGQYVKFL
KYFEKQFEL	KYFEKQFEL
RRGPNRTSY	RRGPNRTSY
RLPAWQPIL	RLPAWQPIL
RGGPILTF	RGGPIL-TF
KRAEKERIM	KRAEKERIM
KSTDVAKTF	KSTDVAKTF
KTYGVSFFL	KTYGVSFFL
SRVKLILEY	SRVKLILEY
RGSDVIIML	RGSDVIIML
ARADFQKVL	ARADFQKVL
ASFHRVWSF	ASFHRVWSF
RSINQPVAF	RSINQPVAF
NTDEPPMVF	NTDEPPMVF
QRVDYIMQL	QRVDYIMQL
LRNPDIRVL	LRNPDIRVL
STPEFTIL	STPEFT-IL
YRGPANGF	YRGPAN-GF
ERIAGEASRL	RIAGEASRL
KRLDVTVQSF	KRLDVTQSF
LRNKVIIEY	LRNKVIIEY
YRNEFTAWY	YRNEFTAWY
LRDHSVRVL	LRDHSVRVL
RRSSQSWSL	RRSSQSWSL
IRFQEERRL	IRFQEERRL
RRGAIRVL	RRGAIR-VL
KAFARPWSL	KAFARPWSL
KRGEIPLEL	KRGEIPLEL
KNHFHQSF	KNHFHQ-SF
KTSDFLKVL	KTSDFLKVL
KRREYLYQL	KRREYLYQL
VRFHRPYRL	VRFHRPYRL
NAENEFVTIK	AENEFVTIK
GNYLHPSL	GNYLHP-SL
KRPVAVYNL	KRPVAVYNL
LRDRHVRFF	LRDRHVRFF
RTAIHEVM	RTAIHE-VM
RRKDGVFLY	RRKDGVFLY
RRNDKIIVF	RRNDKIIVF
YAAPHFFHL	YAAPHFFHL
SRNAYMLVY	SRNAYMLVY
AAPVPTTTL	AAPVPTTTL
KTNHVFFLL	KTNHVFFLL
LRGVVQEL	LRGVVQ-EL
VAPVTHVSV	VAPVTHVSV
RTPDTPFSL	RTPDTPFSL
YRNAYTMVL	YRNAYTMVL
VRNDIYITL	VRNDIYITL
RNYFKKEEL	RNYFKKEEL
SVKHFHVEY	SVKHFHVEY
IDNNIEQISSY	NNIEQISSY
RTHPVATSF	RTHPVATSF
LRVAPEEHPTL	VAPEEHPTL
VSPVVRVAV	VSPVVRVAV
SRSEYLNRL	SRSEYLNRL
LTTMGDRF	LTTMGD-RF
RRKDFVSEAY	RRKDFVSEA
ARLNWILHF	ARLNWILHF
KSFEGLFYF	KSFEGLFYF
KAPAPRPSL	KAPAPRPSL
RRNPYCRTL	RRNPYCRTL
ASSGHYIAY	ASSGHYIAY
KTKSIAEEL	KTKSIAEEL
RTPGNRIVY	RTPGNRIVY
KAFPFHIIF	KAFPFHIIF
YRAQPSVSL	YRAQPSVSL
RRNPGVVIY	RRNPGVVIY
SRKESYSIYVY	SRKESYSIY
TRIPRVRVL	TRIPRVRVL
YAPSGNFV	YAPSGN-FV
RLPEIYIQL	RLPEIYIQL
NRLGYTHLY	NRLGYTHLY
RTKASVHTL	RTKASVHTL
RNLPTIFVY	RNLPTIFVY
HSGPAVYF	HSGPAV-YF
ARNEYLLNL	ARNEYLLNL
RRYSTLREL	RRYSTLREL
RRCPHVETL	RRCPHVETL
FRTPHVLVL	FRTPHVLVL
RRTSAIKAL	RRTSAIKAL
KRWESERVL	KRWESERVL
QRGDLIRIL	QRGDLIRIL
RRFMQTFVL	RRFMQTFVL
RSPDFASSF	RSPDFASSF
GRMVQVHEL	GRMVQVHEL
TSPEAFLAL	TSPEAFLAL
IRKPYIWEY	IRKPYIWEY
RTADFVFMF	RTADFVFMF
RRAAMERQL	RRAAMERQL
RRGDIIEVL	RRGDIIEVL
RRWDDDVVF	RRWDDDVVF
RRYQDKRLL	RRYQDKRLL
QRQDIAFAY	QRQDIAFAY
ARGPIQIL	ARGPIQ-IL
ARMEFILRH	ARMEFILRH
AEQRGELAIKD	QRGELAIKD
KGFVHKVEL	KGFVHKVEL
RTSAEIAAIVF	SAEIAAIVF
GYPGGIHEV	GYPGGIHEV
KRQLYYQVL	KRQLYYQVL
VLPEHVSVL	VLPEHVSVL
RRPSFTRTW	RRPSFTRTW
SRAPSTYTY	SRAPSTYTY
KRYHIAKVY	KRYHIAKVY
SRIGSIINY	SRIGSIINY
ITPTGTHPL	ITPTGTHPL
VRKDLQNF	VRKDLQ-NF
RRGPPRNY	RRGPPR-NY
TRSKSLKIL	TRSKSLKIL
KRLDVEFVL	KRLDVEFVL
YNLIHPEY	YNLIHP-EY
SRNPQSYHL	SRNPQSYHL
GRYHVIRKL	GRYHVIRKL
PTTKTYFPHF	TTKTYFPHF
IRSSHIKYI	IRSSHIKYI
VTIPIHFIY	VTIPIHFIY
RVQEAIIHF	RVQEAIIHF
KRFGKAYNL	KRFGKAYNL
SRVEAVYVL	SRVEAVYVL
HSFLHPSY	HSFLHP-SY
GRFEDVYQL	GRFEDVYQL
RVYVHPFHL	RVYVHPFHL
AQQGHRPYFL	QQGHRPYFL
NIPEKTTAL	NIPEKTTAL
RRGHTALHL	RRGHTALHL
RNFVEETVY	RNFVEETVY
TTFFHHEY	TTFFHH-EY
SAPVPASPL	SAPVPASPL
SRGDVKVIM	SRGDVKVIM
KGSGVVIIM	KGSGVVIIM
ARNTVTQVL	ARNTVTQVL
RRNEALPVTL	RRNEALVTL
SRNKDTYFL	SRNKDTYFL
IRMTYIKEL	IRMTYIKEL
RRFEEALQTIF	RRFEEALQT
ARLPLVNSY	ARLPLVNSY
RRAPAGGSL	RRAPAGGSL
RRSINQPVAF	RSINQPVAF
TRAQWFYEY	TRAQWFYEY
KRGILTLKY	KRGILTLKY
TRNPLVAVY	TRNPLVAVY
RRGIFHIIL	RRGIFHIIL
VAPPVSGDL	VAPPVSGDL
KTIDYIQFL	KTIDYIQFL
IRVVGSEF	IRVVGS-EF
YRAQPSASL	YRAQPSASL
RTIGFFYTL	RTIGFFYTL
RRIQDPLIEF	RRIQDPIEF
HRYEVVTEL	HRYEVVTEL
RRYPIARVF	RRYPIARVF
RRAAEPVTF	RRAAEPVTF
RNVSTGDVNVE	STGDVN-VE
RNGPYRQL	RNGPYR-QL
KRVTWIVEF	KRVTWIVEF
VSSIPLVL	VSSIPL-VL
EMKPHPWFF	EMKPHPWFF
RRIQFPIEM	RRIQFPIEM
KLPPLPLTL	KLPPLPLTL
RVKPNIFSY	RVKPNIFSY
KRFDDKYTL	KRFDDKYTL
RRAEVELEY	RRAEVELEY
ALEEQLQQIR	ALEEQLQQI
NRGDKYIAKF	RGDKYIAKF
QRNVNIFKF	QRNVNIFKF
EEQLQQIR	EEQLQQ-IR
AAPALASSL	AAPALASSL
FTDEESRVF	FTDEESRVF
AAAPAGTTF	AAAPAGTTF
IRSSYIRVL	IRSSYIRVL
LRHDRPYTL	LRHDRPYTL
HRNPLIRKY	HRNPLIRKY
YNEFPEPIKL	NEFPEPIKL
RRAPHLHTL	RRAPHLHTL
STIGQAFEL	STIGQAFEL
RRPEYTPIHL	RRPEYTIHL
IRHETIRVA	IRHETIRVA
IRNQIIREL	IRNQIIREL
RSGPWNRGF	RSGPWNRGF
RRKDLVLKY	RRKDLVLKY
KRSELVNWY	KRSELVNWY
RRFDTAFFL	RRFDTAFFL
FRGVVIKY	FRGVVI-KY
KRSGAIQVL	KRSGAIQVL
KTNEMLLNF	KTNEMLLNF
LLNSNIPLE	LLNSNIPLE
SRYDGQIAVF	SRYDGQAVF
KRGVVTML	KRGVVT-ML
SRMPGELVL	SRMPGELVL
ARVIFITEY	ARVIFITEY
ITDLPIKL	ITDLPI-KL
IRFVHKEM	IRFVHK-EM
SRPENAIIY	SRPENAIIY
VIGPPVVL	VIGPPV-VL
SVPEAQSAL	SVPEAQSAL
GAPVAAAAL	GAPVAAAAL
SRFEKEFSF	SRFEKEFSF
RRFEKAHNL	RRFEKAHNL
KKTEVVITL	KKTEVVITL
SRSVIIREL	SRSVIIREL
TRLGFFTTY	TRLGFFTTY
KRREPLPSL	KRREPLPSL
ISPTGHSL	ISPTGH-SL
RRHNAEKLL	RRHNAEKLL
KRKGQVIQF	KRKGQVIQF
HRLPPVTSF	HRLPPVTSF
KRIAEFAFEY	RIAEFAFEY
AAPATRAAL	AAPATRAAL
YRAPGTPTY	YRAPGTPTY
RRGDLPFVV	RRGDLPFVV
TRVDTILEF	TRVDTILEF
STGEPLEL	STGEPL-EL
HSTVHLIEF	HSTVHLIEF
RVQGFQVEY	RVQGFQVEY
IVPGNVKSL	IVPGNVKSL
SRTNRPPLSL	RTNRPPLSL
KTSPYPVIL	KTSPYPVIL
KRIDYILVY	KRIDYILVY
SAPGPSQSL	SAPGPSQSL
KRADLQSTF	KRADLQSTF
AQFNRMTVEY	AQFNRMVEY
KRGDILKVL	KRGDILKVL
HRNGGLITL	HRNGGLITL
TRMSTVSEL	TRMSTVSEL
KRSTYNYSL	KRSTYNYSL
YQSKYEEL	YQSKYE-EL
GRNSTPLHL	GRNSTPLHL
VRPEQPFIVL	VRPEQPIVL
SIPGGYNAL	SIPGGYNAL
NVKVDPEIQ	NVKVDPEIQ
RRFKEPWFL	RRFKEPWFL
IRASVGAGF	IRASVGAGF
ARNDYLLTL	ARNDYLLTL
RRPEPVQTL	RRPEPVQTL
AYKDAIYVF	AYKDAIYVF
SSLLEKGLD	SSLLEKGLD
RTPDGQYIY	RTPDGQYIY
HAGPPVYF	HAGPPV-YF
RRLSELLRY	RRLSELLRY
RRGDTFYVV	RRGDTFYVV
SRYQDILVF	SRYQDILVF
ASSPHGLVM	ASSPHGLVM
GTSPYVYQL	GTSPYVYQL
ATNPKPVKL	ATNPKPVKL
IPLRVMLLL	IPLRVMLLL
PIRPDIVNF	PIRPDIVNF
FRPLYTHEY	FRPLYTHEY
SRFAKVHIL	SRFAKVHIL
QRAEVIRIL	QRAEVIRIL
ANSSIRPIF	ANSSIRPIF
IRRYQKSTEL	RRYQKSTEL
KKPELVISY	KKPELVISY
ARYSGSYNDYL	ARYSGSNDY
KRSQLVKKL	KRSQLVKKL
ARLDLPYEL	ARLDLPYEL
SRVQYFWEA	SRVQYFWEA
HNSGVPVYL	HNSGVPVYL
KKNPFHLEL	KKNPFHLEL
IRDNFVIIY	IRDNFVIIY
SINQFALEL	SINQFALEL
HSNPYFFLL	HSNPYFFLL
ATNPISRVL	ATNPISRVL
IAPGVTHEL	IAPGVTHEL
RTFGGGFEL	RTFGGGFEL
RRSPVKVVF	RRSPVKVVF
HSQFHAPL	HSQFHA-PL
RNKESPVF	RNKESP-VF
YRGIFPVL	YRGIFP-VL
KSTPVTVVL	KSTPVTVVL
RTADVIIMM	RTADVIIMM
AAPVSATVL	AAPVSATVL
RRMEVYNEF	RRMEVYNEF
RTFLHTVCF	RTFLHTVCF
VRNNVIIVM	VRNNVIIVM
KRGDLIIEF	KRGDLIIEF
ITQIEHEVS	ITQIEHEVS
HTFLHTVY	HTFLHT-VY
YRLEYMRVL	YRLEYMRVL
RSSTYVQVL	RSSTYVQVL
KRGFGFVY	KRGFGF-VY
YSGVLITL	YSGVLI-TL
RRVEKHWRL	RRVEKHWRL
FKQYANDNGVD	YANDNG-VD
KRAKHFLEL	KRAKHFLEL
KRQDMVQRL	KRQDMVQRL
RRFPLEQRL	RRFPLEQRL
RRISQIQQL	RRISQIQQL
YRHDAVKIL	YRHDAVKIL
SRIGHIAHL	SRIGHIAHL
VAPGKDLTKT	VAPGKDLTK
KSNNEIVLVL	SNNEIVLVL
KAEAESLYQS	KAEAES-LY
RQRSLFVVV	RQRSLFVVV
LTFNKKEF	LTFNKK-EF
SRNDFTLQL	SRNDFTLQL
KTKTVTLEY	KTKTVTLEY
YRGQPGNAY	YRGQPGNAY
IRGNVGFVF	IRGNVGFVF
HTDTTVKF	HTDTTV-KF
EEQLQQIRAE	EQLQQIRAE
NREGLPLMVF	REGLPLMVF
HRNEVTVEL	HRNEVTVEL
AGPLRKSSL	AGPLRKSSL
YRGPCHTY	YRGPCH-TY
RSFFHQHYL	RSFFHQHYL
IRGHVLSL	IRGHVL-SL
RRPYVRVEL	RRPYVRVEL
RRPEFQTLL	RRPEFQTLL
VTKKYHEVL	VTKKYHEVL
RRNPEPLRF	RRNPEPLRF
TRMRHVISY	TRMRHVISY
KRNDYVHAL	KRNDYVHAL
TRNDYVMM	TRNDYV-MM
KRIDIIHNL	KRIDIIHNL
RRVEVTRQL	RRVEVTRQL
FTNRTVLEL	FTNRTVLEL
RRQELEQVL	RRQELEQVL
KAPEPLSSL	KAPEPLSSL
HNKEPVYSL	HNKEPVYSL
AVSPYSIVL	AVSPYSIVL
SRPSTYYEL	SRPSTYYEL
TRWPGFYIL	TRWPGFYIL
KRGEYIKTW	KRGEYIKTW
AANKTIIYL	AANKTIIYL
KRLQQFLEF	KRLQQFLEF
IRPENVIIY	IRPENVIIY
FTSHNGMQF	FTSHNGMQF
ATYNGPKHSL	YNGPKH-SL
KRLLVVREL	KRLLVVREL
RTNHQGTYVL	TNHQGTYVL
HSGPIHVL	HSGPIH-VL
ATGPDLEF	ATGPDL-EF
IGGPAILL	IGGPAI-LL
KRFSYSRYM	KRFSYSRYM
RRAEGPPRLA	RRAEGPPRL
FTEKEWPLL	FTEKEWPLL
RRIYLILEY	RRIYLILEY
KAPEMTNEL	KAPEMTNEL
KRFDMAVMF	KRFDMAVMF
SRLFFVIEY	SRLFFVIEY
KIPDKQYVL	KIPDKQYVL
KSQVHPVL	KSQVHP-VL
YRPAYLVTL	YRPAYLVTL
RRISGVDRYY	RRISGVRYY
RRCGSKAYHL	RCGSKAYHL
ARAPLHYL	ARAPLH-YL
KTNAIPLTL	KTNAIPLTL
HNVGYHIVY	HNVGYHIVY
MAPERVASL	MAPERVASL
RIYPHGLVL	RIYPHGLVL
KRQEAIFEL	KRQEAIFEL
SRNSSMLTL	SRNSSMLTL
GRNPFVHEL	GRNPFVHEL
GRIVAFFEF	GRIVAFFEF
VAPLPRSAL	VAPLPRSAL
KRFVPSQHYVY	KRFVPSQHY
KRLNFITEY	KRLNFITEY
HRFEQAFYTY	HRFEQAYTY
ATFARIWYL	ATFARIWYL
SRNKQVREL	SRNKQVREL
SRAPVFLQF	SRAPVFLQF
RTNEGVIEF	RTNEGVIEF
FRLLGNVL	FRLLGN-VL
RNKEIVHTF	RNKEIVHTF
FRGPVVPAF	FRGPVVPAF
RNRFVELHF	RNRFVELHF
LRVAPEEHPVL	VAPEEHPVL
SVPGKDAIYSL	PGKDAIYSL
VTDGKEVLL	VTDGKEVLL
KRADWLARL	KRADWLARL
YTNGKCVIL	YTNGKCVIL
HRYPAVHVY	HRYPAVHVY
HSYFHKWSA	HSYFHKWSA
GNYYKPWFF	GNYYKPWFF
RYMELYTHVY	RYMELYHVY
ARNPSTVCL	ARNPSTVCL
RRGGNIIL	RRGGNI-IL
IRENHERAL	IRENHERAL
RPPGFSPFR	RPPGFSPFR
TNHLHQTPL	TNHLHQTPL
RNLDAQYEM	RNLDAQYEM
KRSNYITRL	KRSNYITRL
YNNFSGNSL	YNNFSGNSL
KTVYALPTIAF	YALPTI-AF
IRGPTYVWTF	RGPTYVWTF
ARAPGTRTL	ARAPGTRTL
GRHSLPKTL	GRHSLPKTL
KTFPYQHRY	KTFPYQHRY
RNNSVVQVL	RNNSVVQVL
RNRYAGEVY	RNRYAGEVY
FHPEAHAITL	HPEAHAITL
RTGPALVL	RTGPAL-VL
EGVHGGLINKK	GVHGGLINK
YRDPRERTL	YRDPRERTL
VINPEPITL	VINPEPITL
SVPLAATSM	SVPLAATSM
SRMGLIIVN	SRMGLIIVN
YTSDYFISY	YTSDYFISY
KTKGFEVYL	KTKGFEVYL
IAPTGHSL	IAPTGH-SL
RRDFQIRVL	RRDFQIRVL
SRFTYPYLL	SRFTYPYLL
KRGDVIYIL	KRGDVIYIL
YGSPGILEF	YGSPGILEF
KRYDREFLL	KRYDREFLL
RRQEAIYEM	RRQEAIYEM
TRSFYKHIL	TRSFYKHIL
AMYPHIFYF	AMYPHIFYF
ITGVVITL	ITGVVI-TL
ASLMHSFIL	ASLMHSFIL
NAPWAVTSL	NAPWAVTSL
RRRSSTFTL	RRRSSTFTL
RYMDDYIFTY	YMDDYIFTY
QRPTIYYVM	QRPTIYYVM
SRVIHIRKL	SRVIHIRKL
IRPNIILVL	IRPNIILVL
SAPVGVTAL	SAPVGVTAL
IRGPTQHEL	IRGPTQHEL
HSGPPIVI	HSGPPI-VI
YTTDFIFNL	YTTDFIFNL
KNFVSQEL	KNFVSQ-EL
RVAIHGWSY	RVAIHGWSY
QIPEIKQTL	QIPEIKQTL
RRDDMLRMY	RRDDMLRMY
KRHKVIGTF	KRHKVIGTF
RTNNIELHY	RTNNIELHY
NVEIDPEIQ	NVEIDPEIQ
LRPGVRHPL	LRPGVRHPL
RRFEYKYSF	RRFEYKYSF
KRVEDAYIL	KRVEDAYIL
KRAYIPRTL	KRAYIPRTL
RRGPFPLAL	RRGPFPLAL
ARDPGARVL	ARDPGARVL
KYEELQIT	KYEELQ-IT
VSNKYGLVF	VSNKYGLVF
KNLAFYWIL	KNLAFYWIL
KRVKANIEF	KRVKANIEF
YRHPDPREL	YRHPDPREL
RNLHVVFTM	RNLHVVFTM
KRYDGDITDL	KRYDGDTDL
RRFDAMPFTL	RRFDAMFTL
ARSDKPIFTL	ARSDKPFTL
VRGVVHVY	VRGVVH-VY
ITFPGLHEL	ITFPGLHEL
LRHPAIRVL	LRHPAIRVL
RISDVHFSV	RISDVHFSV
SSTISSNVASK	ISSNVA-SK
RRPKFCRKM	RRPKFCRKM
RRGPLTWYL	RRGPLTWYL
RRSAKIAVY	RRSAKIAVY
RTATYITEL	RTATYITEL
RSFPSVREL	RSFPSVREL
ATISYILTL	ATISYILTL
RRMGQPKRL	RRMGQPKRL
LLVVYPWTQR	LLVVYPWTQ
RAAPHRISL	RAAPHRISL
FNDEKTYL	FNDEKT-YL
RTKDTPLSL	RTKDTPLSL
SVVFHSTVI	SVVFHSTVI
TIIDTKGVTAL	DTKGVT-AL
RRIEVNVEL	RRIEVNVEL
KRWESERIL	KRWESERIL
RRRDHISHF	RRRDHISHF
YEEIAQRS	YEEIAQ-RS
ATNAAVTVL	ATNAAVTVL
ARLKEVLEY	ARLKEVLEY
IRGVVIVL	IRGVVI-VL
ETFNTPAMY	ETFNTPAMY
KRHSIISVL	KRHSIISVL
RRGDFIHVM	RRGDFIHVM
KSNPKPLVL	KSNPKPLVL
GGLPERSVSL	GLPERSVSL
ITNKYQLVF	ITNKYQLVF
RRAQMTKYL	RRAQMTKYL
RIPSFVTEL	RIPSFVTEL
IRKLPFQRL	IRKLPFQRL
KVSDYEMKL	KVSDYEMKL
SRAKAVRAL	SRAKAVRAL
VAPGKDLTKTL	PGKDLTKTL
TRDPLVIEL	TRDPLVIEL
KTKPFQLQL	KTKPFQLQL
RNVARCWTY	RNVARCWTY
SSPEFSKTL	SSPEFSKTL
KRFSGTVRL	KRFSGTVRL
KTKETIQVL	KTKETIQVL
QRYHQPHTL	QRYHQPHTL
KNAQYVLVF	KNAQYVLVF
RVFPHAEF	RVFPHA-EF
VGGPEIEL	VGGPEI-EL
KNSYHPVSL	KNSYHPVSL
VRSPVVHSV	VRSPVVHSV
RRKHQITYL	RRKHQITYL
RVIDYILDL	RVIDYILDL
FAPYNKPSL	FAPYNKPSL
SRHSGPFFTF	SRHSGPFTF
KVFEYHNVL	KVFEYHNVL
KVNGRPLEM	KVNGRPLEM
DLGEEHFK	DLGEEH-FK
RRPARCYRY	RRPARCYRY
LNSRDELF	LNSRDE-LF
VTDPRVVDL	VTDPRVVDL
GRAPQVLVL	GRAPQVLVL
TRAQLPVVVF	RAQLPVVVF
KYIGYARQY	KYIGYARQY
SRNLFVLGF	SRNLFVLGF
RILDQPYSL	RILDQPYSL
GSGLPLVL	GSGLPL-VL
IRSQAIHQL	IRSQAIHQL
KTPEEVIEY	KTPEEVIEY
VTGPEIVY	VTGPEI-VY
NRLSFFFDF	NRLSFFFDF
RRAPVVVRL	RRAPVVVRL
GSNPVRVSF	GSNPVRVSF
SFEDAKEAL	SFEDAKEAL
RSQEYKIVL	RSQEYKIVL
ASNPAMLLY	ASNPAMLLY
RRSHDLHTL	RRSHDLHTL
GRIGYIYAL	GRIGYIYAL
NRFNYPFEL	NRFNYPFEL
SRGPGTSFEF	SRGPGTFEF
RTYDLYITY	RTYDLYITY
KRNFNYHIL	KRNFNYHIL
RTISVILFL	RTISVILFL
LAGPALEL	LAGPAL-EL
RGVEFVHVY	RGVEFVHVY
TAPQGNVDL	TAPQGNVDL
TEELNREVATN	LNREVA-TN
RRIEIAHSL	RRIEIAHSL
YTTDFIYQL	YTTDFIYQL
ARRENILVM	ARRENILVM
RNLFHRQGF	RNLFHRQGF
ASNKYLVEF	ASNKYLVEF
HYFLHISL	HYFLHI-SL
RSLGVHLSF	RSLGVHLSF
RKNPFVYKV	RKNPFVYKV
ANKYQVFFF	ANKYQVFFF
RRTETVQKL	RRTETVQKL
KTYDYLFKL	KTYDYLFKL
IRDDHIRFI	IRDDHIRFI
LQIDNARLA	LQIDNARLA
TRVKAVRIL	TRVKAVRIL
RILVHEWPM	RILVHEWPM
KRPNAILKL	KRPNAILKL
HNLTHPEL	HNLTHP-EL
RRNHSQHIL	RRNHSQHIL
TTYKLVINGKT	TTYKLVING
ARNKNIHYY	ARNKNIHYY
ERNPAVYNF	ERNPAVYNF
KVAGIAKVL	KVAGIAKVL
SRIAGIRVL	SRIAGIRVL
RVYIHPFHL	RVYIHPFHL
ERVSYALLF	ERVSYALLF
SIIAEVKAQ	SIIAEVKAQ
KKPNFILLL	KKPNFILLL
KRVFPKWTY	KRVFPKWTY
KRPFGVSLL	KRPFGVSLL
LTGPVLEL	LTGPVL-EL
RTPSDVKEL	RTPSDVKEL
RKPKYIHNL	RKPKYIHNL
RSFFHQHY	RSFFHQ-HY
KTKEVYELL	KTKEVYELL
TRGPVVRL	TRGPVV-RL
VRPSYWLVL	VRPSYWLVL
HRAQVIYTR	HRAQVIYTR
YRPETGSWVF	YRPETGWVF
KRFQVAVNL	KRFQVAVNL
RRPRIPREL	RRPRIPREL
RRFFPYYVY	RRFFPYYVY
RASQFTIVL	RASQFTIVL
IRAIAEEL	IRAIAE-EL
AQNRFLLEL	AQNRFLLEL
IIHEIAVLEL	IIHEIALEL
TVTEKPEVIDA	TVTEKPEVI
IRQTGVIVL	IRQTGVIVL
KNTDIAKEL	KNTDIAKEL
QRGPVRGI	QRGPVR-GI
HRGAVVVL	HRGAVV-VL
IRPQVVTTF	IRPQVVTTF
VTDDHIRM	VTDDHI-RM
NRGEVVTSF	NRGEVVTSF
KSYVHSAL	KSYVHS-AL
IRGVINQL	IRGVIN-QL
MRYVASYL	MRYVAS-YL
RRKDGVFL	RRKDGV-FL
VRNPRITSL	VRNPRITSL
ASGGHYYSY	ASGGHYYSY
ASFVGYSY	ASFVGY-SY
KRPEFVRGY	KRPEFVRGY
SGPGPAAAL	SGPGPAAAL
KRQEVIYEL	KRQEVIYEL
KRPSSVKVF	KRPSSVKVF
RRFFYDQAF	RRFFYDQAF
ASGPELIL	ASGPEL-IL
SVHGKPSVVY	SVHGKPVVY
ARGVIRLL	ARGVIR-LL
RRWHLQHTL	RRWHLQHTL
HSGPFFTF	HSGPFF-TF
RNFHVFLEY	RNFHVFLEY
KRLGILVVF	KRLGILVVF
RNHPYPYLM	RNHPYPYLM
SLVGLGGTK	SLVGLGGTK
FSNPYSIEY	FSNPYSIEY
HTHDYPYSL	HTHDYPYSL
VRTPYTMSY	VRTPYTMSY
YRTDMIQAL	YRTDMIQAL
RVAMYVHAY	RVAMYVHAY
KRGDFIPGL	KRGDFIPGL
ASLLHPVVY	ASLLHPVVY
ARAPVHSSM	ARAPVHSSM
KRKEYFFKY	KRKEYFFKY
NSGDVNVEIN	NSGDVNVEI
RIAEFAFEY	RIAEFAFEY
YSAPGRDL	YSAPGR-DL
SGGPGFTF	SGGPGF-TF
IREEYPDR	IREEYP-DR
KTKSVVLQL	KTKSVVLQL
KRKDEIEREVL	KRKDEIREV
RRSDPGHYSF	RSDPGHYSF
ARFGSVNEL	ARFGSVNEL
RYVEFNLLY	RYVEFNLLY
RRSPTKSSL	RRSPTKSSL
QRRHFIIQY	QRRHFIIQY
ISERYGPVFTI	ERYGPVFTI
FTDEESRVFL	FTDEESRVF
RRPKYTIYF	RRPKYTIYF
KRPVFIFEW	KRPVFIFEW
ARLAETREL	ARLAETREL
RRQNVAYEY	RRQNVAYEY
RSLSTTNVF	RSLSTTNVF
PRKIEEIKDF	RKIEEIKDF
IRPEHVLRL	IRPEHVLRL
RRFKWAIEL	RRFKWAIEL
AGGHPLEL	AGGHPL-EL
NRHGLIRKY	NRHGLIRKY
KRYSGNMEY	KRYSGNMEY
RRLDLVHTA	RRLDLVHTA
ATNKITIIF	ATNKITIIF
VRVPYFIDL	VRVPYFIDL
RRLPDAHSDY	RRLPDAHSD
ARYGKSPYLY	ARYGKSPYL
SRLYLIFEF	SRLYLIFEF
KRPRLPRKL	KRPRLPRKL
VNFVHTNL	VNFVHT-NL
KVKEFFEKL	KVKEFFEKL
SRLGSSRVL	SRLGSSRVL
KRLGIARVV	KRLGIARVV
KRTTVVAQL	KRTTVVAQL
YRDAYLFLL	YRDAYLFLL
SVLPFQIYY	SVLPFQIYY
KRNEFESVL	KRNEFESVL
IGTAGASDVHV	AGASDV-HV
KRLATEFEL	KRLATEFEL
SAPDKSLEL	SAPDKSLEL
ADINGLRQVLD	INGLRQ-VL
RRFHGVKTM	RRFHGVKTM
KRKGVHCVM	KRKGVHCVM
KANHAELIL	KANHAELIL
IRNHHVASL	IRNHHVASL
AFNPEPLVL	AFNPEPLVL
RRYEIAVNL	RRYEIAVNL
RLPDVQLWL	RLPDVQLWL
VTDTNVIL	VTDTNV-IL
AVSEAAIIL	AVSEAAIIL
KRDAYVSRL	KRDAYVSRL
AAPTSAAAL	AAPTSAAAL
RQFPTAFEF	RQFPTAFEF
QTNDVLLTF	QTNDVLLTF
SRMYFTQTL	SRMYFTQTL
QVHPDTGISSK	VHPDTGISS
VNLPINGNGKQ	VNLPIN---
SIPILASAL	SIPILASAL
KRAPGIRSW	KRAPGIRSW
KTTVILIL	KTTVIL-IL
KRNEFLGEL	KRNEFLGEL
SRFDMIFIV	SRFDMIFIV
STDVAKTF	STDVAK-TF
AEQRGENALKD	QRGENALKD
SVNRYILQL	SVNRYILQL
RRGIALIF	RRGIAL-IF
RRYQKSTEL	RRYQKSTEL
ARAIYAYAL	ARAIYAYAL
RYIDRIHIFF	RYIDRIHIF
RSLPFPTVL	RSLPFPTVL
FNEKSKEL	FNEKSK-EL
AAGRPLEL	AAGRPL-EL
VSPYTEIHL	VSPYTEIHL
ATDDPAARF	ATDDPAARF
ARYSGSYNDY	ARYSGSNDY
ARPRTEVSL	ARPRTEVSL
KRFADFTVY	KRFADFTVY
SGPQAPVFEF	SGPQAPFEF
HLPSGVKSL	HLPSGVKSL
FRVPTANVS	FRVPTANVS
AAPSAAREL	AAPSAAREL
FRDAFTQEL	FRDAFTQEL
KTNDQMVVVY	KTNDQMVVY
FTEDQTAEF	FTEDQTAEF
AAPEGVPL	AAPEGV-PL
MAPLKMLAL	MAPLKMLAL
DTYGSSILSIL	YGSSILSIL
ARMEFAWIY	ARMEFAWIY
RRNEQIRKL	RRNEQIRKL
SAIPANIHIY	AIPANIHIY
LTISSLQPEDF	ISSLQPEDF
SRRFFPYYVY	RRFFPYYVY
ARGPLRQTF	ARGPLRQTF
YTDFHIDF	YTDFHI-DF
RNTFHVISF	RNTFHVISF
LAPTDVKEL	LAPTDVKEL
ALPEIFTEL	ALPEIFTEL
RRGPHHYEL	RRGPHHYEL
RRPLFALLL	RRPLFALLL
RRHEVARLL	RRHEVARLL
SLVNLGGSK	SLVNLGGSK
SRNEIIQSY	SRNEIIQSY
RRFNYVVRL	RRFNYVVRL
RRGPCIIY	RRGPCI-IY
YNHPVHFVF	YNHPVHFVF
SSKGSLGGGF	SKGSLGGGF
NAPLVHATL	NAPLVHATL
KRASVFVKL	KRASVFVKL
RRSSIPITV	RRSSIPITV
KRTGTVQVL	KRTGTVQVL
IRAGEIVVF	IRAGEIVVF
RNYYHESAF	RNYYHESAF
SAPYGRITL	SAPYGRITL
SGGPVLQF	SGGPVL-QF
KRYDLEYWAF	KRYDLEWAF
RRSDDMFTF	RRSDDMFTF
KSFEDIHHY	KSFEDIHHY
AGFAGDDAPR	AGDDAP---
ARPQVSLTF	ARPQVSLTF
KRFQPVHDL	KRFQPVHDL
SRYGDIRRL	SRYGDIRRL
RVKTVTFEY	RVKTVTFEY
RVKPAVFDL	RVKPAVFDL
RTIATALEY	RTIATALEY
SRNSNTVVF	SRNSNTVVF
KRAPYIAYL	KRAPYIAYL
KNYTLVTVF	KNYTLVTVF
RQADFVQVL	RQADFVQVL
SRTGYVHIY	SRTGYVHIY
IRAPQIGGSF	IRAPQIGSF
SRNGKSYTF	SRNGKSYTF
SRGQQVIVSY	SRGQQVVSY
KRFDEWKEL	KRFDEWKEL
SRITTHFEL	SRITTHFEL
RRAPEPRVI	RRAPEPRVI
KTFVHTVHL	KTFVHTVHL
KRIEPADAHVL	KRIEPAHVL
LRDEYIKRL	LRDEYIKRL
KYADKIYSI	KYADKIYSI
KRFEKVYTH	KRFEKVYTH
KRHSNVVIL	KRHSNVVIL
SSSKGSLGGGF	SSSKGS--L
SIPLALALS	SIPLALALS
RRYNDFVVF	RRYNDFVVF
SRNNFIRNY	SRNNFIRNY
KAFIHHEL	KAFIHH-EL
KTKSMFFFL	KTKSMFFFL
KRALASNTSF	KRALASTSF
SRADLIKQY	SRADLIKQY
ITHPVYSL	ITHPVY-SL
ARPDEKAIMTY	ARPDEKAIM
VRSGYYKVL	VRSGYYKVL
TRGDYAPIL	TRGDYAPIL
KYMDVQFDF	KYMDVQFDF
SRVGYPAQVY	SRVGYPQVY
