Data	Data aligned
TLQNAVRNV	TLQNAVRNV
FLYPFPLALF	FLYPFPLAL
SVYKNVILQV	SVYKVILQV
MLREQVAQL	MLREQVAQL
GLYTGEVTEI	GLYTEVTEI
SLSSLELFL	SLSSLELFL
GQFPSYLETV	GQFPYLETV
GLAPKPVQV	GLAPKPVQV
RLYPEVPEVL	RLYPEVPEV
FLKDISTTL	FLKDISTTL
RLFEMGFAEQL	RLFEFAEQL
SLNPRKLIEV	SLNPKLIEV
VLSTRVTNV	VLSTRVTNV
FVADRLRAV	FVADRLRAV
YLSFLPLQTV	YLSFPLQTV
HLVDRTTVV	HLVDRTTVV
YLFEEIAKI	YLFEEIAKI
ALFPHLLQPVL	ALFPLLQPV
AAYEGSVAKV	AAYESVAKV
ALYFFPILTV	ALYFPILTV
ILADIQSHM	ILADIQSHM
YLATVTGI	YLA-TVTGI
QVFPGLLERV	QVFPLLERV
GLKDAVYFL	GLKDAVYFL
VLSDRIAFL	VLSDRIAFL
AMFGKLMTI	AMFGKLMTI
TLIEELKAL	TLIEELKAL
VLKEIVERV	VLKEIVERV
KVGPVPVLV	KVGPVPVLV
ALFPGPGNA	ALFPGPGNA
KLNPGIAYV	KLNPGIAYV
AVFDKTLAEL	AVFDTLAEL
TLAAAVPKI	TLAAAVPKI
VLAEIPQQV	VLAEIPQQV
GLYSDRISEL	GLYSRISEL
YIFPLDDKAAV	YIFPLDDKA
VLRDNIQGIT	VLRDNIQGI
ALAPLLSSL	ALAPLLSSL
YLKEILEQL	YLKEILEQL
ALAPWPIVGL	ALAPPIVGL
LLHSFVDSV	LLHSFVDSV
YLKDGPYITA	YLKDPYITA
ILVEHISGV	ILVEHISGV
ILKEIVEML	ILKEIVEML
RLAPAVLLTGL	RLAPAVLLT
ALYPVLEKA	ALYPVLEKA
TLIDLPGITKV	TLIDGITKV
SLREKIQFI	SLREKIQFI
YLFDLPLKVL	YLFDLPLKV
ALAPMEAAKV	ALAPEAAKV
FIYHGEVPQA	FIYHEVPQA
LLYDDKGVGL	LLYDKGVGL
GVIAEILRGV	VIAEILRGV
TLHPQVATI	TLHPQVATI
YAIKNIHGV	YAIKNIHGV
VLKVFLENV	VLKVFLENV
ALATWTIQGA	ALATTIQGA
HLAELIAEL	HLAELIAEL
LILEKQPAYV	LILEQPAYV
FMASQMLKV	FMASQMLKV
QLREYQLEGV	QLREQLEGV
SAAGFPLSGA	SAAGPLSGA
LMEHIHKL	LME-HIHKL
SLIKKIKDV	SLIKKIKDV
VLAPRVLRA	VLAPRVLRA
VLYPHPPLA	VLYPHPPLA
GMAFRVPTA	GMAFRVPTA
GLALLYSGV	GLALLYSGV
LLFRNAFTSV	LLFRAFTSV
QLFKKPRQV	QLFKKPRQV
LLFERELHSV	LLFEELHSV
RLYSNDIHAI	RLYSDIHAI
NLISALEEA	NLISALEEA
LLYQEKIRYA	LLYQKIRYA
SLIRNLEQL	SLIRNLEQL
FLPEFAGTQL	FLPEAGTQL
GLFGKTVPKTV	FGKTVPKTV
ALNLYMHQV	ALNLYMHQV
ILYNGLIEEL	ILYNLIEEL
ALIPRIKNA	ALIPRIKNA
FLKIIHTSV	FLKIIHTSV
ALKGHLYAV	ALKGHLYAV
VLAHTILGV	VLAHTILGV
HLANIVERV	HLANIVERV
GLYPNLIQV	GLYPNLIQV
GLAAGGIVAV	GLAAGIVAV
SMYGVDLHHA	SMYGDLHHA
QLADGLQYI	QLADGLQYI
LQIPAILGI	LQIPAILGI
SLIGHLQTL	SLIGHLQTL
VLTNKLLTV	VLTNKLLTV
TLSSIPTAL	TLSSIPTAL
FIQSIISTV	FIQSIISTV
SVFTETPSPVL	SVFTTPSPV
YLVPELDGV	YLVPELDGV
SVFDYSINSV	SVFDSINSV
KMNEKLYTV	KMNEKLYTV
WLANEGLITRL	LANELITRL
SLAEFISERV	SLAEISERV
SLHTELNSV	SLHTELNSV
ILSEVQQAV	ILSEVQQAV
LLYEDIGTSRV	LLYEDIGTS
ALRSFLQAL	ALRSFLQAL
LLAEKVEQL	LLAEKVEQL
AMQDRYMEV	AMQDRYMEV
IQVTKVTQV	IQVTKVTQV
ALIEKLVEL	ALIEKLVEL
LINPNIATV	LINPNIATV
KLKPFLKSL	KLKPFLKSL
GLKDGVALL	GLKDGVALL
GVFGVKIAVV	GVFGKIAVV
ALVEKLESL	ALVEKLESL
TLYKDLKPVL	TLYKDLKPV
YQYMHETITV	YQYMETITV
GLPSFLTEV	GLPSFLTEV
VLIPKLPQL	VLIPKLPQL
GLKNGVPAV	GLKNGVPAV
ALRDMLDQV	ALRDMLDQV
SMYGVDLHKA	SMYGDLHKA
RLRELQLQEV	RLREQLQEV
KLNAKLAEL	KLNAKLAEL
SLFVKLHNV	SLFVKLHNV
ALIEAEKVAQV	ALIEKVAQV
ILKKVLEAL	ILKKVLEAL
QIADIVTSV	QIADIVTSV
SVILKLSNV	SVILKLSNV
AQFPLQPGKV	AQFPQPGKV
KMKEALLSIGK	KMKEALLSI
LLAPLAQTV	LLAPLAQTV
LLGPKPFPL	LLGPKPFPL
FLKGFLTEV	FLKGFLTEV
FLFELPSRL	FLFELPSRL
MLSEHTSKL	MLSEHTSKL
LLFSKQPSQA	LLFSQPSQA
LLFPSVMVV	LLFPSVMVV
SLFLRTPKIV	SLFLRTPKI
RILAQQPLSV	ILAQQPLSV
IRSVNLLVV	IRSVNLLVV
MLRSHVREL	MLRSHVREL
VLREWLVAV	VLREWLVAV
ILTDITKGV	ILTDITKGV
SLIEKIPTA	SLIEKIPTA
GLIVKEWNSV	GLIVEWNSV
FLAEAARSL	FLAEAARSL
YLRNLTWTL	YLRNLTWTL
SLSDHLLRA	SLSDHLLRA
ALKGDGILIV	ALKGGILIV
TLSSQISRL	TLSSQISRL
SLKEIISSA	SLKEIISSA
YLKDLIEEV	YLKDLIEEV
TIFRTISV	TIF-RTISV
LLIDLSRASTL	LLI-DLSRA
SLPDHLPSV	SLPDHLPSV
RLAHYIDRV	RLAHYIDRV
KTMEDTLMTV	TMEDTLMTV
LLSEHVIAI	LLSEHVIAI
NLFKHLAKA	NLFKHLAKA
NLKKIFREV	NLKKIFREV
ALQEKVQAV	ALQEKVQAV
SLKGLVKNI	SLKGLVKNI
TLVEAIKQV	TLVEAIKQV
QLIDYKILGL	QLIDKILGL
FLSELTQQL	FLSELTQQL
QMIPFQPRHL	QMIPQPRHL
FLHETGGAMV	FLHEGGAMV
SMYPIALTRA	SMYPALTRA
TMKDHLVRV	TMKDHLVRV
TLAGDVHIV	TLAGDVHIV
LLSSHVRGV	LLSSHVRGV
ALGEEALLRYV	ALGELLRYV
TMFPGVLLPLL	TMFPVLLPL
TLGNVLVTV	TLGNVLVTV
FLKNELDNV	FLKNELDNV
WIVDRTTTV	WIVDRTTTV
SLYIRPTFI	SLYIRPTFI
VLMEIIAKV	VLMEIIAKV
YIKTELISV	YIKTELISV
SLRPDLLTV	SLRPDLLTV
FLHDNMVEI	FLHDNMVEI
ILYKLKLGEI	ILYKKLGEI
LLAKLLSQL	LLAKLLSQL
AQIGWIQTV	AQIGWIQTV
TLIQYIRPVF	TLIQYIRPV
FLREWVESM	FLREWVESM
FTIFRTISV	FTIFRTISV
YVYPQRLNFV	YVYPRLNFV
KLFGHLERGV	KLFGLERGV
TTFPRPVTV	TTFPRPVTV
GLSSHVEVV	GLSSHVEVV
ALAEFLQRKL	ALAELQRKL
KLAEGVQLL	KLAEGVQLL
TLAPKTLSV	TLAPKTLSV
SLFERLVKV	SLFERLVKV
FLKGGALGV	FLKGGALGV
SVYGSLASV	SVYGSLASV
TVADHIQKV	TVADHIQKV
RLFYSNIQTV	RLFYNIQTV
SLAWDVPAA	SLAWDVPAA
YLIARVMLL	YLIARVMLL
RLNLVEAFV	RLNLVEAFV
ALRSKLVRL	ALRSKLVRL
ALMADMVYV	ALMADMVYV
ALADLLLAL	ALADLLLAL
LLHGHIVEL	LLHGHIVEL
ILGTEDLIVEV	GTEDLIVEV
GLVPFLVSVL	GLVPFLVSV
SLKSNVTSL	SLKSNVTSL
SLAANTFTI	SLAANTFTI
SMKDDLERV	SMKDDLERV
ITNEKLAMV	ITNEKLAMV
LLFWVTEV	LLF-WVTEV
SLIARLERL	SLIARLERL
SLRDFTVTV	SLRDFTVTV
SVATKLTAV	SVATKLTAV
AIFDRVLTEL	AIFDVLTEL
LLSPVVPQI	LLSPVVPQI
YLNFIRGV	YLN-FIRGV
FLTEFINYI	FLTEFINYI
AIKKELTQI	AIKKELTQI
SLVDIYSQL	SLVDIYSQL
FVAKHLKTI	FVAKHLKTI
GLMTTVHAI	GLMTTVHAI
KQIDQFLVV	KQIDQFLVV
SLGKVFGV	SLG-KVFGV
KLYEKKLLKL	KLYEKLLKL
LLKPGLRAV	LLKPGLRAV
YLHDFLKYL	YLHDFLKYL
ALKEITRQL	ALKEITRQL
ALYDYMPMNA	ALYDMPMNA
NLALKLLSV	NLALKLLSV
RIKATVMDV	RIKATVMDV
TLQEVVTGV	TLQEVVTGV
YLSDNVHLV	YLSDNVHLV
VLYPASPHGV	VLYPSPHGV
FLPSFLSYI	FLPSFLSYI
FTHDWMVFV	FTHDWMVFV
NMKTVYVSV	NMKTVYVSV
ALGKILSV	ALG-KILSV
LLLPDYYLVTV	LLPDYLVTV
ILRSQKPVMV	ILRSKPVMV
QIKDNLREV	QIKDNLREV
YLAPHVRTLY	YLAPHVRTL
GLSEKLLAYV	GLSELLAYV
AIHRIIEV	AIH-RIIEV
VLSQHFQTV	VLSQHFQTV
YLQPKLLGI	YLQPKLLGI
SIYDAIKEV	SIYDAIKEV
ILFSEGLIKA	ILFSGLIKA
HLASIHGYL	HLASIHGYL
VLSSNLRHV	VLSSNLRHV
SLNTLTLNV	SLNTLTLNV
TLSTVISKV	TLSTVISKV
LLPIKTVGV	LLPIKTVGV
YLLESVNKL	YLLESVNKL
IQILKTSEV	IQILKTSEV
HITDFNIATV	HITDNIATV
LLYDQPLQV	LLYDQPLQV
AARPQVVAV	AARPQVVAV
KLYEAAVKKV	KLYEAVKKV
GLVAFEPHAL	GLVAEPHAL
TMYPGLPSRL	TMYPLPSRL
IMIDPVLGTV	IMIDVLGTV
WMVPFVNVV	WMVPFVNVV
SLFSHLLEI	SLFSHLLEI
YLGAKPRSL	YLGAKPRSL
SLAEFVQSL	SLAEFVQSL
LLKDSIVQL	LLKDSIVQL
VLFGQVVRGL	VLFGVVRGL
SLKMKVVEV	SLKMKVVEV
TLFPKDVQLA	TLFPDVQLA
TLKEDPVLQV	TLKEPVLQV
VIKESVVSI	VIKESVVSI
ALATKLLSL	ALATKLLSL
FLSQTGHGV	FLSQTGHGV
RLFDEPQLA	RLFDEPQLA
FLGPWPAAS	FLGPWPAAS
RLAALGRQV	RLAALGRQV
SLKQKILKV	SLKQKILKV
RLPPEGILHNV	RLPPILHNV
FLRQRLQAL	FLRQRLQAL
YLGQVAIL	YLG-QVAIL
VIVEKPLSV	VIVEKPLSV
LLRSIVKQV	LLRSIVKQV
SISDQSIASV	SISDSIASV
SVTYDLSKL	SVTYDLSKL
MLPVRLATA	MLPVRLATA
SLALLLNYL	SLALLLNYL
LMRFLPTEAEV	LMRFLPTEA
LLYQGPHNTL	LLYQPHNTL
AIRDGVIEA	AIRDGVIEA
RMFDGKFVVA	RMFDKFVVA
ATKGRILTV	ATKGRILTV
ALLDVTPKAV	ALLDTPKAV
TVFTDHMLTV	TVFTHMLTV
WLKEHVEPVF	WLKEHVEPV
YIIDVSQSV	YIIDVSQSV
ALAEALRLL	ALAEALRLL
YLNSILQHA	YLNSILQHA
ALIDRMVNL	ALIDRMVNL
SLISVIHLI	SLISVIHLI
RLKPALETL	RLKPALETL
ALFQPHLINV	ALFQHLINV
SMSADVPLV	SMSADVPLV
RVLDFDPMAV	RVLDDPMAV
SIAEMGAYV	SIAEMGAYV
YLFAKNVRSL	YLFANVRSL
KLFEPYVVHV	KLFEYVVHV
YLFPGIPELL	YLFPGIPEL
SLFEGKALGL	SLFEKALGL
SVMELLQGV	SVMELLQGV
TLHSRFLEGV	TLHSFLEGV
AQYEHDLEVA	AQYEHDLEV
YLKKEIGQHV	YLKKIGQHV
SLVGQHILSV	SLVGHILSV
SLASLLAKV	SLASLLAKV
YLPPATQVV	YLPPATQVV
ALRAQLHQL	ALRAQLHQL
LLFEGIARI	LLFEGIARI
FLASESLIKQI	FLASLIKQI
SLAEEKLQASV	SLAEEKLQA
GLKKVIQKV	GLKKVIQKV
TLKGGTILGT	TLKGTILGT
RVADILTQL	RVADILTQL
QVYRGALQKV	QVYRALQKV
FLPPEHTIVYI	FLPPEHTIV
FLRERLFEA	FLRERLFEA
LLPAHPGAEV	LLPAPGAEV
GLAGSVRGL	GLAGSVRGL
GVKDKVTLV	GVKDKVTLV
VIIPLLHTV	VIIPLLHTV
HMKNFVTKV	HMKNFVTKV
FLRSDLIEV	FLRSDLIEV
LLHKGILAV	LLHKGILAV
YLSDIPLHDA	YLSDPLHDA
VLFQEALWHV	VLFQALWHV
LALHPEAPGL	ALHPEAPGL
TLKEWTLQV	TLKEWTLQV
VLFMKILSGL	VLFMILSGL
MLIERIVRL	MLIERIVRL
NIFPYPVGV	NIFPYPVGV
ISISKRSIL	ISISKRSIL
KLAEKLTIL	KLAEKLTIL
TLSDIMVSL	TLSDIMVSL
GLFHHISKL	GLFHHISKL
SLKAPSIATI	SLKASIATI
RIYPFLLMVV	RIYPFLLMV
RLHEKVNII	RLHEKVNII
KLMELLEEI	KLMELLEEI
SLVENIERLKV	SLVENIERL
TMKTNLESL	TMKTNLESL
GLKAFYKGV	GLKAFYKGV
FLFQGFRLV	FLFQGFRLV
QMFSAIAAV	QMFSAIAAV
VLYSPGPKQA	VLYSGPKQA
ALRDQIPEL	ALRDQIPEL
FLAPRLLSL	FLAPRLLSL
ALNENINQV	ALNENINQV
YLTDRVMTV	YLTDRVMTV
ALANLKVSQI	ALANKVSQI
VLNGKLLLV	VLNGKLLLV
SVKPQILSV	SVKPQILSV
LGNISKLDI	LGNISKLDI
VLIEILQKA	VLIEILQKA
YLVYILNEL	YLVYILNEL
HQVPAVSSV	HQVPAVSSV
GLREQGMEVV	GLREQGMEV
ILAFVQGTV	ILAFVQGTV
ALVLNLLQI	ALVLNLLQI
YVAGIIPLAV	YVAGIPLAV
RLYTVVPRLV	RLYTVVPRL
NLKEVLNAV	NLKEVLNAV
RIFQTLLEV	RIFQTLLEV
FLVQNIHTL	FLVQNIHTL
SLSSHVTEL	SLSSHVTEL
FTYVGGPRSV	FTYVGPRSV
SLLNQPKAV	SLLNQPKAV
SLFDQPLSII	SLFDQPLSI
TVFTNPTQV	TVFTNPTQV
YLTAEVLEL	YLTAEVLEL
LLYNRPGTV	LLYNRPGTV
KMPDFGQVTV	KMPDGQVTV
FLKVDLLLV	FLKVDLLLV
ALKNDLVEAL	ALKNDLVEA
TLKRTIEAL	TLKRTIEAL
LLYDEFVKSV	LLYDFVKSV
SVYGKLRKV	SVYGKLRKV
RMFGIPVVV	RMFGIPVVV
GLAAFRAFL	GLAAFRAFL
ALYASNVRRV	ALYANVRRV
KLSSKLSAV	KLSSKLSAV
GLAKRPGALL	GLAKRPGAL
SLADVHIEV	SLADVHIEV
KLKKELTGL	KLKKELTGL
YIAGHPAFV	YIAGHPAFV
SLAQMVSGL	SLAQMVSGL
LLFPHPVNQV	LLFPPVNQV
FIMEGPLTRI	FIMEPLTRI
ALRSNLRTV	ALRSNLRTV
FLAEDALNTV	FLAEALNTV
GLASIQPSKV	GLASQPSKV
MEIERILGV	MEIERILGV
FLWERPTLLV	FLWERPTLL
FLVEKQPPQV	FLVEQPPQV
LLAAWTARA	LLAAWTARA
SLKGTLDNL	SLKGTLDNL
LMRANITAI	LMRANITAI
SIYNGDMEKI	SIYNDMEKI
SIIDKLVNI	SIIDKLVNI
RMITAMNTI	RMITAMNTI
YLGEGPRMV	YLGEGPRMV
FSSPHLVQV	FSSPHLVQV
SLRDLIQGL	SLRDLIQGL
TVTTVILEV	TVTTVILEV
AMREEVRQL	AMREEVRQL
SMAKAITGV	SMAKAITGV
FISAVREGSLV	FISAREGSL
ILHGLVAAV	ILHGLVAAV
HQRTFVLEV	HQRTFVLEV
FAIDPHLLLSV	AIDPLLLSV
RLKENQISV	RLKENQISV
FLITHNPTNA	FLITNPTNA
ALKSLLQEA	ALKSLLQEA
RQYPWGVVQV	RQYPGVVQV
SLAVSSPRL	SLAVSSPRL
LLHVQPSMV	LLHVQPSMV
ALSDHHIYL	ALSDHHIYL
ALRETVVEV	ALRETVVEV
LMKQYIEFV	LMKQYIEFV
ALKNDLVEA	ALKNDLVEA
LLADKVLKL	LLADKVLKL
GLSETILAV	GLSETILAV
RMVHILTSV	RMVHILTSV
ILINDVLTA	ILINDVLTA
VLVDRTIYI	VLVDRTIYI
GQISEVVVV	GQISEVVVV
TMRENLATV	TMRENLATV
ALMPVLNQV	ALMPVLNQV
SVISKVNSV	SVISKVNSV
SVFAGVVGV	SVFAGVVGV
LLFPSDVQTL	LLFPDVQTL
VQVQQVRSV	VQVQQVRSV
LLHDGIPVV	LLHDGIPVV
ALALSVKEL	ALALSVKEL
LLYPHQVPLVL	LLYPQVPLV
HLKDGIMNL	HLKDGIMNL
GLYEFPLNKV	GLYEPLNKV
SLIAGVIRV	SLIAGVIRV
YLRIDLERL	YLRIDLERL
GLIEIISNA	GLIEIISNA
ALKLRVAVL	ALKLRVAVL
ALAPWGPVKV	ALAPGPVKV
ALYVAVVNV	ALYVAVVNV
ILREDPAYL	ILREDPAYL
RLAVYIDKV	RLAVYIDKV
NLRNAVELA	NLRNAVELA
SIFDSKVTEI	SIFDKVTEI
TLAQHLSQL	TLAQHLSQL
VLKDLVKVI	VLKDLVKVI
FLADPSAFV	FLADPSAFV
VLYEPPPLSA	VLYEPPLSA
ALAARLLQPA	ALAALLQPA
HLKDGVPGL	HLKDGVPGL
KIKIYISQV	KIKIYISQV
FLFPHSVLV	FLFPHSVLV
SMMQTLLTV	SMMQTLLTV
HLRAAVLYV	HLRAAVLYV
SLYGYLRGA	SLYGYLRGA
TLKEEVQKL	TLKEEVQKL
FTAAIISRV	FTAAIISRV
KLHPGLLEV	KLHPGLLEV
RLVEFNITGA	RLVENITGA
ILNKALLLGA	ILNKLLLGA
RLFTDPLALL	RLFTDPLAL
FLKADVVFL	FLKADVVFL
LLNPHLRQL	LLNPHLRQL
GLTDKVGRV	GLTDKVGRV
FLAERLYAEV	FLAELYAEV
VAPGKDLTKT	VAPGDLTKT
FLKSPELVQA	FLKSELVQA
FVKDSIRLV	FVKDSIRLV
SLKDEVLKI	SLKDEVLKI
ILISKLLGA	ILISKLLGA
TMVDRIEEV	TMVDRIEEV
KLHYVVTEV	KLHYVVTEV
LLRPGGILAV	LLRPGILAV
ALRSILRQI	ALRSILRQI
GLAESVSTL	GLAESVSTL
ALSGTLSGV	ALSGTLSGV
FLKIDVPTA	FLKIDVPTA
LLASEVPQL	LLASEVPQL
VLYDPLKRV	VLYDPLKRV
LLYLGPHIASV	YLGPHIASV
SLAELVHAV	SLAELVHAV
ILATNTQKV	ILATNTQKV
ALRSSPLTV	ALRSSPLTV
TLSEVTNQL	TLSEVTNQL
ILAEGITIV	ILAEGITIV
SLAWKPLSA	SLAWKPLSA
SLIGVSFNSV	SLIGSFNSV
TLATDILMGV	TLATILMGV
AIKTELTQI	AIKTELTQI
LLIQGVPAV	LLIQGVPAV
MIAGKVAVV	MIAGKVAVV
YLFKVVLI	YLF-KVVLI
QLHAGSLVSV	QLHASLVSV
SLQESILAQV	SLQEILAQV
RLSPIENFL	RLSPIENFL
ALFPHLLQPV	ALFPLLQPV
VLASPWLIL	VLASPWLIL
YLLPERPATL	LLPERPATL
FMTYWHLLNA	FMTYHLLNA
ALIYGTPRAA	ALIYTPRAA
KLAEIVKQV	KLAEIVKQV
SLKEDIQKA	SLKEDIQKA
VLFTGVKEV	VLFTGVKEV
RLPEAIEEV	RLPEAIEEV
KINNEIRSV	KINNEIRSV
ALKLFLREL	ALKLFLREL
ALITRIFGV	ALITRIFGV
TLANVVTSL	TLANVVTSL
SLISGIIRA	SLISGIIRA
ALAPGVRAV	ALAPGVRAV
VMKLDLITV	VMKLDLITV
FAYDGKDYLTL	FAYDGKDYL
FMVDRVVDL	FMVDRVVDL
SLYSNFLDTL	SLYSFLDTL
SVHKGFAFV	SVHKGFAFV
ALFNRLVPSV	ALFNLVPSV
GLKDHIKEI	GLKDHIKEI
SLADYITAA	SLADYITAA
SIAPRMMSV	SIAPRMMSV
QLKHKLEQL	QLKHKLEQL
SLIDIVTEI	SLIDIVTEI
ALISQVLEA	ALISQVLEA
ELAERVPAI	ELAERVPAI
KLFEKVKEV	KLFEKVKEV
NLFHYLTEV	NLFHYLTEV
HLIGDFSKV	HLIGDFSKV
GIFGGHIRSV	GIFGHIRSV
NLKAHVVAV	NLKAHVVAV
TVFPAGLANV	TVFPGLANV
YLDGHLITTV	YLDGLITTV
SIFELDPTTL	SIFEDPTTL
YMIAHITGL	YMIAHITGL
FLLPHPGLQV	FLLPPGLQV
AQAPGVITGV	AQAPVITGV
FLPIHLLGL	FLPIHLLGL
AQILQILTV	AQILQILTV
GLFWANIRAA	GLFWNIRAA
ALYSELLAV	ALYSELLAV
ALFSDTPANA	ALFSTPANA
LLTDGIMRV	LLTDGIMRV
FLHWYTGEGM	FLHWYTGEG
ALKAIVNVI	ALKAIVNVI
RMYPFQIHSI	RMYPQIHSI
LIKSGQLLGV	LIKSQLLGV
FLARTVQV	FLA-RTVQV
FLWPGLNVPL	FLWPLNVPL
KLFDAPLSI	KLFDAPLSI
FLFEPVVKA	FLFEPVVKA
VSKVKTLTV	VSKVKTLTV
FLHTLVPFL	FLHTLVPFL
ALHDHLATI	ALHDHLATI
ALRVVVALV	ALRVVVALV
SLRQSLMKL	SLRQSLMKL
KLFDRPQEL	KLFDRPQEL
FLRPMLQYV	FLRPMLQYV
ALFDSGLHPA	ALFDGLHPA
ILIDPIRVV	ILIDPIRVV
ALKEIQAEV	ALKEIQAEV
LLKYIVIQV	LLKYIVIQV
FLGKLLEA	FLG-KLLEA
KLLEVQILEV	KLLEQILEV
ALAVIVPEGV	ALAVVPEGV
NVAPIISKV	NVAPIISKV
SLYDNKIQSL	SLYDKIQSL
AIKELLDTV	AIKELLDTV
KMNEKIASL	KMNEKIASL
ALPPVLTTV	ALPPVLTTV
KLSFIIRTV	KLSFIIRTV
GLKELSEYV	GLKELSEYV
YLRELLTTM	YLRELLTTM
NMVAKVDEV	NMVAKVDEV
ILQDRLNQV	ILQDRLNQV
ELAKTRLQL	ELAKTRLQL
SLKKQLTRV	SLKKQLTRV
GLAGPVRGV	GLAGPVRGV
SLFEKGLKNV	SLFEGLKNV
ALGHVRYV	ALG-HVRYV
FLNDSYLKYV	FLNDYLKYV
ALNGHVEMV	ALNGHVEMV
HLKQQVSGL	HLKQQVSGL
FLFGYKFSGL	FLFGKFSGL
SLKSSLHTL	SLKSSLHTL
ELFPHSLLSV	ELFPSLLSV
YMSEHLLKA	YMSEHLLKA
FIIQGLRSVGA	FIIQGLRSV
TLFPAIEKNIV	TLFPIEKNI
LLYSEIPKKV	LLYSIPKKV
GMAPHSMAVV	GMAPSMAVV
TLYDMLASI	TLYDMLASI
VLMEYIRSL	VLMEYIRSL
ALKEAGVFV	ALKEAGVFV
KLIPQLPTL	KLIPQLPTL
AVSDHISKV	AVSDHISKV
FMKPGTLYV	FMKPGTLYV
SLSSVLSHV	SLSSVLSHV
RLTDYISKV	RLTDYISKV
LIKDIISQV	LIKDIISQV
HLRRFILSV	HLRRFILSV
ALLSAHDTI	ALLSAHDTI
YLILHLISTV	YLILLISTV
RLAEVVHEL	RLAEVVHEL
ALLDWVTSV	ALLDWVTSV
YTYEELLNRV	YTYELLNRV
TMIGEIAAA	TMIGEIAAA
LLPDIISRL	LLPDIISRL
VMIPVPAGV	VMIPVPAGV
NIRDFLVEI	NIRDFLVEI
VLRSLPLVQV	VLRSPLVQV
ILAFLVPFV	ILAFLVPFV
LIAGTAVVG	LIAGTAVVG
YLPTRVTAI	YLPTRVTAI
NAKLLQQIQEV	KLLQQIQEV
NLKPHIQGI	NLKPHIQGI
ALATHILSL	ALATHILSL
FLMEFQVKNV	FLMEQVKNV
ILAELLLRV	ILAELLLRV
ELFEGIVRQV	ELFEIVRQV
VLASLIIRL	VLASLIIRL
YLSEATIGL	YLSEATIGL
SLAQLLGKI	SLAQLLGKI
SVMEYVTAV	SVMEYVTAV
LTKDMLLEV	LTKDMLLEV
ILYEHQLGQA	ILYEQLGQA
FLFGEVHKA	FLFGEVHKA
LTMEVIRQV	LTMEVIRQV
GLFGETLRAA	GLFGTLRAA
AMFDHIPVGV	AMFDIPVGV
RLFDDVPQV	RLFDDVPQV
GLYQGQVLVI	GLYQQVLVI
RLFSSIVTV	RLFSSIVTV
YLFNSVVNV	YLFNSVVNV
ILTGHTQSV	ILTGHTQSV
VLKEQIREL	VLKEQIREL
LLKEYIQKL	LLKEYIQKL
ILAPVVKEI	ILAPVVKEI
QLYYQVLNFA	QLYYVLNFA
TLHSLISEL	TLHSLISEL
NMYGKVVTV	NMYGKVVTV
FVYNLPHTV	FVYNLPHTV
FLLDGFPRTV	FLLDFPRTV
ALSPHNILL	ALSPHNILL
GLAWIVGRV	GLAWIVGRV
IIRDILQDV	IIRDILQDV
KLPMSIIIVGV	KLPMSIIIV
SLKKAIRQI	SLKKAIRQI
KLFPDTPLAL	KLFPTPLAL
LLRQGVLGI	LLRQGVLGI
TLIHQVLEA	TLIHQVLEA
MMPKYLNFV	MMPKYLNFV
GVKFNVTTV	GVKFNVTTV
HLAEIFGKV	HLAEIFGKV
ALNEITESGRI	ALNEITESG
SLAELKGFEV	SLAEKGFEV
GIKDDVFLSV	GIKDVFLSV
FLFASTILHL	FLFATILHL
FIMEGGAMV	FIMEGGAMV
TLNEKLTAL	TLNEKLTAL
SLQVLLTTV	SLQVLLTTV
SLIAKVATA	SLIAKVATA
SLNTGIITV	SLNTGIITV
ALNEQIARL	ALNEQIARL
YLHSYLTYI	YLHSYLTYI
FGYPFRLNEA	FGYPRLNEA
YLVSHPNEV	YLVSHPNEV
ALATIRLLDV	ALATRLLDV
SLSAIFNNV	SLSAIFNNV
VQADFKPATL	VQADKPATL
ALNSGILTI	ALNSGILTI
GLHFKIKPI	GLHFKIKPI
KLMDKVVRL	KLMDKVVRL
YLFITPPKTVL	YLFIPPKTV
LLAGLLTGL	LLAGLLTGL
ALAPSTMKI	ALAPSTMKI
TLISELVQA	TLISELVQA
ALFGAGPASI	ALFGGPASI
KLAEFIDFL	KLAEFIDFL
SLKEMVSKL	SLKEMVSKL
TLINLLLKV	TLINLLLKV
GLKHDIARV	GLKHDIARV
SLKVDVEAL	SLKVDVEAL
LMVDHVTEV	LMVDHVTEV
GMYIFLHTV	GMYIFLHTV
YQPDWRFMES	YQPDRFMES
SLKHTLLSL	SLKHTLLSL
FLVTVIHTL	FLVTVIHTL
FQRPNALAV	FQRPNALAV
ILKEISPLL	ILKEISPLL
RLAPTLSQL	RLAPTLSQL
SVKEVISAV	SVKEVISAV
FLISRLIKL	FLISRLIKL
MLFGGVPKTT	MLFGVPKTT
SVFERALSSV	SVFEALSSV
FLFGEEPSKL	FLFGEPSKL
RLAVYIDRV	RLAVYIDRV
SVTSHIYQV	SVTSHIYQV
FLFGYPKRL	FLFGYPKRL
SLAERSSLL	SLAERSSLL
SLFEVLPQQV	SLFELPQQV
ALKDSILKI	ALKDSILKI
TLSELKTVL	TLSELKTVL
RLMNETTAV	RLMNETTAV
GLTGQRVLGV	GLTGRVLGV
GLKEGIPAL	GLKEGIPAL
ALKDPVHTV	ALKDPVHTV
TLFPEEVIATI	TLFPVIATI
VLKPGGLLKV	VLKPGLLKV
SVASSVKGV	SVASSVKGV
YVSKYINYI	YVSKYINYI
KSIARVLTV	KSIARVLTV
VLSELAARL	VLSELAARL
LIFSHMLAEI	LIFSMLAEI
TLAETLVNL	TLAETLVNL
RLPEIYIQL	RLPEIYIQL
GTKDVPITSV	GTKDPITSV
ILANIVNAL	ILANIVNAL
TLKDFVTVL	TLKDFVTVL
RLNKVIKSV	RLNKVIKSV
FLRDNLEWL	FLRDNLEWL
NLNSIVPSV	NLNSIVPSV
GLVGALMHV	GLVGALMHV
AMIERITFI	AMIERITFI
RFFDGELTKV	RFFDELTKV
ALASEPLKV	ALASEPLKV
VLADALKSI	VLADALKSI
GLIDVKPLGV	GLIDKPLGV
QLIDIIHTA	QLIDIIHTA
VLPRFQPRVL	VLPRQPRVL
GLYPAPLKI	GLYPAPLKI
TLKDPIVSI	TLKDPIVSI
MQIEHIIENI	MQIEIIENI
SLKSLILTA	SLKSLILTA
GLAARMSQV	GLAARMSQV
SLSEKTVLL	SLSEKTVLL
SVANHNSFL	SVANHNSFL
SLASHVKNL	SLASHVKNL
ILSEFSSKL	ILSEFSSKL
FMKPGKVVLV	FMKPKVVLV
ALANGVSRI	ALANGVSRI
SIYPSPTGV	SIYPSPTGV
FLYAAQPELL	FLYAQPELL
AMKEALVQV	AMKEALVQV
FLLEKPFSV	FLLEKPFSV
ALKLVITAL	ALKLVITAL
YTYESKMAFL	YTYEKMAFL
FMAQIRPGES	FMAQRPGES
YIPDFLTLL	YIPDFLTLL
HLYQQGMLSV	HLYQGMLSV
KLFKAPAYI	KLFKAPAYI
LLATEVVTV	LLATEVVTV
VLRGALEMV	VLRGALEMV
GLAQFVREI	GLAQFVREI
HQIQNVVTV	HQIQNVVTV
YLGIVELLV	YLGIVELLV
GLSNHIAAL	GLSNHIAAL
QLYYKEITEA	QLYYEITEA
TLRPALVGV	TLRPALVGV
YLSPKLWAL	YLSPKLWAL
FLPSHSLDTV	FLPSSLDTV
ILKDNIKLL	ILKDNIKLL
VLYDRIQAA	VLYDRIQAA
YLSPDLSKI	YLSPDLSKI
SMNTHLKAV	SMNTHLKAV
ALAPGLPTA	ALAPGLPTA
KMAEMLVEL	KMAEMLVEL
AVLQGKLAEV	VLQGKLAEV
QLVQRVASV	QLVQRVASV
NLRDGPITI	NLRDGPITI
ALQDFLLSV	ALQDFLLSV
GLAAFLKAI	GLAAFLKAI
ALKKEVGDI	ALKKEVGDI
GLHANIAVA	GLHANIAVA
AIKEILTQV	AIKEILTQV
ILYGKIIHL	ILYGKIIHL
ILANGALRAV	ILANALRAV
FLNLGIEQV	FLNLGIEQV
FLFNKVVNL	FLFNKVVNL
KLFPGFEIETV	KLFPEIETV
IQIMKVEEI	IQIMKVEEI
LLALHVLEA	LLALHVLEA
LSVDLYSGAL	LSVDLYSGA
SMIPALREL	SMIPALREL
TLFSGLLLGL	TLFSLLLGL
VIKALLEVV	VIKALLEVV
YVSPRILTA	YVSPRILTA
AQYEDIAQK	AQYEDIAQK
ALFPGVALL	ALFPGVALL
LLGPRLVLA	LLGPRLVLA
HLYSRIPGLL	HLYSRIPGL
TQILSVPKV	TQILSVPKV
FMYNFQLVTL	FMYNQLVTL
TLIEELKTL	TLIEELKTL
ILKPSTIIGV	ILKPTIIGV
KYEELQIT	KYE-ELQIT
FLSEEGGHVAV	FLSEEGGHV
AMKPKPLSV	AMKPKPLSV
FLFDGSPTYVL	FLFDSPTYV
RLKAELARL	RLKAELARL
TLVDLSKMQNV	TLVDKMQNV
GLVGIVVGTV	GLVGVVGTV
SLKGDIVEL	SLKGDIVEL
ALANQIPTV	ALANQIPTV
ILRDALSDL	ILRDALSDL
FIRELISNA	FIRELISNA
AVYGFKLQSL	AVYGKLQSL
TLFPGKVHSL	TLFPKVHSL
ILADIVISA	ILADIVISA
VLSEKVSQL	VLSEKVSQL
GLFSNDIPHV	GLFSDIPHV
FLVEHVLTLI	FLVEHVLTL
SLYEMVSRV	SLYEMVSRV
RLSDVQIYV	RLSDVQIYV
FLEVRVAVV	FLEVRVAVV
ALGPKPQGL	ALGPKPQGL
FLIGILLREV	FLIGLLREV
ALHAAVIAI	ALHAAVIAI
NMARAVFGV	NMARAVFGV
SLAARAIAV	SLAARAIAV
TLAEHQQLI	TLAEHQQLI
DTISLSMFV	DTISLSMFV
AIVDKVPSV	AIVDKVPSV
SLAQYLINV	SLAQYLINV
FIYPSNMQTM	FIYPNMQTM
RLFNDPVAMV	RLFNPVAMV
NLAENISRV	NLAENISRV
GMYVFLHAV	GMYVFLHAV
NLFEHELGAL	NLFEELGAL
YLHNQGIGV	YLHNQGIGV
GLSEEKPLSV	GLSEKPLSV
YLPDGTASL	YLPDGTASL
KISDFGLATV	KISDGLATV
VLHEHIQRL	VLHEHIQRL
GTIGLIHAV	GTIGLIHAV
VLRDNIQGI	VLRDNIQGI
FLGEKIASV	FLGEKIASV
ILFDYILSQI	ILFDILSQI
RQYPWGTVQV	RQYPGTVQV
KLKETSPLTA	KLKESPLTA
KLINQVNTI	KLINQVNTI
FLYPFLHTV	FLYPFLHTV
FLAPWATIA	FLAPWATIA
SLLGGDVVSV	SLLGDVVSV
VIKEDVSEL	VIKEDVSEL
KLFSGVLMDL	KLFSVLMDL
VLRPQVTAV	VLRPQVTAV
LLKELRHGV	LLKELRHGV
YLIQLVQVL	YLIQLVQVL
ALRGEIETV	ALRGEIETV
QLVDIIEKV	QLVDIIEKV
NIFPSPNSV	NIFPSPNSV
SLFIVPSVV	SLFIVPSVV
YLIQSVPAEL	YLIQVPAEL
SLADIAQKL	SLADIAQKL
ALKDLINEA	ALKDLINEA
TIIEQVGKV	TIIEQVGKV
GMYPNLVHV	GMYPNLVHV
YVFEGKMLEA	YVFEKMLEA
RLISETTSV	RLISETTSV
FLKPGILTG	FLKPGILTG
QLSTVITQV	QLSTVITQV
LLSPHNPALA	LLSPNPALA
TLKEDPGKV	TLKEDPGKV
YAIHGVLEV	YAIHGVLEV
AIAPIIAAV	AIAPIIAAV
SLASLLVSV	SLASLLVSV
FLFDHLLTL	FLFDHLLTL
GLIEILKKV	GLIEILKKV
SMIDPPRAAV	SMIDPPRAA
IVATKPLYV	IVATKPLYV
YLNEIKDSVV	YLNEIKDSV
VINGNIKTV	VINGNIKTV
VIAEILRGV	VIAEILRGV
RLIPTLVSI	RLIPTLVSI
ALAELTKRL	ALAELTKRL
FLRTPEILTV	FLRTEILTV
SLIRIVPVV	SLIRIVPVV
LLADLLHNV	LLADLLHNV
KLYGKPIRV	KLYGKPIRV
FLRDNQLSEV	FLRDQLSEV
ALSELIILT	ALSELIILT
AIKDNVVIV	AIKDNVVIV
GLAEWVLMEL	GLAEVLMEL
LLLPGVIKTV	LLLPVIKTV
VMFRTPLASV	VMFRPLASV
LQFNSSLQKV	LQFNSLQKV
MLSDRLTFL	MLSDRLTFL
SLRPTVAEL	SLRPTVAEL
LMRPLVVTA	LMRPLVVTA
SVASTITGV	SVASTITGV
ALARPGLTI	ALARPGLTI
ALRETVNAL	ALRETVNAL
NLNSHITGL	NLNSHITGL
FLVPVLEAL	FLVPVLEAL
FIAEHYMFL	FIAEHYMFL
VLIPALKTI	VLIPALKTI
ILPSNLLTV	ILPSNLLTV
SLARIFTSI	SLARIFTSI
NAPLVNVTL	NAPLVNVTL
LLKNPFLSV	LLKNPFLSV
FLIPAVELI	FLIPAVELI
LLHFIALTV	LLHFIALTV
HLFDTLPLEV	HLFDLPLEV
LLAELLTHL	LLAELLTHL
VLFEKEVNEV	VLFEEVNEV
SLKQTVVTL	SLKQTVVTL
NIVEKLREV	NIVEKLREV
FLSPLLTLL	FLSPLLTLL
SLLEKLSAL	SLLEKLSAL
FIMEGTLTRV	FIMETLTRV
HLFSWIPLSA	HLFSIPLSA
LMYPYIFHV	LMYPYIFHV
YLLGRELMAL	YLLGELMAL
LLIGHLERV	LLIGHLERV
KVKEPPILRV	KVKEPILRV
YLKGFLEDL	YLKGFLEDL
ILRDLINEA	ILRDLINEA
SLANIIRQL	SLANIIRQL
RLKGQIPEI	RLKGQIPEI
SIYQFLIAV	SIYQFLIAV
ILPEKVARV	ILPEKVARV
RLGPVPSGL	RLGPVPSGL
RLFPGAPPTA	RLFPAPPTA
VLAWGLLNV	VLAWGLLNV
AIANAISVV	AIANAISVV
ALFRHEVGYV	ALFREVGYV
YLHHILRQL	YLHHILRQL
SLREALSFV	SLREALSFV
YLPSQVSRV	YLPSQVSRV
LLIENVASL	LLIENVASL
TLIPSVSQV	TLIPSVSQV
GLYEGLTWL	GLYEGLTWL
TLAKPPSVV	TLAKPPSVV
HVYDGKFLARV	HVYDFLARV
ALFGALFLA	ALFGALFLA
ALFSGPLVQA	ALFSPLVQA
FLYKVVQV	FLY-KVVQV
SLRDGSVLQTV	SLRDVLQTV
TIKEILGTA	TIKEILGTA
LLAPKLNEA	LLAPKLNEA
FLKDKFVEI	FLKDKFVEI
LLGPRGIGV	LLGPRGIGV
ALTGAILAA	ALTGAILAA
VLFLDAVREV	VLFLAVREV
LQKEGVIGV	LQKEGVIGV
VLRVVIPEV	VLRVVIPEV
ALSELATAV	ALSELATAV
HLAPRTPEV	HLAPRTPEV
WLSTSIPEA	WLSTSIPEA
SLHDTVTTL	SLHDTVTTL
ALKEIKAEV	ALKEIKAEV
RLKNEITRL	RLKNEITRL
RLFENLRML	RLFENLRML
LVYPEELKPVL	LVYPELKPV
TLNNWLATV	TLNNWLATV
YLIKDIRFL	YLIKDIRFL
GLAKAVASV	GLAKAVASV
FSPFHASVL	FSPFHASVL
KLYESLLPFA	KLYELLPFA
IVKEELALL	IVKEELALL
SLAPNIISQL	SLAPIISQL
TLTERLLGI	TLTERLLGI
ALAEIAKAEL	ALAEAKAEL
SLITLIEKV	SLITLIEKV
FLYQRLVVGA	FLYQLVVGA
YLRSMIPHL	YLRSMIPHL
YIFTTPKSV	YIFTTPKSV
SLITRLLEV	SLITRLLEV
SLFPGKLEVV	SLFPKLEVV
TLSSFITKI	TLSSFITKI
KLKDSLRQL	KLKDSLRQL
FMFQRVLVSL	FMFQVLVSL
KLGEIVTTI	KLGEIVTTI
FLWKITNV	FLW-KITNV
NLPDIVSKV	NLPDIVSKV
LLQEPPRTV	LLQEPPRTV
YMAPEVVEA	YMAPEVVEA
ATFPVAPRYA	ATFPAPRYA
ALSSNVILHV	ALSSVILHV
FLFDGSPTYV	FLFDSPTYV
GLADNTVIAKV	GLADNTVIA
HLFDHVVNRV	HLFDVVNRV
FLPEAPAEL	FLPEAPAEL
ALVANIIQNV	ALVAIIQNV
AVYERVTTI	AVYERVTTI
NIVERVKEV	NIVERVKEV
TMINAIPVA	TMINAIPVA
LVVEKPLVS	LVVEKPLVS
FLFQEPRSI	FLFQEPRSI
LLREKVEFL	LLREKVEFL
FLAELPGSL	FLAELPGSL
SMFGAGLTV	SMFGAGLTV
SLQSTILGV	SLQSTILGV
FELRHEIEI	FELRHEIEI
ALIRVISKL	ALIRVISKL
VLYPSLKEI	VLYPSLKEI
SLPDFGISYV	SLPDGISYV
FLSELQYYL	FLSELQYYL
FLKESSKVV	FLKESSKVV
LLRDQVLGV	LLRDQVLGV
ALRVLLVQV	ALRVLLVQV
AQIEVVPSA	AQIEVVPSA
TLREIVIGV	TLREIVIGV
FLYNEALYSL	FLYNALYSL
YIMDLRTESLI	YIMDRTESL
FLNELIKVL	FLNELIKVL
FMAEIRQYI	FMAEIRQYI
YLIELIDRV	YLIELIDRV
SLYRDLLRA	SLYRDLLRA
RLINQVLEL	RLINQVLEL
NLIPQITSI	NLIPQITSI
LLRQEVVAV	LLRQEVVAV
ALIQQATTV	ALIQQATTV
KMMDVTVTI	KMMDVTVTI
GLAPGGLAVV	GLAPGLAVV
GLLGNVAEV	GLLGNVAEV
ALYEYQPLQI	ALYEQPLQI
FLLEGIRSL	FLLEGIRSL
LLSNLFTTL	LLSNLFTTL
SLAQYLINA	SLAQYLINA
FVNEIISRI	FVNEIISRI
GLYSGVTTV	GLYSGVTTV
SLKTFVHTV	SLKTFVHTV
FLPLIVNTV	FLPLIVNTV
FLSEKDSLL	FLSEKDSLL
YLVELSSLL	YLVELSSLL
YLPDFRFTPF	YLPDRFTPF
SLAQYNPKL	SLAQYNPKL
YLISELEAA	YLISELEAA
VLKPDLIDV	VLKPDLIDV
SLAGSLRSV	SLAGSLRSV
ALRKEIKQL	ALRKEIKQL
AVANIVNSV	AVANIVNSV
YLIPNIKHL	YLIPNIKHL
SLAEVLQQL	SLAEVLQQL
KLFIGGLNV	KLFIGGLNV
ALKDFVASI	ALKDFVASI
FVFDRPLPVS	FVFDRPLPV
SLHDAIMIV	SLHDAIMIV
ALTRALALA	ALTRALALA
ILYPSTLFLL	ILYPSTLFL
SLRDKVLQL	SLRDKVLQL
ILAAIVNHL	ILAAIVNHL
TLKNWVKEL	TLKNWVKEL
GLIENPALL	GLIENPALL
ALAPAPPQV	ALAPAPPQV
FLLPILSQI	FLLPILSQI
YLTEVFLHV	YLTEVFLHV
TLFNVIKSV	TLFNVIKSV
SVISHLLRV	SVISHLLRV
SLAPIIVHV	SLAPIIVHV
FLIGQGAHV	FLIGQGAHV
YLSSVITTI	YLSSVITTI
YITGHVLVV	YITGHVLVV
KLKTALLDI	KLKTALLDI
TLPDTILTV	TLPDTILTV
SLIRAMLQV	SLIRAMLQV
KLKGEIAHL	KLKGEIAHL
IIRKPVTV	IIR-KPVTV
FLHDHVDLQV	FLHDVDLQV
RLPPDTLLQQV	RLPPLLQQV
GLYPSISLL	GLYPSISLL
YMLEHVITL	YMLEHVITL
GLQGRVTTV	GLQGRVTTV
LSSHVRGV	LSS-HVRGV
IIIDSVPEV	IIIDSVPEV
AMINRFQFV	AMINRFQFV
GLATDVQTV	GLATDVQTV
ILPERFLAV	ILPERFLAV
YMKSEDPLFV	YMKSDPLFV
GLIIRKPVTV	GLIIKPVTV
YIMSYISRV	YIMSYISRV
NLRDWLRVV	NLRDWLRVV
LLREELQLL	LLREELQLL
ILFDHMVPLV	ILFDMVPLV
KLGLKPLEV	KLGLKPLEV
LLGPPPVGV	LLGPPPVGV
KLKEEIRGL	KLKEEIRGL
FLSGIINFI	FLSGIINFI
GLSDLRLEL	GLSDLRLEL
FMKKYIHVA	FMKKYIHVA
FMNPHLISV	FMNPHLISV
TMIVSLAAV	TMIVSLAAV
ALFISPALI	ALFISPALI
NLTENLQYV	NLTENLQYV
FMSSHIKSV	FMSSHIKSV
QVLSRLSTL	QVLSRLSTL
TLNEKLTALE	TLNEKLTAL
ALFNLDIRRA	ALFNDIRRA
FLAEHPNVTL	FLAEPNVTL
YMFEEVPIVI	YMFEEVPIV
ALLAGPLRPA	LLAGPLRPA
VLFENQLLQI	VLFEQLLQI
VAGLALVGV	VAGLALVGV
KLHDFGYRGV	KLHDGYRGV
FAPYNKPSL	FAPYNKPSL
YLFHVQEV	YLF-HVQEV
TLYEALKTI	TLYEALKTI
KVMGTFSTV	KVMGTFSTV
TLKKVSVTV	TLKKVSVTV
QQRLVVVSV	QQRLVVVSV
GVAESIHLWEV	GVAEHLWEV
YIKDYMKSI	YIKDYMKSI
FIIGRVIKA	FIIGRVIKA
VLKSGNPRGL	VLKSNPRGL
RLYPELPSQL	RLYPLPSQL
GLYSRQLYVL	GLYSRQLYV
FAFALTPQQV	FAFATPQQV
LQKYIEIYV	LQKYIEIYV
SLAEKIQAL	SLAEKIQAL
ALFPLLPKV	ALFPLLPKV
YLAKVKSLL	YLAKVKSLL
SLSELQISYV	SLSEQISYV
VVFQKPSGV	VVFQKPSGV
QLKEEIAFL	QLKEEIAFL
TLRGHLAKI	TLRGHLAKI
FQRPTIYYV	FQRPTIYYV
SLSKITTTV	SLSKITTTV
YLIPLLERL	YLIPLLERL
YVFDGKPPQL	YVFDKPPQL
ALINVLNAL	ALINVLNAL
ILTETINTV	ILTETINTV
SVISIMKPV	SVISIMKPV
FLANIGTSV	FLANIGTSV
TMAKESSIIGV	MAKESIIGV
ILKEGDLVKI	ILKEDLVKI
YLNHIEPLKI	YLNHEPLKI
KLYPQLPAEI	KLYPLPAEI
RVFIGNLNTL	RVFINLNTL
SLKEALQKA	SLKEALQKA
ALYTVIETV	ALYTVIETV
VQYNEPLKV	VQYNEPLKV
IAYDRYIKEV	IAYDYIKEV
YLINFEIRSL	YLINEIRSL
VLAPLIALV	VLAPLIALV
YLVDSVAKT	YLVDSVAKT
NLYPFVKTV	NLYPFVKTV
ALNPKLTVI	ALNPKLTVI
RMVGQVLGA	RMVGQVLGA
GLFRTIAL	GLF-RTIAL
SLSDHSLGI	SLSDHSLGI
FLNEIQQSI	FLNEIQQSI
ALSQRTITV	ALSQRTITV
LLAEHIKSL	LLAEHIKSL
KLNFIVTGL	KLNFIVTGL
SVRPAVLQV	SVRPAVLQV
ALRNWVFQV	ALRNWVFQV
SLTAHLRSL	SLTAHLRSL
KLYHQWLSTV	KLYHWLSTV
ALSDLEITL	ALSDLEITL
FIINGIEKV	FIINGIEKV
YMFPDTMLQA	YMFPTMLQA
FLNQFVVHTV	FLNQVVHTV
SVKDDSILSV	SVKDSILSV
NVKVDPEIQ	NVKVDPEIQ
FLANVSTVL	FLANVSTVL
GLKGRVFEV	GLKGRVFEV
SVAEGRALMSV	SVAEALMSV
SLSGELREV	SLSGELREV
ILFNRVLGV	ILFNRVLGV
KQAFTVAAV	KQAFTVAAV
SLFDAVSSL	SLFDAVSSL
YIRGGIVSQV	YIRGIVSQV
GMIDRQGLLHV	GMIDRQGLL
ILNVDGLIGV	ILNVGLIGV
HLFSGHLSTL	HLFSHLSTL
FLREYFERL	FLREYFERL
LVKDGFLVEV	LVKDFLVEV
ILKEHITQL	ILKEHITQL
FLFDMLNGQDP	FLFDMLNGQ
SLREQLEGV	SLREQLEGV
SLKSKVLSV	SLKSKVLSV
VVKGTVLTI	VVKGTVLTI
SLKTLLVQL	SLKTLLVQL
YVFPGVTRL	YVFPGVTRL
SLKKLILEV	SLKKLILEV
ALLEKPGEL	ALLEKPGEL
SLARHLMTL	SLARHLMTL
SLKSNVLNV	SLKSNVLNV
KVAPAPAVV	KVAPAPAVV
IASLLLAKL	IASLLLAKL
ALFEAAREV	ALFEAAREV
RLLDEEISRV	RLLDEISRV
GLFGKELHKV	GLFGELHKV
VLIDYQRNV	VLIDYQRNV
ILKDVIPPLE	ILKDVIPPL
YAFAHILTV	YAFAHILTV
HLSDHLSEL	HLSDHLSEL
TLAELLVLL	TLAELLVLL
IIFETPLRV	IIFETPLRV
ALFPAPLAQI	ALFPPLAQI
SLFPHNPQFIG	SLFPNPQFI
ILKEKLRQL	ILKEKLRQL
YLVVKIEKV	YLVVKIEKV
FVIAELVNV	FVIAELVNV
FMNDAIEKA	FMNDAIEKA
RIFGESIMIGV	RIFGESIMI
FVRDMIREV	FVRDMIREV
LLYPREILIL	LLYPEILIL
SMLPATPWGV	MLPATPWGV
FQIGPVAGV	FQIGPVAGV
VLATTVGKV	VLATTVGKV
ALVDHLNVGV	ALVDLNVGV
VLYDQPRHV	VLYDQPRHV
NLVEKTPALV	NLVETPALV
SMKENISKL	SMKENISKL
GLVDIQPHWV	GLVDQPHWV
KLNDMEPSKAV	KLNDEPSKA
TLAQRVKEV	TLAQRVKEV
YLNQHVNRI	YLNQHVNRI
LLHQGGLSV	LLHQGGLSV
GQIEVVPEV	GQIEVVPEV
GLMRKVPRV	GLMRKVPRV
RLPDIPLRQV	RLPDPLRQV
WMNINLREV	WMNINLREV
GLTPHLTMV	GLTPHLTMV
QLSPRLLEV	QLSPRLLEV
ALWKGRPLSV	ALWKRPLSV
SLSSHMSLL	SLSSHMSLL
RLFDPDPQKV	RLFDDPQKV
FIKQILDGV	FIKQILDGV
SMAPGLVIQAV	SMAPLVIQA
ILSPWGAEV	ILSPWGAEV
SLFFHVPAGL	SLFFVPAGL
VLAAKVLNL	VLAAKVLNL
QLFQDEVAKA	QLFQEVAKA
YLRLPEVQGV	YLRLEVQGV
YLLDLHSYL	YLLDLHSYL
QLQGYLRSV	QLQGYLRSV
KVASLLHQV	KVASLLHQV
FLAVKPDGV	FLAVKPDGV
AVFERVLSAV	AVFEVLSAV
STAAKIMGV	STAAKIMGV
QLYQDPRNV	QLYQDPRNV
ILNDNINLL	ILNDNINLL
ILKQVVNQV	ILKQVVNQV
ALNEKLVNL	ALNEKLVNL
VLAYFLPEA	VLAYFLPEA
HLAIKLEQV	HLAIKLEQV
GLAALKMLAV	GLAAKMLAV
AQKKLISQV	AQKKLISQV
SLIEKVTQL	SLIEKVTQL
KLIEELETL	KLIEELETL
VLYPHEPTAV	VLYPEPTAV
FLTKKLREI	FLTKKLREI
SLKDQLTDL	SLKDQLTDL
LLKPTLSEI	LLKPTLSEI
SLFRHPKQV	SLFRHPKQV
TLKDTITSV	TLKDTITSV
VIRQITATV	VIRQITATV
GLTSAIQAV	GLTSAIQAV
GAFGFQLKEV	GAFGQLKEV
FLGKLTIPV	FLGKLTIPV
FVYFIVREV	FVYFIVREV
KLKPGDLVGV	KLKPDLVGV
FLKEFENPEV	FLKEENPEV
RLAAFYSQV	RLAAFYSQV
RLAELEGREQV	RLAEGREQV
VQIEHISSL	VQIEHISSL
LLKNELLGA	LLKNELLGA
SLLDRFLATV	SLLDFLATV
MKAFISKV	MKA-FISKV
LLASINSTV	LLASINSTV
ILNGIVAAL	ILNGIVAAL
RMANRDLLSSV	ANRDLLSSV
AMAETLKTL	AMAETLKTL
KMLEIDPQKV	KMLEDPQKV
SVIPQIQKV	SVIPQIQKV
FVIRNIVEA	FVIRNIVEA
TMFRVEYA	TMF-RVEYA
KLYQEVEIASV	KLYQEVEIA
SIPDFPMHLA	SIPDFPMHL
MNIVPIVNT	MNIVPIVNT
YVFENTVATVM	YVFETVATV
GTIQVMLLTI	TIQVMLLTI
SLFAGGMLRV	SLFAGMLRV
KVFSGALQEA	KVFSALQEA
ALNFIISYL	ALNFIISYL
ILSHLSSEL	ILSHLSSEL
VMFGGKQVVV	VMFGKQVVV
HLAEHSLQV	HLAEHSLQV
TLAELHISL	TLAELHISL
ALNSKILSV	ALNSKILSV
YLVEDIQHI	YLVEDIQHI
FLIPFVITV	FLIPFVITV
FIAQKILAL	FIAQKILAL
ALAKLVEAI	ALAKLVEAI
LLKDFLRNL	LLKDFLRNL
SLFAGQPLTI	SLFAQPLTI
VLRPAVLQA	VLRPAVLQA
ILHDVVEV	ILH-DVVEV
ILMGVLKEV	ILMGVLKEV
HLSELNTKL	HLSELNTKL
SIKAYVSTL	SIKAYVSTL
LLKSKLLVL	LLKSKLLVL
TLAKYLMEL	TLAKYLMEL
KLADFGLARA	KLADGLARA
YLLNDASLISV	LLNDSLISV
SLIFKLEEL	SLIFKLEEL
KLYTGLREV	KLYTGLREV
FLYWHLEDL	FLYWHLEDL
TLIEDILGV	TLIEDILGV
GLVPFLVSV	GLVPFLVSV
ILKKSIRNL	ILKKSIRNL
ILFPDIIARA	ILFPIIARA
MLAEKLPNL	MLAEKLPNL
KLREGEITHL	KLREEITHL
RLFHKDLTSL	RLFHDLTSL
SVYSRVIQV	SVYSRVIQV
VLKEYLDNV	VLKEYLDNV
AMAAVPAKV	AMAAVPAKV
ALAAALAHI	ALAAALAHI
RIKLGIKSL	RIKLGIKSL
SIAAVLPKV	SIAAVLPKV
HLIHEVTKV	HLIHEVTKV
YVYKVLKQV	YVYKVLKQV
ALAEALKEV	ALAEALKEV
SINSRLQLV	SINSRLQLV
FLIQNVLRL	FLIQNVLRL
YLADIFTKL	YLADIFTKL
YLAELVTPIL	YLAELVTPI
FLEKLLPPV	FLEKLLPPV
FLINFIHTL	FLINFIHTL
KVIDYVPGI	KVIDYVPGI
ALYNWLIQV	ALYNWLIQV
ALATLIHQV	ALATLIHQV
GMFKNLLKEV	GMFKLLKEV
FLAKLIAQA	FLAKLIAQA
KLIKSLEAA	KLIKSLEAA
KIADFGWSV	KIADFGWSV
SLKEVMTHI	SLKEVMTHI
SLLEHLSHV	SLLEHLSHV
LLANKVPAA	LLANKVPAA
TLAEKIQTI	TLAEKIQTI
NLIPILKTV	NLIPILKTV
SLYALHVKAA	SLYAHVKAA
TLKDGIIMI	TLKDGIIMI
LLKPGLNVV	LLKPGLNVV
KLYNWLRVA	KLYNWLRVA
KMREDVISSI	KMREVISSI
LLKVGILYI	LLKVGILYI
YIKAAVKNV	YIKAAVKNV
LVKLRILEL	LVKLRILEL
VLGVVTGV	VLG-VVTGV
FTVPRVVAV	FTVPRVVAV
IMKGKIKSI	IMKGKIKSI
SGYPGLLNGV	SGYPLLNGV
ALFKNSVSGI	ALFKSVSGI
ALFTFSPLTV	ALFTSPLTV
GQYDQPVLAV	GQYDPVLAV
ALGPPGAAL	ALGPPGAAL
GLAERISVL	GLAERISVL
FLQEHNTTL	FLQEHNTTL
NLIRSVRTV	NLIRSVRTV
SLIDMRGIETV	SLIDGIETV
NLKEAIETI	NLKEAIETI
ALVPFSIKPL	ALVPSIKPL
YLPYPIHQV	YLPYPIHQV
GLFAHPSLWQL	FAHPSLWQL
SLNKQIETV	SLNKQIETV
FISEPARTV	FISEPARTV
ALNPEIVSV	ALNPEIVSV
YVTEKVLAAV	YVTEVLAAV
YLRTLINEL	YLRTLINEL
ALAKAPFAA	ALAKAPFAA
RLAQHITYV	RLAQHITYV
SLFGYSPAAA	SLFGSPAAA
YLYTKEQLL	YLYTKEQLL
KLVPFLKKV	KLVPFLKKV
AQYEDIAQKS	AQYEDIAQK
RLFADILNDV	RLFAILNDV
NLMNAVVQTV	LMNAVVQTV
VMYRVIQV	VMY-RVIQV
YLATVTGIAV	YLATTGIAV
HLKLFVTRI	HLKLFVTRI
KLAEGVLDV	KLAEGVLDV
ILNEIVNFV	ILNEIVNFV
FIIEKQPPQV	FIIEQPPQV
KLFGMIITI	KLFGMIITI
HLSDAIVEV	HLSDAIVEV
FLTDSNNIKEV	FLTDNIKEV
TMADQIVTV	TMADQIVTV
RMKKLVSIV	RMKKLVSIV
VMLESPPKGV	VMLEPPKGV
RLYEALTPVH	RLYEALTPV
LLQDIILQV	LLQDIILQV
GLAQVITAV	GLAQVITAV
MMVGDLLEV	MMVGDLLEV
SLAEPRVSV	SLAEPRVSV
GVKQLIVGV	GVKQLIVGV
VLQEKIEVV	VLQEKIEVV
KLREDLERL	KLREDLERL
NLISQVGRV	NLISQVGRV
YMAELIERL	YMAELIERL
YLKIQLEDI	YLKIQLEDI
ALKPDLVNV	ALKPDLVNV
ILADKTRQL	ILADKTRQL
SLINVGLISV	SLINGLISV
KLIANLNML	KLIANLNML
GLIRFPLMTI	GLIRPLMTI
ILKSHVEKL	ILKSHVEKL
ALKPQVSSI	ALKPQVSSI
SLFPHNPQFI	SLFPNPQFI
SLSQHNDFL	SLSQHNDFL
LLMEHIQEI	LLMEHIQEI
FLNGLEILL	FLNGLEILL
ITQIEHEVSSS	TQIEEVSSS
ALATSPITV	ALATSPITV
ALRDVIKAL	ALRDVIKAL
SLFHTPKFV	SLFHTPKFV
NIKPEIVSV	NIKPEIVSV
KLYRPGSVAYV	KLY-RPGSV
ALSEKLARL	ALSEKLARL
KVKDILSKV	KVKDILSKV
FLAGEIRET	FLAGEIRET
ALNNHVEVA	ALNNHVEVA
ALINNIVEI	ALINNIVEI
FLFDRPMHV	FLFDRPMHV
ALPHHRVIEV	ALPHRVIEV
GLYGLIVALI	GLYGLIVAL
SIRNFLIYV	SIRNFLIYV
FIFEKKLAQA	FIFEKLAQA
KLYDIDVAKV	KLYDDVAKV
ALANHLIKV	ALANHLIKV
ILRLQVTNV	ILRLQVTNV
YIMEGVKATI	YIMEVKATI
NLAKCIVSV	NLAKCIVSV
SSYSRFSSS	SSYSRFSSS
AMFPDTIPRV	AMFPTIPRV
MLKSNIVTV	MLKSNIVTV
GLKEILPNL	GLKEILPNL
YLNVQVKEL	YLNVQVKEL
ALKALLRSL	ALKALLRSL
FLSLINVGL	FLSLINVGL
RLKDIIFDV	RLKDIIFDV
TLSDLRVYL	TLSDLRVYL
YLWLKLNQV	YLWLKLNQV
ALLDRIVSV	ALLDRIVSV
ALVDHVAEL	ALVDHVAEL
SLAEVAGLQV	SLAEAGLQV
YLLPAIVHI	YLLPAIVHI
FVRDGQLQPVL	FVRDQLQPV
LLADLKTMV	LLADLKTMV
VMAPRTLVL	VMAPRTLVL
GLFGTIISGI	GLFGIISGI
AMKKVVQQL	AMKKVVQQL
SLKQELEQL	SLKQELEQL
TMITKRLAQV	TMITRLAQV
LQFDKELRSL	LQFDELRSL
FLYNHGIGTL	FLYNGIGTL
ALRPGVTGA	ALRPGVTGA
HLKDILTSV	HLKDILTSV
AMASLGALALL	AMASGALAL
SLKELITEA	SLKELITEA
FLAPLLAKL	FLAPLLAKL
SLVNLGGSK	SLVNLGGSK
YLTELLTTQRV	YLTELLTTQ
MLKDEVRTL	MLKDEVRTL
YIMDNKLAQI	YIMDKLAQI
VLAWVKEKV	VLAWVKEKV
FLRSLLGSI	FLRSLLGSI
FIIQGLRSV	FIIQGLRSV
KMFESFIESV	KMFEFIESV
FLAQHTMLTL	FLAQTMLTL
SLSQHINWV	SLSQHINWV
SLATRISTL	SLATRISTL
AAFGGNPKSV	AAFGNPKSV
GLHSGNFSRV	GLHSNFSRV
VLKEEILLA	VLKEEILLA
KLREMLIRV	KLREMLIRV
SLVAILQSV	SLVAILQSV
VLKDFLSGI	VLKDFLSGI
WLIEDGKVVTV	LIEDKVVTV
YLADVTNAL	YLADVTNAL
GLADITQQL	GLADITQQL
ALKDAMLEL	ALKDAMLEL
ALKPEVDKL	ALKPEVDKL
QQIDRVVEV	QQIDRVVEV
SLATHLQEL	SLATHLQEL
KVFDQYLNFI	KVFDYLNFI
YLMEGSYNKV	YLMESYNKV
VLAPHLTRA	VLAPHLTRA
VMSERVSGL	VMSERVSGL
GLLTRLLQV	GLLTRLLQV
FLAAHIPLFL	FLAAIPLFL
FIFDVHVHEV	FIFDHVHEV
SLRSSLEVL	SLRSSLEVL
SLKLFAKEV	SLKLFAKEV
VLTEFTREV	VLTEFTREV
QLRAVIVRV	QLRAVIVRV
NLSAHIESL	NLSAHIESL
PVKRSIITV	PVKRSIITV
YLTAEILEL	YLTAEILEL
RMFHIRAV	RMF-HIRAV
IMPAFIFEHI	IMPAIFEHI
GLFPAPIHV	GLFPAPIHV
LLATVLQAV	LLATVLQAV
TVMGRIATL	TVMGRIATL
FAFTNKITSV	FAFTKITSV
SMAPSLKEL	SMAPSLKEL
KMKEAVRLV	KMKEAVRLV
TLNSKLLKV	TLNSKLLKV
YLKHRLIVV	YLKHRLIVV
AMNDILAQV	AMNDILAQV
NLKQAILQA	NLKQAILQA
ALFMYKPKKV	ALFMKPKKV
MMHPGPSAL	MMHPGPSAL
LQARIAHQI	LQARIAHQI
FLYPFPLAL	FLYPFPLAL
KIKEIAVTV	KIKEIAVTV
AMQEYIAVV	AMQEYIAVV
ALSDIFQAV	ALSDIFQAV
AMNGHVPAV	AMNGHVPAV
SLSEILSNI	SLSEILSNI
SVIQNLRTV	SVIQNLRTV
KMAPALRKV	KMAPALRKV
SLMEKISKL	SLMEKISKL
SLSLHNNLL	SLSLHNNLL
SLAHAQLSEV	SLAHQLSEV
TLKEEWIAYI	TLKEWIAYI
YLSKIIPAL	YLSKIIPAL
KLNVAPLAV	KLNVAPLAV
AQIDHYLGL	AQIDHYLGL
SMKSELSYL	SMKSELSYL
GLTKQYLRYV	GLTKYLRYV
SLVEIILHV	SLVEIILHV
LLHFSIVSV	LLHFSIVSV
LESATAIAV	LESATAIAV
FLKDLVASV	FLKDLVASV
KVFDPVPVGV	KVFDVPVGV
YLFERIKEL	YLFERIKEL
SLNEHLQAL	SLNEHLQAL
FLLPIKTVGV	FLLPKTVGV
ILAAVETRL	ILAAVETRL
RMFDMGFEYQV	FDMGFEYQV
ILSGHILSV	ILSGHILSV
ALNRSVQVV	ALNRSVQVV
SLKPLLFEI	SLKPLLFEI
LQKPDVVGI	LQKPDVVGI
VLFEHAVGYA	VLFEAVGYA
YLAPENGYL	YLAPENGYL
GLADASLLKKV	GLADLLKKV
TLNFPGRTV	TLNFPGRTV
ILNEVQVGV	ILNEVQVGV
FLAEAELLNL	FLAEELLNL
ALGPRWALV	ALGPRWALV
RLQDAIAKV	RLQDAIAKV
VLFSSHVRKV	VLFSHVRKV
VLNARIQKA	VLNARIQKA
QLRPYQMEV	QLRPYQMEV
WLRLQPLTSA	WLRLPLTSA
FLNNQIKEL	FLNNQIKEL
ALTDFVRSV	ALTDFVRSV
NLKEKIKEL	NLKEKIKEL
ALKKVIIMI	ALKKVIIMI
WLKGEFVTTV	WLKGFVTTV
RLIESLFTI	RLIESLFTI
VLHSSPLNV	VLHSSPLNV
FLMDFIHQV	FLMDFIHQV
ALHDILTEI	ALHDILTEI
LLTEIRAVV	LLTEIRAVV
SLFSGILKEM	SLFSILKEM
VLPNFLPYNV	VLPNLPYNV
SLAERVDRL	SLAERVDRL
ALSNHLNAV	ALSNHLNAV
IQAERVRGV	IQAERVRGV
ALAVNISAA	ALAVNISAA
RMKLSLTKV	RMKLSLTKV
AVAAVLTQV	AVAAVLTQV
ILMEHIHKL	ILMEHIHKL
YLGKIKRV	YLG-KIKRV
VLMDRLPSL	VLMDRLPSL
ALRELVAEA	ALRELVAEA
SLFDGFFLTA	SLFDFFLTA
SLVSSLYKV	SLVSSLYKV
GLYGLIVAL	GLYGLIVAL
ALYNHISEL	ALYNHISEL
SLFGKNLTTI	SLFGNLTTI
ILKEQIREL	ILKEQIREL
MLFPKFLKGL	MLFPFLKGL
YLLENIAWV	YLLENIAWV
RLVPSVNGV	RLVPSVNGV
MLNVLVRAV	MLNVLVRAV
ALAELESVL	ALAELESVL
KLHGVNINV	KLHGVNINV
FLQPIYLKSV	FLQPYLKSV
SLSSFLHGV	SLSSFLHGV
VLNEYFHNV	VLNEYFHNV
NLYNLPLKTL	NLYNPLKTL
RQIDQFLVV	RQIDQFLVV
SLAGIFTRL	SLAGIFTRL
ILRAILLSL	ILRAILLSL
TLKDLLFGV	TLKDLLFGV
YLGQVTTI	YLG-QVTTI
GLYPKVAKI	GLYPKVAKI
ALIFKIASA	ALIFKIASA
ALFPEFLKEL	ALFPFLKEL
SLIDGIKRA	SLIDGIKRA
YLNENPLRA	YLNENPLRA
AQHPNIVTV	AQHPNIVTV
GLGPNLVGV	GLGPNLVGV
AVYGFMPAKA	AVYGMPAKA
LLKNFVELI	LLKNFVELI
GLFPGAPKGA	GLFPAPKGA
SLFGGKIAVL	SLFGKIAVL
ALAQRLLEV	ALAQRLLEV
FLNKEITSV	FLNKEITSV
YLKDFFSNV	YLKDFFSNV
MVAPAVASV	MVAPAVASV
ILVGLLHMV	ILVGLLHMV
AAFEFDIHQV	AAFEDIHQV
YLAPHVRTL	YLAPHVRTL
SLKDDLTKL	SLKDDLTKL
LLYEDALYTV	LLYEALYTV
VLYPHEPTAVF	VLYPEPTAV
GLMDTVKKV	GLMDTVKKV
GLWHGMFANV	GLWHMFANV
SLAKIYTEA	SLAKIYTEA
LLKEYLVTL	LLKEYLVTL
YIYDKDMEII	YIYDKDMEI
FQIGKMRYV	FQIGKMRYV
ALFQRPPLI	ALFQRPPLI
VLITTLITA	VLITTLITA
AINPKLLQL	AINPKLLQL
VLSELLWQV	VLSELLWQV
YISDINPRSV	YISDNPRSV
FLPETRIMTSV	FLPERIMTS
ALYPGQLVQL	ALYPQLVQL
LVIDAVREI	LVIDAVREI
RMFDRIFGQA	RMFDIFGQA
HLFPKLELSV	HLFPLELSV
NLARALQQV	NLARALQQV
RLPMSIIIVGV	RLPMSIIIV
HLVPFVGKV	HLVPFVGKV
ALNPNEIQRA	ALNPEIQRA
SVFPNNVVFV	SVFPNVVFV
ILNPEVVTV	ILNPEVVTV
SMAEILRSL	SMAEILRSL
YMADRLLGV	YMADRLLGV
FLKANILGL	FLKANILGL
FLKNYLTNL	FLKNYLTNL
RLFEVPHEL	RLFEVPHEL
GLSNFINFI	GLSNFINFI
TIIDLPGITRV	TIIDGITRV
FLFPNKESLI	FLFPNKESL
AMFQEQLMTL	AMFQQLMTL
IIIGGVATV	IIIGGVATV
SLKNRIESV	SLKNRIESV
LLQPHLERV	LLQPHLERV
YLAPFLRNV	YLAPFLRNV
SIMDRILQI	SIMDRILQI
TLFYSLREV	TLFYSLREV
HLKVHIERV	HLKVHIERV
MLSAIQSEV	MLSAIQSEV
ILPGLSVMGV	ILPGSVMGV
SIHETIPLV	SIHETIPLV
GLREDLLRGI	GLRELLRGI
ALYPNVVQV	ALYPNVVQV
MLAKHVITL	MLAKHVITL
SLFGSSRVQYV	SLFGRVQYV
YLFGKEMYQV	YLFGEMYQV
MLRQIIGQA	MLRQIIGQA
SLASFIPAV	SLASFIPAV
YLINEIDRI	YLINEIDRI
SLYKGLLSV	SLYKGLLSV
RLALVISEL	RLALVISEL
SLYPKPEAL	SLYPKPEAL
VLIAKVARL	VLIAKVARL
TLASSLHTL	TLASSLHTL
FLKNEVVKA	FLKNEVVKA
RLQEVTHSV	RLQEVTHSV
ALRAAVAEL	ALRAAVAEL
VMYDLITEL	VMYDLITEL
GIYKDDIAQV	GIYKDIAQV
SLASHIQSL	SLASHIQSL
SQISRLQNI	SQISRLQNI
TMKNPSIVGV	TMKNSIVGV
YAFDEAFVREV	YAFDFVREV
FVKPAVVTV	FVKPAVVTV
VQSNRILGV	VQSNRILGV
RQYPWGVAEV	RQYPGVAEV
HMKSFVTRV	HMKSFVTRV
NLAGENILNPL	NLAGILNPL
AIQDHLLEV	AIQDHLLEV
NIKPDIMAV	NIKPDIMAV
VQIGDIVTV	VQIGDIVTV
FLPESVAVV	FLPESVAVV
KLYFPELHMV	KLYFELHMV
YLGQVTLT	YLG-QVTLT
YLITSVELL	YLITSVELL
YLVSKELMSL	YLVSELMSL
LLSPLQPQL	LLSPLQPQL
ILSDVASRL	ILSDVASRL
ILAAHVPTL	ILAAHVPTL
TLADVLYHV	TLADVLYHV
VIIPLLSSV	VIIPLLSSV
RLYPWGVVEV	RLYPGVVEV
LLSAEPVPA	LLSAEPVPA
ALSDSIHTV	ALSDSIHTV
KMKPEVTAL	KMKPEVTAL
FLSEKLERI	FLSEKLERI
FLPEPMGTA	FLPEPMGTA
KLFGHLTSA	KLFGHLTSA
GLYPFRVNSA	GLYPRVNSA
VLMPNVGEI	VLMPNVGEI
TLASIIKEV	TLASIIKEV
SLVDKTKQV	SLVDKTKQV
HLNPSLLQNV	HLNPLLQNV
GLAAKLMEL	GLAAKLMEL
GLTEALHFV	GLTEALHFV
ALSEKIVSV	ALSEKIVSV
SLFQGVEFHYV	SLFQGVEFH
AIIEARGVSV	AIIERGVSV
FLKPEKFTKV	FLKPKFTKV
VLFGLLREV	VLFGLLREV
FLIPFETRQL	FLIPETRQL
LIFPAEPAQA	LIFPEPAQA
LLNPAVLSTA	LLNPVLSTA
RLNEAAVTV	RLNEAAVTV
QLTSNLAQV	QLTSNLAQV
GLRESISKV	GLRESISKV
RVFTGIVTSL	RVFTIVTSL
FLFGSIRGA	FLFGSIRGA
ALASHILTA	ALASHILTA
FLISKGANV	FLISKGANV
FLSAIVSSV	FLSAIVSSV
LLNDRKVFV	LLNDRKVFV
ALYGKLLKL	ALYGKLLKL
GLSFHIASL	GLSFHIASL
SLYGGTITI	SLYGGTITI
VVAAIAISE	VVAAIAISE
SLKPKLIEA	SLKPKLIEA
GFTIILSGL	GFTIILSGL
SLFLGILSV	SLFLGILSV
YCAEIAHNV	YCAEIAHNV
AMAPGTVTV	AMAPGTVTV
KIADFGLARV	KIADGLARV
VIVHRLLAV	VIVHRLLAV
SLFGGSVKLA	SLFGSVKLA
SLRPILNTL	SLRPILNTL
KLVTTVTEI	KLVTTVTEI
SLEKISIAL	SLEKISIAL
YVINDLTAV	YVINDLTAV
ALNGKLYIV	ALNGKLYIV
FLQPHLDAV	FLQPHLDAV
FISGHTSEL	FISGHTSEL
ALVLLLTEV	ALVLLLTEV
AVIGLTKSV	AVIGLTKSV
KLAEVSQNI	KLAEVSQNI
FIATVREV	FIA-TVREV
LLQDAIREV	LLQDAIREV
IMTEKELLAV	IMTEELLAV
ILKETVRQI	ILKETVRQI
ALTELLAKI	ALTELLAKI
PLTGHLLEV	PLTGHLLEV
YLEERRVKEV	YLEERVKEV
GLSPLRPPSV	GLSPRPPSV
ILHTLLTLV	ILHTLLTLV
NLKLKLTAV	NLKLKLTAV
AVFPFQPGSV	AVFPQPGSV
QMISRIEYV	QMISRIEYV
TVIAKVNNV	TVIAKVNNV
YLADLYHFV	YLADLYHFV
AMIAVVPGYI	AMIAVPGYI
SLFVFIPMVV	SLFVIPMVV
ALAEFHVQRV	ALAEHVQRV
KLISDINKA	KLISDINKA
SLGQKISTV	SLGQKISTV
ALKDEVQEL	ALKDEVQEL
ALKEKIHEL	ALKEKIHEL
YVYEYLLHV	YVYEYLLHV
ALKRFVNLV	ALKRFVNLV
GLKLTLDTI	GLKLTLDTI
TLIGFLRSIDQ	TLIGFLRSI
YLVTSIAKA	YLVTSIAKA
RLKELLTML	RLKELLTML
GLISGILRV	GLISGILRV
ALKPQVSSIF	ALKPQVSSI
LLAWFPLQEA	LLAWPLQEA
TLFQGIKTV	TLFQGIKTV
RLQETEGMVAV	RLQETEGMV
TLKPGTMSV	TLKPGTMSV
ILYPKPKAC	ILYPKPKAC
KLNTAVRQV	KLNTAVRQV
TLKEYLESL	TLKEYLESL
AMKDTLTNI	AMKDTLTNI
GLTDIRTLV	GLTDIRTLV
GLYYGDVIWV	GLYYDVIWV
YLAEFFVNEA	YLAEFVNEA
YLFNVSDSSAL	YLFNSDSSA
TLFPVRLLVA	TLFPRLLVA
ALKDTIGKL	ALKDTIGKL
SLLGHLMIV	SLLGHLMIV
FIKPPVYVTV	FIKPVYVTV
VLKDDILEI	VLKDDILEI
AVITKVKGV	AVITKVKGV
GVFGVKISVV	GVFGKISVV
NLYGNIVNNV	NLYGIVNNV
KLAENIDAQL	KLAEIDAQL
SLFDIISKI	SLFDIISKI
LLPHPGLQV	LLPHPGLQV
VLKGDVEKL	VLKGDVEKL
KMFDLNGDGEV	KMFDGDGEV
TLRPSLLPLH	TLRPSLLPL
IMFQKPVEV	IMFQKPVEV
ADASLLKKV	ADASLLKKV
SLKADLQKL	SLKADLQKL
GMKSIVGEI	GMKSIVGEI
VMAPHEPLVV	VMAPEPLVV
KLAEALPSL	KLAEALPSL
VLMEKPDVV	VLMEKPDVV
VLFHQLQEI	VLFHQLQEI
LLAPAPAQA	LLAPAPAQA
QLRSLVVAL	QLRSLVVAL
AMIDQVLEL	AMIDQVLEL
TLKEILRYL	TLKEILRYL
LLFKILSSV	LLFKILSSV
KLGPAPKTL	KLGPAPKTL
AVRDGLRAV	AVRDGLRAV
SLADFMQEV	SLADFMQEV
FGGHIRSV	FGG-HIRSV
HLRQDLERV	HLRQDLERV
LLNKSIIRV	LLNKSIIRV
YLLPGAPADL	YLLPAPADL
ILIPNVETI	ILIPNVETI
FLHQRIPQSV	FLHQIPQSV
LLIGATMQV	LLIGATMQV
YQVGQLYSV	YQVGQLYSV
GLIGVGLINV	GLIGGLINV
ILKNFLYDI	ILKNFLYDI
SLKRQLQQL	SLKRQLQQL
LLAFVVRSV	LLAFVVRSV
FLHETGLAMI	FLHEGLAMI
HLSNILSEV	HLSNILSEV
VIAPKITSV	VIAPKITSV
SIYGGFLLGV	SIYGFLLGV
GLKYDVKKV	GLKYDVKKV
TLADLVHHV	TLADLVHHV
YLNIKLTDI	YLNIKLTDI
KLASKYLHV	KLASKYLHV
FLKEQMILV	FLKEQMILV
LLADVETFV	LLADVETFV
LLAKKISQL	LLAKKISQL
KLMDQLEAL	KLMDQLEAL
IMKEVIPFL	IMKEVIPFL
FLSPLLPLL	FLSPLLPLL
QIVRDHWVHVL	IVRDWVHVL
GLIQGVKSV	GLIQGVKSV
FQHGVIAAV	FQHGVIAAV
KLSDLQTQL	KLSDLQTQL
SLQDEIQRV	SLQDEIQRV
AIFQQPPVGV	AIFQPPVGV
SLRGHVVGL	SLRGHVVGL
VMQDPEFLQSV	QDPEFLQSV
FLYQILRGL	FLYQILRGL
AMYTLPRQA	AMYTLPRQA
ALTALISQV	ALTALISQV
YLKEAVTTL	YLKEAVTTL
TLVYHVVGV	TLVYHVVGV
YMSPHPSPL	YMSPHPSPL
ALHGMVALV	ALHGMVALV
LLNDHIYVV	LLNDHIYVV
SLGPQPLVA	SLGPQPLVA
LLAEGITWV	LLAEGITWV
VLYNQRVEEI	VLYNRVEEI
ALKDQLLAA	ALKDQLLAA
FLQTKIATL	FLQTKIATL
LLSERVSNL	LLSERVSNL
IIKPDPPEGV	IIKPPPEGV
ILFLGPLMQL	ILFLPLMQL
PYHWPLLV	PYH-WPLLV
GVISKVSTL	GVISKVSTL
ALKEFNEDGAL	ALKENEDGA
ALREVSIHTV	ALRESIHTV
SMSETVRLV	SMSETVRLV
ALSNLEVKL	ALSNLEVKL
GLFNRIIRKV	GLFNIIRKV
HLAKLVSLV	HLAKLVSLV
GLIDKVNEL	GLIDKVNEL
ILVDWLVQV	ILVDWLVQV
GLQEYVEAV	GLQEYVEAV
WIKDKLLHI	WIKDKLLHI
TLPERPLTEV	TLPEPLTEV
KLVGEFLEV	KLVGEFLEV
KVAGFNLLMTL	AGFNLLMTL
FLIEPEHVNTV	FLIEHVNTV
SLARILSLL	SLARILSLL
ITFSNPKEV	ITFSNPKEV
VLKPELQTA	VLKPELQTA
SLGRHISQV	SLGRHISQV
SLISNPPAMI	SLISPPAMI
SLVELLNQI	SLVELLNQI
YLGKVLEL	YLG-KVLEL
VLHDRIVSV	VLHDRIVSV
FLKAWLEYL	FLKAWLEYL
TLADRLLEL	TLADRLLEL
LLYEDIPDKV	LLYEIPDKV
GLNEEIARV	GLNEEIARV
YLLQEPPRTV	LLQEPPRTV
RIKDTVQKL	RIKDTVQKL
FLQEYGLSV	FLQEYGLSV
QQFPDIPESV	QQFPIPESV
LEVKLGALV	LEVKLGALV
ALKATLVES	ALKATLVES
ALIPDLNQI	ALIPDLNQI
SLKPEVAQV	SLKPEVAQV
VLKTGFLFV	VLKTGFLFV
KQFPLIISSV	KQFPIISSV
GIVGGLSTV	GIVGGLSTV
SLKTAIYRI	SLKTAIYRI
SLFAQRLKTL	SLFARLKTL
QLNEKVAQL	QLNEKVAQL
KLFSILSTV	KLFSILSTV
HLRTAIEHV	HLRTAIEHV
VMRAYLQQL	VMRAYLQQL
ALIPVINKL	ALIPVINKL
ILAQQPLSV	ILAQQPLSV
VLMTQQPRPVL	VLMTQPRPV
NVIPNVANV	NVIPNVANV
GLAPAAPLQV	GLAPAPLQV
VLKPVVELL	VLKPVVELL
VLAERMSTI	VLAERMSTI
SLAQSIAKI	SLAQSIAKI
YLYPSTLVRT	YLYPTLVRT
KLILLITQV	KLILLITQV
SLAEVNTQL	SLAEVNTQL
TIDDIVLTI	TIDDIVLTI
SLTGHISTV	SLTGHISTV
HLPETKFSEL	HLPEKFSEL
SLFGNIKGA	SLFGNIKGA
YLYPDITRL	YLYPDITRL
TLKMEVISL	TLKMEVISL
LLPGNFTVGV	LLPGFTVGV
TLSPLLLFL	TLSPLLLFL
SLPPHILEV	SLPPHILEV
FLLGHEIAHA	FLLGEIAHA
TLTAHLSQA	TLTAHLSQA
ALVSTIQFV	ALVSTIQFV
ALPEERLSV	ALPEERLSV
SLSHSLLAV	SLSHSLLAV
SLFYRDIISI	SLFYDIISI
ALVESLITV	ALVESLITV
VLRGEVAYI	VLRGEVAYI
KLMDEVAGI	KLMDEVAGI
ALPARLTQV	ALPARLTQV
YMKDLISYL	YMKDLISYL
KMYEEFLSKV	KMYEFLSKV
YLYSNKLQSL	YLYSKLQSL
NLKPWVLEV	NLKPWVLEV
YLIDVKFNGT	YLIDKFNGT
SLRNLVVSL	SLRNLVVSL
RIRDQLSAV	RIRDQLSAV
FMFDEKLVTV	FMFDKLVTV
LLAGPLRPA	LLAGPLRPA
YLNALVHLI	YLNALVHLI
GLNGHLTKL	GLNGHLTKL
ALSSLIHAL	ALSSLIHAL
GVYQGRVSAV	GVYQRVSAV
RLRDPSGDFSV	RLRDGDFSV
FLKNEVERL	FLKNEVERL
FIFPGKLGTL	FIFPKLGTL
ALKSGKLVTA	ALKSKLVTA
IVADVQISV	IVADVQISV
TLKQGIERV	TLKQGIERV
QVIPQLQTV	QVIPQLQTV
LMNAVVQTV	LMNAVVQTV
SMKAFISKV	SMKAFISKV
ILTDHILET	ILTDHILET
SLITPLQAV	SLITPLQAV
FTFPNRLLTT	FTFPRLLTT
ILKAPGTNV	ILKAPGTNV
FLKPLLIGEL	FLKPLIGEL
YLLPERPSYL	LLPERPSYL
SLFGQDVKAV	SLFGDVKAV
ALSPITKLSV	ALSPTKLSV
FLIGPKLYEA	FLIGKLYEA
NLAEKLIGV	NLAEKLIGV
NLRDIVRVV	NLRDIVRVV
SLKETIEEL	SLKETIEEL
TMKTYVEKV	TMKTYVEKV
FLRSDLIEVA	FLRSDLIEV
TLGVKQLIVGV	GVKQLIVGV
KLKDVLLQV	KLKDVLLQV
YTYEFDFSKV	YTYEDFSKV
YMNHIMVSV	YMNHIMVSV
VLNPLITAV	VLNPLITAV
ALKAVLVDL	ALKAVLVDL
ALKEKVTSL	ALKEKVTSL
SVAESLNYV	SVAESLNYV
GLVGIIVGTV	GLVGIVGTV
SLRGVVQEL	SLRGVVQEL
ILNNNLNTL	ILNNNLNTL
SLIDFLRVV	SLIDFLRVV
TLYDIAHTPGV	TLYDHTPGV
ILNPHGIPL	ILNPHGIPL
YLHSQVVSV	YLHSQVVSV
HMHIHISTV	HMHIHISTV
LLNQKPLSL	LLNQKPLSL
GLFHFPTPL	GLFHFPTPL
SLTSGLLTI	SLTSGLLTI
SIIGRLLEV	SIIGRLLEV
FLNKEILEL	FLNKEILEL
LLKDVKISV	LLKDVKISV
ALAPLAIPSAA	ALAPAIPSA
ALGSVVAV	ALG-SVVAV
HLLPTAPTTV	LLPTAPTTV
GLQIGDKIMQV	LQIGKIMQV
FLKEELVAAV	FLKELVAAV
VLYDRPLKI	VLYDRPLKI
ELANKLITV	ELANKLITV
LLFEGEKITI	LLFEEKITI
SIFASPESV	SIFASPESV
VLIETLVTL	VLIETLVTL
KLVSFTLSDL	KLVSTLSDL
SLRPAVLTGV	SLRPVLTGV
RLYDGLFKVI	RLYDGLFKV
GLAPHLEQI	GLAPHLEQI
YLYGQTTTYL	YLYGTTTYL
VLYELLQHI	VLYELLQHI
YLNKNALTTL	YLNKALTTL
FLFPSGPGSL	FLFPGPGSL
VLREILTTL	VLREILTTL
YLFLVRVV	YLF-LVRVV
QIITSVVSV	QIITSVVSV
YLKPYFLEA	YLKPYFLEA
SLKSIIGIGV	SLKSIGIGV
SLIEKLWQT	SLIEKLWQT
IITDLLRSV	IITDLLRSV
KLIFSVEAV	KLIFSVEAV
AVKDGILLA	AVKDGILLA
YAFNMKATV	YAFNMKATV
YLSEKVLAA	YLSEKVLAA
FLSDGTIISV	FLSDTIISV
KLFSELPLA	KLFSELPLA
GITDHIVQV	GITDHIVQV
MMKLIINSL	MMKLIINSL
GLAPNTPGKA	GLAPTPGKA
KLYPQLSSV	KLYPQLSSV
FLIGGLLRI	FLIGGLLRI
MIAQTVTAV	MIAQTVTAV
HLNPMQLMTV	HLNPQLMTV
TLAGLIPFV	TLAGLIPFV
TLRDAVPATL	TLRDVPATL
GLSSVVRNV	GLSSVVRNV
RLQEEINEV	RLQEEINEV
SLIGGTNFV	SLIGGTNFV
TIKENIIKV	TIKENIIKV
VLFGAVITGA	VLFGVITGA
FLSTINVGL	FLSTINVGL
KLGSVPVTV	KLGSVPVTV
ALSQINTKL	ALSQINTKL
LLFDRPMHV	LLFDRPMHV
SLFPLLPQDV	SLFPLPQDV
VLADLKVQL	VLADLKVQL
QVHGTITGV	QVHGTITGV
YLMEVTHDL	YLMEVTHDL
ALANKLFGA	ALANKLFGA
ILFHVVAI	ILF-HVVAI
QLMEQVAQL	QLMEQVAQL
ILASLLRNL	ILASLLRNL
HLYGQNVTMV	HLYGNVTMV
KLMDHIYAV	KLMDHIYAV
VLIKNLLVSV	VLIKLLVSV
SIKDGVMVL	SIKDGVMVL
ALFVKTKEV	ALFVKTKEV
ILGPKPQGV	ILGPKPQGV
KLGPVAVSI	KLGPVAVSI
GLNHWVRAL	GLNHWVRAL
RLAHHLVAL	RLAHHLVAL
VLTEHVAAA	VLTEHVAAA
GGLPERSVSL	GLPERSVSL
ALAKHLIKI	ALAKHLIKI
FLAEEKHLHVL	FLAEKHLHV
SLFLGRILSL	SLFLRILSL
ALFTPQLNNV	ALFTQLNNV
GVYAGRPLSV	GVYARPLSV
ALASVIMGL	ALASVIMGL
LLKAFIANL	LLKAFIANL
FLFRITQV	FLF-RITQV
HIIENIVAV	HIIENIVAV
SLIGNLHLA	SLIGNLHLA
YLTFLPAEV	YLTFLPAEV
FLYKEKLVSV	FLYKKLVSV
ILIKGLAKL	ILIKGLAKL
SMAPYVLNV	SMAPYVLNV
QLVRDLLEV	QLVRDLLEV
TLYPLHILFV	TLYPHILFV
YLNENPLRAL	YLNEPLRAL
LLNPSLQKV	LLNPSLQKV
TVKDFVAKV	TVKDFVAKV
LLYGSIPKAA	LLYGSIPKA
GLAEFQSPL	GLAEFQSPL
TLIEKVQEA	TLIEKVQEA
SLSGYINYL	SLSGYINYL
EQYEQILAFV	EQYEILAFV
VLFEGRTVQL	VLFERTVQL
SLVSFIPLNI	SLVSIPLNI
SLIPIISGV	SLIPIISGV
ALTLNLTEV	ALTLNLTEV
FLVERLLHI	FLVERLLHI
GVRESVFTV	GVRESVFTV
NLFDISQSAQT	NLFDISQSA
TLYPAVKSL	TLYPAVKSL
YLITHPLAV	YLITHPLAV
SLKAHVQEV	SLKAHVQEV
GLAPLHIQL	GLAPLHIQL
SLRPSVLTSV	SLRPVLTSV
VLVEHVKNV	VLVEHVKNV
AIPGFTINRV	AIPGTINRV
SLINLPANSTI	SLINLPANS
SLIDKPTNL	SLIDKPTNL
SVAESLLQV	SVAESLLQV
YLKEILQDL	YLKEILQDL
SVWGLPSVV	SVWGLPSVV
YLSPDLSKV	YLSPDLSKV
KLIANNTTV	KLIANNTTV
IAPTGHSL	IAP-TGHSL
KLFTQIFGV	KLFTQIFGV
FLAVRVQQV	FLAVRVQQV
YLFITPPKTV	YLFIPPKTV
TVRPGELLAV	TVRPELLAV
AMAASPHAV	AMAASPHAV
SLMTKEISSV	SLMTEISSV
LLIKQVVEV	LLIKQVVEV
RVIGTLEEV	RVIGTLEEV
VAATSLLDTL	AATSLLDTL
KAYQELLATV	KAYQLLATV
LMNGLIQGV	LMNGLIQGV
NLAEVVERV	NLAEVVERV
KLKDDEVAQL	KLKDEVAQL
TVLPVPPLSV	VLPVPPLSV
SISERLSVL	SISERLSVL
AQYGNILKHV	AQYGILKHV
FLLPLLIEKV	FLLPLIEKV
NLFNPSSKSSV	NLFNPSSKS
KLAVRPLSV	KLAVRPLSV
LLRPEGLTSV	LLRPGLTSV
TLKPAIEEI	TLKPAIEEI
ALAGGITMV	ALAGGITMV
FLKINVSEL	FLKINVSEL
YMVSKELRNV	YMVSELRNV
FIFSEKPVFV	FIFSKPVFV
TLKELTSLV	TLKELTSLV
ALFQHITAL	ALFQHITAL
SLAEGRLYL	SLAEGRLYL
IVIDGLREL	IVIDGLREL
ILQQHIATV	ILQQHIATV
VLYTGVVRV	VLYTGVVRV
ALLNILSEV	ALLNILSEV
FTFPNIASA	FTFPNIASA
NLAEKPKTV	NLAEKPKTV
MLKPSVTSA	MLKPSVTSA
ALSGHLETV	ALSGHLETV
KLRDELVKL	KLRDELVKL
ALVQDLAKA	ALVQDLAKA
FLSSVIQNL	FLSSVIQNL
TMAYNITPL	TMAYNITPL
RLMNDMTAV	RLMNDMTAV
ALQPHLAAI	ALQPHLAAI
ATIGELAQV	ATIGELAQV
AVINRVQKV	AVINRVQKV
ALKELVSTI	ALKELVSTI
TLYKEILTRA	TLYKILTRA
AVADLQTRL	AVADLQTRL
RLANVVRQV	RLANVVRQV
LFNKQLESI	LFNKQLESI
TLISRLPAV	TLISRLPAV
VLHEGTNFV	VLHEGTNFV
FLRDYTQINV	FLRDTQINV
RLYGLGTGV	RLYGLGTGV
LLSERFINV	LLSERFINV
KLQEFLQTL	KLQEFLQTL
HLISTINTV	HLISTINTV
FVIGHLKGA	FVIGHLKGA
VLIANLEKL	VLIANLEKL
FLKLGGLQV	FLKLGGLQV
SLKKTISQI	SLKKTISQI
ALSGHLGEV	ALSGHLGEV
TLIEKTMQNV	TLIETMQNV
SLKQVLTAL	SLKQVLTAL
TLADMATRL	TLADMATRL
SLKEIVINV	SLKEIVINV
LLKPELLRA	LLKPELLRA
IIIPEIQKV	IIIPEIQKV
HQYGLPIKSV	HQYGPIKSV
YMGEEKLIASV	YMGELIASV
FINSRIITV	FINSRIITV
AVKPSVTCV	AVKPSVTCV
FLIPIYHQV	FLIPIYHQV
RLMNLPLHSV	RLMNPLHSV
YQFDSALLPAV	YQFDALLPA
SMYPTRIEGA	SMYPRIEGA
ALFSDILSGL	ALFSILSGL
SLIPGPALLLV	SLIPGPALL
ALADGVQKV	ALADGVQKV
TLSDIVVTL	TLSDIVVTL
IVVGRITEV	IVVGRITEV
ALHHRILAL	ALHHRILAL
KVKDGQLTV	KVKDGQLTV
RVFGSQNLTTV	FGSQNLTTV
GLREFVVIA	GLREFVVIA
TLKSTVEAL	TLKSTVEAL
FLQEGDLISA	FLQEDLISA
YIAPLKALV	YIAPLKALV
KLHDVELHQV	KLHDELHQV
LISESFLTV	LISESFLTV
IVIGIIKTV	IVIGIIKTV
VQIEEVRQV	VQIEEVRQV
FLANLHITA	FLANLHITA
GLIDRQVTV	GLIDRQVTV
SLKYPYVAV	SLKYPYVAV
TLREHLERL	TLREHLERL
GLAKLIADV	GLAKLIADV
NLASFIEQV	NLASFIEQV
VLSGNIKTV	VLSGNIKTV
ILSDNLRQV	ILSDNLRQV
YLKPIQRTI	YLKPIQRTI
SLVEQLTMV	SLVEQLTMV
FLGVIPQFV	FLGVIPQFV
AMRKLVRSV	AMRKLVRSV
YLKGRTIIGV	YLKGTIIGV
GAAGFALSQV	GAAGALSQV
YLFDIQLPNI	YLFDQLPNI
TLLLTQLSLLQ	LLLTQLSLL
LMKNTIIAA	LMKNTIIAA
YQFGEIRTI	YQFGEIRTI
YIFNKSVASL	YIFNSVASL
VMFKKIKSFEV	VMFKKIKSF
AVIHYLLQV	AVIHYLLQV
AMKDVLLPL	AMKDVLLPL
YIFGGYNARL	YIFGYNARL
LLIPGLATA	LLIPGLATA
GLGPPGRSV	GLGPPGRSV
SLNKQIAQL	SLNKQIAQL
SLFRVITEV	SLFRVITEV
QLRNEVAIL	QLRNEVAIL
ALAKKPHII	ALAKKPHII
LLAEALNQV	LLAEALNQV
SQYDYILPQV	SQYDILPQV
ILYPEIPRKL	ILYPIPRKL
FLFNLPLNI	FLFNLPLNI
RLLDYVATV	RLLDYVATV
ALASHILTAL	ALASHILTA
FQFPSHVTDV	FQFPHVTDV
VLNKVITV	VLN-KVITV
MLSPFISSV	MLSPFISSV
GLTEVLKEI	GLTEVLKEI
LLIDIQPNTL	LLIDQPNTL
ALIPIPLAVI	ALIPIPLAV
KLAAVVNNL	KLAAVVNNL
ILPGFQRTV	ILPGFQRTV
RLFEGNALL	RLFEGNALL
ALAGGPLAV	ALAGGPLAV
QMISRIEYI	QMISRIEYI
FLAQRAVEL	FLAQRAVEL
VMIAGKVAVV	VMIAKVAVV
ILNYVLVRV	ILNYVLVRV
KLRLYLEQL	KLRLYLEQL
FMTTNVPNV	FMTTNVPNV
RLSNHISSL	RLSNHISSL
GIYIFIPQNV	GIYIIPQNV
RLFQENLGLL	RLFQNLGLL
SLVQRVETI	SLVQRVETI
YLKELIEPVL	YLKELIEPV
SLVGLGGTK	SLVGLGGTK
LLHAGGLARA	LLHAGLARA
FVFKEPQQV	FVFKEPQQV
NMKEKINAV	NMKEKINAV
KLADISINYV	KLADSINYV
MLYPEVIQQV	MLYPVIQQV
MLAILLTEV	MLAILLTEV
YLYPIKNLEM	YLY-PIKNL
AQAGIKISSV	AQAGKISSV
TLKVQELKV	TLKVQELKV
RLQGELQAV	RLQGELQAV
KIFDEILVNA	KIFDILVNA
ALPEIFTEL	ALPEIFTEL
AQHENVPFI	AQHENVPFI
SVKNGILTI	SVKNGILTI
YLRDYSRTI	YLRDYSRTI
FTNVVKTTV	FTNVVKTTV
SLIKQIPRI	SLIKQIPRI
IIYPTPKVV	IIYPTPKVV
YLFERTFNL	YLFERTFNL
GLHAFIVPI	GLHAFIVPI
QLQNYLRSV	QLQNYLRSV
FLAPDNSLLLA	FLAPDNSLL
TLIALLAHA	TLIALLAHA
FLHSSVKMV	FLHSSVKMV
FLITILDHL	FLITILDHL
LLKVFVVEA	LLKVFVVEA
YTTDRVMTV	YTTDRVMTV
SGLHETLAL	SGLHETLAL
FLREKNLLVT	FLREKNLLV
YLKNVVKQI	YLKNVVKQI
ILYDKLEKI	ILYDKLEKI
TIKSGDLEYV	TIKSDLEYV
YLPVKIEQV	YLPVKIEQV
FLFRLINI	FLF-RLINI
VLKDYIAYA	VLKDYIAYA
SLHLRIPEI	SLHLRIPEI
NLAEKYQTV	NLAEKYQTV
FLLDSAPLNV	FLLDAPLNV
TVFGTALNYV	TVFGALNYV
GLAPFLLNAV	GLAPLLNAV
NLVLSVREV	NLVLSVREV
SLMDHTIPEV	SLMDTIPEV
WLREGEFVTV	WLREEFVTV
ALYGYDIRSA	ALYGDIRSA
FIREHIEEL	FIREHIEEL
NLQGKILSV	NLQGKILSV
AIPESSPPSGI	AIPEPPSGI
SLINNPAFI	SLINNPAFI
HVYPAQVQYV	HVYPQVQYV
VLMENIVYL	VLMENIVYL
ILHSVTTNL	ILHSVTTNL
FIAPVTLKV	FIAPVTLKV
ALFGIPMAL	ALFGIPMAL
VLAEVPTQL	VLAEVPTQL
TLIEDEIATI	TLIEEIATI
YLSNVDVYL	YLSNVDVYL
SLRSIVKSL	SLRSIVKSL
ALRPSVVSI	ALRPSVVSI
FLMPFPVNYV	FLMPPVNYV
ALNELLQHV	ALNELLQHV
MLFGHPLLV	MLFGHPLLV
YLQTILKEL	YLQTILKEL
ALTSLLKTV	ALTSLLKTV
HLAGEVLAV	HLAGEVLAV
KPVLDIPHL	KPVLDIPHL
KLVEFDFLGA	KLVEDFLGA
FGYDHLILNV	FGYDLILNV
TLPSFSPSAA	TLPSSPSAA
AMNSQILEV	AMNSQILEV
ALAGIVTNV	ALAGIVTNV
SIRDSVVEI	SIRDSVVEI
RLTDYVAFL	RLTDYVAFL
KLTAFVNTL	KLTAFVNTL
VLSTGVPTV	VLSTGVPTV
AMNGKSFSV	AMNGKSFSV
AMYVYPPNV	AMYVYPPNV
VLSWQFSSV	VLSWQFSSV
GLREQELQVV	GLREELQVV
FLHARLRTA	FLHARLRTA
KLLAGFMGV	KLLAGFMGV
GLVGSLQEV	GLVGSLQEV
LLNDASLISV	LLNDSLISV
SLFLQTPKIV	SLFLTPKIV
HLFGSTLLGI	HLFGTLLGI
YLNSVVQV	YLN-SVVQV
ILKERIYRL	ILKERIYRL
LTIKSYGML	LTIKSYGML
SVKDGTILKV	SVKDTILKV
GLINTGVLSV	GLINGVLSV
ALCEENMRGV	ALCENMRGV
VLYENPNLKGV	VLYENLKGV
AQQAAKLQGI	QQAAKLQGI
GLIDHQTYL	GLIDHQTYL
GLWGHPVLAV	GLWGPVLAV
GLAPGGLAV	GLAPGGLAV
KIADFGLARI	KIADGLARI
TLKEDWIAYI	TLKEWIAYI
ALRDQVPTL	ALRDQVPTL
FLAGAVTSV	FLAGAVTSV
YLYDRLLRI	YLYDRLLRI
MLAGFITTL	MLAGFITTL
ILTNGLVSV	ILTNGLVSV
AMYPDQVQLL	AMYPQVQLL
GLRDILAVL	GLRDILAVL
LMTKEISSV	LMTKEISSV
IMEGLSAFL	IMEGLSAFL
YLWHIPLSYV	YLWHPLSYV
ALAPSPVSGV	ALAPPVSGV
QQIGKVVQV	QQIGKVVQV
GLELLLSQG	GLELLLSQG
STIAILNSV	STIAILNSV
GLTGQRLLGV	GLTGRLLGV
KQISTLESV	KQISTLESV
RLTPKLMEV	RLTPKLMEV
ILVDWLVEV	ILVDWLVEV
LLSPHSQVL	LLSPHSQVL
NLSGHLLSA	NLSGHLLSA
RLADFNIYQV	RLADNIYQV
LINEIKPQSV	LINEKPQSV
YMIDNVILLI	YMIDNVILL
FLIAALDVL	FLIAALDVL
QLYPFAISLI	QLYPAISLI
VIKQQLESV	VIKQQLESV
SLKISIGNV	SLKISIGNV
FLNPAQRAL	FLNPAQRAL
IIHEIAVLEL	IIHEAVLEL
AIAYILQGV	AIAYILQGV
VLSSLTPAKV	VLSSTPAKV
ILAMHLIDV	ILAMHLIDV
ALRNLPPLRA	ALRNPPLRA
SLYDYNPNLA	SLYDNPNLA
VNLPINGNGKQ	NLPINGNGK
TLADIYREL	TLADIYREL
VLFPLPTPL	VLFPLPTPL
ILADRILLM	ILADRILLM
LQFDGIHVV	LQFDGIHVV
ILYPKTLFLL	ILYPKTLFL
ALRVFVESV	ALRVFVESV
FIKDYPVVSI	FIKDPVVSI
RLFEWVVNRI	RLFEVVNRI
YIALKLVAV	YIALKLVAV
TLYEAVREV	TLYEAVREV
FLNPGILEA	FLNPGILEA
FLNKLIPVL	FLNKLIPVL
ALRAGLTLA	ALRAGLTLA
YLIKYIAIV	YLIKYIAIV
RQFFTAPATV	RQFFAPATV
TLAVSGLGV	TLAVSGLGV
ALGNVRTV	ALG-NVRTV
ILVGGGALATV	ILVGALATV
QLYIHQMISV	QLYIQMISV
ALAAFISSV	ALAAFISSV
ILIDKTSFV	ILIDKTSFV
ALAEEVEQV	ALAEEVEQV
QLDNSILTV	QLDNSILTV
ALFQRPPLIA	ALFQRPPLI
SLIEHLQGL	SLIEHLQGL
VALELLASN	VALELLASN
GLADKVYFL	GLADKVYFL
SLYKDAMQYA	SLYKAMQYA
VLAVHLNTL	VLAVHLNTL
HLRDFLVQI	HLRDFLVQI
SLASLPPLHV	SLASPPLHV
ALIHRMIEFV	ALIHMIEFV
YFAERVTSL	YFAERVTSL
ILFPYIEENV	ILFPIEENV
FLYIGDIVSL	FLYIDIVSL
FLADIVQKL	FLADIVQKL
ALSASLARV	ALSASLARV
GMIGLLTFI	GMIGLLTFI
GLFPGSNATF	GLFPSNATF
KLFVEALGQI	KLFVALGQI
RLYPEGLAQL	RLYPGLAQL
TLIGEIFNSV	TLIGIFNSV
SLATKIQAA	SLATKIQAA
GMASVISRL	GMASVISRL
RIIDTVAQV	RIIDTVAQV
NLKTTVEGL	NLKTTVEGL
VLAVRVVTL	VLAVRVVTL
SLMGTLSKL	SLMGTLSKL
YIFAHVGQL	YIFAHVGQL
LIYGTPRAA	LIYGTPRAA
ALKDKIEKAVV	ALKDKIEKA
AVIDVGINRV	AVIDGINRV
ALKPFLPQL	ALKPFLPQL
SLHVFVLAV	SLHVFVLAV
VLRGKLQLV	VLRGKLQLV
LAKALHLLK	LAKALHLLK
SLFSHSLISI	SLFSSLISI
VIFDLPTTV	VIFDLPTTV
FSMLSAHVI	FSMLSAHVI
GLAGFFASV	GLAGFFASV
FLAVSLVKV	FLAVSLVKV
FLFGLPLGV	FLFGLPLGV
QLSTIRSFL	QLSTIRSFL
YLSDSLRNL	YLSDSLRNL
GLIPQLIGV	GLIPQLIGV
YIYSSKIVRV	YIYSKIVRV
ALSALTARL	ALSALTARL
ILFPNDPLYA	ILFPDPLYA
RLPSFAIPYA	RLPSAIPYA
ILYPYELFQS	ILYPELFQS
RLAQLITQA	RLAQLITQA
NLMAPAPSTV	LMAPAPSTV
SMYDGLLQA	SMYDGLLQA
FLYEKLDRKV	FLYELDRKV
AMYGTKLETI	AMYGKLETI
VLRESGLKYV	VLREGLKYV
MTYWHLLNA	MTYWHLLNA
ALKKNLEKI	ALKKNLEKI
NMMSGISSV	NMMSGISSV
RVFSDIIYTV	RVFSIIYTV
LQENLSEVSQV	NLS-EVSQV
SIIDWLNSV	SIIDWLNSV
AQYVFTIQSI	AQYVTIQSI
GMMEALLKV	GMMEALLKV
SMISKLKQA	SMISKLKQA
QLNDSIITV	QLNDSIITV
IIKEVLLEA	IIKEVLLEA
ALKDIVINA	ALKDIVINA
ILISTLPSV	ILISTLPSV
TLAQLLTLL	TLAQLLTLL
TLIGGLLLHV	TLIGLLLHV
FQKIQVRLV	FQKIQVRLV
GISPLKPGTV	GISPKPGTV
SLASLLTIA	SLASLLTIA
TTISKVSQV	TTISKVSQV
FISSSILYV	FISSSILYV
ILARDILEI	ILARDILEI
