Data	Data aligned
EIVEGENHTY	EIVEENHTY
EIITADEVHYF	EIITDEVHY
YIIQNIPGF	YIIQNIPGF
EVPHFHHEL	EVPHFHHEL
EAIARYQGR	EAIARYQGR
EVIETEKTLY	EVIEEKTLY
EVIDKYTAV	EVIDKYTAV
EIKETLRQY	EIKETLRQY
QVAEMLGHKY	QVAELGHKY
ETIKDLPKM	ETIKDLPKM
EVSPKLPEY	EVSPKLPEY
EVVSEPFRSF	EVVSPFRSF
EVKQKLQEF	EVKQKLQEF
FVISNTTGY	FVISNTTGY
HVVAGTAGY	HVVAGTAGY
ETHQPIVETY	ETHQIVETY
EVMRILPRM	EVMRILPRM
MVTEIRLKY	MVTEIRLKY
DLANIRSEY	DLANIRSEY
EVPHEVGDF	EVPHEVGDF
EAAPGPRVLGF	EAAPRVLGF
EVQDSYEAY	EVQDSYEAY
QVADIDGQY	QVADIDGQY
EAFQTTISKY	EAFQTISKY
ETIDTARLHY	ETIDARLHY
AVKEKISKF	AVKEKISKF
ELPDYLIKY	ELPDYLIKY
EIFDGIQPKM	EIFDIQPKM
APATGAHNY	APATGAHNY
ELIGKYAMR	ELIGKYAMR
HVKDANGNSF	HVKDNGNSF
EAVQAISMF	EAVQAISMF
EVAQMAAYY	EVAQMAAYY
SVVELINHY	SVVELINHY
EIYSKTTRF	EIYSKTTRF
EVVAFIQHF	EVVAFIQHF
EVATFYTMY	EVATFYTMY
TISSNVASK	TISSNVASK
EVTSQTSHL	EVTSQTSHL
DVVFLITKY	DVVFLITKY
DVAHSDLILHV	DVAHSDLIL
HTINGHNAEV	HTINHNAEV
ETVLKTTGY	ETVLKTTGY
TVIDEVRTGTY	TVIDRTGTY
EVVSQIPNL	EVVSQIPNL
HIIGRIESY	HIIGRIESY
DTLDKVFTY	DTLDKVFTY
DVIRDVPLV	DVIRDVPLV
SVINSKASLTY	SVINSKASL
EVRQGLKAY	EVRQGLKAY
DTFGRPVIVAY	DTFGVIVAY
EIATTFEHYY	EIATTFEHY
NVIESKAYVGR	NVIESKAYV
DVTEQISRF	DVTEQISRF
TTYKLVINGKT	TTYKVINGK
QVIEAEGLKEM	QVIEEGLKE
EVIDLMIKEY	EVIDMIKEY
TIRNIPHL	-TIRNIPHL
QTPDFTPTKY	QTPDTPTKY
ETRDGQVLGR	ETRDQVLGR
YVQDRVPSY	YVQDRVPSY
DLIGKTSEM	DLIGKTSEM
DIPLFPVQTKY	PLFPVQTKY
YVPDVTGRY	YVPDVTGRY
DIIDHHDNTY	DIIDHDNTY
EVSSHFSHF	EVSSHFSHF
EVAEFLARH	EVAEFLARH
EVAEHVQYM	EVAEHVQYM
DVFTHVLYY	DVFTHVLYY
TVHSIISKM	TVHSIISKM
EVIQALPKL	EVIQALPKL
DTTHNLPEF	DTTHNLPEF
DTSGPTMRY	DTSGPTMRY
EVKLEIPSF	EVKLEIPSF
YSKYYKTID	YSKYYKTID
EIVPRLPDY	EIVPRLPDY
ETFYSTERY	ETFYSTERY
AVIGDVIRVY	AVIGVIRVY
EVINRSMDTY	EVINSMDTY
EIAEKMATF	EIAEKMATF
TVADQVLVGSY	TVADLVGSY
EVASNMARF	EVASNMARF
SILDRDDIFVY	SILDRDDIF
DVISNIETF	DVISNIETF
AVKEKISMF	AVKEKISMF
HTIGKTVEY	HTIGKTVEY
ELKKTMALF	ELKKTMALF
ELKTKISAM	ELKTKISAM
HVAQIYAIR	HVAQIYAIR
EAAPGTIRGDF	EAAPTIRGD
DIPARVTLM	DIPARVTLM
EVVDKKIEEF	EVVDKIEEF
EVVGVTGVVHM	EVVGVTGVV
DVPENNQHGY	DVPENQHGY
KAPAPRPSL	KAPAPRPSL
ETFPGVTAL	ETFPGVTAL
EVLDSLLVQY	EVLDLLVQY
EVYDQLFKSR	EVYDLFKSR
ETFGGFDSHQM	ETFGGFDSH
EVRGGGLTR	EVRGGGLTR
EIYDRREYSRF	EIYDEYSRF
ELINNVAKA	ELINNVAKA
ETFKEQGNAY	ETFKQGNAY
AEQRGENALKD	EQRGNALKD
EIADQVSREY	EIADVSREY
ETVLYIEHRY	ETVLIEHRY
EVPGHQSVF	EVPGHQSVF
ETFDLQLGRF	ETFDQLGRF
ETVGKFIQY	ETVGKFIQY
DVKGQTALY	DVKGQTALY
DVYTHVLSAF	DVYTVLSAF
EVFETIIHSY	EVFEIIHSY
EAVTHIGRVY	EAVTHIGRV
DVASKGLGLVY	DVASKGLGL
FVIDTTPGM	FVIDTTPGM
DVANKIGII	DVANKIGII
TIAKLVKY	-TIAKLVKY
VPKTAENFRQF	KTAENFRQF
EVYDDFLHY	EVYDDFLHY
EVATRMQSF	EVATRMQSF
EVFRKEMSQF	EVFREMSQF
EVRWFQSQF	EVRWFQSQF
EVYRLAIQSF	EVYRAIQSF
EVADELVSEF	EVADLVSEF
EVVQRISNV	EVVQRISNV
EIAGHIMEF	EIAGHIMEF
FLRDKIASY	FLRDKIASY
TVYEGPFASR	TVYEPFASR
STFKETENTAY	TFKEENTAY
EVYEKVVDY	EVYEKVVDY
ETIDVHSGYDI	ETIDVHSGY
DLPGMYPAHMY	DLPGMYPAH
DVKDGKYSQV	DVKDKYSQV
SVIDIINKY	SVIDIINKY
EVFQTKIQEF	EVFQKIQEF
EAIRPYVSR	EAIRPYVSR
NLPDEIYHVY	NLPDIYHVY
EVVTGVIGQR	EVVTVIGQR
SAPSRATAL	SAPSRATAL
DTIEIITDR	DTIEIITDR
EVVQRLTRM	EVVQRLTRM
ESFEDGLKY	ESFEDGLKY
HVPAGLLALF	HVPALLALF
ETVVRYEKF	ETVVRYEKF
EVAGIVAAR	EVAGIVAAR
EIPHEVGDF	EIPHEVGDF
DVKPFVPRF	DVKPFVPRF
EVPPPTVPMDY	EVPPPTVPM
EAYSAKIALF	EAYSKIALF
DTTAINKSYY	DTTAINKSY
EVVEEVEKY	EVVEEVEKY
EAMHGVFLY	EAMHGVFLY
EVVGVYGSF	EVVGVYGSF
DLIKNIPDA	DLIKNIPDA
DTPGHVDFSY	DTPGVDFSY
DVIPVDGARY	DVIPDGARY
EVIQWLAKL	EVIQWLAKL
HLIQNIPGF	HLIQNIPGF
EVTGHTDHYF	EVTGHTDHY
EVVERLLSV	EVVERLLSV
DVFEEPMSGM	DVFEPMSGM
ETFNVPAMY	ETFNVPAMY
SFEDAKEAL	SFEDAKEAL
EVVTGVIGQRM	EVVTVIGQR
DVIAEQSVSGY	DVIASVSGY
EVFPLKVFGY	EVFPKVFGY
HTKLSLGSY	HTKLSLGSY
DLSPITVKY	DLSPITVKY
SVVDISQQY	SVVDISQQY
HSFGGGTGSGF	HSFGTGSGF
EVIDVFEIM	EVIDVFEIM
IVAEPGAVLLY	IVAEAVLLY
EVISKLYAV	EVISKLYAV
EVYDHARRALY	EVYDARRAL
NVYDFKTTY	NVYDFKTTY
DVAEFSSRY	DVAEFSSRY
NIPGSELMSSF	NIPGLMSSF
EVTWELPQY	EVTWELPQY
EVFPLAMNYL	EVFPLAMNY
EVAPGALLGL	EVAPALLGL
ETVWRLEEF	ETVWRLEEF
HVVDEHTGQY	HVVDHTGQY
DVIERVIQY	DVIERVIQY
ETKEAMSEM	ETKEAMSEM
EVYPFGIVGM	EVYPGIVGM
HVIDVKFLY	HVIDVKFLY
EVIHNLPDF	EVIHNLPDF
EVINDYHFR	EVINDYHFR
SVPEAQSAL	SVPEAQSAL
AVKERIAKF	AVKERIAKF
SVADWKVMAF	SVADKVMAF
EVIGVLAQSKF	EVIGVLAQS
EVVGIIESR	EVVGIIESR
YVSDINSVY	YVSDINSVY
EVPSFLVERM	EVPSLVERM
EAAPHDIGY	EAAPHDIGY
HVFTFGSRLY	HVFTFGSRL
EAIGIISKMMY	EAIGIISKM
STYEKALGY	STYEKALGY
DVIAQGIGKL	DVIAGIGKL
ETFPGVTALF	ETFPVTALF
EVYPGAKLFY	EVYPAKLFY
EVASAKQSVKY	EVASAKQSV
EVIKEVQEF	EVIKEVQEF
ESADLIQHY	ESADLIQHY
SVKDKITAF	SVKDKITAF
YIFPSSISAM	YIFPSISAM
EVVQQVVLY	EVVQQVVLY
ETIGKYWAA	ETIGKYWAA
ELPSVNIGAF	ELPSNIGAF
DVAPSTLLPSY	DVAPLLPSY
HVINQTGGY	HVINQTGGY
EVPHFHHELVY	EVPHFHHEL
DIYNFPIHAF	DIYNPIHAF
EVNEWFTKY	EVNEWFTKY
HTIELEPNRQF	HTIELEPNR
EIVEKIGVH	EIVEKIGVH
EVSGIKALY	EVSGIKALY
EVVWPGVTSM	EVVWGVTSM
DLKTKIQKY	DLKTKIQKY
SVVGAISSY	SVVGAISSY
EVTTNIPKM	EVTTNIPKM
EVISGEKVTFY	EVISKVTFY
ESAGIHETTY	ESAGHETTY
SAPQSAGIT	SAPQSAGIT
EVKEDIGVGSY	EVKEGVGSY
DVYENLYAGR	DVYELYAGR
YAPKGSSL	-YAPKGSSL
ELIETIQEM	ELIETIQEM
EVSAATGRF	EVSAATGRF
ETTDIISRH	ETTDIISRH
DVVEKLNLF	DVVEKLNLF
DLIEKLLNY	DLIEKLLNY
ETVSGLKGY	ETVSGLKGY
EVVERVLTF	EVVERVLTF
EVPNTVHQF	EVPNTVHQF
DVFPTKYGREF	DVFPKYGRE
ESAPVHNSF	ESAPVHNSF
ETVKEIKEV	ETVKEIKEV
SVDRKFISLM	SVDRFISLM
ELVKKIAIY	ELVKKIAIY
EAIDSEGHSY	EAIDEGHSY
EISDIHTKL	EISDIHTKL
TEPVSLFPEE	EPVSLFPEE
EVKLKVDSF	EVKLKVDSF
EVFTGGISSY	EVFTGISSY
AVAEKMLQY	AVAEKMLQY
STIDWNKLY	STIDWNKLY
ELVDLIPEY	ELVDLIPEY
FVYDVTKMTSF	FVYDKMTSF
EVKSRTTLF	EVKSRTTLF
EIISEISKL	EIISEISKL
EVVAGEFGSR	EVVAEFGSR
QVINNVSKF	QVINNVSKF
ETEQKRLGL	ETEQKRLGL
FEVDTVAP	-FEVDTVAP
EVPRIQLEEY	EVPRQLEEY
PKTAENFRQF	KTAENFRQF
ETRPAGDGTF	ETRPGDGTF
HTIHVLSAY	HTIHVLSAY
DTYDDRAYSSF	DTYDAYSSF
EVIRQAGVY	EVIRQAGVY
ETIPKAVSF	ETIPKAVSF
EVAAAIAGY	EVAAAIAGY
SLKETIGKY	SLKETIGKY
EVAPALSVF	EVAPALSVF
ETIERLQQL	ETIERLQQL
EVIGQVLSTL	EVIGVLSTL
EVFDKTYQF	EVFDKTYQF
EVVELLIKY	EVVELLIKY
EIKQIVSEY	EIKQIVSEY
EVIEKKPEKF	EVIEKPEKF
HVYQHGLTGF	HVYQGLTGF
HTPENPVIRY	HTPEPVIRY
DVIESVNLL	DVIESVNLL
DVVKEIFFHY	DVVKIFFHY
EIAPHFAVNHF	EIAPAVNHF
YVYEYPSRY	YVYEYPSRY
LFNLAKDIF	LFNLAKDIF
EVYEGALLY	EVYEGALLY
ELIQAKVGSF	ELIQKVGSF
YTKHGTLKY	YTKHGTLKY
DPLRVQPHL	DPLRVQPHL
EAYTQLLTEM	EAYTLLTEM
EVIRLIANF	EVIRLIANF
DTIDERAINKK	DTIDRAINK
DIPAHWSDM	DIPAHWSDM
ATKARIPFY	ATKARIPFY
FTYDPWIGKL	FTYDWIGKL
EVFPLAMNY	EVFPLAMNY
TTIDIGVKY	TTIDIGVKY
EVAPRLAFA	EVAPRLAFA
EIIARIAQH	EIIARIAQH
DAAALISYY	DAAALISYY
YQSKYEEL	-YQSKYEEL
EVYAWAPKPY	EVYAAPKPY
EVVDVTWRY	EVVDVTWRY
PEYVLAYID	PEYVLAYID
EIIKIIGKY	EIIKIIGKY
DIPGEAMVKLY	DIPGAMVKL
GGLPERSVSL	GLPERSVSL
EVIGRVPQA	EVIGRVPQA
DVIQAGKEY	DVIQAGKEY
EVVSLETRY	EVVSLETRY
EVVDFSSHY	EVVDFSSHY
EVPTQLVSYF	EVPTQLVSY
EAIQRTEAY	EAIQRTEAY
AEFAEVSK	-AEFAEVSK
ETIHIRGGVF	ETIHRGGVF
HVPEHAVVL	HVPEHAVVL
EVSEQILHM	EVSEQILHM
ETVWHLEEF	ETVWHLEEF
AVISSVAHY	AVISSVAHY
ETITVSPEY	ETITVSPEY
FLIDKVNAF	FLIDKVNAF
EVIEGYEIA	EVIEGYEIA
SPVDNHRY	-SPVDNHRY
NAPWAVTSL	NAPWAVTSL
EVIPLVQTF	EVIPLVQTF
HTVPIYEGY	HTVPIYEGY
EVVGYFGRF	EVVGYFGRF
ETIHIRGGVFS	ETIHRGGVF
ELVERLQSY	ELVERLQSY
ELVTIIPNF	ELVTIIPNF
YVADLENMVQY	YVADNMVQY
EVRQAMGMLAF	EVRQAMGML
YVADHASSY	YVADHASSY
EVVDGLEKAIY	EVVDGLEKA
TKAVDAETAE	KAVDAETAE
EVVEKYEIY	EVVEKYEIY
ETTSIATAR	ETTSIATAR
EVYPHVSTI	EVYPHVSTI
STIGFKLPSY	STIGKLPSY
EIYSYITKY	EIYSYITKY
EVAAVLLHF	EVAAVLLHF
EVVNKDVLDVY	EVVNDVLDV
EVKEDIAKL	EVKEDIAKL
ENMWNTGSTY	ENMWTGSTY
EVFPDSPGAY	EVFPSPGAY
YVILNILRF	YVILNILRF
EIPAANLVNKY	EIPALVNKY
RVVGSELIQKY	VVGSLIQKY
ETIGRDLHRQF	ETIGRDLHR
EVTFVPGLY	EVTFVPGLY
EAFGQKIGHF	EAFGKIGHF
DVITIIDRSF	DVITIDRSF
EVAPAGASY	EVAPAGASY
EIIGRDLSGF	EIIGDLSGF
ETFSGVYKKL	ETFSVYKKL
PDGTVVTVM	PDGTVVTVM
FTVETASREY	FTVEASREY
EVVAEVQEF	EVVAEVQEF
ELPDNILNF	ELPDNILNF
SVISKDGELY	SVISDGELY
SIKDRMAKY	SIKDRMAKY
TSTDISSLY	TSTDISSLY
HTAPNVPHY	HTAPNVPHY
EIIGPYASW	EIIGPYASW
ELKHFIAEY	ELKHFIAEY
IIHEIAVLEL	IIHEAVLEL
YVFEGKMLEA	YVFEKMLEA
AVDFAERHGY	AVDFERHGY
EIMDRAYDSF	EIMDAYDSF
DTIDERTINKK	DTIDRTINK
EVHDYIRAY	EVHDYIRAY
ESSSVVLRY	ESSSVVLRY
EVVTEGLLNTY	EVVTLLNTY
EIIETGLAAF	EIIEGLAAF
EVVRKILLL	EVVRKILLL
ELMHSIVGSY	ELMHIVGSY
YASSPGGVY	YASSPGGVY
FVYEVTSTKY	FVYETSTKY
EVVERILFIY	EVVEILFIY
DVPDGTVVTVM	DVPDTVVTV
EVAPENFFSL	EVAPNFFSL
EPVQRIPRY	EPVQRIPRY
SLVGLGGTK	SLVGLGGTK
EVVIRQLEF	EVVIRQLEF
EVIDVFEIMKA	EVIDVFEIM
HVNGIVQKY	HVNGIVQKY
SSSKGSLGGGF	SSKGLGGGF
EVIGLLGGRY	EVIGLGGRY
SQHYHQGYY	SQHYHQGYY
SVIEQILHY	SVIEQILHY
EVIDEGWWRGY	EVIDWWRGY
EIISHISQH	EIISHISQH
EVSEIKSSYY	EVSEIKSSY
DVIRLIGQH	DVIRLIGQH
EPIYIITEY	EPIYIITEY
EVASNITSF	EVASNITSF
EVAGIINDAK	EVAGIINDA
EVIGGADKY	EVIGGADKY
VVYDGEHLGSF	VVYDHLGSF
DIPENVDITL	DIPEVDITL
DTIRMIDAY	DTIRMIDAY
YTTDRVMTV	YTTDRVMTV
YVFDGTNPPY	YVFDTNPPY
IWSHAIQKY	IWSHAIQKY
ELAPSLPSY	ELAPSLPSY
DIAQVNLKY	DIAQVNLKY
EVIRTLPSL	EVIRTLPSL
YVTHLHAEY	YVTHLHAEY
EVIKDANLY	EVIKDANLY
ELIGRPIGEF	ELIGPIGEF
DTATPDIKSHY	ATPDIKSHY
TVIEPLKGY	TVIEPLKGY
DIISRIPKI	DIISRIPKI
DSYVGDEAQSK	YVGDEAQSK
EVHTIPAKM	EVHTIPAKM
EIIQDLAAM	EIIQDLAAM
SVVGGFVSHY	SVVGFVSHY
SVPTQQGHLY	SVPTQGHLY
TVIEEHLGKF	TVIEHLGKF
EVVDKINQV	EVVDKINQV
SVIDGRFEGF	SVIDRFEGF
EVFTEILNY	EVFTEILNY
EVMPLFAGY	EVMPLFAGY
MVITPQNGRY	MVITQNGRY
EVISSVSEL	EVISSVSEL
EIFDGNVAHI	EIFDNVAHI
IAPTGHSL	-IAPTGHSL
DIYESPNHLY	DIYEPNHLY
EVADRLFSSF	EVADLFSSF
DVYNHFLLY	DVYNHFLLY
FVAPATGAHNY	FVAPATGAH
SAPKGSVL	-SAPKGSVL
EVPDYSMAY	EVPDYSMAY
EVIEQIENL	EVIEQIENL
HGIDPTGTYH	HGIDPTGTY
EVPDPNVVPHY	EVPDVVPHY
ELKKVVALY	ELKKVVALY
DVKDVIEQY	DVKDVIEQY
DLFGRDLSY	DLFGRDLSY
ETADVIAKV	ETADVIAKV
EVAGHLRTY	EVAGHLRTY
PENTVFDAKR	ENTVFDAKR
HSSSIVTAY	HSSSIVTAY
LRNVSTGD	-LRNVSTGD
EVPHEVAQY	EVPHEVAQY
DVIKEIEDF	DVIKEIEDF
EIIDNIKGTEY	EIIDKGTEY
SVVAVPLPLH	SVVAPLPLH
ETASRIAKV	ETASRIAKV
EVATDHKAFY	EVATHKAFY
ETIQVHRRY	ETIQVHRRY
DVKKRILEF	DVKKRILEF
EVKSHLLDY	EVKSHLLDY
DTVDKIVVQKY	DTVDVVQKY
YSKYYKTIDD	-----YSKY
ETINRIKLY	ETINRIKLY
EVSDRISSL	EVSDRISSL
DVVEKTIQKY	DVVETIQKY
YVPESVGSF	YVPESVGSF
ETAWRWPEF	ETAWRWPEF
EVVSNVQEY	EVVSNVQEY
ETFKEQGNAYY	ETFKQGNAY
VLKEKIAKY	VLKEKIAKY
EVINRIQKL	EVINRIQKL
TYDDATKTF	TYDDATKTF
LAGHGHLY	-LAGHGHLY
EVIPYTPAM	EVIPYTPAM
NVSTVLTSKY	NVSTLTSKY
EVYPGQQYL	EVYPGQQYL
SVSTVLTSKY	SVSTLTSKY
ETSADNQHYY	ETSADNQHY
HVITGLLEHY	HVITLLEHY
EVVDARLVSVF	EVVDRLVSV
EVVVQVPYL	EVVVQVPYL
DVKGGTLTQY	DVKGTLTQY
DVFQQQTGGVY	DVFQQTGGV
DAADKAAVVKF	DAADKAAVV
EIKDILIQY	EIKDILIQY
ELVDAFVEHRY	ELVDAFVEH
SAVEFRQTGY	SAVERQTGY
EVHRFGITGY	EVHRGITGY
ELKEKLTEY	ELKEKLTEY
DSFFGETSHNY	SFFGTSHNY
HTKENGLPY	HTKENGLPY
EVIGESMEM	EVIGESMEM
ETIRNIPHL	ETIRNIPHL
DTKEAIANY	DTKEAIANY
DTISPTLGF	DTISPTLGF
ETTVLVESY	ETTVLVESY
EVYEKPVQV	EVYEKPVQV
YVIGRRKSY	YVIGRRKSY
ETMHTLLDYTY	ETMHTLLDY
EVYQHLAHY	EVYQHLAHY
YVTTSTRTY	YVTTSTRTY
DVASFATKL	DVASFATKL
LQPLNVKVD	LQPLNVKVD
FTKDQMSHL	FTKDQMSHL
SVIEKALRNF	SVIEALRNF
ETTSHLMGMFY	ETTSHLMGM
ETIQNMSKV	ETIQNMSKV
DILDFAYTSR	DILDAYTSR
EVVAIKKMSY	EVVAKKMSY
YFAERVTSL	YFAERVTSL
EVSSISSKF	EVSSISSKF
EVTSINSFL	EVTSINSFL
HVVKREAILLY	VVKRAILLY
EVFHDQLHTF	EVFHQLHTF
DVAEEIANY	DVAEEIANY
EVFGRVERY	EVFGRVERY
DLKDLITRM	DLKDLITRM
ELIRKIEAY	ELIRKIEAY
FIIQNIPGF	FIIQNIPGF
SVIRKIPAL	SVIRKIPAL
ESIDIITRA	ESIDIITRA
EIFQHLMAY	EIFQHLMAY
DAAKGFGGKY	DAAKFGGKY
ETAAKVALM	ETAAKVALM
ETADTLMGLRY	ETADTLMGL
NVADLHEKY	NVADLHEKY
EVGGEALGRL	EVGGALGRL
DVQELLTQY	DVQELLTQY
EIVSTPRLQY	EIVSPRLQY
EVIEDEKQFY	EVIEEKQFY
HVLIDVGTGYY	VLIDVGTGY
DVISKRSGY	DVISKRSGY
EVIGAYKQA	EVIGAYKQA
ETAVAILRF	ETAVAILRF
FAFEHSEEY	FAFEHSEEY
DIKEIVPLF	DIKEIVPLF
EIRDIILGM	EIRDIILGM
EIASTDLKY	EIASTDLKY
GFGQHGSVSGQ	FGQHSVSGQ
DVISRIDRM	DVISRIDRM
ETYSNLIKL	ETYSNLIKL
ELKEVIERF	ELKEVIERF
ATFDAISKTY	ATFDISKTY
ETYEALLARF	ETYELLARF
SIPEKNRPL	SIPEKNRPL
EVIEKFDYV	EVIEKFDYV
EVMDVFLRF	EVMDVFLRF
HIATFNALGY	HIATNALGY
NVIRLVGKY	NVIRLVGKY
ETAGRYITY	ETAGRYITY
DLIKDVLRY	DLIKDVLRY
IGKRGIIGY	IGKRGIIGY
DVEAIFSKY	DVEAIFSKY
EVVAGIKEYF	EVVAGIKEY
DTMGTYHGM	DTMGTYHGM
EVANKVGGIY	EVANVGGIY
ETAIYKGDY	ETAIYKGDY
YTKNYLPLL	YTKNYLPLL
NVIEQYIGRF	NVIEYIGRF
SVVDRVASM	SVVDRVASM
EVFTGGIGSY	EVFTGIGSY
DVKTQVAEY	DVKTQVAEY
TVIEPLKGYY	TVIEPLKGY
EVFESVSAY	EVFESVSAY
EVVGNMAVSRY	EVVGAVSRY
DVVDSEALQVY	DVVDEALQV
EIVPKVAKM	EIVPKVAKM
RVPFIYGHKY	RVPFYGHKY
EVYNEQIHDL	EVYNQIHDL
EVPDDETVNQM	EVPDTVNQM
DVIGVTKGKGY	DVIGKGKGY
EVAPGYVVTVL	EVAPYVVTV
DTIEEKFVPY	DTIEKFVPY
HVIDVDSGNSY	HVIDSGNSY
DVASGQVVRKF	DVASVVRKF
WSQHYHQGYY	SQHYHQGYY
EVASGMILVM	EVASMILVM
ETKEPSMMEY	ETKESMMEY
EVISSLEKY	EVISSLEKY
EVIRILSTM	EVIRILSTM
ETVPKVSIV	ETVPKVSIV
SVAGIFNYY	SVAGIFNYY
QTPAHIAAF	QTPAHIAAF
IEEHLGKF	-IEEHLGKF
FVAGVVTFY	FVAGVVTFY
VEELKPTPE	VEELKPTPE
ETIVNVLDF	ETIVNVLDF
HVYDGKFLARV	HVYDKFLAR
EVIPALPRL	EVIPALPRL
EVIQGLLKKF	EVIQLLKKF
EVIESTNLKY	EVIETNLKY
EVMDEFDGRSF	EVMDEFDGR
AVIEDTWHYF	AVIEDTWHY
EAIMKVGQM	EAIMKVGQM
EVTDFLSFY	EVTDFLSFY
ELAKQITSY	ELAKQITSY
FNEKSKEL	-FNEKSKEL
EVIQPYQEF	EVIQPYQEF
EVTELLVKH	EVTELLVKH
ELYHQSVVY	ELYHQSVVY
EVAPVISSAY	EVAPISSAY
FVIKRLPLF	FVIKRLPLF
EVLNFLLRY	EVLNFLLRY
ELKKLIGEV	ELKKLIGEV
DSIGEKLGRY	DSIGKLGRY
ETPFFLLTGY	ETPFLLTGY
YTYESPAGY	YTYESPAGY
ETFDAGLQAF	ETFDGLQAF
DVKDLIGFF	DVKDLIGFF
ETYGKIVHY	ETYGKIVHY
EVTEFGNKY	EVTEFGNKY
ISPTGHSL	-ISPTGHSL
EVIDHKLTER	EVIDKLTER
EVSGIKAAY	EVSGIKAAY
NVKVDPEI	-NVKVDPEI
YENEVALRQ	YENEVALRQ
ELMYGGVSSY	ELMYGVSSY
RVYIHPFHL	RVYIHPFHL
EALNKQIMEY	EALNQIMEY
EIIEKNFDY	EIIEKNFDY
TFTRVQKY	-TFTRVQKY
EVFGRVSRF	EVFGRVSRF
EVFNKFFKER	EVFNFFKER
ETITQLNLSGY	ETITNLSGY
ETMSPGVFSR	ETMSGVFSR
EAYNAVVRY	EAYNAVVRY
DTYPEESRSY	DTYPESRSY
FTAERSSYY	FTAERSSYY
EVFDKTYQFL	EVFDKTYQF
SVIEAVAHF	SVIEAVAHF
EAIGNEVTRLV	EAIGEVTRL
DVAGRVMQY	DVAGRVMQY
ETFPDAKGWIF	ETFPDAKGW
ELPDTVGEL	ELPDTVGEL
DVKVGGSKY	DVKVGGSKY
EVISKTPTL	EVISKTPTL
ETIQITQKY	ETIQITQKY
EVIKELAQI	EVIKELAQI
DVPEKWARF	DVPEKWARF
ETPEMLPAY	ETPEMLPAY
EVADVLVDGY	EVADLVDGY
DLIGHIVEF	DLIGHIVEF
SVIKIQSYY	SVIKIQSYY
EVSPNLVRY	EVSPNLVRY
AVRDNNMAPY	AVRDNMAPY
DTLPLATRY	DTLPLATRY
ETMHTLLDY	ETMHTLLDY
DIPEYVLAY	DIPEYVLAY
ETVSRVSSV	ETVSRVSSV
DVMKDFEEM	DVMKDFEEM
NVIDYGHASKY	NVIDHASKY
FVFDTIQSHQY	FVFDTIQSH
EVFMHVSTAY	EVFMVSTAY
EVNKFQMAY	EVNKFQMAY
STVGGWVSTR	STVGWVSTR
EAYNSLMKSY	EAYNLMKSY
ETIAKLVKY	ETIAKLVKY
TISSNVASKA	TISSNVASK
EIMEHRFKTY	EIMERFKTY
ETVGTGIMGR	ETVGGIMGR
ETIRNILLH	ETIRNILLH
AIIERVQRY	AIIERVQRY
TVVVRIMEF	TVVVRIMEF
ETYGHKTPY	ETYGHKTPY
EIVPFRVAAY	EIVPRVAAY
EIKEVILEF	EIKEVILEF
DLMGLIPKY	DLMGLIPKY
EVYRHHLEQM	EVYRHLEQM
EVAPAKDVTLL	EVAPKDVTL
HVIDDFVQF	HVIDDFVQF
EVIAKNNSF	EVIAKNNSF
GVFTGPGGHSY	FTGPGGHSY
DLIEHFSQF	DLIEHFSQF
EIPGKFMGY	EIPGKFMGY
EVVPVISPM	EVVPVISPM
GGFGGGSFRGS	GGFGGGSFR
EVIPENTVIY	EVIPNTVIY
EVVKYLLRM	EVVKYLLRM
AKNKLNDLED	-AKNKLNDL
SVASIKTGF	SVASIKTGF
EVISVLQKY	EVISVLQKY
EVKRLIAEA	EVKRLIAEA
DIASLVGHEF	DIASVGHEF
EVLGILRYI	EVLGILRYI
EVAPHHLFLSH	EVAPHHLFL
TLIDIMTRF	TLIDIMTRF
DPDVLNSL	-DPDVLNSL
TTYKLVINGK	TTYKVINGK
ETIAKYEIM	ETIAKYEIM
HTKTTLPTF	HTKTTLPTF
DIYGGDYERF	DIYGDYERF
DVSPVVSTY	DVSPVVSTY
HVIYTVNLY	HVIYTVNLY
EVGPAGSQF	EVGPAGSQF
ETVQTTLKF	ETVQTTLKF
EAIEQILKY	EAIEQILKY
LSNVSLDTIY	SNVSLDTIY
EVMEIMSRF	EVMEIMSRF
EVIKSMKPK	EVIKSMKPK
EVVGEQVTSY	EVVGQVTSY
AVNDAHLLQY	AVNDHLLQY
ETISKAQAF	ETISKAQAF
NTIEGTAKY	NTIEGTAKY
EVADRIGDY	EVADRIGDY
EVAQVESLRY	EVAQESLRY
ETFDGVIYGF	ETFDVIYGF
DIINREKLLQY	DIINKLLQY
EIIKEISIM	EIIKEISIM
YIATKIGAF	YIATKIGAF
EVVQKLKFGVY	EVVQKFGVY
DTANKVGTY	DTANKVGTY
DTYASTIGHY	DTYATIGHY
ETASELLMRL	ETASLLMRL
EITDKLGLH	EITDKLGLH
EVKPVLPEL	EVKPVLPEL
EVTTHILSQF	EVTTILSQF
STYEKALGYF	STYEKALGY
DLPDIQIKH	DLPDIQIKH
DVTDFISHL	DVTDFISHL
EVGGEALGR	EVGGEALGR
YSAPATLSSR	SAPATLSSR
GGFGGGSFR	GGFGGGSFR
ETFQQKMLRF	ETFQKMLRF
EVIDTQTKLY	EVIDTQTKL
EAMSGHIDQF	EAMSHIDQF
HTAAMVQQY	HTAAMVQQY
ETIYDLGTKM	ETIYLGTKM
YVVEPYRKY	YVVEPYRKY
AVKAIIYQY	AVKAIIYQY
SIPGGYNAL	SIPGGYNAL
EVYEGVYTNH	EVYEVYTNH
ETFHHSSNW	ETFHHSSNW
EVISTLLEKM	EVISLLEKM
HVIEDHERIGY	HVIEDHERI
DTLAHVLYY	DTLAHVLYY
EVISNEGGRF	EVISEGGRF
EIIEHGIELF	EIIEGIELF
EIFNPDIGMF	EIFNDIGMF
HGIDPTGTY	HGIDPTGTY
ETIPDGIGKL	ETIPGIGKL
FVAPVDLQAY	FVAPDLQAY
MPVGPDAILRY	PVGPAILRY
EVYEGRFSLY	EVYERFSLY
DSSPVSTPF	DSSPVSTPF
YVIQKFFEF	YVIQKFFEF
ITQIEHEVSSS	TQIEEVSSS
HVISYSLSPF	HVISSLSPF
DSRPGGYGY	DSRPGGYGY
EVYGSVAKV	EVYGSVAKV
EAISYYSKY	EAISYYSKY
EIVNISSGY	EIVNISSGY
HVIRDVAQF	HVIRDVAQF
EMKEYITKF	EMKEYITKF
EVASVYQSY	EVASVYQSY
EVNKVISSV	EVNKVISSV
AVIEGAKFIM	AVIEAKFIM
DTISKMNDF	DTISKMNDF
ELITKFLQY	ELITKFLQY
DVISSIRNF	DVISSIRNF
EIKERIERV	EIKERIERV
ELMQKVSGY	ELMQKVSGY
EVYSADREDLY	EVYSDREDL
EAASVPVVY	EAASVPVVY
ETAQAIKGM	ETAQAIKGM
EAFTEMMEAY	EAFTMMEAY
ELYERPPHLY	ELYERPPHL
SVYGGGGIHEY	SVYGGIHEY
DVVKKIESF	DVVKKIESF
EVKDKVPSL	EVKDKVPSL
AAPATRAAL	AAPATRAAL
DVKSLMAKY	DVKSLMAKY
EVVKFTQAY	EVVKFTQAY
ETNGFISAH	ETNGFISAH
EIYPPKLHQF	EIYPKLHQF
ETASKTLSRF	ETASTLSRF
DTVSTFTSY	DTVSTFTSY
EVLDFITHLY	EVLDITHLY
QIKDAIGRY	QIKDAIGRY
TVSDAILRY	TVSDAILRY
ELVKRILNF	ELVKRILNF
DVIARIAQH	DVIARIAQH
ETVDPASLWEY	ETVDPASLW
SIRSFVSKM	SIRSFVSKM
ETYQDIFRDF	ETYQIFRDF
DVVGPEGMEKF	DVVGGMEKF
EVSGKVLEM	EVSGKVLEM
DVVDFFQKY	DVVDFFQKY
EVRTGGMAF	EVRTGGMAF
NVIDKLAQF	NVIDKLAQF
DTKQMMSSF	DTKQMMSSF
EVGPEGALGK	EVGPGALGK
NLKDFISRF	NLKDFISRF
DIPERILTY	DIPERILTY
EVISHIGKL	EVISHIGKL
NLGGSKRISIS	NLGGKRISI
LEQLLALY	-LEQLLALY
DAVKAKLISRM	AVKALISRM
ETAFGYKGL	ETAFGYKGL
EVFIHKDKGF	EVFIKDKGF
GVIEKLLTSY	GVIELLTSY
NVEIDPEIQ	NVEIDPEIQ
DIKPYIAEY	DIKPYIAEY
EVPSWLENMAY	EVPSWLENM
TAPTGHTL	-TAPTGHTL
ETIFSISKA	ETIFSISKA
EVTGPHEAF	EVTGPHEAF
ETAPRLPQH	ETAPRLPQH
ETYIRSGTY	ETYIRSGTY
EIIKNVPLK	EIIKNVPLK
EVTEIISQF	EVTEIISQF
SVADKEAIANF	SVADAIANF
ETFNHANGL	ETFNHANGL
TTISKSGGDY	TTISSGGDY
DVAADIAKY	DVAADIAKY
EVIKNFIQY	EVIKNFIQY
NVKVDPEIQ	NVKVDPEIQ
ELYPYGELGHY	ELYPELGHY
AVRDPYGNR	AVRDPYGNR
ETSPIVLRY	ETSPIVLRY
EVVTVFQYY	EVVTVFQYY
SAPVGVTAL	SAPVGVTAL
HVPNFIFDEF	HVPNIFDEF
ETIDVHSGY	ETIDVHSGY
EVFNHREVNY	EVFNREVNY
EIFPLETPAF	EIFPETPAF
EVVDLFRAYDA	EVVDLFRAY
SVIDSAELQAY	SVIDELQAY
LAADFEIGHF	LAADEIGHF
EVVHKIIEL	EVVHKIIEL
SAVEKKLAEY	SAVEKLAEY
ETYGNKFAAH	ETYGKFAAH
EVIGKITAL	EVIGKITAL
FTAEFSSRY	FTAEFSSRY
SVVSVISRF	SVVSVISRF
DLVTYITRF	DLVTYITRF
ETIDSRVQEY	ETIDRVQEY
DVAPHVSLF	DVAPHVSLF
ETAPAKLIVYL	ETAPKLIVY
EIKQKIDSY	EIKQKIDSY
EATYVRSYY	EATYVRSYY
ENRPKYAGY	ENRPKYAGY
EVAEVKISHF	EVAEKISHF
ETAGAIMAF	ETAGAIMAF
EVNDARRIGKY	EVNDRIGKY
VVAPITTGY	VVAPITTGY
DTVHHMLLF	DTVHHMLLF
EPVQRVPRY	EPVQRVPRY
YVNPANTHQF	YVNPNTHQF
NAPLVHATL	NAPLVHATL
DVFNEKGWNY	DVFNKGWNY
YLPDFRFTPF	YLPDRFTPF
EIITNQIPKY	EIITQIPKY
FTMDVIGGKY	FTMDIGGKY
STISGGYAEY	STISGYAEY
EVFDHMMKRM	EVFDHMMKR
SVKEKISMF	SVKEKISMF
YTYPENWRAF	YTYPNWRAF
DIKRGIPNY	DIKRGIPNY
EVIWSHAIQKY	EVIWAIQKY
EVYEGVWKKY	EVYEVWKKY
HVAEQISKM	HVAEQISKM
ETIESINQL	ETIESINQL
EAFRGVHRY	EAFRGVHRY
DSFPMEIRQY	DSFPEIRQY
DTINLNSFF	DTINLNSFF
DVIGTLSGF	DVIGTLSGF
NVIDVNKVVEY	NVIDKVVEY
EVINGNIKTV	EVINNIKTV
DVAPTHILY	DVAPTHILY
EAAPPGELY	EAAPPGELY
EVAPPEYHRK	EVAPEYHRK
EVAPMLKAREY	EVAPMLKAR
EIADIKSKY	EIADIKSKY
ELQGHIGRF	ELQGHIGRF
EVYGKNLTSS	EVYGNLTSS
ESSYIATQY	ESSYIATQY
EVISKYDQF	EVISKYDQF
DIQIKDAIGRY	QIKDAIGRY
EAFPEKIPLF	EAFPKIPLF
DVVDEKISAM	DVVDKISAM
DSVDPHGFISY	SVDPGFISY
ETATLRSGY	ETATLRSGY
EILEKSFSEF	EILESFSEF
EVMNQNLAYY	EVMNNLAYY
ETYPSNILSH	ETYPNILSH
ETIVIINKF	ETIVIINKF
HVPDPVISIAM	HVPDVISIA
EVFDYSYRDY	EVFDSYRDY
YNSDGYGGNY	YNSDYGGNY
EIIKLIADY	EIIKLIADY
TVTEKPEVID	TVTEKPEVI
EAVDIRQIY	EAVDIRQIY
MAPERVASL	MAPERVASL
EVYHSSLASL	EVYHSLASL
ETVGTGIMGRM	ETVGGIMGR
ETAVVNVTY	ETAVVNVTY
EVLEVDNVKY	EVLEDNVKY
EIKPEMIGHY	EIKPMIGHY
DTITETDLRNH	DTITETDLR
ETFGFEIQSY	ETFGEIQSY
EIAEAYLGY	EIAEAYLGY
EVYAGSHQY	EVYAGSHQY
EVISPSPHFY	EVISPSPHF
EPIYIVTEY	EPIYIVTEY
ETVDEIVKSGY	ETVDVKSGY
DVIDHDDFRY	DVIDDDFRY
HTVGEKVIVDF	TVGEVIVDF
ELYNRMLKRF	ELYNRMLKR
ETVGEEDIRLF	ETVGDIRLF
EAYPLPGVTY	EAYPPGVTY
EVTELLARY	EVTELLARY
FPLKVFGY	-FPLKVFGY
EVISQHLVSY	EVISHLVSY
ETADITHAL	ETADITHAL
FVADEELVHLL	FVADELVHL
DSIPLSSGY	DSIPLSSGY
EVGGEALGRLL	EVGGALGRL
EVAAPDVGRM	EVAADVGRM
ETIDRFNNY	ETIDRFNNY
ETIQHTEAF	ETIQHTEAF
DIVAAIQHNY	DIVAIQHNY
DVYGANLFHQY	DVYGLFHQY
DVPEKSSLF	DVPEKSSLF
ETYEAKRHEF	ETYEKRHEF
TVFDKLNHEY	TVFDLNHEY
EVVEKWLDY	EVVEKWLDY
EVIASIISRY	EVIAIISRY
EVKKLMRKY	EVKKLMRKY
ETAEKLARF	ETAEKLARF
FVAEQKVEY	FVAEQKVEY
EVIQEIKSF	EVIQEIKSF
DVMTALSQGY	DVMTLSQGY
SVKDAKIAVY	SVKDKIAVY
QTIRSIGYY	QTIRSIGYY
STIQDYLGF	STIQDYLGF
DSHEPTYGIY	DSHETYGIY
ETIKDGVSRF	ETIKGVSRF
DLYAGMLHSM	DLYAMLHSM
EVFDPSPQGKY	EVFDPQGKY
EVVKKVNEM	EVVKKVNEM
HVAPDSIRGSF	HVAPIRGSF
HTVHVLSAY	HTVHVLSAY
EVADVGIEV	EVADVGIEV
ELVTGTVRTF	ELVTTVRTF
EVIDVVRTM	EVIDVVRTM
EVAGFGESR	EVAGFGESR
ETLETEKAQY	ETLEEKAQY
EVIDFSHGLAM	EVIDFSHGL
ETVRTLNNLY	ETVRLNNLY
EVIVGVNKY	EVIVGVNKY
DVIRLIMQY	DVIRLIMQY
EIIQIDGHIY	EIIQDGHIY
EVIPYTPAMQR	EVIPYTPAM
EIIGKRGIIGY	EIIGGIIGY
ELFHKDIEAF	ELFHDIEAF
FTPDGNHFLY	FTPDNHFLY
MTKRDVPGF	MTKRDVPGF
EAFDELLASKY	EAFDLLASK
DLIGDFSKGY	DLIGFSKGY
DAASGSLLRAF	DAASSLLRA
EVIESTNLKYF	EVIETNLKY
EISSIISKM	EISSIISKM
HTAEYLTYY	HTAEYLTYY
DVPDGTLVTVM	DVPDTLVTV
EAIKILKGEY	EAIKLKGEY
EVVDLFRAY	EVVDLFRAY
ETYPFNPPKY	ETYPNPPKY
SIPDIKTAF	SIPDIKTAF
EVVSHTSQV	EVVSHTSQV
EAVTHIGRV	EAVTHIGRV
EVVERVEEL	EVVERVEEL
DLPDHLLSY	DLPDHLLSY
EVMEQVRGY	EVMEQVRGY
EVTDFAGQY	EVTDFAGQY
DTIGYLLTRY	DTIGLLTRY
FVYEQKLNEY	FVYEKLNEY
DSHPFDLGLY	DSHPDLGLY
DVATYKVNY	DVATYKVNY
YTVEKREGY	YTVEKREGY
VLPERYSSL	VLPERYSSL
NVIEVDSAHY	NVIEDSAHY
HTVDFTADKY	HTVDTADKY
EVFDKDLSKL	EVFDDLSKL
EAAPEETRALY	EAAPETRAL
DVAALLIKY	DVAALLIKY
YTIATILHY	YTIATILHY
DVAAPFGGF	DVAAPFGGF
SVVDDIPEF	SVVDDIPEF
EVIEALLRKF	EVIELLRKF
ETVGTGIMGKM	ETVGIMGKM
YVAEILPKY	YVAEILPKY
EVIPPYYSY	EVIPPYYSY
EVISGKGQFF	EVISKGQFF
EIIPVAAEY	EIIPVAAEY
MVADVFSHRF	MVADFSHRF
EVIEIMTDR	EVIEIMTDR
HVYDGKFLAR	HVYDKFLAR
EAYHSVIKY	EAYHSVIKY
MTIEELLTRY	MTIELLTRY
EVFNGPLPRA	EVFNPLPRA
EVIPTHTVY	EVIPTHTVY
TVAGLALIKKY	TVAGLIKKY
DIISKIDLM	DIISKIDLM
DVYAKLLHRY	DVYALLHRY
DVKDYIQEY	DVKDYIQEY
ELIPEYLNF	ELIPEYLNF
ETIGTGGFAKV	ETIGTGGFA
EVITHELQDF	EVITELQDF
EVTDEDTVKRY	EVTDDTVKR
ETIETINQL	ETIETINQL
EIAQVGAKY	EIAQVGAKY
EVSSMVLTKM	EVSSVLTKM
EVIPNSNFY	EVIPNSNFY
QVAEIVSKY	QVAEIVSKY
EVFPEHLARF	EVFPHLARF
DVYPEIIERA	DVYPIIERA
ETFEKSRLY	ETFEKSRLY
HTFQNDIHVY	HTFQDIHVY
QTIGALLTKY	QTIGLLTKY
EVAPHPVYY	EVAPHPVYY
EVINKLGPRY	EVINLGPRY
AVYERELQTF	AVYEELQTF
ETTEESLRNYY	ETTESLRNY
HVHSLLSVF	HVHSLLSVF
EVFGYLAKY	EVFGYLAKY
EVVTHKTFHRY	EVVTTFHRY
TTIAKYAQY	TTIAKYAQY
EIAGVKLLY	EIAGVKLLY
EVVAVAHAVY	EVVAAHAVY
AVHDITVAY	AVHDITVAY
SLVNLGGSK	SLVNLGGSK
DVVRVVGAY	DVVRVVGAY
ETQIGGERY	ETQIGGERY
EVAQHLAATY	EVAQLAATY
YINPAKLTPY	YINPKLTPY
DVMDSTTTQKY	DVMDTTQKY
HVIENLHAAAY	HVIENLHAA
EVYRHFTGH	EVYRHFTGH
DIGWITGHSY	DIGWTGHSY
ETYQFSGVY	ETYQFSGVY
DVYGGTNRY	DVYGGTNRY
ETTKIVSEM	ETTKIVSEM
DISPVDNHRY	DISPDNHRY
EVKARLQKY	EVKARLQKY
EVLPAALAVY	EVLPALAVY
ELKESLSRM	ELKESLSRM
ETALLSSGF	ETALLSSGF
EVYDQEVGTSY	EVYDVGTSY
EVIPPMKEF	EVIPPMKEF
DVKEIMSQH	DVKEIMSQH
ETANADIVTLL	ETANDIVTL
DVPDGILDF	DVPDGILDF
EVFPKEMTKW	EVFPEMTKW
EVVERILFI	EVVERILFI
ETFNTPAMY	ETFNTPAMY
ELIERIPEL	ELIERIPEL
EVADEKMLSGL	EVADMLSGL
EAAEVILRV	EAAEVILRV
ESAPKEVSRY	ESAPEVSRY
ETQTDSISRY	ETQTSISRY
EVIRKGSITEY	EVIRSITEY
STTAVSARY	STTAVSARY
EVFTGHMGKL	EVFTHMGKL
YLPDGTASL	YLPDGTASL
EVIHLEAGGY	EVIHEAGGY
ELIRYISEL	ELIRYISEL
EVAPDFFEYF	EVAPDFFEY
ETFPEAYKPT	ETFPAYKPT
ETAENYLGH	ETAENYLGH
ELIAKIPNF	ELIAKIPNF
FVHWYVGEGM	FVHWVGEGM
EAVWRLPEF	EAVWRLPEF
EVVHLILFY	EVVHLILFY
EVIQNLERGY	EVIQLERGY
EVSTEVPEM	EVSTEVPEM
ETAPKSEEF	ETAPKSEEF
TVIDQIPFL	TVIDQIPFL
DVIGKALQY	DVIGKALQY
DVTDFISHLF	DVTDFISHL
EVNVAKSIAKF	NVAKSIAKF
ETPDYLLKY	ETPDYLLKY
EVAEAITQF	EVAEAITQF
TTKVGPNATY	TTKVPNATY
EVFSFKMVSY	EVFSKMVSY
QTIGNHASY	QTIGNHASY
DVYSGTPTKV	DVYSTPTKV
DVAALRGSRKF	DVAALRGSR
HVPGADILNSY	HVPGILNSY
EVAATEIKM	EVAATEIKM
FTITKTVEY	FTITKTVEY
ESIWEILHRY	ESIWILHRY
EVYPFQVAWY	EVYPQVAWY
ETSPAPIPNGF	ETSPIPNGF
DTFIGEGKEY	DTFIEGKEY
GTFEYEYSQR	GTFEEYSQR
AVADKVHLMY	AVADKVHLM
EAIYVTRHLF	EAIYVTRHL
KAPSAARSL	KAPSAARSL
FTVDGIPYF	FTVDGIPYF
YAADIFYSRY	YAADFYSRY
EVIDFSHGL	EVIDFSHGL
HLPETKFSEL	HLPEKFSEL
EVASNVPKV	EVASNVPKV
EVYNEKIHDL	EVYNKIHDL
EVHNLNQLLY	EVHNNQLLY
LEEALQQAKED	EALQQAKED
ETVNHHYLLF	ETVNHYLLF
SVVEAIPEF	SVVEAIPEF
DTILANAKY	DTILANAKY
EIYGGSDSRF	EIYGSDSRF
EVVAGIKEY	EVVAGIKEY
EVKEDDGKGNF	EVKEGKGNF
ETVNVITLY	ETVNVITLY
TTSGIQVRY	TTSGIQVRY
EVVSGVVSKV	EVVSVVSKV
YVFFEKDFGDM	YVFFKDFGD
EVVDKRNPM	EVVDKRNPM
WVFEHPETLY	WVFEPETLY
ETFGHLGALGF	ETFGHLGAL
ETFTRVQKY	ETFTRVQKY
EIIEDLAFY	EIIEDLAFY
ETMTEKLVKF	ETMTKLVKF
DLPDDLIGYF	DLPDLIGYF
ETTAVALAY	ETTAVALAY
SVIERQVGTF	SVIEQVGTF
DLLDWKYLGRY	DLLDKYLGR
AVISTILKY	AVISTILKY
DVVGDTSGY	DVVGDTSGY
STHVTISTY	STHVTISTY
DVAGIIADY	DVAGIIADY
SIIQRIQEF	SIIQRIQEF
AVVNAIGLY	AVVNAIGLY
YAVSELAGH	YAVSELAGH
AAPEGKRSL	AAPEGKRSL
ELYPKQIRAM	ELYPQIRAM
ETVEHHTEF	ETVEHHTEF
EIYPPEVAEF	EIYPEVAEF
ETAMVTADSKY	ETAMADSKY
EVAIRLLEM	EVAIRLLEM
EIMTRIQTY	EIMTRIQTY
SVISKIDLHKY	SVISKIDLH
EVSPIFTQF	EVSPIFTQF
