Data	Data aligned
VVDNPQKF	VVDNP-QKF
YADQLKEYL	YADQLKEYL
FMDKPEEFI	FMDKPEEFI
FVDQCKTVL	FVDQCKTVL
YSDGASQQF	YSDGASQQF
LSDDGRYVLL	LSDDGRYVL
VSDKAVSL	VSDKA-VSL
MPDSPAEV	MPDSP-AEV
FLEEHGPAM	FLEEHGPAM
FTDGITNKL	FTDGITNKL
FLDEEVKL	FLDEE-VKL
HGDERPAWL	HGDERPAWL
FLDNERHEV	FLDNERHEV
VSDVPLSLI	VSDVPLSLI
LADVMSEQL	LADVMSEQL
YGDTLVTGF	YGDTLVTGF
IGDSRPPSF	IGDSRPPSF
AVDPQPSVV	AVDPQPSVV
SADQAVAEL	SADQAVAEL
GADNSVVRF	GADNSVVRF
FADREVQLL	FADREVQLL
YNEFPEPIKL	YNEFPEIKL
FIDEQNYIL	FIDEQNYIL
QADSQSPKL	QADSQSPKL
YLDSEQRLM	YLDSEQRLM
SQDAKPTCL	SQDAKPTCL
VGDESQARV	VGDESQARV
MTDRVGKAF	MTDRVGKAF
FIDENGSRL	FIDENGSRL
HADHSSLTL	HADHSSLTL
FTDEEVDEL	FTDEEVDEL
AAEKSITIL	AAEKSITIL
FAEAVKTVF	FAEAVKTVF
FGDTGGFHF	FGDTGGFHF
AAEFVPSFL	AAEFVPSFL
FGDLGSAKL	FGDLGSAKL
LQDLLDVSF	LQDLLDVSF
NADSVQAKV	NADSVQAKV
ITDNDIQSL	ITDNDIQSL
VSENDVIRL	VSENDVIRL
IGDEAATHL	IGDEAATHL
IQDQSVEV	IQDQS-VEV
SMDNNSKF	SMDNN-SKF
TLDHGSKL	TLDHG-SKL
GADSKTVKL	GADSKTVKL
FVDPNGKISL	FVDPNGISL
RTDGHPVM	RTDGH-PVM
TGDVPHTSV	TGDVPHTSV
FPEPNPRVI	FPEPNPRVI
ILDQTKTEL	ILDQTKTEL
YIDKTIRV	YIDKT-IRV
LRDEFLVKI	LRDEFLVKI
NAIEGGTQL	NAIEGGTQL
AADPVSPLL	AADPVSPLL
ISDAITHL	ISDAI-THL
IADIKRTVL	IADIKRTVL
YQDQEQRIL	YQDQEQRIL
LIDIMTRF	LIDIM-TRF
VTDDVKSIV	VTDDVKSIV
TAPTGHTL	TAPTG-HTL
YADVGGKQF	YADVGGKQF
SVDEVARQL	SVDEVARQL
FSDHYTHF	FSDHY-THF
SVPLAATSM	SVPLAATSM
YLDVIRLL	YLDVI-RLL
AADPGLPARL	AADPGLARL
LTDEGAVHV	LTDEGAVHV
FLDTEEAEL	FLDTEEAEL
FSDDGYRTV	FSDDGYRTV
FADNDVSRF	FADNDVSRF
LIDEQILCV	LIDEQILCV
FLDSNGLFL	FLDSNGLFL
VYDAAVRWL	VYDAAVRWL
TADRSMMSM	TADRSMMSM
LADFAELI	LADFA-ELI
IFDLTSHL	IFDLT-SHL
VLDGSGHIL	VLDGSGHIL
FSDSHNAL	FSDSH-NAL
IIEEPSRL	IIEEP-SRL
YLDQVKLQF	YLDQVKLQF
AADDSSVKL	AADDSSVKL
TTDSPTTKV	TTDSPTTKV
KADEEEML	KADEE-EML
VGDGYVVHL	VGDGYVVHL
VTDHATTAL	VTDHATTAL
MTDEKTTKI	MTDEKTTKI
FVDVQPSSL	FVDVQPSSL
ALENDLALL	ALENDLALL
MADEAGLDL	MADEAGLDL
AGDPILTYF	AGDPILTYF
SSDTFSTHM	SSDTFSTHM
FLDRTEEL	FLDRT-EEL
QADFEAHNI	QADFEAHNI
VTDPRVVDLL	VTDPRVVDL
HLDEDQQEL	HLDEDQQEL
VSDEKNINTF	VSDEKNNTF
VSDNIIAKL	VSDNIIAKL
MQDPMEIFV	MQDPMEIFV
MSDDDKIRL	MSDDDKIRL
SSDGTVKI	SSDGT-VKI
NTDHLTTVL	NTDHLTTVL
TVDKHSVEV	TVDKHSVEV
ITDSKVSNL	ITDSKVSNL
FQDDPHAGL	FQDDPHAGL
HSDQSSKTSL	HSDQSSTSL
FVDDQQTF	FVDDQ-QTF
AADQAKQLL	AADQAKQLL
TADHGPPRL	TADHGPPRL
TSDSQPPRL	TSDSQPPRL
LSDRKKVTL	LSDRKKVTL
FLDKDAQRL	FLDKDAQRL
FADHVECL	FADHV-ECL
FADELSHLL	FADELSHLL
YADEYAIGYF	YADEYAGYF
SLDSPVSV	SLDSP-VSV
IADQRNFIF	IADQRNFIF
ASDIPGLHL	ASDIPGLHL
NADPILISL	NADPILISL
AADGKLLKL	AADGKLLKL
FQDNFEFV	FQDNF-EFV
IIDDNHAIV	IIDDNHAIV
LAEAPRSKL	LAEAPRSKL
VLDEIGIEI	VLDEIGIEI
SADKGGFLYL	SADKGGLYL
AADFEIGHF	AADFEIGHF
AGDEGRVLL	AGDEGRVLL
LVDKDSTFL	LVDKDSTFL
TADDPSLSLI	TADDPSLSL
YLDKKHTIF	YLDKKHTIF
FLDEPTNHL	FLDEPTNHL
FTDSAIAM	FTDSA-IAM
TSDPAEVLV	TSDPAEVLV
RVDAVASKV	RVDAVASKV
LVDGAPVRI	LVDGAPVRI
KGDHPETIM	KGDHPETIM
ALDVPNTML	ALDVPNTML
ISDIDKKL	ISDID-KKL
TCDEGHGIF	TCDEGHGIF
IIDGSPRL	IIDGS-PRL
HLDLPSNNNL	HLDLPSNNL
ILDDIGHGV	ILDDIGHGV
RADGISSTF	RADGISSTF
VADKFTEL	VADKF-TEL
RQDRRERML	RQDRRERML
YQDPSVLYI	YQDPSVLYI
NADVALVNF	NADVALVNF
ASDHAPHTL	ASDHAPHTL
NVDDPTGNF	NVDDPTGNF
YADTQEINL	YADTQEINL
VTDGGHLEL	VTDGGHLEL
YSDSTEVKF	YSDSTEVKF
ILDLETQL	ILDLE-TQL
QLDPLVVEL	QLDPLVVEL
FTDKANSGL	FTDKANSGL
YVDFPQHL	YVDFP-QHL
LSEDQMSRL	LSEDQMSRL
AFEPLSQLL	AFEPLSQLL
RADSVGKLV	RADSVGKLV
SADEVQRF	SADEV-QRF
FLDNGPKTI	FLDNGPKTI
RIDGVSLL	RIDGV-SLL
YQDLLNVKM	YQDLLNVKM
YTDVTPRQF	YTDVTPRQF
SGDDISKL	SGDDI-SKL
ISDPRVPEI	ISDPRVPEI
LADVAHIL	LADVA-HIL
YLDGVHTV	YLDGV-HTV
TADDFLVFL	TADDFLVFL
FAEDITTGQVL	FAEDITGQV
YMDNPQNL	YMDNP-QNL
LADNDEVKF	LADNDEVKF
TVDGPSGKL	TVDGPSGKL
VIDRIGDIL	VIDRIGDIL
RTDEIGVAF	RTDEIGVAF
ILDEPTNNL	ILDEPTNNL
FLDLEQHL	FLDLE-QHL
YIDEGRLVL	YIDEGRLVL
KQDSAFSNL	KQDSAFSNL
NQDKPALL	NQDKP-ALL
NIDTGVNSKV	NIDTGVSKV
YTDGEQPITL	YTDGEQITL
GSDDGTVKL	GSDDGTVKL
YSEPQLIFL	YSEPQLIFL
YTDIQEPMF	YTDIQEPMF
SIDKAVQL	SIDKA-VQL
VADHPGIDF	VADHPGIDF
NVDAGKSTL	NVDAGKSTL
ILDAGGHNV	ILDAGGHNV
YVDTESKFL	YVDTESKFL
SAESKTIEF	SAESKTIEF
FIEESRQLL	FIEESRQLL
SADERILVI	SADERILVI
SADMSHVAL	SADMSHVAL
ASDDGTVRI	ASDDGTVRI
RTDLSSEHF	RTDLSSEHF
IADVHLVE	IADVH-LVE
VADEDSVKV	VADEDSVKV
NAEKGTITI	NAEKGTITI
YIDRDSEYL	YIDRDSEYL
VVDPIVSNF	VVDPIVSNF
HTDLPVSV	HTDLP-VSV
VTDSGRTVI	VTDSGRTVI
SADISLERL	SADISLERL
NLDVPTHL	NLDVP-THL
FIESAHTEL	FIESAHTEL
RADDPLRL	RADDP-LRL
VIDEPVRL	VIDEP-VRL
SADATPLHV	SADATPLHV
AADLSLHSF	AADLSLHSF
LTDHTVTFL	LTDHTVTFL
YTEDSPGLKV	YTEDSPLKV
IVDPFQILV	IVDPFQILV
SIPEKNRPL	SIPEKNRPL
FSDSVKSTF	FSDSVKSTF
FIDTTSKF	FIDTT-SKF
ITDLPSEVL	ITDLPSEVL
TADGMVHL	TADGM-VHL
VQDRPESSL	VQDRPESSL
FSDKQMIKL	FSDKQMIKL
FSDDSDLQL	FSDDSDLQL
KADKVTQL	KADKV-TQL
AGDKPATFV	AGDKPATFV
SAEEVIVKL	SAEEVIVKL
VDDTQFVRF	VDDTQFVRF
IAEEKGLVV	IAEEKGLVV
IIDKSGSTV	IIDKSGSTV
IADSHQNF	IADSH-QNF
TADGSALV	TADGS-ALV
VIDRPNGTKV	VIDRPNTKV
AVEAKKTYVRD	AVEAKKTYV
VADMHSTQI	VADMHSTQI
YADVQKDGV	YADVQKDGV
VQDHRPQFL	VQDHRPQFL
TGDDRVYQM	TGDDRVYQM
IIDDSDSNL	IIDDSDSNL
FLDDPQAV	FLDDP-QAV
ISDLDTIWL	ISDLDTIWL
SSDKFVSEL	SSDKFVSEL
KADQSEVKL	KADQSEVKL
SIDSNNQLF	SIDSNNQLF
LCDSPHQNL	LCDSPHQNL
YVDSDMVNEF	YVDSDMNEF
SADNSCRL	SADNS-CRL
VGDIPGVRF	VGDIPGVRF
AADAKPESL	AADAKPESL
YVEKPSTFI	YVEKPSTFI
FADRSLLEM	FADRSLLEM
LADKGAKL	LADKG-AKL
VSDLSEHVF	VSDLSEHVF
IAEGPETKI	IAEGPETKI
KAEEVVSF	KAEEV-VSF
IIDINVRL	IIDIN-VRL
KIDGSANL	KIDGS-ANL
TSDWPTVL	TSDWP-TVL
SADSRIAEL	SADSRIAEL
VVDGIYRL	VVDGI-YRL
KADLGKIVL	KADLGKIVL
FSDPQWNHF	FSDPQWNHF
HVDAGKSTI	HVDAGKSTI
TADDPSLSL	TADDPSLSL
RAEELGQEL	RAEELGQEL
IGDTSGHF	IGDTS-GHF
NIDVVGVSF	NIDVVGVSF
DRVYIHPFHL	RVYIHPFHL
SQDFPGSNL	SQDFPGSNL
VVDKAMEL	VVDKA-MEL
KVDAAELL	KVDAA-ELL
HTDPVDYEF	HTDPVDYEF
KADDPYAHL	KADDPYAHL
LVDHVAEL	LVDHV-AEL
SDESLGIVI	SDESLGIVI
VADKHELL	VADKH-ELL
TADFSGDVTL	TADFSGVTL
KADGFVNL	KADGF-VNL
YSDDKVHAI	YSDDKVHAI
SADESGQIFI	SADESGQIF
ANDDPNGIF	ANDDPNGIF
SADLVAQL	SADLV-AQL
TADPLDYRL	TADPLDYRL
SSDTTVKV	SSDTT-VKV
VSDLISVL	VSDLI-SVL
IIEEHPPLM	IIEEHPPLM
SSDSPTNHFF	SSDSPTNHF
QADFKPATL	QADFKPATL
PIRLLAAAA	PIRLLAAAA
SADDKTVRL	SADDKTVRL
KLDVGNAEV	KLDVGNAEV
FAERSVAKL	FAERSVAKL
TVDSHEPRL	TVDSHEPRL
LIDTPGHVDF	LIDTPGVDF
VGDQVTHI	VGDQV-THI
HVDHGKTTL	HVDHGKTTL
FADAVQELL	FADAVQELL
LAEAGVAVF	LAEAGVAVF
VADIKASQI	VADIKASQI
VGDPHTVTV	VGDPHTVTV
AADKIPGLL	AADKIPGLL
VFDFCEHDL	VFDFCEHDL
KAEHASSLL	KAEHASSLL
YVDDTQFVRF	YVDDTQVRF
IADSPTGQKV	IADSPTQKV
KTDQLVSFL	KTDQLVSFL
IADLVSKEL	IADLVSKEL
STDFPSTSI	STDFPSTSI
YGEDDFSRL	YGEDDFSRL
LAEESIVCL	LAEESIVCL
IIDRAITSL	IIDRAITSL
YFDEPVEL	YFDEP-VEL
VADDQKLMI	VADDQKLMI
KADQVDTQQLM	KADQVDQQL
IGEHTPSAL	IGEHTPSAL
SIDPVTVSI	SIDPVTVSI
YADKEETKL	YADKEETKL
VVEDGILKL	VVEDGILKL
YSDDHVKFF	YSDDHVKFF
HVDNETEL	HVDNE-TEL
YIDAEHLGDF	YIDAEHGDF
TIDTENSTV	TIDTENSTV
FLDRNSQF	FLDRN-SQF
ATDPTIHTV	ATDPTIHTV
VADKDTVLL	VADKDTVLL
NADLFRGTL	NADLFRGTL
SLVNLGGSK	SLVNLGGSK
HADSVTGL	HADSV-TGL
AADGKGVVVV	AADGKGVVV
ISDGSNQKL	ISDGSNQKL
FPDPEKPCKM	FPDPEKCKM
NAEAKITKL	NAEAKITKL
TQDGVSRL	TQDGV-SRL
YADPGAEVKI	YADPG-AEV
RSDNKLYRL	RSDNKLYRL
ISEEHGFLL	ISEEHGFLL
SAEQATALL	SAEQATALL
IIDDHPEV	IIDDH-PEV
TIDDTISKF	TIDDTISKF
LSDPIVNTL	LSDPIVNTL
FLEERSVLL	FLEERSVLL
AADKRLTVL	AADKRLTVL
HPDVASKL	HPDVA-SKL
YADLNQNDF	YADLNQNDF
AVDAVIAEL	AVDAVIAEL
LADCIAEKL	LADCIAEKL
TIDPIPHQL	TIDPIPHQL
TIDWEGTSF	TIDWEGTSF
LADMHSTEI	LADMHSTEI
SVDSQFTHL	SVDSQFTHL
SVDTARTLF	SVDTARTLF
SMDPLPVFL	SMDPLPVFL
FADENNEKL	FADENNEKL
IVDRGSTNL	IVDRGSTNL
KVDEHQTFL	KVDEHQTFL
KADVEEEFL	KADVEEEFL
ASDDGYIKI	ASDDGYIKI
AIDTEERL	AIDTE-ERL
KADIGVAM	KADIG-VAM
LLDVPTAAV	LLDVPTAAV
YVDAVGQFL	YVDAVGQFL
NADVEARI	NADVE-ARI
VLDKPSRL	VLDKP-SRL
IADNSPLFGL	IADNS-PLF
NVDPDNVVL	NVDPDNVVL
SIDTHGETF	SIDTHGETF
FADAVQEL	FADAV-QEL
NADVPEQLI	NADVPEQLI
SADQVTRAL	SADQVTRAL
SADEPMTTFV	SADEPMTTF
ICDVSRQEL	ICDVSRQEL
NVDGLLVQL	NVDGLLVQL
FGDDIPSAL	FGDDIPSAL
VSDSAPHL	VSDSA-PHL
SADGIVRI	SADGI-VRI
EIDIPHVWL	EIDIPHVWL
KTDTGIVTV	KTDTGIVTV
VSEVHPSRL	VSEVHPSRL
KADIPSVAF	KADIPSVAF
HTEEKPFEV	HTEEKPFEV
VSDGVIKVF	VSDGVIKVF
VVDVVRNLV	VVDVVRNLV
YLDKISEL	YLDKI-SEL
LIDLPGHESL	LIDLPGESL
HSDIHSLL	HSDIH-SLL
IIDNNDTQL	IIDNNDTQL
TSDVPGKLI	TSDVPGKLI
IVDANLSVL	IVDANLSVL
TLDAGNIKL	TLDAGNIKL
SLDLPHSEL	SLDLPHSEL
SADEANVL	SADEA-NVL
AMDLVKNHL	AMDLVKNHL
VVDQGSTNL	VVDQGSTNL
FADENNEKLF	FADENNEKL
YVDESRECV	YVDESRECV
FADDNRFDF	FADDNRFDF
YADESFHFF	YADESFHFF
WSDHSQEL	WSDHS-QEL
TVDTPHGIF	TVDTPHGIF
KVDEAVAV	KVDEA-VAV
IGDRGTTL	IGDRG-TTL
YSDDIPHAL	YSDDIPHAL
AQDLGVVNL	AQDLGVVNL
FLDPGGPMM	FLDPGGPMM
RLDWPVRTL	RLDWPVRTL
ASDVAQHL	ASDVA-QHL
ISDSVLVDI	ISDSVLVDI
VIDDHERGL	VIDDHERGL
SADNIAHL	SADNI-AHL
YLDGHLITTV	YLDGHLTTV
KTDDLITRF	KTDDLITRF
YGDQNSRLV	YGDQNSRLV
FIDTAQHM	FIDTA-QHM
LIDKPNLQF	LIDKPNLQF
LSDASLKL	LSDAS-LKL
AADGVIRL	AADGV-IRL
FQEADSPTL	FQEADSPTL
IADGLPVAV	IADGLPVAV
TADGGQISL	TADGGQISL
SSDWQEIHF	SSDWQEIHF
SIDSEGRTVL	SIDSEGTVL
AVDKDTTNV	AVDKDTTNV
AQDPVPSKL	AQDPVPSKL
YLEEAVMHL	YLEEAVMHL
FIDRDPTVF	FIDRDPTVF
KADAIVKM	KADAI-VKM
YSDSFPMEL	YSDSFPMEL
SADEAHGLL	SADEAHGLL
QTDVGITHF	QTDVGITHF
FLDTEEAELL	FLDTEEAEL
AADIDTRSEF	AADIDTSEF
TTDPKLAHM	TTDPKLAHM
AAEPHVVTV	AAEPHVVTV
VADPTPFHI	VADPTPFHI
HVDGVAVTL	HVDGVAVTL
SADVATPKM	SADVATPKM
RGDTAYTKL	RGDTAYTKL
HVDTGNSYL	HVDTGNSYL
EFDKLREF	EFDKL-REF
FVDTDADTRL	FVDTDATRL
TIDESLSEL	TIDESLSEL
AVDGRTVNL	AVDGRTVNL
RQDARSVHL	RQDARSVHL
RTDDKVIRF	RTDDKVIRF
HIDPKTGVAV	HIDPKTVAV
AVDESNDHML	AVDESNHML
NVDTPVSTL	NVDTPVSTL
RADDTFEAL	RADDTFEAL
ASEGKTVEV	ASEGKTVEV
TTDRVMTVSF	TTDRVMVSF
KSDPSIVRL	KSDPSIVRL
ALDVANKIGII	ALDVA-NKI
DIDEVSSLL	DIDEVSSLL
SADASIRI	SADAS-IRI
LSDLTGSLL	LSDLTGSLL
IVDQEGSLL	IVDQEGSLL
NADSGVHL	NADSG-VHL
NADTPVSKF	NADTPVSKF
VADRFSEL	VADRF-SEL
YLDRAEKL	YLDRA-EKL
FTDTDELQL	FTDTDELQL
HADLEIRL	HADLE-IRL
NADKVLEL	NADKV-LEL
TLDKPSVV	TLDKP-SVV
NLDDVTFLF	NLDDVTFLF
SADESGQALL	SADESGQAL
AAEPTPTQV	AAEPTPTQV
RQDPFTVHM	RQDPFTVHM
YSDSTAKL	YSDST-AKL
VADDYQPVRL	VADDYQVRL
LRELAVGSL	LRELAVGSL
TVDGSPHEL	TVDGSPHEL
TLDFPESRV	TLDFPESRV
FADQVEEIL	FADQVEEIL
AQDEHLITF	AQDEHLITF
TADLDITEI	TADLDITEI
YVDEAGTVKL	YVDEAGVKL
LLDSSHSEL	LLDSSHSEL
TAEHPGTRL	TAEHPGTRL
FTDSLISNL	FTDSLISNL
NADGKLSVKF	NADGKLVKF
KVDELTTEI	KVDELTTEI
TIDGPSKV	TIDGP-SKV
VADSTPAHF	VADSTPAHF
KSDLHPTL	KSDLH-PTL
AAEEREASL	AAEEREASL
FVDKENLTM	FVDKENLTM
KADEDPALF	KADEDPALF
TADIPALFL	TADIPALFL
IGDTHASEV	IGDTHASEV
ISDEGIAYL	ISDEGIAYL
SNDDKNAWF	SNDDKNAWF
SSDESPSTSF	SSDESPTSF
FQDKDNLYF	FQDKDNLYF
TIDFPEFL	TIDFP-EFL
IGDPNLEFV	IGDPNLEFV
ASDKPSQETL	ASDKPSETL
KADTRAIQL	KADTRAIQL
LIDLPGTEL	LIDLPGTEL
IIDTPGIL	IIDTP-GIL
IADVAPSAI	IADVAPSAI
YADIHGDLL	YADIHGDLL
QADKASTRL	QADKASTRL
TADAEIKM	TADAE-IKM
LTDDPSPRL	LTDDPSPRL
FGDVVVKI	FGDVV-VKI
YVDDTQFL	YVDDT-QFL
TADGMVHLL	TADGMVHLL
FPESCNHVF	FPESCNHVF
RMDEEFTKI	RMDEEFTKI
AADEPSSL	AADEP-SSL
SIDFGKTVV	SIDFGKTVV
SADRFVTLL	SADRFVTLL
ITDLEERL	ITDLE-ERL
AVDGGKLTVF	AVDGGKLTV
LADERNELL	LADERNELL
RADIGAASL	RADIGAASL
FVDNPVGTGF	FVDNPVTGF
TVDADDVRL	TVDADDVRL
VIDYQTHF	VIDYQ-THF
SAEKAPVSV	SAEKAPVSV
SIDKNITLL	SIDKNITLL
SIDGPIRL	SIDGP-IRL
FAEGITKI	FAEGI-TKI
IADRLNVEF	IADRLNVEF
KSDDTAEHL	KSDDTAEHL
FGDVSSRL	FGDVS-SRL
STDDHSNWF	STDDHSNWF
SLDQPTQTV	SLDQPTQTV
VGDKPVNNF	VGDKPVNNF
IADQITLL	IADQI-TLL
EEQLQQIRAE	--EEQLQQI
YVDEHGTRL	YVDEHGTRL
VFDPHGTL	VFDPH-GTL
KVDQEVKL	KVDQE-VKL
FTDIGKVDF	FTDIGKVDF
VSDLSQVTV	VSDLSQVTV
VADHIQKV	VADHI-QKV
NQDLTVLEM	NQDLTVLEM
KVDLAVVEV	KVDLAVVEV
NLDGTVTEM	NLDGTVTEM
LTDPAIVKV	LTDPAIVKV
AADDHTVKL	AADDHTVKL
ISEDTVYKV	ISEDTVYKV
FADQEVRSL	FADQEVRSL
NADVQERLL	NADVQERLL
IIDEKGPVM	IIDEKGPVM
RVYIHPFHL	RVYIHPFHL
GADDYTVKL	GADDYTVKL
YADQISRL	YADQI-SRL
ISDIQSQL	ISDIQ-SQL
NADTVSSKL	NADTVSSKL
QTDQPETVI	QTDQPETVI
SSDSTHVTF	SSDSTHVTF
AADVAQSTHV	AADVAQTHV
LLDDPNLVV	LLDDPNLVV
KIDDKPVKI	KIDDKPVKI
AAEEPNAAV	AAEEPNAAV
TYDDATKTF	TYDDATKTF
RSDELTRHF	RSDELTRHF
LADKGEIRV	LADKGEIRV
LSDPQVHTV	LSDPQVHTV
AADPSVVNL	AADPSVVNL
LSDDGKASL	LSDDGKASL
SADGHTML	SADGH-TML
VVDELDNQM	VVDELDNQM
GIDRPAEL	GIDRP-AEL
SADKEIMSL	SADKEIMSL
YIDQGIAEL	YIDQGIAEL
YQDTHPERL	YQDTHPERL
KTDGSPVM	KTDGS-PVM
TVDLSSHL	TVDLS-SHL
ISDDRLTVV	ISDDRLTVV
LADDDARLL	LADDDARLL
SADSRIVKM	SADSRIVKM
FSDTLKTYF	FSDTLKTYF
RTDPVPVTI	RTDPVPVTI
VSDDHTCRI	VSDDHTCRI
SSDRPVSL	SSDRP-VSL
VADYEATTF	VADYEATTF
MLDEPTNHL	MLDEPTNHL
AADKLIYVF	AADKLIYVF
FTEPEVVFL	FTEPEVVFL
YVDDTQFVQF	YVDDTQVQF
NQDRPSLL	NQDRP-SLL
LPEDSKAVL	LPEDSKAVL
VQDLAKAV	VQDLA-KAV
FVDPSAALDLL	FVDPS-AAL
ALDTPVMV	ALDTP-VMV
LSEQGDVKL	LSEQGDVKL
LADAVVKI	LADAV-VKI
VIDTPVFEL	VIDTPVFEL
RSDLGFITF	RSDLGFITF
AVDGKEMVTM	AVDGKEVTM
ETDPGMVHL	ETDPGMVHL
TADFPPSKL	TADFPPSKL
AADEDEVSF	AADEDEVSF
IQDAGRTQI	IQDAGRTQI
IAEGGASRF	IAEGGASRF
LADSVGHHL	LADSVGHHL
LADDHDVL	LADDH-DVL
IADPDQPVL	IADPDQPVL
YAEQLHVQL	YAEQLHVQL
PKKAKKPAAT	KAKKP-AAT
SQPLGPRII	SQPLGPRII
SVDPLPAGL	SVDPLPAGL
YAEEFRTYL	YAEEFRTYL
ASDVHGNF	ASDVH-GNF
VSDLADKL	VSDLA-DKL
RADDARQLFV	RADDARQLF
QADQEAKEL	QADQEAKEL
SADPEVMLL	SADPEVMLL
VSDPNLIHV	VSDPNLIHV
FIDVEAEI	FIDVE-AEI
SVDSKPPVI	SVDSKPPVI
SVDKVLEL	SVDKV-LEL
NGDHREVKV	NGDHREVKV
LSDRETLL	LSDRE-TLL
IVDGRGKATI	IVDGRGATI
LAEHPNVTL	LAEHPNVTL
AGDKPATF	AGDKP-ATF
AAEYPAVKF	AAEYPAVKF
VVDHQTEL	VVDHQ-TEL
KADSDGPEF	KADSDGPEF
KAEGSEIRL	KAEGSEIRL
KADGVPVYL	KADGVPVYL
FADYVSTM	FADYV-STM
FAEELHERV	FAEELHERV
VADENQNHHL	VADENQHHL
AADETAVQL	AADETAVQL
VADGLFSKF	VADGLFSKF
VQDFNRTEF	VQDFNRTEF
HTDTTVKF	HTDTT-VKF
SQDEIKQEV	SQDEIKQEV
AQDLISKLL	AQDLISKLL
NADKLTVKF	NADKLTVKF
YADPQKTSL	YADPQKTSL
FGDMTNEEF	FGDMTNEEF
TADKLAIKL	TADKLAIKL
HLPETKFSEL	LPETKFSEL
AVDGSGTKF	AVDGSGTKF
AADVQARL	AADVQ-ARL
VGDKQPTIL	VGDKQPTIL
VADEELVHL	VADEELVHL
IGDEPERGM	IGDEPERGM
KVDTGGFL	KVDTG-GFL
IIDKEVSLM	IIDKEVSLM
LADHAARQL	LADHAARQL
IIDDPSGNSF	IIDDPSNSF
SIDFKPSEI	SIDFKPSEI
FLDQHGHNL	FLDQHGHNL
TADARIVI	TADAR-IVI
YTDEAVVI	YTDEA-VVI
FSEETPVVL	FSEETPVVL
VADEVCRIF	VADEVCRIF
YVDEVMTRL	YVDEVMTRL
GVDVAVRV	GVDVA-VRV
VADKDTVL	VADKD-TVL
MADPEVQQI	MADPEVQQI
SADVKEVLL	SADVKEVLL
VIDVGINRV	VIDVGINRV
SVDVTNTTFL	SVDVTNTTF
VADQIVTKL	VADQIVTKL
AVDTSSEI	AVDTS-SEI
RADSSRASL	RADSSRASL
NVDGHLYEL	NVDGHLYEL
VADLQPQL	VADLQ-PQL
RSDGGHTVL	RSDGGHTVL
AQYEDIAQK	AQYEDIAQK
FLESNPVMI	FLESNPVMI
KMDESTLL	KMDES-TLL
IAESKSPEM	IAESKSPEM
NSDRPGVL	NSDRP-GVL
FLDVVSKL	FLDVV-SKL
LLDEQTSLL	LLDEQTSLL
MADSGESL	MADSG-ESL
LADKSVLV	LADKS-VLV
KNDYNKETF	KNDYNKETF
RTDGKVFQF	RTDGKVFQF
AADRPGVSL	AADRPGVSL
IADEEQKAL	IADEEQKAL
IADKLIEL	IADKL-IEL
FSDPESQTL	FSDPESQTL
FLEDSNVKL	FLEDSNVKL
ISDYAVKI	ISDYA-VKI
SADEGQTVF	SADEGQTVF
VSDKDASL	VSDKD-ASL
ASDEVTRL	ASDEV-TRL
IQDQPVAL	IQDQP-VAL
MTDPEMVEV	MTDPEMVEV
YLENEPLML	YLENEPLML
SADEPMTTFY	SADEPMTTF
VIDVGRLL	VIDVG-RLL
HQDFPSVVL	HQDFPSVVL
FIDGHFVEM	FIDGHFVEM
VAEGGKAEL	VAEGGKAEL
FLDIDVEI	FLDID-VEI
AADAGTFL	AADAG-TFL
VSDVPSLSV	VSDVPSLSV
VADGLITTL	VADGLITTL
KADEDDIKL	KADEDDIKL
FGEIEAIEL	FGEIEAIEL
ISDPFIFNL	ISDPFIFNL
LSDPVHLTV	LSDPVHLTV
FLDSTSPLL	FLDSTSPLL
KSDEVTQEI	KSDEVTQEI
VADKGGMLL	VADKGGMLL
VSDQANHVL	VSDQANHVL
LSEVGDTQV	LSEVGDTQV
VIEDFPAKEL	IEDFPAKEL
YTDHQFTEL	YTDHQFTEL
SVDISHTL	SVDIS-HTL
VSDYEMKL	VSDYE-MKL
VSDHFPVEF	VSDHFPVEF
SADKFQVLL	SADKFQVLL
YVDARDTNM	YVDARDTNM
RVDSPVTV	RVDSP-VTV
FSDQDPRV	FSDQD-PRV
ITDGNPKL	ITDGN-PKL
SSDTGKVKL	SSDTGKVKL
RADLTYAEF	RADLTYAEF
KADAISKSEL	KADAISSEL
STDQVGEFF	STDQVGEFF
AADPLASKL	AADPLASKL
SAEGHVTMF	SAEGHVTMF
SSDATVKI	SSDAT-VKI
SAEVHPISL	SAEVHPISL
AADTLVTKF	AADTLVTKF
KADRAGVL	KADRA-GVL
YLEAGGTKV	YLEAGGTKV
ISDLSEHVF	ISDLSEHVF
VIDGHIYAV	VIDGHIYAV
STDFPQMQL	STDFPQMQL
IADLQSPLF	IADLQSPLF
SADKTVRVY	SADKTVRVY
SSDQPLTV	SSDQP-LTV
VVDELVRF	VVDEL-VRF
SADIARAEV	SADIARAEV
ASDPDEAKL	ASDPDEAKL
VSDLQHVTL	VSDLQHVTL
FGDTPEELF	FGDTPEELF
LADRNVTVL	LADRNVTVL
GTDVGSRL	GTDVG-SRL
ISDNKSATV	ISDNKSATV
FAEERNQNL	FAEERNQNL
VFDDFIFIF	VFDDFIFIF
VVDDSNEHML	VVDDSNEHM
VADFLQNIL	VADFLQNIL
GADGSVRMF	GADGSVRMF
VSDKPTVTF	VSDKPTVTF
AADIENRVL	AADIENRVL
IADRHGGL	IADRH-GGL
TIDHPHTHV	TIDHPHTHV
FTDREIDL	FTDRE-IDL
VVDRFVEF	VVDRF-VEF
HVDAHATL	HVDAH-ATL
VDDTQFVQF	VDDTQFVQF
LADVIIHEI	LADVIIHEI
VADFGLSRL	VADFGLSRL
IIEEHPPMI	IIEEHPPMI
LSDLQTQL	LSDLQ-TQL
AAEKGDVGL	AAEKGDVGL
YVDISENHL	YVDISENHL
NADISQSLL	NADISQSLL
IQDGKGDVTI	IQDGKGVTI
GADKSVKF	GADKS-VKF
TQDEVSQTL	TQDEVSQTL
FCDSSGNSF	FCDSSGNSF
EVDGQKVEV	EVDGQKVEV
AADTPPLETL	AADTPPETL
LTDRDLCEL	LTDRDLCEL
PADEPRTVL	PADEPRTVL
SIDRNPPQL	SIDRNPPQL
VIDSPGIL	VIDSP-GIL
AADDRLRIS	AADDRLRIS
KADSVVVLL	KADSVVVLL
IVDDFGTHL	IVDDFGTHL
AADEKSVSI	AADEKSVSI
VAEGAKNVL	VAEGAKNVL
VADMAAYQL	VADMAAYQL
RADDARQLF	RADDARQLF
AADGTNVVKL	AADGTNVKL
KTDVTVVRF	KTDVTVVRF
ISDTQRISL	ISDTQRISL
ICDDLISKM	ICDDLISKM
KTDLNNLEM	KTDLNNLEM
GLDEVVRL	GLDEV-VRL
KQDSPFSRV	KQDSPFSRV
TIDQSELSSQL	QSELS-SQL
VSDNQVHL	VSDNQ-VHL
SVDIPVEF	SVDIP-VEF
MTDDLPCHF	MTDDLPCHF
YADTVTTV	YADTV-TTV
NADSSVQLL	NADSSVQLL
KADIIVSEL	KADIIVSEL
TADDKKLQF	TADDKKLQF
TAEDPSKSYV	TAEDPSSYV
KADYSSIL	KADYS-SIL
VADPIIYVL	VADPIIYVL
YGDIKDVRL	YGDIKDVRL
RADEKITNI	RADEKITNI
FQDEVGALLL	FQDEVGALL
VTDISHLV	VTDIS-HLV
FIDKNGETEL	FIDKNGTEL
GQDLLHTVF	GQDLLHTVF
NADVQSIAV	NADVQSIAV
NLDDIVHI	NLDDI-VHI
LCDLETKL	LCDLE-TKL
KADQKGVTI	KADQKGVTI
VADMERAQL	VADMERAQL
VLDEVVTVL	VLDEVVTVL
YADASGRNTL	YADASGNTL
LSDDKEAQL	LSDDKEAQL
IIEGPIIKL	IIEGPIIKL
IVDRTTTVV	IVDRTTTVV
SVDGDTRMV	SVDGDTRMV
AQDQPVKM	AQDQP-VKM
SADSKPIDV	SADSKPIDV
IADRPLYL	IADRP-LYL
FTDKHGEV	FTDKH-GEV
ITDEVLKL	ITDEV-LKL
SADDRCKVL	SADDRCKVL
NVDSLITRL	NVDSLITRL
NTDEPPMVF	NTDEPPMVF
YTDFDGTRV	YTDFDGTRV
FVDEGSLYGL	FVDEGSYGL
IQDEIRSVI	IQDEIRSVI
ISDIHTKL	ISDIH-TKL
YGDQDMHEV	YGDQDMHEV
VPDPNVIKL	VPDPNVIKL
SVDVTNTTF	SVDVTNTTF
RVDAQPVKV	RVDAQPVKV
FSDDNARAV	FSDDNARAV
NVDPPPSTL	NVDPPPSTL
VNDQGVVKV	VNDQGVVKV
VSDEHSLF	VSDEH-SLF
YTDVGEKGSQL	VGEKG-SQL
LSDAEIIQL	LSDAEIIQL
VIDDFVQF	VIDDF-VQF
FAEKLSVKL	FAEKLSVKL
KIDLENRQV	KIDLENRQV
IADRPPPVI	IADRPPPVI
FAEAGRSTL	FAEAGRSTL
LSDNKLTEL	LSDNKLTEL
ITSMLNPLI	ITSMLNPLI
LSDGQVKV	LSDGQ-VKV
FSDEIEVDF	FSDEIEVDF
RQDSAVNL	RQDSA-VNL
YSEDGLLKL	YSEDGLLKL
YTDLEVRV	YTDLE-VRV
PQDYLLLI	PQDYL-LLI
SIDKAVTKL	SIDKAVTKL
VADRLGLEL	VADRLGLEL
GADLPSNHV	GADLPSNHV
FSDRAEEF	FSDRA-EEF
KSDDLVVDV	KSDDLVVDV
MTDDKTTKI	MTDDKTTKI
LADGLKVVL	LADGLKVVL
VTDRVIGGLL	VTDRVIGLL
LADRVIVF	LADRV-IVF
ISDLVGRVV	ISDLVGRVV
FADGKVYAL	FADGKVYAL
KAAFKELQ	KAAFK-ELQ
KADEANDNLF	KADEANDNL
RADDYEQV	RADDY-EQV
NQDNPSYIGL	NQDNP-SYI
VLDDKLVFV	VLDDKLVFV
VVDVSSHL	VVDVS-SHL
FADATVEL	FADAT-VEL
VTDPRVVDL	VTDPRVVDL
VQDPKVTYL	VQDPKVTYL
AADKAIEKM	AADKAIEKM
SADSKVLLF	SADSKVLLF
FIDKNNDLLF	FIDKNNDLL
IVDPVDSTL	IVDPVDSTL
FVDGVSTV	FVDGV-STV
MVDSSTSRL	MVDSSTSRL
VADKTGSITI	VADKTGITI
VLDFITHL	VLDFI-THL
FSETGAGKHV	FSETGAKHV
ESGPSIVHR	ESGPSIVHR
RQDVATNLL	RQDVATNLL
VVDLGKTSSTV	VVDLGKTSS
VTDADRSIL	VTDADRSIL
AADPGLHETL	AADPGLETL
NSDPNINQF	NSDPNINQF
FVDIVKVLL	FVDIVKVLL
ISDKDQQL	ISDKD-QQL
AADGVLSEV	AADGVLSEV
YADHPFIFL	YADHPFIFL
NIDDVVRF	NIDDV-VRF
YADEVHTQVL	YADEVHTQV
YADELAKMEL	YADELAMEL
LADDSVRSL	LADDSVRSL
SADIFQQV	SADIF-QQV
YKDDPVDL	YKDDP-VDL
MPDSAAALL	MPDSAAALL
VADKTGSINI	VADKTGINI
YIDKDLEYV	YIDKDLEYV
IVDPQNQTM	IVDPQNQTM
YAEQLVVEL	YAEQLVVEL
YGDPYYSYL	YGDPYYSYL
SGDDGCVRL	SGDDGCVRL
STDLDSKL	STDLD-SKL
VADEQNRAL	VADEQNRAL
IGDKPSSI	IGDKP-SSI
FQDGTKATF	FQDGTKATF
YVDIHTGL	YVDIH-TGL
VAESAVSKL	VAESAVSKL
VIDPVPAAV	VIDPVPAAV
TIDGVVFV	TIDGV-VFV
IIDTPGHESF	IIDTPGESF
SADFETVRM	SADFETVRM
IADRSQVL	IADRS-QVL
VLSAADKGNVK	AADKG-NVK
TSDEHREF	TSDEH-REF
SQDPGTHVV	SQDPGTHVV
IAEETSSRL	IAEETSSRL
GQDPGAPQL	GQDPGAPQL
RTDGKVFQFL	RTDGKVQFL
KTDESSPVL	KTDESSPVL
FLDKAGSV	FLDKA-GSV
TIDQPVQI	TIDQP-VQI
YTDNLVRV	YTDNL-VRV
LLDYPNNVL	LLDYPNNVL
NADQPLRV	NADQP-LRV
FCDEKQTTL	FCDEKQTTL
SLDQPGGTL	SLDQPGGTL
AADGTVEL	AADGT-VEL
ASDKDITV	ASDKD-ITV
IGDEGVSQL	IGDEGVSQL
NAEQHVTQL	NAEQHVTQL
YADQHSVQVF	YADQHSVQV
FADFDGDGHM	FADFDGGHM
LLDEPTNHL	LLDEPTNHL
VADANGKNL	VADANGKNL
LPDSGHLHPL	LPDSGHHPL
IADTGANVVV	IADTGANVV
VADSKTLL	VADSK-TLL
LIDSPGHVDF	LIDSPGVDF
SVDANTKL	SVDAN-TKL
FADYNLLDL	FADYNLLDL
KSDLDTLL	KSDLD-TLL
GADIHSKEF	GADIHSKEF
TADENPDKSTL	TADENPSTL
ISDKITSEL	ISDKITSEL
AVDEPQML	AVDEP-QML
KSDEMNVKV	KSDEMNVKV
VSDSGAHVL	VSDSGAHVL
MADRGEARL	MADRGEARL
NSDTHSSTF	NSDTHSSTF
VADNLDQATRV	NLDQA-TRV
VQDEMLARF	VQDEMLARF
HQDPQSIFV	HQDPQSIFV
HLDPGPIYM	HLDPGPIYM
LVDQRELYL	LVDQRELYL
KADTISKSEL	KADTISSEL
IIDKASRNL	IIDKASRNL
SIDSAGIQL	SIDSAGIQL
AVDGIIKV	AVDGI-IKV
AADIPINI	AADIP-INI
SADGPLKL	SADGP-LKL
VADELVAEF	VADELVAEF
FAEDPPTSL	FAEDPPTSL
SVDVATRV	SVDVA-TRV
ISDDGINRM	ISDDGINRM
FAETHRTVL	FAETHRTVL
NLDETTKL	NLDET-TKL
IIDDGDSNL	IIDDGDSNL
KSDELPNQM	KSDELPNQM
FSDENVRAI	FSDENVRAI
VADPVVTF	VADPV-VTF
VIDHSQYL	VIDHS-QYL
ISDRLVTL	ISDRL-VTL
AIDSPVSFL	AIDSPVSFL
IADFPGLHL	IADFPGLHL
KNDLDSKL	KNDLD-SKL
NADHTTLLL	NADHTTLLL
VTEIISEI	VTEII-SEI
NAPLVHATL	NAPLVHATL
SAEEEQARL	SAEEEQARL
TADIPLKV	TADIP-LKV
SGDGGRAEL	SGDGGRAEL
KADEIRTLV	KADEIRTLV
RSDEAQRVF	RSDEAQRVF
VADFSATYL	VADFSATYL
NADIAVVEM	NADIAVVEM
FVDLEPTVI	FVDLEPTVI
FIEEKENRL	FIEEKENRL
ESDSAKPASL	ESDSAKASL
GADEPQRL	GADEP-QRL
FADVEGKNL	FADVEGKNL
YAEVGRVLL	YAEVGRVLL
SADGLQGETQL	SADGLQTQL
VSDFGQSHL	VSDFGQSHL
TVEEQRPPEL	TVEEQRPEL
HPDVLPFAL	HPDVLPFAL
VAEGPGAEL	VAEGPGAEL
VADDFCKV	VADDF-CKV
VSDEEMMEL	VSDEEMMEL
VADFADKL	VADFA-DKL
FQDGATKL	FQDGA-TKL
YAEKQSEL	YAEKQ-SEL
VVDESENFF	VVDESENFF
IVDVRPTL	IVDVR-PTL
HIDGDHLTLL	HIDGDHLTL
HPDAPMSQV	HPDAPMSQV
YADSNFHDF	YADSNFHDF
FLDENVHFF	FLDENVHFF
KVDEAVAVL	KVDEAVAVL
KADEDVTKL	KADEDVTKL
KQDIMYNLF	KQDIMYNLF
VAEFHTEL	VAEFH-TEL
KVDENGKI	KVDEN-GKI
FADKEGLEM	FADKEGLEM
LTDMSRPVEL	LTDMSRVEL
FQDVTVEF	FQDVT-VEF
AVDLLTQL	AVDLL-TQL
NADEIAEYI	NADEIAEYI
IADPNIAKL	IADPNIAKL
FLEKASKL	FLEKA-SKL
EGDHPNNSF	EGDHPNNSF
LLDEGAKL	LLDEG-AKL
KGDKSVRVM	KGDKSVRVM
YVDDGLISL	YVDDGLISL
SSDPMLSEF	SSDPMLSEF
VADAFLSKF	VADAFLSKF
GVDLDQLL	GVDLD-QLL
ISDPYNVNL	ISDPYNVNL
FVDEHEPSM	FVDEHEPSM
CTDDNIYMF	CTDDNIYMF
YADGPQLYI	YADGPQLYI
YFAERVTSL	YFAERVTSL
YVDRGKQSL	YVDRGKQSL
HAMQFPAEL	HAMQFPAEL
FQDDPDIIAF	FQDDPDIAF
LMELEKPVL	LMELEKPVL
VADALEPVQF	VADALEVQF
FVDEGKATV	FVDEGKATV
VLDNPTPEM	VLDNPTPEM
IIDKSGSTI	IIDKSGSTI
SLDEPSVKTM	SLDEPSVKT
IADGGKKL	IADGG-KKL
IADNRPSVEF	IADNRPVEF
SQDSKLVYI	SQDSKLVYI
SLDKDIVAL	SLDKDIVAL
ASDPYQVHV	ASDPYQVHV
NADAIVVKL	NADAIVVKL
KMDDDVFL	KMDDD-VFL
NADGPNPWML	NADGPNPWM
KFDDGAVF	KFDDG-AVF
HIDSGKTAL	HIDSGKTAL
VGDGQRIYL	VGDGQRIYL
VLDEPGQDL	VLDEPGQDL
VTDDEGNRL	VTDDEGNRL
KADSINKPF	KADSINKPF
ALDSGVSTM	ALDSGVSTM
YSDVEHTSV	YSDVEHTSV
AGDGGRVAL	AGDGGRVAL
KSDYIIRTL	KSDYIIRTL
VADYMRYLM	VADYMRYLM
HQDLSQKI	HQDLS-QKI
YAEYMPIKL	YAEYMPIKL
ALDEPTTNL	ALDEPTTNL
VSDELIKL	VSDEL-IKL
FLDSTGSRL	FLDSTGSRL
FADDMQEF	FADDM-QEF
VSDIQELYI	VSDIQELYI
FIDKQTNL	FIDKQ-TNL
FADKETLIQF	FADKE-TLI
ISDGLKYSL	ISDGLKYSL
YSDREIEVM	YSDREIEVM
ASDIAMTEL	ASDIAMTEL
HADASSKVL	HADASSKVL
SVDWPESFV	SVDWPESFV
VSDDTVMHL	VSDDTVMHL
VADLREAIL	VADLREAIL
VADLTGELM	VADLTGELM
AADFTAKV	AADFT-AKV
IADVSHFI	IADVS-HFI
KLDHVVTII	KLDHVVTII
KADLESESF	KADLESESF
KADVQSII	KADVQ-SII
FADQAEILL	FADQAEILL
ISDNKLTEL	ISDNKLTEL
SQDVHVVL	SQDVH-VVL
QAEEGSARL	QAEEGSARL
LFDSYSESL	LFDSYSESL
ALDGDAVVL	ALDGDAVVL
VIDFTGHAL	VIDFTGHAL
SADHPVIKV	SADHPVIKV
VIDDKMIVF	VIDDKMIVF
APEEHPVLL	APEEHPVLL
RKDDPVTNL	RKDDPVTNL
VADVFSHRF	VADVFSHRF
LADHAGEL	LADHA-GEL
FLETNVPLL	FLETNVPLL
NADARNTTM	NADARNTTM
HADHIGQGF	HADHIGQGF
SADDGIRNL	SADDGIRNL
YLDRTEQL	YLDRT-EQL
ASDKETYEL	ASDKETYEL
YVDGRVLVV	YVDGRVLVV
FADSDSHSSF	FADSDSSSF
IADGGFTEL	IADGGFTEL
NYDPNQRPF	NYDPNQRPF
WADQEQWF	WADQE-QWF
YFENLLSHF	YFENLLSHF
VADKDHPKF	VADKDHPKF
FLEKREPKL	FLEKREPKL
IIDRTNTTL	IIDRTNTTL
FVDIVSQDNF	FVDIVSDNF
VSDRAEYL	VSDRA-EYL
FLDAGHKL	FLDAG-HKL
GIDNGEGTRL	GIDNGETRL
VQDAVDALM	VQDAVDALM
IIEADEVLL	IIEADEVLL
RCDELTRKM	RCDELTRKM
HLDEARTLL	HLDEARTLL
SADHPPKL	SADHP-PKL
SAEEAAHRL	SAEEAAHRL
AAPSAAREL	AAPSAAREL
FADDNRFDFL	FADDNRFDF
QAESKVFYL	QAESKVFYL
SSDTSGHF	SSDTS-GHF
YVDSEGNRI	YVDSEGNRI
RGDDGGASF	RGDDGGASF
TADAFIVRF	TADAFIVRF
LADLQNDEV	LADLQNDEV
FADQENQVA	FADQENQVA
QADSGRVLL	QADSGRVLL
RVDNLAVVM	RVDNLAVVM
VLDVVERSL	VLDVVERSL
VADPDNPLV	VADPDNPLV
LVDQPGLSL	LVDQPGLSL
KIDFDSVSSIM	KIDFDSSSI
VSENPGQTHF	VSENPGTHF
TADSQPPVF	TADSQPPVF
DPFNPFELTNH	FNPFELTNH
TADAPSKDIFV	TADAPSKDI
YIDDTLTMV	YIDDTLTMV
SIDPVPTSI	SIDPVPTSI
SADPNVVDL	SADPNVVDL
SADELVTRI	SADELVTRI
FPDPNVKYV	FPDPNVKYV
IVDDGKSQKL	IVDDGKQKL
VQDLIEGHL	VQDLIEGHL
LTDDGRVFL	LTDDGRVFL
IVDGSRFTEF	IVDGSRTEF
MVDDRLVTM	MVDDRLVTM
ISDLGQHTL	ISDLGQHTL
DFDPALLEF	DFDPALLEF
EADRNPPVL	EADRNPPVL
NSDPYSVAL	NSDPYSVAL
RSDGEAELL	RSDGEAELL
IADKVVFL	IADKV-VFL
VVDQEQHL	VVDQE-QHL
FGEVESIEL	FGEVESIEL
SSDKSVKV	SSDKS-VKV
FVDGYKQLGF	FVDGY-KQL
VAEEPAGTSL	VAEEPATSL
TADTKIQRM	TADTKIQRM
RQDYGAVFL	RQDYGAVFL
FSDAKFVEF	FSDAKFVEF
FSDEIRHNL	FSDEIRHNL
FAERTVAKL	FAERTVAKL
QADGRVVLV	QADGRVVLV
KADAASSLTV	KADAA-SSL
LSDELLHL	LSDEL-LHL
LMDGSVKL	LMDGS-VKL
TITGKTFSSR	ITGKTFSSR
LSDPQQVTL	LSDPQQVTL
VSDLGPVVL	VSDLGPVVL
HADPEPSVI	HADPEPSVI
VADKIQLI	VADKI-QLI
IVDRPVTL	IVDRP-VTL
IVDRPVTLV	IVDRPVTLV
NNDNNMFFL	NNDNNMFFL
AGFAGDDAPR	AGDDA----
VIDYAVKI	VIDYA-VKI
FIDGGGSVLV	FIDGGGSVL
FSDTEAAM	FSDTE-AAM
SGDTGVIHV	SGDTGVIHV
IIEPSLRQL	IIEPSLRQL
IIDDVMKEL	IIDDVMKEL
IVDQVMVTL	IVDQVMVTL
KTDKQEAYV	KTDKQEAYV
IADATKIFV	IADATKIFV
FQDPVPLTV	FQDPVPLTV
ASDDKTVKV	ASDDKTVKV
FGDNNRMTYF	FGDNNRTYF
LEDESLLPPL	LEDESLPPL
VGDPSTTNL	VGDPSTTNL
NADQQNFTV	NADQQNFTV
YADGESFL	YADGE-SFL
NIDFMPTIL	NIDFMPTIL
IADKIQQI	IADKI-QQI
FAEMYVAKF	FAEMYVAKF
VSDDPQVL	VSDDP-QVL
NKELDPIQKL	ELDPI-QKL
KTDGSVVKL	KTDGSVVKL
IVDSARSIL	IVDSARSIL
IGDVATQYF	IGDVATQYF
TSDLPSSKV	TSDLPSSKV
FAEHRPPKI	FAEHRPPKI
FIDRDGSTF	FIDRDGSTF
SAEHSHPAL	SAEHSHPAL
TADDELSF	TADDE-LSF
FLDDVVHSL	FLDDVVHSL
LADFSPLTL	LADFSPLTL
VADGYPVRL	VADGYPVRL
LAEEVVALL	LAEEVVALL
MAPERVASL	MAPERVASL
GVDHPSHTL	GVDHPSHTL
HADVGKEL	HADVG-KEL
EADIQNSKF	EADIQNSKF
GADKNVVVF	GADKNVVVF
FADRPGDMV	FADRPGDMV
AVDPLLAL	AVDPL-LAL
ALDSASRL	ALDSA-SRL
LTDAETSKL	LTDAETSKL
ISDKDLEL	ISDKD-LEL
IADDRQSL	IADDR-QSL
TADKYAAL	TADKY-AAL
IADLGSTSI	IADLGSTSI
KSDAPDTLL	KSDAPDTLL
VGDGTTSVTLL	VGDGTTVTL
KADNVGSAL	KADNVGSAL
RADTGHAFL	RADTGHAFL
YADGEAKVEQL	YADGE-AKV
LIDEPSAYL	LIDEPSAYL
FAEDDRIEL	FAEDDRIEL
NADTIQHF	NADTI-QHF
FAENNFTEL	FAENNFTEL
AQDEEIARL	AQDEEIARL
YVDTESKF	YVDTE-SKF
TADRWRVSL	TADRWRVSL
KIDEAILI	KIDEA-ILI
AGDGDVKL	AGDGD-VKL
FVDCPGHDI	FVDCPGHDI
VADRLLVEL	VADRLLVEL
NIPEKTTAL	NIPEKTTAL
MSDLPVKV	MSDLP-VKV
NADDFPNLF	NADDFPNLF
YLDQRELLL	YLDQRELLL
FIDEAYVEV	FIDEAYVEV
YADDNSLL	YADDN-SLL
RQDLTTLDV	RQDLTTLDV
VTDHNLHEL	VTDHNLHEL
FSDISEKL	FSDIS-EKL
AADTPAIM	AADTP-AIM
TADISDVWL	TADISDVWL
ITDSPVVV	ITDSP-VVV
KSDQALHSF	KSDQALHSF
LSDKDPPKL	LSDKDPPKL
LLDRALTSL	LLDRALTSL
NADSSNTAL	NADSSNTAL
VVDQPLKL	VVDQP-LKL
ITDLISEL	ITDLI-SEL
VTDFISHL	VTDFI-SHL
YTDIVGLLL	YTDIVGLLL
SADDVIKM	SADDV-IKM
TIDRQQKL	TIDRQ-QKL
VSDDVSMTFI	VSDDVSMTF
ISEEVSRNL	ISEEVSRNL
YQDPDATSL	YQDPDATSL
AAPAYSRAL	AAPAYSRAL
TSDPALNHV	TSDPALNHV
FSDTGNFGF	FSDTGNFGF
MPDSAAAL	MPDSA-AAL
KLDDYQERM	KLDDYQERM
YLDELMKL	YLDEL-MKL
ISDDNAKL	ISDDN-AKL
YADKIESVHF	YADKIEVHF
ISDIDDAVRKL	DIDDAVRKL
LKDNATIEL	LKDNATIEL
RMDGEGQLTL	RMDGEGLTL
RADEDARMI	RADEDARMI
RADKPWTRL	RADKPWTRL
HLDQEQQL	HLDQE-QQL
YIELPAYL	YIELP-AYL
SADFTVKV	SADFT-VKV
YSDATTSKI	YSDATTSKI
SVDKVGTFF	SVDKVGTFF
FGDSEPEL	FGDSE-PEL
GSDSPRSSL	GSDSPRSSL
KLDEHIAYL	KLDEHIAYL
TTDDKTTKI	TTDDKTTKI
FQDSGLSRF	FQDSGLSRF
TSDMGSYAL	TSDMGSYAL
FTDGGPRTL	FTDGGPRTL
IIDDPSGNSFV	IIDDPSNSF
FVDGSAIQVL	FVDGSAIQV
IADRGAEYV	IADRGAEYV
IYDEETAEL	IYDEETAEL
IAEDPKVFL	IAEDPKVFL
IMDTPGHVNF	IMDTPGVNF
YTEKEGPLL	YTEKEGPLL
KADEVLEIL	KADEVLEIL
YSDPRFLNL	YSDPRFLNL
VTDDGMAV	VTDDG-MAV
FAEEVGAAL	FAEEVGAAL
FSDLTMHEL	FSDLTMHEL
NSDLFYREV	NSDLFYREV
VLDHFSEL	VLDHF-SEL
GADLPNLLF	GADLPNLLF
TSDEQNHLV	TSDEQNHLV
IIDKSGSTVF	IIDKSGSTV
KADGQGSTTML	KADGQGTTM
SADKYVKI	SADKY-VKI
IAENNNSIM	IAENNNSIM
LADKDLYV	LADKD-LYV
IADVSTGL	IADVS-TGL
RAEEGFTQV	RAEEGFTQV
SVDKPGIVV	SVDKPGIVV
RVDEEPTTL	RVDEEPTTL
YLDQGTQIFL	YLDQGTQIF
FADDGVKYL	FADDGVKYL
VADPPIARL	VADPPIARL
ASDGTVRL	ASDGT-VRL
LVDEVMLTL	LVDEVMLTL
NADFAAMEFL	NADFAAMEF
AADGPQKL	AADGP-QKL
AQDPEIASL	AQDPEIASL
YADRHAEL	YADRH-AEL
IQDFQSVTL	IQDFQSVTL
LIDKPTNL	LIDKP-TNL
IADSGLLS	IADSG-LLS
RQDEGARLL	RQDEGARLL
KIDEAESL	KIDEA-ESL
QIDVNNEF	QIDVN-NEF
FIDKQLEL	FIDKQ-LEL
FQDKASEL	FQDKA-SEL
IQDITQKL	IQDIT-QKL
FQEEVVAVL	FQEEVVAVL
FADMECKL	FADME-CKL
IAEQYHTVL	IAEQYHTVL
VVDIESRL	VVDIE-SRL
YPETLGRLL	YPETLGRLL
IAEQTVVTL	IAEQTVVTL
VIDTQQKV	VIDTQ-QKV
AADDTEISF	AADDTEISF
TADTLFQEV	TADTLFQEV
TADGISIRF	TADGISIRF
SADPRHILL	SADPRHILL
ILDPHVVLL	ILDPHVVLL
HSDDYIKF	HSDDY-IKF
AAEEPLSLL	AAEEPLSLL
VVDPNDPQM	VVDPNDPQM
VADRTGHSL	VADRTGHSL
LADQMISRI	LADQMISRI
KSDHPGISI	KSDHPGISI
FTDQHNICL	FTDQHNICL
AVDLGGTNL	AVDLGGTNL
LAEEGFYKF	LAEEGFYKF
ISDLAQHYL	ISDLAQHYL
SVDWPESSL	SVDWPESSL
VADSHSSHF	VADSHSSHF
LSDLRVYL	LSDLR-VYL
YLDGILQIL	YLDGILQIL
GQDSSEIHF	GQDSSEIHF
KAEGDVAAL	KAEGDVAAL
RVDDPQDVF	RVDDPQDVF
LVDGQTHL	LVDGQ-THL
KVDVEQKM	KVDVE-QKM
SIDFPLTKV	SIDFPLTKV
LTEAIQALF	LTEAIQALF
IADSNPMVV	IADSNPMVV
ESDPKVYSL	ESDPKVYSL
FTDPSNSERF	FTDPSNERF
LFHPSNVEM	LFHPSNVEM
ISDLVKVTL	ISDLVKVTL
ILDSTGSTLF	ILDSTGSTL
MIDETRNSL	MIDETRNSL
TQDEISRL	TQDEI-SRL
NADHTTLL	NADHT-TLL
KVDDARALL	KVDDARALL
LADFGLARI	LADFGLARI
IYDPQEGAVVV	IYDPQEAVV
NADGPAPLEL	NADGPALEL
RADKIASKL	RADKIASKL
AADGGLRASV	AADGGLASV
VIDICMKL	VIDIC-MKL
ILDDVSLTHL	ILDDVSTHL
SNDPDVIKL	SNDPDVIKL
ASEDATIKV	ASEDATIKV
LSDLNRVDF	LSDLNRVDF
RADGRIVKM	RADGRIVKM
TIDTDTLL	TIDTD-TLL
TQDGNIYQL	TQDGNIYQL
VSDDTVEM	VSDDT-VEM
TAELDPHIL	TAELDPHIL
FVEEEEHFL	FVEEEEHFL
EADEVAAQL	EADEVAAQL
FTDTSIILF	FTDTSIILF
SIDKTGENF	SIDKTGENF
FSDRSSLTF	FSDRSSLTF
IADDAHIGNLL	IADDAHGNL
AADDIHRSL	AADDIHRSL
LADLENLAF	LADLENLAF
NGDFLPTRL	NGDFLPTRL
FMDQHPEM	FMDQH-PEM
QSDEAKNYM	QSDEAKNYM
LADDRMAL	LADDR-MAL
LAEDTRTEL	LAEDTRTEL
LPDQVLRVF	LPDQVLRVF
QAERPDTML	QAERPDTML
LVDIPVEF	LVDIP-VEF
AADIPRILV	AADIPRILV
FADRERKV	FADRE-RKV
FNDVTAIIF	FNDVTAIIF
HTDLPVSVF	HTDLPVSVF
FVDDGTETHF	FVDDGTTHF
QADHFNTRL	QADHFNTRL
MSDDPRYNQM	MSDDPRNQM
HVDAGKSTL	HVDAGKSTL
LTDETSRLF	LTDETSRLF
VADEPERI	VADEP-ERI
RGDGKVIKL	RGDGKVIKL
NADVQERL	NADVQ-ERL
VVDKPSSI	VVDKP-SSI
IIEKQPPQV	IIEKQPPQV
SPEPGAVVL	SPEPGAVVL
IADTVPKYL	IADTVPKYL
IIDPVALEI	IIDPVALEI
FLEKESAIV	FLEKESAIV
IADLSNIINKL	IADLS-NII
VSDPNLIHVL	VSDPNLIHV
QCDKPNKEF	QCDKPNKEF
YVDTAVRHV	YVDTAVRHV
FLDLARNL	FLDLA-RNL
IVDEGHRM	IVDEG-HRM
VQDAVSQL	VQDAV-SQL
SADSLEHVL	SADSLEHVL
FQDQNDVEL	FQDQNDVEL
FAEENGLLF	FAEENGLLF
VSDGVIKV	VSDGV-IKV
YAPKGSSL	YAPKG-SSL
KADVVPVTL	KADVVPVTL
LTDHTNPNF	LTDHTNPNF
FLDEKTHEL	FLDEKTHEL
AGDHPVEL	AGDHP-VEL
LTEEGVIKV	LTEEGVIKV
GQDGSVVQF	GQDGSVVQF
SADFPALVV	SADFPALVV
LADGADEHL	LADGADEHL
LSDLALHFL	LSDLALHFL
SVPEAQSAL	SVPEAQSAL
VADEQQRL	VADEQ-QRL
MAEEDVYWL	MAEEDVYWL
YVDEGEVYF	YVDEGEVYF
KAEDLGSKL	KAEDLGSKL
YAESVGRKV	YAESVGRKV
FADQPIQI	FADQP-IQI
VSDIPRLI	VSDIP-RLI
TADEFYSTM	TADEFYSTM
AVDGNTVEL	AVDGNTVEL
TSDPNAVVM	TSDPNAVVM
VSEDNVAKV	VSEDNVAKV
YVDVVKVLL	YVDVVKVLL
FTDKDANV	FTDKD-ANV
FSEPKFAQV	FSEPKFAQV
VIDRGPSSYL	VIDRGPSYL
LGDDPTSSF	LGDDPTSSF
SVDQENNMM	SVDQENNMM
VADNTNLYVF	VADNTNLYV
GAEGRPWAL	GAEGRPWAL
NSDDSSRNLF	NSDDSSRNL
AADAGLLQF	AADAGLLQF
SFDPARGL	SFDPA-RGL
LSDHIVLL	LSDHI-VLL
YLEKVSEV	YLEKV-SEV
FIEEHATKL	FIEEHATKL
ITDPDVVHI	ITDPDVVHI
TADEIVKL	TADEI-VKL
FQDDHVSL	FQDDH-VSL
NIDEGPLAF	NIDEGPLAF
FTDPAHTEEF	FTDPAHEEF
VLDEQLNEF	VLDEQLNEF
SADFKTEL	SADFK-TEL
SSPQPGSAL	SSPQPGSAL
KADTVSKTEL	KADTVSTEL
IIDTANTTEM	IIDTANTEM
RQDEIKNKL	RQDEIKNKL
AGDTTNFHF	AGDTTNFHF
RIDGKTYVI	RIDGKTYVI
AADGKGVVV	AADGKGVVV
FVEDASGKGL	FVEDASKGL
NAESGRGQVM	NAESGRGQV
YADVQAVL	YADVQ-AVL
SSDDGTVKL	SSDDGTVKL
LADPSTTGQM	LADPSTGQM
RTDDFITRL	RTDDFITRL
LVDGEEHVGF	LVDGE-EHV
LVDGPCTQV	LVDGPCTQV
RKDDPTLL	RKDDP-TLL
IGDGYVIHL	IGDGYVIHL
NADGKIISL	NADGKIISL
VADLIESML	VADLIESML
LIDQKVYEL	LIDQKVYEL
YGDIIKETL	YGDIIKETL
LGDAHIYL	LGDAH-IYL
SSDEAVIL	SSDEA-VIL
VADNRIQEL	VADNRIQEL
IVDEVNGLI	IVDEVNGLI
LAEKSTVHM	LAEKSTVHM
GADEAPPRL	GADEAPPRL
KGDAQIVRL	KGDAQIVRL
VGDDKAMKV	VGDDKAMKV
FPDDPPTFIF	FPDDPPTFI
FQDEDEAQL	FQDEDEAQL
FADGHVLELL	FADGHVLEL
YNDQGQVRL	YNDQGQVRL
FSDNENNFVF	FSDNENNFV
LTDKSCQSF	LTDKSCQSF
KADPQGPEL	KADPQGPEL
RIDEFIVKL	RIDEFIVKL
ISDAPVTGM	ISDAPVTGM
LSELDTKI	LSELD-TKI
RAEWDQVTV	RAEWDQVTV
QSDEDVIRL	QSDEDVIRL
VADLAHVL	VADLA-HVL
AADDPLVHESL	AADDPLVHE
YTDVTPRQFF	YTDVTPRQF
VSDFGGRSL	VSDFGGRSL
SADKMQQL	SADKM-QQL
VLDDKDYFL	VLDDKDYFL
HVDKAIAL	HVDKA-IAL
HADDTQPARL	HADDTQARL
VADGMNEMYL	VADGM-NEM
FTDIDIDTL	FTDIDIDTL
LVDEAKNYL	LVDEAKNYL
FQDKDQVF	FQDKD-QVF
NMDVESRTM	NMDVESRTM
AADIAVQL	AADIA-VQL
NVDPDSVVL	NVDPDSVVL
AADEPVTVL	AADEPVTVL
LADEVITVF	LADEVITVF
INDREQKL	INDRE-QKL
FVDWKELKL	FVDWKELKL
VQDNESRL	VQDNE-SRL
AQDFKTDL	AQDFK-TDL
FSEELIVEL	FSEELIVEL
AGDIRPAEV	AGDIRPAEV
IADHYMQV	IADHY-MQV
LADIAQSQL	LADIAQSQL
HVDTLVTKF	HVDTLVTKF
VADLQLIDF	VADLQLIDF
ATDTKGHSL	ATDTKGHSL
ITDSTGTHL	ITDSTGTHL
VSDEARAEV	VSDEARAEV
SVDTHQRSF	SVDTHQRSF
TADDFIHQHF	TADDFIQHF
VSDHEATL	VSDHE-ATL
SGDGVTHTV	SGDGVTHTV
YADYEESRM	YADYEESRM
VADLAFAHL	VADLAFAHL
YLEDFGGGRF	LEDFGGGRF
FNERNPPEL	FNERNPPEL
SADARSFEM	SADARSFEM
HLDKASVM	HLDKA-SVM
NAESSIIHF	NAESSIIHF
FSDGITSV	FSDGI-TSV
SADDWSEHI	SADDWSEHI
VSESPGKTV	VSESPGKTV
VAEAGGGQL	VAEAGGGQL
GADDRLVKI	GADDRLVKI
VADTPENL	VADTP-ENL
LADDLGHVV	LADDLGHVV
ITDPSVIVM	ITDPSVIVM
ILDEGHAI	ILDEG-HAI
FTDEESRVFL	FTDEESVFL
KVDPSGVSL	KVDPSGVSL
IADLPSTQL	IADLPSTQL
IADDFAAF	IADDF-AAF
MTDDKITEV	MTDDKITEV
TTDDPRKL	TTDDP-RKL
LIDEDVYRL	LIDEDVYRL
YIDGLESRV	YIDGLESRV
LSDEGHYWV	LSDEGHYWV
IGDDSMKV	IGDDS-MKV
FADKTLLEL	FADKTLLEL
RAELHPVEL	RAELHPVEL
SSDLPERL	SSDLP-ERL
KQDEPIDLF	KQDEPIDLF
LADKVYFL	LADKV-YFL
RTEEQPMEV	RTEEQPMEV
NAESKVVLV	NAESKVVLV
SSDKGGSFL	SSDKGGSFL
LLDTVNNVF	LLDTVNNVF
LADRESAL	LADRE-SAL
VADPHNLKI	VADPHNLKI
DIDTAMKL	DIDTA-MKL
FQEDSRSTL	FQEDSRSTL
SAELEAVLL	SAELEAVLL
LTDPDIHVL	LTDPDIHVL
SADMTIKL	SADMT-IKL
FAYDGKDYI	FAYDGKDYI
LADEAEVHL	LADEAEVHL
VAEQPPLKL	VAEQPPLKL
HPDPTRLLLF	HPDPTRLLL
LTDQVTRF	LTDQV-TRF
SSDDGRVLI	SSDDGRVLI
MADTFLEHM	MADTFLEHM
KSDMETHM	KSDME-THM
SLDQTVKL	SLDQT-VKL
ILDKAMVL	ILDKA-MVL
AYDPAALCGL	AYDPAACGL
IADPDEIMWF	IADPD-EIM
TADVIAKV	TADVI-AKV
AAISQVDRL	AAISQVDRL
STDKTVKV	STDKT-VKV
FAEASGLEL	FAEASGLEL
SADGARIMV	SADGARIMV
VSDEKSSEL	VSDEKSSEL
INDVPPQYF	INDVPPQYF
AADEEVKNIM	AADEEVKNI
FQDKQVSRV	FQDKQVSRV
STDRVVLI	STDRV-VLI
LADKNVPNL	LADKNVPNL
VIDIPGADTL	VIDIPGDTL
VVPEPGQPL	VVPEPGQPL
LTDGPNERI	LTDGPNERI
LIDPGSPFL	LIDPGSPFL
KIDKYTEV	KIDKY-TEV
LADLPQQL	LADLP-QQL
HVDGHLYEL	HVDGHLYEL
IVDLGDHREVL	IVDLGDREV
VVDGPGVKV	VVDGPGVKV
VVDDAAVL	VVDDA-AVL
AAEATPVAL	AAEATPVAL
FVDPVLNQL	FVDPVLNQL
IVDDPEGFF	IVDDPEGFF
FADYRPTEV	FADYRPTEV
TADKAVDL	TADKA-VDL
RIEKNPARL	RIEKNPARL
YRDIPELQGF	YRDIPEQGF
VSDFHVFV	VSDFH-VFV
NADSATRL	NADSA-TRL
ISDNAAKI	ISDNA-AKI
VVDLGLIRV	VVDLGLIRV
RVDDKVNF	RVDDK-VNF
FAEPSSVSF	FAEPSSVSF
ETDTPAQL	ETDTP-AQL
YQDPSNAQFL	YQDPSNAQF
FSDRSPLF	FSDRS-PLF
KTDVAKTLL	KTDVAKTLL
LADITQQL	LADIT-QQL
IVDIPGTSV	IVDIPGTSV
YLEDSPLEL	YLEDSPLEL
VVDNPIYL	VVDNP-IYL
LLDQEAKL	LLDQE-AKL
IADKTENTL	IADKTENTL
VSDAPVHI	VSDAP-VHI
VAETHIVLL	VAETHIVLL
IGDTGVKF	IGDTG-VKF
SVDISPTRL	SVDISPTRL
EADERVSEL	EADERVSEL
FLDGNELTL	FLDGNELTL
KSDSPAIQL	KSDSPAIQL
YVDRGYYSV	YVDRGYYSV
AADGRGLQTV	AADGRGQTV
RGDDPVRI	RGDDP-VRI
GDAVSPRQL	GDAVSPRQL
FSEQHISQL	FSEQHISQL
LADGPDEVHL	LADGPDVHL
FIEEGIVVM	FIEEGIVVM
MSDVQIHWF	MSDVQIHWF
TADTSKVSL	TADTSKVSL
FADDQIAQSL	FADDQIQSL
VGDRSSNL	VGDRS-SNL
VAEERGAVL	VAEERGAVL
FADDLHNL	FADDL-HNL
NADISGMKV	NADISGMKV
TADGIVSHL	TADGIVSHL
VAEHHVATL	VAEHHVATL
SVDKTTTV	SVDKT-TTV
VVDKPEQTV	VVDKPEQTV
FLEKKVTEL	FLEKKVTEL
KVDDHPEV	KVDDH-PEV
LSDPSSRL	LSDPS-SRL
STDKASMEV	STDKASMEV
VADGLVKV	VADGL-VKV
FTEERLAKL	FTEERLAKL
RVDKQSALM	RVDKQSALM
HGDSAMHL	HGDSA-MHL
TSDNPVVQL	TSDNPVVQL
LLDLHSYL	LLDLH-SYL
VTENPKTEV	VTENPKTEV
IIDEVVNKF	IIDEVVNKF
RADEDARM	RADED-ARM
LADKHATL	LADKH-ATL
VADPVYRTF	VADPVYRTF
AKDEPDTNL	AKDEPDTNL
SADKLTNL	SADKL-TNL
LADIGYKTF	LADIGYKTF
MIDRDNSVF	MIDRDNSVF
SSDGHEFIV	SSDGHEFIV
GSDPRVTQL	GSDPRVTQL
IADLAHLLL	IADLAHLLL
RQDKRTVYV	RQDKRTVYV
SADLIIQEF	SADLIIQEF
IIDTPGHVDF	IIDTPGVDF
VCDIPPRGL	VCDIPPRGL
LWDDKGPAKI	LWDDKGAKI
TADAMNREV	TADAMNREV
SADKGSLEV	SADKGSLEV
HADSNIVIML	HADSNIVIM
AGDDAPRAV	AGDDAPRAV
LADHPDAPM	LADHPDAPM
FMDDTSRSI	FMDDTSRSI
KADDPSSYM	KADDPSSYM
NLDKQAKL	NLDKQ-AKL
FADHVSSSL	FADHVSSSL
VADVVVSRW	VADVVVSRW
AADKIHSSF	AADKIHSSF
FTDEESRVF	FTDEESRVF
VSDLLQALF	VSDLLQALF
VADKKARLI	VADKKARLI
VIDSPLKL	VIDSP-LKL
LSDTPNNHF	LSDTPNNHF
LTDLPSPSF	LTDLPSPSF
MGDRPVQF	MGDRP-VQF
TQDDDNIRL	TQDDDNIRL
YIDRGVVFV	YIDRGVVFV
KADPSHFEL	KADPSHFEL
FADIIHSL	FADII-HSL
KVDENHSEF	KVDENHSEF
VNDEDVRL	VNDED-VRL
FGDINYQEF	FGDINYQEF
SLDNIVKL	SLDNI-VKL
FADELSHL	FADEL-SHL
AADLGSPSL	AADLGSPSL
FTDGDAALEF	FTDGD-AAL
SVDGPIRL	SVDGP-IRL
VADSGLTL	VADSG-LTL
ALDVPHAEL	ALDVPHAEL
LADLPQSI	LADLP-QSI
SVDAHTAEV	SVDAHTAEV
LGDSRTGEM	LGDSRTGEM
VIDNGSGM	VIDNG-SGM
YIDVAVKL	YIDVA-VKL
NIDTHARL	NIDTH-ARL
YSDGEISI	YSDGE-ISI
KVDEIVVL	KVDEI-VVL
ICDERGQEL	ICDERGQEL
VADPDNPLVL	VADPDNPLV
FTDTVIRI	FTDTV-IRI
AADHYSQQM	AADHYSQQM
KLDETGNSL	KLDETGNSL
SQDGPLSVL	SQDGPLSVL
LGDSQLVKL	LGDSQLVKL
YLDHTADV	YLDHT-ADV
AADEISRF	AADEI-SRF
AADPIITRW	AADPIITRW
SIDDLPTVL	SIDDLPTVL
STDLVAKL	STDLV-AKL
GGDDSFNTFF	GGDDSFNTF
VCDEGLRSL	VCDEGLRSL
LSDREVVNL	LSDREVVNL
ALDLGGTNF	ALDLGGTNF
AADEVTAHL	AADEVTAHL
FIEDCEHTVL	FIEDCETVL
IADPRGNTL	IADPRGNTL
VADTFQDYF	VADTFQDYF
TTDKWVKL	TTDKW-VKL
IADENGAYLM	IADENGAYL
ISDKQCAEL	ISDKQCAEL
AQDEHLITFF	AQDEHLITF
LSDATTKF	LSDAT-TKF
ISDDNARL	ISDDN-ARL
HLDDLPGAL	HLDDLPGAL
FSDENVPRL	FSDENVPRL
KSDEKASVV	KSDEKASVV
VADVVIKF	VADVV-IKF
VADEMDVML	VADEMDVML
RSDPGHYSF	RSDPGHYSF
SSDALKVTF	SSDALKVTF
IIDLPALF	IIDLP-ALF
HPDPERRPSAM	HPDPERSAM
ISEDHVASV	ISEDHVASV
MNDDARTEL	MNDDARTEL
FTDHVMLF	FTDHV-MLF
QADAPNPSL	QADAPNPSL
GADPSTVEM	GADPSTVEM
AKEIDVSFV	AKEIDVSFV
HADDPERVV	HADDPERVV
NADVHASL	NADVH-ASL
AADHTGPKF	AADHTGPKF
RIDPFVRTFL	RIDPFVTFL
VADGPAVEV	VADGPAVEV
YADEKTLF	YADEK-TLF
AVESKVSKL	AVESKVSKL
AGDEFETRF	AGDEFETRF
FIDLEEYI	FIDLE-EYI
VQDGAPGTFNF	VQDGAPGTF
KSDKPQTKLL	KSDKPQTKL
YLEKDSQEL	YLEKDSQEL
FAEGKPLAL	FAEGKPLAL
SADASIKI	SADAS-IKI
FVDDQQTFF	FVDDQQTFF
IADGMIHL	IADGM-IHL
KTDPGTVFV	KTDPGTVFV
FLEDPSVL	FLEDP-SVL
TADQVIASF	TADQVIASF
SADGTVRI	SADGT-VRI
FQDKRNLYL	FQDKRNLYL
YLEEPLTQV	YLEEPLTQV
SLDELTKI	SLDEL-TKI
SVDKEQKL	SVDKE-QKL
IGDAIARL	IGDAI-ARL
TEKPEVID	TEKPE-VID
VSDHISKV	VSDHI-SKV
LADSKEIFL	LADSKEIFL
AADAEPLEI	AADAEPLEI
ISDPEKWEI	ISDPEKWEI
VQDVEVHL	VQDVE-VHL
ALDLPSLTSL	ALDLPSTSL
VSDESSQYL	VSDESSQYL
IAEAVRTTL	IAEAVRTTL
SSDDGTVKI	SSDDGTVKI
IADAKTLI	IADAK-TLI
FLDLPEPLL	FLDLPEPLL
VAEDGSRVYV	VAEDG-SRV
FADGERKVEHL	FADGE-RKV
ITDKDPLV	ITDKD-PLV
SFEDAKEAL	SFEDAKEAL
KSDDKNTVNL	KSDDKNVNL
FIDHISSL	FIDHI-SSL
YLDTVSALNF	YLDTV-SAL
TVTEKPEVID	VTEKP-EVI
SIDVGYERF	SIDVGYERF
ISDGEREEL	ISDGEREEL
IVDGAVVKF	IVDGAVVKF
LTDHGDVKL	LTDHGDVKL
SSDLPVAL	SSDLP-VAL
IIDSTNIIF	IIDSTNIIF
FLDDLGTNL	FLDDLGTNL
FQDDDQTRV	FQDDDQTRV
LADIAQKL	LADIA-QKL
NSEKPQTKL	NSEKPQTKL
FQDEINWRL	FQDEINWRL
TADEVHYFL	TADEVHYFL
SQDLAFLSM	SQDLAFLSM
YSDPILVQT	YSDPILVQT
HIDAVARF	HIDAV-ARF
FIDEYVETV	FIDEYVETV
TADISSHF	TADIS-SHF
VCDEPHPLL	VCDEPHPLL
FSDFPQHDI	FSDFPQHDI
YADDNSLLFM	YADDN-SLL
YSDGRSLHL	YSDGRSLHL
KQDNETFGF	KQDNETFGF
SADMHCHEV	SADMHCHEV
VPDHVVWSLF	VPDHVVWSL
FLDIDTKF	FLDID-TKF
SVDQPLKI	SVDQP-LKI
IVDKSGRTL	IVDKSGRTL
VADSVLTKV	VADSVLTKV
HADVAQLL	HADVA-QLL
AAEQKVTRL	AAEQKVTRL
YADPVSAQH	YADPVSAQH
EPSELPLPG	EPSELPLPG
FLDKMGSL	FLDKM-GSL
FIDENKELF	FIDENKELF
QADFTAEKF	QADFTAEKF
TADPPDGIKV	TADPPDIKV
VLDGRGHLL	VLDGRGHLL
FTDDIEYLL	FTDDIEYLL
YIDRFLSSM	YIDRFLSSM
VADPRTEVM	VADPRTEVM
LSDGVAVL	LSDGV-AVL
LADLHPDVF	LADLHPDVF
TADRIPIAV	TADRIPIAV
FVDTDSDVRL	FVDTDSVRL
KSDAASKVM	KSDAASKVM
AVDREARL	AVDRE-ARL
SAEAEASRL	SAEAEASRL
AAEEKGGLV	AAEEKGGLV
VLDIEQRL	VLDIE-QRL
FSEEHPVLL	FSEEHPVLL
LIDDEVRI	LIDDE-VRI
EADRLITYL	EADRLITYL
LAPTDVKEL	LAPTDVKEL
LSDDGVDL	LSDDG-VDL
IVDEAIYYF	IVDEAIYYF
IDDAVRKL	IDDAV-RKL
LAEIAKVEL	LAEIAKVEL
YVDETGRKL	YVDETGRKL
KADLPEGVAV	KADLPEVAV
MADLEQKV	MADLE-QKV
FGDVSVKI	FGDVS-VKI
MPEEKLVEAL	MPEEKLEAL
KIDEFVQL	KIDEF-VQL
NADEARSL	NADEA-RSL
LSDEFSHL	LSDEF-SHL
AVDPNGAFL	AVDPNGAFL
YADKEQPNL	YADKEQPNL
YEDIAQKS	YEDIA-QKS
LSDTKLEL	LSDTK-LEL
SADKFQVL	SADKF-QVL
FIDRVEYL	FIDRV-EYL
RADLIAYL	RADLI-AYL
ATDDSLHQL	ATDDSLHQL
TIDESGSIL	TIDESGSIL
VFDIHVVYV	VFDIHVVYV
ISDDSRTASQL	ISDDSRSQL
VIDVNKVVEYV	VIDVN-KVV
TQDELKEVF	TQDELKEVF
VQDFLRVLF	VQDFLRVLF
IGDIHPSDL	IGDIHPSDL
YSDGPGEAL	YSDGPGEAL
KADTEEEFL	KADTEEEFL
YVDPLDPSF	YVDPLDPSF
FVDEDVFF	FVDED-VFF
LLEEAEQLL	LLEEAEQLL
KAPEPEEEI	KAPEPEEEI
IQDEIVDFL	IQDEIVDFL
FPDPAGKLNQF	FPDPA-GKL
SADEPMTTF	SADEPMTTF
KADKVTML	KADKV-TML
VVDNKQEI	VVDNK-QEI
SVDETTQAM	SVDETTQAM
FAERVTSL	FAERV-TSL
AAEEPVSEV	AAEEPVSEV
VSDKTGLVEF	VSDKTGVEF
TADVSHTNL	TADVSHTNL
VIDQGETDVYV	VIDQGETDV
YGDQNSRL	YGDQN-SRL
TQDELRSLF	TQDELRSLF
KAEEPPSQL	KAEEPPSQL
ALDEAGQRSTM	ALDEAGQRS
LADGVQKV	LADGV-QKV
VTDNGLQKV	VTDNGLQKV
IADFGLARI	IADFGLARI
KSDKPQTKL	KSDKPQTKL
KSDEGGKVLL	KSDEGGVLL
FVEPSRQFV	FVEPSRQFV
YSDGYRSSSL	YSDGYRSSL
FTDEDQQV	FTDED-QQV
FIDPGYQTF	FIDPGYQTF
AADIASKV	AADIA-SKV
AADGTPKHSF	AADGTPHSF
SADDKTVRLW	SADDKTVRL
TAEENSPKM	TAEENSPKM
IGDGRSPEF	IGDGRSPEF
LSEKLERI	LSEKL-ERI
LADVDPMQL	LADVDPMQL
YTDLPNRQL	YTDLPNRQL
FSDQSDKF	FSDQS-DKF
TLDDKKVYL	TLDDKKVYL
TSEDYRTFL	TSEDYRTFL
KLDSHAEL	KLDSH-AEL
QVDGNSPVRF	QVDGNSVRF
FSDVFFKGF	FSDVFFKGF
RADQFEYVM	RADQFEYVM
RADPEPPGL	RADPEPPGL
FQDPSAVYSEL	FQDPSASEL
LLDKWVEL	LLDKW-VEL
SSDMSSREL	SSDMSSREL
YSDAFAKL	YSDAF-AKL
SVDPNGHSF	SVDPNGHSF
KADVQSIIGL	KADVQSIGL
YADQHSVQV	YADQHSVQV
IIEDPARSAGF	IEDPARAGF
IGDPARIQL	IGDPARIQL
VNDGVVRL	VNDGV-VRL
SADKPASL	SADKP-ASL
MVDGKPVNL	MVDGKPVNL
NAENPRGTFL	NAENPRTFL
VTEPDHPVL	VTEPDHPVL
TSDKPHSAL	TSDKPHSAL
YTDEPVSKI	YTDEPVSKI
FGDVTAHLL	FGDVTAHLL
FVDAITEL	FVDAI-TEL
YLDSEQRL	YLDSE-QRL
VSDKPDIIS	VSDKPDIIS
FADGVPREGL	FADGVPEGL
SIDQTGELL	SIDQTGELL
SSDPKVLTL	SSDPKVLTL
VADAIRTSL	VADAIRTSL
QTDIPFTRL	QTDIPFTRL
GADSEALHV	GADSEALHV
QVDPPTTTM	QVDPPTTTM
VADGSLINQL	VADGSLNQL
TADARALL	TADAR-ALL
FQDKDQVFI	FQDKDQVFI
HADSNIVIM	HADSNIVIM
VAEINGTM	VAEIN-GTM
VTDLGTAEL	VTDLGTAEL
VSDGETKF	VSDGE-TKF
HADGRLTKKL	HADGRLKKL
GSDSGRIVI	GSDSGRIVI
SIDKKISRL	SIDKKISRL
VSDEKRTEL	VSDEKRTEL
YQDTPGVKM	YQDTPGVKM
LAEDPKVTL	LAEDPKVTL
RSDSYVEL	RSDSY-VEL
LADKLYNL	LADKL-YNL
SADKPDSVL	SADKPDSVL
FVDGLTFKV	FVDGLTFKV
IIDSVPEVSF	IIDSVPVSF
SADGTLKL	SADGT-LKL
VVDDEIYYF	VVDDEIYYF
VSDQQQNFL	VSDQQQNFL
LKDLLTEL	LKDLL-TEL
TADVKASVL	TADVKASVL
YIDLPPPRL	YIDLPPPRL
NADPQAVTM	NADPQAVTM
IADIHPIQV	IADIHPIQV
NGDEISKL	NGDEI-SKL
FLDLSIIRF	FLDLSIIRF
RVDDVYSVL	RVDDVYSVL
FADKHIQVL	FADKHIQVL
MVDSKPVNL	MVDSKPVNL
FTDLSSRF	FTDLS-SRF
VSDDGTLHM	VSDDGTLHM
FIDGDLIESF	FIDGDLESF
SSDLPGGEF	SSDLPGGEF
VADEDAHNI	VADEDAHNI
VADDIMDSSL	VADDIMSSL
YADPVTDLL	YADPVTDLL
VVDDIVSKL	VVDDIVSKL
IADREQRL	IADRE-QRL
NADLRPSKL	NADLRPSKL
GADVVSKF	GADVV-SKF
KAPAPRPSL	KAPAPRPSL
KIDVGDVIL	KIDVGDVIL
HVDHGKSTL	HVDHGKSTL
ALDDMISTL	ALDDMISTL
FIEEGTFLF	FIEEGTFLF
IVDEDVKL	IVDED-VKL
FLDKEFTRI	FLDKEFTRI
ATDLAQHL	ATDLA-QHL
VADIDGSTF	VADIDGSTF
NLDNPIQTV	NLDNPIQTV
YQDPSNAQF	YQDPSNAQF
VADKGGSIF	VADKGGSIF
FVDERPEEV	FVDERPEEV
GIEKASVLL	GIEKASVLL
ISDEANSNF	ISDEANSNF
ILDEAVEL	ILDEA-VEL
TIDGQQTII	TIDGQQTII
VSDPVTVHF	VSDPVTVHF
ITDDPSSNQNV	ITDDPSSNQ
GADEKVLRV	GADEKVLRV
VVEKEHPQL	VVEKEHPQL
SLDIPATYL	SLDIPATYL
KADSLLAVV	KADSLLAVV
WADEGSRL	WADEG-SRL
AAEVAATEI	AAEVAATEI
SIDDVVRL	SIDDV-VRL
SGDEMVSL	SGDEM-VSL
VCDNLGDHL	VCDNLGDHL
KQDLVELYL	KQDLVELYL
TGDETGAKV	TGDETGAKV
AADGPQKLL	AADGPQKLL
FIDTAQHML	FIDTAQHML
IVDEGALL	IVDEG-ALL
MTDEICRL	MTDEI-CRL
FQDDNNLYL	FQDDNNLYL
AADSPSQNL	AADSPSQNL
YSDSRVGF	YSDSR-VGF
IGDLVKSTL	IGDLVKSTL
FSDDIEQTM	FSDDIEQTM
TSDQPILL	TSDQP-ILL
ISDDKYGRI	ISDDKYGRI
FLDQQAILF	FLDQQAILF
VADEIQVGF	VADEIQVGF
AAEKKVVKI	AAEKKVVKI
FIDEGVNI	FIDEG-VNI
YVDEASKKEI	YVDEASKEI
FADEFAKL	FADEF-AKL
VGDEVTVLF	VGDEVTVLF
SADEVMRF	SADEV-MRF
LADAINTEF	LADAINTEF
IIDQEVQTL	IIDQEVQTL
VADHRVKL	VADHR-VKL
RADESTYVL	RADESTYVL
VADEALKV	VADEA-LKV
SLDGHAYL	SLDGH-AYL
STDMDKVLL	STDMDKVLL
YSDAPVSEL	YSDAPVSEL
DADQASNIL	DADQASNIL
FADQKQEF	FADQK-QEF
VSDKDTGL	VSDKD-TGL
HIDSGKTTL	HIDSGKTTL
TLDSPAHL	TLDSP-AHL
ATDAVSKM	ATDAV-SKM
KADEGLASL	KADEGLASL
FTDSGRQSV	FTDSGRQSV
YSDGKLQTV	YSDGKLQTV
TADLNCNLF	TADLNCNLF
IIDPGSTVTV	IIDPGSVTV
AGDGEVTKI	AGDGEVTKI
AADTVVIF	AADTV-VIF
RADGENTAF	RADGENTAF
VAPVASAL	VAPVA-SAL
YLEKPMEI	YLEKP-MEI
LADMGHEEL	LADMGHEEL
SADQKTTLL	SADQKTTLL
VIDECVEM	VIDEC-VEM
KSDDTAEHLL	KSDDTAEHL
LTDLISRL	LTDLI-SRL
KADEDPAL	KADED-PAL
GADDRQVKI	GADDRQVKI
LTDEEKSLL	LTDEEKSLL
QADEANKRLL	QADEANKRL
SAEEVTRL	SAEEV-TRL
LSDGIQEL	LSDGI-QEL
SADHKNLEV	SADHKNLEV
KADVERKL	KADVE-RKL
AGDWRPSSI	AGDWRPSSI
YADRVKEL	YADRV-KEL
IADKEVTI	IADKE-VTI
ISDIGAKI	ISDIG-AKI
YIDFGGKF	YIDFG-GKF
FIDKNTQL	FIDKN-TQL
SADSQRVVF	SADSQRVVF
LSDEEIVKF	LSDEEIVKF
TADQPRWV	TADQP-RWV
KLDSHAELL	KLDSHAELL
IADLAHLL	IADLA-HLL
ILDDSDSNL	ILDDSDSNL
LVDRVPTL	LVDRV-PTL
VADREEAF	VADRE-EAF
KTDKTLVLL	KTDKTLVLL
VLDDKDYFLF	VLDDKDYFL
FIDQSQSL	FIDQS-QSL
IADSSTFRV	IADSSTFRV
IGDPNLEF	IGDPN-LEF
FQDDSLIYM	FQDDSLIYM
QADARQVVL	QADARQVVL
FTDQATVERF	FTDQATERF
TQDLPGVKL	TQDLPGVKL
ISDLSVNSL	ISDLSVNSL
TSDAQPHAF	TSDAQPHAF
TADTILNTL	TADTILNTL
FEDPEMMEM	FEDPEMMEM
YTEAERSLL	YTEAERSLL
YGDNRVHEF	YGDNRVHEF
FADPAHGGSWL	FADPAHSWL
LEEVQSLPLPL	LEEVQSLPL
NVDHASVL	NVDHA-SVL
ILDETQHL	ILDET-QHL
FVDDYTVRV	FVDDYTVRV
VVDEAVLV	VVDEA-VLV
NGDTPLHL	NGDTP-LHL
FLDDVNLIL	FLDDVNLIL
YQDPAAVSF	YQDPAAVSF
FADEKPLQDM	FADEKPQDM
FLDKILEV	FLDKI-LEV
GADGEQTRL	GADGEQTRL
YTDRIQVL	YTDRI-QVL
YIDFEMKI	YIDFE-MKI
ISDLSINSL	ISDLSINSL
LAEDDIYLL	LAEDDIYLL
YADDNSLLF	YADDNSLLF
SADQSPSAL	SADQSPSAL
FVDRGFYSV	FVDRGFYSV
WQDWPLTQV	WQDWPLTQV
TIDGPSKVKM	TIDGP-SKV
KAEDVPVRI	KAEDVPVRI
FLDSEVSEL	FLDSEVSEL
IVDQQGHTM	IVDQQGHTM
IIDKEVSL	IIDKE-VSL
NLDQATRV	NLDQA-TRV
LSDEENLKLF	LSDEENLKL
VADEELVHLL	VADEELVHL
LADKVLKL	LADKV-LKL
HVDESGLSL	HVDESGLSL
VIDVGEVTL	VIDVGEVTL
ASDEGRVQM	ASDEGRVQM
NSDSLPHRL	NSDSLPHRL
YMDSPQSIGF	YMDSP-QSI
NSDLNNLLF	NSDLNNLLF
LADLPQQLL	LADLPQQLL
MVDHVTEV	MVDHV-TEV
AADSAVRL	AADSA-VRL
FLDENVHF	FLDEN-VHF
VADIDGQYAM	VADIDGYAM
LTDQMHCEF	LTDQMHCEF
YAEDPSNNFM	YAEDPSNNF
CADPENHKV	CADPENHKV
SADEVMRFF	SADEVMRFF
YADYRIIDL	YADYRIIDL
SADKLVAL	SADKL-VAL
FLDKALEL	FLDKA-LEL
SSDSTVRV	SSDST-VRV
SLDRPHTVL	SLDRPHTVL
ILDEANRL	ILDEA-NRL
TVDLGEPLHSL	TVDLG-EPL
FLEDHGLLV	FLEDHGLLV
VADRLMLEL	VADRLMLEL
TADGGHYYSF	TADGGHYSF
KSDDFTNLL	KSDDFTNLL
FSDTKIISL	FSDTKIISL
IADDADPRV	IADDADPRV
TADLPNEL	TADLP-NEL
VKDVPNSQL	VKDVPNSQL
FFDVDTSQV	FFDVDTSQV
RGDLPFVVPRR	RGDLP-FVV
FADENFKL	FADEN-FKL
SIDILHSIV	SIDILHSIV
ISDAVSRL	ISDAV-SRL
KADEDPIMGF	KADED-PIM
YQDLGIPVL	YQDLGIPVL
HADDFIQEM	HADDFIQEM
SADSANDGF	SADSANDGF
TTDKDVLI	TTDKD-VLI
FGDDHNKNGF	FGDDHNNGF
VGDGGTGKTTF	VGDGGTTTF
TTDIQVKV	TTDIQ-VKV
AIDRAGAEV	AIDRAGAEV
FLENETWEL	FLENETWEL
LTDIFAKV	LTDIF-AKV
TADIQMVTV	TADIQMVTV
ISDAGLLHL	ISDAGLLHL
IADPKTDHRL	IADPKTHRL
MADAGILRL	MADAGILRL
YADRLEAEM	YADRLEAEM
KIDDFKAEDF	KIDDFKEDF
YNDDKNTYI	YNDDKNTYI
KQDEPIDL	KQDEP-IDL
SSDPHQSRL	SSDPHQSRL
FLDHEMVFL	FLDHEMVFL
AADKGVYII	AADKGVYII
FQDFNPSKF	FQDFNPSKF
SLDWNSEGTLL	SLDWNSGTL
SSDEATIRL	SSDEATIRL
SADETAKKI	SADETAKKI
EKAQGPILL	EKAQGPILL
NIDEAITLL	NIDEAITLL
KNDVDVQI	KNDVD-VQI
IVDRVSYL	IVDRV-SYL
SAEQAKVVL	SAEQAKVVL
SADKTVRV	SADKT-VRV
YADAGTVQEML	YADAGTQEM
LADQHIIHV	LADQHIIHV
ASDASIRL	ASDAS-IRL
ISDKKLTTL	ISDKKLTTL
VMDSKIVQV	VMDSKIVQV
SADKPLSNM	SADKPLSNM
YIDQGRNPQL	YIDQGRPQL
QVDDIRSFL	QVDDIRSFL
YIDHGDPQV	YIDHGDPQV
FTDHGGSGF	FTDHGGSGF
VADTSAKAV	VADTSAKAV
FLDGNEMTL	FLDGNEMTL
YADNQVMHF	YADNQVMHF
LSDETLLEI	LSDETLLEI
RADEVKSMF	RADEVKSMF
FPDNQRPAL	FPDNQRPAL
FADLPQVETF	FADLPQETF
SLDRPFTNL	SLDRPFTNL
FLDDQETRL	FLDDQETRL
SSDQSVKV	SSDQS-VKV
YQDKEEVVL	YQDKEEVVL
YGDEIAIEL	YGDEIAIEL
VVDVDVKL	VVDVD-VKL
TSDRESIFF	TSDRESIFF
AADGSVKL	AADGS-VKL
NADPASHEI	NADPASHEI
SFDVSQKF	SFDVS-QKF
FIDDDKVTF	FIDDDKVTF
VTDSTSTFL	VTDSTSTFL
LTDEQVAL	LTDEQ-VAL
YFDLQLLVF	YFDLQLLVF
YSDLSDALVIF	YSDLSDALV
SADKTVKL	SADKT-VKL
KNDIPSSYM	KNDIPSSYM
TSDHFETIM	TSDHFETIM
TVEIGETYL	TVEIGETYL
KSDADSGFL	KSDADSGFL
HVTLSIKH	HVTLS-IKH
VADEISFRL	VADEISFRL
SNDTGSGKF	SNDTGSGKF
KLDSSETTM	KLDSSETTM
FVDDETKL	FVDDE-TKL
SGDKGSPFL	SGDKGSPFL
FLEDGTSQV	FLEDGTSQV
HSDVASGM	HSDVA-SGM
HGDMTNRKF	HGDMTNRKF
TQDTNTFFL	TQDTNTFFL
NLDKQTAL	NLDKQ-TAL
IADGNPKL	IADGN-PKL
YVDDTQFLRF	YVDDT-QFL
ISDGPSKVTL	ISDGPSVTL
FVDGDHVIL	FVDGDHVIL
TADEIQNTL	TADEIQNTL
PKFEVIEKPQA	VIEKP----
VVDAGKVTL	VVDAGKVTL
ISDTWLTV	ISDTW-LTV
ISDDRNSSV	ISDDRNSSV
IIEEEPTWI	IIEEEPTWI
NVDAKIAKL	NVDAKIAKL
VADPDHDHTGF	VADPDHTGF
VVDEADTML	VVDEADTML
VQDPHSRI	VQDPH-SRI
RSDTSSPEV	RSDTSSPEV
RVDIGDTIIYL	IGDTI-IYL
FAIPLIEKL	FAIPLIEKL
SADNVRQQL	SADNVRQQL
STDPAAPNL	STDPAAPNL
VTDSGPTF	VTDSG-PTF
HGDLGNGKF	HGDLGNGKF
LSDDHVLIL	LSDDHVLIL
FTDTDCVVRF	FTDTDCVRF
SQDLSGRL	SQDLS-GRL
IQDFNKVVF	IQDFNKVVF
YSDINQEHV	YSDINQEHV
LSDLALHF	LSDLA-LHF
IADRLNVDF	IADRLNVDF
LIDEMVNTI	LIDEMVNTI
HTDQSSRL	HTDQS-SRL
HTDVADVLL	HTDVADVLL
LADLQLEYL	LADLQLEYL
YSDRISEL	YSDRI-SEL
FLDASGAKL	FLDASGAKL
NADQLASKL	NADQLASKL
FLDGHDLQL	FLDGHDLQL
AAEEANAVL	AAEEANAVL
ILDNPVVQL	ILDNPVVQL
ISDAPINEV	ISDAPINEV
FADSTVRV	FADST-VRV
AADFEIGHFL	AADFEIHFL
HSEESQIYL	HSEESQIYL
FSDQGHPEI	FSDQGHPEI
VLDDFVKV	VLDDF-VKV
FSDDPNVTKTL	FSDDPNVTK
VLDKASSL	VLDKA-SSL
FPDSRTNVDL	FPDSR-TNV
YENEVALRQ	YENEVALRQ
IADLQQKL	IADLQ-QKL
SIDDQLNTL	SIDDQLNTL
VLDKASSLI	VLDKASSLI
SADEVQRFF	SADEVQRFF
ALDKATVLL	ALDKATVLL
IADENGAYL	IADENGAYL
VSDTNQHV	VSDTN-QHV
FSDDIVKI	FSDDI-VKI
KADEDPIM	KADED-PIM
INDAGEVRL	INDAGEVRL
TVDDPYATF	TVDDPYATF
GADKSSNFL	GADKSSNFL
FSDPVYKEI	FSDPVYKEI
ALDFEQEM	ALDFE-QEM
LADQEVRL	LADQE-VRL
KKDDGYTAL	KKDDGYTAL
LGIHEDSTNR	IHEDS-TNR
YGDTDARV	YGDTD-ARV
IVDDEATL	IVDDE-ATL
NSDEHAVVI	NSDEHAVVI
FTDERIFML	FTDERIFML
YGDGDGRTAL	YGDGDGTAL
VADSGSNQL	VADSGSNQL
SADLPESTL	SADLPESTL
YIDKSTQL	YIDKS-TQL
AGDKPRTFL	AGDKPRTFL
NIDLNSWL	NIDLN-SWL
TIDRDTAF	TIDRD-TAF
NADSATRLL	NADSATRLL
HVDTGKTKI	HVDTGKTKI
TIDKVVKI	TIDKV-VKI
IADTGANV	IADTG-ANV
SSDKYAAL	SSDKY-AAL
HIDHPVMV	HIDHP-VMV
RQDFHSEM	RQDFH-SEM
NADVALQNL	NADVALQNL
YADEVHTQV	YADEVHTQV
FADGHVLEL	FADGHVLEL
LADIVQKL	LADIV-QKL
ISDHEATL	ISDHE-ATL
RSDVPSLVTF	RSDVPSVTF
FNDPNAKEM	FNDPNAKEM
TIDPNTRTLL	TIDPNTRTL
FADSKGDVGL	FADSKGVGL
FGDKDSKL	FGDKD-SKL
FVEDSKVVL	FVEDSKVVL
ISDSPIGV	ISDSP-IGV
KGDNITLL	KGDNI-TLL
FSDEDYYQF	FSDEDYYQF
RVDKNAPTV	RVDKNAPTV
FLDRPQQWL	FLDRPQQWL
HIDPNVDYQF	HIDPNVYQF
AGDGPPRSF	AGDGPPRSF
FIDDANYSV	FIDDANYSV
LSDEHAGVI	LSDEHAGVI
YVDDSIAL	YVDDS-IAL
AADGEFLHEL	AADGEFHEL
SADTFTRNL	SADTFTRNL
AADGGPKL	AADGG-PKL
FTDTPLQI	FTDTP-LQI
VLDEAGSTV	VLDEAGSTV
VTDTDETEL	VTDTDETEL
KQDPYLVNF	KQDPYLVNF
KSDIASHF	KSDIA-SHF
AVDKTGRIL	AVDKTGRIL
AGDHPGRAV	AGDHPGRAV
FVEETVYLL	FVEETVYLL
KSDERLTAF	KSDERLTAF
LTDEEAERL	LTDEEAERL
AADLPARGF	AADLPARGF
SLDDIIKL	SLDDI-IKL
YAERDIVQF	YAERDIVQF
ATDGRVYVV	ATDGRVYVV
YSDLRKESM	YSDLRKESM
SADGQTLF	SADGQ-TLF
LLDGGVINL	LLDGGVINL
VAERESAEV	VAERESAEV
AADKGVYI	AADKG-VYI
RADEDARMIHM	RADED-ARM
LQDLTFVHL	LQDLTFVHL
VIDLRAEL	VIDLR-AEL
LTDQSSNLL	LTDQSSNLL
HIDPSGKL	HIDPS-GKL
YSDNLTRL	YSDNL-TRL
FLDDLSQKL	FLDDLSQKL
SSDTSSRSF	SSDTSSRSF
QCDVCDLAFSL	VCDLA-FSL
SSDEPMTTF	SSDEPMTTF
KTDHRNVEL	KTDHRNVEL
HTDHGGSAVL	HTDHGGSAV
VAEQIPLLV	VAEQIPLLV
KVDAPGLALL	KVDAPGLAL
YLEGEAVRL	YLEGEAVRL
VSDPEEMEL	VSDPEEMEL
VIEDKTIEL	VIEDKTIEL
SAEEMVTLL	SAEEMVTLL
KADLGPISL	KADLGPISL
MTDLLAKL	MTDLL-AKL
AGDSPGSQF	AGDSPGSQF
YLDKEDTFF	YLDKEDTFF
VSDGSKVSV	VSDGSKVSV
KSDAPDTLLL	KSDAPDTLL
NQDERISKL	NQDERISKL
RTDCSPIQF	RTDCSPIQF
ALEDIRTEF	ALEDIRTEF
SADGTIKL	SADGT-IKL
MPDLAHVM	MPDLA-HVM
SAESSRTLL	SAESSRTLL
YCERQGLSM	YCERQGLSM
INDNTNSRV	INDNTNSRV
VADSPAEVAL	VADSPAVAL
NIDLPASL	NIDLP-ASL
LADENREVL	LADENREVL
VADLVVNIL	VADLVVNIL
ESDPGVFTEL	ESDPGVTEL
IVDDDDYFL	IVDDDDYFL
RADFEQKM	RADFE-QKM
SAPVGVTAL	SAPVGVTAL
FNDKHITTL	FNDKHITTL
KIEDYFPEF	KIEDYFPEF
YLDEYIARM	YLDEYIARM
FLDEKTHELL	FLDEKTHEL
KVDLESKL	KVDLE-SKL
VADLQTRL	VADLQ-TRL
LSDLSTKL	LSDLS-TKL
SVDVEGGRL	SVDVEGGRL
SADKTVAL	SADKT-VAL
KADGKIMAL	KADGKIMAL
ESGPSIVH	ESGPS-IVH
ASDDHTVCL	ASDDHTVCL
VAETPDIKL	VAETPDIKL
VLDDPKSAGV	VLDDPKAGV
KADEANDNL	KADEANDNL
LSDEKAFVF	LSDEKAFVF
NTDHPPCQL	NTDHPPCQL
VVDEKISAM	VVDEKISAM
YIDRDSEYLL	YIDRDSEYL
FTDWKGYLM	FTDWKGYLM
VVDPVEKTM	VVDPVEKTM
SQDPGAVVL	SQDPGAVVL
TADYICKV	TADYI-CKV
KQDLLAEKV	KQDLLAEKV
VIDLQTRL	VIDLQ-TRL
IIDGTSEM	IIDGT-SEM
ISDGPSKV	ISDGP-SKV
KVDQGTLF	KVDQG-TLF
LADQGEIRV	LADQGEIRV
STDNGRIFL	STDNGRIFL
TIDCGLVRL	TIDCGLVRL
ASDDPEKL	ASDDP-EKL
IVDEVNGLISM	IVDEVNGLI
SIDSEPALV	SIDSEPALV
MLDPLEVHL	MLDPLEVHL
NVDSGKSTL	NVDSGKSTL
SFDHVPALV	SFDHVPALV
SYDPVLNPVL	SYDPVLPVL
VLDEGSASV	VLDEGSASV
NSDGRQQIL	NSDGRQQIL
HSDFFQKL	HSDFF-QKL
LADGGVKM	LADGG-VKM
VGDPVRLEV	VGDPVRLEV
KTDEIVAL	KTDEI-VAL
KLDLPCEL	KLDLP-CEL
RADAETRL	RADAE-TRL
HIDNDVKL	HIDND-VKL
ITDDSTSL	ITDDS-TSL
ESSPPGTTF	ESSPPGTTF
SAEPKIMKV	SAEPKIMKV
FVEEPSKKGAL	FVEEP-SKK
LADGSSRL	LADGS-SRL
FADDVLNL	FADDV-LNL
ISDGKEYLF	ISDGKEYLF
KADENNAKL	KADENNAKL
NAEYHQSIL	NAEYHQSIL
EADRAQQYF	EADRAQQYF
VADTAEEKF	VADTAEEKF
VADDTPVLL	VADDTPVLL
WADVQSQL	WADVQ-SQL
TSDDVAKEFV	TSDDVAKEF
FNDEKTYLV	FNDEKTYLV
YCEDESRTYL	YCEDESTYL
SSDKGTVHI	SSDKGTVHI
IADGHRML	IADGH-RML
SGDPKVIEV	SGDPKVIEV
FADFVEGSSHL	FVEGS-SHL
FADNVSGL	FADNV-SGL
YLDDVSLHHL	YLDDVSHHL
SADDIAGKFQF	SADDIAGKF
VTDKSGISM	VTDKSGISM
LSDPTYREL	LSDPTYREL
SADTVVIFD	SADTVVIFD
KVDKDAEL	KVDKD-AEL
VVDEAHRL	VVDEA-HRL
YFDDCMQLL	YFDDCMQLL
LADEQDVHM	LADEQDVHM
YADVENRV	YADVE-NRV
QVDGDNSHVEM	QVDGDNSHV
SADQTSGNYL	SADQTSNYL
NADWPAGL	NADWP-AGL
LQDFSQVTL	LQDFSQVTL
KLDDTSLEFL	KLDDTSLEF
LADDLNEKI	LADDLNEKI
ETEDPRLL	ETEDP-RLL
VTDEVFNFL	VTDEVFNFL
VAEKHGLTL	VAEKHGLTL
GIDSSSPEV	GIDSSSPEV
FLDLSENLI	FLDLSENLI
KNDEGVTLL	KNDEGVTLL
VQDIVYRTM	VQDIVYRTM
LHDHGVSSL	LHDHGVSSL
VIDQKVYEI	VIDQKVYEI
IAEQTPILL	IAEQTPILL
FTDEDQQVV	FTDEDQQVV
ISDNAARVL	ISDNAARVL
FYDPTAGVV	FYDPTAGVV
NVDEGIYQL	NVDEGIYQL
VGDTQVVVF	VGDTQVVVF
VADLAESI	VADLA-ESI
KADGIVSKNF	KADGIVKNF
KHLDVVTLL	KHLDVVTLL
FNDGSSREL	FNDGSSREL
IIDLEQTATHL	IIDLEQTHL
TTDPNSTF	TTDPN-STF
AADAEMTTRM	AADAEMTRM
VADSDRQL	VADSD-RQL
SLDGIVRL	SLDGI-VRL
NMDSPGPML	NMDSPGPML
SVDPVLSIL	SVDPVLSIL
VIDLDDATFL	VIDLDDATF
FSEWDNPVF	FSEWDNPVF
VNDDSMKL	VNDDS-MKL
DNEGSWFRSL	DNEGSWRSL
KVDGSEPKL	KVDGSEPKL
KTDSQPTSV	KTDSQPTSV
AADLLVVHL	AADLLVVHL
FSDYPPLGRF	FSDYPPGRF
MIDIQTRM	MIDIQ-TRM
VADLIGLNL	VADLIGLNL
YVDDIEKGHTL	YVDDIEHTL
KADNVVNI	KADNV-VNI
LTDEGYEHF	LTDEGYEHF
YSEDELPAEF	SEDELPAEF
LADVHIEV	LADVH-IEV
AQDLITRLL	AQDLITRLL
IIDDTIFNL	IIDDTIFNL
AAPEGVPL	AAPEG-VPL
YSDIDIILL	YSDIDIILL
VTDGALVVV	VTDGALVVV
LADKNSELF	LADKNSELF
YIDAHPETI	YIDAHPETI
YGDLNHLV	YGDLN-HLV
IADSHPEM	IADSH-PEM
IVDKGPVEL	IVDKGPVEL
SLDQNNSHF	SLDQNNSHF
QADEPTTL	QADEP-TTL
RADPESPIL	RADPESPIL
HLDSVTKI	HLDSV-TKI
FIDEELEKM	FIDEELEKM
SVDPAGVTM	SVDPAGVTM
TADSKAARL	TADSKAARL
VVDAVVTQV	VVDAVVTQV
VIDHHNYDI	VIDHHNYDI
RIDEEVKI	RIDEE-VKI
FTDTVGNIL	FTDTVGNIL
FAEDPSQL	FAEDP-SQL
HSDNPSQL	HSDNP-SQL
QSDFGKVTM	QSDFGKVTM
FTDISPEEL	FTDISPEEL
YTDRETGKL	YTDRETGKL
SADFSPAFL	SADFSPAFL
TCDEGHGIFV	TCDEGHGIF
FVEGRSVEF	FVEGRSVEF
IGDGTTGVVVL	IGDGTTVVV
LVDTTVEL	LVDTT-VEL
SADDLLKTL	SADDLLKTL
IIDEFEQKL	IIDEFEQKL
KSDERPVHI	KSDERPVHI
YVDDTPAEQM	YVDDTPEQM
SSDDGRIIV	SSDDGRIIV
QAEDGKTEL	QAEDGKTEL
TIDEIQKL	TIDEI-QKL
LLDVARTSL	LLDVARTSL
HADGLCHRL	HADGLCHRL
ISDYAVKIV	ISDYAVKIV
YADIQSWL	YADIQ-SWL
TAEGTVFHF	TAEGTVFHF
SQDEVRENI	SQDEVRENI
NAEDVYSRL	NAEDVYSRL
AADDHQALI	AADDHQALI
FADNVSGLRM	FADNV-SGL
VSDENSKRL	VSDENSKRL
ASDQPSHSL	ASDQPSHSL
HTDKGSFL	HTDKG-SFL
SLDQTVRV	SLDQT-VRV
VLDENQSKL	VLDENQSKL
IAENQEAKL	IAENQEAKL
IIDEQPLIF	IIDEQPLIF
WLDPNETNEI	WLDPNENEI
TADKLQEF	TADKL-QEF
VGDKPVSNF	VGDKPVSNF
VADTGLQILF	VADTGLQIL
KQDQTLAEL	KQDQTLAEL
YGDKQPVTV	YGDKQPVTV
ISDTGIMHL	ISDTGIMHL
AIDSEGHSYM	AIDSEGSYM
AAEDKSWRV	AAEDKSWRV
FSDGLVRF	FSDGL-VRF
NAEQAATQL	NAEQAATQL
SADGTVRL	SADGT-VRL
VVDKPPSTM	VVDKPPSTM
FLDEKSGSFV	FLDEKSGSF
RADAPVALV	RADAPVALV
NKDFGDTTV	NKDFGDTTV
YPDPHSPFAV	YPDPHSFAV
NVDLTEFQTNL	LTEFQ-TNL
SIDSGHATI	SIDSGHATI
YADSSIAEL	YADSSIAEL
SIDDVDSKL	SIDDVDSKL
KSDVEAIF	KSDVE-AIF
TVDKDITL	TVDKD-ITL
YLDLDSKV	YLDLD-SKV
FSEKASKF	FSEKA-SKF
FVDELRITL	FVDELRITL
AADKAAVVKF	AADKAAVKF
VSDEYEQL	VSDEY-EQL
HGDVAVKI	HGDVA-VKI
AVDNVAHTI	AVDNVAHTI
VADLVHIL	VADLV-HIL
IADLVTSVL	IADLVTSVL
VADDPIVM	VADDP-IVM
VADKHRPLEM	VADKHRLEM
AADKPLAF	AADKP-LAF
NTDEMVEL	NTDEM-VEL
VADKHRPL	VADKH-RPL
ISDHECQEL	ISDHECQEL
VYDMNLREM	VYDMNLREM
VLDQKEHRL	VLDQKEHRL
VYDVVEEKL	VYDVVEEKL
VIDTQTKL	VIDTQ-TKL
FTDIPEVL	FTDIP-EVL
SQDDIATIL	SQDDIATIL
QADEVIAIL	QADEVIAIL
ILDEPTNHL	ILDEPTNHL
VADENLKAF	VADENLKAF
FAEVEQIAF	FAEVEQIAF
LVDDNYFYL	LVDDNYFYL
SADVRQGEF	SADVRQGEF
FAIDPHLLL	FAIDPHLLL
VQDLMETDL	VQDLMETDL
GVDNPAAKV	GVDNPAAKV
RSDLYAVEM	RSDLYAVEM
VADFGSATF	VADFGSATF
LADGVTMQV	LADGVTMQV
SSDKIAAL	SSDKI-AAL
VVDSEPVRF	VVDSEPVRF
SLDEVVLL	SLDEV-VLL
LTEDPHTVL	LTEDPHTVL
FADGSIRTSEL	FADGSISEL
NADTGTKL	NADTG-TKL
AADGSVKLW	AADGSVKLW
FTEDHYVEF	FTEDHYVEF
STDVPEKSSLF	STDVPESSL
KTDVVVNSV	KTDVVVNSV
VTDVHPTLL	VTDVHPTLL
RLDVDTKL	RLDVD-TKL
AVDQLTRL	AVDQL-TRL
FADLTQVETF	FADLTQETF
FIDLDSHAEAL	DLDSHAEAL
AIDTESRL	AIDTE-SRL
LSDTVRTVL	LSDTVRTVL
RQDEHGYI	RQDEH-GYI
AADSAVRLW	AADSAVRLW
TSDGRVIFF	TSDGRVIFF
AADPEAPEI	AADPEAPEI
FTDDQWLNV	FTDDQWLNV
VADEQQRLM	VADEQQRLM
YADFPELDL	YADFPELDL
LLEKAGPEL	LLEKAGPEL
IADLDTTIMF	IADLD-TTI
SADKSVII	SADKS-VII
NADKIRVKI	NADKIRVKI
VVSEVDIAKAD	VSEVDIAKA
VTDGKEVLL	VTDGKEVLL
FIDAVYKL	FIDAV-YKL
FADVAPLQL	FADVAPLQL
AADGGPKLV	AADGGPKLV
TSDPLELFL	TSDPLELFL
FQDDRYLYM	FQDDRYLYM
FLDGRPLTL	FLDGRPLTL
FLDYEAGHL	FLDYEAGHL
STDELASKL	STDELASKL
VGDGPVDM	VGDGP-VDM
RADKSAVGF	RADKSAVGF
TMDGRQTHTV	TMDGRQHTV
TIDPTEFKF	TIDPTEFKF
YTDATPLRV	YTDATPLRV
HSDELTSL	HSDEL-TSL
STDEEVTSL	STDEEVTSL
SADGISSRL	SADGISSRL
AAELGKTLL	AAELGKTLL
FNDGSSRELM	FNDGSSREL
RQDDPSYRSF	RQDDPSRSF
FQEPDSILVL	FQEPDSILV
IADNIIKF	IADNI-IKF
LLDVTPLSL	LLDVTPLSL
VADAVTYQL	VADAVTYQL
YLDEGFLL	YLDEG-FLL
VVDIVQEL	VVDIV-QEL
YLDIAEFL	YLDIA-EFL
STDYETHEF	STDYETHEF
LSDTVQHL	LSDTV-QHL
FADNPGPMVVF	FADNPGPMV
KVDPLFTEL	KVDPLFTEL
YLDNGVVFV	YLDNGVVFV
GADPNATTL	GADPNATTL
YLDQTVVPILL	YLDQTVPIL
FSDGAVSL	FSDGA-VSL
KTDEMHTAL	KTDEMHTAL
YVEPLPLIF	YVEPLPLIF
VADGLVTTL	VADGLVTTL
TSDLGKTEL	TSDLGKTEL
VADWGQKV	VADWG-QKV
HADVGVALL	HADVGVALL
IQEHQPSVL	IQEHQPSVL
IVDHQNDSF	IVDHQNDSF
KADGETIL	KADGE-TIL
VVDGNFEEV	VVDGNFEEV
SGDPLPLKL	SGDPLPLKL
FQDGPKSYL	FQDGPKSYL
RNDKREVKV	RNDKREVKV
KTDVFQSL	KTDVF-QSL
NLDVPTFVSF	NLDVPTVSF
RFDCADRQF	RFDCADRQF
NADLNGKF	NADLN-GKF
VVDGKERTLL	VVDGKERTL
ILDNEMKL	ILDNE-MKL
FSDDNKITI	FSDDNKITI
LADGVPVAL	LADGVPVAL
KIDEKTAEL	KIDEKTAEL
MQDESQYFF	MQDESQYFF
RSDESVGNVTF	RSDESVGNV
SADFHVDL	SADFH-VDL
TAELQDTKL	TAELQDTKL
YKDSGITYL	YKDSGITYL
SIDDIGHLI	SIDDIGHLI
LAEGGGAKF	LAEGGGAKF
FIDEQQIL	FIDEQ-QIL
ITDPYQQAFL	ITDPYQQAF
MADKPGNTV	MADKPGNTV
HVDQVREYM	HVDQVREYM
YSDVMSKL	YSDVM-SKL
NADSKSEYL	NADSKSEYL
ICDTPQKAL	ICDTPQKAL
DADGQATLL	DADGQATLL
SQDPFPAAI	SQDPFPAAI
NCDQAAQRL	NCDQAAQRL
VSDRISSL	VSDRI-SSL
FAEAVGVQL	FAEAVGVQL
SADSKVLL	SADSK-VLL
HYDELQARL	HYDELQARL
TAEEKQTLL	TAEEKQTLL
FIEKRYVEL	FIEKRYVEL
ITDPEVVFV	ITDPEVVFV
TAEERVAEL	TAEERVAEL
SLDSPVLL	SLDSP-VLL
KVDNPDSEKL	KVDNPDEKL
SLDGTIKL	SLDGT-IKL
AADKRPPKF	AADKRPPKF
ADDKTVRL	ADDKT-VRL
VVDAIPVFL	VVDAIPVFL
WTDGKEAML	WTDGKEAML
FSDLPLRV	FSDLP-LRV
QADDGKIVIF	QADDGKIVI
TSDKGFVTM	TSDKGFVTM
VLDSSLSEL	VLDSSLSEL
NSDELLKI	NSDEL-LKI
MADKPGNTVNF	MADKPGNTV
FSDEQILTV	FSDEQILTV
NLDQPPAFF	NLDQPPAFF
QADPTKLEL	QADPTKLEL
HTDDHMALL	HTDDHMALL
AADSPGSGL	AADSPGSGL
AADKGHYKF	AADKGHYKF
VTDFYPAQI	VTDFYPAQI
FQDPSVTQL	FQDPSVTQL
LSDTEQRL	LSDTE-QRL
NIDKSLYV	NIDKS-LYV
AADGGPRVSF	AADGGPVSF
KQDETQTKI	KQDETQTKI
LADPAALGF	LADPAALGF
YTDTSQKEAF	YTDTSQEAF
QIDGIVHF	QIDGI-VHF
AADDRTVRI	AADDRTVRI
RTDEADDVKF	RTDEADVKF
RVDENGPEL	RVDENGPEL
SAEEGGAARL	SAEEGGARL
TVDQVLSEV	TVDQVLSEV
YADHPLGM	YADHP-LGM
NAEEKAVLI	NAEEKAVLI
MADGDSFNEM	MADGDSNEM
AADEVREKL	AADEVREKL
KADVEGELL	KADVEGELL
FQDFSHIFL	FQDFSHIFL
YIDKDMIHI	YIDKDMIHI
FIDRKSSL	FIDRK-SSL
AAEEQKTSGIM	AAEEQKSGI
YPDLENPPLL	YPDLENPLL
AADFAQMEL	AADFAQMEL
IGDPEVLEI	IGDPEVLEI
PAYHSSLMD	PAYHSSLMD
FSDHVALL	FSDHV-ALL
YVDDTQFV	YVDDT-QFV
SADRFVTL	SADRF-VTL
FVDLGSSEL	FVDLGSSEL
AVDSVVSL	AVDSV-VSL
FIESSVAKL	FIESSVAKL
YGDSAAKI	YGDSA-AKI
SQDVTTVTL	SQDVTTVTL
VTDEILHL	VTDEI-LHL
QCDKPNKEFM	QCDKPNKEF
KADIGFSFL	KADIGFSFL
STDFPQEGM	STDFPQEGM
FVDGSAIQV	FVDGSAIQV
AAEEPSKV	AAEEP-SKV
FLDKELTGL	FLDKELTGL
IVDIGPDSL	IVDIGPDSL
LADPGPVNF	LADPGPVNF
WSDTANNLM	WSDTANNLM
NYDVDLPFM	NYDVDLPFM
AQDWPATSL	AQDWPATSL
KLDDYVYYV	KLDDYVYYV
VVDEHTGQYV	VVDEHTQYV
YTDELVEL	YTDEL-VEL
LTDEDVKM	LTDED-VKM
FIDISPAEM	FIDISPAEM
YSDAEKVFL	YSDAEKVFL
SADVAAVVM	SADVAAVVM
FVDPAQITM	FVDPAQITM
VADELQKM	VADEL-QKM
ESDSPDSHL	ESDSPDSHL
KIDYEYSEL	KIDYEYSEL
YSDEVRNEL	YSDEVRNEL
YLDGVHTVF	YLDGVHTVF
SSDSSPPEV	SSDSSPPEV
TTDGAHKTFL	TTDGAHTFL
AADPHKADL	AADPHKADL
YAEQGDVQM	YAEQGDVQM
ASDGIIRV	ASDGI-IRV
VTDNPREL	VTDNP-REL
YIDKDCDL	YIDKD-CDL
VADNLAIQL	VADNLAIQL
RTDVPGELL	RTDVPGELL
IADHPDFRF	IADHPDFRF
NADPLGVLI	NADPLGVLI
KQDAFANF	KQDAF-ANF
AADKAEEF	AADKA-EEF
NADIVTLL	NADIV-TLL
VIDEIGKMEL	VIDEIGMEL
HTDIDAAKV	HTDIDAAKV
YQDQEQRI	YQDQE-QRI
IVDRTNNLF	IVDRTNNLF
NSDEIIKL	NSDEI-IKL
ISDSKAQL	ISDSK-AQL
FNDVYQEV	FNDVY-QEV
RIDMETEL	RIDME-TEL
LTDESLSSL	LTDESLSSL
FIDKQLELL	FIDKQLELL
ITDSTVRV	ITDST-VRV
SADEQPHI	SADEQ-PHI
KSDLTTKKV	KSDLTTKKV
VCDPGNIRV	VCDPGNIRV
NGDAIVKF	NGDAI-VKF
FLDNLTEEL	FLDNLTEEL
TADGRVVKL	TADGRVVKL
YLENGKETL	YLENGKETL
NSDNNTIFV	NSDNNTIFV
VVDGHKLEV	VVDGHKLEV
ISDHAIQEL	ISDHAIQEL
SNDIVNAIM	SNDIVNAIM
SIDAETRL	SIDAE-TRL
KQDGSTIHI	KQDGSTIHI
LADLSELQL	LADLSELQL
FSLFGKKK	FSLFG-KKK
KADVVISAF	KADVVISAF
FLDDLLEL	FLDDL-LEL
FTDEESRV	FTDEE-SRV
AIDLVLEEF	AIDLVLEEF
GADIASKEF	GADIASKEF
LVDPWTPHL	LVDPWTPHL
YPETLGRLLIL	YPETLGRLL
VVDVGSTEV	VVDVGSTEV
VFDLHGNRF	VFDLHGNRF
VAPVTHVSV	VAPVTHVSV
HLDTPSKFL	HLDTPSKFL
VADFQRYIL	VADFQRYIL
HLDTHSGL	HLDTH-SGL
FPEEDAEQL	FPEEDAEQL
VSDEMVVEL	VSDEMVVEL
IIDEKKYYL	IIDEKKYYL
TVDDLLSLK	TVDDLLSLK
SGHTFTVNPRR	HTFTVNPRR
TADKYMQM	TADKY-MQM
KADMNVHLL	KADMNVHLL
HTDGIPHLV	HTDGIPHLV
LKDLPIMFDV	LKDLP-IMF
IQDDAVHTL	IQDDAVHTL
SADGKTITV	SADGKTITV
FQDKNHLYL	FQDKNHLYL
SGDGVTHVI	SGDGVTHVI
ILDDSVEM	ILDDS-VEM
HSDQSLSHL	HSDQSLSHL
TADANRVF	TADAN-RVF
LADDKMVRF	LADDKMVRF
AADDHQAL	AADDH-QAL
STDGSVLL	STDGS-VLL
VADTVYRAL	VADTVYRAL
AVDRAITHL	AVDRAITHL
VLDSVDVRL	VLDSVDVRL
YGDKHITL	YGDKH-ITL
TSDDVAKEF	TSDDVAKEF
LSDVAEKL	LSDVA-EKL
LSDGPNDKI	LSDGPNDKI
TTDFPSESSF	TTDFPSSSF
YLEINPLVV	YLEINPLVV
FSDKQIAL	FSDKQ-IAL
FSDFEARQL	FSDFEARQL
VTDEAQSNL	VTDEAQSNL
FTDRDDKIL	FTDRDDKIL
ITDGNSEHL	ITDGNSEHL
LIDGTNEVF	LIDGTNEVF
VYDDGTNTFF	VYDDGTNTF
FADEDEAQAF	FADEDEQAF
LGDKEAVL	LGDKE-AVL
TIDADAPEL	TIDADAPEL
RAEQGKTYL	RAEQGKTYL
EIKDKTAEL	EIKDKTAEL
AIDSPVSF	AIDSP-VSF
FLDVENEL	FLDVE-NEL
ATDISTHSL	ATDISTHSL
SVDTRCSSL	SVDTRCSSL
TIDPGQTGF	TIDPGQTGF
GTDGVGTKL	GTDGVGTKL
ALDKATVL	ALDKA-TVL
RADGAPRSV	RADGAPRSV
VADGSATEM	VADGSATEM
GIDDSVQL	GIDDS-VQL
IIDGKIFCV	IIDGKIFCV
ISDTLGISL	ISDTLGISL
VSDSSALNL	VSDSSALNL
ILDKPQSI	ILDKP-QSI
HQDLSQRV	HQDLS-QRV
AAEAAAAVV	AAEAAAAVV
SADHLAHEV	SADHLAHEV
TIDKNTKI	TIDKN-TKI
IIDEFIYQF	IIDEFIYQF
TADVNSGF	TADVN-SGF
KVDKDAELV	KVDKDAELV
NSDDIGVFL	NSDDIGVFL
KADYTSHL	KADYT-SHL
TVDGKTANL	TVDGKTANL
FIDDANYSVGL	FIDDANYSV
TADAHHYL	TADAH-HYL
VADYMRYL	VADYM-RYL
ASDAAAFL	ASDAA-AFL
FSDNAPPPEL	FSDNAPPEL
NSDEVKSSF	NSDEVKSSF
LGDSGVWGL	LGDSGVWGL
VQDESHSEW	VQDESHSEW
IADPDEMRM	IADPDEMRM
YQDRYQDL	YQDRY-QDL
FADHGQDSSSL	FADHGQSSL
HVDGQRGGVFV	HVDGQRGGV
YGDIIKETM	YGDIIKETM
FLDNAIMIV	FLDNAIMIV
YVDKVSNL	YVDKV-SNL
SVDPRQTQF	SVDPRQTQF
IAEESQIRI	IAEESQIRI
HIDFGGTSV	HIDFGGTSV
SADEPGVMYL	SADEPGMYL
FQDLQVEAL	FQDLQVEAL
LADVATVL	LADVA-TVL
RQDQIQQVV	RQDQIQQVV
TADAPSKDIF	TADAPSKDI
IVDVRPTLV	IVDVRPTLV
IADAHGLL	IADAH-GLL
IIDDALVRL	IIDDALVRL
FADPNMLDTL	FADPNMDTL
VTDSGPTFNYL	VTDSG-PTF
SVDSHFSHL	SVDSHFSHL
FIDEEQAF	FIDEE-QAF
RADLIEVVM	RADLIEVVM
