Data	Data aligned
LLDGFPRTV	LLDGFPRTV
SLPAGPPGV	SLPAGPPGV
KIIEDLGVHF	IIEDLGVHF
VVDEKISAM	VVDEKISAM
FLDNPGILSEL	FLDNPGSEL
MVDERTDYL	MVDERTDYL
ILDDVSLTHLT	ILDDVSTHL
AVDEFLLLL	AVDEFLLLL
TISPIIKLL	TISPIIKLL
LLPEEEQLWAA	LLPEEE-QL
KINDTIYEV	KINDTIYEV
VLMENIVYL	VLMENIVYL
MLPENVAYL	MLPENVAYL
SLPSVPVFLEV	SLPSVPVFL
KSPEGLLGV	KSPEGLLGV
FVDEILTSL	FVDEILTSL
SVDSVLTAL	SVDSVLTAL
ILDNVQVVL	ILDNVQVVL
FLFLDRTYV	FLFLDRTYV
KLDHVVTII	KLDHVVTII
LVPPTPAEI	LVPPTPAEI
YMIPSIRNGIL	MIPSIRNGI
KIYEGAYHV	KIYEGAYHV
VIDPVPAAV	VIDPVPAAV
SLWPMTFGL	SLWPMTFGL
ALWENPESGEL	ALWENPESG
YGLPVVVKL	YGLPVVVKL
VLFDVTGQV	VLFDVTGQV
NLFEWHFTV	NLFEWHFTV
SLPSSPPPQL	SLPSSPPQL
ALEEADKMFL	ALEEADMFL
ILPPDHLNGV	ILPPDHNGV
IIDDNHAIV	IIDDNHAIV
NIPVHLPNI	NIPVHLPNI
LLPEPNILQLL	LLPEPNLQL
FLPSHYNYL	FLPSHYNYL
LLDDRKLEL	LLDDRKLEL
ALDDFSISV	ALDDFSISV
LLPPIVKL	LLPPIV-KL
YVDDVFLRVL	YVDDVFLRV
KLEDFIKNL	KLEDFIKNL
GLLSIFTKV	GLLSIFTKV
KLFNEFIQL	KLFNEFIQL
IIDTLITKL	IIDTLITKL
MMPEEKLVEAL	MMPEEKVEA
RLPPPFPGLEP	RLPPPFPGL
SIDPVPTSI	SIDPVPTSI
MVDGKPVNL	MVDGKPVNL
ATDDSLHQL	ATDDSLHQL
ILDAAGANL	ILDAAGANL
GLDTILQNL	GLDTILQNL
QLDGVRTGL	QLDGVRTGL
SLDAIVASV	SLDAIVASV
LLPEGPPAI	LLPEGPPAI
ILPDITKDEL	ILPDITDEL
AVDVVAIGL	AVDVVAIGL
ALDQEIIEV	ALDQEIIEV
NVDSLITRLL	NVDSLITRL
KLPKPLEKV	KLPKPLEKV
KIVQFIVTL	KIVQFIVTL
LLDKYFGSV	LLDKYFGSV
KVDDVVKRLL	KVDDVVKRL
NLDRLIQNV	NLDRLIQNV
AVDEFYSKI	AVDEFYSKI
FAIDPHLLLSV	AIDPHLLSV
ILPDGSIFSRV	LPDGSISRV
VMYDLITEL	VMYDLITEL
FLPVGFVTL	FLPVGFVTL
IIDPVALEI	IIDPVALEI
NIFPYPVGV	NIFPYPVGV
YLPPGVIAL	YLPPGVIAL
FLDENVHFF	FLDENVHFF
FLFDKVVIV	FLFDKVVIV
SIDRNPPQL	SIDRNPPQL
KIVETIEELKV	KIVETIEEL
GLPTSVPQI	GLPTSVPQI
GIDDLHISL	GIDDLHISL
FLDKVANGL	FLDKVANGL
SVPPPLTSV	SVPPPLTSV
VLWIPAFMV	VLWIPAFMV
IMPNGDHIVSA	IMPNGDHIV
LLDGVPVAL	LLDGVPVAL
SLPPHILEV	SLPPHILEV
LLDYSFQHL	LLDYSFQHL
KVDELTTEI	KVDELTTEI
FLYSGGHRV	FLYSGGHRV
SLPPVIDKMNI	SLPPVIDKM
NLDYAILKL	NLDYAILKL
SLQDEIQRV	SLQDEIQRV
FLPDLQITM	FLPDLQITM
YIIPVVLFL	YIIPVVLFL
YMAELIERL	YMAELIERL
ILPPLLQL	ILPPLL-QL
IVDPFQILV	IVDPFQILV
LLPHPGLKV	LLPHPGLKV
YLHSQVVSV	YLHSQVVSV
ILDSVISAL	ILDSVISAL
FIDDVVSAVL	FIDDVVSAV
VADWVYNEL	VADWVYNEL
YIPSYFDFV	YIPSYFDFV
ISDGVIYSI	ISDGVIYSI
LLPSPTPGL	LLPSPTPGL
NMYGKVVTV	NMYGKVVTV
KLPPLPAV	KLPPLP-AV
TIDPIPHQLL	TIDPIPHQL
FVLPILQKL	FVLPILQKL
HIDTVINAL	HIDTVINAL
YLDDPDLKY	YLDDPDLKY
LLDVVHPAA	LLDVVHPAA
SLDNGGYYI	SLDNGGYYI
FIFSDTHEL	FIFSDTHEL
LFLHAGIVLP	FLHAGIVLP
ALFASGLIHRV	FASGLIHRV
VILDPVHSV	VILDPVHSV
KLPDGTWNL	KLPDGTWNL
RLPEIYIQL	RLPEIYIQL
ILPDGEDFLAV	ILPDGEDFL
ALQEMVHQV	ALQEMVHQV
GLDDMKANL	GLDDMKANL
AAPPPSVTV	AAPPPSVTV
ALPTLIPSV	ALPTLIPSV
VLPDQEMLMKL	VLPDQEMLM
VLDSEYLVTL	VLDSEYVTL
RLPPATLTL	RLPPATLTL
NLPDEEIFQQL	LPDEEIQQL
FVNEIISRI	FVNEIISRI
FMDSVIFTL	FMDSVIFTL
AVDRAITHL	AVDRAITHL
AMPPPPPQGV	AMPPPPQGV
FIDEGVNIGL	FIDEGVIGL
RIFQTLLEV	RIFQTLLEV
LMDESVLKF	LMDESVLKF
YIDAHPETI	YIDAHPETI
RLISKFDTV	RLISKFDTV
LMDWIEAQI	LMDWIEAQI
LLMDRVDEM	LLMDRVDEM
LLDYHLNYL	LLDYHLNYL
LLPDLIQKV	LLPDLIQKV
VLDETRTAYI	VLDETRAYI
FVEEEEHFL	FVEEEEHFL
KVVPVSDPP	KVVPVSDPP
TTEGIPVLIV	TTEGIPVLI
YIDDVFHAL	YIDDVFHAL
ALDPASISV	ALDPASISV
LLPESIPFL	LLPESIPFL
VLDPPVGNTRL	VLDPPVTRL
KLLDLQVRV	KLLDLQVRV
IIDDVDSFL	IIDDVDSFL
HLDPSLANYL	HLDPSLNYL
VLPAEFFEVL	VLPAEFFEV
AVDLYKSL	AVDLYK-SL
VLDELGLSL	VLDELGLSL
LLDEPYLDRL	LLDEPYDRL
VLPPQSQEV	VLPPQSQEV
FLDDLSQKL	FLDDLSQKL
LLDLPFRVGV	LLDLPFVGV
VLDPKPPPL	VLDPKPPPL
ALDDPTPDYM	ALDDPTDYM
VLPLRGFLGI	VLPLRGLGI
ALDNDNYNL	ALDNDNYNL
LVPTSGIYFV	LVPTSGIYF
VQPSVIILL	VQPSVIILL
FLVTVIHTL	FLVTVIHTL
NLDVPHSYSV	NLDVPHYSV
FLIEEQKIVV	FLIEEQKIV
LLYDLADQLHA	LLYDLADQL
LIPPPLAPI	LIPPPLAPI
LLQQRLEEL	LLQQRLEEL
FIDPSSGLAFF	FIDPSSLAF
LTDTFYYRL	LTDTFYYRL
IIDDALVRL	IIDDALVRL
LLKDSIVQL	LLKDSIVQL
NLPGVLPAL	NLPGVLPAL
VMAPRTLVL	VMAPRTLVL
FLPFLTTEV	FLPFLTTEV
YLPDTDDRHRI	YLPDTDDRH
LIDEPSAYL	LIDEPSAYL
LLDDSLVSI	LLDDSLVSI
KLPPPPPQA	KLPPPPPQA
VLPSIVNEV	VLPSIVNEV
SSIPPVFQL	SSIPPVFQL
SLASFIPAV	SLASFIPAV
YLLEKFVAV	YLLEKFVAV
SLIGHLQTL	SLIGHLQTL
VLIDYQRNV	VLIDYQRNV
QIEDRIFEV	QIEDRIFEV
MIDPDIYLL	MIDPDIYLL
FAPPQPVAA	FAPPQPVAA
FLPEFAGTQL	FLPEFATQL
SLDEVDHKI	SLDEVDHKI
LLDEQFAVL	LLDEQFAVL
AVDAFFTAV	AVDAFFTAV
TMPSDVLEV	TMPSDVLEV
YVSPKQFSV	YVSPKQFSV
NIDSIFIVL	NIDSIFIVL
FLDQVAHKL	FLDQVAHKL
LSPEFFTSV	LSPEFFTSV
NVDEGIYQL	NVDEGIYQL
SLDDVMDYL	SLDDVMDYL
ITPENLPQI	ITPENLPQI
YLWLKLNQV	YLWLKLNQV
DLDDLYVHL	DLDDLYVHL
SLDQPTQTV	SLDQPTQTV
ILDLIQVFV	ILDLIQVFV
VLPAEFFEV	VLPAEFFEV
LVFEGIMEV	LVFEGIMEV
IAPPEAEGV	IAPPEAEGV
FMDGIQISL	FMDGIQISL
ALWGFFPVL	ALWGFFPVL
RIFGESIMIGV	FGESIMIGV
FLLETVVRV	FLLETVVRV
TIDDLEDKL	TIDDLEDKL
LLGEVLTQL	LLGEVLTQL
LMQTEFHHV	LMQTEFHHV
TLPPVLPGSHI	TLPPVLPGS
GLPEEIEELRV	GLPEEIEEL
IVDDWLNLL	IVDDWLNLL
LTDNVMITV	LTDNVMITV
KLEELIGIGL	KLEELIIGL
LLDQVQTVL	LLDQVQTVL
KVFDPVPVGV	KVFDPVVGV
FVPPPLDQEEM	FVPPPLDQE
KVDEAIALF	KVDEAIALF
FLDASGAKL	FLDASGAKL
YLVVKIEKV	YLVVKIEKV
YIGEVLVSV	YIGEVLVSV
LLSEILHLL	LLSEILHLL
ILYDKYFSL	ILYDKYFSL
KLWQTPLHV	KLWQTPLHV
ILPPTILTL	ILPPTILTL
ATMPVVPSV	ATMPVVPSV
AVPDEILIEAV	AVPDEIIEA
VLDTGASIHL	VLDTGAIHL
LVIDVIHEV	LVIDVIHEV
FQDQVLDLL	FQDQVLDLL
VIDSLTVKI	VIDSLTVKI
WLDSVHQLL	WLDSVHQLL
TLPPPPSGL	TLPPPPSGL
SLSAIFNNV	SLSAIFNNV
YLPDCPEGNKV	YLPDCPNKV
VVDHLLDIYI	VVDHLLIYI
YLPRHSIGL	YLPRHSIGL
AIQDKLFQV	AIQDKLFQV
FLPEAPAELL	FLPEAPAEL
VLSDIIQNL	VLSDIIQNL
SMDHIQAEL	SMDHIQAEL
VLYELFTYI	VLYELFTYI
ILNPEVVTV	ILNPEVVTV
VLDDVPVQGF	VLDDVPVQG
NLPDIVSKV	NLPDIVSKV
ILPHSPINV	ILPHSPINV
GLPHWVPAL	GLPHWVPAL
YVDPVNKVL	YVDPVNKVL
ALYPVLEKA	ALYPVLEKA
YIDLPPPRL	YIDLPPPRL
YLPDAVKGL	YLPDAVKGL
FIDFTYVRV	FIDFTYVRV
GLIDKVNEL	GLIDKVNEL
QMPETTETV	QMPETTETV
IVDQTIEKV	IVDQTIEKV
HLPLPGPTL	HLPLPGPTL
NLLKLIAEV	NLLKLIAEV
KIWAPTAEA	KIWAPTAEA
IVDSFDDMNL	IVDSFDMNL
YLDHFSRAL	YLDHFSRAL
NLDAVHDITV	NLDAVHITV
ILDEVDVHI	ILDEVDVHI
FLDYTTDNM	FLDYTTDNM
YLDEAYPGKKL	YLDEAYPGK
TIDDLEEKL	TIDDLEEKL
FLFGEVHKA	FLFGEVHKA
SLPDFGISYV	SLPDFGSYV
LQDDIPTTF	LQDDIPTTF
AVDALIDSM	AVDALIDSM
FVDLEPTVI	FVDLEPTVI
ILDEDKESTF	ILDEDKSTF
NIPLPLGTV	NIPLPLGTV
FILDFYEKV	FILDFYEKV
AVHKLLTLI	AVHKLLTLI
FLFEPVVKA	FLFEPVVKA
VMDHVSDSFL	VMDHVSSFL
TLEEIIFKL	TLEEIIFKL
KLDWVEVGL	KLDWVEVGL
RIKELPELWL	RIKELP-EL
KDYPFYLTV	KDYPFYLTV
LLEPFVHQV	LLEPFVHQV
KIVVVTAGV	KIVVVTAGV
SLDKFLANV	SLDKFLANV
ILDSVASVV	ILDSVASVV
SMPEQAHKV	SMPEQAHKV
GAPVYLAAV	GAPVYLAAV
LLEYHIAYL	LLEYHIAYL
FLTAVAHRL	FLTAVAHRL
AINPKLLQL	AINPKLLQL
RIDDLQMVL	RIDDLQMVL
LLFDSVIHL	LLFDSVIHL
SVPQSLPSL	SVPQSLPSL
RLDPHPELL	RLDPHPELL
YLRGGAITEV	YLRGGATEV
TEADKSTVI	TEADKSTVI
LVDDHFVEL	LVDDHFVEL
YVDNRFFTL	YVDNRFFTL
SLDKDIVAL	SLDKDIVAL
ILDDSFIEGV	ILDDSFEGV
KVDSPTVNTTL	KVDSPTVNT
KVVPTFEAV	KVVPTFEAV
GLDAIITQL	GLDAIITQL
FVDDVTIEDL	FVDDVTEDL
SLDEAYLNI	SLDEAYLNI
FLDDGVDEQV	FLDDGVEQV
LLDEPFLQF	LLDEPFLQF
SIDPVTVSI	SIDPVTVSI
ILTDITKGV	ILTDITKGV
AVDWIFSHI	AVDWIFSHI
SLDGRPPSL	SLDGRPPSL
LLPEEQVYL	LLPEEQVYL
YLNDFTHEI	YLNDFTHEI
YLDEEFVLRV	YLDEEFLRV
GVIELYVKL	GVIELYVKL
SLDFLIELL	SLDFLIELL
YLEAIHNFV	YLEAIHNFV
VLPPTVYL	VLPPTV-YL
TLPELTFLL	TLPELTFLL
ALLDKLYAL	ALLDKLYAL
KVVALVHAV	KVVALVHAV
RLDEARQML	RLDEARQML
EVVEEAENGR	VVEEAENGR
GLDPVGRIQM	GLDPVGIQM
ALDETGKETFL	ALDETGETF
ALDSLVLQM	ALDSLVLQM
IMDSLFQSF	IMDSLFQSF
NLDPIALKL	NLDPIALKL
GMDDIFSHI	GMDDIFSHI
ALDDFYKML	ALDDFYKML
SVPDPELIDLI	SVPDPEIDL
FLHEVLWEL	FLHEVLWEL
LLNEPDGTFLL	LLNEPDTFL
YLVPELDGV	YLVPELDGV
YVDAAYKPGM	YVDAAYPGM
LLPEEFISL	LLPEEFISL
TLDQTLNEL	TLDQTLNEL
YLDEDTIYHL	YLDEDTYHL
VLYHVETEV	VLYHVETEV
KMPEVITIHL	KMPEVIIHL
SMPDVDLHV	SMPDVDLHV
IIDEADRMI	IIDEADRMI
WLDDVEERL	WLDDVEERL
TVIDYFHQL	TVIDYFHQL
ALPPVLTTV	ALPPVLTTV
LLDEFYKLV	LLDEFYKLV
ILDQPYDVNL	ILDQPYVNL
AVVPGLLEV	AVVPGLLEV
FLPDEPYIKV	FLPDEPIKV
FIDGNVESL	FIDGNVESL
KVLELQTEL	KVLELQTEL
GIIDAFHQI	GIIDAFHQI
TLDQINQEL	TLDQINQEL
LLPPEPDYSL	LLPPEPYSL
QTPQRLLEV	QTPQRLLEV
YGPGLTHGV	YGPGLTHGV
SLEKSVLLEL	SLEKSVLEL
SLDQIFETL	SLDQIFETL
HLMEENMIVYV	LMEENMVYV
VVDFVAATL	VVDFVAATL
FVDKYSISL	FVDKYSISL
YLEEAPKFL	YLEEAPKFL
ALGNTGHEIGR	ALGNTGHEI
YLPPATQVV	YLPPATQVV
RIDEFIVKL	RIDEFIVKL
NVDEIFLKL	NVDEIFLKL
SLFSVIVRV	SLFSVIVRV
LLPEPLVSI	LLPEPLVSI
SLPEVLNHNL	SLPEVLHNL
LLDEQTSLL	LLDEQTSLL
AMDPIAELL	AMDPIAELL
YIDEEGVRYV	YIDEEGRYV
GLDALKVTV	GLDALKVTV
LLPAASELAHV	LLPAASELA
LEDGNFLKL	LEDGNFLKL
LLDEVLHTM	LLDEVLHTM
LMPRPLPYHL	LMPRPLYHL
LMPQVLTTL	LMPQVLTTL
TLDEIIDNHI	TLDEIINHI
VLDDLLYAV	VLDDLLYAV
YVDRGYFSI	YVDRGYFSI
AIDDIYFQA	AIDDIYFQA
AVVAHAYYL	AVVAHAYYL
VIIDDHPEVTV	IIDDHPVTV
FLPEPMGTA	FLPEPMGTA
TLPVDFVTA	TLPVDFVTA
AILEKMPLV	AILEKMPLV
FLPDHPIVL	FLPDHPIVL
LLDTIRDEI	LLDTIRDEI
KIDRLILEL	KIDRLILEL
FIPDQPFRV	FIPDQPFRV
YLTDRVMTV	YLTDRVMTV
SLENIYKEL	SLENIYKEL
YMPDLHPAA	YMPDLHPAA
FLDEKTHELL	FLDEKTHEL
SVPATVPSI	SVPATVPSI
AVDEAVILL	AVDEAVILL
SLDERIYVKM	SLDERIVKM
KLPWPEWMGV	KLPWPEMGV
KLDPYVQRL	KLDPYVQRL
KLEEFVNGL	KLEEFVNGL
VVDPNQVNV	VVDPNQVNV
FVDMVARPSM	FVDMVAPSM
IREEYPDR	IREEYP-DR
MLGERLFPL	MLGERLFPL
TLSERLWGL	TLSERLWGL
FVDDQQTFF	FVDDQQTFF
ALFVKTKEV	ALFVKTKEV
QLDQPSWSGRL	QLDQPSWSG
SFPDSLPEV	SFPDSLPEV
YLLDQHILI	YLLDQHILI
YLVEDIQHI	YLVEDIQHI
YVIDPIKGLKL	VIDPIKLKL
SVDDIVKGI	SVDDIVKGI
GLPDAPRNLQL	GLPDAPRNL
NLDPLVYLL	NLDPLVYLL
LLFDVHTTL	LLFDVHTTL
VVPDKISEV	VVPDKISEV
RSDDIYNQV	RSDDIYNQV
ILWDTLLRL	ILWDTLLRL
TLDNILSHI	TLDNILSHI
LLLNELPSV	LLLNELPSV
TPGNRIVYL	TPGNRIVYL
VAPNDIPLV	VAPNDIPLV
HLDGIVQVL	HLDGIVQVL
KLDEDVKMI	KLDEDVKMI
SLPHNIIEL	SLPHNIIEL
KVDKLYAGL	KVDKLYAGL
VLDHTYQEL	VLDHTYQEL
VMPAGVDKI	VMPAGVDKI
KIDSILEVV	KIDSILEVV
KLPAPLPGL	KLPAPLPGL
IIDELIKKL	IIDELIKKL
QVDSLIMQI	QVDSLIMQI
FLKDKFVEI	FLKDKFVEI
IMDDKSLNI	IMDDKSLNI
YLLPAIVHI	YLLPAIVHI
ALSDIFQAV	ALSDIFQAV
SLNEYQPKL	SLNEYQPKL
VMPHTTPEL	VMPHTTPEL
ALDTPVMVHM	ALDTPVVHM
ALDKATVLL	ALDKATVLL
VVDEIAAKL	VVDEIAAKL
SLDEKQNLV	SLDEKQNLV
AMINRFQFV	AMINRFQFV
VVDGAFKEV	VVDGAFKEV
LLDDTTVTL	LLDDTTVTL
KLDFANNVQL	KLDFANVQL
ILDEPTNHLDM	ILDEPTNHL
SLLDIIEKV	SLLDIIEKV
LLDPSVFHV	LLDPSVFHV
LLDSAPLNV	LLDSAPLNV
SVDDIHFLVL	SVDDIHFLV
NGPELLPRV	NGPELLPRV
SLPEFQESV	SLPEFQESV
KIDDVLHTL	KIDDVLHTL
ALPDQGIAKA	ALPDQGAKA
NIPEITPFL	NIPEITPFL
YTPPPPPTA	YTPPPPPTA
LEEDVKIYL	LEEDVKIYL
VVDAIPVFL	VVDAIPVFL
FIGHALQWTI	FIGHALWTI
KLPELWAL	KLPELW-AL
ALWEALLNT	ALWEALLNT
ALDGFVMVL	ALDGFVMVL
ILDESDHITM	ILDESDITM
FLDNERHEV	FLDNERHEV
ALDTGFSLNL	ALDTGFLNL
FLPDGMEARL	FLPDGMARL
SLIDIVTEI	SLIDIVTEI
NVDQAFHEL	NVDQAFHEL
LLPVDIRQYL	LLPVDIQYL
FVDGLNFSL	FVDGLNFSL
FLQPELVKL	FLQPELVKL
FLNKEITSV	FLNKEITSV
KIDAFHYIQL	KIDAFHIQL
LLPSKLASV	LLPSKLASV
ELDKIYETL	ELDKIYETL
LLDEVALEGL	LLDEVAEGL
FLDHEMVFL	FLDHEMVFL
FLPPLPTSV	FLPPLPTSV
TMDDFRWAL	TMDDFRWAL
FLDFLTRPEL	FLDFLTPEL
YLDPDAQKLDF	YLDPDAQKL
VLPPSALQSV	VLPPSAQSV
TLLDPNEKYLL	LLDPNEKYL
RVDAVASKV	RVDAVASKV
AIAPIIAAV	AIAPIIAAV
NIDLVVKEL	NIDLVVKEL
VLWPESISV	VLWPESISV
LAPPPPPGL	LAPPPPPGL
FLDKQGFYV	FLDKQGFYV
QIDDLYSTIKV	QIDDLYSTI
KLDVQFSGL	KLDVQFSGL
LVDAIHNQL	LVDAIHNQL
NLPDEIYHV	NLPDEIYHV
FIDVGGYKL	FIDVGGYKL
VQPIKLARV	VQPIKLARV
YMPPPYASL	YMPPPYASL
YLSPTFKEV	YLSPTFKEV
YLPQLFYHL	YLPQLFYHL
YLDWTIERV	YLDWTIERV
IIEDKTFGL	IIEDKTFGL
FVDNPVGTGF	FVDNPVTGF
FVDPNGKISL	FVDPNGISL
SLFEGTWYL	SLFEGTWYL
YLPPEMIEGRM	YLPPEMIEG
YLDKFIRLL	YLDKFIRLL
LLPDQIEKL	LLPDQIEKL
NLPTFLVEL	NLPTFLVEL
ALDEAQGVGL	ALDEAQVGL
QLIDKVWQL	QLIDKVWQL
RGPPQPLPAV	GPPQPLPAV
KQPPIDNIIRA	KQPPIDNII
ILNPVTTKL	ILNPVTTKL
YLTPLILTL	YLTPLILTL
LLPPVFNI	LLPPVF-NI
LLIPGLATA	LLIPGLATA
FVDDSGRYLAI	FVDDSGRYL
FLDDVFEVKL	FLDDVFVKL
VMDETHVINQV	VMDETHNQV
VIDSDLDVLL	VIDSDLVLL
KLQEKIQEL	KLQEKIQEL
LLPEYVVPYM	LLPEYVPYM
KLFSILSTV	KLFSILSTV
ILPQHLYNI	ILPQHLYNI
YLDPPNERLIL	YLDPPNERL
TVDDLVAEI	TVDDLVAEI
LLPGSEAGVSV	LLPGSEAGV
VLFGLLREV	VLFGLLREV
GLMTTVHAI	GLMTTVHAI
NMDFVFDRM	NMDFVFDRM
AIYHVIMSV	AIYHVIMSV
LIMELINNV	LIMELINNV
KLNAKLAEL	KLNAKLAEL
KLPAFSPLM	KLPAFSPLM
FAPGDLPEL	FAPGDLPEL
NLDAAVYQV	NLDAAVYQV
ILGPKPQGV	ILGPKPQGV
LMDSIVKNV	LMDSIVKNV
VLDGVKAEL	VLDGVKAEL
LLDSGAFHL	LLDSGAFHL
KVPAEEVLVAV	KVPAEEVLV
SLDDIYMIGV	SLDDIYIGV
RMLPHAPGV	RMLPHAPGV
TLDDIMAAV	TLDDIMAAV
REYSFEYV	REYSFE-YV
YVDSEGIVRM	YVDSEGVRM
IIDQIQDAL	IIDQIQDAL
LLPLPFEEL	LLPLPFEEL
ILPNIEAVSNV	ILPNIE-AV
VLDDVGHGV	VLDDVGHGV
SIDEIVQRV	SIDEIVQRV
LVDDYTFNV	LVDDYTFNV
ILPEELQAWV	ILPEELAWV
FLGIHVFLV	FLGIHVFLV
ILPLMKFLEV	ILPLMKLEV
SLPEELNRV	SLPEELNRV
ALDPADQHL	ALDPADQHL
LLDDIFAQL	LLDDIFAQL
KVLGIVVGV	KVLGIVVGV
SLDKFYKQV	SLDKFYKQV
KVDMQWVQV	KVDMQWVQV
LLYGHTVTV	LLYGHTVTV
KLDDLTQDL	KLDDLTQDL
AGFAGDDAPR	AGDDAP---
QMPETTETVL	QMPETTETV
AVPEVAVYL	AVPEVAVYL
LVDTNFINF	LVDTNFINF
MVDVIWRQL	MVDVIWRQL
ILPDTYQHL	ILPDTYQHL
IIDEFIYQF	IIDEFIYQF
RLDDVSNDVRM	RLDDVSNDV
HYGPGWVSM	HYGPGWVSM
IMDRIYKNV	IMDRIYKNV
ALDDMISTL	ALDDMISTL
VIDRILYKL	VIDRILYKL
RIPAYFVTV	RIPAYFVTV
VTSEPHEVSAL	SEPHEVSAL
LLDPCAEMEL	LLDPCAMEL
RLPETIDLGAL	RLPETILGA
GLDDIKDLKV	GLDDIKLKV
KILPTLEAV	KILPTLEAV
GVDDLDFFI	GVDDLDFFI
QLPEPLPGL	QLPEPLPGL
LLDHLHLEL	LLDHLHLEL
MLFENMGAYTV	MLFENMAYT
SLDPKTNTL	SLDPKTNTL
FLPQKIIYL	FLPQKIIYL
SLPEDFYHF	SLPEDFYHF
KMDEVLYSIAE	KMDEVLYSI
ILDQKINEV	ILDQKINEV
ILEENIPVL	ILEENIPVL
MVDVIFADV	MVDVIFADV
ILPGLSVMGV	ILPGLSMGV
LLDSCTKLL	LLDSCTKLL
LLPVPVPAV	LLPVPVPAV
NVDQAVATL	NVDQAVATL
LLPGVIKTV	LLPGVIKTV
LLPENLKEGL	LLPENLEGL
SLIKYFLFV	SLIKYFLFV
YIPTELDQV	YIPTELDQV
VLDFPSSATGL	VLDFPSSAT
ILPERAEEA	ILPERAEEA
HVDPGPTPI	HVDPGPTPI
FLDSLRDLI	FLDSLRDLI
YVPETVYRV	YVPETVYRV
SLDDSAKKVLL	SLDDSAKKV
FLDELAQKL	FLDELAQKL
IILDEIHLL	IILDEIHLL
MVLPLLIFV	MVLPLLIFV
LLPDNVHYV	LLPDNVHYV
GLPSNISSV	GLPSNISSV
MLPVRLATA	MLPVRLATA
KIIEYSVYL	KIIEYSVYL
FLPSYIIDV	FLPSYIIDV
YIDTFFEDL	YIDTFFEDL
VLDELDMEL	VLDELDMEL
KLHGVNINV	KLHGVNINV
QLDSVRVWL	QLDSVRVWL
RLWEKLTLL	RLWEKLTLL
LLYDNVPGA	LLYDNVPGA
LGPEVFQAYDP	LGPEVFQAY
YVDSIQRKL	YVDSIQRKL
ALDEGRSILL	ALDEGRILL
LLNEILEQV	LLNEILEQV
ILDEVIMGY	ILDEVIMGY
MLAEKLPNL	MLAEKLPNL
FLYPFPLAL	FLYPFPLAL
LQPDEDTIFFV	LQPDEDTIF
MLPNQAQSPHL	MLPNQAQSP
ALEAVVISV	ALEAVVISV
YLPDSIVEL	YLPDSIVEL
QIDNLATEL	QIDNLATEL
FLDSELSML	FLDSELSML
TLQEFLERI	TLQEFLERI
YVDTAVRHV	YVDTAVRHV
LLDYGFYLL	LLDYGFYLL
QLDDSILNI	QLDDSILNI
VIPEPSKLPYI	VIPEPS-KL
LLPKEIVKV	LLPKEIVKV
RLDNGQVGL	RLDNGQVGL
HLPDMHSEL	HLPDMHSEL
FLSMYLCMHI	FLSMYLMHI
ALDYRPLYL	ALDYRPLYL
YLDNLLVRF	YLDNLLVRF
MMPAVFHTV	MMPAVFHTV
YLTHDSPSV	YLTHDSPSV
QLEGFFLHL	QLEGFFLHL
FLVDKYEIL	FLVDKYEIL
TLIDLYEQV	TLIDLYEQV
KMPDVELFVNL	KMPDVELFV
FLLDPYKYMTL	LLDPYKMTL
FLDTLKDLI	FLDTLKDLI
SMDEINKQL	SMDEINKQL
ILDRVADGMVF	ILDRVADGM
LLPGPVTLV	LLPGPVTLV
YLSVKIWDL	YLSVKIWDL
LLDDHGHIRI	LLDDHGIRI
LLPPAPPHA	LLPPAPPHA
RLPWVNPYM	RLPWVNPYM
VLWSVLQQI	VLWSVLQQI
FQDDDQTRV	FQDDDQTRV
ILHDDEVTV	ILHDDEVTV
FVMETFVHL	FVMETFVHL
SLPSSKEVAEL	SLPSSKEVA
FLDDFESKYSF	FLDDFESKY
FLDWPQGTF	FLDWPQGTF
GLDEAFSRL	GLDEAFSRL
FLDEVSRQQEL	FLDEVSQEL
TVNPIIYAL	TVNPIIYAL
ALDNVDARMYM	ALDNVDARM
MLDEPTNHLDL	MLDEPTNHL
KLPEPSASL	KLPEPSASL
YLQEIQTQL	YLQEIQTQL
NLDVPHSYSVL	NLDVPHYSV
LLWDYVYQL	LLWDYVYQL
LLPQDVHLL	LLPQDVHLL
ALIEAEKVAQV	ALIEAEKVA
LLPPPPCPA	LLPPPPCPA
LLPDLAAKA	LLPDLAAKA
KIDGVEDML	KIDGVEDML
MLFGHPLLV	MLFGHPLLV
FLPDPSALQNL	FLPDPS-AL
SLPESDKIAEI	SLPESDKIA
ALIEKLVEL	ALIEKLVEL
LLPSHPLEL	LLPSHPLEL
SLPGNFFYL	SLPGNFFYL
ILVDWLVQV	ILVDWLVQV
SLDAIIEFL	SLDAIIEFL
KLYNPENIYL	KLYNPEIYL
ALPPDVTTQSV	ALPPDVTTQ
FLDHIGGTRL	FLDHIGTRL
VLPEIDPVLF	VLPEIDPVL
TLDPLISQL	TLDPLISQL
KIFNPVLNV	KIFNPVLNV
ALDKATVLLSM	ALDKATVLL
VTDAVALRV	VTDAVALRV
VLDIMPLTL	VLDIMPLTL
YIIDVSQSV	YIIDVSQSV
LLPEDFLML	LLPEDFLML
GVDEKGPQL	GVDEKGPQL
YLPDKLPKV	YLPDKLPKV
VLIKWFPEV	VLIKWFPEV
VVDDGVEHTI	VVDDGVHTI
LLMEHIFKL	LLMEHIFKL
RIFPPETSASV	FPPETSASV
AIIALFHLL	AIIALFHLL
KMDWIFHTI	KMDWIFHTI
PERSIFSAI	PERSIFSAI
SSPETLPSL	SSPETLPSL
FIDDIELMF	FIDDIELMF
GLDQQYDIYL	GLDQQYIYL
ALDVSHNLL	ALDVSHNLL
VLDNVKMNL	VLDNVKMNL
LLPDVFDDL	LLPDVFDDL
TFTVTEKPEVI	TVTEKPEVI
KLPGVYEV	KLPGVY-EV
LVDNITGQRL	LVDNITQRL
YLDSIPPGQYM	YLDSIPPGQ
YLYEVSQLKD	YLYEVS-QL
FLVPTFEQL	FLVPTFEQL
MIDPPRAAV	MIDPPRAAV
ALPNVYEVI	ALPNVYEVI
FLDGIYKTI	FLDGIYKTI
AMPSWFDII	AMPSWFDII
LVELALPQL	LVELALPQL
SLDEPYEKV	SLDEPYEKV
SLEELIKWL	SLEELIKWL
RLYHITDQV	RLYHITDQV
RVDKITEYL	RVDKITEYL
RLPPDTLLQQV	LPPDTLQQV
ILPDITKDELF	ILPDITDEL
IMLEALERV	IMLEALERV
FQDIIWVKL	FQDIIWVKL
SVDSVSNNL	SVDSVSNNL
GLVRPPPGL	GLVRPPPGL
LLVDEFLKV	LLVDEFLKV
ALDESHNQNL	ALDESHQNL
NIYAVKTAV	NIYAVKTAV
VQPEATQVPLV	VQPEATVPL
ALFDAQAQV	ALFDAQAQV
YLADLYHFV	YLADLYHFV
KLEDVLPLAF	KLEDVLPLA
AIIEYMPLL	AIIEYMPLL
RLDFVLTSL	RLDFVLTSL
IVDEPTFKV	IVDEPTFKV
FLFDRPMHV	FLFDRPMHV
VLDEADKLL	VLDEADKLL
FLDNLTEEL	FLDNLTEEL
RLDNITQVM	RLDNITQVM
LLDEPTNHLDL	LLDEPTNHL
ALYAVIEKA	ALYAVIEKA
ALDNVDARM	ALDNVDARM
LLHELLTHV	LLHELLTHV
GLPGPEGIVGI	GLPGPEGIV
LLDNDHYAM	LLDNDHYAM
YIPHPFLVV	YIPHPFLVV
RLPPEGILHNV	LPPEGIHNV
VLPPDVLTRV	VLPPDVTRV
FIDDANYSV	FIDDANYSV
LLLEAVWHL	LLLEAVWHL
VLDVIHEVL	VLDVIHEVL
SLRDLPAQLL	SLRDLPAQL
FLVHNVKEL	FLVHNVKEL
NIDTFIEHL	NIDTFIEHL
SIDDVVKKL	SIDDVVKKL
LIDEGETDWKL	LIDEGEWKL
SLPDIKVYL	SLPDIKVYL
LVDDLVDSL	LVDDLVDSL
KLQEFLQTL	KLQEFLQTL
YLEQKVVEL	YLEQKVVEL
VQPEEFVAI	VQPEEFVAI
ALDNGLFTL	ALDNGLFTL
TVDLVINQL	TVDLVINQL
YIDEQFERYL	YIDEQFRYL
SLEGIPLAQV	SLEGIPAQV
GLDISHISQRL	GLDISHISQ
QLWNIFNQV	QLWNIFNQV
RIDAVTPTL	RIDAVTPTL
QLDELMAHL	QLDELMAHL
YLPEDFIRVG	YLPEDFIRV
QLPDIYPDL	QLPDIYPDL
SLDDLTNLVV	SLDDLTNLV
KIVPIAIQL	KIVPIAIQL
IISNPRDIQM	IISNPRIQM
TLYEAVREV	TLYEAVREV
KVDPMAIVV	KVDPMAIVV
MVDDRLVTM	MVDDRLVTM
RVDDIFSDL	RVDDIFSDL
YLWDLDHGFA	YLWDLDHGF
IVPHLVPLL	IVPHLVPLL
VLPAVLTRL	VLPAVLTRL
RLDDVSNDV	RLDDVSNDV
FVLPVATQI	FVLPVATQI
QLDEVRQAM	QLDEVRQAM
ALDKITASL	ALDKITASL
ITPQTIHGV	ITPQTIHGV
AVHLYISAL	AVHLYISAL
NVPEIMPKL	NVPEIMPKL
HIDTILHVL	HIDTILHVL
QMDIIVSEV	QMDIIVSEV
LLVTWKQV	LLVTWK-QV
YVPDVTGRYTI	YVPDVTRYT
ALDENMDLL	ALDENMDLL
ALDDLIDTL	ALDDLIDTL
YIDDLVVIL	YIDDLVVIL
ALEEELAGL	ALEEELAGL
FLDNSLDTV	FLDNSLDTV
SVDELFAEI	SVDELFAEI
NLPAPHIMPGV	NLPAPHIMP
KMDEVLYSIA	KMDEVLYSI
FVDRGFYSV	FVDRGFYSV
SLSTVFVVL	SLSTVFVVL
LVDENQFTL	LVDENQFTL
YIDQGIAEL	YIDQGIAEL
SSVEVRSDWEV	SVEVRSWEV
ILPDEDPEL	ILPDEDPEL
ITPQKLPSL	ITPQKLPSL
FLLDGFPRTV	LLDGFPRTV
ILWSEAIFL	ILWSEAIFL
VLVDAFSHV	VLVDAFSHV
VLDEADRMI	VLDEADRMI
NLDNPIQTV	NLDNPIQTV
GLPDNISSV	GLPDNISSV
ILDEADKLL	ILDEADKLL
VADLVGFLL	VADLVGFLL
VHSLLSRLMSI	SLLSRLMSI
TLNEKLTAL	TLNEKLTAL
FQDEINWRL	FQDEINWRL
FLDRESIKL	FLDRESIKL
SVPDTLPTA	SVPDTLPTA
FLQEQLVEL	FLQEQLVEL
KVIVRFLTV	KVIVRFLTV
ALITRIFGV	ALITRIFGV
LTDKSCQSFIS	LTDKSCQSF
ILDEATSAL	ILDEATSAL
YLIELIDRV	YLIELIDRV
SMPDVELNL	SMPDVELNL
SLPEVGTKL	SLPEVGTKL
FLWEAESHA	FLWEAESHA
KVIDEIYRV	KVIDEIYRV
LLWKSGPVV	LLWKSGPVV
AVDGVIFQL	AVDGVIFQL
KLILLITQV	KLILLITQV
LLPGFLQAV	LLPGFLQAV
HIIENIVAV	HIIENIVAV
YLQDVIMQV	YLQDVIMQV
HIDSFIENL	HIDSFIENL
IMEDIILTL	IMEDIILTL
ALPMVLVLL	ALPMVLVLL
FLPEAFDFI	FLPEAFDFI
SLVEQLTMV	SLVEQLTMV
SLYEMVSRV	SLYEMVSRV
NLPEELRKV	NLPEELRKV
AADEVFSHI	AADEVFSHI
FINELITEL	FINELITEL
YLPPTVITI	YLPPTVITI
LLPQILENL	LLPQILENL
ILPSNLLTV	ILPSNLLTV
RVDEVFEDAF	RVDEVFEDA
KTDVVVNSV	KTDVVVNSV
QLDQVTAKL	QLDQVTAKL
SVDDIVKGINS	SVDDIVKGI
ILDEQLYSF	ILDEQLYSF
YLDAIRSGL	YLDAIRSGL
TLPTVIAEL	TLPTVIAEL
YIPSVLHDV	YIPSVLHDV
KLPEISHRL	KLPEISHRL
ALPVKLIGM	ALPVKLIGM
LLPEIMPGLI	LLPEIMPGL
YLPYPIHQV	YLPYPIHQV
IVDEVNGLI	IVDEVNGLI
IIEENIPEL	IIEENIPEL
FLSSVIQNL	FLSSVIQNL
FILEKIEYL	FILEKIEYL
VVDPVTSEHEL	VVDPVTHEL
KIDPDLGYSF	KIDPDLYSF
ILDIIFQDF	ILDIIFQDF
KLPAELQEL	KLPAELQEL
SMPDVDLHL	SMPDVDLHL
LVDEIMRAGM	LVDEIMAGM
ILPQESPAL	ILPQESPAL
AVVEFLTSV	AVVEFLTSV
AVDGISLHL	AVDGISLHL
VMPSSFFLL	VMPSSFFLL
KIPTPIVGV	KIPTPIVGV
NLPNTNSILGV	NLPNTNSIL
AAPDIVPAL	AAPDIVPAL
IIIDSVPEV	IIIDSVPEV
LLPTIVEKV	LLPTIVEKV
NLYPFVKTV	NLYPFVKTV
ILDWKFDRV	ILDWKFDRV
GLDIPTVQV	GLDIPTVQV
RLDEVLRTL	RLDEVLRTL
SLDEPSVKTM	SLDEPSVKT
NLDVPTFVSF	NLDVPTVSF
AVDDVPFSI	AVDDVPFSI
RLDDLFLESF	RLDDLFESF
IILPEMVGSMV	ILPEMVSMV
HVDDVSSAL	HVDDVSSAL
NLPEETNEL	NLPEETNEL
SLPLFIVTL	SLPLFIVTL
QLVDIIEKV	QLVDIIEKV
ILDDPGKKV	ILDDPGKKV
RLPDPFAKI	RLPDPFAKI
KLLEVQPQV	KLLEVQPQV
QLDSAVKNL	QLDSAVKNL
TIDEGYVYGL	TIDEGYYGL
YADQLKEYL	YADQLKEYL
YVNLPTIAL	YVNLPTIAL
WLEENVHEV	WLEENVHEV
VLPPVPTEGL	VLPPVPEGL
ISSHVDLGL	ISSHVDLGL
VLDAHFLVL	VLDAHFLVL
YLDWDVSEL	YLDWDVSEL
YMDTLNIFM	YMDTLNIFM
ILDEAHERTI	ILDEAHRTI
RLPGSGAVQAA	RLPGSGVQA
SVLDLVVAL	SVLDLVVAL
LLYENITFV	LLYENITFV
SLDDPNRISL	SLDDPNISL
KLQDQIFNL	KLQDQIFNL
ILWQLTGSAA	ILWQLTSAA
ALDPMSVLL	ALDPMSVLL
HLDQIIPRM	HLDQIIPRM
SLPLYFVSA	SLPLYFVSA
SLPELTHAL	SLPELTHAL
AVDAIFTRI	AVDAIFTRI
YIDKDLEYV	YIDKDLEYV
MMLDDLLQL	MMLDDLLQL
FLPFSFEHI	FLPFSFEHI
FVDDYTVRV	FVDDYTVRV
EMPSVFQNV	EMPSVFQNV
VLDELPPLI	VLDELPPLI
KLPPLPLTL	KLPPLPLTL
GIDPPRGVLM	GIDPPRGVL
LISESFLTV	LISESFLTV
SAPPPVVSV	SAPPPVVSV
NIDNVPLLV	NIDNVPLLV
VLFGVETHV	VLFGVETHV
FMDPGPEGKL	FMDPGPGKL
YLDHTADVQL	YLDHTAVQL
SYVWDPLLI	SYVWDPLLI
QLDPLFERV	QLDPLFERV
TMPTSLPNL	TMPTSLPNL
SLPPVPPRL	SLPPVPPRL
LLDGKVLSL	LLDGKVLSL
LLPEPNILQL	LLPEPNLQL
FVPDTPVGV	FVPDTPVGV
NLQIDPSIQ	NLQIDPSIQ
ALPDIKVLTL	ALPDIKLTL
YGDEIAIEL	YGDEIAIEL
SLIDKLYNI	SLIDKLYNI
YLPEADSILFL	YLPEADSIL
LIDEMVNTI	LIDEMVNTI
GLDDIQTLI	GLDDIQTLI
RVIDDSLVVGV	VIDDSLVGV
ILPKSLISV	ILPKSLISV
SVPHIYIQV	SVPHIYIQV
LLPLFLAQL	LLPLFLAQL
LVDDLSDRVYL	LVDDLSDRV
TIPDFIFANV	TIPDFIANV
FLLPILSQI	FLLPILSQI
FLLQHQTFL	FLLQHQTFL
YLEEILVRV	YLEEILVRV
RLIAQRYLL	RLIAQRYLL
YPFPGPIPN	YPFPGPIPN
SVPESTVLKKV	SVPESTVLK
FLDSPNKYSL	FLDSPNYSL
KLDGLIHRF	KLDGLIHRF
LLDKVYSSV	LLDKVYSSV
SLDAFLVAL	SLDAFLVAL
ALIQQATTV	ALIQQATTV
QVDAQLLTV	QVDAQLLTV
IIPDKVWAV	IIPDKVWAV
SVVESVFKL	SVVESVFKL
YVDDTQFLRF	YVDDTQLRF
ILPDMLKNA	ILPDMLKNA
GLWEEAYRV	GLWEEAYRV
ILDPEGLAL	ILDPEGLAL
IQDEEFYTL	IQDEEFYTL
ISFDEFIK	ISFDEF-IK
GLDNLYKKV	GLDNLYKKV
MLDAAVIKM	MLDAAVIKM
SLAEFVQSL	SLAEFVQSL
YLDRKLLTL	YLDRKLLTL
QAPGVITGV	QAPGVITGV
LLYPFSWAH	LLYPFSWAH
IVDGVVQSI	IVDGVVQSI
YVDTAVRHVLL	YVDTAVRHV
AVDPLLALL	AVDPLLALL
HDISPQAPTHF	ISPQAPTHF
NIIEAINELLV	NIIEAINEL
LLPGVDVLL	LLPGVDVLL
GLPLRPFPAA	GLPLRPPAA
HIPEVYLIV	HIPEVYLIV
RLPEAIEEV	RLPEAIEEV
VLMEIIAKV	VLMEIIAKV
KLPEKWESV	KLPEKWESV
FLPEEQDRL	FLPEEQDRL
VIIPLLHTV	VIIPLLHTV
QVPEPPPKV	QVPEPPPKV
VLISKLPYI	VLISKLPYI
KAIEVLLTL	KAIEVLLTL
FTDGITNKL	FTDGITNKL
FVDPVLNQL	FVDPVLNQL
FLVDIMEHL	FLVDIMEHL
HLDVQPAAL	HLDVQPAAL
AIEDTIFYL	AIEDTIFYL
LLDYPNNLL	LLDYPNNLL
TVDPETQARL	TVDPETARL
VADAIRTSL	VADAIRTSL
VLMDRLPSL	VLMDRLPSL
LQNDLYITV	LQNDLYITV
ILDDVAMVL	ILDDVAMVL
SLDAVMPHL	SLDAVMPHL
LLEDYFVPL	LLEDYFVPL
NIDEAYKIL	NIDEAYKIL
SLPRHTFGL	SLPRHTFGL
YIDQRIHEL	YIDQRIHEL
SLSDTVEKL	SLSDTVEKL
ALANQIPTV	ALANQIPTV
IIEQLDPVSF	IIEQLDVSF
SIIQRLLEV	SIIQRLLEV
YLDFIKEVGF	YLDFIKVGF
SIIPPLFTV	SIIPPLFTV
TLPVAFKVV	TLPVAFKVV
ILDETVNSV	ILDETVNSV
GLFTVFTGV	GLFTVFTGV
LIDSPLHNTFL	LIDSPLNTF
VLDEPGQDL	VLDEPGQDL
TLPVSFAQL	TLPVSFAQL
VSDNIIAKL	VSDNIIAKL
LLTDILVFL	LLTDILVFL
SLPDDISVVKV	SLPDDISVV
GLMRKVPRV	GLMRKVPRV
KIDDKPVKI	KIDDKPVKI
KVDPLFTELL	KVDPLFTEL
SLDPSRPVTF	SLDPSRVTF
MVWEGLNVV	MVWEGLNVV
ILDKFTEEV	ILDKFTEEV
LLPPLLHTL	LLPPLLHTL
GLDEAKEILL	GLDEAKILL
HLDRTMYLL	HLDRTMYLL
FIIQGLRSV	FIIQGLRSV
SLDQKLFQL	SLDQKLFQL
AVFPHLTVV	AVFPHLTVV
NLDPAVHEV	NLDPAVHEV
VVDWLYTHV	VVDWLYTHV
ALDTLYIMGL	ALDTLYMGL
ELDNMFVHL	ELDNMFVHL
SVVPQLTGGSV	VVPQLTGSV
FVNDIFERI	FVNDIFERI
IVDQVMVTL	IVDQVMVTL
NLPYKVTQDEL	NLPYKVTQD
KMDRALLEL	KMDRALLEL
VGPPETSLHTV	GPPETSHTV
RLQEEINEV	RLQEEINEV
FTDIVTVQV	FTDIVTVQV
GLPGVGIMPTV	GLPGVGIMP
NIDHLLLNL	NIDHLLLNL
RLPPDFFGV	RLPPDFFGV
LLPELLSAL	LLPELLSAL
WVLEPQEGV	WVLEPQEGV
LLDKLQTYL	LLDKLQTYL
FGPPIPKGV	FGPPIPKGV
KMPRLIAKV	KMPRLIAKV
TLPPALAAL	TLPPALAAL
VVDPETDEQL	VVDPETEQL
ALDDRPQVL	ALDDRPQVL
AVPGPGGIWSV	AVPGPG-GI
IAPPTGFTV	IAPPTGFTV
KIDDILQTL	KIDDILQTL
YLFTIINSL	YLFTIINSL
ILDDVSLTHL	ILDDVSTHL
TLSEPRQAEI	TLSEPRAEI
YLEDILAKL	YLEDILAKL
VLQSVFTSV	VLQSVFTSV
HLDEDKHFVV	HLDEDKHFV
VLPAFTSNL	VLPAFTSNL
NIDEIILQL	NIDEIILQL
FLPEAPAEL	FLPEAPAEL
ILPTLVIKL	ILPTLVIKL
GLPTRLPEI	GLPTRLPEI
TLDTIYPVL	TLDTIYPVL
APEEHPVLL	APEEHPVLL
LLDYIDKEII	LLDYIDKEI
ALESFLKQV	ALESFLKQV
LLPHLLPAL	LLPHLLPAL
SVDEDYDLRL	SVDEDYLRL
IDEPLEGSEDR	-IDEPLEGS
LLDVMFSSV	LLDVMFSSV
FISNVKTAL	FISNVKTAL
TIDDIAQSL	TIDDIAQSL
AAPPAFPEV	AAPPAFPEV
LLPPPTLL	LLPPPT-LL
LLPSRPEVPNI	LLPSRP-EV
SLPDPNLITFL	SLPDPNITF
TIDPFWDISL	TIDPFWISL
MVAPAVASV	MVAPAVASV
FADPIAANL	FADPIAANL
YVDGSTLQL	YVDGSTLQL
QIDSIVELV	QIDSIVELV
KLPEPQSFSSA	KLPEPQSFS
SVPMPLPTV	SVPMPLPTV
KIMTEKELLAV	KIMTEKELL
YMSPHPSPL	YMSPHPSPL
GLPKKFVDI	GLPKKFVDI
IVDNVNQAL	IVDNVNQAL
NVDKVFFDL	NVDKVFFDL
RLLEPAQVQQL	LLEPAQQQL
GLPELVIQL	GLPELVIQL
GLDTVVALL	GLDTVVALL
FLPEALDFV	FLPEALDFV
LLDLALEGM	LLDLALEGM
VLDDKDYFL	VLDDKDYFL
GLPSDFHTA	GLPSDFHTA
LIDDILEKI	LIDDILEKI
FLDNLHINL	FLDNLHINL
FLPEVIYKM	FLPEVIYKM
ILDNPVVQL	ILDNPVVQL
FLDDGFLVPTF	FLDDGF-LV
VVDALNQGL	VVDALNQGL
NIDDVVRFLDS	NIDDVVRFL
VLIPKLPQL	VLIPKLPQL
ILDKEINRL	ILDKEINRL
YLPAHIPYQEL	YLPAHIPYQ
FLDGNEMTL	FLDGNEMTL
KVLEPSETLVV	KVLEPSETL
FLPHELPLL	FLPHELPLL
ALDGAWLMV	ALDGAWLMV
FLDQHPFSF	FLDQHPFSF
LLQDIILQV	LLQDIILQV
FLENEHQQL	FLENEHQQL
ALPGPPAQL	ALPGPPAQL
RLPESVERL	RLPESVERL
LLLEILHEI	LLLEILHEI
SLVAILQSV	SLVAILQSV
FLFDTQHFI	FLFDTQHFI
RLDLIYPMV	RLDLIYPMV
FLPEEFMKT	FLPEEFMKT
FIDDVVSAV	FIDDVVSAV
ALDEVVLKF	ALDEVVLKF
TLPEPVGTQV	TLPEPVTQV
RVAPEEHPVLL	VAPEEHPVL
SMDPLPVFL	SMDPLPVFL
LVPDLSNFYA	LVPDLSFYA
FLDRPQQWL	FLDRPQQWL
ALPATVWSL	ALPATVWSL
TPGNRIVYLY	TPGNRIVYL
FLPQVVVTV	FLPQVVVTV
ALEELTKAL	ALEELTKAL
FLDEPTNHL	FLDEPTNHL
VLPSPGPAL	VLPSPGPAL
FVDATKERL	FVDATKERL
KLDAFVEGV	KLDAFVEGV
HLPPTFHAV	HLPPTFHAV
ILDDTAKNLRV	ILDDTAKNL
FLDSAYFRL	FLDSAYFRL
QLPEGASAV	QLPEGASAV
VVDAVVTQV	VVDAVVTQV
TIPEILPKL	TIPEILPKL
ILIDWLVQV	ILIDWLVQV
NLPVFQPGV	NLPVFQPGV
RLFPVPGSGLV	RLFPVPSGL
SLIEKYFSV	SLIEKYFSV
LLDNTDIHL	LLDNTDIHL
VVDEELSKL	VVDEELSKL
YLNETFSEL	YLNETFSEL
KLQEFELPYV	KLQEFEPYV
FLQDTIEEM	FLQDTIEEM
SLHEFLVNL	SLHEFLVNL
ALDEQLVQV	ALDEQLVQV
VMDVVVKSV	VMDVVVKSV
RLPLISVAL	RLPLISVAL
TVPPPPAAA	TVPPPPAAA
ALPTIAFAFV	ALPTIAAFV
AVDELFTSL	AVDELFTSL
NIDEIYKALSR	NIDEIYKAL
GLDLISVRL	GLDLISVRL
ALYVAVVNV	ALYVAVVNV
TVLPFVSTV	TVLPFVSTV
NILEDLETLRL	NILEDLETL
KLDEILKEI	KLDEILKEI
ILDWHFANL	ILDWHFANL
MVDDVFYIV	MVDDVFYIV
LVDSVLDVV	LVDSVLDVV
KLPSNLPQL	KLPSNLPQL
NLPELKTAV	NLPELKTAV
ATPHPFPAV	ATPHPFPAV
LLPVDKAFYEA	PVDKAFYEA
ALPELYFQKV	ALPELYQKV
KLPDLPQNSV	KLPDLPNSV
AIDEKYDVAI	AIDEKYVAI
SIPPVLKAELL	SIPPVLAEL
NVDAVISKI	NVDAVISKI
FVDGLHEKL	FVDGLHEKL
ILDDIFASL	ILDDIFASL
VVDDIVSKLVF	VVDDIVSKL
ERVETLRF	ERVETL-RF
ALPENVILV	ALPENVILV
GLDQQFAGL	GLDQQFAGL
MLDNSFERL	MLDNSFERL
ILPPQDLSHYI	ILPPQDLSH
NLDEVFKVM	NLDEVFKVM
HLDDQMTLL	HLDDQMTLL
ALDPSLDNHQV	ALDPSLHQV
ALDEVFTKV	ALDEVFTKV
YVDRVTEFL	YVDRVTEFL
TIDDLIDKL	TIDDLIDKL
FLREYFERL	FLREYFERL
MVDELFAEI	MVDELFAEI
RVDPVYIHL	RVDPVYIHL
KIDPDYSVYV	KIDPDYVYV
LLDFNFEQL	LLDFNFEQL
KLDDLYQQKI	KLDDLYQKI
YLPSAILQL	YLPSAILQL
SLDTEYWKL	SLDTEYWKL
ALEDRVWEL	ALEDRVWEL
RIMEFTTTL	RIMEFTTTL
KILPDLNTV	KILPDLNTV
KLDEALAQYF	KLDEALQYF
ALDVPNTML	ALDVPNTML
KLMDQLEAL	KLMDQLEAL
KLDDIFEPVL	KLDDIFPVL
ILDDDTIITTL	ILDDDTTTL
EIIDLVLDR	EIIDLVLDR
AIDEISQQL	AIDEISQQL
SDVVVGLESFI	VVVGLESFI
NLDELSMGL	NLDELSMGL
YIDEGRLVL	YIDEGRLVL
FLDNLHINLL	FLDNLHINL
VLDEIDAAL	VLDEIDAAL
ILIDPFHKA	ILIDPFHKA
NLDKAFEKL	NLDKAFEKL
LLPPDESLHSL	LLPPDE-SL
LLIENVASL	LLIENVASL
FLDHVMYTI	FLDHVMYTI
LIDDVHRLF	LIDDVHRLF
FLIEEQKIV	FLIEEQKIV
FLDSQTATF	FLDSQTATF
FMDDTSRSII	FMDDTSRSI
GLDISSPGM	GLDISSPGM
FIDMPDAAHGI	DMPDAAHGI
KLPQPEAVVAL	KLPQPEAVV
VVDDIVSKL	VVDDIVSKL
LLDDNRELL	LLDDNRELL
MLDEPTNHL	MLDEPTNHL
FVLDKVPFL	FVLDKVPFL
FINPPIGTV	FINPPIGTV
KLPSAVIAL	KLPSAVIAL
VVPPPFEQEAL	VVPPPFQEA
ILDQVWNIF	ILDQVWNIF
LMSSDVFPLL	MSSDVFPLL
ALQEASEAYLV	ALQEASAYL
FLDPPHML	FLDPPH-ML
TEADVYITF	TEADVYITF
RLPAAGVGDMV	RLPAAGVGD
VMDNLLIQV	VMDNLLIQV
RLLPPGAVVAV	LLPPGAVAV
KMDYPEMGL	KMDYPEMGL
FADGVILLL	FADGVILLL
VFRTDLITA	VFRTDLITA
SVDELFQKV	SVDELFQKV
YMDNDYAKL	YMDNDYAKL
SLDWHPNNV	SLDWHPNNV
QIDSIHLLL	QIDSIHLLL
LLDTSSVLV	LLDTSSVLV
VLPNIHPEL	VLPNIHPEL
ILDKKVEKV	ILDKKVEKV
KVIDYVPGI	KVIDYVPGI
GLIEKFYVI	GLIEKFYVI
SIDEAYVDL	SIDEAYVDL
RMDELFVLI	RMDELFVLI
RVDALNDEI	RVDALNDEI
AYIDDFDLGQI	YIDDFDGQI
IIDGVIQMV	IIDGVIQMV
YMPTEMELIEI	YMPTEMELI
HVDEIKEFL	HVDEIKEFL
VLPEHVSVL	VLPEHVSVL
YLDAIKLLL	YLDAIKLLL
IVVDNVPQV	IVVDNVPQV
IIDDVMKEL	IIDDVMKEL
IINEPTAAA	IINEPTAAA
ALPPDLSYI	ALPPDLSYI
HLDYITEKL	HLDYITEKL
FGVPLIVHV	FGVPLIVHV
LLPPVTLAA	LLPPVTLAA
LLDEFTTKL	LLDEFTTKL
ILDSSPEKL	ILDSSPEKL
FLLPVINEM	FLLPVINEM
WIDDTSAFV	WIDDTSAFV
RLPNRALLVNV	RLPNRALLV
GLDSFYEYL	GLDSFYEYL
MLIEVIEKL	MLIEVIEKL
TLDENHSIWQL	TLDENH-SI
ALDSLSWLLL	ALDSLSWLL
YLPVKIEQV	YLPVKIEQV
PLWESGPTV	PLWESGPTV
SLPPLLAAA	SLPPLLAAA
FIDEYVETV	FIDEYVETV
LVDPHFAQV	LVDPHFAQV
LLDEMKFSL	LLDEMKFSL
GLDNETHFL	GLDNETHFL
ILLEAGAFVNV	ILLEAGAFV
YLNVQVKEL	YLNVQVKEL
FLDGNELTL	FLDGNELTL
YLDQVKLQF	YLDQVKLQF
FIDEAYVEV	FIDEAYVEV
VIPEKFQHI	VIPEKFQHI
KLDAFIEAL	KLDAFIEAL
RLPPEYASTV	RLPPEYSTV
ILNTIYEKV	ILNTIYEKV
HSLPDLPY	HSLPDL-PY
LVDEVMLTL	LVDEVMLTL
MMPTRFEDL	MMPTRFEDL
LIWPLLSTV	LIWPLLSTV
KLWDPFSLEE	KLWDPF-SL
KILEDVVGV	KILEDVVGV
IIDEITPKL	IIDEITPKL
FLDLGYNRL	FLDLGYNRL
AMDSVLHTL	AMDSVLHTL
IIDSLFNTV	IIDSLFNTV
IMDATNILV	IMDATNILV
LLPEGGITAI	LLPEGGITA
ILHTLLTLV	ILHTLLTLV
KLDDYVYYV	KLDDYVYYV
YLDVSVGKI	YLDVSVGKI
NVDGHLYEL	NVDGHLYEL
IIDQVNPEL	IIDQVNPEL
WLDEVRLTL	WLDEVRLTL
NIDSIIQRL	NIDSIIQRL
YVDAVGQFL	YVDAVGQFL
KAPDFLPLL	KAPDFLPLL
LLPDTILEKL	LLPDTIEKL
FLAHIYTEL	FLAHIYTEL
FIREHIEEL	FIREHIEEL
AIDNQYTPL	AIDNQYTPL
ALDNFLDKL	ALDNFLDKL
KLPTPTSSV	KLPTPTSSV
AVDYVIRHL	AVDYVIRHL
IVDEVNGLISM	IVDEVNGLI
ILPEVENDRL	ILPEVEDRL
VLEELYKKV	VLEELYKKV
ILDSHAATL	ILDSHAATL
IQDEIVDFL	IQDEIVDFL
VMDLLVLGL	VMDLLVLGL
ALSEKIVSV	ALSEKIVSV
MLDAIPMML	MLDAIPMML
KMPDFGQVTV	KMPDFGVTV
AVDNLVERL	AVDNLVERL
ALTPVVVTL	ALTPVVVTL
ILPKIKAIPQL	ILPKIKPQL
FLLPMFERL	FLLPMFERL
VLDIPQERGL	VLDIPQRGL
GLPPVFGL	GLPPVF-GL
SLWEDFSQSL	SLWEDFQSL
KADSVVVLL	KADSVVVLL
VMDSAFKVYL	VMDSAFVYL
NIPDVVPGSHL	NIPDVVPGS
YLDQISRYYI	YLDQISYYI
LIDYTLEFL	LIDYTLEFL
YLQEVIDVL	YLQEVIDVL
TIDDVVYVI	TIDDVVYVI
SMDTLLATL	SMDTLLATL
HLDDLFFTL	HLDDLFFTL
NMDSVFKEL	NMDSVFKEL
YLPPGFLSA	YLPPGFLSA
AIDAIFLTT	AIDAIFLTT
ILDVSWNSL	ILDVSWNSL
FVDGSAIQV	FVDGSAIQV
FVIDLQTRL	FVIDLQTRL
ITPENLPQILL	ITPENLPQI
ILDESGKKFAM	ILDESGKKF
NIPAFLPNVL	NIPAFLPNV
SLDRIYNML	SLDRIYNML
AMPGEDLKFNL	AMPGEDLKF
ILPKYVQQV	ILPKYVQQV
YVDATYREGM	YVDATYEGM
LIPDIATEL	LIPDIATEL
RLPEPTTRL	RLPEPTTRL
MLPSILVLL	MLPSILVLL
HIPDVITYL	HIPDVITYL
TLSDLRVYL	TLSDLRVYL
MVDSKPVNL	MVDSKPVNL
LLDEEVSRTL	LLDEEVRTL
LLDEVMKSL	LLDEVMKSL
LLPQGLPGL	LLPQGLPGL
LLEEKIASL	LLEEKIASL
FVDTDSDVRL	FVDTDSVRL
LLPDTNVLL	LLPDTNVLL
FLWRTVLVV	FLWRTVLVV
SLDEAIDMRF	SLDEAIMRF
LLDDPTNAHFI	LLDDPTAHF
MLPGFLHRL	MLPGFLHRL
LMVDHVTEV	LMVDHVTEV
SLPGQGVIYNV	SLPGQGVIY
HLPPEIVPATL	LPPEIVATL
FLPDQDQRSQL	FLPDQDQRS
FLFSKFIEL	FLFSKFIEL
VMEDLYNYI	VMEDLYNYI
MLDSLRIYL	MLDSLRIYL
LLPNAVYKV	LLPNAVYKV
LLPDIISRL	LLPDIISRL
FLSELTQQL	FLSELTQQL
RIDEINKEL	RIDEINKEL
YLDEEFHQSL	YLDEEFQSL
LIDEDVYRL	LIDEDVYRL
SIPELQNFL	SIPELQNFL
SVDPVAADL	SVDPVAADL
DYFEQYGK	DYFEQY-GK
VTEGFIKDV	VTEGFIKDV
ILPEVKVEGEL	ILPEVKVEG
IAPPVPLKA	IAPPVPLKA
KMDEVLYSI	KMDEVLYSI
SLYLGEVFTQ	YLGEVF-TQ
LLDATQHTL	LLDATQHTL
VLDPSHRDISL	VLDPSHRDI
LLDELVQSL	LLDELVQSL
KLDSPRVTV	KLDSPRVTV
AGDPVILYV	AGDPVILYV
SLDQLVQAL	SLDQLVQAL
VPEEQIFPVL	VPEEQIPVL
VLDEGKMKL	VLDEGKMKL
IIPPLFTV	IIPPLF-TV
WLPEPGLGL	WLPEPGLGL
FLPPSFPIV	FLPPSFPIV
YLNETFSELRL	YLNETFSEL
KIDSVAVNI	KIDSVAVNI
KLLDVVHPA	KLLDVVHPA
VLDEFYSSL	VLDEFYSSL
NVPDSFNEV	NVPDSFNEV
RLDDAIHVL	RLDDAIHVL
LLDDIFIRL	LLDDIFIRL
KLDEAFEFV	KLDEAFEFV
VLDSLLLTL	VLDSLLLTL
FLDPEIKAFL	FLDPEIAFL
ITDDLHFYV	ITDDLHFYV
ILPDDPRQMTL	ILPDDPRQM
LLPDDKLTLF	LLPDDKLTL
FVDIVDAKL	FVDIVDAKL
IVDLIHDIQI	IVDLIHIQI
QLDEARGLLL	QLDEARLLL
YQPYEIPAV	YQPYEIPAV
SLLEHLSHV	SLLEHLSHV
ALDREVQYL	ALDREVQYL
ALDEPLARRF	ALDEPLARR
FLFDHLLTL	FLFDHLLTL
HIDETYLMF	HIDETYLMF
ILDETQHLDI	ILDETQ-HL
ILDPFILVFL	ILDPFIVFL
SLDEAYRFV	SLDEAYRFV
IVDELKQEV	IVDELKQEV
SVDPQFLKL	SVDPQFLKL
RMDPLEAIQL	RMDPLEIQL
FLYPFLHTV	FLYPFLHTV
KLHYVVTEV	KLHYVVTEV
ALPTEAAILTL	ALPTEAAIL
LLDSITVPVAR	LLDSITVPV
MLPGLALLL	MLPGLALLL
MMDTVISLL	MMDTVISLL
ALDDEFITV	ALDDEFITV
FLTEFINYI	FLTEFINYI
LIDPNTLQV	LIDPNTLQV
ILDAGGHNV	ILDAGGHNV
ALLPYFVYV	ALLPYFVYV
RVDNLAVVM	RVDNLAVVM
KGDDVIVFL	KGDDVIVFL
FIDIVVENL	FIDIVVENL
QIDDVTIKI	QIDDVTIKI
FLDALIVSM	FLDALIVSM
FLEENISEV	FLEENISEV
ALPDTDVLYMT	ALPDTDLYM
GMPGALPSL	GMPGALPSL
VQPFFDNIFV	VQPFFDIFV
TIDGILLLI	TIDGILLLI
KVIEINPYL	KVIEINPYL
ILRDPLQTDTL	LRDPLQDTL
SVVDIKLLL	SVVDIKLLL
QLDLVVKYL	QLDLVVKYL
TLIEDILGV	TLIEDILGV
FISEFEHRV	FISEFEHRV
GQIEVVPEV	GQIEVVPEV
NLDNAFAHV	NLDNAFAHV
EDQTEYLEER	DQTEYLEER
LLPDPLYSL	LLPDPLYSL
MLFDKFRSV	MLFDKFRSV
KLDENSAFLQF	KLDENSAFL
RLAPDYDAL	RLAPDYDAL
RLPDMEMVINV	RLPDMEMVI
KLPMSIIIVGV	KLPMSIIIV
FLDKPEDVLL	FLDKPEVLL
FVPPVFVV	FVPPVF-VV
KMPQSMPEYAL	KMPQSMEYA
KVPEWVDTV	KVPEWVDTV
LVDHLNVGVAQ	LVDHLNVGV
FLPPEHTIVYI	FLPPEHTIV
YIPFYGILGA	YIPFYGLGA
ALDDIIYRA	ALDDIIYRA
FLDPGGPMM	FLDPGGPMM
QLMEQVAQL	QLMEQVAQL
LLLPDYYLVTV	LLPDYYVTV
GAPDFLAHV	GAPDFLAHV
ALDRIVEYL	ALDRIVEYL
FLLEQEKTQAL	LLEQEKQAL
LVQDILLNV	LVQDILLNV
YVDEVMTRL	YVDEVMTRL
YLPDIQERL	YLPDIQERL
TIDPIPHQL	TIDPIPHQL
SVDDVLSHF	SVDDVLSHF
ILDDIIASV	ILDDIIASV
KLPEDIMKL	KLPEDIMKL
KLDDIVQHI	KLDDIVQHI
YLLPSVVLL	YLLPSVVLL
GLPGPPYHSL	GLPGPPHSL
SLDESGEHMGV	SLDESGEHM
ILDIPFHQV	ILDIPFHQV
HLIEPLANA	HLIEPLANA
FMMPQSLGV	FMMPQSLGV
FVDEGKATVRL	FVDEGKATV
HLDNISNNL	HLDNISNNL
ILPKPLTKV	ILPKPLTKV
FVDTDADTRL	FVDTDATRL
LLDQINSTF	LLDQINSTF
FLAILGGAKV	FLAILGAKV
YVPVHFDASV	YVPVHFASV
IVDSVFVNL	IVDSVFVNL
LLDRILPKL	LLDRILPKL
FLDDNQIIT	FLDDNQIIT
SLPEIVPPM	SLPEIVPPM
MLDPLEVHL	MLDPLEVHL
LLFDPLGGV	LLFDPLGGV
IQPPFVPTL	IQPPFVPTL
VQPLELPMV	VQPLELPMV
ALDEEYLKV	ALDEEYLKV
YENEVALRQ	YENEVALRQ
NLPSPSPTV	NLPSPSPTV
QIDGLISQL	QIDGLISQL
ALDEPTTNL	ALDEPTTNL
FIKDYPVVSI	IKDYPVVSI
AQPPWLPGL	AQPPWLPGL
SLQEKLWAI	SLQEKLWAI
RVMELFFTV	RVMELFFTV
ALPEVLAVI	ALPEVLAVI
NLPPHIIRL	NLPPHIIRL
LLDGNPFRV	LLDGNPFRV
HLPEQAFYM	HLPEQAFYM
LLVDYYVKI	LLVDYYVKI
NADAIVVKL	NADAIVVKL
VVDDSNEHML	VVDDSNEHM
LIDTSRHYL	LIDTSRHYL
YLLDMPLWYL	LLDMPLWYL
ILDKVLTAM	ILDKVLTAM
YMDNPQNLAM	YMDNPQNLA
KMPSRFPPVVF	KMPSRFPPV
YLPEWKENI	YLPEWKENI
FLPESVAVV	FLPESVAVV
LLPSVRQEV	LLPSVRQEV
LLDHDAFVL	LLDHDAFVL
ILDTMYPEL	ILDTMYPEL
NLPAATFQV	NLPAATFQV
RVDEEPTTL	RVDEEPTTL
FLPDANSSVLL	FLPDANSSV
LLYEQYAIV	LLYEQYAIV
GLDRLNVTV	GLDRLNVTV
YLPAVFEEVL	YLPAVFEEV
HLDGVHVVF	HLDGVHVVF
KLISSYYNV	KLISSYYNV
LVDEAKNYL	LVDEAKNYL
FLDEKTHEL	FLDEKTHEL
ILDSQTVVL	ILDSQTVVL
ILLAEVPTM	ILLAEVPTM
GVDNIFILV	GVDNIFILV
ALWEDEGVRA	ALWEDEVRA
FLPVKLIFV	FLPVKLIFV
LDIDSPPITAR	DIDSPPITA
QLAPVFQRV	QLAPVFQRV
TVDELMMRL	TVDELMMRL
IQDDAVHTL	IQDDAVHTL
YLYVRAHGV	YLYVRAHGV
ELPKYLPAL	ELPKYLPAL
LLPPAFHL	LLPPAF-HL
YLDRFLAGV	YLDRFLAGV
YIFQPQQSV	YIFQPQQSV
ALDHMVEYV	ALDHMVEYV
FLDHPEIYRS	FLDHPEIYR
VLLSTIHEL	VLLSTIHEL
GLPEITPKL	GLPEITPKL
VIDEIYRVL	VIDEIYRVL
QVPDDLPNV	QVPDDLPNV
FQVDEIYTV	FQVDEIYTV
FLDYQLDEL	FLDYQLDEL
YVPPPFAAA	YVPPPFAAA
RLDELGGVYL	RLDELGVYL
QLFEDLVYL	QLFEDLVYL
KLWSETFDV	KLWSETFDV
YLNDLHEVL	YLNDLHEVL
SMPLSFPSL	SMPLSFPSL
LVPGHLDQV	LVPGHLDQV
YIDEVIIEQF	YIDEVIEQF
VLFELKLLL	VLFELKLLL
FLDISRPKM	FLDISRPKM
AVDNVAHTI	AVDNVAHTI
FVDEGIKTL	FVDEGIKTL
LLPPVVWL	LLPPVV-WL
QVDEFRFLL	QVDEFRFLL
VLPYLVPKL	VLPYLVPKL
SLDEQYKHQL	SLDEQYHQL
NVDKVFFDLM	NVDKVFFDL
FTDERIFML	FTDERIFML
LIDIFIINL	LIDIFIINL
ILPYDFSRV	ILPYDFSRV
NMPPVPHGM	NMPPVPHGM
KAEGVLLDYL	KAEGVLDYL
VLNEYFHNV	VLNEYFHNV
LLPIKTVGV	LLPIKTVGV
RLDDFWSLKL	RLDDFWLKL
ALDPNIATL	ALDPNIATL
ALPGVGPKM	ALPGVGPKM
YLPPEFTAGL	YLPPEFAGL
RLPPLLSPL	RLPPLLSPL
SVDEVLEML	SVDEVLEML
TLDPVEKAL	TLDPVEKAL
FLDQHGHNL	FLDQHGHNL
RLPGPLGTV	RLPGPLGTV
ALDVPHAEL	ALDVPHAEL
TLDGVYPTL	TLDGVYPTL
YLPDIIKDQKA	YLPDIIKDQ
IIDDVMKELNF	IIDDVMKEL
LLDTVYKGI	LLDTVYKGI
LIDQKVYEL	LIDQKVYEL
KLPGLLMTI	KLPGLLMTI
AVVAPTSTV	AVVAPTSTV
KIFSGVFVKV	KIFSGVVKV
SVDSHFSHL	SVDSHFSHL
IVDVIDQNRAL	IVDVIDNRA
VLDHSLESL	VLDHSLESL
FLPSHSLDTV	FLPSHSDTV
NLPLPIPTV	NLPLPIPTV
TLDVQIQHV	TLDVQIQHV
TLDSFYEML	TLDSFYEML
VIFDLPTTV	VIFDLPTTV
TLDPEPQHL	TLDPEPQHL
YLLDLLRLP	YLLDLLRLP
FLPEGQDIGA	FLPEGQIGA
YLDKTFYNL	YLDKTFYNL
FMNPHLISV	FMNPHLISV
YVLPVVSYI	YVLPVVSYI
LVDDNYFYL	LVDDNYFYL
YIFEEPFTI	YIFEEPFTI
LLDSPGKVLL	LLDSPGVLL
VLPELDDLTV	VLPELDLTV
ALPPKPRFL	ALPPKPRFL
MMPDGTLGL	MMPDGTLGL
ILQERIEEM	ILQERIEEM
LLPDYYLVTV	LLPDYYVTV
KLSDLQTQL	KLSDLQTQL
FIDQQQFYL	FIDQQQFYL
FIDAVYKLL	FIDAVYKLL
KLIEVDDERKL	KLIEVDDER
YMDQIIEYL	YMDQIIEYL
YLDQLNHIL	YLDQLNHIL
VLDNIPKLL	VLDNIPKLL
ILEKYIKFV	ILEKYIKFV
VLPPHPQQL	VLPPHPQQL
GLPTRLPEIML	GLPTRLPEI
VAVGVIKAV	VAVGVIKAV
QLPEQPLFL	QLPEQPLFL
AMPQTVYGV	AMPQTVYGV
ALPKIILAV	ALPKIILAV
ILDPFILVF	ILDPFILVF
NMDKIYIVM	NMDKIYIVM
SLVNLGGSK	SLVNLGGSK
VLDLTYNNL	VLDLTYNNL
ILDEAERSL	ILDEAERSL
FLFEPVVKAFL	FLFEPVVKA
KVDKIITPL	KVDKIITPL
FLDAPAVRV	FLDAPAVRV
VMPGNIVFV	VMPGNIVFV
NIDSIIQRLL	NIDSIIQRL
VLLGHIFYV	VLLGHIFYV
LAPSHGLVSV	LAPSHGVSV
LLDSVLVTL	LLDSVLVTL
YLTAEILEL	YLTAEILEL
LLDSTQKYL	LLDSTQKYL
HLDEARTLL	HLDEARTLL
QVDSINALL	QVDSINALL
LLQDKQFEL	LLQDKQFEL
ALLDRIVSV	ALLDRIVSV
IIDDPNLVVKI	IIDDPNLVV
SIYYITGESK	SIYYITESK
LIDESVHALF	LIDESVHAL
SAPAVLLYV	SAPAVLLYV
ALPRLLPAL	ALPRLLPAL
RIWDPVLSV	RIWDPVLSV
SLQEFLAAL	SLQEFLAAL
NQPGVLIQV	NQPGVLIQV
LVDNIQQHF	LVDNIQQHF
ALDTGWNEL	ALDTGWNEL
AVDYITVAL	AVDYITVAL
MLPETREIYEL	MLPETRYEL
SLDLVAAAL	SLDLVAAAL
IVDPTGEEEHL	IVDPTGEHL
LLPPPHQGL	LLPPPHQGL
KMDPIISRV	KMDPIISRV
ALVHLKVAAL	LVHLKVAAL
LADEVITVF	LADEVITVF
YVDEASKKEI	YVDEASKEI
IIDNILQRI	IIDNILQRI
IIDEVVNKF	IIDEVVNKF
LLPHPGLQV	LLPHPGLQV
LLDELTHEFL	LLDELTHEF
VLWEALRKMGL	VLWEALRKM
FLDNMFHVL	FLDNMFHVL
ILDESHYKELL	ILDESHKEL
SLVEIILHV	SLVEIILHV
LLEEFVFQV	LLEEFVFQV
AVHETLVAV	AVHETLVAV
LIPEYLNFI	LIPEYLNFI
YTDHQFTEL	YTDHQFTEL
IIDGVKVQV	IIDGVKVQV
KMIEDLQNEL	MIEDLQNEL
FLPPAQVTV	FLPPAQVTV
AIDLIVQHV	AIDLIVQHV
RLDWPVRTL	RLDWPVRTL
FADPIYQAGL	FADPIYAGL
ALDNVLPSAQL	ALDNVLPSA
IVDEPTFKVLL	IVDEPTFKV
HLDDILQHV	HLDDILQHV
VVDNPQKFALF	VVDNPQFAL
KIIDIQEKV	KIIDIQEKV
MLFGTYMKV	MLFGTYMKV
LAPEIVIKV	LAPEIVIKV
MAPTLLPEL	MAPTLLPEL
TLFNVIKSV	TLFNVIKSV
ALDLKTLYL	ALDLKTLYL
KLPDVYGV	KLPDVY-GV
KLDDYQERM	KLDDYQERM
IMPKDIQLA	IMPKDIQLA
IIPDPVVAPSI	IIPDPVVAP
SLPPLPRKV	SLPPLPRKV
LLPEYLPYA	LLPEYLPYA
VLPNPPQAV	VLPNPPQAV
YLHETLETI	YLHETLETI
LLDDAKARL	LLDDAKARL
ALPRLLPALA	ALPRLLPAL
LSDPIVNTL	LSDPIVNTL
LIDDLKSEL	LIDDLKSEL
LLDEVIQEF	LLDEVIQEF
HLDPGPIYM	HLDPGPIYM
LLDADMNIKI	LLDADMIKI
LLLDRIASV	LLLDRIASV
GMPDFLEKL	GMPDFLEKL
LMPQLNAIIAA	LMPQLNAII
ALDYLQVSL	ALDYLQVSL
LMPMPSLGF	LMPMPSLGF
RLPDQFSKL	RLPDQFSKL
QMLEAIKALEV	QMLEAIKAL
LIDELHRHL	LIDELHRHL
ILVGLLHMV	ILVGLLHMV
LMEHIHKL	LMEHIH-KL
NLFHYLTEV	NLFHYLTEV
IVLPAGALHQV	VLPAGAHQV
IIDNSQGFYV	IIDNSQFYV
LIDPFHKAI	LIDPFHKAI
LLPDEIADV	LLPDEIADV
IADNVFLFL	IADNVFLFL
YLFIVKNEL	YLFIVKNEL
LLDKLYALGL	LLDKLYLGL
FQDSVFNDL	FQDSVFNDL
RIDEIASNL	RIDEIASNL
GLDPNKPPEL	GLDPNKPEL
KVPEIISSI	KVPEIISSI
VLDDPKHIQL	VLDDPKIQL
FLTEINSTV	FLTEINSTV
KVDFIFEQV	KVDFIFEQV
HEKIWFDKF	HEKIWFDKF
ELPDYYLTI	ELPDYYLTI
LGLPPTSPA	LGLPPTSPA
SLPELSASAEL	SLPELSASA
SMVDVVMLL	SMVDVVMLL
FLDDVVHSLL	FLDDVVHSL
VVDRFVEFL	VVDRFVEFL
NLPSILLKV	NLPSILLKV
LVSDLLSEL	LVSDLLSEL
AVDQVIKAV	AVDQVIKAV
FLDDAFRKNL	FLDDAFKNL
LLLAATPGL	LLLAATPGL
LLQNHLGND	LLQNHLGND
EMQVLVSRI	EMQVLVSRI
KLPEPLEDGL	KLPEPLDGL
LMDLDVEQL	LMDLDVEQL
SIDFPLTKV	SIDFPLTKV
VLEEQIERL	VLEEQIERL
KLDEIYVAGL	KLDEIYAGL
DPFNPFELTNH	FNPFELTNH
MMPLKVWEL	MMPLKVWEL
KMPDVELFV	KMPDVELFV
LLLPILVTV	LLLPILVTV
FLPRKFPSL	FLPRKFPSL
IVDAFLQQL	IVDAFLQQL
FLFPVYPLI	FLFPVYPLI
IIDEKGPVM	IIDEKGPVM
YLNDRVDEL	YLNDRVDEL
KVNSVYVLV	KVNSVYVLV
RLDWPIERL	RLDWPIERL
RLDLLITYL	RLDLLITYL
RVPPVVPAQTV	RVPPVVPAQ
LIDNHQVTV	LIDNHQVTV
KLDDTYIKAYL	KLDDTYIKA
YIDAQFENYL	YIDAQFNYL
KLDDMLSEL	KLDDMLSEL
ILPAQLLEV	ILPAQLLEV
GMYIFLHTV	GMYIFLHTV
ILDELVKSL	ILDELVKSL
AVDSVLVKL	AVDSVLVKL
ILMEHIHKL	ILMEHIHKL
VLYSVMTLV	VLYSVMTLV
SIIGRLLEV	SIIGRLLEV
SMPPAFPRL	SMPPAFPRL
ALDEFATKL	ALDEFATKL
YVPFGANQLN	YVPFGANQL
KVDEIFGQL	KVDEIFGQL
ALPEMEIHL	ALPEMEIHL
FILGPSHHV	FILGPSHHV
ILDEEKFNV	ILDEEKFNV
KIDDILQTLL	KIDDILQTL
VLDDPKSAGV	VLDDPKAGV
YMPQNPHII	YMPQNPHII
LLDRFLATV	LLDRFLATV
SIIEYLPTLR	SIIEYLPTL
QLPEKVEYV	QLPEKVEYV
ALDSAYKEL	ALDSAYKEL
LMDNPTLYL	LMDNPTLYL
YLITLLEHL	YLITLLEHL
VLDAMFERI	VLDAMFERI
HLWAELVFL	HLWAELVFL
KVDENHSEFTL	KVDENHSEF
RIDPFVRTFL	RIDPFVTFL
LLPELTNPDEL	LLPELTDEL
VLPGVDALSNI	VLPGVD-AL
SVDPLPAGL	SVDPLPAGL
VIDEPVRL	VIDEPV-RL
FIDGHFVEM	FIDGHFVEM
LAPNIISQL	LAPNIISQL
NLDIVIIGI	NLDIVIIGI
SIHDVTFQV	SIHDVTFQV
YVDDFGVSV	YVDDFGVSV
ALATLIHQV	ALATLIHQV
MIIENFEAL	MIIENFEAL
YIDHGDPQV	YIDHGDPQV
VIHATVTSV	VIHATVTSV
SIDKTGENFRL	SIDKTGENF
SMEEIFQHL	SMEEIFQHL
YVLDLAAKV	YVLDLAAKV
YLFAVNIKL	YLFAVNIKL
SVPGKDAIYSL	SVPGKD-AI
AVEAIVKNV	AVEAIVKNV
KLLEPVLLL	KLLEPVLLL
LLDANFTVV	LLDANFTVV
ILDEVIFKL	ILDEVIFKL
MVVDIVQEL	MVVDIVQEL
LLPKAMIEV	LLPKAMIEV
MLPKDIAKL	MLPKDIAKL
HLDYVDTERI	HLDYVDERI
SFYEHIITV	SFYEHIITV
FLDKELTGL	FLDKELTGL
SVDGVIKEV	SVDGVIKEV
FVDAITELL	FVDAITELL
QMDDLRAQI	QMDDLRAQI
SVDEEFQKL	SVDEEFQKL
YLFERTFNL	YLFERTFNL
YLSPKLWAL	YLSPKLWAL
FLDVYYNL	FLDVYY-NL
LVDSTVVHI	LVDSTVVHI
KIDDFPNEL	KIDDFPNEL
NLDKVVEYL	NLDKVVEYL
YLPSFFTKL	YLPSFFTKL
IIDEQPLIF	IIDEQPLIF
YVDVVKVLL	YVDVVKVLL
NLDLAVLEL	NLDLAVLEL
YVFPGVTRL	YVFPGVTRL
QLPELFHKI	QLPELFHKI
IIIPEIQKV	IIIPEIQKV
LVYEAIIMV	LVYEAIIMV
ALEVLVKGV	ALEVLVKGV
LLDAFSIKL	LLDAFSIKL
AIDDVDIDL	AIDDVDIDL
FLPLKWSLA	FLPLKWSLA
ALDVMVSTF	ALDVMVSTF
RLPGIPITV	RLPGIPITV
RIIDVIDKELI	IIDVIDKEL
ILVDTVWAL	ILVDTVWAL
RLPPGPAGL	RLPPGPAGL
KMPDDVWLV	KMPDDVWLV
YVDDVISRI	YVDDVISRI
FLPFPLPLF	FLPFPLPLF
RLDEAFDFV	RLDEAFDFV
RLDQVEQEL	RLDQVEQEL
KIVPVEITI	KIVPVEITI
ALDVSFNKF	ALDVSFNKF
YLDLRSFQM	YLDLRSFQM
FLADPSAFVAA	FLADPSAFV
FLDPGGPMMKL	FLDPGGPMM
FLDDPQAV	FLDDPQ-AV
ALYPVVSAA	ALYPVVSAA
AIYDFTDTV	AIYDFTDTV
LIDENYLDRL	LIDENYDRL
NLPPDLVNV	NLPPDLVNV
FLDSLIYGA	FLDSLIYGA
TADEVHYFL	TADEVHYFL
GIDRIISQV	GIDRIISQV
YIDIADRSQVL	YIDIADSQV
KLPNFGFVV	KLPNFGFVV
VLDFCYHLL	VLDFCYHLL
NVDTVLMEL	NVDTVLMEL
ILDEPTNNL	ILDEPTNNL
SVVGIPVFRV	SVVGIPFRV
SVPDVTHHL	SVPDVTHHL
RLDIVHENL	RLDIVHENL
KLPGNISSL	KLPGNISSL
IIDDHPEVTV	IIDDHPVTV
SGPGVVLYL	SGPGVVLYL
FLMNEVIKL	FLMNEVIKL
FLDTIKSNL	FLDTIKSNL
SLDPDIDTLKL	SLDPDIDTL
YVSEILEKV	YVSEILEKV
LLPEHFLFL	LLPEHFLFL
VMAPHEPLV	VMAPHEPLV
IIDDTIFNL	IIDDTIFNL
YIGPVLVSV	YIGPVLVSV
SLVPVYVKV	SLVPVYVKV
YLSDNVHLV	YLSDNVHLV
YLPQLIPHM	YLPQLIPHM
NAPWAVTSL	NAPWAVTSL
LAPELFVNV	LAPELFVNV
VLDPPTDLKF	VLDPPTLKF
FLIPIYHQV	FLIPIYHQV
RLFDDSTVTTV	FDDSTVTTV
LLDGLHEDL	LLDGLHEDL
FLPETRIMTSV	FLPETRIMT
FLHEATVRL	FLHEATVRL
AMDPAVPNM	AMDPAVPNM
VLDGVLMEL	VLDGVLMEL
RIPIAVSGV	RIPIAVSGV
TLPSTVAVTSV	TLPSTV-AV
MVDPFHTLF	MVDPFHTLF
AVDVEGLYTL	AVDVEGYTL
FLDLIPQDTL	FLDLIPDTL
LLDVTPLSL	LLDVTPLSL
SLIDQFFGV	SLIDQFFGV
YLDKDLKQYM	YLDKDLQYM
VLDSFVEKL	VLDSFVEKL
LIDGQVIQL	LIDGQVIQL
ILPEQGLQV	ILPEQGLQV
KLDEFGEQL	KLDEFGEQL
VVDNLLFKL	VVDNLLFKL
GMDLVVKTV	GMDLVVKTV
LLMEHIQEI	LLMEHIQEI
VLDEVVTVL	VLDEVVTVL
QIDKVFNNI	QIDKVFNNI
FMDTLSDLKM	FMDTLSLKM
AVDWLHELL	AVDWLHELL
SVDEVARQL	SVDEVARQL
NLDKLYHGL	NLDKLYHGL
FLLPLIIVL	FLLPLIIVL
HMMPDLPNV	HMMPDLPNV
ILDDSHLLV	ILDDSHLLV
TIDIQHPPL	TIDIQHPPL
VVDGVHGAFI	VVDGVHAFI
FLDPVIKTSF	FLDPVITSF
IAPPGTPAV	IAPPGTPAV
GLVPFLVSV	GLVPFLVSV
EIKDKTAEL	EIKDKTAEL
LLDVFYNRL	LLDVFYNRL
KIAPNTPQL	KIAPNTPQL
YLDDLLPKL	YLDDLLPKL
YLDEAGRGHSF	YLDEAGRGH
MLQPYMPTV	MLQPYMPTV
LLASEVPQL	LLASEVPQL
YLPVGSHNL	YLPVGSHNL
ASPPLITNV	ASPPLITNV
VLDPESVEL	VLDPESVEL
YIDKDMIHI	YIDKDMIHI
KLPSFLANV	KLPSFLANV
YLDEAHSIGAL	YLDEAHIGA
VLPWVLLTL	VLPWVLLTL
ITPDEFHFV	ITPDEFHFV
SMPTQLHSL	SMPTQLHSL
KLPDVYGVF	KLPDVYGVF
SLAGLGAYQL	SLAGLGYQL
FLDHVRTSF	FLDHVRTSF
ALDEIAWLF	ALDEIAWLF
FLDELGQHISL	FLDELGQHI
LLEDVTWKYTA	LLEDVTWKY
SLDDVEGMSV	SLDDVEMSV
TADPLSLLRNV	TADPLSLLR
LLDENNVSSYL	LLDENNVSS
HLDLPSNNNLV	HLDLPSNNL
MLDSVEKLL	MLDSVEKLL
FLDGHDLQL	FLDGHDLQL
LIFDQSGTYL	LIFDQSTYL
ALDATHQQL	ALDATHQQL
FQDPVPLTV	FQDPVPLTV
VLDDILEKI	VLDDILEKI
HVDEFIDELL	HVDEFIDEL
NIPPHLQWEV	NIPPHLWEV
FLLEKPFSV	FLLEKPFSV
FVDDGTETHF	FVDDGTTHF
LLPQDKKEYRL	LLPQDKKEY
NVVDVFHAV	NVVDVFHAV
FLIEPEHVNTV	IEPEHVNTV
FLDENIGGVAV	FLDENIGGV
MVPAQRGASP	MVPAQRASP
HLDSMDWLEL	HLDSMDLEL
GLDGPPPTV	GLDGPPPTV
FLLEKGYEV	FLLEKGYEV
ALDNNPLLL	ALDNNPLLL
VLDGTIEYM	VLDGTIEYM
TVDDLQAKL	TVDDLQAKL
YLDQGTQIFL	YLDQGTIFL
FLPTLLHQA	FLPTLLHQA
GLDELFVQV	GLDELFVQV
FLPLHYDYL	FLPLHYDYL
VLPESLPVL	VLPESLPVL
ILPKILQDV	ILPKILQDV
ALDWVTKKL	ALDWVTKKL
ILPEEITNL	ILPEEITNL
ALPQEFAAL	ALPQEFAAL
FVHDLVLYL	FVHDLVLYL
SLPAKFKKL	SLPAKFKKL
ALDPSFPRMNL	ALDPSFPRM
KIWESFPHQAL	KIWESFHQA
TTPPIWHL	TTPPIW-HL
ILDPHVVLL	ILDPHVVLL
ALPEAIAAL	ALPEAIAAL
ILPVPAFNV	ILPVPAFNV
IIFVPVPQL	IIFVPVPQL
YLEDFITNI	YLEDFITNI
SLDRFYEMF	SLDRFYEMF
QLDDQYSRF	QLDDQYSRF
HLFETISQA	HLFETISQA
VVDPIVSNFL	VVDPIVNFL
SILQTLILV	SILQTLILV
ILPEIIPIL	ILPEIIPIL
ALPEPQEAQKL	ALPEPQEAQ
GMDEVYNLF	GMDEVYNLF
FLSTINVGL	FLSTINVGL
FLLDKKIGV	FLLDKKIGV
SMPDFDLHL	SMPDFDLHL
VIPGMFKEV	VIPGMFKEV
TLPDLVPQL	TLPDLVPQL
LLREKVEFL	LLREKVEFL
YIDSIPKTL	YIDSIPKTL
TLPFQLSSV	TLPFQLSSV
FLDTLLEEL	FLDTLLEEL
GLSAFLHAI	GLSAFLHAI
RMDEEFTKI	RMDEEFTKI
RLDAMFRAF	RLDAMFRAF
NLPWKFEHI	NLPWKFEHI
VAPGKGILAA	VAPGKGILA
FLSEVFAQL	FLSEVFAQL
FLDGYVSQL	FLDGYVSQL
QAPGVLPSA	QAPGVLPSA
YLFTSPQRV	YLFTSPQRV
LVDQRELYL	LVDQRELYL
FIPLPFAEA	FIPLPFAEA
LLPPWVIYL	LLPPWVIYL
LLGPPPVGV	LLGPPPVGV
SLPESSLTDLL	SLPESSTDL
ALDLVYGNAL	ALDLVYNAL
ALDILITNV	ALDILITNV
KGPPALNIAV	KGPPALIAV
AVDYFFVEL	AVDYFFVEL
MLPDQEYKV	MLPDQEYKV
KLDVGNAEV	KLDVGNAEV
TAHLTFVIDCT	TAHLTF-VI
YTPPAGAKV	YTPPAGAKV
YLDPAQRGV	YLDPAQRGV
YLFEPVAKA	YLFEPVAKA
SLDALLSQV	SLDALLSQV
KVFDSHPVLHV	KVFDSHPVL
QLRDFYFSV	QLRDFYFSV
LLERAIESL	LLERAIESL
LLVPTSGIYFV	LVPTSGIYF
KIDAFHYVQL	KIDAFHVQL
LLDEAQVTL	LLDEAQVTL
KLMTALVNV	KLMTALVNV
FLDEEVKLI	FLDEEVKLI
SMDSSHVSL	SMDSSHVSL
YLDIKGLLDV	YLDIKGLDV
VLDDKLVFV	VLDDKLVFV
KIDKFFKQL	KIDKFFKQL
TVDALVLRF	TVDALVLRF
VLFNKLTYL	VLFNKLTYL
VMDLSIVRL	VMDLSIVRL
TPVQTVTIVQ	TPVQTVTIV
SLDTQYSKV	SLDTQYSKV
RLPGGNEIGMV	RLPGGNIGM
SVVEQAWKL	SVVEQAWKL
GLDPARVNV	GLDPARVNV
YLFEEIAKI	YLFEEIAKI
AVDEDRKMYL	AVDEDRMYL
KVDLAVVEV	KVDLAVVEV
SLPKKLALL	SLPKKLALL
PIEHGIITNWD	IEHGIITNW
VLDGLSNILKM	VLDGLSNIL
VMDKLSSIRL	VMDKLSIRL
AVPFSLDSV	AVPFSLDSV
ILPDDIGAAL	ILPDDIAAL
LLDEPTNML	LLDEPTNML
RLPDLIKEV	RLPDLIKEV
GVIATIAFL	GVIATIAFL
YLDSIYFNRF	YLDSIYNRF
LVDHAYETYF	LVDHAYTYF
YLPPSVASI	YLPPSVASI
YLYKYLWRL	YLYKYLWRL
YVDPSTDERL	YVDPSTERL
HIFLNNYQL	HIFLNNYQL
LLLEMALSV	LLLEMALSV
ESGPSIVH	ESGPSI-VH
KLFEKVKEV	KLFEKVKEV
RVDDLYTLL	RVDDLYTLL
SVNPYIVKL	SVNPYIVKL
ALDSGFNSV	ALDSGFNSV
SLHFLILYV	SLHFLILYV
IIDQHTFEVL	IIDQHTFEV
FIDNLDERL	FIDNLDERL
VLPAVSLEV	VLPAVSLEV
FLDEPTNHLDI	FLDEPTNHL
GLDIITNKV	GLDIITNKV
GVPQALFGV	GVPQALFGV
FAPAVGPALG	FAPAVGPAL
ILDGIIREL	ILDGIIREL
LIDEGSHMV	LIDEGSHMV
LMTDVLVFL	LMTDVLVFL
RLPDGWSQV	RLPDGWSQV
SLPNEEIVQKI	SLPNEEIVQ
MVDGLRITF	MVDGLRITF
LLDDRHDSGL	LLDDRHSGL
SQPWEVPFV	SQPWEVPFV
LLPDTAKQQEL	LLPDTAQEL
TLDKIMILF	TLDKIMILF
LLDHLSIVYV	LLDHLSVYV
LLPERPSYL	LLPERPSYL
QLDDLKVEL	QLDDLKVEL
KLPENQAIQM	KLPENQIQM
TLMIKFEEA	TLMIKFEEA
FLFEDFSKA	FLFEDFSKA
KMPEGTFLV	KMPEGTFLV
VVPDTSRIYV	VVPDTSIYV
FLPEALDFVGV	FLPEALDFV
FLDMNFQSL	FLDMNFQSL
FLDLLQERI	FLDLLQERI
VVDTFDIRI	VVDTFDIRI
KLYSISSQV	KLYSISSQV
YLHSYLTYI	YLHSYLTYI
KIEDLIKYL	KIEDLIKYL
QVDDIRSFL	QVDDIRSFL
FVIAELVNV	FVIAELVNV
YLPTKLAAV	YLPTKLAAV
KILSELFTV	KILSELFTV
ALDELENLI	ALDELENLI
YLSAKVEAL	YLSAKVEAL
NIVEKLREV	NIVEKLREV
FLPAGIVAV	FLPAGIVAV
FADGVYLVLL	FADGVYLVL
YLDEYIARM	YLDEYIARM
IMPTIFNLI	IMPTIFNLI
SVDEVYEFI	SVDEVYEFI
NVEIDPEIQ	NVEIDPEIQ
LLDTTQKYL	LLDTTQKYL
ILDDFRMHF	ILDDFRMHF
VVPAALKVV	VVPAALKVV
RVDGLLHQL	RVDGLLHQL
SVDEVEISV	SVDEVEISV
IMDTPGHVNF	IMDTPGVNF
VVFPTITLV	VVFPTITLV
KLDDVTDEYLM	KLDDVTEYL
ALNEQIARL	ALNEQIARL
FVPEPSSTMGL	FVPEPSSTM
ALEPHINAQIM	ALEPHIAQI
AVDNILLKL	AVDNILLKL
RLQDAIAKV	RLQDAIAKV
FVDDETKLTL	FVDDETLTL
ALPDLTKVIQL	ALPDLTKVI
YIEEAIEKL	YIEEAIEKL
AIFAVMSRV	AIFAVMSRV
ILDHEVPSL	ILDHEVPSL
RLPEQPVDV	RLPEQPVDV
GLPGVMPNI	GLPGVMPNI
LMNPMVPGL	LMNPMVPGL
TLWEIAKAEV	TLWEIAAEV
ALDDFSISVL	ALDDFSISV
FIPYLVVKV	FIPYLVVKV
TANGGLALASI	TANGGLALA
FLNDEVWNL	FLNDEVWNL
VLDNNSVRL	VLDNNSVRL
IIDTPISEMGF	IIDTPISEM
LLPEDSQKL	LLPEDSQKL
ITPEPFHHV	ITPEPFHHV
KMWEEAISL	KMWEEAISL
YQVGQLYSV	YQVGQLYSV
SLDGLAVVNV	SLDGLAVNV
ALNENINQV	ALNENINQV
VVPQLFITV	VVPQLFITV
ALMPVLNQV	ALMPVLNQV
VLPPFSTKV	VLPPFSTKV
ALLEADVNIKL	LLEADVIKL
AIMDIVIKV	AIMDIVIKV
SIVDLPVHQL	IVDLPVHQL
SQPPVQVSV	SQPPVQVSV
FLPRKFPSLR	FLPRKFPSL
SLDDVGEKL	SLDDVGEKL
YLLDLHSYL	YLLDLHSYL
TVFSHAQTVVL	TVFSHAQTV
RLDEALQGSAL	RLDEALSAL
ILDVSVKTV	ILDVSVKTV
AMDVVYALK	AMDVVYALK
ALPPAIQEEVL	ALPPAIEEV
TLPPFPTRL	TLPPFPTRL
QAPQVLPQV	QAPQVLPQV
TLPEENYQV	TLPEENYQV
FVDESHIRM	FVDESHIRM
YLDQVKIRF	YLDQVKIRF
LLHEKLYEL	LLHEKLYEL
LMYPYIFHV	LMYPYIFHV
HVLDVIHEV	HVLDVIHEV
FLDENVHFA	FLDENVHFA
FASPTQVFF	FASPTQVFF
FADGVYLVL	FADGVYLVL
LLDELIKSGQL	LLDELIKSG
KMPEVIPILEV	KMPEVIPIL
FVQEVVQSQQV	FVQEVVQSQ
YLFERIKEL	YLFERIKEL
KLLEAISSL	KLLEAISSL
KMMDVTVTI	KMMDVTVTI
VVDPVEKTMEL	VVDPVEKTM
LLPYVLENV	LLPYVLENV
LIDWINDVLV	LIDWINVLV
NVPDVYTQI	NVPDVYTQI
YLMEVTHDL	YLMEVTHDL
QLPESAYMHQL	QLPESA-YM
FLEDLVPYL	FLEDLVPYL
SVLEALSGV	SVLEALSGV
KVWGNVVTV	KVWGNVVTV
TLLSLQPQI	TLLSLQPQI
HLDLPSNNNL	HLDLPSNNL
LLDQPVLEQRL	LLDQPVLEQ
VIDKLVVHL	VIDKLVVHL
FVPAPWLSV	FVPAPWLSV
MTLPVDAVISV	TLPVDAISV
FLDLLKDAGL	FLDLLKAGL
YLDQLTQIL	YLDQLTQIL
AQYEDIAQKS	AQYEDIAQK
FLDKPTLL	FLDKPT-LL
SVDPVLSIL	SVDPVLSIL
FLDLPEPLL	FLDLPEPLL
KLPGLQATV	KLPGLQATV
NVPGLYIAV	NVPGLYIAV
GLDHIVDKV	GLDHIVDKV
FVPPTFKSV	FVPPTFKSV
LMDAIQTNF	LMDAIQTNF
LLVGFVHYL	LLVGFVHYL
YLDEIVKEV	YLDEIVKEV
VVDGNFEEV	VVDGNFEEV
THAVVTVPAYF	AVVTVPAYF
FLDTISDFHL	FLDTISFHL
ALLTYLEQV	ALLTYLEQV
VLDSAFEQL	VLDSAFEQL
ALDEGDIALL	ALDEGDIAL
YVYEYLLHV	YVYEYLLHV
TLADVLYHV	TLADVLYHV
FLSELQYYL	FLSELQYYL
FVDQLVEGL	FVDQLVEGL
RLPDGFTQL	RLPDGFTQL
LLPEIMPGL	LLPEIMPGL
ILADKSSFISV	ILADKSSFI
LLDDNMQIRL	LLDDNMIRL
YIDDITVTT	YIDDITVTT
SMMQTLLTV	SMMQTLLTV
VIDEIGKMEL	VIDEIGMEL
LLDNIIQHM	LLDNIIQHM
YVDKFYRSL	YVDKFYRSL
WVDEMQVQL	WVDEMQVQL
KLPDGFSQL	KLPDGFSQL
YLADIFTKL	YLADIFTKL
FVDELRITL	FVDELRITL
YLDPVQRDL	YLDPVQRDL
VVDWLYHNV	VVDWLYHNV
FLFELPSRL	FLFELPSRL
LLDPASHKL	LLDPASHKL
QVDPDTHLL	QVDPDTHLL
FLFDGSPTYV	FLFDGSTYV
ALPKAGKFGPA	ALPKAGKFG
LLDSMHEVV	LLDSMHEVV
QVDEVVDIM	QVDEVVDIM
ALPHVVPTL	ALPHVVPTL
KLPDTTSIFAL	KLPDTTSIF
VLDLSWNKL	VLDLSWNKL
ILPMSLLSV	ILPMSLLSV
AVDPGLPSV	AVDPGLPSV
TVDKILEAL	TVDKILEAL
KVPEIEVTV	KVPEIEVTV
LLGPKPFPL	LLGPKPFPL
IMDHVEESL	IMDHVEESL
RLQEFIDEV	RLQEFIDEV
SIDDVDSKL	SIDDVDSKL
YLDGVHTVF	YLDGVHTVF
TLPGHIQAV	TLPGHIQAV
YVINVTTHL	YVINVTTHL
SLDEAYLNITK	SLDEAYLNI
VVDSSNTAL	VVDSSNTAL
VVVGDLVEV	VVVGDLVEV
LVDEIMMTL	LVDEIMMTL
LLPAVKVFL	LLPAVKVFL
MLPLLLTAV	MLPLLLTAV
VELVDESLFD	LVDESL---
SVVGPVKGV	SVVGPVKGV
HVDGVAVTL	HVDGVAVTL
ALPEDLVEV	ALPEDLVEV
SVDEVYEFIP	SVDEVYEFI
SVNGVFKEV	SVNGVFKEV
ILDIPTHTI	ILDIPTHTI
KLQEQIFHL	KLQEQIFHL
FLIPKFFEL	FLIPKFFEL
VMPGEGDLPQM	VMPGEGDLP
AVPAVLPSF	AVPAVLPSF
ALDTTRHEL	ALDTTRHEL
YLEVFSDKF	YLEVFSDKF
SIPPPPPPA	SIPPPPPPA
SVDDLVEKL	SVDDLVEKL
NIIPYITNV	NIIPYITNV
VLVAELVGV	VLVAELVGV
ALFGALFLA	ALFGALFLA
LLDTMVDTFL	LLDTMVTFL
FVDGVSTVARF	FVDGVSTVA
ALDWVSREQSV	ALDWVSREQ
VLDQVEARL	VLDQVEARL
SLDLPHSEL	SLDLPHSEL
VSPPKFVFV	VSPPKFVFV
ALDGFLFVV	ALDGFLFVV
NLPWYLPSA	NLPWYLPSA
FVDKLFESL	FVDKLFESL
ALHGRADLI	ALHGRADLI
LLDMPLWYL	LLDMPLWYL
LLDGFPRTL	LLDGFPRTL
SLDGKAIKV	SLDGKAIKV
NVIGEPFLNV	VIGEPFLNV
NIDELITFL	NIDELITFL
FLPLPVVQL	FLPLPVVQL
SLPDSGVVEYL	SLPDSG-VV
LMPATLARA	LMPATLARA
NIDEIYKAL	NIDEIYKAL
ILWAASKSQLL	ILWAASSQL
LLDENLLKM	LLDENLLKM
FINIVVHSV	FINIVVHSV
LVDMVNDGV	LVDMVNDGV
FLPPGYKIEV	FLPPGYIEV
TLMDILPRI	TLMDILPRI
WLDGSPVTL	WLDGSPVTL
KVDWLTEKM	KVDWLTEKM
TMPDLYHLL	TMPDLYHLL
KILPVMVTL	KILPVMVTL
VLDDKDYFLF	VLDDKDYFL
VLDFGRPIAM	VLDFGRPIA
TVDQVLSEV	TVDQVLSEV
NIDEAITLL	NIDEAITLL
NVDYIIQEL	NVDYIIQEL
TLPEDISQL	TLPEDISQL
QLDPLPTTL	QLDPLPTTL
KLDAILKNV	KLDAILKNV
LLDEDLRQTV	LLDEDLQTV
LLDLMIAKI	LLDLMIAKI
FIDSVLVKI	FIDSVLVKI
LLPIILTAL	LLPIILTAL
HLDEDQQEL	HLDEDQQEL
FVYKGGKIYKV	YKGGKIYKV
QLDDLYLIAI	QLDDLYIAI
SLDSVFSDKL	SLDSVFDKL
SLPDPVLGA	SLPDPVLGA
ILPPPVHV	ILPPPV-HV
FVDYVAVEQL	FVDYVAEQL
VLDGKIVAL	VLDGKIVAL
YVDPQFLTYM	YVDPQFTYM
QTHSVFVNV	QTHSVFVNV
NAPKWVPSL	NAPKWVPSL
AAPGGLIGV	AAPGGLIGV
VLWKEILFL	VLWKEILFL
SLADLYFRA	SLADLYFRA
YLPHAPPFA	YLPHAPPFA
KVDILYNNI	KVDILYNNI
MVDIPPPFD	MVDIPPPFD
IIDAIVDFSS	IIDAIVDFS
KLFNVTSTL	KLFNVTSTL
YVPTSYVEV	YVPTSYVEV
SLSELQISYV	SLSELQSYV
YVDDTQFVRF	YVDDTQVRF
KSPLNFSTV	KSPLNFSTV
MIDKLTLTF	MIDKLTLTF
MMPSRFDDL	MMPSRFDDL
MMDRIVTGL	MMDRIVTGL
ILDDSPKEI	ILDDSPKEI
QLAELLPSV	QLAELLPSV
SIDTLIFTL	SIDTLIFTL
ALPGGAAVAAV	ALPGGAAVA
YLPEDFIRV	YLPEDFIRV
HLDEAIHVL	HLDEAIHVL
FLDITNPKAVL	FLDITNPKA
ILSQYITFV	ILSQYITFV
YTWEEVFRV	YTWEEVFRV
ALDTVWREL	ALDTVWREL
LLPDQPPYHL	LLPDQPYHL
YIDDLGHLHV	YIDDLGLHV
QVDEVVDIMRV	QVDEVVDIM
MMPPPPAAM	MMPPPPAAM
LLPSEGIVHL	LLPSEGVHL
MVDGTLLLL	MVDGTLLLL
SLDELIQSQQI	SLDELIQSQ
ILPPFIWTL	ILPPFIWTL
FLDDVVHSL	FLDDVVHSL
RAPEFLPEV	RAPEFLPEV
ALQDVPLSSV	ALQDVPSSV
LLDSGAFHLL	LLDSGAFHL
ILDDLFLHTL	ILDDLFHTL
SVDVADLIGL	SVDVADIGL
ILDGISNIKL	ILDGISIKL
HVDKLYQKL	HVDKLYQKL
YLDFTNPKV	YLDFTNPKV
YLDTINRSV	YLDTINRSV
KIDYFLEYF	KIDYFLEYF
SAINEVVTREY	AINEVVTRE
GLDNINVFL	GLDNINVFL
ALLELLHEL	ALLELLHEL
LDNICPVNI	LDNICPVNI
YLVKIFEEL	YLVKIFEEL
ILDELAEKL	ILDELAEKL
RVVDLITNL	RVVDLITNL
YLPERQKYEML	YLPERQYEM
NVDGLLVQL	NVDGLLVQL
FLPEGVNKL	FLPEGVNKL
KVLGALLFV	KVLGALLFV
FIGEDENVHS	FIGEDE-NV
AMPNIAVGQNV	AMPNIAVGQ
KLLDILSYL	KLLDILSYL
VLPSITTEI	VLPSITTEI
ILDVNPQAL	ILDVNPQAL
TLPTVRMIVDV	TLPTVRMIV
ILDKIVQKV	ILDKIVQKV
VTDEVFNFL	VTDEVFNFL
ILDPAYPDITL	ILDPAYPDI
LVDTSYKTL	LVDTSYKTL
MVDGTLLLLL	MVDGTLLLL
SLPSPFLRA	SLPSPFLRA
SLPFQVANV	SLPFQVANV
TLPNIYVTL	TLPNIYVTL
SIPIFLPEV	SIPIFLPEV
LLDEEGTFSL	LLDEEGFSL
KAAKPKKAPKS	AKPKKAPKS
AIPGVVEKV	AIPGVVEKV
LLPVITKEL	LLPVITKEL
NLFPPMLTV	NLFPPMLTV
TLDSILFLL	TLDSILFLL
FIWPMLIHI	FIWPMLIHI
FLDPPYSRVI	FLDPPYSRV
FVDTDSDIRL	FVDTDSIRL
TMDDLTTAL	TMDDLTTAL
YVDDVISRIDR	YVDDVISRI
ATDNIILTV	ATDNIILTV
KVFPSEITDTV	FPSEITDTV
LQDELFELL	LQDELFELL
YLNHLEPPV	YLNHLEPPV
SIAEVVHQL	SIAEVVHQL
LRDEFLVKI	LRDEFLVKI
RMDPVNNINV	RMDPVNINV
RLPPPFPGL	RLPPPFPGL
ALPPYAPKL	ALPPYAPKL
ALDDHHALHL	ALDDHHLHL
VLDKLLLYL	VLDKLLLYL
FADAVQELL	FADAVQELL
YMDAPKAAL	YMDAPKAAL
LLDDKAQAL	LLDDKAQAL
KVAPAPAVV	KVAPAPAVV
TLDEKIEKV	TLDEKIEKV
IIDPNHEIEF	IIDPNHIEF
YLPTLWVKL	YLPTLWVKL
YLPGLFYRV	YLPGLFYRV
FLDLGPPGI	FLDLGPPGI
NIVEKIDFDSV	IVEKIDDSV
KLWTGGLDNTV	KLWTGGNTV
VVVDPIQSV	VVVDPIQSV
ILPEAFSNL	ILPEAFSNL
YVDAGTPMYL	YVDAGTMYL
LILDPIFKV	LILDPIFKV
ILPDDLPEL	ILPDDLPEL
LLDNILQRI	LLDNILQRI
FLWDVPSNWTL	FLWDVPWTL
ALDVANKIGI	ALDVANIGI
HLPPPPKLL	HLPPPPKLL
VGPEELPVV	VGPEELPVV
VVVPPFLQPE	VVVPPFLQP
VVDDLGQKITL	VVDDLGQKI
VADTVYRAL	VADTVYRAL
GADAIYDHI	GADAIYDHI
LLDRMVHLL	LLDRMVHLL
TLQEKIHRL	TLQEKIHRL
IVHELNTTV	IVHELNTTV
LLPDEDALPFL	LLPDED-AL
ILPEHSVLQNI	ILPEHSVLQ
SIAAVLPKV	SIAAVLPKV
HLPYLFHVV	HLPYLFHVV
KLIEELETL	KLIEELETL
ALDTIRPEHVL	ALDTIREHV
TLDGLPPLRL	TLDGLPLRL
KQPEDYFYL	KQPEDYFYL
FLVEPQEDTRL	LVEPQETRL
FLGDPPPGL	FLGDPPPGL
FLLEPGNLEV	FLLEPGLEV
YMDSPQSIGF	YMDSPQIGF
SLWSIISKV	SLWSIISKV
VLDEADEML	VLDEADEML
GLDAIVTQL	GLDAIVTQL
VVDEIYFKV	VVDEIYFKV
YLPGGTTGL	YLPGGTTGL
GLLEIVTSV	GLLEIVTSV
ILDEPTNHL	ILDEPTNHL
YLDEDTIYH	YLDEDTIYH
VMDAALLLI	VMDAALLLI
ALDEPPYLTV	ALDEPPLTV
VAPALAPKV	VAPALAPKV
VLPNFLPYNV	VLPNFLYNV
KVDPVVFVTL	KVDPVVVTL
LSPGLLPHL	LSPGLLPHL
ALDPLADKILI	ALDPLADKI
VLDAITQEL	VLDAITQEL
AVPPIWSV	AVPPIW-SV
ALPGKPPFL	ALPGKPPFL
MLEEVFHNL	MLEEVFHNL
IVPKEEGVISV	IVPKEEGVI
TIPEAWVGQEV	TIPEAWVGQ
ALPGVAVSM	ALPGVAVSM
LIDDLHSQML	LIDDLHSQM
LEPDELAG	LEPDEL-AG
SLDSVHLQM	SLDSVHLQM
AVDAVIAEL	AVDAVIAEL
KLFGMIITI	KLFGMIITI
RIPAIFSPA	RIPAIFSPA
NLPTILVEI	NLPTILVEI
ILPNEDDKFTV	ILPNEDDKF
FLDPIMSTL	FLDPIMSTL
NLLDLLTEV	NLLDLLTEV
IWHHTFYNELR	WHHTFYNEL
SLQEEIAFL	SLQEEIAFL
ILDAVVVVV	ILDAVVVVV
TLDGKVQYL	TLDGKVQYL
AMDLIISTL	AMDLIISTL
YIVDLLTHL	YIVDLLTHL
TTDGVYEGV	TTDGVYEGV
ILDESHERV	ILDESHERV
KLVNILVQL	KLVNILVQL
RLDEILSRI	RLDEILSRI
QVDHVFREV	QVDHVFREV
ALDQAYMRI	ALDQAYMRI
VLPPEPVQL	VLPPEPVQL
LTPPPATHL	LTPPPATHL
ILDTLVFAF	ILDTLVFAF
HLPEQAFYMV	HLPEQAFYM
FLDLTQLEL	FLDLTQLEL
SQPPVFKV	SQPPVF-KV
NIDDVVRFL	NIDDVVRFL
AVDGVIISL	AVDGVIISL
FLLPVIMRA	FLLPVIMRA
RLPEASVHRA	RLPEASVHR
YIDRIIVAI	YIDRIIVAI
LLDHPNGDGL	LLDHPNDGL
YLSGIAHFL	YLSGIAHFL
IIEENIPELL	IIEENIPEL
YVVKETIGV	YVVKETIGV
SLPVEVQEV	SLPVEVQEV
SLDEAQFVL	SLDEAQFVL
QLDIIIHSL	QLDIIIHSL
QVPSSFESV	QVPSSFESV
VLPDLVVEI	VLPDLVVEI
ILDVTVVYL	ILDVTVVYL
FIPPDGNFRL	FIPPDGFRL
ILDPIFKVF	ILDPIFKVF
ILDPVDPTNNV	ILDPVDPTN
ALDKIDQQYL	ALDKIDQYL
FTDEEVDELYR	FTDEEVDEL
KIWDLKERTNV	KIWDLKERT
NMDSVFKELL	NMDSVFKEL
LLDTVTMQV	LLDTVTMQV
RLDSLTTLYL	RLDSLTLYL
ALPKELPLISS	ALPKELPLI
ALPEILFAKV	ALPEILAKV
YLDAIYDVTV	YLDAIYVTV
KLLEKLYKV	KLLEKLYKV
ILDNVIQPLV	ILDNVIPLV
YENEVALR	YENEVA-LR
KLLFWVTEV	KLLFWVTEV
ILDISEHTL	ILDISEHTL
LLRLPTPTV	LLRLPTPTV
YVDDGLISL	YVDDGLISL
FLPEPMGTANI	FLPEPMGTA
KLDQVLVEF	KLDQVLVEF
AVDPNRAVPL	AVDPNRVPL
SVDETTQAM	SVDETTQAM
TLDKSWWTL	TLDKSWWTL
TLHSIIISL	TLHSIIISL
KLFDTQQFL	KLFDTQQFL
YLPEELRGVDF	YLPEELRGV
MLYEFFVKV	MLYEFFVKV
TMDPFVDRI	TMDPFVDRI
LFSAFKAL	LFSAFK-AL
IIPASIPGSEV	IIPASIPGS
GLIDVHVHL	GLIDVHVHL
VVDDLLDQI	VVDDLLDQI
HLDSMNVSL	HLDSMNVSL
LLVEPSRNDLL	LLVEPSNDL
ILDDIGHGV	ILDDIGHGV
YLDNFWPDL	YLDNFWPDL
GLPPAMQKV	GLPPAMQKV
NLPMSVIIVGV	NLPMSVIIV
ILDMTAVLL	ILDMTAVLL
IVDDKFFKL	IVDDKFFKL
LLDSVEVGL	LLDSVEVGL
TLDEVTVTI	TLDEVTVTI
NQPPEDGISSV	QPPEDGSSV
LIPEVFTYF	LIPEVFTYF
SISDVIAQV	SISDVIAQV
LLPAVVMHL	LLPAVVMHL
GLFPTSHSV	GLFPTSHSV
KVVDVVRNLVF	KVVDVVRNL
FTDDQWLNV	FTDDQWLNV
VLDEVDQML	VLDEVDQML
YADPVTDLL	YADPVTDLL
QLDVPVVKV	QLDVPVVKV
NVKVDPEIQ	NVKVDPEIQ
SLPRFQVTL	SLPRFQVTL
ALDEDFAPAKL	ALDEDFAPA
LVDVIEDKL	LVDVIEDKL
YIDSKFEDYL	YIDSKFDYL
ALPPPPPAA	ALPPPPPAA
WLPNHVVFL	WLPNHVVFL
AVDDIMVTL	AVDDIMVTL
ALMADMVYV	ALMADMVYV
VAPDGHIFLEA	VAPDGHIFL
YLDKIRDLL	YLDKIRDLL
QLSPVLLYL	QLSPVLLYL
RILDYVINL	RILDYVINL
YLPSSFPVL	YLPSSFPVL
FVDEFLTYL	FVDEFLTYL
NVDSLITRL	NVDSLITRL
FLDSEVSEL	FLDSEVSEL
SNGLNITDGAF	NGLNITDGA
FLDSTSPLL	FLDSTSPLL
LIYEETRGV	LIYEETRGV
VLDGRGHLL	VLDGRGHLL
ATPMPTPSV	ATPMPTPSV
IIVDIFHGL	IIVDIFHGL
FMSEYLIEL	FMSEYLIEL
RVDESLNIKV	RVDESLIKV
ALFEEVPEL	ALFEEVPEL
MIDMPVERM	MIDMPVERM
RLTEEFQNV	RLTEEFQNV
LLPPDALVGL	LLPPDAVGL
TLDDIKEWL	TLDDIKEWL
MTDEIFHDV	MTDEIFHDV
LLPTAPTTV	LLPTAPTTV
RLPAWQPIL	RLPAWQPIL
MLLDVMHTV	MLLDVMHTV
FIVEETLPL	FIVEETLPL
FLDERTPRL	FLDERTPRL
SLQETIQSL	SLQETIQSL
NVDNQAVLL	NVDNQAVLL
KVVIFLPQV	KVVIFLPQV
VLDSIIWAF	VLDSIIWAF
LLIGHLERV	LLIGHLERV
LLFDLIPVV	LLFDLIPVV
QLDGDPKEV	QLDGDPKEV
QLPNFAFSV	QLPNFAFSV
YLHNQGIGV	YLHNQGIGV
ALFPSTAQA	ALFPSTAQA
VLDEADVMI	VLDEADVMI
TLDEQVLSF	TLDEQVLSF
YLFDLPLKV	YLFDLPLKV
IIDGLFMEI	IIDGLFMEI
SLITRLLEV	SLITRLLEV
ILDISFNLL	ILDISFNLL
LVDHLNVGV	LVDHLNVGV
VIDPPAVNL	VIDPPAVNL
ILPDDPRQM	ILPDDPRQM
LLPEGPPAIAN	LLPEGPPAI
VLDGLLHGL	VLDGLLHGL
QVDKVNFHMF	QVDKVNFHM
VIDEADRIL	VIDEADRIL
LLDVPTAAV	LLDVPTAAV
FLPPEPTYTV	FLPPEPYTV
KLVGEFLEV	KLVGEFLEV
TLIGYFVGL	TLIGYFVGL
MVDPVTGDKL	MVDPVTDKL
SIDDLPTVL	SIDDLPTVL
NLDFVLSFL	NLDFVLSFL
MLDEMKDNLLL	MLDEMKDNL
LLDLHSYLL	LLDLHSYLL
MMPPPPMGM	MMPPPPMGM
FAPVNVTTEV	FAPVNVTEV
GIMKKAYEL	GIMKKAYEL
IVDPVDSTL	IVDPVDSTL
FVDPAQITMKV	FVDPAQITM
VLDDVPVQGFF	VLDDVPVQG
ALYTVIETV	ALYTVIETV
FLDEWLYKF	FLDEWLYKF
YLLHIFMEA	YLLHIFMEA
GLYELVWRV	GLYELVWRV
ALDDVTLPRL	ALDDVTPRL
FVPEKNFRV	FVPEKNFRV
SLDDLLQRL	SLDDLLQRL
LVDDNYFYLF	LVDDNYFYL
KIDDMMFVL	KIDDMMFVL
SLPENTVQV	SLPENTVQV
SISPIVLYL	SISPIVLYL
LLPPVVWLL	LLPPVVWLL
YLISQVEGHQV	LISQVEHQV
NLDHVYNRL	NLDHVYNRL
RIDAFVQSL	RIDAFVQSL
FIDDLPQEI	FIDDLPQEI
TLDMPDEEFRF	TLDMPDEEF
ALPEIFTEL	ALPEIFTEL
GLPRFGIEMV	GLPRFGIEM
ILPPDIGKL	ILPPDIGKL
ILIRPLVSV	ILIRPLVSV
YLPLYVARL	YLPLYVARL
AIDEISKSL	AIDEISKSL
ALADKELLPSV	LADKELPSV
RLDESAFVGL	RLDESAVGL
VLPPSYASDRL	VLPPSYASD
LLPPPPSSL	LLPPPPSSL
AIVDKVPSV	AIVDKVPSV
FLDEHHSVNF	FLDEHHVNF
LLPEYHQRV	LLPEYHQRV
GLDEVVRLL	GLDEVVRLL
FVDGLTFKV	FVDGLTFKV
LLPPLESLATV	LLPPLESLA
FLPLIVNTV	FLPLIVNTV
FLDDLFVFM	FLDDLFVFM
LLDQLHTLL	LLDQLHTLL
MLPPVLTHL	MLPPVLTHL
TLWVDPYEV	TLWVDPYEV
ILDGNQLHI	ILDGNQLHI
VLDFIEDYL	VLDFIEDYL
VLDPDLRMTF	VLDPDLMTF
HIWDPLTNV	HIWDPLTNV
ILPEKVARV	ILPEKVARV
FLDEAAARLL	FLDEAAARL
LLDKLLIRL	LLDKLLIRL
YGMTPDLTISL	MTPDLTISL
AMFENFVSV	AMFENFVSV
QAPDIDVQL	QAPDIDVQL
SIPNRIPKI	SIPNRIPKI
FSDEIRHNL	FSDEIRHNL
VTPRQFFNV	VTPRQFFNV
ILDKVILPQL	ILDKVIPQL
GLASRKPLVL	GLASRKPLV
FLPPDPTYTL	FLPPDPYTL
FGPEEDTAYL	FGPEEDAYL
TLNSFIHVL	TLNSFIHVL
YIDNLLVRV	YIDNLLVRV
KMYAVDTRV	KMYAVDTRV
NLWSLVAKV	NLWSLVAKV
LLDEEGHIKI	LLDEEGIKI
IIPEGTWI	IIPEGT-WI
RLDEAAQRL	RLDEAAQRL
FGPAKLPRL	FGPAKLPRL
NLPEETNEMML	NLPEETNEM
SQPEKVYTL	SQPEKVYTL
IIDPADTRLVL	IIDPADTRL
YLDEGFLL	YLDEGF-LL
ITPENLPQIL	ITPENLPQI
IIDEKKYYL	IIDEKKYYL
SLPEELPLL	SLPEELPLL
RLPMSIIIVGV	RLPMSIIIV
MVPEDVPRL	MVPEDVPRL
FMDDVGQTLL	FMDDVGQTL
VQDEFLEKL	VQDEFLEKL
ALHDILTEI	ALHDILTEI
NLPEETNEM	NLPEETNEM
RLDNLKAHL	RLDNLKAHL
KMDDPDYWRTV	KMDDPDYWR
YIDRIHIFF	YIDRIHIFF
VLSELLWQV	VLSELLWQV
FLDDLGLKF	FLDDLGLKF
WVDEINRHV	WVDEINRHV
LMDTLFNTKF	LMDTLFTKF
NIDEVVNKI	NIDEVVNKI
VLPAGALHQV	VLPAGAHQV
TVDEVVQWL	TVDEVVQWL
ILMGVLKEV	ILMGVLKEV
VVDHVFPLL	VVDHVFPLL
LLPDHTYSV	LLPDHTYSV
HIDNFLEQL	HIDNFLEQL
SLPALLFKA	SLPALLFKA
LLDFVKPEF	LLDFVKPEF
FMPVSSLIVGV	FMPVSSLIV
ILWEHLEQMI	ILWEHLEQM
SIPGGPVRL	SIPGGPVRL
RMPPPANLPSL	RMPPPAPSL
ILDPFQYQL	ILDPFQYQL
YIPDFLTLL	YIPDFLTLL
TAPPNAYTV	TAPPNAYTV
SVISVVSYL	SVISVVSYL
QLPPVIKNMAF	QLPPVIKNM
YVTEELPQL	YVTEELPQL
LIDKIIEYL	LIDKIIEYL
NLDSIIGRL	NLDSIIGRL
FLLHIQQQV	FLLHIQQQV
ILPEAQDYFL	ILPEAQYFL
LLPDDKLTL	LLPDDKLTL
ILDALHQAL	ILDALHQAL
WLPEVMILV	WLPEVMILV
LLPEEIKSSFL	LLPEEISSF
LVDIVDPKQV	LVDIVDKQV
LIGEFLEKV	LIGEFLEKV
VLMEMSYRL	VLMEMSYRL
LLPELRDWGV	LLPELRWGV
NMVAKVDEV	NMVAKVDEV
KLPVPLESV	KLPVPLESV
RLPPEIFGDAL	LPPEIFDAL
FVPEIFHRI	FVPEIFHRI
FIDKFTPPVV	FIDKFTPPV
YLDPLVFREF	YLDPLVREF
RLDEALRLYL	RLDEALLYL
LLDPSIIEAKM	LLDPSIIEA
YLLESVNKL	YLLESVNKL
FLPTILNQL	FLPTILNQL
RVDDVYSVL	RVDDVYSVL
RVDNFVIAL	RVDNFVIAL
RLDEPLASYI	RLDEPLSYI
SLDRPFTNL	SLDRPFTNL
GLDESKAKL	GLDESKAKL
SLKDMDLVEV	SLKDMDVEV
HVPSTDLILNV	HVPSTDLIL
FLYNPLTRV	FLYNPLTRV
FLDQVTGFL	FLDQVTGFL
AVVPPVNGV	AVVPPVNGV
LLPDMEATL	LLPDMEATL
LLDMSLVKL	LLDMSLVKL
VLDGLLYVV	VLDGLLYVV
SLPDHLPSV	SLPDHLPSV
VLDGLEFKV	VLDGLEFKV
MKHLPGPQ	MKHLPG-PQ
IMDSLFDKL	IMDSLFDKL
PASGTIFIDEV	ASGTIFDEV
QLWNNYFHL	QLWNNYFHL
ALQEKLWNV	ALQEKLWNV
KVDTVWVNVGG	KVDTVWVNV
AGLQFPVGR	AGLQFPVGR
LIDESVHAL	LIDESVHAL
FIQSIISTV	FIQSIISTV
FIDTAQHML	FIDTAQHML
ILDEQGRTV	ILDEQGRTV
VIDTPVFEL	VIDTPVFEL
QGTAAIWPSL	GTAAIWPSL
YVDTLLTML	YVDTLLTML
SLDSDPWVL	SLDSDPWVL
VLPPPPTTL	VLPPPPTTL
LLIDLFKYL	LLIDLFKYL
LVNEKFWKV	LVNEKFWKV
ALDEFFDIM	ALDEFFDIM
SVVDVFAQL	SVVDVFAQL
MLPGILSQL	MLPGILSQL
KMGLIFEV	KMGLIF-EV
SVIEQLFFV	SVIEQLFFV
YLHDFLKYL	YLHDFLKYL
SLPHQLPEA	SLPHQLPEA
FLDPPPYETL	FLDPPPETL
AVDAVEEFL	AVDAVEEFL
VLYSIAEKV	VLYSIAEKV
NLDRFYQQV	NLDRFYQQV
FLDAVHQNRL	FLDAVHNRL
ILDKYPLAV	ILDKYPLAV
LLDEEISRV	LLDEEISRV
YVWPNVFET	YVWPNVFET
LLDSPYARV	LLDSPYARV
LVFRPITTV	LVFRPITTV
LAPPASPGI	LAPPASPGI
LLDTVNNVF	LLDTVNNVF
SLDEPLDLKL	SLDEPLLKL
TLSDVVVGL	TLSDVVVGL
TLDEPIWRTEL	TLDEPIWRT
ATDAILATL	ATDAILATL
GIPDALPTV	GIPDALPTV
YMDPEGDWFL	YMDPEGWFL
SLWEAPRGQNM	SLWEAPRGQ
YLGRLAHEV	YLGRLAHEV
RVYIHPFHL	RVYIHPFHL
FVDEVHAVGL	FVDEVHVGL
KIDEHHFVAV	KIDEHHVAV
VIDEIGKMELF	VIDEIGMEL
AVMDTLVSV	AVMDTLVSV
TLDAGNIKL	TLDAGNIKL
SLYHVESTV	SLYHVESTV
KLPPVLAIQL	KLPPVLIQL
FLPQEEPVV	FLPQEEPVV
TLDDLIAAV	TLDDLIAAV
LLEESIANL	LLEESIANL
RLDAVLQRI	RLDAVLQRI
YIEDLKKFL	YIEDLKKFL
AIDEISLFL	AIDEISLFL
ALPNVYEV	ALPNVY-EV
FLWERPTLLV	FLWERPTLL
IIDEFEQKL	IIDEFEQKL
KIISALPQL	KIISALPQL
FLPLIHVYL	FLPLIHVYL
SLPDISAEI	SLPDISAEI
WLDNIIDLV	WLDNIIDLV
LLDHVLLTL	LLDHVLLTL
KIFDEILVNA	IFDEILVNA
PYLGPALLL	PYLGPALLL
HIDLPNEQARL	DLPNEQARL
YVDDVFLRV	YVDDVFLRV
NIPSFIVRL	NIPSFIVRL
AIVRSLPSV	AIVRSLPSV
FLDNSFEKV	FLDNSFEKV
ALEEQLQQIR	ALEEQLQQI
SVIEQIVYV	SVIEQIVYV
AVPATLPEL	AVPATLPEL
VLPDSVEIGL	VLPDSVIGL
IQPDNIVYV	IQPDNIVYV
NVPSALPSL	NVPSALPSL
LLNPAYDVYL	LLNPAYVYL
QLDSVMDWL	QLDSVMDWL
VIDQKVYEI	VIDQKVYEI
TVPKPDVVVQV	TVPKPDVVV
FLDKILVKL	FLDKILVKL
ALDEGDAQKTL	ALDEGDAQK
PPYTVVYFPVR	YTVVYFPVR
ILPPSAHEL	ILPPSAHEL
FLYKEKLVSV	FLYKEKVSV
FLDVDFEKL	FLDVDFEKL
LLDGVVEKL	LLDGVVEKL
FLINFIHTL	FLINFIHTL
YVEPLKLYL	YVEPLKLYL
TVDPYFHDRV	TVDPYFDRV
VVDWLYHHV	VVDWLYHHV
VIDDLVYSIID	VIDDLVYSI
AIDEALAALHV	AIDEALAAL
SLFRVITEV	SLFRVITEV
AIPENLPPL	AIPENLPPL
QLNEKVAQL	QLNEKVAQL
SLVDIYSQL	SLVDIYSQL
FVDIVKVLL	FVDIVKVLL
FLEEEVYPL	FLEEEVYPL
ILVEKFPFV	ILVEKFPFV
FAIPMIHAV	FAIPMIHAV
AIPESSPPSGI	AIPESSPSG
SLPESTLLQAV	SLPESTLQA
YLDNGVVFV	YLDNGVVFV
LLPDERTISL	LLPDERISL
RLLDYVATV	RLLDYVATV
GYSFTTTAER	YSFTTTAER
FVDPAQITM	FVDPAQITM
RGPASVPSV	RGPASVPSV
ALDQFLEGI	ALDQFLEGI
FLEKLLPPV	FLEKLLPPV
LLPLLIQTV	LLPLLIQTV
SLPSVAVGV	SLPSVAVGV
KVDPSGVSL	KVDPSGVSL
VLDKEIIQL	VLDKEIIQL
ATDPVYKTV	ATDPVYKTV
LLDAYLLYI	LLDAYLLYI
YLIPLLERL	YLIPLLERL
HLDATKLLL	HLDATKLLL
HFSVEGQLEFR	FSVEGQLEF
FLPPITPPEKF	FLPPITPEK
TLPTREVFLEA	TLPTREVFL
LLDTADVAL	LLDTADVAL
RLQEDPPVGV	RLQEDPVGV
RLDETIQAI	RLDETIQAI
LLDENGVLKL	LLDENGLKL
FVDDVSEEELL	FVDDVSEEL
RVPPVPPNV	RVPPVPPNV
QLDGIHVTI	QLDGIHVTI
KMPSGEFARI	KMPSGEARI
VLDNLLAFV	VLDNLLAFV
FLDDSTLRF	FLDDSTLRF
ILNEIVNFV	ILNEIVNFV
AMQDRYMEV	AMQDRYMEV
AIIDKYIKL	AIIDKYIKL
FLEEISPHL	FLEEISPHL
ILDEMSHKLRL	ILDEMSHKL
RVPSDPFTGV	RVPSDPTGV
FLPPGDFLV	FLPPGDFLV
LGPPPPLRV	LGPPPPLRV
SVEEVLKTV	SVEEVLKTV
LLPQQSYSL	LLPQQSYSL
ALAEALKEV	ALAEALKEV
LLPEEPVSQL	LLPEEPSQL
YLPEDFMESL	YLPEDFESL
RVLPPSALQSV	VLPPSAQSV
LVDEPLLKL	LVDEPLLKL
GLPWRFEEL	GLPWRFEEL
IIDLVLDRI	IIDLVLDRI
SFSDYPPLGRF	FSDYPPLGR
LLDDSLVSIF	LLDDSLVSI
AVDEVVLKF	AVDEVVLKF
HIDVITAEM	HIDVITAEM
TLDALFNIMM	TLDALFNIM
FLDFAPHYF	FLDFAPHYF
NLHEVYETA	NLHEVYETA
FILPIGATV	FILPIGATV
KLPEIWETL	KLPEIWETL
VVPDTDVLPSF	VVPDTDVLP
VVPSYIPLV	VVPSYIPLV
LLDPPRPNL	LLDPPRPNL
RLFSSIVTV	RLFSSIVTV
ALPEIFTELEI	ALPEIFTEL
GLWPVYEGV	GLWPVYEGV
PYFIKLMGF	PYFIKLMGF
YLTEVFLHV	YLTEVFLHV
ALWSLPLYL	ALWSLPLYL
YLPEELSAL	YLPEELSAL
SMDFVLLNF	SMDFVLLNF
YLVNDIYEL	YLVNDIYEL
QLDPLVVEL	QLDPLVVEL
LLQPVTPSL	LLQPVTPSL
VLDNPTPEM	VLDNPTPEM
ILNDNINLL	ILNDNINLL
LIDDLQHCL	LIDDLQHCL
VLEEFVPEI	VLEEFVPEI
SVDDTIVAL	SVDDTIVAL
AAPPNFHFV	AAPPNFHFV
RLPDPFTPNL	RLPDPFPNL
RIIEAAHQV	RIIEAAHQV
RLDEIFQTGL	RLDEIFTGL
LLDRVITNV	LLDRVITNV
LLAELLTHL	LLAELLTHL
AVDGNTVEL	AVDGNTVEL
FLLDPVKGERL	LLDPVKERL
ILDEMSHKL	ILDEMSHKL
YLPFIMELL	YLPFIMELL
VLDNIKAVF	VLDNIKAVF
MLPPPPLTA	MLPPPPLTA
ALHEIYSYI	ALHEIYSYI
SVDGQLELL	SVDGQLELL
YLDIINLFL	YLDIINLFL
YLDLILNDF	YLDLILNDF
ALPENPPAI	ALPENPPAI
MLPEFYKTV	MLPEFYKTV
LLPTGVFQV	LLPTGVFQV
HLDEVFLEL	HLDEVFLEL
VADQIVTKL	VADQIVTKL
EVISKLYAV	EVISKLYAV
YLSKIIPAL	YLSKIIPAL
VLDNPHHGF	VLDNPHHGF
VADNLAIQL	VADNLAIQL
AVDPVADIATL	AVDPVAATL
MQPWALPTV	MQPWALPTV
TLEEVFIEV	TLEEVFIEV
VAPESFEYI	VAPESFEYI
GLWEIENNPTV	GLWEIEPTV
VVDHLLLRL	VVDHLLLRL
LVDDSVNNV	LVDDSVNNV
RLDDSLLYL	RLDDSLLYL
TIPEIIIKV	TIPEIIIKV
ATMFRATL	ATMFRA-TL
LVDFVIHFM	LVDFVIHFM
ALHDQLFYL	ALHDQLFYL
KIDDTIRYL	KIDDTIRYL
AMPQPVPTA	AMPQPVPTA
FLQRFIDPL	FLQRFIDPL
VLPGLIHKV	VLPGLIHKV
YLWNLQVKL	YLWNLQVKL
IVDAVIEQV	IVDAVIEQV
FIDETSDIENL	FIDETSENL
SMPDFDLNL	SMPDFDLNL
FLPNPVAV	FLPNPV-AV
SLDPTLPSV	SLDPTLPSV
LLPEDTPPFL	LLPEDTPFL
FLPQIEAAL	FLPQIEAAL
YIMEPSIFNTL	MEPSIFNTL
NVDAIVVSV	NVDAIVVSV
VLDDSTAKL	VLDDSTAKL
QVPEKLDVV	QVPEKLDVV
SLDSSGFSL	SLDSSGFSL
FLHEESILERV	HEESILERV
LVDNNFQHSV	LVDNNFHSV
YVIAYIRDLAL	YVIAYIRDL
LMPDQTAMHEV	LMPDQT-AM
FLPPPFPPP	FLPPPFPPP
QLDDVFRQL	QLDDVFRQL
VIDGHIYAV	VIDGHIYAV
YIDAQFEAYL	YIDAQFAYL
YLDPLWHQL	YLDPLWHQL
LLTEQIHSL	LLTEQIHSL
ALPTASPGL	ALPTASPGL
FSDEILLHI	FSDEILLHI
VLPLAFTRL	VLPLAFTRL
QMPSFLQSV	QMPSFLQSV
YLPEELAAL	YLPEELAAL
RLPPGFNDV	RLPPGFNDV
SILSLVTKI	SILSLVTKI
NLDALLNQL	NLDALLNQL
RIDQVNQLL	RIDQVNQLL
YLADVTNAL	YLADVTNAL
FLNDIFERI	FLNDIFERI
QISPFFPLV	QISPFFPLV
LLYHYWIAV	LLYHYWIAV
KVDDARALL	KVDDARALL
MLDEILLQL	MLDEILLQL
HLFDAFVSV	HLFDAFVSV
SLEDFLCDFG	SLEDFLCDF
KMDPVAYRV	KMDPVAYRV
ILFVITKPDV	ILFVITPDV
MLDSTFSIL	MLDSTFSIL
YLPSQVSRV	YLPSQVSRV
RLDEPLASYIF	RLDEPLSYI
GLNEEIARV	GLNEEIARV
KAPDEETLIAL	APDEETIAL
FLYDDNQRV	FLYDDNQRV
LLDNVTVLI	LLDNVTVLI
GIVGVFVKL	GIVGVFVKL
SLDHDIFQL	SLDHDIFQL
LLPDPRELIEI	LLPDPRELI
KLPNWQMEV	KLPNWQMEV
SSDAVFIQL	SSDAVFIQL
YVDRVFHAI	YVDRVFHAI
YMNHIMVSV	YMNHIMVSV
ALDEATKYAL	ALDEATYAL
SADTLWGIQK	SADTLW-GI
FLASESLIKQI	ASESLIKQI
YTDKIMTYL	YTDKIMTYL
NIDTIYDRF	NIDTIYDRF
LIPPPGEQL	LIPPPGEQL
VVPQQLLTV	VVPQQLLTV
VILESDPQQVV	ILESDPQQV
KLPEDFAVVF	KLPEDFAVV
KLDDIVQHIY	KLDDIVQHI
TMDEFRQHL	TMDEFRQHL
SMDSFYKVL	SMDSFYKVL
YLDVAEAFL	YLDVAEAFL
VLPDSGHLHPL	VLPDSG-HL
LLPIYAVTV	LLPIYAVTV
VVPPKFLGDSL	VVPPKFDSL
FIPPDGEFEL	FIPPDGFEL
TLDGLTKIQV	TLDGLTIQV
ILPSDIIQL	ILPSDIIQL
LLPDNFIAA	LLPDNFIAA
ALPEEVQEL	ALPEEVQEL
NVPEGLLATV	NVPEGLATV
KLLEYIEEI	KLLEYIEEI
YMSDSFINV	YMSDSFINV
YLEEPLTQV	YLEEPLTQV
IQVWHEEHR	IQVWHEEHR
LLDMSYEQL	LLDMSYEQL
NLPEAGDSRV	NLPEAGSRV
FLPPYTFQI	FLPPYTFQI
SLPRAFPAL	SLPRAFPAL
SIIEYLPTL	SIIEYLPTL
ALDPPGPTL	ALDPPGPTL
TVFEHTFHV	TVFEHTFHV
QQPDLLPSA	QQPDLLPSA
SLPEILKEV	SLPEILKEV
IQDDMHLVI	IQDDMHLVI
GIYYIPVL	GIYYIP-VL
HLLDIYIQL	HLLDIYIQL
REVIAGPLL	REVIAGPLL
YLIPDIDLKL	LIPDIDLKL
ALPQTLPEIF	ALPQTLPEI
SINPDKHFTV	SINPDKFTV
GVDAETMHTLL	GVDAETHTL
FADGVILLLL	FADGVILLL
LLDEVLNVM	LLDEVLNVM
ILDEVDAAL	ILDEVDAAL
SVDNLFVVV	SVDNLFVVV
RIFNESTSV	RIFNESTSV
LLDNNIGLVL	LLDNNILVL
YMEEIYHRI	YMEEIYHRI
VLDGLHNEL	VLDGLHNEL
MLNEHDFEV	MLNEHDFEV
KIDHILDAL	KIDHILDAL
SLDNLKASV	SLDNLKASV
LLDPNIYRTM	LLDPNIYRT
TILEYLTYL	TILEYLTYL
RVDRIILLF	RVDRIILLF
KLPSTLTGL	KLPSTLTGL
IQLTQMSLQL	QLTQMSLQL
YLTKKFAEL	YLTKKFAEL
SMPPVYPSV	SMPPVYPSV
HIDAVSLLL	HIDAVSLLL
AQPPWLPGLEA	AQPPWLPGL
ILNDPSQSEVM	ILNDPSSEV
VMPHANMNV	VMPHANMNV
LQDDFYLNL	LQDDFYLNL
ALDEADRMIDM	ALDEADRMI
LLPHILPLL	LLPHILPLL
AIDSLRDLR	AIDSLRDLR
AVDTIVAIM	AVDTIVAIM
TVDPVIVEA	TVDPVIVEA
VLDPDEGIRF	VLDPDEIRF
KLDDNSIQLF	KLDDNSIQL
MMPPPVGMV	MMPPPVGMV
FLHEATARL	FLHEATARL
ALWDKLFNL	ALWDKLFNL
KIVDFSYSV	KIVDFSYSV
FLETNVPLL	FLETNVPLL
AVPPPPAPL	AVPPPPAPL
MLPDPQNISL	MLPDPQISL
AVDAAIAAL	AVDAAIAAL
LLDTVLVNL	LLDTVLVNL
FLPNAPKAL	FLPNAPKAL
TLDELGIHL	TLDELGIHL
FLPPFPAHL	FLPPFPAHL
EITALAPSTMK	ITALAPSTM
FVEETVYLL	FVEETVYLL
FLIGQGAHV	FLIGQGAHV
LLDERLVTL	LLDERLVTL
NLPTIFVYL	NLPTIFVYL
ALDKWTNQL	ALDKWTNQL
AVPSWFVRV	AVPSWFVRV
VIDLITIKL	VIDLITIKL
YLDSPLVRF	YLDSPLVRF
GLDDLLLFL	GLDDLLLFL
VMDEIHTVL	VMDEIHTVL
RLPELARV	RLPELA-RV
FLDSSGHLNL	FLDSSGLNL
LILNDFPSV	LILNDFPSV
VLPSNTPNV	VLPSNTPNV
ALDERSTIL	ALDERSTIL
TLISRLPAV	TLISRLPAV
HLPDVCVNL	HLPDVCVNL
AIEDLVKFV	AIEDLVKFV
TLPHSSAFTPL	TLPHSSAFT
TLEDIYNQV	TLEDIYNQV
VIDDLVYSI	VIDDLVYSI
YVPATKVFL	YVPATKVFL
FVDLIIKHI	FVDLIIKHI
LLDSQSHHL	LLDSQSHHL
FMVEKGPTL	FMVEKGPTL
LLDPEDISV	LLDPEDISV
KVVDVDVKL	KVVDVDVKL
KLDNLMLEL	KLDNLMLEL
HLDMVLPEV	HLDMVLPEV
FIPLPSAVVQA	FIPLPSAVV
FFDDPIPK	FFDDPI-PK
AVDDFIEKL	AVDDFIEKL
ALDPAAQAFLL	ALDPAAAFL
RIDGVLIRM	RIDGVLIRM
GLPSFLTEV	GLPSFLTEV
KLMDHIYAV	KLMDHIYAV
VMPEAVPEV	VMPEAVPEV
YLDDLNEGVYI	YLDDLNEGV
FIEDYLKRV	FIEDYLKRV
ALNELLQHV	ALNELLQHV
AVDSVVSLL	AVDSVVSLL
FIDTLHHTL	FIDTLHHTL
LLPDKWFDI	LLPDKWFDI
LGIHEDSTNR	GIHEDSTNR
ILPIKFPHL	ILPIKFPHL
LLPQIFVKM	LLPQIFVKM
ALNEKLVNL	ALNEKLVNL
LLPGLLKTI	LLPGLLKTI
FIDEELEKM	FIDEELEKM
LMDSNLPRL	LMDSNLPRL
YLDIVKLLL	YLDIVKLLL
FLIAQLPKL	FLIAQLPKL
SVDSHFQEV	SVDSHFQEV
YDNEFGYSNR	YDNEFGYSN
YMENFIEHL	YMENFIEHL
HVDEFIDEL	HVDEFIDEL
NVDRVFQEV	NVDRVFQEV
YLDKMNNNI	YLDKMNNNI
FLMDFIHQV	FLMDFIHQV
ALPQFFNNV	ALPQFFNNV
ILPYSFIIGV	ILPYSFIGV
FLWERPTLL	FLWERPTLL
SMPSFTARL	SMPSFTARL
RLYDTHITV	RLYDTHITV
QVIPVLPQV	QVIPVLPQV
ILWEHLEIL	ILWEHLEIL
KLLAVIHEL	KLLAVIHEL
FSPEDSPSV	FSPEDSPSV
LVDENFTEL	LVDENFTEL
GLKEGIPAL	GLKEGIPAL
FLDEDDMSL	FLDEDDMSL
SLLELPHPLL	SLLELPPLL
KKAPTMPKPQ	KAPTMPKPQ
VLDSLNARM	VLDSLNARM
LSDNIFTHF	LSDNIFTHF
SLDIPATYL	SLDIPATYL
KVPQLEIVPN	KVPQLEIVP
SLMMPAVFHTV	MMPAVFHTV
ALPHNTHRV	ALPHNTHRV
IVPEGVHAL	IVPEGVHAL
FLNDPGHLL	FLNDPGHLL
YVDEAGTVKL	YVDEAGVKL
LLEEQYFEL	LLEEQYFEL
SLDGFTIQV	SLDGFTIQV
SLDTALAEL	SLDTALAEL
LVPDVVNEV	LVPDVVNEV
FLDPITGTF	FLDPITGTF
FVLPELPSV	FVLPELPSV
TLPEAIHFL	TLPEAIHFL
LLDEARNYHL	LLDEARYHL
ILDDLFLHT	ILDDLFLHT
FVDEGKATV	FVDEGKATV
FLLVTEVHL	FLLVTEVHL
YIDSSINNV	YIDSSINNV
FLNNQIKEL	FLNNQIKEL
IIDETMAQL	IIDETMAQL
YLPTHTSLL	YLPTHTSLL
RVPPPPQSV	RVPPPPQSV
ALDKVIEIV	ALDKVIEIV
TLVLTLPTV	TLVLTLPTV
SMPTSGALDRV	SMPTSG-AL
VLDEQLNEF	VLDEQLNEF
KIPDSYQL	KIPDSY-QL
KVPDVLPVL	KVPDVLPVL
KIGSIIFQV	KIGSIIFQV
TAQVIILNHPG	AQVIILNHP
LLDAGFLFL	LLDAGFLFL
ALPVSLPQI	ALPVSLPQI
SLPEFQQFL	SLPEFQQFL
FIEDIVKLI	FIEDIVKLI
LSPDYLPAM	LSPDYLPAM
KVQEQIFNL	KVQEQIFNL
HAVGDIPGVRF	AVGDIPVRF
FLEEYTSQL	FLEEYTSQL
MAPPTIPSA	MAPPTIPSA
ALEEITKNM	ALEEITKNM
ALDTINILL	ALDTINILL
WVDDAIWRL	WVDDAIWRL
KMPEINAKV	KMPEINAKV
VVDPIVSNF	VVDPIVSNF
LLFDRPMHV	LLFDRPMHV
LVLPVLVFL	LVLPVLVFL
KKPAASPHAGR	KKPAASPHA
NIDETYGVNV	NIDETYVNV
VMDSKIVQV	VMDSKIVQV
LENDKILQI	LENDKILQI
YLNDGLWHM	YLNDGLWHM
HVDGIHLHVA	HVDGIHLHV
FLGEKIASV	FLGEKIASV
LLIDDKGTIKL	LIDDKGIKL
KLDQVLSKV	KLDQVLSKV
YLDQTVVPILL	YLDQTVVPI
KVDPLFTEL	KVDPLFTEL
LLYGKYVSV	LLYGKYVSV
GLKLETELL	GLKLETELL
RLGPVPPGL	RLGPVPPGL
VAPPKAHEV	VAPPKAHEV
ILHSVTTNL	ILHSVTTNL
KLEEIIHQI	KLEEIIHQI
IMLSEKHLISV	MLSEKHISV
MVDEVSGKVL	MVDEVSGKV
HVIEKMHHV	HVIEKMHHV
LLDGVIFGA	LLDGVIFGA
SLPGTLPVL	SLPGTLPVL
VLPNIQAVL	VLPNIQAVL
ILDESHERVF	ILDESHERV
RLDLIAQQM	RLDLIAQQM
RISDVHFSV	RISDVHFSV
LIDELNQAL	LIDELNQAL
KLLPQLTYL	KLLPQLTYL
KLDTAYDDL	KLDTAYDDL
ALPGATVTL	ALPGATVTL
LLEDTNTFRGV	LLEDTNTFR
YLGDDYVRAM	YLGDDYVRA
YLKDFFSNV	YLKDFFSNV
KIQEILTQV	KIQEILTQV
FIIENTDLAV	FIIENTLAV
KVGPVPVLV	KVGPVPVLV
NVPYPLPKI	NVPYPLPKI
LLWGDLIWL	LLWGDLIWL
LLMSFSVCL	LLMSFSVCL
KVDTVWVNV	KVDTVWVNV
VIDQIAETL	VIDQIAETL
LVEINKILL	LVEINKILL
NLDDVGVRL	NLDDVGVRL
LVDDIGDVTI	LVDDIGVTI
MLDEMKDNL	MLDEMKDNL
GLMTTVHAITA	GLMTTVHAI
YIDGILIKT	YIDGILIKT
VLPKLYVKL	VLPKLYVKL
LVPSDFLSV	LVPSDFLSV
KLWEVSSGEL	KLWEVSGEL
KISELTTEV	KISELTTEV
MMPKYLNFV	MMPKYLNFV
KLQEVLDYL	KLQEVLDYL
LLDEAIQAV	LLDEAIQAV
SIISNLITV	SIISNLITV
FLPTTGTKL	FLPTTGTKL
KLYELYLQL	KLYELYLQL
AMPHSIMRV	AMPHSIMRV
MLPATPWGV	MLPATPWGV
SLSQVFLHL	SLSQVFLHL
LADGIFETL	LADGIFETL
RLPFLFTLV	RLPFLFTLV
ILPQDLERA	ILPQDLERA
KSPPDQPVKH	SPPDQPVKH
HLPLPEQIHKA	PLPEQIHKA
YMPPSTVLQQI	YMPPSTVLQ
RIAELLTEL	RIAELLTEL
IKEPIWETL	IKEPIWETL
NIIPRFVQV	NIIPRFVQV
FLENETWEL	FLENETWEL
ILYDERSVHKV	LYDERSHKV
SIDQFSIRL	SIDQFSIRL
HQPHQPLPPT	HQPHQPLPP
TVNPQDPSYV	TVNPQDSYV
NIDEIYKALS	NIDEIYKAL
AVPELPGPSV	AVPELPPSV
GLDPLGYEIQL	GLDPLGYEI
VLIETLVTL	VLIETLVTL
VMPGQVMRV	VMPGQVMRV
TITDIISAL	TITDIISAL
NLDDIYHFM	NLDDIYHFM
ALPHAILRL	ALPHAILRL
IMDDEFQLL	IMDDEFQLL
LLDQSDPGL	LLDQSDPGL
VNLPINGNGKQ	NLPINGNGK
YLSELSEHV	YLSELSEHV
EVDDILAAV	EVDDILAAV
MLPEKLRPL	MLPEKLRPL
SLFDIISKI	SLFDIISKI
KLPIPDPGV	KLPIPDPGV
MLPHAPGVQM	MLPHAPVQM
KLWEMDNMLI	KLWEMDNML
YIIEVNARL	YIIEVNARL
YSDDIPHAL	YSDDIPHAL
YLDTLYRYA	YLDTLYRYA
QLDSHVHAV	QLDSHVHAV
LLDSPGKVL	LLDSPGKVL
ILPENFKDSRL	ILPENFSRL
LLDDNFASI	LLDDNFASI
RLPTRLPEI	RLPTRLPEI
SVDGIPARL	SVDGIPARL
YVYKVLKQV	YVYKVLKQV
VVPNAGILPLV	VVPNAGLPL
VLDSVDVRL	VLDSVDVRL
FMDDTSRSIIR	FMDDTSRSI
ALDKIFNKV	ALDKIFNKV
IVDEAIYYF	IVDEAIYYF
VAPEEHPVL	VAPEEHPVL
FLDTIATRF	FLDTIATRF
LLLPKLPTL	LLLPKLPTL
IVFCFLCYF	IVFCFLCYF
LLDEPTNHL	LLDEPTNHL
FLPSANEHL	FLPSANEHL
FLDDPIWRG	FLDDPIWRG
FLDESRSTQYM	FLDESRSTQ
ILDYSWEKL	ILDYSWEKL
RLDDSSFLGL	RLDDSSLGL
LLWDVVTGQSV	LLWDVVTGQ
LTPVRLPSI	LTPVRLPSI
ALDEAAAAL	ALDEAAAAL
LLPPPMKELRV	LLPPPMKEL
LVDDLSVLL	LVDDLSVLL
HMDTFIETF	HMDTFIETF
ALDEVIFSL	ALDEVIFSL
KLPSTLTGLYV	KLPSTLTGL
VVDEKLPGL	VVDEKLPGL
KLLEPVPVSV	LLEPVPVSV
APGNLSLPIP	APGNLSLPI
ALPSVLLEL	ALPSVLLEL
FLDLPVDTL	FLDLPVDTL
FLPPVLLKL	FLPPVLLKL
RLDEVPASL	RLDEVPASL
VVWGTVIRV	VVWGTVIRV
TVPDTRELPSI	TVPDTR-EL
NLPEYLPFVL	NLPEYLPFV
RIVDVYENL	RIVDVYENL
LTPKLFHEV	LTPKLFHEV
VADQIPILG	VADQIPILG
TLSDIFLLF	TLSDIFLLF
GVDDAFYTL	GVDDAFYTL
GGNFGFGDSR	GGNFGFDSR
FVDSPSSGTHL	FVDSPSSGT
TLDGSLHAV	TLDGSLHAV
ESYSVYVYK	ESYSVYVYK
ALDSKANNL	ALDSKANNL
ALPKELPLI	ALPKELPLI
SLPNTTPTI	SLPNTTPTI
KILQELPSV	KILQELPSV
ILPIMFPSL	ILPIMFPSL
FIDKNNDLL	FIDKNNDLL
FLDHLYVGI	FLDHLYVGI
LMPWVQETL	LMPWVQETL
KLLEVYEQL	KLLEVYEQL
MLIGEIFEL	MLIGEIFEL
YLDEPIKIG	YLDEPIKIG
LLPENTFIV	LLPENTFIV
FVDLLDGENL	FVDLLDENL
IIDEDGLLNL	IIDEDGLNL
SADPFYWMRV	SADPFYMRV
YLHWLLTNI	YLHWLLTNI
YLPDGTASL	YLPDGTASL
SVDQISLQV	SVDQISLQV
HGESAWNLENR	HGESAW-NL
ALLNILSEV	ALLNILSEV
SLDAKEIYL	SLDAKEIYL
GLADKVYFL	GLADKVYFL
LLDSHLPEEAL	LLDSHLEEA
HIPGPGGIEGV	PGPGGIEGV
VLDEGSASV	VLDEGSASV
KLDDDMNLL	KLDDDMNLL
FLDSLPDVKI	FLDSLPVKI
FMFDEKLVTV	MFDEKLVTV
FLANVSTVL	FLANVSTVL
IMDDLTEVL	IMDDLTEVL
LQCNPPPGL	LQCNPPPGL
NVDEAVLHF	NVDEAVLHF
PLGYEIQL	PLGYEI-QL
IPPLTQTPV	IPPLTQTPV
NVPGEIVES	NVPGEIVES
YMIAHITGL	YMIAHITGL
LLDGSNVVF	LLDGSNVVF
KVVDLDPCLS	KVVDLDPCL
LLPKHPHLV	LLPKHPHLV
FLPPEVNQL	FLPPEVNQL
SVPIEIPTI	SVPIEIPTI
AVDPVFQAKM	AVDPVFAKM
SLDSLGDVFL	SLDSLGVFL
NMDWVSTQL	NMDWVSTQL
SLPLEKVLPPA	SLPLEKVLP
SLDLIYRDL	SLDLIYRDL
LLIAPMPTA	LLIAPMPTA
SLIEQTTAL	SLIEQTTAL
YLEPYLKEV	YLEPYLKEV
GLPEAPPFL	GLPEAPPFL
FLLPKFHGV	FLLPKFHGV
VIDAVTHAL	VIDAVTHAL
SLDQSIISF	SLDQSIISF
MLDSGADYLHL	MLDSGADYL
YLDVKFEYL	YLDVKFEYL
KVFSAFITV	KVFSAFITV
LQPDKVPEI	LQPDKVPEI
FLDQQAILF	FLDQQAILF
NLPILKRAV	NLPILKRAV
LLPPPPQML	LLPPPPQML
HLPETKFSEL	HLPETKSEL
NMPVSFEVI	NMPVSFEVI
KVASLIGV	KVASLI-GV
KLWPEASKV	KLWPEASKV
YLSEEVQAV	YLSEEVQAV
ILGMWIPEV	ILGMWIPEV
GLDEVIFSYV	GLDEVISYV
NIVERVKEV	NIVERVKEV
AGVAPPPTAG	AGVAPPPTA
RLFDWLVSV	RLFDWLVSV
ILPEELQTL	ILPEELQTL
AIDEALAAL	AIDEALAAL
FLPALITAV	FLPALITAV
VLDDPELRQGI	VLDDPELRQ
RKYPTLLEV	RKYPTLLEV
SIPGFVERL	SIPGFVERL
RLIESLFTI	RLIESLFTI
IMPPHSITQTV	IMPPHSITQ
KLWDPFSL	KLWDPF-SL
YLQPFLAKL	YLQPFLAKL
IVDRPVTLV	IVDRPVTLV
YVAPAYGVYL	YVAPAYVYL
VMDKLFDEL	VMDKLFDEL
AAPPEMYEV	AAPPEMYEV
DPRLSANLHL	RLSANL-HL
LLPSEVPAL	LLPSEVPAL
FLFNTENKL	FLFNTENKL
LLPEVEAYL	LLPEVEAYL
LGFQVDPAL	LGFQVDPAL
FLDHIIASV	FLDHIIASV
VLWDRTFSL	VLWDRTFSL
FVEGVVKKV	FVEGVVKKV
FHASTLHRL	FHASTLHRL
SIDQALAQL	SIDQALAQL
NLNEKINHL	NLNEKINHL
KILEIRDL	KILEIR-DL
YLLDRLPEM	YLLDRLPEM
KLPETHQLLQL	KLPETHQLL
ILIVLDVLK	ILIVLDVLK
VLPGPVETV	VLPGPVETV
RVDSFNEEV	RVDSFNEEV
LITAILVKV	LITAILVKV
LLDSSHSEL	LLDSSHSEL
VETGVLKPG	VETGVLKPG
ALAEKFKEL	ALAEKFKEL
SLEPVAVEL	SLEPVAVEL
HLPSDFTPAVH	HLPSDFPAV
SLDKDPLLL	SLDKDPLLL
LLPSDVARL	LLPSDVARL
AMNDILAQV	AMNDILAQV
WPEVLLLLT	WPEVLLLLT
RLYEITIEVF	RLYEITIEV
KLMELLEEI	KLMELLEEI
RLQEEVHLL	RLQEEVHLL
RLFTLYEQV	RLFTLYEQV
YMPPTSEAA	YMPPTSEAA
FVEPFVILL	FVEPFVILL
TLPPESTQV	TLPPESTQV
PMFIVNTNVPR	PMFIVNTNV
SIMDYVVFV	SIMDYVVFV
SLPGTDLPSL	SLPGTDPSL
GLIEILKKV	GLIEILKKV
FIHQHFVEV	FIHQHFVEV
IIDDKPIGL	IIDDKPIGL
SMDTIVGML	SMDTIVGML
ALPESGSSLAL	ALPESGSSL
FAVTEYPTL	FAVTEYPTL
VQPEHIQYL	VQPEHIQYL
ALPEVLAVIQV	ALPEVLAVI
TMDALLARL	TMDALLARL
VPQLEIVPN	VPQLEIVPN
VIPTNVPEL	VIPTNVPEL
SEPFWEDDL	SEPFWEDDL
LLIGATMQV	LLIGATMQV
LIDEGHAATQL	LIDEGHAAT
FMDKYYLEF	FMDKYYLEF
GIPTVFVAV	GIPTVFVAV
MLPSILNQL	MLPSILNQL
YLEERLIEL	YLEERLIEL
FIDKQLELL	FIDKQLELL
PSSVPLLAW	PSSVPLLAW
SLSSFLHGV	SLSSFLHGV
KLPAEPPAL	KLPAEPPAL
RLVSLITLL	RLVSLITLL
YLDPNYQSI	YLDPNYQSI
IDAPGHRDF	IDAPGHRDF
KIPGTGALASA	KIPGTGALA
VLDEADRMIDM	VLDEADRMI
SLPNVFSAL	SLPNVFSAL
RLPPTPLLL	RLPPTPLLL
KVLPQELV	KVLPQE-LV
QEVAVKEQLT	QEVAVKEQL
LIDKTTAAF	LIDKTTAAF
KVDPVYETLRF	KVDPVYETL
LADTHLTEET	LADTHLTEE
