Data	Data aligned
HTATVIANSF	HTATIANSF
YFAERVTSL	YFAERVTSL
YSFQDKDNLYF	YSFQDKDNL
RTIKLEHVHF	RTIKEHVHF
KSFADINLY	KSFADINLY
SAAPLFFSW	SAAPLFFSW
ISPSRTEAL	ISPSRTEAL
KSWLKGLVTF	KSWLGLVTF
KLIEFLSKF	KLIEFLSKF
KSKTLQEFL	KSKTLQEFL
RTKQVLHTF	RTKQVLHTF
RVKEKEAEL	RVKEKEAEL
KTIDDLEEKL	KTIDLEEKL
KSFDNIKNW	KSFDNIKNW
KSSDIAKTF	KSSDIAKTF
KAAEVFFETF	KAAEFFETF
GTYYFTEYF	GTYYFTEYF
KAPLHLDVTW	KAPLLDVTW
KTDKTLVLL	KTDKTLVLL
ASLPFFEVF	ASLPFFEVF
RGYPDSESTW	RGYPSESTW
RSTSTQVVF	RSTSTQVVF
QSLPNDVISSL	QSLPVISSL
KTKFEQHTI	KTKFEQHTI
KTATELSTVYL	KTATLSTVY
KTLELAKVTQF	KTLEKVTQF
RAQPYDPNF	RAQPYDPNF
TAPTGHTL	TAPT-GHTL
RSNPKLKDLYI	RSNPKLKDL
VSLPSHLNI	VSLPSHLNI
RARTIYERF	RARTIYERF
AAGHAELAWT	AAGHAELAW
KIKYPENFF	KIKYPENFF
SSVRAVAVW	SSVRAVAVW
RSNKLHFAF	RSNKLHFAF
KSRPIIKRF	KSRPIIKRF
RAVQLQELW	RAVQLQELW
KSLDLLTMKN	KSLDLLTMK
LAAKLLAKY	LAAKLLAKY
KTIGGGDDSF	KTIGGDDSF
AVNPRDPPSW	AVNPDPPSW
HSFLYQPDWRF	HSFLYQPDW
KSGETSVRF	KSGETSVRF
KAFPFHIIF	KAFPFHIIF
KTFTGHREW	KTFTGHREW
KSLGLRANL	KSLGLRANL
QTARQHPKMHL	QTARQHPKM
ATLTIQGIRF	ATLTQGIRF
RTEILNQEW	RTEILNQEW
RSHDTLVRW	RSHDTLVRW
KAAHVSEQF	KAAHVSEQF
ISFPDPKML	ISFPDPKML
KVKTDTVLI	KVKTDTVLI
ITTSLTTKW	ITTSLTTKW
KVADPVVTF	KVADPVVTF
RGVPWNFTF	RGVPWNFTF
KVLELDPAL	KVLELDPAL
QSYQKFRRF	QSYQKFRRF
ASFPLNASF	ASFPLNASF
YLPDGTASL	YLPDGTASL
RSIKGLKEHF	RSIKLKEHF
KSYRIIYNLF	KSYRIYNLF
KSKPIIAEPEI	KSKPIIAEP
KTAEEIKQIW	KTAEIKQIW
KTSGIINKF	KTSGIINKF
GSMPLKNSF	GSMPLKNSF
VTARLVGVLW	VTARVGVLW
RTHPVEIFY	RTHPVEIFY
KTLPETSLPNY	KTLP-ETSL
RSIDDIGHLI	RSIDIGHLI
VSIRDILSW	VSIRDILSW
KVLELFESF	KVLELFESF
VTIRLLETI	VTIRLLETI
AGFAGDDAPR	AGFAGDDAP
KALEVFPEF	KALEVFPEF
LSQKLQMIL	LSQKLQMIL
AVWTRAYGW	AVWTRAYGW
RTIRMGTTL	RTIRMGTTL
ASFPGANII	ASFPGANII
AAAAAAAAAW	AAAAAAAAW
QSLPSKTKVAW	QSLPSKTKV
SALRAQETF	SALRAQETF
VAKRNSLKELW	KRNSLKELW
KSLENSVENKI	KSLESVENK
KSDPSIVRL	KSDPSIVRL
TTTVMNPKF	TTTVMNPKF
LEEALQQAKED	EALQQAKED
KSFRSPSKL	KSFRSPSKL
SSPQPGSAL	SSPQPGSAL
KAIEEGVNHMW	KAIEGVNHM
KTQGPRALW	KTQGPRALW
LASPDLGLLKL	ASPDGLLKL
QSLRLGHLL	QSLRLGHLL
ATYMKPEMW	ATYMKPEMW
RNLPFDFTW	RNLPFDFTW
QSSTLLTSVRL	STLLTSVRL
KTLDFELDTF	KTLDELDTF
KVMELLVHL	KVMELLVHL
KAFDKHMNL	KAFDKHMNL
KTRQGVEDAF	KTRQVEDAF
HTIQIRQDW	HTIQIRQDW
ISSSAGARW	ISSSAGARW
KTFQDGATKL	KTFQGATKL
AAAAAAAAAMS	AAAAAAAAM
LTSPDVGLLKL	TSPDGLLKL
AALPAAALW	AALPAAALW
KAVTHQVKF	KAVTHQVKF
ISLHDPVSI	ISLHDPVSI
AVSTIETVPYW	STIETVPYW
LTKPFEYLF	LTKPFEYLF
KTLPSKPSW	KTLPSKPSW
VSTVLTSKY	VSTVLTSKY
YAPSGNFV	YAPS-GNFV
ATLKINNEI	ATLKINNEI
KSYQSFQTF	KSYQSFQTF
AVIAIVPVF	AVIAIVPVF
RTDLDKARTF	RTDLKARTF
KAATILTKSTL	ATILTKSTL
KVFDSHPVL	KVFDSHPVL
RSPDESHRMW	RSPDESHRM
SVGESSSKGP	SVGESSSKG
QSAVMSATF	QSAVMSATF
RVREITENL	RVREITENL
HSNETIGSVRW	HSNEGSVRW
MAHQVQELF	MAHQVQELF
VTRHEHEAW	VTRHEHEAW
RSFDKGPFATF	RSFDPFATF
KTILPLINF	KTILPLINF
KTLDQAIMKF	KTLDAIMKF
TTVPNTIVVSW	TVPNIVVSW
VTIKLKNVNF	VTIKKNVNF
KSLPEEDVAEI	KSLPDVAEI
QTMSDQIIGRI	MSDQIIGRI
SSLPTVEKW	SSLPTVEKW
RSPEPGQTW	RSPEPGQTW
KAIELLQEF	KAIELLQEF
ATNRITVTW	ATNRITVTW
YSLKKRHFF	YSLKKRHFF
ATLKDRELSF	ATLKRELSF
KTIEDDLVSAL	KTIELVSAL
IVLKKWYTI	IVLKKWYTI
SSPAPRTAL	SSPAPRTAL
KVPPFVFFF	KVPPFVFFF
KIIPLVVKF	KIIPLVVKF
GTTTLAFKF	GTTTLAFKF
RSIFSDFVF	RSIFSDFVF
SVIPARIIHNW	IPARIIHNW
RTMDDKTVF	RTMDDKTVF
LSRPEAQSL	LSRPEAQSL
HSVELRNMF	HSVELRNMF
ATSQAQAGW	ATSQAQAGW
RSLDNGGYYI	RSLDGGYYI
HTFSPSPKL	HTFSPSPKL
KALDVMVSTF	KALDMVSTF
RAFPNKQGYVL	RAFPNKQGY
GTLKGHNGW	GTLKGHNGW
KTLPVAFKV	KTLPVAFKV
GSIALIVLY	GSIALIVLY
HSAEILAEI	HSAEILAEI
KSKYFESKF	KSKYFESKF
ASKEEATTF	ASKEEATTF
RSSTPLPTI	RSSTPLPTI
HSKELITAW	HSKELITAW
KTKIEVIRM	KTKIEVIRM
ITTVVVQTF	ITTVVVQTF
KTFTTQETI	KTFTTQETI
ATALIEDIF	ATALIEDIF
KTIDAMDTW	KTIDAMDTW
GTDRNAYVW	GTDRNAYVW
VTSPLTVEW	VTSPLTVEW
HSMDPPTFTF	HSMDPTFTF
ISTPVIRTF	ISTPVIRTF
KTILDPLTL	KTILDPLTL
RSIPAYLAETL	RSIPLAETL
AGPLRKSSL	AGPLRKSSL
LTFRDVAIEF	LTFRVAIEF
RAIQINPAF	RAIQINPAF
ITREEGVLTLW	ITREGVLTL
TTHNIPQTF	TTHNIPQTF
KSINSEVLKF	KSINEVLKF
ATADVEWRW	ATADVEWRW
KTFGQKPVKF	KTFGKPVKF
KAFDYPSRF	KAFDYPSRF
KVIEEAVYF	KVIEEAVYF
KTSKLQTAF	KTSKLQTAF
HTEMVAELW	HTEMVAELW
HSAAVNGLSF	HSAANGLSF
KSFLGVKELSF	KSFLGVKEL
ISFPLKEYF	ISFPLKEYF
FSFKKSFKL	FSFKKSFKL
TTIFVAAFPL	TTIF-VAAF
KSAFVRTQW	KSAFVRTQW
KSYVQGVTW	KSYVQGVTW
TTKPSSLDQF	TTKPSLDQF
KAVDSQILPKI	KAVDILPKI
RVWNLNHLW	RVWNLNHLW
KSGLNIAHF	KSGLNIAHF
LSNPDPRLLF	LSNPPRLLF
FAPYNKPSL	FAPYNKPSL
KSLDQIFETL	KSLDIFETL
YSSDDINKFLW	YSSDDINKF
HTAKISDFSW	HTAKSDFSW
ATYDKGYQF	ATYDKGYQF
RSAQAIHKF	RSAQAIHKF
ISPRGAGWLF	ISPRAGWLF
KTVSNDSFFNF	KTVSNDSFF
HSSGILPKW	HSSGILPKW
KSLEDLKATL	KSLELKATL
KSTDYMNLHF	KSTDMNLHF
RTMNIKSATW	RTMNKSATW
KTMDGKADVSF	KTMDADVSF
RTAHVILRY	RTAHVILRY
SAPVGVTAL	SAPVGVTAL
KSNSAVAW	KSNS-AVAW
KAPSVASSW	KAPSVASSW
KSSKIMESF	KSSKIMESF
FAYKDQNENRW	FAYKQNENR
LAWQNPSGW	LAWQNPSGW
HSNPGDPALW	HSNPDPALW
ATFHQRGIALW	ATFHRGIAL
ITSPTGETW	ITSPTGETW
IAPTGHSL	IAPT-GHSL
KAFNLRISF	KAFNLRISF
KSLEKSELI	KSLEKSELI
ITSPVHVSF	ITSPVHVSF
RTLPVDSSHGF	RTLPSSHGF
LLEEMEILK	LLEEMEILK
RTSAEIAAIVF	TSAEAAIVF
KTGETMIQW	KTGETMIQW
KASDLYITL	KASDLYITL
RSMQNYVQF	RSMQNYVQF
KSFEAPIKL	KSFEAPIKL
KIREYEQTL	KIREYEQTL
VTNPYQATI	VTNPYQATI
KTFLFSATM	KTFLFSATM
YSFKFGFNEF	YSFKGFNEF
KSAEAVGVKI	KSAEVGVKI
ATLKNPILW	ATLKNPILW
KSVTLGYLF	KSVTLGYLF
RSLKTYGVSF	RSLKYGVSF
QSLPNPKSWDF	QSLPNPKSW
KTKDFQESSI	KTKDQESSI
GTHKVTVLF	GTHKVTVLF
HSAILDQKL	HSAILDQKL
KTSVSQNVI	KTSVSQNVI
RSYQLEGVNW	RSYQEGVNW
TTYKLVINGKT	TTYKVINGK
LVWKAQNTW	LVWKAQNTW
VSLPAPGVPAW	VSLPGVPAW
SAFSGFPSF	SAFSGFPSF
KTSDSTFLVF	KTSDTFLVF
LSSFVGGLSV	SSFVGGLSV
KTLTPIIQEYF	KTLTIIQEY
FSAAEARQKF	SAAEARQKF
KSLEEIYLF	KSLEEIYLF
RAGPLSGKKF	RAGPSGKKF
LTIVDTPGF	LTIVDTPGF
GSDKLYHQW	GSDKLYHQW
KTPGKAYLF	KTPGKAYLF
KTITDVINI	KTITDVINI
ATNVNNWHW	ATNVNNWHW
KTFLHDPLVEW	KTFLPLVEW
RVFEDESGKHW	RVFESGKHW
KTIETSPSL	KTIETSPSL
STIRNLKERF	STIRLKERF
RSFKAQVF	RSFK-AQVF
KTFVDNIQTAF	KTFVIQTAF
KSSEVFTTF	KSSEVFTTF
ISAKDLKNML	ISAKLKNML
KIKSFEVVF	KIKSFEVVF
KSLLVVHFW	KSLLVVHFW
RSLPQRFKM	RSLPQRFKM
RTLPDDLHFL	RTLPDDLHF
VVVPAEWIKNW	VVPAWIKNW
KAIADRGWRF	KAIARGWRF
RSMEVSTQL	RSMEVSTQL
AAIREQVRF	AAIREQVRF
RSLEYLPLRF	RSLELPLRF
RAPQQWATF	RAPQQWATF
KSLGELGLEHF	KSLGGLEHF
LTYENVERW	LTYENVERW
AALDSRKNYNW	AALDSRKNY
ITFTKNNQF	ITFTKNNQF
RTTDLLTDW	RTTDLLTDW
RSPKLFVVF	RSPKLFVVF
VTSTILQTI	VTSTILQTI
KSLLGKDVLF	KSLLKDVLF
RVYPELQRF	RVYPELQRF
TSLPDTDTW	TSLPDTDTW
HSFLYQPDW	HSFLYQPDW
HLPETKFSEL	HLPEKFSEL
HSSELAPKF	HSSELAPKF
NAGEDPGLAR	NAGEPGLAR
VTSHFQVTL	VTSHFQVTL
KVWKAPSSW	KVWKAPSSW
ISLKFYKEL	ISLKFYKEL
KAKYPDYEVTW	AKYPYEVTW
RTMEIESTF	RTMEIESTF
GPSSVEDIK	GPSSVEDIK
RSLAYIHSF	RSLAYIHSF
ITTKAISRW	ITTKAISRW
RSDTAQVEL	RSDTAQVEL
ATRPDYISW	ATRPDYISW
SSLPNFKQNEF	SSLPKQNEF
KAADLKNLF	KAADLKNLF
RALKEITTF	RALKEITTF
LTPDVQPRF	LTPDVQPRF
TVGNNKTL	TVGN-NKTL
SSGPVAESW	SSGPVAESW
KTLSAILRI	KTLSAILRI
TSLTLKHAAW	TSLTKHAAW
KGFLFLHTL	KGFLFLHTL
KSFYGSTLFL	KSFYGSTLF
KVLDFEHFL	KVLDFEHFL
STSRVFTTLVL	STSRVFTTL
KIIEDLGVHF	KIIELGVHF
KALDQFVNF	KALDQFVNF
KTPPPVLIF	KTPPPVLIF
GTWLPSRAEW	GTWLSRAEW
KTKEGVREVF	KTKEVREVF
STFKNWPFL	STFKNWPFL
HTAPSGVGSSW	TAPSVGSSW
RTTDIVIRI	RTTDIVIRI
KTPEEIRKTF	KTPEIRKTF
RTVEKPPKF	RTVEKPPKF
QAWKEILKW	QAWKEILKW
LTGPALQW	LTGP-ALQW
KANPALYVL	KANPALYVL
RSALLHADF	RSALLHADF
RSVDVTNTTF	RSVDTNTTF
KAYGASKTF	KAYGASKTF
RSFPGFQAF	RSFPGFQAF
KTDWHRYNL	KTDWHRYNL
TANKYQVFF	TANKYQVFF
RATPENYLF	RATPENYLF
KTLELPHVF	KTLELPHVF
LIRELEPLL	LIRELEPLL
ISSPVVTSL	ISSPVVTSL
RSLGFNTQI	RSLGFNTQI
RQFPTAFEF	RQFPTAFEF
VTDKKIAILGF	VTDKKIAIL
TTLKHSNVW	TTLKHSNVW
RSIPMTVDF	RSIPMTVDF
RSLTTLSEQW	RSLTLSEQW
KSKSEEIKI	KSKSEEIKI
QATRTVPVF	QATRTVPVF
RSLWKDVTF	RSLWKDVTF
YENEVALRQ	YENEVALRQ
RTHPVATSF	RTHPVATSF
RSADEPMTTF	RSADPMTTF
HSFNQSSSSQW	HSFNQSSSS
GSYGSLARF	GSYGSLARF
LAADLSLHSF	LAADSLHSF
KTLAESALQLL	KTLASALQL
HALEALIHF	HALEALIHF
VSIGDLQATF	VSIGLQATF
KTSSTVNTKF	KTSSVNTKF
YTYRGPKAF	YTYRGPKAF
RLIPQPAFQW	RLIPPAFQW
ATLELTHNW	ATLELTHNW
LATTILQHW	LATTILQHW
ITWQSVEYF	ITWQSVEYF
ITAHPERW	ITAH-PERW
IQAPLVYHF	IQAPLVYHF
QSLPSSVLHII	QSLPSVLHI
LSVAVRSEF	LSVAVRSEF
VVARTVAQLW	VARTVAQLW
GTYAGPVLW	GTYAGPVLW
KSLEEAQEW	KSLEEAQEW
STTRVKPFI	STTRVKPFI
KTTAQVLIRF	KTTAVLIRF
ITHIVNQNF	ITHIVNQNF
AVIILNHNF	AVIILNHNF
KSATDTSAKW	KSATTSAKW
VSVKLLTSF	VSVKLLTSF
RSDESVGNVTF	RSDEGNVTF
AVLQKVALW	AVLQKVALW
RIKNNDPKL	RIKNNDPKL
LTSVVQTLL	LTSVVQTLL
HTFFDHQDQVW	HTFFHQDQV
KTAEDAKDFF	KTAEAKDFF
KAVEDIHGLF	KAVEIHGLF
RAFKEVGIEF	RAFKVGIEF
VTYPGELLL	VTYPGELLL
KTIKLWNTL	KTIKLWNTL
ATRDELPYTF	ATRDLPYTF
ITLIVENVHF	ITLIENVHF
KVLPIIQRW	KVLPIIQRW
PEPAKSAPAPK	KSAP-----
STRPEVASI	STRPEVASI
GTYSPEISW	GTYSPEISW
KTWHKGTLI	KTWHKGTLI
AAYRNLGQNLW	AAYRLGQNL
LTLREVEVF	LTLREVEVF
HSLDQSIISF	HSLDSIISF
KALQEKVEI	KALQEKVEI
KSYDRNYRL	KSYDRNYRL
ATDGKVLLW	ATDGKVLLW
LTMSDVQIHW	LTMSVQIHW
RTLLAILRL	RTLLAILRL
AEQRGENALKD	AEQRGENAL
KTAQNHPML	KTAQNHPML
RSFFHQHYL	RSFFHQHYL
KTVSSTKLVSF	VSSTKLVSF
VTRDIVENW	VTRDIVENW
NTINLIHTF	NTINLIHTF
IAIPVTVAF	IAIPVTVAF
LSAHGIVVAW	LSAHIVVAW
LTSKLYSLL	LTSKLYSLL
KILEENPKF	KILEENPKF
KTISPEHVI	KTISPEHVI
KIWTSEHVF	KIWTSEHVF
ISKKPESTSF	ISKKESTSF
ISPRGAGYTF	ISPRAGYTF
MAIVGTHKF	MAIVGTHKF
LTSDALAVTF	LTSDLAVTF
KSLPSLVPLRI	KSLPSLVPL
AAFNKDALLNW	AAFNKDALL
ISTEVNPKL	ISTEVNPKL
RAADVLVYL	RAADVLVYL
RTYTYEKLLW	RTYTEKLLW
LSFTHPISF	LSFTHPISF
HTMDPQLRL	HTMDPQLRL
QTAVLIETL	QTAVLIETL
KSVELEDVKF	KSVEEDVKF
VTDIHQLSF	VTDIHQLSF
ETADVIAKVAF	TADVAKVAF
KSVSFSDVF	KSVSFSDVF
KSIVSSSISAF	IVSSSISAF
KTLTGKTITL	KTLTKTITL
KTLDLINKL	KTLDLINKL
KTQEPDNLLF	KTQEDNLLF
ISPGLDITF	ISPGLDITF
KSVKYTVNF	KSVKYTVNF
KSIDNGIFVQL	KSIDIFVQL
RSSVVTAVKF	RSSVTAVKF
RTLDSLMQF	RTLDSLMQF
SAARLLFSF	SAARLLFSF
KILENAQRF	KILENAQRF
KTSDSLLSMKF	KTSDSLLSM
KTFVQKSTL	KTFVQKSTL
LALSPVPSHW	LALSVPSHW
KLFDIRPIW	KLFDIRPIW
RSMEAHNIL	RSMEAHNIL
QTIRLPAQSIW	QTIRPAQSI
RTLESKLVLF	RTLEKLVLF
KSGPVVSLGW	KSGPVSLGW
GPPPPPGKPQ	GPPPPPGKP
ITFEGKVAF	ITFEGKVAF
RTVVTGIEMF	RTVVGIEMF
ISMKILNSL	ISMKILNSL
KTILERNNF	KTILERNNF
KSRPELLEY	KSRPELLEY
KLIDVTNIYW	KLIDTNIYW
KARVETQNHW	KARVTQNHW
HAIPLRSSW	HAIPLRSSW
IAWWTDKNVKF	AWWTKNVKF
AVAEALTNLVF	AVAEALTNL
ITVDGKPPTW	ITVDKPPTW
KSFENISKW	KSFENISKW
RAIEALLQYW	RAIELLQYW
KSFQAIHQF	KSFQAIHQF
ATHRIPIIW	ATHRIPIIW
RSFVSPPVL	RSFVSPPVL
YSKYYKTID	YSKYYKTID
NSTVRLYEW	NSTVRLYEW
KTKSENGLEF	KTKSNGLEF
KALEIITDF	KALEIITDF
ISQKIIPLL	ISQKIIPLL
KAAEAAASAYY	KAAEAASAY
ITKADAAEFW	ITKADAAEF
KAMGIMNSF	KAMGIMNSF
ASLRDLPAQLL	ASLRLPAQL
ISLPGIRNEF	ISLPIRNEF
RTFAAQSLVQL	RTFA-AQSL
KTMETAEKL	KTMETAEKL
HTVYNIITNF	HTVYIITNF
KALKRIHQF	KALKRIHQF
STFPGFVSW	STFPGFVSW
ATIGHVEKF	ATIGHVEKF
KAWHQKSHF	KAWHQKSHF
KSFSDTLKTYF	KSFSTLKTY
HARPEEPSW	HARPEEPSW
STYDGVFIW	STYDGVFIW
LTKKYEHVL	LTKKYEHVL
GASEAVADIKF	ASEAADIKF
KTTGIPIHVF	KTTGPIHVF
LSTTIQEEF	LSTTIQEEF
KAFSTRWNW	KAFSTRWNW
KSYLGSEADVW	KSYLGSEAD
KTAEELMNF	KTAEELMNF
KSFNRHLHF	KSFNRHLHF
VTNPHSSQW	VTNPHSSQW
KTFTAKSTL	KTFTAKSTL
KTVPQKVTI	KTVPQKVTI
ISAEAPVLF	ISAEAPVLF
QTLTDYDIRF	QTLTYDIRF
RSAHLRSYF	RSAHLRSYF
TVYDKPASF	TVYDKPASF
KTQDVEYIF	KTQDVEYIF
VTVKDMYLF	VTVKDMYLF
LTRVEVTEF	LTRVEVTEF
RVSEDLVSIHL	RVSEDLVSI
ITSQVTGQIGW	ITSQVTGQI
RTFDPLLF	RTFD-PLLF
KVVDAKTIF	KVVDAKTIF
KVASLLHQVSW	ASLLHQVSW
KTLKDEQTRKL	KTLKEQTRK
IAAQTGTRW	IAAQTGTRW
KSFEAPIKLVF	KSFEAPIKL
RAAEEFVNVYY	RAAEFVNVY
TTKDVEPLL	TTKDVEPLL
ASAPLGARW	ASAPLGARW
ISTFLLTRELW	STFLTRELW
RSKPGEGKLIF	RSKPEGKLI
VSLTLTNKF	VSLTLTNKF
KTFVQKQTL	KTFVQKQTL
RSFKATKF	RSFK-ATKF
QTHRIHNAL	QTHRIHNAL
ITAGAHRLW	ITAGAHRLW
ISAPDKRIYQF	ISAPDKRIY
VTTSITSKKW	VTTSTSKKW
HTVGLSSTW	HTVGLSSTW
QSAKEQIKW	QSAKEQIKW
VSLRLGDLVW	VSLRGDLVW
RTVYFSEQW	RTVYFSEQW
ASYVNLPTI	ASYVNLPTI
LLVVYPWTQR	VVYP----W
IIFVPVPQL	IIFVPVPQL
DSYVGDEAQSK	YVGDEAQSK
KAVETVHNL	KAVETVHNL
GVSQVLNRLTF	VSQVNRLTF
RTLRDIETFY	RTLRDIETF
KTLIEKERF	KTLIEKERF
RTVENMSIIGW	RTVENMSII
KSKGSQTEEW	KSKGQTEEW
RVMPSSFFL	RVMPSSFFL
MSLPYRLVF	MSLPYRLVF
ISQEPVLF	ISQE-PVLF
KGFTDADNTW	KGFTADNTW
ATSKYLIGW	ATSKYLIGW
ISVRQQVVL	ISVRQQVVL
ITQRAQVSL	ITQRAQVSL
RSKKQTKFEVL	RSKK-QTKF
RAITHLNNNF	RAITLNNNF
KAPEYLHRF	KAPEYLHRF
GSTKVLQAVQW	STKVQAVQW
ISVAEVEKW	ISVAEVEKW
KVLPGHFNTF	KVLPHFNTF
IAAIIVSQW	IAAIIVSQW
TSYRDFLGTNW	TSYRLGTNW
KTNTFQGVIF	KTNTQGVIF
ASLLLHNKF	ASLLLHNKF
AVAAVLTQVVW	AAVLTQVVW
EALALTQTW	EALALTQTW
YTQPPLKF	YTQP-PLKF
AAAKIQASF	AAAKIQASF
RSLVPAAVVW	RSLVAAVVW
RTYSDDHVKF	RTYSDHVKF
RSLPHITDVSW	RSLPTDVSW
KVIQMVPEF	KVIQMVPEF
AAPEGKRSL	AAPEGKRSL
VSKSTQFEYAW	KSTQFEYAW
SANEILGSLRW	SANEILGSL
ISSSDLVSKW	ISSSLVSKW
KTLQEFLERI	KTLQFLERI
KTLTMDILTL	KTLTDILTL
RTTTVESSF	RTTTVESSF
KVMPQNHSF	KVMPQNHSF
KTLPADVQNYY	KTLPDVQNY
RVNPVEYSI	RVNPVEYSI
ISWTGDGWEF	ISWTDGWEF
KSTEILLRKL	KSTELLRKL
SIPEKNRPL	SIPEKNRPL
ASLPLRVSF	ASLPLRVSF
KTQEKIWEF	KTQEKIWEF
RSIRLPETI	RSIRLPETI
IVDANLSVLNL	IVDANLSVL
KAVKGKYKF	KAVKGKYKF
RSVPLKATF	RSVPLKATF
LVFPYTHQNW	LVFPTHQNW
LALVKPEVW	LALVKPEVW
RSWDHNEFF	RSWDHNEFF
ASNKLQIVF	ASNKLQIVF
RSLEQKKTF	RSLEQKKTF
LSTLVRPVF	LSTLVRPVF
RSKKDDINL	RSKKDDINL
RAYAKDVKF	RAYAKDVKF
KTKPEVLEAHY	KTKPVLEAH
KVYDSQGLLIF	KVYDSQGLL
KVSVLTGIIKI	SVLTGIIKI
RALEAEKRALW	RALEEKRAL
KSVIDYQTHF	KSVIYQTHF
VALQDHFKW	VALQDHFKW
LADRLLHQF	LADRLLHQF
KTRSVEQTL	KTRSVEQTL
RSLGVHLSF	RSLGVHLSF
YAPRAEAEKTF	RAEA-EKTF
KTIDGQQTII	KTIDGQQTI
LSIPDIKTAF	LSIPIKTAF
KTTNTVSKF	KTTNTVSKF
LALDPSLVPTF	LALDLVPTF
ATYNEIVTF	ATYNEIVTF
KVFGNEIKL	KVFGNEIKL
KTKESSEYL	KTKESSEYL
LAKKIEPEL	LAKKIEPEL
HTSPSSDSLLF	HTSPSSDSL
QTVSPAEKW	QTVSPAEKW
HSFYPTPALQW	HSFYPTPAL
LSDPDEVARRW	LSDPEVARR
KSLTAHIVENF	LTAHIVENF
IASARAGETRF	ASARGETRF
RSDKPKLF	RSDK-PKLF
SAPKGSVL	SAPK-GSVL
RSLPEIWTL	RSLPEIWTL
KSFTQIQATF	KSFTIQATF
ISKFDTVEDFW	ISKFTVEDF
KAMPLQPSI	KAMPLQPSI
HTLPHEIVVNL	HTLPIVVNL
TSVPLPVTW	TSVPLPVTW
KIITFTKNNQF	ITFTKNNQF
QTASAVVQHM	QTASVVQHM
KVAKEAANRW	KVAKAANRW
VVVPQAPEF	VVVPQAPEF
KAAKLKEKY	KAAKLKEKY
HTVQPKGKITF	TVQPGKITF
RSAEAYENF	RSAEAYENF
HSFGGGTGSGF	HSFGTGSGF
KSIEFLSSKW	KSIELSSKW
TVLTTHHHW	TVLTTHHHW
GSQGRAYLF	GSQGRAYLF
ATIKDIREHEW	ATIKREHEW
RVIDVGSEW	RVIDVGSEW
SFHNIHNTF	SFHNIHNTF
RSIQADGLVW	RSIQDGLVW
RTFSEGTHF	RTFSEGTHF
KTSELLVRKW	KTSELVRKW
KSQELQSQI	KSQELQSQI
KSIDLIQKW	KSIDLIQKW
KSYELPDGQVI	KSYEDGQVI
RTAPFHLDLW	RTAPHLDLW
KAAVMVHQL	KAAVMVHQL
KSYKGRQII	KSYKGRQII
RSALVNNTI	RSALVNNTI
KQFAEMYVAKF	FAEMYVAKF
KTYEAALETI	KTYEALETI
KTLQEVHFLL	KTLQVHFLL
SAVKVLMKF	SAVKVLMKF
HSYSVLERF	HSYSVLERF
STLRELGQTW	STLRLGQTW
KSLDPSRPVTF	KSLDRPVTF
ILKGFDPLL	ILKGFDPLL
RAAEPVRVVW	RAAEVRVVW
RTLKEEVQKL	RTLKEVQKL
ASTKMLDRW	ASTKMLDRW
KSFQIIAHL	KSFQIIAHL
KTFHPVPNL	KTFHPVPNL
RSWDQQIKLW	RSWDQQIKL
LAWSADGQTLF	LAWSDGQTL
ATKVGKDELF	ATKVKDELF
GAVALTETW	GAVALTETW
RLGQIYQSW	RLGQIYQSW
RSFLTKLEW	RSFLTKLEW
GTLKERVQW	GTLKERVQW
LADWVSGKISF	VSGK--ISF
LASPIYTHF	LASPIYTHF
RSMEDFVTW	RSMEDFVTW
HSSHVTNVSF	SSHVTNVSF
KTFESLVDF	KTFESLVDF
RSADHPPKL	RSADHPPKL
HTVAIDNQIF	HTVADNQIF
RAFLIRELF	RAFLIRELF
KALPALPISI	KALPLPISI
KAYRLTPKL	KAYRLTPKL
TTYKHQNKL	TTYKHQNKL
NVAAAAAFN	NVAAAAAFN
GSLSTTSHF	GSLSTTSHF
RSVDLQTRI	RSVDLQTRI
RGFYSVETF	RGFYSVETF
RAPEVILSW	RAPEVILSW
KSLELHEEF	KSLELHEEF
GSSEVQPQF	GSSEVQPQF
KTWKVDVVL	KTWKVDVVL
GTTVIQTRF	GTTVIQTRF
KSIELFYKF	KSIELFYKF
VSLKNVAVSF	VSLKVAVSF
HSSGVTGVTF	HSSGTGVTF
ITIPDIKKDRW	ITIPKKDRW
STLRNIQGLF	STLRIQGLF
KAFDLIEHY	KAFDLIEHY
GTIAIKHYF	GTIAIKHYF
RAFREEAIKF	RAFREAIKF
KTNTKLGKLYL	KTNTKLGKL
KTQRDFMLSF	KTQRFMLSF
RTLPWSSVL	RTLPWSSVL
HAGPIVSVW	HAGPIVSVW
LSSPDYQIRW	LSSPYQIRW
SNKGISKTEI	KGIS-KTEI
KSLERATQL	KSLERATQL
KVVNIVPVI	KVVNIVPVI
RTTLVDNNTW	TTLVDNNTW
RTAITTPNF	RTAITTPNF
RVFPEKGYSF	RVFPKGYSF
LANKLYERW	LANKLYERW
VTVPANVQRW	VTVPNVQRW
KTNIIRDYL	KTNIIRDYL
SSLRVPSQW	SSLRVPSQW
HTSSTTSAW	HTSSTTSAW
GTYGVRAAW	GTYGVRAAW
KIISTLPSW	KIISTLPSW
KTDIIDHSF	KTDIIDHSF
FTLRDEGKTI	FTLREGKTI
KVIAQQVQL	KVIAQQVQL
RAFEYEIRF	RAFEYEIRF
RTIKIRNISY	RTIKRNISY
RVLRFQVSF	RVLRFQVSF
RVLVVSAKF	RVLVVSAKF
ESWKTKVNW	ESWKTKVNW
GTSKVLVLL	GTSKVLVLL
VVWENKHITW	VVWEKHITW
GTYYIKEQKL	GTYYKEQKL
TTWKPLNPNSW	TTWKNPNSW
QTARMEDFTF	QTAREDFTF
KVFESWMHHW	KVFEWMHHW
KTLALEIINF	KTLAEIINF
TTKAISRW	TTKA-ISRW
KVLDLRINL	KVLDLRINL
KSQIPLSKI	KSQIPLSKI
LVHAVQALW	LVHAVQALW
YTHEVVTLW	YTHEVVTLW
KSTPYTAVRW	KSTPTAVRW
KVFDPKVFTF	KVFDKVFTF
ISSGVVSIW	ISSGVVSIW
TAAVLNAVW	TAAVLNAVW
RSSVEVRMEF	RSSVVRMEF
QSLPDFGISY	QSLPFGISY
LSVPSPFTW	LSVPSPFTW
LEDALQQAKED	DALQQAKED
VAAPPPKNSF	AAPPPKNSF
RSGPFAPVL	RSGPFAPVL
RALSEQINI	RALSEQINI
KGIEKLYEW	KGIEKLYEW
KTFQGKPIM	KTFQGKPIM
ASIKDPKDLKF	ASIKKDLKF
RTIKPEKHLRF	RTIKPEKHL
RSLPRFQVTL	RSLPFQVTL
ASNKYLVEF	ASNKYLVEF
ALQQAKED	ALQQ-AKED
RVFKNLQLF	RVFKNLQLF
RTVKELGNSL	RTVKLGNSL
ITTTINPRF	ITTTINPRF
KTLVNPANVTF	LVNPANVTF
ISKALVAYY	ISKALVAYY
RTFTDHVMLF	RTFTHVMLF
KVIAINDLNW	KVIANDLNW
MTFKDVEVTF	MTFKVEVTF
KSTGELVVQW	KSTGLVVQW
STIETVPYW	STIETVPYW
RTVAELVQF	RTVAELVQF
LTLPVNHIF	LTLPVNHIF
KAIPSFLNSF	KAIPFLNSF
ASLKSNYNL	ASLKSNYNL
KSNDISIHHF	KSNDSIHHF
RILDIVPPTF	RILDVPPTF
KTATIGSRF	KTATIGSRF
TTAQVLIRF	TTAQVLIRF
RTIADSLINSF	IADSLINSF
TSVMLKDRW	TSVMLKDRW
VVMPIAHEF	VVMPIAHEF
ITAGAHRL	ITAG-AHRL
RSLEQNIQL	RSLEQNIQL
ISNLVDAIYK	ISNLVDAIY
RSADFLGKVAI	RSADFLGKV
RTLKSGDGITF	RTLKDGITF
ATAPVVALF	ATAPVVALF
ASSLTIDKLLL	SSLTIDKLL
KSGSPVATF	KSGSPVATF
YSRNEPLTF	YSRNEPLTF
KTYRPELI	KTYR-PELI
TVYPKPEEW	TVYPKPEEW
KTIDDLEDKL	KTIDLEDKL
RSISQGLTWTW	RSISQGLTW
HSIPSLPRF	HSIPSLPRF
KTLQEVTQL	KTLQEVTQL
KLSPEELLLRW	LSPELLLRW
KAIPDTRLTI	KAIPTRLTI
KLKPFIDREWW	KLKPIDREW
KALSMPEKW	KALSMPEKW
KVKPEELESF	KVKPELESF
ATANLEAKW	ATANLEAKW
KTKQGGLRF	KTKQGGLRF
RVNPALAELNL	RVNPALAEL
LSWQYLTTL	LSWQYLTTL
KATDAVSKMTI	KATDAVSKM
HTFTFSHATF	HTFTSHATF
KTLHDTRTHF	KTLHTRTHF
KTAPFDSRF	KTAPFDSRF
LSALPADTQAW	SALPDTQAW
KTFSDEDYYQF	KTFSDYYQF
RSATEVDNNF	RSATVDNNF
KTNVPVKL	KTNV-PVKL
KSVTQGFSF	KSVTQGFSF
VSWDEKGMTW	VSWDKGMTW
HTANIQTLI	HTANIQTLI
RSFQGPVLI	RSFQGPVLI
MSERQVALW	MSERQVALW
GVHTIDVKF	GVHTIDVKF
KSLTYDEVISF	LTYDEVISF
KSTALQTWLF	KSTAQTWLF
KSLALLGQTF	KSLALGQTF
ATVPNTIVVNW	ATVPIVVNW
ASSRQIISHW	SSRQIISHW
ATSSVFQEVTL	SSVFQEVTL
VTKKTYEIW	VTKKTYEIW
RTTPGTLARF	RTTPTLARF
KTFNIKNDF	KTFNIKNDF
INSTVRLYEW	STVR-LYEW
RMYPLKPTWW	RMYPLKPTW
KSSLTQHSW	KSSLTQHSW
KTAEDMNLF	KTAEDMNLF
KSLPDTELM	KSLPDTELM
RTDGKVFQF	RTDGKVFQF
ATGPSIKI	ATGP-SIKI
ISVPGLQTNW	ISVPLQTNW
ISRPIVNLF	ISRPIVNLF
LTMKDSNQF	LTMKDSNQF
RLWEQLVHF	RLWEQLVHF
TTIPTKQTQTF	IPTKQTQTF
FSSREQPKL	FSSREQPKL
KSLESLDTSLF	KSLELDTSL
RSMQNSPSI	RSMQNSPSI
ITFQPDLSKF	ITFQDLSKF
KALADVEVTY	KALAVEVTY
RSTELIPRL	RSTELIPRL
KTYAEVDRQVI	KTYAEVDRQ
KTKNAQQVHF	KTKNQQVHF
LTVIHDFLF	LTVIHDFLF
KAIDLSRNQF	KAIDSRNQF
ASLNLPAVSW	ASLNPAVSW
VSAGIQTSF	VSAGIQTSF
KSFSKSDLVNW	FSKSDLVNW
ISWGQGHFW	ISWGQGHFW
KSLGVQDLLQF	KSLGVQDLL
ISPTIVQQF	ISPTIVQQF
KSAQPIEKF	KSAQPIEKF
RSNPSVFVIF	RSNPVFVIF
STFEDVKILAF	STFEDVKIL
KIIFIDSTW	KIIFIDSTW
RTNGKEPEL	RTNGKEPEL
RIIAKLAAW	RIIAKLAAW
KSYPLVHVV	KSYPLVHVV
RVVPQFVVF	RVVPQFVVF
RSLEQIESFF	RSLEQIESF
KALGAIVYI	KALGAIVYI
RTLVEHSGRVF	RTLVEHSGR
STNKGTAYTFF	STNKTAYTF
RSMPLGARILF	RSMPLGARI
KTAKLASTF	KTAKLASTF
ISHVAHVTI	ISHVAHVTI
RSSTVTVLLL	RSSTVTVLL
KTFVGRAKL	KTFVGRAKL
LTYLDNGVVF	LTYLNGVVF
LSQPTPATL	LSQPTPATL
RAFPYGNVAF	RAFPGNVAF
TVAQITQRF	TVAQITQRF
ASFGSFHLI	ASFGSFHLI
KSLGSSDLKF	KSLGSDLKF
KASNLLLGF	KASNLLLGF
RIIHLVHRF	RIIHLVHRF
KSIASAIVNEL	IASAIVNEL
RTIQTPIGSTW	RTIQIGSTW
ASFTRAYLL	ASFTRAYLL
IAPRILTNF	IAPRILTNF
TTYKLVINGK	TTYKVINGK
VASTAIAAAQW	STAIAAAQW
LTVRNLPQY	LTVRNLPQY
KSQDLELSW	KSQDLELSW
ISMPDVDLHL	ISMPVDLHL
GSMGLRSLW	GSMGLRSLW
KSAVELVQEF	KSAVLVQEF
KTLDVFNITI	KTLDFNITI
KARLAEPQL	KARLAEPQL
KSVTAHLAAKW	VTAHLAAKW
RTLRDIETF	RTLRDIETF
KSYDFLTGF	KSYDFLTGF
ATIPVSQISTI	ATIP-VSQI
KTLQHDKLVRL	KTLQKLVRL
RAYPHNLMTF	RAYPNLMTF
LKSQLALK	LKSQ-LALK
KSFKLSGFSF	KSFKSGFSF
RSARPPEKF	RSARPPEKF
HSRPEQDKF	HSRPEQDKF
KTHTIQGTI	KTHTIQGTI
RSFHEVREF	RSFHEVREF
KSWHPQTL	KSWH-PQTL
RSLPDIPAHL	RSLPIPAHL
YTYKDPITEF	YTYKPITEF
ITPTGTHPL	ITPTGTHPL
LTLEERVHF	LTLEERVHF
KTYQDIQNTI	KTYQIQNTI
STVKVLIRL	STVKVLIRL
KTSRVLQNVAF	KTSRVLQNV
VSPPLITQVHW	VSPPLITQV
RSIISPNFSF	RSIIPNFSF
KTFQMAEYL	KTFQMAEYL
HSRPEIIFL	HSRPEIIFL
KSFDNIRNW	KSFDNIRNW
KSNELFTTF	KSNELFTTF
LSIPYRLIF	LSIPYRLIF
RSKQAEEEF	RSKQAEEEF
KSFVTPPQSHF	VTPP-QSHF
RVLISTDVW	RVLISTDVW
KTLADLLESF	KTLALLESF
RVDPDVAQHW	RVDPVAQHW
KTDATTAIIKL	KTDATTAII
RTKASVHTL	RTKASVHTL
RAANLESKF	RAANLESKF
RAPEVYVAF	RAPEVYVAF
KAKEFVADIF	KAKEVADIF
YSIRGQLSW	YSIRGQLSW
RVVDIYSKF	RVVDIYSKF
ISASSLTSKW	ISASLTSKW
ITAHVEPLL	ITAHVEPLL
RTNPNNGEF	RTNPNNGEF
KSANPPHTI	KSANPPHTI
KSINEFWNKF	KSINFWNKF
IIMKDVPDW	IIMKDVPDW
KSLELAIGRF	KSLEAIGRF
RLAPIGRRQLL	LAPIRRQLL
KTGPVAKEL	KTGPVAKEL
KTMKQQLQF	KTMKQQLQF
QSVTLTHLF	QSVTLTHLF
GTMDIRHFF	GTMDIRHFF
VTVAVVDTF	VTVAVVDTF
ISKPVGFGEEF	ISKPFGEEF
RSKFENEEF	RSKFENEEF
KSYGNEKRF	KSYGNEKRF
RSRVDQEERW	RSRVQEERW
KSNPKPLVL	KSNPKPLVL
IGAQVLGKILW	GAQVGKILW
RTTEILHHL	RTTEILHHL
KTITQIEEF	KTITQIEEF
ATAPLTELL	ATAPLTELL
RGWNDPPQF	RGWNDPPQF
IARKDEKLLSF	IARKDEKLL
KTYNEPGSQVF	KTYNGSQVF
ITIPKNMHW	ITIPKNMHW
QTLPTSVVTI	QTLPSVVTI
KSFPGGKEYL	KSFPGKEYL
VTFRDVAIDF	VTFRVAIDF
VSKEEPVTF	VSKEEPVTF
KAASLKSNY	KAASLKSNY
PTSSPPSFEF	TSSPPSFEF
KSPPVLSHEF	KSPPLSHEF
KATPIKLIW	KATPIKLIW
ISVKGSNLF	ISVKGSNLF
RSYSESEKQW	RSYSSEKQW
RTVIIEQSW	RTVIIEQSW
RTFTSPRPTQF	FTSPRPTQF
ATNRIISHF	ATNRIISHF
QTLPTSNYF	QTLPTSNYF
RGAVVVGNVGF	AVVVGNVGF
KTAITVEHL	KTAITVEHL
QSTPIQHSF	QSTPIQHSF
AKEIIQHF	AKEI-IQHF
KSFKDNYNTL	KSFKNYNTL
LTYASPPLI	LTYASPPLI
RTILVDNNTW	RTILDNNTW
ASVPIMYSW	ASVPIMYSW
KSLEDKSLEF	KSLEKSLEF
RAATIHHRL	RAATIHHRL
RAAEVFFETF	RAAEFFETF
PDLLVNVL	PDLL-VNVL
HSGPFFTF	HSGP-FFTF
LSIHLQHKF	LSIHLQHKF
KTTKLYSRF	KTTKLYSRF
KSLDQAISRF	KSLDAISRF
STDKTVAVW	STDKTVAVW
SSLRVHERI	SSLRVHERI
KTVEQHLRL	KTVEQHLRL
TAQSDNKITW	TAQSNKITW
RSKEGLTERF	RSKELTERF
HSTRFVTYF	HSTRFVTYF
SSSHTLTYSYW	SSHTLTYSY
KTLDSWRDEF	KTLDWRDEF
YSPRAIHSW	YSPRAIHSW
KSFGSAQEFAW	KSFGSAQEF
HATKAIYRW	HATKAIYRW
HTTGMDVLW	HTTGMDVLW
RTWNVVVHDW	RTWNVVHDW
KSSQLVTHL	KSSQLVTHL
RTIGVITKL	RTIGVITKL
LLFPGKAFSW	LLFPKAFSW
QTFLSEIRW	QTFLSEIRW
GTFNPVSLW	GTFNPVSLW
HTAPVLDIAW	HTAPLDIAW
FVEIKGSV	FVEI-KGSV
KAVEAAHTF	KAVEAAHTF
QTVMITPTF	QTVMITPTF
KSDQALHSF	KSDQALHSF
KTAVETAVLLL	KTAVTAVLL
KSVGVFEAF	KSVGVFEAF
STYKFFEVI	STYKFFEVI
KSAWQTLNEF	KSAWTLNEF
KSSQVQRRF	KSSQVQRRF
ITRTKEEAL	ITRTKEEAL
VTTVVNPKY	VTTVVNPKY
LSLPESTESF	LSLPSTESF
RSMQLDYTTW	RSMQDYTTW
VSEHQPTTW	VSEHQPTTW
RTLDELGIHL	RTLDLGIHL
IALPPIAKW	IALPPIAKW
RTADWRLYL	RTADWRLYL
VSQKISKTRW	VSQKSKTRW
RSYSDPPLKF	RSYSPPLKF
KAYFILDEF	KAYFILDEF
KVIHEQVNHRW	VIHEVNHRW
ASHLHIHVF	ASHLHIHVF
RSIQLDGLVW	RSIQDGLVW
TTKKDLKDYF	TTKKLKDYF
QTALLQKLTW	TALLQKLTW
AHSNLNGVWH	HSNL-NGVW
VSFAEKNGW	VSFAEKNGW
RAAELGVNF	RAAELGVNF
ASLKNLETI	ASLKNLETI
KVMPFANLM	KVMPFANLM
KSTDVAKTF	KSTDVAKTF
RSSQSSSQQF	RSSQSSQQF
ITAENVAKKW	ITAEVAKKW
KTPEKEPPLW	KTPEEPPLW
KTSNIRANF	KTSNIRANF
GTVITPDTW	GTVITPDTW
KSLITTHHL	KSLITTHHL
HSSNVKVVL	HSSNVKVVL
VSYKNPSLM	VSYKNPSLM
RVADFGSATF	RVADGSATF
SSLALVTSW	SSLALVTSW
ASLPAELINQI	ASLP-AELI
STVRLYEW	STVR-LYEW
RSAVFSVTY	RSAVFSVTY
KLLPVLVHTF	KLLPLVHTF
KAINPINTF	KAINPINTF
ATSKTQTRL	ATSKTQTRL
KTAYISIQQF	KTAYSIQQF
KALKDYKSSF	KALKYKSSF
KSLQDIIAIL	KSLQIIAIL
RSDPGHYSF	RSDPGHYSF
KSSVIGASSQF	SSVIASSQF
KAVAAESNATF	VAAESNATF
KTPELNLDQF	KTPENLDQF
KIQPDTIIQVW	KIQPIIQVW
VTLKIGDHKF	VTLKGDHKF
IIAPPERK	IIAP-PERK
SSSAAVKDTLW	SSAAVKDTL
LSTIISPLF	LSTIISPLF
RVTSVVTGF	RVTSVVTGF
RVIEFAAKF	RVIEFAAKF
KTLGGVIFRK	KTLG-GVIF
VTMDVGMTKF	VTMDGMTKF
GTNESLER	GTNE-SLER
RSAVVEMLI	RSAVVEMLI
RTHPDEPLYSF	RTHPDEPLY
RALQASALNAW	RALQ-ASAL
KSFLSQGQVL	KSFLQGQVL
ITYDKLNKW	ITYDKLNKW
RSQVVLYTL	RSQVVLYTL
KAATIGQIGW	KAATGQIGW
KSIKNIQKI	KSIKNIQKI
KAIKELEEW	KAIKELEEW
KSYSKAFTL	KSYSKAFTL
LSAPIHTQM	LSAPIHTQM
GTRQAEPEL	GTRQAEPEL
KTKDGVREVF	KTKDVREVF
KTKKPLLI	KTKK-PLLI
ASFNDNIIKW	ASFNNIIKW
NARLAADD	NARL-AADD
RLAEISDVW	RLAEISDVW
RVHAFLEQW	RVHAFLEQW
HTADVQLHAW	HTADQLHAW
TSLVEKHTL	TSLVEKHTL
RSYSDGASQQF	RSYSASQQF
KAFNHPATL	KAFNHPATL
ISVQVNSIKF	ISVQNSIKF
KGFSEEHNTW	KGFSEHNTW
KSIVQVETL	KSIVQVETL
KSSEMNVLI	KSSEMNVLI
GTWIGKGTERW	GTWIKGTER
KVMPLIIQGF	KVMPIIQGF
RTSRPLKI	RTSR-PLKI
KTRDDWLVSW	KTRDWLVSW
KSLGLLTTKF	KSLGLTTKF
KTAVETAVLL	KTAVTAVLL
YTTKIKPRL	YTTKIKPRL
RTSTSQAVF	RTSTSQAVF
KSFEGLFYF	KSFEGLFYF
RTWKGTAFGGW	RTWK-GTAF
KAFDFPSSF	KAFDFPSSF
KSWKGGGII	KSWKGGGII
RVDPNGSRYLL	RVDPNGSRY
KTSDLYQLF	KTSDLYQLF
HTSDVPGKLIY	HTSDVPGKL
RSLQDTAELL	RSLQTAELL
RTQVITQTL	RTQVITQTL
YTVRVIDVF	YTVRVIDVF
RTFSLFQQL	RTFSLFQQL
KTVEPTGKRF	KTVETGKRF
KSIVIMVHI	KSIVIMVHI
KTIIKKLFF	KTIIKKLFF
LSLPDIKVYL	LSLPIKVYL
RTSETNTLF	RTSETNTLF
KLKKPEAVRW	KLKKEAVRW
KTLQRAPTI	KTLQRAPTI
FTLRDMYEQF	FTLRMYEQF
RSTVHGVTQAF	STVHVTQAF
RSQVSTPRF	RSQVSTPRF
ILYPHEAPSW	ILYPEAPSW
GTIPELPTF	GTIPELPTF
FSLPNIPRW	FSLPNIPRW
KAFDRPSLF	KAFDRPSLF
RTIQAHEGF	RTIQAHEGF
RTIQGLIDFI	RTIQGLIDF
RIAEALSKMKL	RIAEALSKM
KSARVKGLSF	KSARKGLSF
IVYPGIAVFF	IVYPIAVFF
RTLDKIMILF	RTLDIMILF
KALKDIKVGF	KALKIKVGF
GSSHLISTSSW	SSHLSTSSW
KAMTGVEQW	KAMTGVEQW
IIHEIAVLEL	IIHEAVLEL
SQPLGPRII	SQPLGPRII
ASLAIKPVF	ASLAIKPVF
KAPAPRPSL	KAPAPRPSL
KSQEIFLNL	KSQEIFLNL
STLHLVLRL	STLHLVLRL
VTHSVRIGF	VTHSVRIGF
KSNKLLYTF	KSNKLLYTF
RASQVQSKL	RASQVQSKL
KVRPSEEML	KVRPSEEML
VSAPSSETF	VSAPSSETF
IASHSIARISF	ASHSARISF
KTIEFGKTNF	KTIEGKTNF
RTLPKLYSL	RTLPKLYSL
KTHGEHVGF	KTHGEHVGF
ITYPAGFMDVI	ITYP--AGF
RAAGALSKRYW	RAAGLSKRY
RSLSTTNVF	RSLSTTNVF
KTLSDATTKF	KTLSATTKF
RTYINPFVSF	RTYIPFVSF
NAPWAVTSL	NAPWAVTSL
HSSEELRNLGW	HSSEELRNL
VTFRDVAIYF	VTFRVAIYF
IASPVQPVL	IASPVQPVL
KTAENFRQF	KTAENFRQF
KSLLFVNTL	KSLLFVNTL
QTFSSKTEW	QTFSSKTEW
MSLRLNEQY	MSLRLNEQY
KAAELSIKF	KAAELSIKF
HSHFQNIFW	HSHFQNIFW
VSFYNQNKW	VSFYNQNKW
KSIHIVVTM	KSIHIVVTM
RSLINSNVGF	RSLISNVGF
SSSPSVRQTW	SSSPVRQTW
LSVETDYTF	LSVETDYTF
ISVILGDRW	ISVILGDRW
AAPATRAAL	AAPATRAAL
ISLPNGLQGF	ISLPGLQGF
KSAEQLRIEL	KSAELRIEL
HTLGDAHIYL	HTLGAHIYL
RVFPDKGYSF	RVFPKGYSF
KAVFLVPKW	KAVFLVPKW
MAFQNDVYEW	MAFQDVYEW
ITYQHIDRW	ITYQHIDRW
HTNPVGTEW	HTNPVGTEW
KTILSEVRF	KTILSEVRF
LRNVSTGD	LRNV-STGD
RLFKNDPLF	RLFKNDPLF
RSDNIIFQF	RSDNIIFQF
KTLTQEEKI	KTLTQEEKI
LGTLPPEIQAW	GTLPEIQAW
KTFLIPVLF	KTFLIPVLF
EVSRIVGSVEF	VSRIGSVEF
ITKGQTILL	ITKGQTILL
KSLEIEEKI	KSLEIEEKI
KAYEALYNF	KAYEALYNF
YTVKVEDLTF	YTVKEDLTF
KALEKGIEI	KALEKGIEI
KVHQLYETI	KVHQLYETI
LTKEDGEKETW	LTKEEKETW
RSINQPVAF	RSINQPVAF
QSLPAGTLLHL	QSLPAGTLL
KSLRSLNNF	KSLRSLNNF
ISSTAFDIRF	ISSTFDIRF
KTLTADKLEHL	LTADKLEHL
QTVHINENF	QTVHINENF
ASAAVLAPLGF	ASAAVLAPL
ISSIKGAEEW	SSIKGAEEW
KSSLLQVLI	KSSLLQVLI
KSQPEPSPVL	KSQPPSPVL
HTLDDRTQLW	HTLDRTQLW
RTQGFLALF	RTQGFLALF
KTDVTVVRF	KTDVTVVRF
KTYSYLTPDLW	KTYSLTPDL
VTPKSPYTF	VTPKSPYTF
KSKAMTGVEQW	KAMTGVEQW
YTYKKQVKI	YTYKKQVKI
HSVEVHKW	HSVE-VHKW
KTLNAHEHF	KTLNAHEHF
RTSIETNVRF	RTSITNVRF
KADENHPQF	KADENHPQF
QVLKTQTKF	QVLKTQTKF
RVAQLEQVYI	RVAQEQVYI
KSQEVYENF	KSQEVYENF
KTFEEKQGTEI	KTFEEKQGT
RSIEEVYYLW	RSIEVYYLW
KALNVEKVINF	KALNVEKVI
STLRTLPTL	STLRTLPTL
RTLALQQQL	RTLALQQQL
ISQPASGNTF	ISQPSGNTF
LTKQEFQTLF	LTKQFQTLF
RASITPGTILI	ASITPGTIL
KSHLLVTGF	KSHLLVTGF
RSIDLTVKL	RSIDLTVKL
KSWPEGHFATI	KSWPHFATI
KSFETDTNLNF	KSFETDTNL
RSLAAFLQQL	RSLAFLQQL
RAHQIFEEF	RAHQIFEEF
QTLPNGVTQKI	QTLPNGVTQ
GSASVNSRW	GSASVNSRW
RSSNMTATTKF	SSNMATTKF
LSFKDVAVVF	LSFKVAVVF
KTLYHITLW	KTLYHITLW
KTAPDQFIGIF	KTAPQFIGI
KSFEGNVFMYY	KSFE-GNVF
RTFQDEPLI	RTFQDEPLI
KSMTLKEAI	KSMTLKEAI
KVASALEKW	KVASALEKW
ATARNLSNLTL	ATARNLSNL
TSHSVGTVF	TSHSVGTVF
KTYPVNTPERW	KTYPTPERW
ITFAPTYRF	ITFAPTYRF
RSFVEKHRW	RSFVEKHRW
SVAALRFEW	SVAALRFEW
NSRKQEAEW	NSRKQEAEW
VSWDTKLIQW	VSWDKLIQW
KAFDYPSLF	KAFDYPSLF
RSSRSHSVFQL	RSSRSHSVF
QTNQRMQETF	QTNQMQETF
TSSSSVRVEW	SSSSVRVEW
RTSDDVAKEF	RTSDVAKEF
ASLPEAQVW	ASLPEAQVW
HSLAITNNF	HSLAITNNF
GALRVLNSYW	GALRLNSYW
VTYVPVTTF	VTYVPVTTF
RTINVYPNF	RTINVYPNF
KAPSAARSL	KAPSAARSL
LSGPFVQKW	LSGPFVQKW
RTDVGITHQHW	RTDVTHQHW
RTPSVTAQF	RTPSVTAQF
QSLMQAPLL	QSLMQAPLL
ATYAAAVLF	ATYAAAVLF
KTIQKAALL	KTIQKAALL
RVGPIEATSF	RVGPEATSF
KALELDSNLY	KALELDSNL
RTMELLTQNW	RTMELTQNW
KAWTKQNTL	KAWTKQNTL
LTPVVVTLW	LTPVVVTLW
KSVRLDVTL	KSVRLDVTL
RSIPVNEKDTL	RSIPVNEKD
SSSSVLHGMVF	SSVLHGMVF
KTIEESEETL	KTIESEETL
KAIETQPNF	KAIETQPNF
RSLIHHIRL	RSLIHHIRL
RSVLHHFHF	RSVLHHFHF
SSFGNFDRF	SSFGNFDRF
RTRLEQVHEW	RTRLQVHEW
RTVQPHFLEF	RTVQHFLEF
ISLADIAQKL	ISLAIAQKL
RTYKQRLLF	RTYKQRLLF
KSVKIKTKL	KSVKIKTKL
SIPGGYNAL	SIPGGYNAL
KTSVLVVQF	KTSVLVVQF
YTNRVVTLW	YTNRVVTLW
RSVQVIGGIW	RSVQIGGIW
RSWAGIINL	RSWAGIINL
QALQTNWHL	QALQTNWHL
YTSRIVVRL	YTSRIVVRL
KTLGKLWRL	KTLGKLWRL
VSRPENEQL	VSRPENEQL
KVAEAAIQIF	KVAEAIQIF
LSPRDITTI	LSPRDITTI
HSYFWPLEW	HSYFWPLEW
HAGNINFKW	HAGNINFKW
ISFHFTPVL	ISFHFTPVL
RSMSLVLDEF	RSMSVLDEF
HSNPSAYRM	HSNPSAYRM
KAYSEAHEI	KAYSEAHEI
RSLPENIQF	RSLPENIQF
KTFEEIWKF	KTFEEIWKF
RTSVKISYIGL	RTSVKISYI
KTYDYLFKL	KTYDYLFKL
GTMPLRNIF	GTMPLRNIF
KALSDHHIYL	KALSHHIYL
TTIDPRWLVEF	IDPRWLVEF
VSFIPLNI	VSFI-PLNI
KTVAIHTLW	KTVAIHTLW
YTNKVITLW	YTNKVITLW
KTNPKIQSIYL	KTNPKIQSI
STYVIRDEW	STYVIRDEW
RTATQLAVNKI	RTATLAVNK
RAVLDVANHF	RAVLVANHF
ISGHHPETW	ISGHHPETW
KSFSHWSKL	KSFSHWSKL
HSGPGLLQLW	HSGPLLQLW
EDAANNYAR	EDAANNYAR
LTLKPVKF	LTLK-PVKF
LSAQDHQTFF	LSAQDHQTF
KSITEINANF	KSITINANF
KVSSINSRF	KVSSINSRF
IAHLFNVEW	IAHLFNVEW
GSWDKTLKF	GSWDKTLKF
KSKPDKQLI	KSKPDKQLI
RTNPNSGDFRF	RTNPNSGDF
ITDKAREF	ITDK-AREF
RTLPTNTLMGF	RTLPTNTLM
KTLNVESNFI	KTLNVESNF
YAPKGSSL	YAPK-GSSL
GTAAVFNAVNW	AAVFNAVNW
ATMPHQLQDTF	ATMPLQDTF
VTKSVDFHF	VTKSVDFHF
ISQSAVKTKF	ISQSVKTKF
ISAGYAPVL	ISAGYAPVL
LSNTVMPRF	LSNTVMPRF
RALLVNVKF	RALLVNVKF
TTKTDDPQL	TTKTDDPQL
RSLKDHKVSF	RSLKHKVSF
ITFPNKEIAW	ITFPKEIAW
KAAEVYTRL	KAAEVYTRL
ASVKVVSKF	ASVKVVSKF
ISAIPANIHI	SAIPANIHI
RTYPVQEYF	RTYPVQEYF
TNHIHVRI	TNHI-HVRI
RSLRDTAVRL	RSLRTAVRL
KSVKTGSVFW	KSVKTGSVF
KSLVSKGTL	KSLVSKGTL
KLDENSAFLQF	KLDENSAFL
TTARVTTAF	TTARVTTAF
FSLPLKPVI	FSLPLKPVI
QSAIVLGDLKL	SAIVGDLKL
KSVDDHIVRF	KSVDHIVRF
GTHSLDIKW	GTHSLDIKW
KTLAEINQKW	KTLAINQKW
SAQGSESHSL	SAQGESHSL
KVDPAKDRELW	KVDPKDREL
GTGKLFWVF	GTGKLFWVF
ATYVFLHTV	ATYVFLHTV
VAGPLGVTHF	VAGPGVTHF
SISAVQWL	SISA-VQWL
ISNPKTAEF	ISNPKTAEF
STLRVLYNLF	STLRLYNLF
ATLAAVLQRI	ATLAVLQRI
LSDETKNNW	LSDETKNNW
RVFWDPSVNLF	RVFWPSVNL
RVFDLPLTW	RVFDLPLTW
KTVDKFNEW	KTVDKFNEW
HTSDEQNHLVI	HTSDEQNHL
YAPSGNYV	YAPS-GNYV
LTIPDGGVHI	LTIPGGVHI
KSPPASPESW	KSPPSPESW
VASKEIGKRKL	ASKEGKRKL
GSYAVQAKF	GSYAVQAKF
KTKGFHTTI	KTKGFHTTI
LTDRLQLTL	LTDRLQLTL
KTVALGHRL	KTVALGHRL
RSLPIVFDEF	RSLPVFDEF
VTNPHTDAW	VTNPHTDAW
KAIPRPDGIEW	KAIPRPDGI
SADKTVALW	SADKTVALW
KTIEDVREFL	KTIEVREFL
RILPQDVILKF	RILPQDVIL
RTFLLQGLL	RTFLLQGLL
SSPTSPNAL	SSPTSPNAL
SLVNLGGSK	SLVNLGGSK
KSWQGVTIYF	KSWQVTIYF
GYSFTTTAER	YSFTTTAER
ITYTFHSTW	ITYTFHSTW
VSPKTLLTF	VSPKTLLTF
KSIRNDIEW	KSIRNDIEW
YSKYYKTIDD	KTID-----
VSFPDVEKAEW	VSFPEKAEW
RSMGDYAQTL	RSMGYAQTL
ASSQLKEHF	ASSQLKEHF
RSFDQADRAKF	RSFDDRAKF
KVLDLNPGF	KVLDLNPGF
ISKEEAMRW	ISKEEAMRW
KVLKNNIRF	KVLKNNIRF
VTLKTLQQQTF	KTLQ-QQTF
LSAFLPARF	LSAFLPARF
RSMSVERDIRF	MSVERDIRF
FSLPAQPLW	FSLPAQPLW
KAGPIWDLRL	KAGPWDLRL
KVVGKDYLL	KVVGKDYLL
VTRPEPQAL	VTRPEPQAL
KSFDFHFGF	KSFDFHFGF
ASVEQFWRF	ASVEQFWRF
ASYRQVASF	ASYRQVASF
KTFEGHDASVL	KTFEHDASV
KSIHLSINFF	KSIHLSINF
KSKLIALFW	KSKLIALFW
RTVEDFNKF	RTVEDFNKF
KSHTVVIGF	KSHTVVIGF
KTLERIKAI	KTLERIKAI
KVLPTNHRVTW	KVLPTNHRV
KVSKMEQKF	KVSKMEQKF
MAHQIQEMF	MAHQIQEMF
ATNPESKVF	ATNPESKVF
RTKEEVNEW	RTKEEVNEW
KIIPKTLTW	KIIPKTLTW
KAVDIVKQVW	KAVDVKQVW
GTLETKYKW	GTLETKYKW
RSTQQTTEW	RSTQQTTEW
RTNAIKQTF	RTNAIKQTF
AAALPAAALW	AALPAAALW
RTIEDFNKF	RTIEDFNKF
KSADWVSDW	KSADWVSDW
SAARLYYYW	SAARLYYYW
KSSIQKVVF	KSSIQKVVF
ASLPSELIVHI	ASLPLIVHI
ATKKEITFF	ATKKEITFF
RLFPSAAQVTF	RLFPAQVTF
VSFKDVAVDF	VSFKVAVDF
KTPEEAALF	KTPEEAALF
KTLSDIFLLF	KTLSIFLLF
YSQKAQNSW	YSQKAQNSW
RTAKALQAHW	RTAKLQAHW
AVFVQGPAWQF	AVFVQGPAW
HTLVTSGVYAW	LVTSGVYAW
KSALVFITF	KSALVFITF
HTAVVEDVSW	HTAVEDVSW
HAFDGFEVNW	HAFDFEVNW
RSWDQQIKL	RSWDQQIKL
FSFKKPFKL	FSFKKPFKL
MTVSIIDRF	MTVSIIDRF
LSKPVPESEF	LSKPPESEF
KILPFSPEF	KILPFSPEF
HSAVVEDVAW	HSAVEDVAW
MAAKILEEF	MAAKILEEF
KTFKPIDL	KTFK-PIDL
SSSSVRVEW	SSSSVRVEW
KSFPDTGSLNL	KSFPDTGSL
KTLPDILTF	KTLPDILTF
RSARDTAQIF	RSARTAQIF
TSFKHFIFF	TSFKHFIFF
ATLPDNIKF	ATLPDNIKF
KTLDQIRTI	KTLDQIRTI
GTYIGGVTF	GTYIGGVTF
STSGIHAITVF	TSGIAITVF
KSREEDPTL	KSREEDPTL
VTDNAVYHW	VTDNAVYHW
ITRTQEEKL	ITRTQEEKL
KSLGPMILI	KSLGPMILI
ASAIIIQRW	ASAIIIQRW
HALALAWTF	HALALAWTF
VSKRIEPSV	VSKRIEPSV
KSSTVLHTF	KSSTVLHTF
RSSPVEYEF	RSSPVEYEF
KTIEGIYEKF	KTIEIYEKF
RSQDHFHVF	RSQDHFHVF
KSLRFIDVEF	KSLRIDVEF
RAGPFDEFQI	RAGPDEFQI
NARMPEKVTW	ARMPEKVTW
RTAKLQVTL	RTAKLQVTL
RTFEDFVRI	RTFEDFVRI
VTLPEAIHF	VTLPEAIHF
RTLVPNFTF	RTLVPNFTF
KVARLDNIFL	KVARLDNIF
RSMGLPLQF	RSMGLPLQF
QTLSLKQLF	QTLSLKQLF
HSGPVVAMVW	HSGPVAMVW
RSFPTLPTL	RSFPTLPTL
ITWTPPAIF	ITWTPPAIF
MSFPVGDVNNF	MSFPDVNNF
GTISREHPW	GTISREHPW
KAYGPKVDIW	KAYGKVDIW
VGLPAAGKTTW	LPAAGKTTW
KTFEEAAAQLL	KTFEAAAQL
RTLPVLLLY	RTLPVLLLY
KVSEQVKNVKL	VSEQKNVKL
SVNGSKSYEI	SVNGKSYEI
ITVKDGKTL	ITVKDGKTL
KVINAAHSF	KVINAAHSF
KTLPADVQNY	KTLPDVQNY
KSRPEVITF	KSRPEVITF
RTWDYVAPFL	RTWDVAPFL
YSLPNAPTL	YSLPNAPTL
KTFGGFASSSF	KTFGASSSF
VSAKSGAVTF	VSAKGAVTF
KVVDVVRNLVF	KVVDVVRNL
ASIRLPSQYNF	ASIRLPSQY
KSFPSIFKF	KSFPSIFKF
RSQPPVRAF	RSQPPVRAF
TTLVDNNTW	TTLVDNNTW
KTLKEIRNAF	KTLKIRNAF
KSKLDAEVSKW	KSKLEVSKW
RSLPSLKKTL	RSLPLKKTL
KSLAKLPEF	KSLAKLPEF
NTLKEVNMRW	NTLKVNMRW
HSNGTVSLW	HSNGTVSLW
KAGIIQDTW	KAGIIQDTW
KSFVKVYNY	KSFVKVYNY
GSNPHLQTF	GSNPHLQTF
YTNKYSSQF	YTNKYSSQF
ATIRFHDLL	ATIRFHDLL
KTIIIKDHL	KTIIIKDHL
KTGKFLKRF	KTGKFLKRF
RTLLGDPKF	RTLLGDPKF
KTYPPFVNF	KTYPPFVNF
ISFHNIHNTF	ISFHIHNTF
KTAVIDHHNY	KTAVDHHNY
RSHKIQTQL	RSHKIQTQL
KTYTDRVFF	KTYTDRVFF
ASRIIRNEQF	ASRIRNEQF
VSAPTQILAQF	SAPTILAQF
HSSVVNYEF	HSSVVNYEF
KSWADVVKL	KSWADVVKL
KSKVEDPEI	KSKVEDPEI
ISWGPSPTF	ISWGPSPTF
LSLPEDFYHF	LSLPDFYHF
QVHPDTGISSK	QVHPTGISS
KAAVLLHLL	KAAVLLHLL
LSLKNIPVL	LSLKNIPVL
KAIEKNVLF	KAIEKNVLF
RSLDQQMYL	RSLDQQMYL
LTRTELETL	LTRTELETL
RTFPVLLRL	RTFPVLLRL
GAVRENYTW	GAVRENYTW
SAANIQPIF	SAANIQPIF
KTRDEYLSL	KTRDEYLSL
KSKGNYDEGF	KSKGYDEGF
KSFSQSSTLF	KSFSQSSTL
KTIKAFKNRF	KTIKFKNRF
RTLETLIRL	RTLETLIRL
RSKQTKELW	RSKQTKELW
VTAEAVRSVW	VTAEVRSVW
KALEYVFKF	KALEYVFKF
KSIEDFAHSSF	KSIEAHSSF
LSSTEILKW	LSSTEILKW
VTYKNVPNW	VTYKNVPNW
ISISVDGLKF	ISISDGLKF
RSYQDPSNAQF	RSYQSNAQF
KASLSLIEKYF	ASLSLIEKY
VVDPVHGFMYW	VVDP-VHGF
SSLPDVEALRF	SSLPDVEAL
RGWDGFVEF	RGWDGFVEF
QAALALSRVEL	AALASRVEL
KSLENAIEW	KSLENAIEW
KVLIDIREYW	KVLIIREYW
STLKDTRLLTF	STLKDTRLL
ISERYGPVFTI	ISERYGPVF
KSSIAGSSTW	KSSIGSSTW
KTMLDDDKRQL	KTMLDKRQL
KTMTDTYLLNL	KTMTDTYLL
RSVVLNDVFL	RSVVLNDVF
RSIKAQLQNF	RSIKQLQNF
RALPQGSIKF	RALPGSIKF
ASAVLSWKL	ASAVLSWKL
GVHTVHVTF	GVHTVHVTF
ISLLAQNTSW	ISLLQNTSW
KALPELIYY	KALPELIYY
RVVDFDETW	RVVDFDETW
RIYNFAHRF	RIYNFAHRF
LKERDFEIK	LKERDFEIK
KTKIDIIRM	KTKIDIIRM
KSFVLPSW	KSFV-LPSW
RSIVNQVRF	RSIVNQVRF
LQQAKEDL	LQQA-KEDL
RSLTHPPTI	RSLTHPPTI
RVKEKEAIL	RVKEKEAIL
YSPKIEVHF	YSPKIEVHF
ENAGEDPGLAR	NAGEPGLAR
FTLREVQERW	FTLRVQERW
HTNQDHVHAVW	HTNQHVHAV
KSGAIIEKW	KSGAIIEKW
KSLKDPSNNF	KSLKPSNNF
ATNALLNSLEF	ATNALLNSL
QSDPSGAYFAW	QSDPSGAYF
VSSITASLRF	SSITASLRF
KAMKQGFEF	KAMKQGFEF
KTFEQVKAIFL	KTFEVKAIF
RVSDLVKDLIF	RVSDVKDLI
KSAEKEISLW	KSAEKEISL
HTADISSHF	HTADISSHF
RSLAHQHVVGF	LAHQHVVGF
RVAVILNEF	RVAVILNEF
KTFRDKNTL	KTFRDKNTL
KTTILYKL	KTTI-LYKL
KSRDYEREI	KSRDYEREI
ISPRSDATF	ISPRSDATF
FTVPVRPFF	FTVPVRPFF
RTMPRIPTL	RTMPRIPTL
KTHPGDPRF	KTHPGDPRF
RTSVTDVKF	RTSVTDVKF
VSKRIAQETF	VSKRAQETF
ASNPRVTRF	ASNPRVTRF
ISATEVDSRW	ISATVDSRW
KTLGANAQTL	KTLGNAQTL
KAIEENNNF	KAIEENNNF
ITNKYQLVF	ITNKYQLVF
RAFQAHKEENW	RAFQKEENW
KVLKIHINF	KVLKIHINF
VSLPSHLNISY	VSLPSHLNI
SAASPHYQEW	AASPHYQEW
VSFEEDDKIRW	VSFEEDDKI
KALQDVQIRF	KALQVQIRF
HIAKLQELW	HIAKLQELW
LSAFLSHQF	LSAFLSHQF
TSWYSPDAKF	TSWYPDAKF
MTVKEQQEW	MTVKEQQEW
ASNGDVYAW	ASNGDVYAW
ISKPDVITL	ISKPDVITL
LVFVGKGITF	LVFVKGITF
ETLKLISGW	ETLKLISGW
RTIVLQESI	RTIVLQESI
STALPLTQLRW	TALPTQLRW
SVTEIQEKW	SVTEIQEKW
IGWDKHYGF	IGWDKHYGF
KVQPRNWLL	KVQPRNWLL
RVYPQAVYF	RVYPQAVYF
KLIEFMDTF	KLIEFMDTF
KSVAVKTTRF	KSVAKTTRF
RVLEAANLFQF	RVLEAANLF
RTSTSQAVFRL	RTSTSQAVF
YTLRILRQL	YTLRILRQL
RTIDDRIVHEL	RTIDIVHEL
FSLKGVDFQKF	FSLKDFQKF
LTWPEGKVLW	LTWPGKVLW
RSQIHLHKY	RSQIHLHKY
VTQPNTKYTF	VTQPTKYTF
ATLKIRNSNF	ATLKRNSNF
GTLVSKITF	GTLVSKITF
VTIKKALTL	VTIKKALTL
RTVDARLKL	RTVDARLKL
KSFEKLMKI	KSFEKLMKI
RNVSTGDVNVE	VSTGDVNVE
VSADLNNKF	VSADLNNKF
QSAKTQIKL	QSAKTQIKL
RSTPFRYLL	RSTPFRYLL
EEFAKLIQTI	EFAKLIQTI
KTLPFYKDYF	KTLPYKDYF
KVVTIIPKI	KVVTIIPKI
AALPDQSFLW	AALPQSFLW
RSFKETTNRW	RSFKTTNRW
ASHKGQKLW	ASHKGQKLW
RSLKADLQKL	RSLKDLQKL
KTYDLLFKL	KTYDLLFKL
ISMPDFDLHL	ISMPFDLHL
KTQDYVVGF	KTQDYVVGF
KTFARYLSF	KTFARYLSF
RSPPIKPLL	RSPPIKPLL
RSLQLHLVF	RSLQLHLVF
KTLSTFKESW	KTLSFKESW
KSSEPVVTM	KSSEPVVTM
TTSAVIHSENF	TSAVHSENF
KTLERSYLL	KTLERSYLL
RTLDFDPLL	RTLDFDPLL
RSLGYAYVNF	RSLGAYVNF
KSLPEFPDSGF	KSLPPDSGF
YTHQVVTRW	YTHQVVTRW
FNEKSKEL	FNEK-SKEL
VIWPNPVIW	VIWPNPVIW
RTLPTKEFLW	RTLPTKEFL
STFRLLTVF	STFRLLTVF
RAAVIKHRF	RAAVIKHRF
ATWKSNYFL	ATWKSNYFL
KSLDHQGINF	KSLDQGINF
HTLEIEDTF	HTLEIEDTF
RTLDNQLFFF	RTLDNQLFF
VSKPDLITF	VSKPDLITF
RSTELDSNW	RSTELDSNW
STIKKTFNF	STIKKTFNF
HSFQISLHF	HSFQISLHF
KSVENLGVSY	KSVELGVSY
ATIRLLDVL	ATIRLLDVL
VTIKKDVDGAY	VTIKKDVDG
RAKTDSAEKW	RAKTSAEKW
ATIKEIVVW	ATIKEIVVW
RSAAYAARW	RSAAYAARW
KSSGQMAQKF	KSSGMAQKF
KSFIPKDNQNF	KSFIDNQNF
NNRSLDLD	NNRS-LDLD
VSYPGKNKI	VSYPGKNKI
GPASSLPQS	GPASSLPQS
ATLGNFAKATF	ATLGAKATF
TFRDKNTLK	TFRDKNTLK
KSFSTVTNTF	KSFSVTNTF
HSGPFESKF	HSGPFESKF
RAALWIGTTSF	AALWGTTSF
RAINIALQL	RAINIALQL
AKNKLNDLED	KNKLNDLED
RSFTNQIIL	RSFTNQIIL
RAIDSIHQLW	RAIDIHQLW
TISAARLYYYW	SAARLYYYW
KASELHSVRKL	KASELHSVR
FSHRIYVAY	FSHRIYVAY
KVAELFEKL	KVAELFEKL
RASLVTSVVW	ASLVTSVVW
KSLEVSDTRF	KSLESDTRF
QSSSEISDHSF	SSSESDHSF
FSYRDVNSW	FSYRDVNSW
KTPSSDVLVF	KTPSDVLVF
KTFPYQHRY	KTFPYQHRY
KTLESSIQGL	KTLESIQGL
MTNPHNHLY	MTNPHNHLY
LAAKLIHTL	LAAKLIHTL
RAIELQPHF	RAIELQPHF
KSLIIVHPSW	KSLIVHPSW
KVQDITMQW	KVQDITMQW
GALPNLRELW	GALPLRELW
RSHYSPIYL	RSHYSPIYL
SSLNVVTTF	SSLNVVTTF
RSVVLNDVF	RSVVLNDVF
KSPASDTYIVF	KSPASDTYI
KTGTTIAGLVF	KTGTTIAGL
ITTDVLYTI	ITTDVLYTI
KTLEHVAVTV	KTLEVAVTV
LESRIRDVHEL	RIRD-VHEL
KTRSKDIFDQL	RSKDIFDQL
VSYISKEHF	VSYISKEHF
KLVINGKTL	KLVINGKTL
KTLETQSAL	KTLETQSAL
KSQHASETF	KSQHASETF
KSYKDPATL	KSYKDPATL
ISKQFHHQL	ISKQFHHQL
VTLHDQGTAQW	VTLHGTAQW
SVAQDAPR	SVAQ-DAPR
KTVTAMDVVY	KTVTMDVVY
RVAVVSSRF	RVAVVSSRF
KTLEHRGFKL	KTLERGFKL
HSFPLQFTL	HSFPLQFTL
GSIPVTLTF	GSIPVTLTF
KTIDGQQTI	KTIDGQQTI
TSRKALETL	TSRKALETL
ITYDDPIKTSW	ITYDIKTSW
GTYENLIHVW	GTYELIHVW
RTNHQGTYVL	RTNHGTYVL
KVLEEHGEWW	KVLEEHGEW
KSTTTGHLI	KSTTTGHLI
STLREQVSL	STLREQVSL
QARIEIESF	QARIEIESF
GTHTVSVKY	GTHTVSVKY
KSIDDTSNF	KSIDDTSNF
QSVHFQTIF	QSVHFQTIF
LSAEAIRQRL	LSAEIRQRL
KTVTELGNQL	KTVTLGNQL
QTFITLEKF	QTFITLEKF
HSRSEPQYF	HSRSEPQYF
KSVSAAEQQLW	VSAAEQQLW
RASGLTQKW	RASGLTQKW
RTVSLVHESF	RTVSVHESF
KSVDWLLVF	KSVDWLLVF
KAKSEEFRF	KAKSEEFRF
KAWENSPSL	KAWENSPSL
RSSRSHAVLLV	RSSRHAVLL
LSYNFSPEVEF	YNFSPEVEF
RALKLLTTL	RALKLLTTL
ISLLNEPNTF	ISLLEPNTF
QALQDSRNYGW	QALQDSRNY
KSHDVQEVL	KSHDVQEVL
RTMQPLAVL	RTMQPLAVL
RSLSLHNNL	RSLSLHNNL
KTLNVESNF	KTLNVESNF
KTIHKYVHL	KTIHKYVHL
LSDSPGPTW	LSDSPGPTW
RVADLTEQY	RVADLTEQY
ITNHIHVRI	ITNHIHVRI
RAATLIQSF	RAATLIQSF
GSVLLDKRF	GSVLLDKRF
KTQQASKHIRF	KTQQASKHI
SSRPEEPFL	SSRPEEPFL
LGTQLLYKF	LGTQLLYKF
MAPERVASL	MAPERVASL
RVHPETYEW	RVHPETYEW
TSSRPEEPFL	SSRPEEPFL
AGEEAFEK	AGEE-AFEK
KSYEDATKI	KSYEDATKI
KSHDDIVTEF	KSHDIVTEF
TSYLGKEHW	TSYLGKEHW
LSDRGQLFSW	LSDRQLFSW
ITTVVLPTL	ITTVVLPTL
STIRLLTSL	STIRLLTSL
ISFPEKELLLL	ISFPEKELL
KAIGLFISF	KAIGLFISF
KTLHETVNF	KTLHETVNF
SSHHFVETF	SSHHFVETF
KTYKDEGNDYF	KTYKEGNDY
RTPFPLAFW	RTPFPLAFW
ISLRQPPMAF	ISLRPPMAF
ATADISDVW	ATADISDVW
KSFLPVVSTF	KSFLVVSTF
RVFPHEVNW	RVFPHEVNW
LTIDHVPIW	LTIDHVPIW
VSKPDLITW	VSKPDLITW
KSVTAFFKW	KSVTAFFKW
RSLPEHPAF	RSLPEHPAF
QSLPEFGITHF	QSLPGITHF
TTVKNKDIRKF	TTVKKDIRK
RSSGRVYYF	RSSGRVYYF
ISKQDAQELF	ISKQAQELF
KVIEINPYL	KVIEINPYL
YTLLLHTW	YTLL-LHTW
KVAELENSEF	KVAEENSEF
KAWFQTPYTTF	KAWFPYTTF
LTKQEFQTL	LTKQEFQTL
ISHQVDPEF	ISHQVDPEF
QSLELVHRF	QSLELVHRF
HAIQYVVEF	HAIQYVVEF
KVLDILQHI	KVLDILQHI
KVLPPLEQVW	KVLPLEQVW
ASYQDRRQSW	ASYQRRQSW
KTFSGKSNL	KTFSGKSNL
KASGQLKSLRF	ASGQKSLRF
RASTLLSKVFL	STLLSKVFL
KSTMLYNKF	KSTMLYNKF
ITLQEQVKL	ITLQEQVKL
KTVVGGAMF	KTVVGGAMF
LSQPILLEL	LSQPILLEL
MTTRELQQYW	TTRELQQYW
KTFKDVGNLL	KTFKVGNLL
KVLPPNHRVVW	KVLPPNHRV
KSWVFGVHF	KSWVFGVHF
KAVEAAHTFF	KAVEAAHTF
ITLRQTITTF	ITLRTITTF
LTIVDTGIGM	LTIVTGIGM
KTNDQMVVVYL	KTNDMVVVY
RTLNISGNEI	RTLNSGNEI
ITLIVDGHHF	ITLIDGHHF
HTSREVLIIF	HTSRVLIIF
TSLGYEVQKF	TSLGEVQKF
HTLTTKIKF	HTLTTKIKF
KAHGVKNLVF	KAHGKNLVF
VTATDIRVTL	VTATIRVTL
RAYPFHWAW	RAYPFHWAW
ITKKQVSVW	ITKKQVSVW
RVLPPSHRVTW	RVLPPSHRV
KALEDARINL	KALEARINL
IAPPKPASW	IAPPKPASW
RAATVLATVLL	RAATLATVL
ATKNAEPLI	ATKNAEPLI
LTKKSEEVF	LTKKSEEVF
FSLRPIDSNTF	SLRPDSNTF
KLYPWIHQF	KLYPWIHQF
KTFFLGDGQKL	KTFFDGQKL
KTKSTETEHSF	KSTETEHSF
ITKRKEVIF	ITKRKEVIF
KSYYHVYKL	KSYYHVYKL
ISRGEMDSF	ISRGEMDSF
STAKEIIQHF	STAKIIQHF
KTFEDRMDLF	KTFERMDLF
ISKPGQFETF	ISKPQFETF
RTYEHEAMW	RTYEHEAMW
ASRDTVIVW	ASRDTVIVW
NTLKNTIVF	NTLKNTIVF
KVAELKQEL	KVAELKQEL
KTKETSVNW	KTKETSVNW
ATLSVVPQL	ATLSVVPQL
RSLPSSSQL	RSLPSSSQL
RTFEEITFL	RTFEEITFL
VTLKNKYLDW	VTLKKYLDW
HSLESQVTF	HSLESQVTF
KGWKEGTKITF	KGWKEGTKI
KTGPFVVHW	KTGPFVVHW
QVAPLTHVF	QVAPLTHVF
KSKINVNEIF	KSKIVNEIF
QAAELRAYL	QAAELRAYL
LSLGVAALYKF	LSLGVAALY
QSLKKQNVF	QSLKKQNVF
HTFLPKIFF	HTFLPKIFF
KTLEEKLRSLF	KTLEKLRSL
LTWKKIIKF	LTWKKIIKF
RTVEKTWKL	RTVEKTWKL
LSQKPISSF	LSQKPISSF
GSFKNPSSF	GSFKNPSSF
VTFLLPAGW	VTFLLPAGW
KAWAEYVVEW	KAWAYVVEW
RSSPLKLEF	RSSPLKLEF
RAFHPDLEF	RAFHPDLEF
LTVGLSNLF	LTVGLSNLF
KSLENQTYF	KSLENQTYF
KSLKQNINL	KSLKQNINL
VTFEDVAVHF	VTFEVAVHF
KAISGVHTVRF	ISGVHTVRF
KSGPFGKKY	KSGPFGKKY
KAISKNVLF	KAISKNVLF
RTNPNNGEFRF	RTNPNNGEF
RVFSLSSEF	RVFSLSSEF
ITSSIHSKETF	SSIHSKETF
RSIGALNKINF	RSIGALNKI
KSFQKIQVRL	KSFQIQVRL
RSFRPLLF	RSFR-PLLF
RTLGTPDEVVW	RTLGTPDEV
RSTQITVRF	RSTQITVRF
VTIFVEGQRF	VTIFEGQRF
ITQKALQSQSW	KALQ-SQSW
LTKAKEALI	LTKAKEALI
ISYPQEVIPTF	ISYPVIPTF
VTAHLAAKW	VTAHLAAKW
KSFEKAKESW	KSFEAKESW
VSLKVGETI	VSLKVGETI
STARSIAVLEL	STARSIAVL
HSYPGASGW	HSYPGASGW
KVDIIISEW	KVDIIISEW
VTFKDVAVTF	VTFKVAVTF
ASLPQAATF	ASLPQAATF
ATYIFLQTF	ATYIFLQTF
KGWDGYDVQW	KGWDYDVQW
RSLPRPHDF	RSLPRPHDF
KALEGIISNF	KALEIISNF
RTVALTALL	RTVALTALL
GGLPERSVSL	GGLPRSVSL
RSASSTSSLF	RSASTSSLF
KTVVNKDVF	KTVVNKDVF
ISAPDSQVRF	ISAPSQVRF
KTFTFDTVF	KTFTFDTVF
SALPADTQAW	SALPDTQAW
ATKIEKELF	ATKIEKELF
KTYDKTVAL	KTYDKTVAL
KTKRDINRF	KTKRDINRF
KSLLKIFAW	KSLLKIFAW
KTGPKPVRF	KTGPKPVRF
RSNNINTLF	RSNNINTLF
QSIPYQDLPHL	IPYQDLPHL
KTEALTQAF	KTEALTQAF
SSSKEHVKW	SSSKEHVKW
ASFIGGIRW	ASFIGGIRW
LSMIITPAF	LSMIITPAF
KTFIVGDQISF	KTFIVGDQI
IARAEVASF	IARAEVASF
RTLDTIQLAF	RTLDIQLAF
KTVAQSQQL	KTVAQSQQL
TITKGPSKL	TITKGPSKL
RTLPELITQF	RTLPLITQF
ITTVIQHVF	ITTVIQHVF
ITVEDSDKQLL	ITVESDKQL
RSPEILVKF	RSPEILVKF
ATAKAVAVTL	ATAKVAVTL
YSLQHKLLL	YSLQHKLLL
RTVKELKEKF	RTVKLKEKF
HSAGNMLFRTW	HSAG-NMLF
LTAKILEAF	LTAKILEAF
RSLPDPNLITF	RSLPDPNLI
KTLPSMLIL	KTLPSMLIL
KTIDYIQFL	KTIDYIQFL
KTPEEIHKTF	KTPEIHKTF
RTYTGLSGLAL	RTYTGLSGL
ISPSIPITF	ISPSIPITF
KTLRQVEVINF	KTLRQVEVI
KTRYIFDLF	KTRYIFDLF
ISLKENRHW	ISLKENRHW
KTAEEVAALI	KTAEVAALI
KTMKMRGQAF	KTMKRGQAF
QSIYPLHDVF	SIYPLHDVF
SSTTVIPTL	SSTTVIPTL
RSINKLIRI	RSINKLIRI
RTWKKFVKF	RTWKKFVKF
PTKQTQTF	PTKQ-TQTF
VTQRLNSQW	VTQRLNSQW
RTATFQQRF	RTATFQQRF
ATLKGNAAW	ATLKGNAAW
KSLPAEINRM	KSLPEINRM
KTLPAKAKI	KTLPAKAKI
KTVAGGAWTY	KTVAGAWTY
KTIQIPEHLM	KTIQIPEHL
HARAAEPLL	HARAAEPLL
SVSEVVGSSTL	VSEVGSSTL
ISISAVQW	ISIS-AVQW
KGAYPIIFTAW	GAYPIFTAW
RSGPFGQIF	RSGPFGQIF
KTSENTAEF	KTSENTAEF
RSGEGFLLVF	RSGEFLLVF
KTNEMLLNF	KTNEMLLNF
SVPEAQSAL	SVPEAQSAL
KTYGEIFEKF	KTYGIFEKF
KSLEKVLVEF	KSLEVLVEF
RTKTKPHLF	RTKTKPHLF
ASPPSPARW	ASPPSPARW
KTLQLEYRF	KTLQLEYRF
KSITIIGGGF	KSITIGGGF
STLRVLYNL	STLRVLYNL
KSVKVKIKL	KSVKVKIKL
RVWQWDEKW	RVWQWDEKW
SAIKENFQF	SAIKENFQF
LSKQETGTEF	LSKQTGTEF
RSHQVSVTL	RSHQVSVTL
KSLGVTTKF	KSLGVTTKF
HSYRGHLWLF	HSYRHLWLF
KTVYTGIDHHW	TVYTIDHHW
SSYPNTFEW	SSYPNTFEW
KTFNEPGSEYF	KTFNPGSEY
GTLVSHVTL	GTLVSHVTL
KSWKKIFNL	KSWKKIFNL
RSSSYLDNLVW	RSSSYLDNL
ISVPIFKQF	ISVPIFKQF
MTNGFHMTW	MTNGFHMTW
KTKEVIQEW	KTKEVIQEW
KTTPDVIFVF	KTTPVIFVF
KTQHLQELF	KTQHLQELF
KSSTAPSRNF	KSSTPSRNF
HSGPSKWNW	HSGPSKWNW
GTLSGHASW	GTLSGHASW
TSADAVRNMEW	TSADAVRNM
KTMTDTYLL	KTMTDTYLL
KSGKFVFSF	KSGKFVFSF
VTNKSVSVW	VTNKSVSVW
LTSKLYSLLF	LTSKLYSLL
KAVIDLNNRW	KAVILNNRW
ATVATQTQF	ATVATQTQF
SAYQHPASF	SAYQHPASF
LSQSHAYQQF	LSQSAYQQF
KTRQIISTI	KTRQIISTI
RAKPEYHKF	RAKPEYHKF
KVGKFYELY	KVGKFYELY
RVVELQQTL	RVVELQQTL
KAASVRPVL	KAASVRPVL
RSILAPLAW	RSILAPLAW
RGTTILAKHAW	TTILAKHAW
KTLEKIRPVF	KTLEIRPVF
YAYDGKDYI	YAYDGKDYI
RSQKAEGQRW	RSQKEGQRW
KTGEHTWSL	KTGEHTWSL
TSLQLQHLF	TSLQLQHLF
KTVIDSQTHY	KTVISQTHY
ISLRPAQSF	ISLRPAQSF
KTGKNKWFF	KTGKNKWFF
KALKGQFNF	KALKGQFNF
RTLDNQLFF	RTLDNQLFF
