Data	Data aligned
AEIAAKDKL	AEIAAKDKL
AEINNIIKI	AEINNIIKI
KEFSGHSSL	KEFSGHSSL
EIEERGVKL	EIEERGVKL
NEIPVEVVL	NEIPVEVVL
TESTARVEL	TESTARVEL
RETTEVDLL	RETTEVDLL
HELDQGQQL	HELDQGQQL
SEDEVKLAL	SEDEVKLAL
SEFVDPSSL	SEFVDPSSL
GESRVPLTL	GESRVPLTL
GETSDIYVL	GETSDIYVL
REVTPDQKL	REVTPDQKL
GEHLKTDLL	GEHLKTDLL
GEEARVTQL	GEEARVTQL
AEANHFIDL	AEANHFIDL
REWTEQETL	REWTEQETL
AEPTIVAQL	AEPTIVAQL
LEAPPEVSL	LEAPPEVSL
KEFDGKSLV	KEFDGKSLV
AEAAVIEAM	AEAAVIEAM
SEQGLIEIL	SEQGLIEIL
SETTERTVL	SETTERTVL
ADFAKVLEL	ADFAKVLEL
TEKEDFIEL	TEKEDFIEL
REDPAPGLL	REDPAPGLL
AEIEEREAL	AEIEEREAL
QESNVQLKL	QESNVQLKL
TEDDKQLLL	TEDDKQLLL
KEFIDNEMI	KEFIDNEMI
REAVSKTAL	REAVSKTAL
AETRVGSAL	AETRVGSAL
KEKEPEEEL	KEKEPEEEL
YEVQSEAKL	YEVQSEAKL
GEISQEEVL	GEISQEEVL
SESPGATEL	SESPGATEL
REFIAPVTL	REFIAPVTL
FEDKSAYAL	FEDKSAYAL
HETPVEVEL	HETPVEVEL
SEAKGLVTL	SEAKGLVTL
SEGLPEPVL	SEGLPEPVL
AEDASKFEL	AEDASKFEL
AELMKVQAL	AELMKVQAL
REIQTAVRL	REIQTAVRL
AESDGSFLL	AESDGSFLL
EEKAAVTSL	EEKAAVTSL
RESYVETEL	RESYVETEL
SEDLNKHVL	SEDLNKHVL
GENLPTIIL	GENLPTIIL
GESEKLVRL	GESEKLVRL
KEEKDFTIL	KEEKDFTIL
REEPEKIIL	REEPEKIIL
TESDTAVRL	TESDTAVRL
SESPVWVKL	SESPVWVKL
VEDVSWHLL	VEDVSWHLL
WEEERQPIL	WEEERQPIL
REMFGYMKL	REMFGYMKL
REEINFVEI	REEINFVEI
LENASDIKL	LENASDIKL
KEAGSIVRL	KEAGSIVRL
GEDPTSVAI	GEDPTSVAI
HESGASIKI	HESGASIKI
REFNEEGAL	REFNEEGAL
LEAAGIGKL	LEAAGIGKL
SEIEDAAFL	SEIEDAAFL
GENVEKQQL	GENVEKQQL
REVDEQHQL	REVDEQHQL
REFEERRSL	REFEERRSL
KENATVAHL	KENATVAHL
SEASFQEAL	SEASFQEAL
IEMNEPVQL	IEMNEPVQL
SEDPSHPSM	SEDPSHPSM
KEFPEKQEL	KEFPEKQEL
AEFPLEPML	AEFPLEPML
AEAGADLVL	AEAGADLVL
REVSEEHNL	REVSEEHNL
KEYENIIAL	KEYENIIAL
FELEKSESL	FELEKSESL
SEAVFKEEL	SEAVFKEEL
GEQSPNVSL	GEQSPNVSL
IEIGDGAEL	IEIGDGAEL
GEYSDPVTL	GEYSDPVTL
AELNKIFAL	AELNKIFAL
KETPDKVEL	KETPDKVEL
VEFPLDPAL	VEFPLDPAL
AEEGGAARL	AEEGGAARL
KEEIGNVQL	KEEIGNVQL
HENEDIYKL	HENEDIYKL
KESTATTFL	KESTATTFL
NPIDSLPGE	NPIDSLPGE
SEAREKAVL	SEAREKAVL
RETGVIEKL	RETGVIEKL
AEAAALEVL	AEAAALEVL
GEPMNFVHL	GEPMNFVHL
SELRDIYDL	SELRDIYDL
IEDKVKALL	IEDKVKALL
KEMRNLIRL	KEMRNLIRL
LEKIADPTL	LEKIADPTL
KEFKGDEIL	KEFKGDEIL
MEDGGVKLL	MEDGGVKLL
LEDFDIHEL	LEDFDIHEL
HEIHDPQHL	HEIHDPQHL
AESPSFLSL	AESPSFLSL
REDSGTFSL	REDSGTFSL
EPNFPEILL	EPNFPEILL
IEYAKPTRL	IEYAKPTRL
REPVQLETL	REPVQLETL
SESKIRVLL	SESKIRVLL
IEYDSPEQL	IEYDSPEQL
RETSSDVAL	RETSSDVAL
AEIDSIHQL	AEIDSIHQL
HEAVKAIVL	HEAVKAIVL
LEVDKDEAL	LEVDKDEAL
QEPLHNEEL	QEPLHNEEL
VEDPYTASL	VEDPYTASL
GEGKPTPAL	GEGKPTPAL
FEDSFSSIL	FEDSFSSIL
QEEQTRVAL	QEEQTRVAL
HEYYQPTAL	HEYYQPTAL
AESPTPQAL	AESPTPQAL
SEVVEASSL	SEVVEASSL
SEAVIWEVL	SEAVIWEVL
SEEVVKAIL	SEEVVKAIL
HEAATKAVL	HEAATKAVL
SETINTELL	SETINTELL
GEEEDGPVL	GEEEDGPVL
REDYIEPAL	REDYIEPAL
KEESVESSL	KEESVESSL
AEAEKKVQL	AEAEKKVQL
AEAEERGEL	AEAEERGEL
AEVDKNIEL	AEVDKNIEL
KEEPVAPEL	KEEPVAPEL
QEHPELAVL	QEHPELAVL
HEILNEVDL	HEILNEVDL
NETDTPAQL	NETDTPAQL
SEHLAAIEI	SEHLAAIEI
AEAVLYEHL	AEAVLYEHL
KEKPGSEVL	KEKPGSEVL
SEILDGNQL	SEILDGNQL
SEPEIEIKL	SEPEIEIKL
IEQEQKLAL	IEQEQKLAL
SEMRFVQDL	SEMRFVQDL
GELSIQPSL	GELSIQPSL
AELVPSEVL	AELVPSEVL
SENKLPAEL	SENKLPAEL
KEISNNDKL	KEISNNDKL
SETLPLLAL	SETLPLLAL
SEDDTVLDL	SEDDTVLDL
RELDIYNNL	RELDIYNNL
REIIQKLML	REIIQKLML
LETVTKDIL	LETVTKDIL
LENKDNIRL	LENKDNIRL
SEVNIPLSL	SEVNIPLSL
KEIESRVVF	KEIESRVVF
TETQEKNPL	TETQEKNPL
VEMRDNPEL	VEMRDNPEL
AEIAEKETL	AEIAEKETL
REDENKSIL	REDENKSIL
FEDESEGLL	FEDESEGLL
LEHIKTHEL	LEHIKTHEL
REEKVKAVL	REEKVKAVL
AEALKAVLL	AEALKAVLL
KEMESIWNL	KEMESIWNL
AEDEGTQRL	AEDEGTQRL
AESISLLEL	AESISLLEL
AEATEEVSL	AEATEEVSL
VEFDEVDSL	VEFDEVDSL
SETSSVSHI	SETSSVSHI
QEKEAIERL	QEKEAIERL
AEFKEAFSL	AEFKEAFSL
KEYLDNVQL	KEYLDNVQL
GEAAKREIL	GEAAKREIL
SETRVLVDI	SETRVLVDI
GELAPSHGL	GELAPSHGL
TEIKKTEVL	TEIKKTEVL
SEARLRDVL	SEARLRDVL
REVIQSDSL	REVIQSDSL
REAEFTKSI	REAEFTKSI
HEEIDLVSL	HEEIDLVSL
GEVNVLDNL	GEVNVLDNL
SESQKAVEL	SESQKAVEL
KETGGVEKL	KETGGVEKL
QEHLQLQNL	QEHLQLQNL
AEALKKLIL	AEALKKLIL
GETQDFHSL	GETQDFHSL
AEAQGSTTL	AEAQGSTTL
AESPERVLL	AESPERVLL
SEGPIVATL	SEGPIVATL
KEIEKDLRL	KEIEKDLRL
GEAEVRTLL	GEAEVRTLL
REPLVRQVL	REPLVRQVL
TESPENVAL	TESPENVAL
NEVFNDVRL	NEVFNDVRL
SEERFHVEL	SEERFHVEL
FEFGGPEVL	FEFGGPEVL
GEMEHSAAL	GEMEHSAAL
EESQIRIEL	EESQIRIEL
TYDDATKTF	TYDDATKTF
VEIHIPITL	VEIHIPITL
TVLVPTRHP	TVLVPTRHP
KEEEKPVML	KEEEKPVML
SEGVVAVLL	SEGVVAVLL
HEAERTEVL	HEAERTEVL
NEIRTLIDL	NEIRTLIDL
KEIFLRELI	KEIFLRELI
SEPPVYANL	SEPPVYANL
REFREEESL	REFREEESL
AEAEIIQLL	AEAEIIQLL
HENSDHIIL	HENSDHIIL
REPESVEQL	REPESVEQL
REDEKPLVL	REDEKPLVL
AEAKKIERL	AEAKKIERL
AEVEPGVHL	AEVEPGVHL
HEEDRKDFL	HEEDRKDFL
TETEPPVAL	TETEPPVAL
MEDGPIVKL	MEDGPIVKL
GEVRLGGSL	GEVRLGGSL
YEASLPHQI	YEASLPHQI
SEVQGMVEL	SEVQGMVEL
YELPDGQVI	YELPDGQVI
HEADVDVLM	HEADVDVLM
HEDLLNITL	HEDLLNITL
KEIISSEML	KEIISSEML
YENMVTEIM	YENMVTEIM
GETPEAAAL	GETPEAAAL
AEKVEIATL	AEKVEIATL
TEAVVDSIL	TEAVVDSIL
GETKAKVLL	GETKAKVLL
SESHVHSLL	SESHVHSLL
AEINDLENL	AEINDLENL
AEIAQLMSL	AEIAQLMSL
AEETGVHII	AEETGVHII
SEEEVKLAL	SEEEVKLAL
AEFIKFTVI	AEFIKFTVI
WESSIVDRL	WESSIVDRL
SEDSHLESL	SEDSHLESL
HEESQTATL	HEESQTATL
IESPLFLKL	IESPLFLKL
SEFYKHIVL	SEFYKHIVL
GETNDFELL	GETNDFELL
KEVMVDDRL	KEVMVDDRL
GEPFASHSL	GEPFASHSL
HEEFSEHAL	HEEFSEHAL
GEAHLKTIL	GEAHLKTIL
RELQGETKL	RELQGETKL
TEIEDSHTL	TEIEDSHTL
TEFLDISQL	TEFLDISQL
EEENSKVEL	EEENSKVEL
FEDEKPALL	FEDEKPALL
GEHLVSVTL	GEHLVSVTL
HEVEKMFTL	HEVEKMFTL
SEIEGIQSL	SEIEGIQSL
REIREENKL	REIREENKL
IEYQGDPEL	IEYQGDPEL
TELTTKSSL	TELTTKSSL
HEAAARIQL	HEAAARIQL
KEDSHPFDL	KEDSHPFDL
FESSPDPEL	FESSPDPEL
TEDRIQHAL	TEDRIQHAL
TEIQQQSAL	TEIQQQSAL
GELITQREL	GELITQREL
KEFAQIIKI	KEFAQIIKI
FEHHGQVRL	FEHHGQVRL
QEGPVGSTL	QEGPVGSTL
KETDLLILF	KETDLLILF
TEVSKVPSL	TEVSKVPSL
GEAEKGAVL	GEAEKGAVL
REAQMAAKL	REAQMAAKL
NEEDSKIEL	NEEDSKIEL
REWTGIDRL	REWTGIDRL
AEAKPELSL	AEAKPELSL
KEKIQPEIL	KEKIQPEIL
KEDENVPFL	KEDENVPFL
SEFGRNYSL	SEFGRNYSL
AEAEAAVGL	AEAEAAVGL
TELPVMVEL	TELPVMVEL
YEDATKITV	YEDATKITV
AEHRTPDVL	AEHRTPDVL
HEEAGIFKL	HEEAGIFKL
LEHQVFTVL	LEHQVFTVL
IEAPVDADL	IEAPVDADL
HELEKKIEL	HELEKKIEL
GELFSSPHL	GELFSSPHL
SEAGSRIVL	SEAGSRIVL
AEEPKARVL	AEEPKARVL
EIISEISKL	EIISEISKL
GEIQAGAKL	GEIQAGAKL
IEHLLPLFL	IEHLLPLFL
KEAFAKVDL	KEAFAKVDL
SEDKKNIIL	SEDKKNIIL
SEERVQVAL	SEERVQVAL
REMENKETL	REMENKETL
SEVIFGHVL	SEVIFGHVL
TENNDHINL	TENNDHINL
TEEKLTPVL	TEEKLTPVL
AEDTPVVQL	AEDTPVVQL
SEVGKTPTL	SEVGKTPTL
LEFGEPVLL	LEFGEPVLL
LEQDFKVTL	LEQDFKVTL
AEPDIIEQL	AEPDIIEQL
AEFTAKIAL	AEFTAKIAL
GEVGATSAL	GEVGATSAL
REYTLMELL	REYTLMELL
FETFNTPAM	FETFNTPAM
AEFKEAFQL	AEFKEAFQL
AEAQFTTAL	AEAQFTTAL
KEMGQMQVL	KEMGQMQVL
IESNHPIVL	IESNHPIVL
GEMREMQQL	GEMREMQQL
HEFSKTEEL	HEFSKTEEL
HEFSSPSHL	HEFSSPSHL
SEEVHQAVL	SEEVHQAVL
TEHPENFNL	TEHPENFNL
KEFDQNVKL	KEFDQNVKL
YESHYALPL	YESHYALPL
YELYEKLEL	YELYEKLEL
QELFLAHIL	QELFLAHIL
LEAPDETTL	LEAPDETTL
RETDLQELF	RETDLQELF
WESSNKALL	WESSNKALL
TEHGVEVVL	TEHGVEVVL
KEKPEEESL	KEKPEEESL
YEPKLIIDL	YEPKLIIDL
GEHTLLVTV	GEHTLLVTV
GEYRAVTEL	GEYRAVTEL
GELDHVVEI	GELDHVVEI
SEDPEPLLL	SEDPEPLLL
VEMDIVEKL	VEMDIVEKL
GELTDLHGL	GELTDLHGL
SEHLTESIL	SEHLTESIL
QEIEDWSKL	QEIEDWSKL
LEYLTAEVL	LEYLTAEVL
KEITGETAL	KEITGETAL
LESEDEVKL	LESEDEVKL
NEISIYDKL	NEISIYDKL
GEGPLDVRL	GEGPLDVRL
REIKSSQGL	REIKSSQGL
RESLPIYKL	RESLPIYKL
RETIIMNQI	RETIIMNQI
AEHADTVQL	AEHADTVQL
GELHGHFML	GELHGHFML
SEMRYGIEI	SEMRYGIEI
KEAEILEVL	KEAEILEVL
SELEKTFNL	SELEKTFNL
KEEEPSVKL	KEEEPSVKL
SEHGINIDL	SEHGINIDL
QEFQPEPSL	QEFQPEPSL
QESNVRLKL	QESNVRLKL
RELDVSYVL	RELDVSYVL
EEVQEFHQL	EEVQEFHQL
AEHYTETAL	AEHYTETAL
WEISQKTVL	WEISQKTVL
HETSLPVQL	HETSLPVQL
WEIEDNQLL	WEIEDNQLL
REDGSIVIV	REDGSIVIV
RETLQQHKL	RETLQQHKL
NEFGEKWEL	NEFGEKWEL
TEKTKPEVL	TEKTKPEVL
AEPEEVEVL	AEPEEVEVL
AEVKERVTL	AEVKERVTL
HETAVSVSL	HETAVSVSL
AEASMISKL	AEASMISKL
HEMALRIVL	HEMALRIVL
RELDQKTWL	RELDQKTWL
KEYVGIVRL	KEYVGIVRL
KEEEHAPEL	KEEEHAPEL
GEEAKPIIL	GEEAKPIIL
FEDGQKIVV	FEDGQKIVV
RDSISKEDL	RDSISKEDL
TELEYIHAL	TELEYIHAL
SEADPAPLL	SEADPAPLL
REIFLFNDL	REIFLFNDL
EEYGGTWEL	EEYGGTWEL
SEHAVEAML	SEHAVEAML
GEEELASKL	GEEELASKL
TEDITRYFL	TEDITRYFL
EELGLVTHL	EELGLVTHL
GEPENTYIL	GEPENTYIL
QENVDYVIL	QENVDYVIL
SEVKEDVVL	SEVKEDVVL
ENITKQVEI	ENITKQVEI
LEVVQTEKL	LEVVQTEKL
KENSAPVKL	KENSAPVKL
SEEDRATVL	SEEDRATVL
QEDSKPITL	QEDSKPITL
HEEQKSVRL	HEEQKSVRL
SLVNLGGSK	SLVNLGGSK
REAEIYQTV	REAEIYQTV
GENRGPILL	GENRGPILL
YETFISDVL	YETFISDVL
PEADKGTVL	PEADKGTVL
YEMEVSQRL	YEMEVSQRL
AEEPAGTSL	AEEPAGTSL
SEVVEIQAL	SEVVEIQAL
AEALERMFL	AEALERMFL
GETGKGTLL	GETGKGTLL
LEYGLPIQV	LEYGLPIQV
NEAKVKETL	NEAKVKETL
KEVATDVRL	KEVATDVRL
GENEDLLKL	GENEDLLKL
LESDFRDVL	LESDFRDVL
GEIINTHTL	GEIINTHTL
QEIEEFQKL	QEIEEFQKL
SEDGQPMVL	SEDGQPMVL
TEAAHPIRL	TEAAHPIRL
VEETSHQAL	VEETSHQAL
GEENGAHTI	GEENGAHTI
AEEKSIPTL	AEEKSIPTL
SEFAKDPSL	SEFAKDPSL
YEDKTALSL	YEDKTALSL
GELIRPTTL	GELIRPTTL
KEVDALLHL	KEVDALLHL
VEERNTISL	VEERNTISL
SEEAVQVLI	SEEAVQVLI
REVLPSTRL	REVLPSTRL
GELEYATKI	GELEYATKI
GETSTDLKL	GETSTDLKL
AEAPSQVRL	AEAPSQVRL
AELPLRLFL	AELPLRLFL
REVVNKDVL	REVVNKDVL
TEEDVKFYL	TEEDVKFYL
FEEGKKISL	FEEGKKISL
LEVPVSDLL	LEVPVSDLL
SEIGQKQKL	SEIGQKQKL
TEDKISLLL	TEDKISLLL
REEWKFDTL	REEWKFDTL
AEVLRTMEL	AEVLRTMEL
SEEPFTTVL	SEEPFTTVL
LERLSELAL	LERLSELAL
GEENQVLEL	GEENQVLEL
LEADVNIKL	LEADVNIKL
SEAEIFTTL	SEAEIFTTL
GEEQNKEAL	GEEQNKEAL
EVDGKQVEL	EVDGKQVEL
REDLTQVEL	REDLTQVEL
HEVKEAQTL	HEVKEAQTL
NEFHSPIGL	NEFHSPIGL
SEEPAGQIL	SEEPAGQIL
AEEVGVEHL	AEEVGVEHL
VEAIESYVL	VEAIESYVL
KEETNIVKL	KEETNIVKL
KEVAELTRL	KEVAELTRL
SELKKVVAL	SELKKVVAL
KEEPDGPAL	KEEPDGPAL
AETAEAVEL	AETAEAVEL
AELAVPIEL	AELAVPIEL
GEEQNRVQL	GEEQNRVQL
NEFPEPIKL	NEFPEPIKL
AEITSGESL	AEITSGESL
HEDDHNFEL	HEDDHNFEL
LERIEETAL	LERIEETAL
REWPESVSL	REWPESVSL
LESLPSPTL	LESLPSPTL
YEDIKNVVL	YEDIKNVVL
LEFGSEPSL	LEFGSEPSL
AELRSTASL	AELRSTASL
GEFSASPML	GEFSASPML
KEDEIKQWL	KEDEIKQWL
HEADKTYML	HEADKTYML
IESPGQDLL	IESPGQDLL
QETDVRAQI	QETDVRAQI
GEKNVFEAL	GEKNVFEAL
GEVLEKSLL	GEVLEKSLL
AEVETGDKL	AEVETGDKL
VEEPTVLVL	VEEPTVLVL
AEQVDAVTL	AEQVDAVTL
SESVASSQL	SESVASSQL
TEITHAVVI	TEITHAVVI
GEEKEAATL	GEEKEAATL
KEVSTGTVL	KEVSTGTVL
AEAEHKIDL	AEAEHKIDL
LEVIEPEVL	LEVIEPEVL
RELQSKEFL	RELQSKEFL
VETAEGVAL	VETAEGVAL
GEAQSKETL	GEAQSKETL
YESPGKIFL	YESPGKIFL
WEYDESHVI	WEYDESHVI
REHDIAIKF	REHDIAIKF
SEWNTVERL	SEWNTVERL
AEARKSPAL	AEARKSPAL
LEIADPIVL	LEIADPIVL
GETLGIIGL	GETLGIIGL
AETHDATAL	AETHDATAL
SESTAESHL	SESTAESHL
SEHSMDTLL	SEHSMDTLL
KESPPHEDL	KESPPHEDL
SETTAAHSL	SETTAAHSL
GEDVRSALL	GEDVRSALL
YELEKLWTL	YELEKLWTL
KESEKQLLL	KESEKQLLL
GEPDHNEAL	GEPDHNEAL
KEAEVQTWL	KEAEVQTWL
NAPWAVTSL	NAPWAVTSL
SEVVTGSGL	SEVVTGSGL
GEMVALPPV	GEMVALPPV
HEDIVAVEL	HEDIVAVEL
GEASFPVMV	GEASFPVMV
GEGTGEVVL	GEGTGEVVL
GEDHPEMAL	GEDHPEMAL
SETEGTPKL	SETEGTPKL
KAPSAARSL	KAPSAARSL
LEVQVRESL	LEVQVRESL
AESRALAQL	AESRALAQL
YEIHDGMNL	YEIHDGMNL
GEIKHVSSL	GEIKHVSSL
TELGDELTL	TELGDELTL
KEIEFGTSL	KEIEFGTSL
AETEKQVAL	AETEKQVAL
AEFKTKYKL	AEFKTKYKL
SEDKQLHEL	SEDKQLHEL
ELQSTGRLL	ELQSTGRLL
SEWDGIVTV	SEWDGIVTV
VEFEDGSQI	VEFEDGSQI
YEEDSKETL	YEEDSKETL
TEETTHVVM	TEETTHVVM
SEYRFPEEL	SEYRFPEEL
LEALVPVTI	LEALVPVTI
QEIKDIYGL	QEIKDIYGL
GEANEEFAL	GEANEEFAL
VEDDIQQLL	VEDDIQQLL
LEENVHEVL	LEENVHEVL
LESPTTPLL	LESPTTPLL
GEVVGKFYL	GEVVGKFYL
GEDKGIKAL	GEDKGIKAL
AEDKPSTDL	AEDKPSTDL
FEVEKQALL	FEVEKQALL
QEESLRTYL	QEESLRTYL
KEIDIYANL	KEIDIYANL
SEDDVKMAL	SEDDVKMAL
AELHPLPQL	AELHPLPQL
YLPDGTASL	YLPDGTASL
AEMLHNVTL	AEMLHNVTL
SEVVGSSTL	SEVVGSSTL
YEETRQEVL	YEETRQEVL
QETEEKILL	QETEEKILL
GEVTDFLRL	GEVTDFLRL
KEVAQAVLL	KEVAQAVLL
VEQPEDYTL	VEQPEDYTL
SELQVHSAL	SELQVHSAL
KEAEKSPQL	KEAEKSPQL
AELQPTESL	AELQPTESL
KEHEVTIFV	KEHEVTIFV
HESLQNPLL	HESLQNPLL
VEEAQVITL	VEEAQVITL
LEISKMEVL	LEISKMEVL
KEDSKLIAL	KEDSKLIAL
SEAPEAPLL	SEAPEAPLL
KEIDKEEHL	KEIDKEEHL
KEEHLYILI	KEEHLYILI
KEIPIPFYL	KEIPIPFYL
SEFQKAVKL	SEFQKAVKL
REKLQEEML	REKLQEEML
KELSMVTEL	KELSMVTEL
GELLMHPVL	GELLMHPVL
AEAQLAYEL	AEAQLAYEL
SEHELDVAL	SEHELDVAL
DTRGLKAEL	DTRGLKAEL
SEEDRVVVI	SEEDRVVVI
GEEILITVL	GEEILITVL
AESHIILVL	AESHIILVL
SESRYPQAL	SESRYPQAL
TEVPVEPVL	TEVPVEPVL
SEGPAQVYL	SEGPAQVYL
TEDHVMHLL	TEDHVMHLL
REGEIAQFL	REGEIAQFL
HEPEKSFSL	HEPEKSFSL
EEEPGIHSL	EEEPGIHSL
GEGSGVEIL	GEGSGVEIL
IEVENKEVL	IEVENKEVL
KEIIQDVTL	KEIIQDVTL
YEEVHVPAL	YEEVHVPAL
AEKPVGALL	AEKPVGALL
FEITQPPLL	FEITQPPLL
SEFDFFERL	SEFDFFERL
EDKKITVLL	EDKKITVLL
REENPSSVL	REENPSSVL
REEVGNISI	REEVGNISI
AEFAHHNYL	AEFAHHNYL
NEAIVKDVL	NEAIVKDVL
AEKIQTIIL	AEKIQTIIL
AETLYKEIL	AETLYKEIL
AEVLNKHSL	AEVLNKHSL
KEDPTSFRL	KEDPTSFRL
KEFSEENVL	KEFSEENVL
HEWGELVQL	HEWGELVQL
HEIQEKLGL	HEIQEKLGL
LESQVRELL	LESQVRELL
KEIGELTQL	KEIGELTQL
GETAFAFHL	GETAFAFHL
VETVYTHVL	VETVYTHVL
KEPDVSEEL	KEPDVSEEL
GEIGTKTTL	GEIGTKTTL
AEEPRGSSL	AEEPRGSSL
AEEVTRELL	AEEVTRELL
AETGKVVII	AETGKVVII
AEPEDHYFL	AEPEDHYFL
VEFADEVRL	VEFADEVRL
SESSVKVRL	SESSVKVRL
QEHAQEVVL	QEHAQEVVL
KEFEGKTLV	KEFEGKTLV
SEAPGQRAL	SEAPGQRAL
MEEKGSISL	MEEKGSISL
AEMPEKGAL	AEMPEKGAL
EIDNSELLL	EIDNSELLL
SEFKAMDSI	SEFKAMDSI
KEVEQQTGL	KEVEQQTGL
AESDTSPVL	AESDTSPVL
AEVDTRESL	AEVDTRESL
GEVREDLRL	GEVREDLRL
FEMATRAAL	FEMATRAAL
SEPKDVTVL	SEPKDVTVL
IENEEPVVL	IENEEPVVL
REGLLFTAL	REGLLFTAL
QEFGADVRL	QEFGADVRL
VESKVKDIL	VESKVKDIL
QELLSDTKL	QELLSDTKL
AELTGDHQL	AELTGDHQL
AAPATRAAL	AAPATRAAL
FEDAAEIRL	FEDAAEIRL
SEYGEEPIL	SEYGEEPIL
SEFSLVDKL	SEFSLVDKL
GEAGPIHHL	GEAGPIHHL
SELIRNVTL	SELIRNVTL
SEAAFIENL	SEAAFIENL
SESALPTSL	SESALPTSL
QENAEIIKL	QENAEIIKL
REFQNPPQL	REFQNPPQL
LEPGHTELL	LEPGHTELL
AEKAYHEQL	AEKAYHEQL
GEIVEKIGV	GEIVEKIGV
SEISSATKL	SEISSATKL
KEESIVSSL	KEESIVSSL
AENKDEIAL	AENKDEIAL
AEHGETLAM	AEHGETLAM
TEVKTSTVI	TEVKTSTVI
YEEGLRVVI	YEEGLRVVI
TEAVVKEKL	TEAVVKEKL
KESGQVVAI	KESGQVVAI
TEHGEFLAL	TEHGEFLAL
SEEAKSILL	SEEAKSILL
KESEVFYEL	KESEVFYEL
VEVSIPAKL	VEVSIPAKL
GELEKDPKL	GELEKDPKL
YESGEYEML	YESGEYEML
MESEGKTVL	MESEGKTVL
KEVADAIRL	KEVADAIRL
IESHPDNAL	IESHPDNAL
AEITKEQRL	AEITKEQRL
AEFVGVSHL	AEFVGVSHL
AEGPGETVL	AEGPGETVL
AEQDLVQTL	AEQDLVQTL
FESDLHSLL	FESDLHSLL
AESDKPVVI	AESDKPVVI
KEAPTAYSL	KEAPTAYSL
AEVAGQFVI	AEVAGQFVI
HEIKSLEDL	HEIKSLEDL
AEPAEALVL	AEPAEALVL
AEADAIIQM	AEADAIIQM
AEEAPKTPL	AEEAPKTPL
TEYEKDFSL	TEYEKDFSL
GEDLEKVTL	GEDLEKVTL
AENPDTPAL	AENPDTPAL
TEHEKVAIL	TEHEKVAIL
AESIISPSL	AESIISPSL
REDISSIEI	REDISSIEI
GEHGLIIRV	GEHGLIIRV
LESKTYHAL	LESKTYHAL
AEALATHIL	AEALATHIL
HEVPSGNSL	HEVPSGNSL
FEDVGRQVL	FEDVGRQVL
HEFHSQENL	HEFHSQENL
SEVEKGEAL	SEVEKGEAL
AEDVQHQIL	AEDVQHQIL
QEEPVQPLL	QEEPVQPLL
FESGISQAL	FESGISQAL
AEPILPYAL	AEPILPYAL
AEDPTISLL	AEDPTISLL
GEQPLQPVL	GEQPLQPVL
NESVVKEML	NESVVKEML
GEISEKAKL	GEISEKAKL
VEFFHVEDL	VEFFHVEDL
KEGFPITAI	KEGFPITAI
HEQEEIFKL	HEQEEIFKL
SEAPATVEL	SEAPATVEL
SEGKDSVVL	SEGKDSVVL
VETATELLL	VETATELLL
AEMAMKVEL	AEMAMKVEL
AELGSSTSL	AELGSSTSL
GEVDLPSEL	GEVDLPSEL
KESTLHLVL	KESTLHLVL
KELPEYYEL	KELPEYYEL
VEALPGPSL	VEALPGPSL
RELEKLFQL	RELEKLFQL
HEHRLPHVL	HEHRLPHVL
KEVQDGIEL	KEVQDGIEL
GEEEKKIFL	GEEEKKIFL
SELATALAL	SELATALAL
SEFGAPVSV	SEFGAPVSV
RETEGGTVL	RETEGGTVL
YEQLLDVKI	YEQLLDVKI
TEHINIHQL	TEHINIHQL
SEVIGPVSL	SEVIGPVSL
SEKVDRAVL	SEKVDRAVL
GEKSQAPTL	GEKSQAPTL
SEVMGEPHL	SEVMGEPHL
AEAVAALLL	AEAVAALLL
TEIGQTLDL	TEIGQTLDL
TEFEQQERL	TEFEQQERL
AELILHDAL	AELILHDAL
VEFPHSPEI	VEFPHSPEI
FEITPPVVL	FEITPPVVL
REEDEETQL	REEDEETQL
REAVPEPVL	REAVPEPVL
YEEGINIHL	YEEGINIHL
LEVVTPEVL	LEVVTPEVL
GEVLIDTHL	GEVLIDTHL
FEEAERTYL	FEEAERTYL
SELRSVEGL	SELRSVEGL
HESQLSVEL	HESQLSVEL
HELLERIGL	HELLERIGL
AELKQAQTL	AELKQAQTL
RENGQEILL	RENGQEILL
GEFGEIEAI	GEFGEIEAI
REEPSNPFL	REEPSNPFL
REEQIVQLL	REEQIVQLL
HEFDGDEEF	HEFDGDEEF
AEHLEKSSL	AEHLEKSSL
TEFDAAQVL	TEFDAAQVL
AEDGADPNL	AEDGADPNL
AEAPGEAFL	AEAPGEAFL
KEDFSSFQL	KEDFSSFQL
AELKQVQTL	AELKQVQTL
KEAEFLQKL	KEAEFLQKL
GEDLPTIVI	GEDLPTIVI
AEGPPAASL	AEGPPAASL
IEPADAHVL	IEPADAHVL
IESVIKSNL	IESVIKSNL
KEILSGTKL	KEILSGTKL
LEEKDPVPL	LEEKDPVPL
IEFSDKESV	IEFSDKESV
VEAPPSVVL	VEAPPSVVL
AEDTRLIEL	AEDTRLIEL
TEFLIEPSL	TEFLIEPSL
TEIDPINAL	TEIDPINAL
KEVFDSAIL	KEVFDSAIL
SELDLISRL	SELDLISRL
FESEKEIEL	FESEKEIEL
MEDETQKEL	MEDETQKEL
GEELLHSVL	GEELLHSVL
AEGPYKIIL	AEGPYKIIL
GEDEPLHAL	GEDEPLHAL
AESLPPPTL	AESLPPPTL
EESGAQLLL	EESGAQLLL
HEDPGQATL	HEDPGQATL
REAQVFVRL	REAQVFVRL
LEDKYNLQL	LEDKYNLQL
QESLAQARL	QESLAQARL
LEAKVKDLL	LEAKVKDLL
ADHVQSLLL	ADHVQSLLL
FEWAKNSPL	FEWAKNSPL
SESDKTAVL	SESDKTAVL
QEIQDQLSL	QEIQDQLSL
SEVDINTTL	SEVDINTTL
SEPSQHVVL	SEPSQHVVL
REFDQKALL	REFDQKALL
HEVPEKTSI	HEVPEKTSI
GEDMTPTLL	GEDMTPTLL
KEKVEPEVL	KEKVEPEVL
AEISQPPAL	AEISQPPAL
FESQSEDEL	FESQSEDEL
FETEVDKIL	FETEVDKIL
IEENIPELL	IEENIPELL
RESERQLRL	RESERQLRL
IEDEIATIL	IEDEIATIL
TEVRELVSL	TEVRELVSL
KEESMKETL	KEESMKETL
TESDIREMM	TESDIREMM
LEVEKSLVL	LEVEKSLVL
AEELLRIGL	AEELLRIGL
SEPGKVIVL	SEPGKVIVL
AEEHSIATL	AEEHSIATL
KEPEINTTL	KEPEINTTL
REKDLEVYL	REKDLEVYL
GEAGSITHL	GEAGSITHL
AEQPTPQAL	AEQPTPQAL
TEVGEKIAL	TEVGEKIAL
AEETSSPVI	AEETSSPVI
TEVRVANEL	TEVRVANEL
HEQKEQISL	HEQKEQISL
GESVTKLTL	GESVTKLTL
KEDDPKAAL	KEDDPKAAL
LETKVAELL	LETKVAELL
EMEKGSPSL	EMEKGSPSL
QEQAAKAVL	QEQAAKAVL
IEDEYQVFL	IEDEYQVFL
SEGPHHVAL	SEGPHHVAL
KETIEIIDL	KETIEIIDL
MAPERVASL	MAPERVASL
GESLVREPL	GESLVREPL
SESHRFTVL	SESHRFTVL
AEPPLTAVL	AEPPLTAVL
AEDYTESLL	AEDYTESLL
LEEPYEIQL	LEEPYEIQL
ELIEGEREL	ELIEGEREL
KEDSDEVHL	KEDSDEVHL
KEEDGSLSL	KEEDGSLSL
SEDGAIHVI	SEDGAIHVI
NEFPVIVRL	NEFPVIVRL
VSDAETESI	VSDAETESI
AEAVVNDVL	AEAVVNDVL
SEYSVHSSL	SEYSVHSSL
ESMVELLDL	ESMVELLDL
AEGEIYTKL	AEGEIYTKL
AEVPESVFL	AEVPESVFL
KEDNTIYRL	KEDNTIYRL
EISTPVTIS	EISTPVTIS
SEEVSRSEL	SEEVSRSEL
AEERWEVVL	AEERWEVVL
LEFQTPELL	LEFQTPELL
RELYLFDVL	RELYLFDVL
GEAGPGRAL	GEAGPGRAL
QELYFFHEL	QELYFFHEL
GESSLSPSL	GESSLSPSL
GEDTPVTKL	GEDTPVTKL
GEKKDEVYL	GEKKDEVYL
TEIEDMPTL	TEIEDMPTL
QEENITRAL	QEENITRAL
GEAPVLIMI	GEAPVLIMI
QEEKPEPVL	QEEKPEPVL
GEVPKFKAL	GEVPKFKAL
RESNEVVHL	RESNEVVHL
LEHVPDTVL	LEHVPDTVL
LEGSKDALL	LEGSKDALL
KELEEEITL	KELEEEITL
KEWEKVFEM	KEWEKVFEM
TESRQVVEL	TESRQVVEL
VESHIQHSL	VESHIQHSL
AESGAKEEL	AESGAKEEL
GEANVMKAL	GEANVMKAL
TEIEGTQKL	TEIEGTQKL
QEEDRTVSL	QEEDRTVSL
EGEAVPVAI	EGEAVPVAI
KEYEGKWLL	KEYEGKWLL
REMLIRVNM	REMLIRVNM
LENPEGVIL	LENPEGVIL
HEFEELFRL	HEFEELFRL
REDYYDIQL	REDYYDIQL
IEEERNVPL	IEEERNVPL
SEFEENTNL	SEFEENTNL
SESPIVVVL	SESPIVVVL
LEDGQAVQL	LEDGQAVQL
LESNDFEML	LESNDFEML
SEAERVSEL	SEAERVSEL
YEIEKEPLL	YEIEKEPLL
KESEEKEVL	KESEEKEVL
FESQDTVAL	FESQDTVAL
VEFREVTEL	VEFREVTEL
VEGDPIVAL	VEGDPIVAL
GEVTYVELL	GEVTYVELL
AETRESTQL	AETRESTQL
LEGQIHPEL	LEGQIHPEL
AENGLTVRL	AENGLTVRL
AEFPLDPQL	AEFPLDPQL
LEIQDKEYL	LEIQDKEYL
LEFDEKAVL	LEFDEKAVL
REEIEKQAL	REEIEKQAL
SEEGLRNAL	SEEGLRNAL
AETVDPASL	AETVDPASL
READFFWSL	READFFWSL
WEAQEPIQM	WEAQEPIQM
REIKFLDVL	REIKFLDVL
LEFLDRESI	LEFLDRESI
EEVGLFNEL	EEVGLFNEL
TEAFDIATL	TEAFDIATL
YEDVNPVLL	YEDVNPVLL
NEDGALAVL	NEDGALAVL
REENKQIAL	REENKQIAL
HEVRIQPSL	HEVRIQPSL
GEDDKMPPL	GEDDKMPPL
GEVGHHIDL	GEVGHHIDL
HEIDRYTAI	HEIDRYTAI
SEERAGAPL	SEERAGAPL
EEAPVQPIL	EEAPVQPIL
AEQATKSVL	AEQATKSVL
YELGGPMTL	YELGGPMTL
GEHHSTPSL	GEHHSTPSL
TESQVVITL	TESQVVITL
FEVNIPTDL	FEVNIPTDL
QEQQENPRL	QEQQENPRL
SEDRMTLLL	SEDRMTLLL
REKQDTFAL	REKQDTFAL
TEATAGNVL	TEATAGNVL
VEADLVEAL	VEADLVEAL
LEENSTPQL	LEENSTPQL
AEERPRVAL	AEERPRVAL
HEAEPVRTL	HEAEPVRTL
VEEQRPPEL	VEEQRPPEL
REVEIQSHL	REVEIQSHL
KEVVHTVSL	KEVVHTVSL
LETSTGHSL	LETSTGHSL
FEMKELPQL	FEMKELPQL
REFWAKPKP	REFWAKPKP
TETNVYFKL	TETNVYFKL
KEVEAVVYL	KEVEAVVYL
SESRIFNEL	SESRIFNEL
YEERVQAVV	YEERVQAVV
KEDEQQQAL	KEDEQQQAL
HEQGLSTAL	HEQGLSTAL
AEGLLQEAL	AEGLLQEAL
SEVSTVLKL	SEVSTVLKL
IEFKETQAL	IEFKETQAL
SETVVTGSL	SETVVTGSL
SEESRPQSL	SEESRPQSL
KEEELQAAL	KEEELQAAL
SEQEEPIEL	SEQEEPIEL
GEFQELMKL	GEFQELMKL
GEVPFNHEI	GEVPFNHEI
GEVPTIESL	GEVPTIESL
SELGESSLI	SELGESSLI
YEAPDVMNL	YEAPDVMNL
FEQQMVEKL	FEQQMVEKL
GETEESEKL	GETEESEKL
REGRPIWQL	REGRPIWQL
AEVGIIESI	AEVGIIESI
HEQANVESL	HEQANVESL
METPELIEL	METPELIEL
AEERVSFGL	AEERVSFGL
AEYRLGPLL	AEYRLGPLL
SEENKATPL	SEENKATPL
YEEEVKKTL	YEEEVKKTL
TEYLEPVVL	TEYLEPVVL
GESILPTTL	GESILPTTL
TEADVEEAL	TEADVEEAL
KESIIIHQL	KESIIIHQL
MEVAGVTAL	MEVAGVTAL
REDKVHLKL	REDKVHLKL
SEQTGKELL	SEQTGKELL
LESPTVSTL	LESPTVSTL
KEKEFQEEL	KEKEFQEEL
REEEVSYQL	REEEVSYQL
TETVVTEYL	TETVVTEYL
KEVEEISLL	KEVEEISLL
SEAEIRVFL	SEAEIRVFL
HEGTDVIML	HEGTDVIML
LETDSVQRL	LETDSVQRL
REAMNDPLL	REAMNDPLL
TEHPVPIIL	TEHPVPIIL
IEMQAITAL	IEMQAITAL
KEESQQMVL	KEESQQMVL
GEIPVQEHL	GEIPVQEHL
YEEEQFTVL	YEEEQFTVL
AEVDKVARL	AEVDKVARL
GEVDPKVAL	GEVDPKVAL
QEVISRAEL	QEVISRAEL
TEDQRFPQL	TEDQRFPQL
AEIEDIRVL	AEIEDIRVL
KEEVSRQEL	KEEVSRQEL
HEGKVFISL	HEGKVFISL
AEASVMTQL	AEASVMTQL
AETFHTPSL	AETFHTPSL
KEFNEDGAL	KEFNEDGAL
LENMHIEQL	LENMHIEQL
TEAQVTQEL	TEAQVTQEL
GESKYLMAL	GESKYLMAL
SEPGPAEEL	SEPGPAEEL
KEISDLHYL	KEISDLHYL
IEDSRVYEL	IEDSRVYEL
GEDTLMEYL	GEDTLMEYL
FEFEYQTKV	FEFEYQTKV
AESLVAEGL	AESLVAEGL
YSKYYKTID	YSKYYKTID
AEEDFYEKL	AEEDFYEKL
KELTIGSKL	KELTIGSKL
AESVEEYVL	AESVEEYVL
YEAGPDAVL	YEAGPDAVL
AEYTAKIAL	AEYTAKIAL
YEEITKWYL	YEEITKWYL
FEDHNPPQL	FEDHNPPQL
LEDFPTISL	LEDFPTISL
YEVVDKDSI	YEVVDKDSI
SELNGHHTL	SELNGHHTL
VEASGGITL	VEASGGITL
TEIQLVQSL	TEIQLVQSL
GEARVGSEL	GEARVGSEL
AEAGGLEEL	AEAGGLEEL
FSGANKEKL	FSGANKEKL
RENKTAVVV	RENKTAVVV
SESLVYTTL	SESLVYTTL
GENSRNSIL	GENSRNSIL
REHVEAIKI	REHVEAIKI
NESGVRELL	NESGVRELL
VEEGKSITL	VEEGKSITL
GESQTDIEI	GESQTDIEI
RENWHEEVL	RENWHEEVL
AEDKDTPAL	AEDKDTPAL
QEEWFKAEL	QEEWFKAEL
TEAWLQEKL	TEAWLQEKL
KEIEDFDSL	KEIEDFDSL
AEDNIREML	AEDNIREML
REMEENFAV	REMEENFAV
FEMPYVVRL	FEMPYVVRL
SETTVAPSL	SETTVAPSL
SEFQDDPVL	SEFQDDPVL
GESATLRSL	GESATLRSL
RETELKVHL	RETELKVHL
SEMVELVEL	SEMVELVEL
SEDGDAHVL	SEDGDAHVL
EEEKRNPAL	EEEKRNPAL
REKKPEELI	REKKPEELI
GEAGSDVSL	GEAGSDVSL
YEDQTKPVL	YEDQTKPVL
AEEHNIVFM	AEEHNIVFM
KEDSGKIKL	KEDSGKIKL
GELQKAIDL	GELQKAIDL
SENNRIFTL	SENNRIFTL
VEANYPETL	VEANYPETL
EENPEFTSL	EENPEFTSL
SESLPVETL	SESLPVETL
TESGLNVTL	TESGLNVTL
AEVHSEEAL	AEVHSEEAL
FEIPIKVRL	FEIPIKVRL
QEFVKAFYL	QEFVKAFYL
REEHIVVEL	REEHIVVEL
REQRESLKL	REQRESLKL
AEEKMPLSL	AEEKMPLSL
AEEALKYLL	AEEALKYLL
QEVVDFEKL	QEVVDFEKL
GEFEKIMQL	GEFEKIMQL
AEGHTDAVL	AEGHTDAVL
TENLVRELL	TENLVRELL
EQLNEQLVT	EQLNEQLVT
SEMAVAHAL	SEMAVAHAL
AEASVDPSL	AEASVDPSL
SESPRSTSL	SESPRSTSL
REALTETTL	REALTETTL
KEMEDTQRL	KEMEDTQRL
KESEDKPEI	KESEDKPEI
FEVDSRVYL	FEVDSRVYL
QETEPSKEL	QETEPSKEL
QEAESAVRL	QEAESAVRL
REEAIAVTM	REEAIAVTM
GETQKTISL	GETQKTISL
KEMLPHVGV	KEMLPHVGV
IEFSIPDSL	IEFSIPDSL
SESQDQVFL	SESQDQVFL
AEVEKQTSL	AEVEKQTSL
AEEKAAQAL	AEEKAAQAL
REKEIKSEL	REKEIKSEL
SEIQVLEHL	SEIQVLEHL
GEDSRPPRL	GEDSRPPRL
SELMDITKL	SELMDITKL
REAESFTQL	REAESFTQL
TEADVKIVI	TEADVKIVI
YEFEGGVKL	YEFEGGVKL
GEEVEVHNL	GEEVEVHNL
IESSDVIRL	IESSDVIRL
LESDNNTAL	LESDNNTAL
KEVDVSKQL	KEVDVSKQL
SELKETVEL	SELKETVEL
KEAERDVSL	KEAERDVSL
REPDQTFSL	REPDQTFSL
AEKSEQPTL	AEKSEQPTL
LENDGATAL	LENDGATAL
GETPQVAVI	GETPQVAVI
GEVSARQEL	GEVSARQEL
LETLVSPKL	LETLVSPKL
RELYANVVL	RELYANVVL
LEAFGDVKL	LEAFGDVKL
SEAPSQPSL	SEAPSQPSL
MEVSEPHIL	MEVSEPHIL
VENNDIIIL	VENNDIIIL
GEEPGSQGL	GEEPGSQGL
GELSLPVHL	GELSLPVHL
AEIEIVKDL	AEIEIVKDL
LEQQNKILL	LEQQNKILL
FETPTEISL	FETPTEISL
LEPHDSPVL	LEPHDSPVL
VESGLKTIL	VESGLKTIL
VEALTKEEL	VEALTKEEL
AEDTITALL	AEDTITALL
QEEASGVAL	QEEASGVAL
QEQIEAVLL	QEQIEAVLL
IEPGVSVSL	IEPGVSVSL
LESQGIERL	LESQGIERL
KEVNFTSEL	KEVNFTSEL
KEFIINDIL	KEFIINDIL
AEFNRIMSL	AEFNRIMSL
QEEDTFHSL	QEEDTFHSL
IEQEIRILL	IEQEIRILL
AELAEEVNL	AELAEEVNL
AEAKSVWAL	AEAKSVWAL
SIPEKNRPL	SIPEKNRPL
AEAEIILQL	AEAEIILQL
TESKDDPSL	TESKDDPSL
KESSTVFEL	KESSTVFEL
VEHFMPILM	VEHFMPILM
AEAKEKIYL	AEAKEKIYL
FEKEETFTL	FEKEETFTL
VEDITPPRL	VEDITPPRL
KELEEIYML	KELEEIYML
KELEKTLAL	KELEKTLAL
QENVQKIIL	QENVQKIIL
GEGAPAWVL	GEGAPAWVL
KETKDVSAL	KETKDVSAL
KEAALSTAL	KEAALSTAL
AETEVEQAL	AETEVEQAL
REGDVITII	REGDVITII
KELDTVEVL	KELDTVEVL
EIKDLEEQL	EIKDLEEQL
IEESGEHII	IEESGEHII
AEQKVEYTL	AEQKVEYTL
QELFPAPIL	QELFPAPIL
KEILSLDKL	KEILSLDKL
REVEDETVL	REVEDETVL
SEAVLWEAL	SEAVLWEAL
KETGQIVAI	KETGQIVAI
GEEGYGRSL	GEEGYGRSL
AEAHARIHL	AEAHARIHL
SEVDSPNVL	SEVDSPNVL
AEEREKTVL	AEEREKTVL
SEGPPAPAL	SEGPPAPAL
GEAVDRSLL	GEAVDRSLL
QEFLERIHL	QEFLERIHL
GEIRTITVV	GEIRTITVV
GELKIAYQL	GELKIAYQL
VEVPDGPTL	VEVPDGPTL
SEEMIKSEL	SEEMIKSEL
AEAYHFFIL	AEAYHFFIL
HEGTDSYEL	HEGTDSYEL
KAPAPRPSL	KAPAPRPSL
KEINQNVEI	KEINQNVEI
LEDVVRAYL	LEDVVRAYL
REKIDQERL	REKIDQERL
FEAPDQKTL	FEAPDQKTL
SEAPFLHYL	SEAPFLHYL
RETDDTLVL	RETDDTLVL
SEEETRVVF	SEEETRVVF
GEMKFQWDL	GEMKFQWDL
AEFEDLDSL	AEFEDLDSL
AEALEKLFL	AEALEKLFL
AEARINAQL	AEARINAQL
EESAARVVL	EESAARVVL
AEGPVGSTL	AEGPVGSTL
REFDGTEVL	REFDGTEVL
SEVNPSVEL	SEVNPSVEL
VEDRPQDPL	VEDRPQDPL
AEIKDGERL	AEIKDGERL
YEILNNPEL	YEILNNPEL
SEWDGHEEL	SEWDGHEEL
RIDPESGDL	RIDPESGDL
SVPLAATSM	SVPLAATSM
KEYDEPYVL	KEYDEPYVL
GEVKDFPDL	GEVKDFPDL
GEVGSEVHL	GEVGSEVHL
SESASPSAL	SESASPSAL
GELARAVVL	GELARAVVL
KEIQWETRL	KEIQWETRL
HEEDRQELL	HEEDRQELL
RETSMVHEL	RETSMVHEL
AENAGSYSL	AENAGSYSL
AEEKHLHVL	AEEKHLHVL
NEYFTNEVL	NEYFTNEVL
SEISQVFEI	SEISQVFEI
FEVETPAVL	FEVETPAVL
KEYVQPVQL	KEYVQPVQL
RETKVLGAL	RETKVLGAL
AELERNVAL	AELERNVAL
GEPSLYNSL	GEPSLYNSL
GEFADPFKL	GEFADPFKL
GEKSGIEIL	GEKSGIEIL
SENVLQVHL	SENVLQVHL
REMDEQIRL	REMDEQIRL
GEQREPETL	GEQREPETL
AEEKLPMTL	AEEKLPMTL
GEARKTEVL	GEARKTEVL
VEVTAGNRL	VEVTAGNRL
AEVDPDTIL	AEVDPDTIL
KESEDAELL	KESEDAELL
SEIEDVNTL	SEIEDVNTL
GEPNIDSPL	GEPNIDSPL
KEGEEQPVL	KEGEEQPVL
HESETTTSL	HESETTTSL
AEYPEGFEI	AEYPEGFEI
KEAPEEAQL	KEAPEEAQL
GEPHSSPEL	GEPHSSPEL
FEEDPEISL	FEEDPEISL
SIPGGYNAL	SIPGGYNAL
IEIDSPYEI	IEIDSPYEI
HEFFHILNL	HEFFHILNL
KETTYYDVL	KETTYYDVL
HEDLGHVAL	HEDLGHVAL
HEDKIRVVL	HEDKIRVVL
KESDNNVKL	KESDNNVKL
AETRAGLTL	AETRAGLTL
IEQEAAVEL	IEQEAAVEL
LEIQHTTAL	LEIQHTTAL
LTQALKDNK	LTQALKDNK
SEEGGHVAV	SEEGGHVAV
REAPNPIHL	REAPNPIHL
MEEKTSHIL	MEEKTSHIL
GEDKGGYVI	GEDKGGYVI
HEIGHIFGL	HEIGHIFGL
GEDIPREML	GEDIPREML
LEHLTNEAL	LEHLTNEAL
DEIPETVSL	DEIPETVSL
SEMIDKLTL	SEMIDKLTL
TEDFIVESL	TEDFIVESL
KETAVFINI	KETAVFINI
TEAEIDAHL	TEAEIDAHL
GEEKLKEIL	GEEKLKEIL
YEENAKAEL	YEENAKAEL
FEFPNKVVL	FEFPNKVVL
REIEELHKL	REIEELHKL
GETSTVEKL	GETSTVEKL
SEVQDRVML	SEVQDRVML
AEPKLAFVI	AEPKLAFVI
AEDPLVQSL	AEDPLVQSL
HEVMEQQTI	HEVMEQQTI
SEPHILETL	SEPHILETL
ITPTGTHPL	ITPTGTHPL
SEDQSFVVL	SEDQSFVVL
SESNHLIHL	SESNHLIHL
YEIDDVERL	YEIDDVERL
AEEPHALEL	AEEPHALEL
REDTKAAVL	REDTKAAVL
KEEYLKPVL	KEEYLKPVL
AEERRDVSL	AEERRDVSL
AEYIRTEML	AEYIRTEML
SVPEAQSAL	SVPEAQSAL
KEAVIKHSL	KEAVIKHSL
SEVGSDHEL	SEVGSDHEL
AEHERELAL	AEHERELAL
SEVGTDHKL	SEVGTDHKL
AEVVPTEGL	AEVVPTEGL
TEGEDKITL	TEGEDKITL
SEARVKAEL	SEARVKAEL
AEITDKLGL	AEITDKLGL
KESGNSIVL	KESGNSIVL
SEENITIKL	SEENITIKL
HEAERNIAL	HEAERNIAL
SAPVGVTAL	SAPVGVTAL
AEHIESRTL	AEHIESRTL
LEVEDRTSL	LEVEDRTSL
AQYEDIAQK	AQYEDIAQK
LEYGVPVTL	LEYGVPVTL
REAVSKEDL	REAVSKEDL
LEEAADLLV	LEEAADLLV
REIQEAIAV	REIQEAIAV
QEDLDNPVL	QEDLDNPVL
YEEILNTKL	YEEILNTKL
REAPERPSL	REAPERPSL
KEDDLDVVL	KEDDLDVVL
AENIPENPL	AENIPENPL
REQEEIVRL	REQEEIVRL
GESGKSTFI	GESGKSTFI
AESAPAWRL	AESAPAWRL
VEWNKKEEL	VEWNKKEEL
TEMEQDYQL	TEMEQDYQL
LESVDSEAL	LESVDSEAL
YEELVRMVL	YEELVRMVL
SEEPFVVKL	SEEPFVVKL
GEFRAVTEL	GEFRAVTEL
AEAHAKVRL	AEAHAKVRL
SETEAKALL	SETEAKALL
REIAGKMDL	REIAGKMDL
QEEPLPHEL	QEEPLPHEL
NVKVDPEIQ	NVKVDPEIQ
MESDFEQKL	MESDFEQKL
REMEEKVTL	REMEEKVTL
GEFSEPVTL	GEFSEPVTL
HEWMKSEEL	HEWMKSEEL
YEDPQHHPL	YEDPQHHPL
HEDPVIAVF	HEDPVIAVF
GETLPEQHL	GETLPEQHL
GEADPSIQL	GEADPSIQL
SEPSSTVSL	SEPSSTVSL
LEVPSTTAL	LEVPSTTAL
TEEGQKIVL	TEEGQKIVL
KEEDLQWVL	KEEDLQWVL
SEGDPDLVL	SEGDPDLVL
GEVTKQTVL	GEVTKQTVL
KEDELRTVL	KEDELRTVL
QETAVAPSL	QETAVAPSL
SEFYEPEAL	SEFYEPEAL
KEVEQFTQV	KEVEQFTQV
REWQGRDLL	REWQGRDLL
AEFQRDIML	AEFQRDIML
EEEPLHTIL	EEEPLHTIL
VEERPAVSL	VEERPAVSL
SEQRLLIVL	SEQRLLIVL
REAQVWEML	REAQVWEML
YEDFHIVKL	YEDFHIVKL
HEFSREPSL	HEFSREPSL
AEFVSTPEL	AEFVSTPEL
RELGFSSNL	RELGFSSNL
KELSDSVTL	KELSDSVTL
FEAQGKPEL	FEAQGKPEL
GEAEYVVAL	GEAEYVVAL
QESVPDPEL	QESVPDPEL
SEIEYYAML	SEIEYYAML
SEDPNQAKL	SEDPNQAKL
KQQLELDSI	KQQLELDSI
GEHVKAIEI	GEHVKAIEI
GEEAVPVAL	GEEAVPVAL
KEIKEVIEL	KEIKEVIEL
KEVKEVATL	KEVKEVATL
AEYQDLTFL	AEYQDLTFL
FEENTQHLL	FEENTQHLL
KEAPPPVLL	KEAPPPVLL
TETEIVTSL	TETEIVTSL
HEVGIGSVL	HEVGIGSVL
REWKGIDRL	REWKGIDRL
HEKQPDVIL	HEKQPDVIL
AEEPPTPAL	AEEPPTPAL
GEALGFVSL	GEALGFVSL
GEITGEVRM	GEITGEVRM
SEDASIHRL	SEDASIHRL
SEFLKEEKL	SEFLKEEKL
AELKNLEVL	AELKNLEVL
REELLPHLL	REELLPHLL
AEGAYQVRL	AEGAYQVRL
REIEGDLLL	REIEGDLLL
SSPQPGSAL	SSPQPGSAL
DAVTKTVGL	DAVTKTVGL
QEMPGDVPL	QEMPGDVPL
