Data	Data aligned
FAPRGEHTL	FAPRGEHTL
VLPSERYKEL	VLPSERKEL
WSPTHPAL	WSPTH-PAL
SSPEHPEL	SSPEH-PEL
YLPSAILQL	YLPSAILQL
LAPATVQTV	LAPATVQTV
SLPSRKLVAL	SLPSRKVAL
SVPLAATSM	SVPLAATSM
FSPFNPTSL	FSPFNPTSL
KSPERFLQL	KSPERFLQL
LSPTPATAL	LSPTPATAL
NGPGGRNSL	NGPGGRNSL
TLPESLLSSL	TLPESLSSL
LGPSKGAPL	LGPSKGAPL
AAPDGTRNL	AAPDGTRNL
FLPVPGEEL	FLPVPGEEL
TLPHEILEM	TLPHEILEM
FSPSSDSLL	FSPSSDSLL
KTPDSRPSL	KTPDSRPSL
IGPRGNTL	IGPRG-NTL
FAERVTSL	FAERV-TSL
VSPESQEM	VSPES-QEM
TAPATEQTL	TAPATEQTL
LLPFSKSI	LLPFS-KSI
YVPTSYVEV	YVPTSYVEV
ASPEGKTL	ASPEG-KTL
FVPGTTAVL	FVPGTTAVL
MAAAAPVAA	MAAAAPVAA
VIPDEAKAL	VIPDEAKAL
IFEAAKQEL	IFEAAKQEL
TSPEIVTAL	TSPEIVTAL
QVNDLTTAL	QVNDLTTAL
AAPFAKSHL	AAPFAKSHL
VAPTAGHSV	VAPTAGHSV
SAPSTQQVL	SAPSTQQVL
MAPERVASL	MAPERVASL
VINEMVREL	VINEMVREL
ALPQPTSVL	ALPQPTSVL
RSPEEVTEL	RSPEEVTEL
SVIQHTNSL	SVIQHTNSL
GAPYRSTCL	GAPYRSTCL
AAPAPTAVV	AAPAPTAVV
FIPEHTNLSL	FIPEHTLSL
AAPYGGPIAL	AAPYGGIAL
TLPGPGASL	TLPGPGASL
AAPESYEEL	AAPESYEEL
ASPAGEWRAL	ASPAGERAL
IFVPARNNM	IFVPARNNM
LMPSVVTTM	LMPSVVTTM
RVPSAGSSL	RVPSAGSSL
VIPRITIEM	VIPRITIEM
FAPIQPLAM	FAPIQPLAM
SGPQVGNAL	SGPQVGNAL
TILDKAMVL	TILDKAMVL
AANFSDRSL	AANFSDRSL
LGPGPGPTTPL	PGPGPTTPL
VGPGGEITEL	VGPGGETEL
NSPLVRRTL	NSPLVRRTL
VAPRPGAGL	VAPRPGAGL
SVPDGFLSEL	SVPDGFSEL
VAPGPVIGL	VAPGPVIGL
AVFGEATNL	AVFGEATNL
AGPPRCSSL	AGPPRCSSL
VIPPTSATM	VIPPTSATM
ALHQKQLLTL	ALHQKQLTL
SSPLANQSL	SSPLANQSL
RAPEAQQTL	RAPEAQQTL
VSPVVRVAV	VSPVVRVAV
FLPARFYQAL	FLPARFQAL
NLPERSVPL	NLPERSVPL
KISERTPSAL	KISERTSAL
ASPLSPTSL	ASPLSPTSL
SAPTGHTF	SAPTG-HTF
SIPELLYSDL	SIPELLSDL
VGPVPARAL	VGPVPARAL
ELHDHGVSSL	ELHDHGSSL
KWDSHFRESV	DSHFR-ESV
VGPPGTGKTL	VGPPGTKTL
SAPSYPMASL	SAPSYPASL
SMPWNVDTL	SMPWNVDTL
NSPTNISSL	NSPTNISSL
SIFSGAASL	SIFSGAASL
NAPWAVTSL	NAPWAVTSL
SLPEKVGQL	SLPEKVGQL
IAPGHVSVI	IAPGHVSVI
FLPEGGCYEL	FLPEGGYEL
HGPESGKAL	HGPESGKAL
QGPPVTPVL	QGPPVTPVL
AAPVPTTTL	AAPVPTTTL
MVPPVQVSPL	VPPVQVSPL
SLPNVFSAL	SLPNVFSAL
YSPFGDSPL	YSPFGDSPL
SAPNSPMAL	SAPNSPMAL
SIPKGFSYL	SIPKGFSYL
LSPEARRSL	LSPEARRSL
VVQGDPREL	VVQGDPREL
VVTGVANAL	VVTGVANAL
LSPNHKVL	LSPNH-KVL
ISPFHDIPI	ISPFHDIPI
QLPDYYDTPL	QLPDYYTPL
IISSSILTSL	IISSSITSL
VAPAYGVYL	VAPAYGVYL
AAPHSIESF	AAPHSIESF
ITPGGFSSV	ITPGGFSSV
SSPQFGVTL	SSPQFGVTL
VIPELAQEL	VIPELAQEL
KLPGNISSL	KLPGNISSL
LFMPRSTEF	LFMPRSTEF
ASPGSHNAL	ASPGSHNAL
SVPPYGVAL	SVPPYGVAL
VFLPRVTEL	VFLPRVTEL
ILPPSAHEL	ILPPSAHEL
ALPSSSYTDL	ALPSSSTDL
SAPDNVLEV	SAPDNVLEV
FSPSGIFGAF	FSPSGIGAF
IAPSRKVTF	IAPSRKVTF
ISPEFFTVL	ISPEFFTVL
NAPEANRGL	NAPEANRGL
ITPTGTHPL	ITPTGTHPL
SVPKENSTL	SVPKENSTL
YSPSMTMSV	YSPSMTMSV
SVPTADEL	SVPTA-DEL
FLSPASMSAL	LSPASMSAL
TIPGGTPSL	TIPGGTPSL
NLPQYVSNEL	NLPQYVNEL
KAPEPLSSL	KAPEPLSSL
GSPGGAVRPL	GSPGGARPL
VSPATSQSI	VSPATSQSI
VIHATVTSV	VIHATVTSV
GIPSAFLEL	GIPSAFLEL
STPSPTSSL	STPSPTSSL
MSPMAERSM	MSPMAERSM
TAPVSEVSI	TAPVSEVSI
MAPQNLSTF	MAPQNLSTF
YLPPATQVV	YLPPATQVV
ALNTSKYLEL	ALNTSKLEL
ALPFSLVSM	ALPFSLVSM
VGPPGRSSL	VGPPGRSSL
HSPEEAREL	HSPEEAREL
IIPVLVGAL	IIPVLVGAL
MAPHNPHTL	MAPHNPHTL
SLPNGTASL	SLPNGTASL
IFKDHVSL	IFKDH-VSL
SGPVPGTAI	SGPVPGTAI
SLPRSAHSL	SLPRSAHSL
VFPKEPVEL	VFPKEPVEL
ALHEAAPSQL	ALHEAASQL
VIKEQNREL	VIKEQNREL
SAPVSKTL	SAPVS-KTL
LFKEREKPL	LFKEREKPL
SGPAGPILSL	SGPAGPLSL
SGPTAEAL	SGPTA-EAL
IVPEGVHAL	IVPEGVHAL
LAPASLTSA	LAPASLTSA
IVPTRELAL	IVPTRELAL
TAPIPGATL	TAPIPGATL
YAPVGIMFL	YAPVGIMFL
RGPGPGPRPL	RGPGPGRPL
AAPVSATVL	AAPVSATVL
AGPPAVHGL	AGPPAVHGL
NAPKEASRL	NAPKEASRL
VAHVDDMPNAL	HVDDMPNAL
IAPSRPWAL	IAPSRPWAL
YIPAQIGAL	YIPAQIGAL
TIPVVHASI	TIPVVHASI
KAPVNTAEL	KAPVNTAEL
RLPAWQPIL	RLPAWQPIL
SSPVTNQAI	SSPVTNQAI
YIPDGHTKEM	YIPDGHKEM
SMPTIPALAL	SMPTIPLAL
FSPTGKYL	FSPTG-KYL
SVPYHQAAL	SVPYHQAAL
TAPLSDAVL	TAPLSDAVL
ALPQEFAAL	ALPQEFAAL
VMPGPRQEL	VMPGPRQEL
VVIGNIGAL	VVIGNIGAL
KAPGFAQML	KAPGFAQML
TGPPAMKSL	TGPPAMKSL
RSPSSVTGNAL	RSPSSVNAL
TINGHNAEV	TINGHNAEV
AGPLRKSSL	AGPLRKSSL
AAPYGIESM	AAPYGIESM
AAPTRPSAL	AAPTRPSAL
YFAERVTSL	YFAERVTSL
IFPVFDNLL	IFPVFDNLL
YLPDAVKGL	YLPDAVKGL
LLIENVASL	LLIENVASL
SSPTFLRAL	SSPTFLRAL
SAPARQAVL	SAPARQAVL
VLPTLPFHVL	VLPTLPHVL
QFLPRTITL	QFLPRTITL
YSPIRLLEV	YSPIRLLEV
RVPEGQHL	RVPEG-QHL
HIPDVITYL	HIPDVITYL
RAPDVARAL	RAPDVARAL
VTPGSKAAL	VTPGSKAAL
VSPIQTSASPL	VSPIQTSAS
NSPMSPAL	NSPMS-PAL
FSPSSLSSL	FSPSSLSSL
RPSSLPVGPVL	SLPVG-PVL
NTPEDVQAL	NTPEDVQAL
ALHQHTISTL	ALHQHTSTL
YLPSSPNLSL	YLPSSPLSL
YTPYGWLQL	YTPYGWLQL
NTPVVKSAL	NTPVVKSAL
IFQVAQEL	IFQVA-QEL
RAPEYTEPL	RAPEYTEPL
STPGGSHPAL	STPGGSPAL
KAPGSTSNL	KAPGSTSNL
KSPAGSIVHEL	KSPAGSHEL
VLPNIQAVL	VLPNIQAVL
KVPKERLAL	KVPKERLAL
YLPEELSAL	YLPEELSAL
FLPEVPLGQL	FLPEVPGQL
FLPEFAGTQL	FLPEFATQL
FFPEYTHQL	FFPEYTHQL
TAPSALHTL	TAPSALHTL
SLPIATQEL	SLPIATQEL
KIQEAVKAL	KIQEAVKAL
IAPNAGSRM	IAPNAGSRM
DAPVSELSL	DAPVSELSL
YIPESLGSL	YIPESLGSL
SAPYGRITL	SAPYGRITL
RLHEYYQPTAL	RLHEYYTAL
FCPPEHYEAL	FCPPEHEAL
YTPQNPSSL	YTPQNPSSL
KAPGFRPPL	KAPGFRPPL
HLPAHSHDL	HLPAHSHDL
VSPRQTLEL	VSPRQTLEL
FLPLFDRVL	FLPLFDRVL
IVTERLVAL	IVTERLVAL
SSPVADIAV	SSPVADIAV
SAPSADAPM	SAPSADAPM
SAPSNVTSL	SAPSNVTSL
ITPTGHSL	ITPTG-HSL
SAPSSQARL	SAPSSQARL
VSPVAHKHL	VSPVAHKHL
MGPAGAKNL	MGPAGAKNL
RQPAKVAAL	RQPAKVAAL
FIPGFIGSL	FIPGFIGSL
NAPVGTEL	NAPVG-TEL
MMPDGTLGL	MMPDGTLGL
SSPLGSGEGL	SSPLGSEGL
FSPDSRHVL	FSPDSRHVL
SLNEKKLLEL	SLNEKKLEL
VVPTSQSL	VVPTS-QSL
IAPESDYSL	IAPESDYSL
SAPTAIKAA	SAPTAIKAA
SPKVKMAL	SPKVK-MAL
LAPVRQQEL	LAPVRQQEL
RLPARGFREV	RLPARGREV
KSPEAKSPL	KSPEAKSPL
NVPFKRLSV	NVPFKRLSV
YLPDFLDYF	YLPDFLDYF
TIFGKAHSL	TIFGKAHSL
FAPSSLFDL	FAPSSLFDL
VAPQSREL	VAPQS-REL
VVPQAIEL	VVPQA-IEL
VIPTNVPEL	VIPTNVPEL
CGPEHSTEL	CGPEHSTEL
GAPAGVREV	GAPAGVREV
AGPMRQISL	AGPMRQISL
TMPSDVLEV	TMPSDVLEV
ATPKVTQAL	ATPKVTQAL
FAPYNKPSL	FAPYNKPSL
LLPTHAFSTL	LLPTHASTL
NGPILNVLV	NGPILNVLV
KAPATVTNL	KAPATVTNL
FGPPGTGKTL	FGPPGTKTL
ATPGQVKEL	ATPGQVKEL
FLPSGSEM	FLPSG-SEM
RAPRSGRSL	RAPRSGRSL
NIPELAAEL	NIPELAAEL
YMPMNANDL	YMPMNANDL
LLWPGAAL	LLWPG-AAL
VFPGQVAQL	VFPGQVAQL
YLPAGQSVL	YLPAGQSVL
SINQTTLEL	SINQTTLEL
ISPPPTANL	ISPPPTANL
AAPVVPQAL	AAPVVPQAL
ILPERFLAV	ILPERFLAV
VAPWNSLSL	VAPWNSLSL
VLPNTALHL	VLPNTALHL
LLPHAVSSL	LLPHAVSSL
AAPGPRQTL	AAPGPRQTL
HAPDNFREL	HAPDNFREL
AAPGEFRAI	AAPGEFRAI
TSPVINTSL	TSPVINTSL
MLPELKSTL	MLPELKSTL
AAPGSKTTQL	AAPGSKTQL
YAPPPFLHI	YAPPPFLHI
LSPKTNQTL	LSPKTNQTL
SAPPPAPSL	SAPPPAPSL
ILPDFSLDL	ILPDFSLDL
LIPKDYRSL	LIPKDYRSL
KSPGTANVL	KSPGTANVL
SSPLRKQEL	SSPLRKQEL
SLPAPSKAL	SLPAPSKAL
GLPDFPLDSL	GLPDFPDSL
AAPAGTTFV	AAPAGTTFV
YGPELHVAL	YGPELHVAL
HLPAHSQSL	HLPAHSQSL
KLGEKERSEL	KLGEKESEL
NVPDGTGAL	NVPDGTGAL
YTPEERRAL	YTPEERRAL
IIPVGGTYL	IIPVGGTYL
FLPPNLLAL	FLPPNLLAL
KAPDFLPLL	KAPDFLPLL
FAPYERRAM	FAPYERRAM
SLHSQPPQHL	SLHSQPQHL
VLGSGFGEL	VLGSGFGEL
ALPYNLAEL	ALPYNLAEL
TLPYPPLAL	TLPYPPLAL
NAPTFGSL	NAPTF-GSL
HISNSHPLSL	ISNSHPLSL
VTPNTGMSL	VTPNTGMSL
FLPFLTTEV	FLPFLTTEV
MSPKAQRPL	MSPKAQRPL
KLPDGFSQL	KLPDGFSQL
TFLNHPAL	TFLNH-PAL
FVPRHTRNL	FVPRHTRNL
TLPQFYSFL	TLPQFYSFL
AAPSAAREL	AAPSAAREL
LAPNQTKEL	LAPNQTKEL
RLPETIDLGAL	RLPET-IDL
TFPQNPVEL	TFPQNPVEL
RTPAAVREL	RTPAAVREL
ASPEAGNTL	ASPEAGNTL
SGPGPASNL	SGPGPASNL
ILSDRQQHAL	ILSDRQHAL
YGPDFTQHL	YGPDFTQHL
AFSPSSDSL	AFSPSSDSL
LIPAVGSSL	LIPAVGSSL
ALPADIRAL	ALPADIRAL
KISEDERMEL	ISEDERMEL
SLPGSASSL	SLPGSASSL
YAPGARLAL	YAPGARLAL
FIPLDTTVL	FIPLDTTVL
ALPDDTEAL	ALPDDTEAL
STPFGQAL	STPFG-QAL
FLPSHYNYL	FLPSHYNYL
YAPSGNFV	YAPSG-NFV
NAPPSFGTL	NAPPSFGTL
KAPDGLPAL	KAPDGLPAL
SAPVNFISA	SAPVNFISA
VSPQSRASL	VSPQSRASL
LAPESRAL	LAPES-RAL
VAPPGNISL	VAPPGNISL
MAPVASIWL	MAPVASIWL
RVPYRDSKL	RVPYRDSKL
FSPQARSL	FSPQA-RSL
KMPEHSTL	KMPEH-STL
YSPKDVAVL	YSPKDVAVL
FLPPDPTYTL	FLPPDPYTL
NVPEAASTL	NVPEAASTL
AAPLSGQTF	AAPLSGQTF
IIPYITNVL	IIPYITNVL
YLNENQLSQL	YLNENQSQL
RLPLRYPRAL	RLPLRYRAL
VIAPNPAQL	VIAPNPAQL
YLPAFQNDF	YLPAFQNDF
LSPAPSKTL	LSPAPSKTL
TLPSQEVQAL	TLPSQEQAL
IIPFGNNPI	IIPFGNNPI
RIPNFKGSYL	RIPNFKSYL
AAPESGLEV	AAPESGLEV
VVPARSEAL	VVPARSEAL
KLPGPGSSL	KLPGPGSSL
RTPSDVKEL	RTPSDVKEL
SLSTSKLNSL	SLSTSKNSL
RLPSRVLEL	RLPSRVLEL
LSPSSDLTL	LSPSSDLTL
ISPEPKTEM	ISPEPKTEM
FFQVGSDL	FFQVG-SDL
EAPESAQCL	EAPESAQCL
SSPQPGSAL	SSPQPGSAL
MIPTFTALL	MIPTFTALL
SSPEKAASL	SSPEKAASL
VAPDGHIFL	VAPDGHIFL
LFPEWPSYL	LFPEWPSYL
NMPLTISSL	NMPLTISSL
EAPVGNSL	EAPVG-NSL
KAPSSNTDL	KAPSSNTDL
YLNVQVKEL	YLNVQVKEL
SLPATATMSL	SLPATAMSL
SLHNKVCQQL	SLHNKVQQL
ATPVVVRSL	ATPVVVRSL
NAPSRKSVL	NAPSRKSVL
YAPAAATV	YAPAA-ATV
NGPGTPRPL	NGPGTPRPL
SSPVTVHTL	SSPVTVHTL
SISSPVLSL	SISSPVLSL
HFPGLASEL	HFPGLASEL
TIPVSPLHL	TIPVSPLHL
MAPSETQFSHL	MAPSE-TQF
LLPIFSPEL	LLPIFSPEL
FLPDPSALQNL	FLPDP-SAL
YSPPTFRFL	YSPPTFRFL
HAPVRPVTL	HAPVRPVTL
ISPRGSCL	ISPRG-SCL
FIPSPPSFL	FIPSPPSFL
FSPAGPVL	FSPAG-PVL
AAPAYSRAL	AAPAYSRAL
VIIEKTYSL	VIIEKTYSL
ISPETMVAL	ISPETMVAL
FVTFTTRAM	FVTFTTRAM
VSPGQASPL	VSPGQASPL
MSPLSNNSL	MSPLSNNSL
KLPNYDAREI	KLPNYDREI
FLHGSDLNSL	FLHGSDNSL
YLGNFRSAL	YLGNFRSAL
GAPGRDLPL	GAPGRDLPL
SSPTGTGL	SSPTG-TGL
TLPEQHLQEL	TLPEQHQEL
IFPLIYSEM	IFPLIYSEM
FGPGPGSNF	FGPGPGSNF
PSSLPVGPVL	SLPVG-PVL
MSPIPAHSL	MSPIPAHSL
SAPGYLPTSL	SAPGYLTSL
IINDLLQSL	IINDLLQSL
ALNPAALTAL	ALNPAATAL
YLPQLVQAL	YLPQLVQAL
IMPNVTISL	IMPNVTISL
SLPDIKVYL	SLPDIKVYL
VVPTALEL	VVPTA-LEL
SSPGGATIHAL	SSPGGAHAL
YCPGMGVAL	YCPGMGVAL
LLPTGLSSL	LLPTGLSSL
LLPVITKEL	LLPVITKEL
KSPAITATL	KSPAITATL
VAPGLHLEL	VAPGLHLEL
SAPTGSGKTL	SAPTGSKTL
LVPSGSEL	LVPSG-SEL
FISDIANDAL	FISDIADAL
SAPDKRLTL	SAPDKRLTL
AAPRAPSAL	AAPRAPSAL
NAPLFIRAV	NAPLFIRAV
NSPASLVGL	NSPASLVGL
VIPHIHKSL	VIPHIHKSL
NVPPAATSL	NVPPAATSL
YLPPGVIAL	YLPPGVIAL
FSPFREQML	FSPFREQML
IAPEGSLVF	IAPEGSLVF
TAPGHTSQL	TAPGHTSQL
STPDHTSTL	STPDHTSTL
TVTEKPEVID	TVTEKPEVI
AINHDTKEL	AINHDTKEL
IAPDVDTYKEI	IAPDVDKEI
ILPEQHMSL	ILPEQHMSL
SAPASTTAV	SAPASTTAV
VIPDTIKEV	VIPDTIKEV
VSPTGRYTTL	VSPTGRTTL
LSPENLQSL	LSPENLQSL
ALPFSQMSEL	ALPFSQSEL
STPDGAGSL	STPDGAGSL
QAPSGRAPL	QAPSGRAPL
YMGIRDTEL	YMGIRDTEL
TIPEIATSEL	TIPEIASEL
LGPMGGGLTL	LGPMGGLTL
QLQLRSLA	QLQLR-SLA
FMPPGLQEL	FMPPGLQEL
IAPENLPPL	IAPENLPPL
VAPTSTVAV	VAPTSTVAV
MIQNSRPSL	MIQNSRPSL
ASPVRLLSL	ASPVRLLSL
QTIGARKEL	QTIGARKEL
KLHEEEIQEL	KLHEEEQEL
FLPDHPIVL	FLPDHPIVL
SLPNDVISSL	SLPNDVSSL
FVPETKEEL	FVPETKEEL
AAPSHSSSL	AAPSHSSSL
RAPAAGESL	RAPAAGESL
SPLPAGNAL	SPLPAGNAL
AMPFYNPAQL	AMPFYNAQL
SAPVGVTAL	SAPVGVTAL
YIPEITSVL	YIPEITSVL
VIQEHQPSVL	VIQEHQSVL
RLPSEVSAL	RLPSEVSAL
STPSSSSSL	STPSSSSSL
YSPVSRIGL	YSPVSRIGL
LLSPTPATAL	LSPTPATAL
RSPFSFVYL	RSPFSFVYL
KLPSHATHSL	KLPSHAHSL
TLPKISPSSL	TLPKISSSL
AAPTGPLL	AAPTG-PLL
AAPATNHI	AAPAT-NHI
KVTELRSEL	KVTELRSEL
YGPPGTGKTL	YGPPGTKTL
NIPAGKPSL	NIPAGKPSL
MAPEQKTEL	MAPEQKTEL
ASPVSFQEL	ASPVSFQEL
VLPAFTSNL	VLPAFTSNL
ALIPETTTL	ALIPETTTL
SLSPSPALAL	LSPSPALAL
FAPAVGPAL	FAPAVGPAL
TAPTFTGSFL	TAPTFTSFL
ISPEGRAAM	ISPEGRAAM
VVKPPGSSL	VVKPPGSSL
LAPASVQTL	LAPASVQTL
NVPAAGSHL	NVPAAGSHL
SLPALPLAEL	SLPALPAEL
TIQGAANAL	TIQGAANAL
AAPPWALGL	AAPPWALGL
LVPAFQNLM	LVPAFQNLM
TSPGSSSHL	TSPGSSSHL
SIKPGPEL	SIKPG-PEL
KSPEGMSL	KSPEG-MSL
TVYVSMIAL	TVYVSMIAL
FSPSGHIL	FSPSG-HIL
ILHPNGNITEL	LHPNGNTEL
YLPVGSHNL	YLPVGSHNL
TVPDLLLPL	TVPDLLLPL
GPLRKSSL	GPLRK-SSL
QLPLAALQAL	QLPLAAQAL
IGPKGSTL	IGPKG-STL
LLPEELTPL	LLPEELTPL
LLPSWPLAM	LLPSWPLAM
SSPDMNETHPL	SSPDMNETH
VQPQVTVPL	VQPQVTVPL
RGPSGAAAM	RGPSGAAAM
NLPSTGGSL	NLPSTGGSL
YSPERQRSL	YSPERQRSL
RLPGRSTSL	RLPGRSTSL
NLPKARAAL	NLPKARAAL
VMAPRTLIL	VMAPRTLIL
ISPFHDIPL	ISPFHDIPL
VAPGLVLGL	VAPGLVLGL
ASPDRTHVL	ASPDRTHVL
SLPGPRKPL	SLPGPRKPL
RLPHSTAAL	RLPHSTAAL
ASPPARDAL	ASPPARDAL
RLPETEMWAEL	RLPETEAEL
SIPERPAQL	SIPERPAQL
FAPHYFNYI	FAPHYFNYI
GAPLSLVDL	GAPLSLVDL
LTPTHGEM	LTPTH-GEM
FIPKNYIEM	FIPKNYIEM
QAPVAAVL	QAPVA-AVL
IKEPIWETL	IKEPIWETL
HIPEQTTQL	HIPEQTTQL
FSPNVPKSL	FSPNVPKSL
TVPKDLRHL	TVPKDLRHL
TPPPLPKPAL	TPPPLPPAL
HSPAGSQAL	HSPAGSQAL
TVPASFSSL	TVPASFSSL
LTPPVATEL	LTPPVATEL
NAAIAKQAL	NAAIAKQAL
ALPGPFLSM	ALPGPFLSM
AAPSDASAM	AAPSDASAM
VIPSTPLAI	VIPSTPLAI
DPFNPFELTNH	FNPFELTNH
AGPSHVAAM	AGPSHVAAM
ILPLRNWLL	ILPLRNWLL
NVPSPNAPL	NVPSPNAPL
FLPFSAISV	FLPFSAISV
KAPESPSL	KAPES-PSL
IVPGNVKSL	IVPGNVKSL
SVPTDYSYL	SVPTDYSYL
FSPLSEDTL	FSPLSEDTL
YAPVHADDL	YAPVHADDL
QLPQTPPSCL	QLPQTPSCL
KAPVTKVAA	KAPVTKVAA
SLNNNHLREL	SLNNNHREL
YVPPRRLAV	YVPPRRLAV
TQPSRLLSL	TQPSRLLSL
SLPDTTATL	SLPDTTATL
QLPQLPLAAL	QLPQLPAAL
SSPATESAL	SSPATESAL
QSPEGRYSAL	QSPEGRSAL
LLPSSGFMEL	LLPSSGMEL
FLPPLPTSV	FLPPLPTSV
QIPVDLSEL	QIPVDLSEL
VCPPNRPGL	VCPPNRPGL
ALPLGGKAL	ALPLGGKAL
STPSGCLEL	STPSGCLEL
TAPRQVSAL	TAPRQVSAL
SSPEFSKTL	SSPEFSKTL
VAPGKRPAL	VAPGKRPAL
EAPPAFSHL	EAPPAFSHL
ALPEDDFLSL	ALPEDDLSL
KAPEMTNEL	KAPEMTNEL
SIPGARPVL	SIPGARPVL
YFEGGVSSV	YFEGGVSSV
IAPLRVLSF	IAPLRVLSF
FSPLPTPAL	FSPLPTPAL
FSPNGKYL	FSPNG-KYL
STPSGYLEL	STPSGYLEL
QLPEGASAV	QLPEGASAV
ISPHGNAL	ISPHG-NAL
KAPVGPVTM	KAPVGPVTM
NFPEHIFPAL	NFPEHIPAL
SSPMATTAA	SSPMATTAA
FLPPEASQL	FLPPEASQL
YAPDYSSRL	YAPDYSSRL
SSPGGSGRAL	SSPGGSRAL
AAPLHSVL	AAPLH-SVL
NLPENSQEL	NLPENSQEL
KAPLSKVRL	KAPLSKVRL
FMPKSYEAL	FMPKSYEAL
RLSQVPMSAL	LSQVPMSAL
KTPEEAYRAL	KTPEEARAL
SSPGQRAVL	SSPGQRAVL
SAPFLASAV	SAPFLASAV
FISGHTSEL	FISGHTSEL
KAPSAARSL	KAPSAARSL
MLPEKLRPL	MLPEKLRPL
QAPKSRQEL	QAPKSRQEL
RSPTKSSL	RSPTK-SSL
FSPNRVIGL	FSPNRVIGL
FLPGAWRGL	FLPGAWRGL
KAPAPRPSL	KAPAPRPSL
YVPEVSAL	YVPEV-SAL
KSPITRSEM	KSPITRSEM
SSPKLPVSSL	SSPKLPSSL
SAPGPSQSL	SAPGPSQSL
SNPGGRPAL	SNPGGRPAL
RLPNVPSSSL	RLPNVPSSL
LAPGPFCAM	LAPGPFCAM
SIPLANESL	SIPLANESL
NSPFQVTAL	NSPFQVTAL
AIHLIDPNTL	AIHLIDNTL
FGPEGQTAL	FGPEGQTAL
RLPAWQPLL	RLPAWQPLL
HISSQNSEL	HISSQNSEL
TLSDRQPAEL	TLSDRQAEL
IWHHTFYNELR	IWHHTFNEL
AVPLNLIGL	AVPLNLIGL
YIPQRPYMSL	YIPQRPMSL
LAPAVIHAL	LAPAVIHAL
MAPSGSLAV	MAPSGSLAV
TAPSSSSL	TAPSS-SSL
VSAAGLVQGL	SAAGLVQGL
YLDEEFHQSL	YLDEEFQSL
YLPSFFTKL	YLPSFFTKL
YLNKNALTTL	YLNKNATTL
ESPAPKQEL	ESPAPKQEL
KLPEYNPRTL	KLPEYNRTL
LTPLGSSEL	LTPLGSSEL
KLPKVNKEL	KLPKVNKEL
FIPESWLNSL	FIPESWNSL
IAPKSTSVF	IAPKSTSVF
ILPQVSFTAV	ILPQVSTAV
HLPEGALNSL	HLPEGANSL
FIPDVKGAVL	FIPDVKAVL
SVPIQANAL	SVPIQANAL
MAPDKQLTL	MAPDKQLTL
SSPTGSKDL	SSPTGSKDL
FVPVANEL	FVPVA-NEL
ISPSRTEAL	ISPSRTEAL
ILNISPPLNL	ILNISPLNL
SGPASHNSL	SGPASHNSL
LGPPAAHSL	LGPPAAHSL
KAPQTPSAL	KAPQTPSAL
IAPETRRSI	IAPETRRSI
RAPDAVYTEL	RAPDAVTEL
ISPSTFAQL	ISPSTFAQL
QTPPGMLAL	QTPPGMLAL
SAPSRVAAV	SAPSRVAAV
VSPLHRVL	VSPLH-RVL
FLPEAPAEL	FLPEAPAEL
QAPVAAHTV	QAPVAAHTV
YAPSYYHVM	YAPSYYHVM
TIPKSKFLAL	TIPKSKLAL
GLIDTKELEPL	GLIDT-KEL
GPPGTGKTLL	GPPGTGKTL
SSLPVGPVL	SSLPVGPVL
STPEGIAL	STPEG-IAL
VTPNHSAF	VTPNH-SAF
FSPFHASVL	FSPFHASVL
VSPLATSAL	VSPLATSAL
FTPDSLAAL	FTPDSLAAL
FTPVCTTEL	FTPVCTTEL
TAPVPTTEI	TAPVPTTEI
GAPGVRAEL	GAPGVRAEL
ALPLTRFQAV	ALPLTRQAV
AAPGSARRPL	AAPGSARPL
SSPSSLRAL	SSPSSLRAL
YAPYPSPVL	YAPYPSPVL
FLPLHYDYL	FLPLHYDYL
FGPLSSNTL	FGPLSSNTL
TFPMQCSAL	TFPMQCSAL
TGPEGHVL	TGPEG-HVL
VVPTAPEL	VVPTA-PEL
MTPTRELAL	MTPTRELAL
YSPEACRSM	YSPEACRSM
MAPNHQTL	MAPNH-QTL
YFENRKAL	YFENR-KAL
VGPDALMAL	VGPDALMAL
NGPVSHSSL	NGPVSHSSL
SILTTHTTL	SILTTHTTL
RLPERMTTL	RLPERMTTL
WAPSGNLL	WAPSG-NLL
QLPSGWASI	QLPSGWASI
HLPNDFPTCL	HLPNDFTCL
FSPSEVKSL	FSPSEVKSL
TSPEAFLAL	TSPEAFLAL
YLPEWTAWL	YLPEWTAWL
NIPEKTTAL	NIPEKTTAL
SSPLKSHPL	SSPLKSHPL
NAPLVHATL	NAPLVHATL
NTPENLHEM	NTPENLHEM
KLPLFPEPL	KLPLFPEPL
LLPPAWQQL	LLPPAWQQL
SAPDFQQSL	SAPDFQQSL
VGPGPALML	VGPGPALML
YMHDSDNKAL	YMHDSDKAL
YLNDDQVKEL	YLNDDQKEL
VSPPPGAVL	VSPPPGAVL
WAPESAPL	WAPES-APL
LSPLARTDL	LSPLARTDL
RIHESSPLDL	RIHESSLDL
SGPQRLVSF	SGPQRLVSF
QAPDGMQSL	QAPDGMQSL
VAPAGVTL	VAPAG-VTL
ASPASLARTL	ASPASLRTL
SSPLVVVSV	SSPLVVVSV
SAPRHGSL	SAPRH-GSL
SLPSRVGEL	SLPSRVGEL
TTPFSTCSV	TTPFSTCSV
SAPGPAQAM	SAPGPAQAM
VISGGASDL	VISGGASDL
AIMENANVL	AIMENANVL
SAAQRLTAL	SAAQRLTAL
SAPIHTQM	SAPIH-TQM
IAPGVTHEL	IAPGVTHEL
YLPGEDLMSL	YLPGEDMSL
LVPTRELAL	LVPTRELAL
VAPPVSGDL	VAPPVSGDL
ILPEYADIF	ILPEYADIF
LAPERRSTL	LAPERRSTL
IGPQGAKAL	IGPQGAKAL
KAPNASNL	KAPNA-SNL
HSPGAVSSL	HSPGAVSSL
AAPNGAEPL	AAPNGAEPL
EIPERTMSV	EIPERTMSV
SLSSADLSSL	SLSSADSSL
FIPATGHSL	FIPATGHSL
HLSDTGISAL	LSDTGISAL
FAPGDLPEL	FAPGDLPEL
VISDHECQEL	VISDHEQEL
TLPIAASSSL	TLPIAASSL
FAPEKLQEL	FAPEKLQEL
VSPREGSSL	VSPREGSSL
SSPVSMVHL	SSPVSMVHL
NLPKQPPLAL	NLPKQPLAL
HHPDYNNEL	HHPDYNNEL
FLPEAEMFSL	FLPEAEFSL
EVPGPAAAL	EVPGPAAAL
TLHEQASAL	TLHEQASAL
IIPLLPMAL	IIPLLPMAL
YAPNRTITV	YAPNRTITV
VAPPGCSHL	VAPPGCSHL
TIPSQILEV	TIPSQILEV
KIAEGVNSL	KIAEGVNSL
STPVAREL	STPVA-REL
AVPESTGAL	AVPESTGAL
RLPQGIVREL	RLPQGIREL
VAPLATVNI	VAPLATVNI
TAPSTSTTM	TAPSTSTTM
VLSDQAYSEL	VLSDQASEL
RGPGPRSSL	RGPGPRSSL
YVPFAERSL	YVPFAERSL
RCPEHGTF	RCPEH-GTF
ISPKPSKPL	ISPKPSKPL
TAPLTLESL	TAPLTLESL
FLRQVGVTEM	LRQVGVTEM
ALPAAPASSL	ALPAAPSSL
VLPDSGHLHPL	VLPDS-GHL
VLPNPPQAV	VLPNPPQAV
FTPTGGLGL	FTPTGGLGL
SLSHTSEEDF	LSHTSEEDF
RLPKGAVL	RLPKG-AVL
SFEPTTVEL	SFEPTTVEL
FIFSDTHEL	FIFSDTHEL
SLDPSNRKPL	LDPSNRKPL
SAPTARVFM	SAPTARVFM
VTPQAGTAL	VTPQAGTAL
FLPFTLQEL	FLPFTLQEL
SVPYFVTAL	SVPYFVTAL
KLPSAVIAL	KLPSAVIAL
TLPRGFGSL	TLPRGFGSL
NMPNQVKEL	NMPNQVKEL
NLPIWVNKL	NLPIWVNKL
LAPSGFLGL	LAPSGFLGL
TAPQSQLFL	TAPQSQLFL
FLPVGFVTL	FLPVGFVTL
NAAERRGPL	NAAERRGPL
ISPDTVGTL	ISPDTVGTL
ASPVSPEL	ASPVS-PEL
VAPTAAHSV	VAPTAAHSV
FAPSPTGFL	FAPSPTGFL
AAPTTGNQI	AAPTTGNQI
TAPVGINM	TAPVG-INM
QAPQPQSSL	QAPQPQSSL
NVPFSELNL	NVPFSELNL
FSPAPSLSL	FSPAPSLSL
NSPVGNQL	NSPVG-NQL
YMPPPYASL	YMPPPYASL
VGPVGNSDL	VGPVGNSDL
YVPSGIRCV	YVPSGIRCV
SMPEFMANL	SMPEFMANL
NLPHGNAL	NLPHG-NAL
VANVSLLAL	VANVSLLAL
LAPDYDALDV	LAPDY-DAL
ISPRFDVQL	ISPRFDVQL
LVPEHVVM	LVPEH-VVM
GVAIGQTSL	GVAIGQTSL
LSPSSLFSAL	LSPSSLSAL
SLPSRAAAL	SLPSRAAAL
FLSEHPNVTL	FLSEHPVTL
SLAPTDVKEL	LAPTDVKEL
SLPENYKQL	SLPENYKQL
LLPGPPFAREL	PGPPFAREL
ATPAGDIMEL	ATPAGDMEL
IFQPVAEL	IFQPV-AEL
KLPALPTQAL	KLPALPQAL
FIPFCVDAL	FIPFCVDAL
VIPDGPTRAL	VIPDGPRAL
AAPTSSAL	AAPTS-SAL
YAPSTYAHL	YAPSTYAHL
YAPDPGMLF	YAPDPGMLF
KVPEIVSVL	KVPEIVSVL
YIPQIVQAL	YIPQIVQAL
RVIDLRAEL	RVIDLRAEL
AGPVGGSL	AGPVG-GSL
QTPGHTEEL	QTPGHTEEL
LSPMSVNAV	LSPMSVNAV
KLPDYSSIEI	KLPDY-SSI
TGPISTHSL	TGPISTHSL
SVPVTKTNL	SVPVTKTNL
AAPATRAAL	AAPATRAAL
NLPWYLPSAL	NLPWYLSAL
RVEERLSAL	RVEERLSAL
RVPTANVSV	RVPTANVSV
KGPGSTKEL	KGPGSTKEL
YGPPSNFLEI	YGPPSNLEI
FGPDSKSSAL	FGPDSKSAL
TLPTNFRDL	TLPTNFRDL
VGPGPYRAT	VGPGPYRAT
ISPENHISL	ISPENHISL
SFEDAKEAL	SFEDAKEAL
VGPPPATSI	VGPPPATSI
TSGPASSPVA	SGPAS-SPV
ASPSSIRSL	ASPSSIRSL
FAPGTTVPLAL	FAPGTTVPL
RIAEFTTNL	RIAEFTTNL
NVATHSTL	NVATH-STL
ALPGFAEAL	ALPGFAEAL
SVPVATVEL	SVPVATVEL
MSPDVKNSI	MSPDVKNSI
FSPVGSVL	FSPVG-SVL
SSPQAGSSL	SSPQAGSSL
YIPGKNRDL	YIPGKNRDL
ISPTGHSL	ISPTG-HSL
ITPESILSAL	ITPESISAL
TSPGGSYGHL	TSPGGSGHL
IAPGGGAFTTL	IAPGGGTTL
QIPEIKQTL	QIPEIKQTL
SAPYSPYAL	SAPYSPYAL
VMPSRLKAL	VMPSRLKAL
KIHSSFRSL	KIHSSFRSL
VSPSTSLEL	VSPSTSLEL
KTPFVARSL	KTPFVARSL
TLPDWKRSL	TLPDWKRSL
SAPDKSLEL	SAPDKSLEL
TAPNTFKTL	TAPNTFKTL
YLPEDFMESL	YLPEDFESL
YLPPGFLSA	YLPPGFLSA
FFDEKLNSL	FFDEKLNSL
TSPVPGRTL	TSPVPGRTL
TSPEGKKL	TSPEG-KKL
RVNSTMTTL	RVNSTMTTL
SAPMTTNGL	SAPMTTNGL
LGPAGGDREAL	LGPAGGEAL
HLGSKGTSSL	LGSKGTSSL
VAPVGSGSAL	VAPVGSSAL
LSPGTPRSL	LSPGTPRSL
VLPPRQPSAL	VLPPRQSAL
TAPYSLETL	TAPYSLETL
YLPDSLTQL	YLPDSLTQL
FAPFLSRTL	FAPFLSRTL
IIHEIAVLEL	IIHEIALEL
VAPGTGIDL	VAPGTGIDL
FFPFDPCVL	FFPFDPCVL
KIPEDVSGL	KIPEDVSGL
SSPGHGSPL	SSPGHGSPL
ALPTGSRAL	ALPTGSRAL
LFHPSNVEM	LFHPSNVEM
RSPSWQTAM	RSPSWQTAM
STPEYTVEL	STPEYTVEL
LMPQVLTTL	LMPQVLTTL
ISPKVKMAL	ISPKVKMAL
QSPEGMISL	QSPEGMISL
NAPEQACHL	NAPEQACHL
LLPSHASYL	LLPSHASYL
FINGDISSL	FINGDISSL
VLPPPPTTL	VLPPPPTTL
MFPLVKSAL	MFPLVKSAL
YSPKSPSL	YSPKS-PSL
SAPLPQSTL	SAPLPQSTL
LLPEFPRGPL	LLPEFPGPL
TGPVSKTL	TGPVS-KTL
ILPKTGTVSL	ILPKTGVSL
FVPSDKSAL	FVPSDKSAL
TLPERPLTEV	TLPERPTEV
AGPGGLSGSTL	AGPGGLSTL
ISPVANEM	ISPVA-NEM
SAPSRVQAL	SAPSRVQAL
HLPTKEASSL	HLPTKESSL
VAPVTHVSV	VAPVTHVSV
KAPEPPPAL	KAPEPPPAL
AAPRTVALTAL	AAPRT-VAL
YSPTGKEF	YSPTG-KEF
AAPDGPAL	AAPDG-PAL
VSPTVNQRL	VSPTVNQRL
SVPAFASSL	SVPAFASSL
AAPVSTSEL	AAPVSTSEL
VAPPKAHEV	VAPPKAHEV
IAPTGIESL	IAPTGIESL
VLPEVESSL	VLPEVESSL
APTDVKEL	APTDV-KEL
NSPLGEAL	NSPLG-EAL
VAPPPPTHL	VAPPPPTHL
GLPTGSTPL	GLPTGSTPL
SAPTIATYL	SAPTIATYL
FLPEKISSTL	FLPEKISTL
VAPKQLHSL	VAPKQLHSL
TVPFTVESL	TVPFTVESL
SIPTKALEL	SIPTKALEL
VTPVTGASL	VTPVTGASL
LINPSSLLEL	INPSSLLEL
EAPVTSHSL	EAPVTSHSL
LAPPAGATL	LAPPAGATL
SLPEIDNAL	SLPEIDNAL
AAPPAGGTL	AAPPAGGTL
LSPTYELAL	LSPTYELAL
LIPDIATEL	LIPDIATEL
YSPAGNLEL	YSPAGNLEL
QVPVVMTSL	QVPVVMTSL
NMPAAVHAL	NMPAAVHAL
SAPTETHSL	SAPTETHSL
VGPLGSTIPM	VGPLG-STI
KAMEAASSL	KAMEAASSL
RLPSKPYSTL	RLPSKPSTL
VLSERDYESL	VLSERDESL
RVPGGYLAL	RVPGGYLAL
VAPEPCPQPL	VAPEPCQPL
HPNYLGDLIM	HPNYL-GDL
IVPTGKTGL	IVPTGKTGL
LSPNTTSSL	LSPNTTSSL
IAPQRIPSL	IAPQRIPSL
VMPYIKTSL	VMPYIKTSL
KSPEIQRAL	KSPEIQRAL
NSPSCTREL	NSPSCTREL
SAPSYLARSL	SAPSYLRSL
TAPSNSSSL	TAPSNSSSL
VSPFAFEAM	VSPFAFEAM
TVPGYRNSL	TVPGYRNSL
MAPGTVTVV	MAPGTVTVV
KAPNYSCVM	KAPNYSCVM
IAPDFPAQVL	IAPDFPQVL
YAPKGSSL	YAPKG-SSL
RQPLSKESL	RQPLSKESL
RGPEGHPL	RGPEG-HPL
RAPVSESL	RAPVS-ESL
SGPAPRCEL	SGPAPRCEL
VAPESFEYI	VAPESFEYI
SVPNKALEL	SVPNKALEL
VAPTSGPAL	VAPTSGPAL
RVAEHHVATL	VAEHHVATL
NLPEETNEL	NLPEETNEL
KLPEKWESV	KLPEKWESV
IISEQQAKSL	ISEQQAKSL
PGPGRKEL	PGPGR-KEL
DGSVPEAQSAL	SVPEAQSAL
RLANKDRPAL	LANKDRPAL
YLPESRRPL	YLPESRRPL
ASPKVRLSL	ASPKVRLSL
TAPQGNVDL	TAPQGNVDL
TLPVTAPIAL	TLPVTAIAL
FLPGFSQSL	FLPGFSQSL
SAPRHGSI	SAPRH-GSI
RLPESAAEL	RLPESAAEL
VSPYSGAVF	VSPYSGAVF
FSPAPRPEM	FSPAPRPEM
NSPIFDKPL	NSPIFDKPL
KIAEKTAAL	KIAEKTAAL
MAPLKMLAL	MAPLKMLAL
ISPASTPSCL	ISPASTSCL
MSPTGDFL	MSPTG-DFL
KWPDRITLL	KWPDRITLL
VVPEPGQPL	VVPEPGQPL
SLPSAIREL	SLPSAIREL
SAPDPHQQL	SAPDPHQQL
KVPTTKSTL	KVPTTKSTL
RAPSPTKPL	RAPSPTKPL
IAPERRFYL	IAPERRFYL
FSPFPPSVL	FSPFPPSVL
MAPAYLPRSL	MAPAYLRSL
EGPVGSTL	EGPVG-STL
SAPVSVSAV	SAPVSVSAV
SSPVVHQSL	SSPVVHQSL
VIPKDYKTM	VIPKDYKTM
ICPGYNAVL	ICPGYNAVL
KTPEGCTEI	KTPEGCTEI
SAPVPASPL	SAPVPASPL
AAAAATMAL	AAAAATMAL
YSPEGHVL	YSPEG-HVL
FWPPYVELL	FWPPYVELL
VQPHSTAEL	VQPHSTAEL
ASPLRLQSH	ASPLRLQSH
HWEVRIKEL	HWEVRIKEL
VFIDKQTNL	VFIDKQTNL
VAPASVITI	VAPASVITI
RSPGRAYAL	RSPGRAYAL
IAPTGHSL	IAPTG-HSL
RAPEEVHAL	RAPEEVHAL
LLLERAKEL	LLLERAKEL
IIPEYISAF	IIPEYISAF
ASPLRESAL	ASPLRESAL
RAPWTSTSV	RAPWTSTSV
SSPFFREAL	SSPFFREAL
SAPSASVGL	SAPSASVGL
AGPDSAGIAL	AGPDSAIAL
MAPYGPLAA	MAPYGPLAA
KFWERFIAL	KFWERFIAL
SAPGIISAL	SAPGIISAL
IVPHGYTEV	IVPHGYTEV
TSPQFQQAL	TSPQFQQAL
FCPEPGQKL	FCPEPGQKL
PRHSQSLTM	PRHSQSLTM
YFPELIANF	YFPELIANF
LLPRAGLEL	LLPRAGLEL
STPTGYGTL	STPTGYGTL
ALPEAIAAL	ALPEAIAAL
KAPDNRETL	KAPDNRETL
SLPSFPSTL	SLPSFPSTL
VAPVASAL	VAPVA-SAL
QLPNNMAMAL	QLPNNMMAL
AAPAGTTF	AAPAG-TTF
SIPESRSSI	SIPESRSSI
VAYVSSVAL	VAYVSSVAL
HLHNMPPSAL	HLHNMPSAL
ASPPPVSEL	ASPPPVSEL
SAPTSAGKTL	SAPTSAKTL
LLPPVFNIRSL	LLPPVFRSL
RLPVGGFRSL	RLPVGGRSL
KLPEPEPQPL	KLPEPEQPL
HAPLSGESL	HAPLSGESL
SLPGLMMDL	SLPGLMMDL
SIPDIKTAF	SIPDIKTAF
NTPHSTLSV	NTPHSTLSV
LSPTRELAL	LSPTRELAL
AGPPATSEL	AGPPATSEL
IAPGLFGTPL	IAPGLFTPL
SLPVHVFEAL	SLPVHVEAL
YAPINANAI	YAPINANAI
LSPITKLSV	LSPITKLSV
TIPSFMNII	TIPSFMNII
ILTDESLSSL	LTDESLSSL
NLPTFLVEL	NLPTFLVEL
TGHTGDVMSL	TGHTGDMSL
NIPDMLQSL	NIPDMLQSL
AAPQSLEFL	AAPQSLEFL
ALPEAPAPL	ALPEAPAPL
GLPSQKTASL	GLPSQKASL
VAPAGITL	VAPAG-ITL
NAPLVNVTL	NAPLVNVTL
IAPNGALQL	IAPNGALQL
TCPGQSSSL	TCPGQSSSL
FSPIRSSAF	FSPIRSSAF
FIHEDHLREL	FIHEDHREL
MIPLLLAAL	MIPLLLAAL
TLNASILNSL	TLNASINSL
VIPPFCNLL	VIPPFCNLL
ILARDGPNAL	LARDGPNAL
TSPENNASL	TSPENNASL
SLPELTHAL	SLPELTHAL
IIYTAKISL	IIYTAKISL
STAIREISL	STAIREISL
AIPDHARQL	AIPDHARQL
SVPDSVTPL	SVPDSVTPL
AIPLHASSL	AIPLHASSL
YSPGMTMSV	YSPGMTMSV
MVASGSEL	MVASG-SEL
SSPTSPNAL	SSPTSPNAL
VHPGGDTVAI	VHPGGDVAI
MMPKGAAL	MMPKG-AAL
KTAENFRAL	KTAENFRAL
ILPNFNASYL	ILPNFNSYL
ASPAVGQPL	ASPAVGQPL
VAPSRLDF	VAPSR-LDF
TILDNRKEL	TILDNRKEL
ESPAAVMEL	ESPAAVMEL
SFEAQGAL	SFEAQ-GAL
KIPANSKAV	KIPANSKAV
SSPQGQRSL	SSPQGQRSL
NGPSSASEL	NGPSSASEL
RNPPAFTEL	RNPPAFTEL
RLPESNQTL	RLPESNQTL
AAPMSTSVM	AAPMSTSVM
RLPPYSSQL	RLPPYSSQL
DIPKGYMDL	DIPKGYMDL
AAPRAEAL	AAPRA-EAL
VAPVSFFL	VAPVS-FFL
SSPVVATTM	SSPVVATTM
YMPLLAGQL	YMPLLAGQL
FVPDYTREL	FVPDYTREL
RAPEFLQTL	RAPEFLQTL
AAPGSGRVL	AAPGSGRVL
TAPSTSARL	TAPSTSARL
KGPPAALTL	KGPPAALTL
YLPEWKENIM	YLPEWKENI
AAPASGAL	AAPAS-GAL
TLPTVIAEL	TLPTVIAEL
AAPEGAGAL	AAPEGAGAL
KAPSRQISL	KAPSRQISL
RIAELLTEL	RIAELLTEL
IGPLRLSTL	IGPLRLSTL
KFHTEALTAL	KFHTEATAL
IGPTTARAL	IGPTTARAL
NIPTWLTEL	NIPTWLTEL
SAPGGGPGTL	SAPGGGGTL
FVPETQVSL	FVPETQVSL
HGPGPVGAL	HGPGPVGAL
IVPDGTLQL	IVPDGTLQL
TSPEGQAL	TSPEG-QAL
RIPDQLGYL	RIPDQLGYL
NLPIGFLEL	NLPIGFLEL
AAPTAQKSL	AAPTAQKSL
SAPGTLKTL	SAPGTLKTL
LLPDGTANL	LLPDGTANL
TSAPKGSVL	TSAPKGSVL
YCPPETAVL	YCPPETAVL
HLPPGFLHL	HLPPGFLHL
YLNENPLRAL	YLNENPRAL
ILPPTFSFL	ILPPTFSFL
YSPHGHIL	YSPHG-HIL
ALPEIFTEL	ALPEIFTEL
ALPEGRQEL	ALPEGRQEL
ALPEEVQEL	ALPEEVQEL
YMPASSYQSL	YMPASSQSL
FIQEIEHAL	FIQEIEHAL
TGPDVVKSV	TGPDVVKSV
YLPFGPFKEL	YLPFGPKEL
VIPGIFIAL	VIPGIFIAL
ALPPGSYASL	ALPPGSASL
LSPGSLTLS	LSPGSLTLS
IINGEATML	IINGEATML
RLPDTALPTL	RLPDTAPTL
TLPWGTLSSL	TLPWGTSSL
AAPSGATL	AAPSG-ATL
NSPLPGSEL	NSPLPGSEL
IAPETGENL	IAPETGENL
TIIDTKGVTAL	IIDTKGTAL
HIPDQETTSL	HIPDQETSL
SLPSSGRSSL	SLPSSGSSL
YTPFHAVL	YTPFH-AVL
ALSQSNPSAL	ALSQSNSAL
TAPDRATAV	TAPDRATAV
TIPSLQNSL	TIPSLQNSL
CAPPSRLTL	CAPPSRLTL
VIPYANHEL	VIPYANHEL
ALPSGQLTSL	ALPSGQTSL
FLPGGDMMTL	FLPGGDMTL
SVPQALTGL	SVPQALTGL
MAPLGNTPM	MAPLGNTPM
RAPPPGAQL	RAPPPGAQL
GAPGAVTTL	GAPGAVTTL
LLPPPIAPL	LLPPPIAPL
MSPQGQVL	MSPQG-QVL
ILPSSIKEL	ILPSSIKEL
HLPETKFSEL	HLPETKSEL
SLPSYVSVL	SLPSYVSVL
FLPPEVNQL	FLPPEVNQL
RCPKPASQI	RCPKPASQI
VTPSKYSSL	VTPSKYSSL
RVPEGRAL	RVPEG-RAL
SSPQYSTFL	SSPQYSTFL
YLPLAHVL	YLPLA-HVL
VAPVAQVAL	VAPVAQVAL
RAPEVILEL	RAPEVILEL
TLSSTKNRAL	LSSTKNRAL
LLPEEPVSQL	LLPEEPSQL
FSPSSDSL	FSPSS-DSL
IFPETHRPL	IFPETHRPL
SIPKGNSAL	SIPKGNSAL
IAPHARNGL	IAPHARNGL
ITPSTQQHL	ITPSTQQHL
NVPISPAL	NVPIS-PAL
ITPDMMATL	ITPDMMATL
TIIEATHVL	TIIEATHVL
GGSFDVADRMF	SFDVADRMF
AVPEHAARL	AVPEHAARL
FLPSSVLWL	FLPSSVLWL
IAPSAKTL	IAPSA-KTL
YLPENKPCYL	YLPENKCYL
AAPTVNQFL	AAPTVNQFL
RSPVVHSVL	RSPVVHSVL
MAPSKETEM	MAPSKETEM
YIPDLYNHFL	YIPDLYHFL
AAPFSYHST	AAPFSYHST
TFVPAMTAI	TFVPAMTAI
VSPHASGSL	VSPHASGSL
GIPEHADNL	GIPEHADNL
ISPTRLHSL	ISPTRLHSL
HFYGKAIEL	HFYGKAIEL
GIPAGWMGL	GIPAGWMGL
LSPPPPAAL	LSPPPPAAL
ASPSAASQL	ASPSAASQL
SINGDLMEL	SINGDLMEL
GLSENPFASL	GLSENPASL
SLPDLTTPL	SLPDLTTPL
SLPEDHFSEL	SLPEDHSEL
AASPSRLLSL	ASPSRLLSL
VAPSRAIYF	VAPSRAIYF
VSQEVTRSL	VSQEVTRSL
QAPSPPPAL	QAPSPPPAL
KLHEEKTKEL	KLHEEKKEL
MVPPNIAEL	MVPPNIAEL
RQPYAVSEL	RQPYAVSEL
KLPTPMQSL	KLPTPMQSL
KWQERKEAL	KWQERKEAL
NAPMTLEEF	NAPMTLEEF
ILPIVWNTL	ILPIVWNTL
SLVTGITAL	SLVTGITAL
NGPTHSSTL	NGPTHSSTL
HGPAHTKPL	HGPAHTKPL
SIPILASAL	SIPILASAL
FLHSQGTGQL	FLHSQGGQL
ALGDPASAL	ALGDPASAL
KLPERVTAL	KLPERVTAL
LLPSARPEL	LLPSARPEL
SAPSSDKPL	SAPSSDKPL
FLPKGYLAL	FLPKGYLAL
SAPAAAAGL	SAPAAAAGL
RSPDGRIAV	RSPDGRIAV
VAPGGATRL	VAPGGATRL
HLQEYTSTL	HLQEYTSTL
TSPVINVPL	TSPVINVPL
MAPYTPFLTEL	YTPFL-TEL
SGPSSPSSL	SGPSSPSSL
SIAEQAHEL	SIAEQAHEL
SVPDVTHHL	SVPDVTHHL
GGLPERSVSL	GLPERSVSL
RLHSVHPASL	RLHSVHASL
RVPRNIKSL	RVPRNIKSL
RLPEELRSL	RLPEELRSL
NAIPVDTVL	NAIPVDTVL
TTPSPTSSL	TTPSPTSSL
TMPRHSQSL	TMPRHSQSL
YAPPLPSLAL	YAPPLPLAL
SAPQHAEV	SAPQH-AEV
IAPKPAAHL	IAPKPAAHL
SIQTSVNAL	SIQTSVNAL
VTPSAMAEL	VTPSAMAEL
KAPEATVTL	KAPEATVTL
QVNGAATEL	QVNGAATEL
SAPKIFQAL	SAPKIFQAL
NSPIRSSAF	NSPIRSSAF
VAPRNSAEL	VAPRNSAEL
KAPPEHREL	KAPPEHREL
HVITKTMEL	HVITKTMEL
IFPEGFVEL	IFPEGFVEL
TLPQASNL	TLPQA-SNL
VAPLPRSAL	VAPLPRSAL
FYPIYFRPL	FYPIYFRPL
LIPPPLAPI	LIPPPLAPI
QTPLALRSL	QTPLALRSL
TCPGDRSAL	TCPGDRSAL
KGPKPTSSL	KGPKPTSSL
AAPGNKTSHL	AAPGNKSHL
YAPQGWIAF	YAPQGWIAF
SVPTLRSEL	SVPTLRSEL
SAPGPSGQSV	SAPGPSQSV
TSPLGSLS	TSPLG-SLS
SAPTARVF	SAPTA-RVF
MAPDSSMSM	MAPDSSMSM
SGPLHSVSL	SGPLHSVSL
LGPAALHAL	LGPAALHAL
IPHIHKSL	IPHIH-KSL
AAPFPRGEL	AAPFPRGEL
MTPSAKQSL	MTPSAKQSL
SAPRPTRFL	SAPRPTRFL
SAPKGSVL	SAPKG-SVL
NGPPHSHTL	NGPPHSHTL
YSPIIYQAL	YSPIIYQAL
VLPERYSSL	VLPERYSSL
SAPSRIINL	SAPSRIINL
TAPDAALTL	TAPDAALTL
LLPQNVLDL	LLPQNVLDL
SAPGTTMFL	SAPGTTMFL
KLFEHYYQEL	KLFEHYQEL
IAPNGAQVL	IAPNGAQVL
SIPELLSAV	SIPELLSAV
SAPEKRLTL	SAPEKRLTL
NVPVGKVL	NVPVG-KVL
AGPPDTISL	AGPPDTISL
SLSEKKNLTL	SLSEKKLTL
VVPDSAHKL	VVPDSAHKL
VFPDDMPTL	VFPDDMPTL
HVPGWLRPL	HVPGWLRPL
YAPHYDSTF	YAPHYDSTF
VTPVPGQTL	VTPVPGQTL
QLPAPKWTEL	QLPAPKTEL
RSPHPSSAL	RSPHPSSAL
HLPDMHSEL	HLPDMHSEL
VFQPVAEL	VFQPV-AEL
LSPQRKEAL	LSPQRKEAL
HVPAPKLAL	HVPAPKLAL
ATIDPDTISAL	IDPDTISAL
FITEEDYQAL	ITEEDYQAL
LAPTYLGEFSL	LAPTYLGEF
AASKERSGVSL	ASKERSVSL
YSPTSKAL	YSPTS-KAL
VVPVPLLSL	VVPVPLLSL
SGPASGHAL	SGPASGHAL
TAPIGHIL	TAPIG-HIL
NCPTHSTL	NCPTH-STL
TAPQAEHAM	TAPQAEHAM
SVPVAFSHF	SVPVAFSHF
IAEPGSVA	IAEPG-SVA
ASAPALTLS	ASAPALTLS
STPCPRTEM	STPCPRTEM
FLPGICKEL	FLPGICKEL
YLPTRVTAI	YLPTRVTAI
RVPLASQGL	RVPLASQGL
HLPESQSSSV	HLPESQSSV
SVPVSLQTL	SVPVSLQTL
LGPPGTSAL	LGPPGTSAL
NAPAAISFL	NAPAAISFL
GTPEGLYL	GTPEG-LYL
SSPLSKEL	SSPLS-KEL
HLPSGVKSL	HLPSGVKSL
YSPDAQACL	YSPDAQACL
NAPNHMEL	NAPNH-MEL
KLPQGYRSI	KLPQGYRSI
RAPVPASEL	RAPVPASEL
LFEDATSAL	LFEDATSAL
QGPDGRLEL	QGPDGRLEL
VLPQRIREL	VLPQRIREL
RIPSFVTEL	RIPSFVTEL
NCPERIITL	NCPERIITL
FVNSKSLSSL	FVNSKSSSL
ACPRTATAL	ACPRTATAL
VAPAAASSL	VAPAAASSL
FLPEAKRSL	FLPEAKRSL
HGPRAVSCL	HGPRAVSCL
HVHPKGPKSL	VHPKGPKSL
NCPHFKNAV	NCPHFKNAV
ILSKHQNSAL	ILSKHQSAL
QAPLALAHDGV	QAPLA-LAH
PAPGPHPAL	PAPGPHPAL
VSPAKNPSSL	VSPAKNSSL
HLAEKTSSL	HLAEKTSSL
SAPGPGLLL	SAPGPGLLL
FTPDGFRSL	FTPDGFRSL
ALHHYKPTPL	ALHHYKTPL
QSPFFPVVL	QSPFFPVVL
SLPFGTLEL	SLPFGTLEL
MTPLRALAL	MTPLRALAL
SAPGPHAVL	SAPGPHAVL
LLPSHPLEL	LLPSHPLEL
QTPDIKVSL	QTPDIKVSL
VLHLVGLDSL	VLHLVGDSL
RLPTSKRSL	RLPTSKRSL
IWPLHPSLL	IWPLHPSLL
TLPMRLLAL	TLPMRLLAL
VAPGQEKISSL	VAPGQESSL
RLPDDDPTAV	RLPDDDTAV
IFQTAKETL	IFQTAKETL
RLPDLRPWTSL	RLPDLRTSL
SSPSVSSTL	SSPSVSSTL
SGPPPRCSV	SGPPPRCSV
FLPQVMPTFL	FLPQVMTFL
SIPALTATL	SIPALTATL
FVPEPSSTM	FVPEPSSTM
FAPNPSLML	FAPNPSLML
FLPRQPPMSL	FLPRQPMSL
PDDTEAALL	PDDTEAALL
TMPTDVLEV	TMPTDVLEV
EAPERPSL	EAPER-PSL
VIQDFINAL	VIQDFINAL
KAPGTNVAM	KAPGTNVAM
YSPEVSSKAYL	YSPEVSSKA
KVFSTKSSL	KVFSTKSSL
KLPAFSPLM	KLPAFSPLM
LSPDSRASSL	LSPDSRSSL
LLPEHFLFL	LLPEHFLFL
VGPLRLVQL	VGPLRLVQL
RGPERRRAL	RGPERRRAL
RAPFSISAF	RAPFSISAF
NCPERIVTI	NCPERIVTI
GLPEKVLSL	GLPEKVLSL
VAPENFFSL	VAPENFFSL
IAPSGHGL	IAPSG-HGL
PVPALALAL	PVPALALAL
TAPQPGSAV	TAPQPGSAV
SPLPDRSLPAL	PLPDRSPAL
GSPTGAAL	GSPTG-AAL
SSPAPRTAL	SSPAPRTAL
YLPSSFPVL	YLPSSFPVL
RSPPPGMGL	RSPPPGMGL
LLPTSLNAL	LLPTSLNAL
VAPEEHPVL	VAPEEHPVL
SVPLSALEL	SVPLSALEL
TSPAGSSPAV	TSPAGSPAV
IFATVREL	IFATV-REL
LSPMSESTL	LSPMSESTL
RLPPLLSPL	RLPPLLSPL
LVPFSIKPL	LVPFSIKPL
RAPASAEAM	RAPASAEAM
FIPTEVSVL	FIPTEVSVL
HIIAGAGEL	HIIAGAGEL
NSPLRENSF	NSPLRENSF
GGLPEGPVL	GGLPEGPVL
AAPALASSL	AAPALASSL
TAPGFTAEM	TAPGFTAEM
VIPWGDMASL	VIPWGDASL
FTPPGCISL	FTPPGCISL
TFKESIVSL	TFKESIVSL
SAPSSSTPF	SAPSSSTPF
TYDDATKTF	TYDDATKTF
SAPTPIQAL	SAPTPIQAL
HLPEANHNSL	HLPEANNSL
FLPWPARPAL	FLPWPAPAL
YFPTKPMFV	YFPTKPMFV
AVPIYSSAL	AVPIYSSAL
SIPEKNRPL	SIPEKNRPL
LAPFTDEQL	LAPFTDEQL
IIHDPGRGAPL	HDPGRGAPL
FFPEDPVKI	FFPEDPVKI
TAPQTQHVSPM	TAPQT-QHV
RLNDAALRAL	RLNDAARAL
ELPLELPSDL	ELPLELSDL
SQPHSSAL	SQPHS-SAL
IAPGSQTVL	IAPGSQTVL
SSPEREITL	SSPEREITL
FVIPVVQAL	FVIPVVQAL
KSPVNTKSL	KSPVNTKSL
VIYDSNGVVL	VIYDSNVVL
GIPSRTASL	GIPSRTASL
SSPYSTDTL	SSPYSTDTL
SLPTLARAL	SLPTLARAL
TAPSMASVL	TAPSMASVL
VVPEPGTSL	VVPEPGTSL
HLHNNKIRSL	HLHNNKRSL
KVQAGNSSL	KVQAGNSSL
GQPEAVARL	GQPEAVARL
SSPASKTTL	SSPASKTTL
YGPMKSGNF	YGPMKSGNF
ESPRGNAL	ESPRG-NAL
YCPNDYHQL	YCPNDYHQL
VSPPAGRSL	VSPPAGRSL
YVPQRPYMTL	YVPQRPMTL
PAYHSSLMD	PAYHSSLMD
IIPRGADNL	IIPRGADNL
KIPDISSFL	KIPDISSFL
TSPVTARTL	TSPVTARTL
SVQRADTSL	SVQRADTSL
YVPLGPFL	YVPLG-PFL
VSPGPRPVL	VSPGPRPVL
IAPSFVKGFL	IAPSFVGFL
VLPSYEEAL	VLPSYEEAL
GIPGTRGPI	GIPGTRGPI
KCPEGTKPM	KCPEGTKPM
SSPGAVAGL	SSPGAVAGL
KVPFIINTL	KVPFIINTL
NIPSFAPVL	NIPSFAPVL
FAPRHYTEL	FAPRHYTEL
VGPGPTAAA	VGPGPTAAA
IVPVGEAL	IVPVG-EAL
AAPGGKTLAL	AAPGGKLAL
SLSVEEFMSL	SLSVEEMSL
NSPAGSTSV	NSPAGSTSV
RLPDHLIKDL	RLPDHLKDL
LLLTRPVWL	LLLTRPVWL
YLPSQVTEM	YLPSQVTEM
RIPVHSSAL	RIPVHSSAL
LAPTREIAV	LAPTREIAV
ITPLGSSEL	ITPLGSSEL
VIPPYYSYL	VIPPYYSYL
IVPNGITL	IVPNG-ITL
QSPASLSSL	QSPASLSSL
LSGPQRSALL	SGPQR-SAL
VSPFSLLEL	VSPFSLLEL
AAPPAAQTL	AAPPAAQTL
ILPRKDYESL	ILPRKDESL
GTPGSRPGL	GTPGSRPGL
AAPGPGRKEL	AAPGPGKEL
ASPSRLLSL	ASPSRLLSL
VSQVGKEL	VSQVG-KEL
HVPEHAVVL	HVPEHAVVL
VAPAGPASL	VAPAGPASL
TGPVAVASL	TGPVAVASL
VSPQHHEL	VSPQH-HEL
AAAAAATPGL	AAAAATPGL
LAPPAGSVL	LAPPAGSVL
IGPKGNSL	IGPKG-NSL
SAPIFTTSL	SAPIFTTSL
VAPVAGQL	VAPVA-GQL
VGPPAGSPF	VGPPAGSPF
LVPSDFLSV	LVPSDFLSV
AVPQGSKL	AVPQG-SKL
TVPATEQEL	TVPATEQEL
YSPPAFRFL	YSPPAFRFL
AGPDGTKSV	AGPDGTKSV
HAPFTATSL	HAPFTATSL
TIPDWLQAI	TIPDWLQAI
VGPYSTTVL	VGPYSTTVL
LAPSASVVL	LAPSASVVL
RLIKDTLAL	RLIKDTLAL
TNNLRPKKKV	NLRPK-KKV
SFQPTVVSL	SFQPTVVSL
TAPNGTRCL	TAPNGTRCL
SFHTTPNTSL	SFHTTPTSL
SSPAGGGAEAL	SSPAGGEAL
VSPSFSAEL	VSPSFSAEL
KILDKSQAL	KILDKSQAL
TLPAILNTL	TLPAILNTL
RIMEFTTTL	RIMEFTTTL
RLPPKVESL	RLPPKVESL
KFPEILATL	KFPEILATL
VGPLGSTI	VGPLG-STI
FSPKDVSSL	FSPKDVSSL
LLPELLSAL	LLPELLSAL
MLIEQARAL	MLIEQARAL
VLPLVLHAL	VLPLVLHAL
LSPFSGTSL	LSPFSGTSL
GGPPPVRAL	GGPPPVRAL
FSPDRSYAL	FSPDRSYAL
FSPLRIWDL	FSPLRIWDL
VIPDIPDHFL	VIPDIPHFL
ALHLQPLRSA	ALHLQPRSA
TAPLRAEL	TAPLR-AEL
LLNSATTSL	LLNSATTSL
NLPYGDLTEI	NLPYGDTEI
KGPSASAAL	KGPSASAAL
STPPPASEL	STPPPASEL
HAPDHTRHL	HAPDHTRHL
MLPSILNQL	MLPSILNQL
SSPSYENSL	SSPSYENSL
SGPGPAAAL	SGPGPAAAL
TIIPKVLAM	TIIPKVLAM
ILPVHITSL	ILPVHITSL
LAPFTAGTSL	LAPFTATSL
FVNPGILGSL	FVNPGIGSL
MAPSIMKSL	MAPSIMKSL
SVPVPATEL	SVPVPATEL
RSPSPKTSL	RSPSPKTSL
SSPGHIKEL	SSPGHIKEL
ASPTACRAV	ASPTACRAV
FIPWGPASI	FIPWGPASI
AVAAYRRAL	AVAAYRRAL
GPGPGPTTPL	PGPGPTTPL
SLDDRVLSSL	SLDDRVSSL
FVPIIGIAM	FVPIIGIAM
MAPGSTLWL	MAPGSTLWL
VAPNTSTNL	VAPNTSTNL
AIPLKASVL	AIPLKASVL
YISDFSVRAL	ISDFSVRAL
VAPGSVQCL	VAPGSVQCL
AAPTANLL	AAPTA-NLL
TVYLRDIAL	TVYLRDIAL
MSPIGTDL	MSPIG-TDL
ATPLSTLSL	ATPLSTLSL
SAPLGKMSL	SAPLGKMSL
ACPYYGSRL	ACPYYGSRL
DAPIPGSPL	DAPIPGSPL
TVPPPPAAL	TVPPPPAAL
ILPEQGVSAL	ILPEQGSAL
VSPNGQHL	VSPNG-QHL
NVGTGEAL	NVGTG-EAL
YLPSQPSSL	YLPSQPSSL
PLPDRSLPAL	PLPDRSPAL
VLSSLPLNSL	VLSSLPNSL
ISPWPGTTL	ISPWPGTTL
ARPPPGAAGL	RPPPGAAGL
FSPHSQAYF	FSPHSQAYF
ALHERELDSL	ALHEREDSL
KTPGPVRGL	KTPGPVRGL
FGPEWLRAL	FGPEWLRAL
LLNESPMLEL	LLNESPLEL
IIPETLLEL	IIPETLLEL
SANYTEIAL	SANYTEIAL
SAPRARHL	SAPRA-RHL
SLPKEAFLVL	SLPKEALVL
KSPEAATPV	KSPEAATPV
SLPNKVTEL	SLPNKVTEL
SANFSYNAL	SANFSYNAL
QTPVGVSTL	QTPVGVSTL
AAPSGSGTL	AAPSGSGTL
VGPSSDKAL	VGPSSDKAL
SAPESLQNL	SAPESLQNL
FGPSLAQEL	FGPSLAQEL
AGPPAAAEV	AGPPAAAEV
GPPGTGKTI	GPPGTGKTI
GWSQDLFRAL	WSQDLFRAL
FMPWVSQYL	FMPWVSQYL
RTPVTSTYL	RTPVTSTYL
VVQDVASAL	VVQDVASAL
LFENRLSSL	LFENRLSSL
FAPDGRYL	FAPDG-RYL
SAPVPFTVL	SAPVPFTVL
TVMDKTRAL	TVMDKTRAL
ASPAKGEPSL	ASPAKGPSL
QAPEATVL	QAPEA-TVL
NVPISFSQL	NVPISFSQL
VVPNKGYSSL	VVPNKGSSL
FMNSVIQSL	FMNSVIQSL
FVIETARQL	FVIETARQL
ILPNGAESL	ILPNGAESL
KGPEHMQSL	KGPEHMQSL
SVPFAATAT	SVPFAATAT
LSPLQLQSL	LSPLQLQSL
SGPERILSI	SGPERILSI
KVPRNTRAL	KVPRNTRAL
VIPQYHSSV	VIPQYHSSV
LAPSGDLSL	LAPSGDLSL
RIPAYFVTV	RIPAYFVTV
DSPAGKTNAL	DSPAGKNAL
SQPDAAREL	SQPDAAREL
FIISRTQAL	FIISRTQAL
RGPKPRKEL	RGPKPRKEL
SSPPPHPQL	SSPPPHPQL
SIPAFLSSL	SIPAFLSSL
TAPQGNKDL	TAPQGNKDL
NTPNGNSL	NTPNG-NSL
AAPTGTTI	AAPTG-TTI
FSPAGPIL	FSPAG-PIL
SAPDPVSTL	SAPDPVSTL
AAPGLIGNVM	AAPGLINVM
FLPNAPKAL	FLPNAPKAL
SLPYEPYKAL	SLPYEPKAL
KCPDIATQL	KCPDIATQL
FAPQHMAML	FAPQHMAML
VAPFFKSYI	VAPFFKSYI
LAPNIISQL	LAPNIISQL
RGPKKGSVL	RGPKKGSVL
KCPDHGLDL	KCPDHGLDL
RTPSSSSTL	RTPSSSSTL
NLSSNQITEL	LSSNQITEL
TLNKNNLTEL	TLNKNNTEL
KGPEGKYPL	KGPEGKYPL
AAPEETRAL	AAPEETRAL
GPPGTGKTL	GPPGTGKTL
YLPGSRQTL	YLPGSRQTL
FVDPNGKISL	VDPNGKISL
SIPDFPMHL	SIPDFPMHL
VFIDGPLAL	VFIDGPLAL
FCPEYSISL	FCPEYSISL
VFAEKITSL	VFAEKITSL
ILISTPESL	ILISTPESL
NTPSGTNAL	NTPSGTNAL
SLPLPNFSSL	SLPLPNSSL
VAPEKQATEL	VAPEKQTEL
VSPYTEIHL	VSPYTEIHL
TAPLSFRTL	TAPLSFRTL
SAPTVRNAM	SAPTVRNAM
RSPVFNHSL	RSPVFNHSL
YCPATKKTI	YCPATKKTI
SAPQRPVAM	SAPQRPVAM
LTNQPTLEL	LTNQPTLEL
LSPDGTVL	LSPDG-TVL
AAPEGKRSL	AAPEGKRSL
YAPARLAAA	YAPARLAAA
KVPAGVQEL	KVPAGVQEL
SLPTVGPSGL	SLPTVGSGL
SVPEAQSAL	SVPEAQSAL
WVPAGSREL	WVPAGSREL
SSPGSAGEL	SSPGSAGEL
YAPSGNYV	YAPSG-NYV
TSPSSSTAL	TSPSSSTAL
SVPVAEVL	SVPVA-EVL
FGPYNVSHL	FGPYNVSHL
VSPLNVTSV	VSPLNVTSV
KAPNAEDL	KAPNA-EDL
VFDPHGTL	VFDPH-GTL
SLPGPGFLAL	SLPGPGLAL
AVIGSTEEL	AVIGSTEEL
KLPYFMNEL	KLPYFMNEL
IIPESMFTSL	IIPESMTSL
FSPEPGFSL	FSPEPGFSL
FSPISDIGL	FSPISDIGL
MAPGTPKSL	MAPGTPKSL
YLPDSIVEL	YLPDSIVEL
RLPDGFTQL	RLPDGFTQL
RSPAGTTTL	RSPAGTTTL
AAPTAITEA	AAPTAITEA
RIPSAFRHL	RIPSAFRHL
FIPLNISCL	FIPLNISCL
YWPTYTPMEV	YWPTYTMEV
TIASQRLTPL	IASQRLTPL
TSPSTPSSL	TSPSTPSSL
IPPTKTRPL	IPPTKTRPL
FYPPDPAQL	FYPPDPAQL
LVPQARAL	LVPQA-RAL
LCPTHADSL	LCPTHADSL
TLPEENYQVL	TLPEENQVL
ILPISQESL	ILPISQESL
FLPGISTAL	FLPGISTAL
VLPWTSISSL	VLPWTSSSL
AAPLGTTL	AAPLG-TTL
YIPDYSVRAL	YIPDYSRAL
VAPSRIRTL	VAPSRIRTL
KLSNHVFNAL	KLSNHVNAL
ALAEIAKAEL	ALAEIAAEL
FSPTGEIL	FSPTG-EIL
VVPYGTPL	VVPYG-TPL
YWQNHPEL	YWQNH-PEL
ITPAAFSTL	ITPAAFSTL
YLPDGTASL	YLPDGTASL
RAPHASSL	RAPHA-SSL
SAPKYIDYL	SAPKYIDYL
RSPEACCEL	RSPEACCEL
VAPSAVNL	VAPSA-VNL
RLPGPGQAL	RLPGPGQAL
YIPEAILNL	YIPEAILNL
TGPVAKEL	TGPVA-KEL
YFPDKVALL	YFPDKVALL
MAPKAWTVL	MAPKAWTVL
APPKAHEV	APPKA-HEV
YTAFSERPL	YTAFSERPL
VLSAADKGNV	LSAADKGNV
YITNLEVKEL	ITNLEVKEL
KSPNRTTAV	KSPNRTTAV
YLPSNVSEL	YLPSNVSEL
RAPPSHRPL	RAPPSHRPL
FLPDANSSV	FLPDANSSV
YCPYSTQNL	YCPYSTQNL
RSPTATREV	RSPTATREV
SIPLAFACL	SIPLAFACL
TIIDKSKSV	TIIDKSKSV
PASGSDAASI	ASGSDAASI
SAPASQASL	SAPASQASL
VLPVGTEL	VLPVG-TEL
IFRVNLRTL	IFRVNLRTL
AAPFGFLGM	AAPFGFLGM
LSPEFFTSV	LSPEFFTSV
LAPVVSREL	LAPVVSREL
YAYDGKDYIAL	YAYDGKIAL
SAPSHSTSL	SAPSHSTSL
SLPGSPTHSL	SLPGSPHSL
ITPDKVRGL	ITPDKVRGL
VQPHTVTAL	VQPHTVTAL
TAPTGHTL	TAPTG-HTL
NSPSRNRSL	NSPSRNRSL
FTPNNIKQV	FTPNNIKQV
YFPEEIAKL	YFPEEIAKL
VMPGHAKRL	VMPGHAKRL
TLPDGTHEL	TLPDGTHEL
KCPFTGNVSI	KCPFTGVSI
HLPPTFHAV	HLPPTFHAV
IFEGGATEL	IFEGGATEL
ILHEIAVLEL	ILHEIALEL
VFVTVKEL	VFVTV-KEL
VAPEEHPV	VAPEE-HPV
VTPTSLSSL	VTPTSLSSL
VFLDHNAL	VFLDH-NAL
VAPSFGTLL	VAPSFGTLL
IVPFFVNAL	IVPFFVNAL
QAPIAAVL	QAPIA-AVL
SIPEAQWHSSL	SIPEAQSSL
SMNTASHSL	SMNTASHSL
SIPKNIQSL	SIPKNIQSL
AAPVATGAV	AAPVATGAV
SLPDTVNSL	SLPDTVNSL
RLPVNVREL	RLPVNVREL
LAPTRELAV	LAPTRELAV
YCPDYTVRAL	YCPDYTRAL
VTPNCRVAL	VTPNCRVAL
AGPSAFNITSL	AGPSAFTSL
ESGPSIVH	ESGPS-IVH
AGPTAHEL	AGPTA-HEL
RTPTSGQSV	RTPTSGQSV
SVPYPTASL	SVPYPTASL
LAPTDVKEL	LAPTDVKEL
QIAVGFLEL	QIAVGFLEL
VIAEHANDSL	VIAEHADSL
HVNVSGNEL	HVNVSGNEL
KLFSEKRVEL	LFSEKRVEL
AAPGGWLQV	AAPGGWLQV
SSPYSPAYL	SSPYSPAYL
RAPVHSSM	RAPVH-SSM
RINEILSNAL	RINEILNAL
LGPTGKEV	LGPTG-KEV
QGPGGASEL	QGPGGASEL
YAPVAFRYF	YAPVAFRYF
TGPITGLAL	TGPITGLAL
VTPSAIERL	VTPSAIERL
NSPGTYQEL	NSPGTYQEL
SSHKTFRIKRF	SSHKTFRIK
ALDASQHSSL	ALDASQSSL
NAPVHRLL	NAPVH-RLL
KLPEPSASL	KLPEPSASL
YAPSGRSL	YAPSG-RSL
YIIKQDINSL	IIKQDINSL
GIPDVRGL	GIPDV-RGL
TLPESSKLSSL	TLPESSSSL
SVIPDREYL	SVIPDREYL
ALPDIKVLTL	ALPDIKLTL
AAPTSAAAL	AAPTSAAAL
RPPSTPEGIAL	STPEG-IAL
QSPQGRVM	QSPQG-RVM
KIITKAKSL	KIITKAKSL
NAPSHPRAL	NAPSHPRAL
SSPAGGCREV	SSPAGGREV
SLIEQTTAL	SLIEQTTAL
SSPAGNSPAPL	SSPAGNSPA
FLPEAPAELL	FLPEAPAEL
NCPYSEINL	NCPYSEINL
LSPSPALAL	LSPSPALAL
LLPEYPGVL	LLPEYPGVL
FLPGGEYQEL	FLPGGEQEL
EAPFSNLEL	EAPFSNLEL
SSPSPGSSL	SSPSPGSSL
FLPPNMQGL	FLPPNMQGL
FIMDRAQAL	FIMDRAQAL
KVPSGGQEL	KVPSGGQEL
YLPGRPIAEL	YLPGRPAEL
LFEPVINAL	LFEPVINAL
SVPENKGISL	SVPENKISL
LGPANVRPL	LGPANVRPL
VLLPAASEL	VLLPAASEL
FGHPLAPQAL	FGHPLAQAL
TAPTGEYL	TAPTG-EYL
KSPGKVKEV	KSPGKVKEV
KIGEHTPSAL	KIGEHTSAL
KAPSFETAL	KAPSFETAL
TAPIRSPAL	TAPIRSPAL
QLHRQGLLSL	QLHRQGLSL
YGSDRRLAEL	YGSDRRAEL
VMPGHSESL	VMPGHSESL
VCPPPGYGL	VCPPPGYGL
VSPRGAGYL	VSPRGAGYL
FSPLVTSTL	FSPLVTSTL
TGPIFSMAL	TGPIFSMAL
LLPDQPPYHL	LLPDQPYHL
MTPGPWLGL	MTPGPWLGL
YAPGLDIESSL	YAPGLDSSL
FIAPTGHSL	FIAPTGHSL
FAPYGTVM	FAPYG-TVM
VFLPSHSL	VFLPS-HSL
AMPFKCMQL	AMPFKCMQL
SSPTVNTTL	SSPTVNTTL
FISPTGHSL	FISPTGHSL
SIPGGYNAL	SIPGGYNAL
VGPVAQQAI	VGPVAQQAI
YTPEGTVL	YTPEG-TVL
VAPRSGLAA	VAPRSGLAA
AAPGPSAAF	AAPGPSAAF
SVPSAKVSL	SVPSAKVSL
SAPVSQESL	SAPVSQESL
PMSESTLSI	PMSESTLSI
SVPNVHGAL	SVPNVHGAL
SVLAAANSV	SVLAAANSV
FSPSGHLL	FSPSG-HLL
NAPGYGPII	NAPGYGPII
QSPDGVLDL	QSPDGVLDL
LLPPPSPSL	LLPPPSPSL
AMPGLASFL	AMPGLASFL
YGPEGLEL	YGPEG-LEL
AGPGPGAVL	AGPGPGAVL
FISDLSINSL	ISDLSINSL
SAPGPGYAPL	SAPGPGAPL
TLPVASAL	TLPVA-SAL
VAPIAEQL	VAPIA-EQL
NSPEKACSL	NSPEKACSL
FVPAPWLSV	FVPAPWLSV
YLPTGFFSL	YLPTGFFSL
LAPEPPTAL	LAPEPPTAL
SAPEPRVTL	SAPEPRVTL
MLPDWKSSL	MLPDWKSSL
VLSPLPAGNAL	LSPLPANAL
KTPQGLSNL	KTPQGLSNL
RTPLHEIAL	RTPLHEIAL
ISLAPTDVKEL	LAPTDVKEL
VIPSVTRVL	VIPSVTRVL
SAPFVARAL	SAPFVARAL
SAPGPITMDL	SAPGPIMDL
TAPRPGALL	TAPRPGALL
AAPTARKQL	AAPTARKQL
TTYKLVINGK	VINGK----
YLPGGTTGL	YLPGGTTGL
RTPVAKEL	RTPVA-KEL
FHPVHGTL	FHPVH-GTL
ALPSMPRAL	ALPSMPRAL
SSPLGKRPL	SSPLGKRPL
GAPFSWDSL	GAPFSWDSL
MLPAEGVKEL	MLPAEGKEL
VSPTKKVAV	VSPTKKVAV
FIPFSVSSV	FIPFSVSSV
ASPVTNNTI	ASPVTNNTI
RWPKKSAEF	RWPKKSAEF
QLPVLPWSEV	QLPVLPSEV
LCPNSNNSL	LCPNSNNSL
NAPTCTVEM	NAPTCTVEM
ILAEFKVRAL	ILAEFKRAL
LLPLFLAQL	LLPLFLAQL
VAPKETAEL	VAPKETAEL
TGPAHRAAL	TGPAHRAAL
SLPAEVHSL	SLPAEVHSL
TLPHGAGHL	TLPHGAGHL
VIPPNCIQL	VIPPNCIQL
YSPQRERPL	YSPQRERPL
VAPVAPVAV	VAPVAPVAV
KIPEESKAL	KIPEESKAL
AAPAAAGAAL	AAPAAAAAL
MLPMKVRAL	MLPMKVRAL
LVPKRDHAL	LVPKRDHAL
YMSPHPSPL	YMSPHPSPL
VLPEHVSVL	VLPEHVSVL
MAPPPPRSV	MAPPPPRSV
YGPPPGMAL	YGPPPGMAL
SLPSFHAIM	SLPSFHAIM
LGPCSFAEL	LGPCSFAEL
SLPSKPSSTL	SLPSKPSTL
TVPLPASQL	TVPLPASQL
FDSLQGFVIV	SLQGF-VIV
NIPKDTSQL	NIPKDTSQL
LSPGGRAEL	LSPGGRAEL
SAPAGETL	SAPAG-ETL
EGPPVTTVL	EGPPVTTVL
SSPGPSLSL	SSPGPSLSL
SVPSAVSSL	SVPSAVSSL
IVPPTFSAL	IVPPTFSAL
FTPAVHASL	FTPAVHASL
SAPSAIAL	SAPSA-IAL
SIPSHSSEL	SIPSHSSEL
IAPSHVIEM	IAPSHVIEM
ASPESISSL	ASPESISSL
NGPTHMEL	NGPTH-MEL
LLPDEVSTL	LLPDEVSTL
VVPRGSTL	VVPRG-STL
HIPVAGHAL	HIPVAGHAL
SPLPIVRSNL	PLPIVRSNL
KAPVTVTSL	KAPVTVTSL
FLPEFPSCSL	FLPEFPCSL
AGPSIRGAL	AGPSIRGAL
TVPRSASVL	TVPRSASVL
NLPGEVTFLPL	NLPGEVTFL
SSPIGKSV	SSPIG-KSV
VSPEIFQFL	VSPEIFQFL
TSPPPRDFL	TSPPPRDFL
GTPSRASLI	GTPSRASLI
SAPVPASTL	SAPVPASTL
AGPPPTRAL	AGPPPTRAL
IVAKHTSAL	IVAKHTSAL
TVNGGHPPSAL	TVNGGHSAL
GAPSKTSSL	GAPSKTSSL
FAPPNTSDM	FAPPNTSDM
SAPVSERMNAL	SAPVSENAL
FGPEQQKEL	FGPEQQKEL
LGALLFRTPL	GALLFRTPL
FLPDGCDHL	FLPDGCDHL
FLQGDTSVL	FLQGDTSVL
SSLPAGAAL	SSLPAGAAL
VIDEIGKMEL	VIDEIGMEL
KIPEDQHAL	KIPEDQHAL
DRVYIHPFHL	RVYIHPFHL
VAPVGSGL	VAPVG-SGL
VAPSTVKEV	VAPSTVKEV
FSPLAINAF	FSPLAINAF
SVQSGNLAL	SVQSGNLAL
AAPWTEETV	AAPWTEETV
VVPESFLGL	VVPESFLGL
SAPESKHKSSL	SAPESKSSL
MSPLSETEM	MSPLSETEM
AVPFSLDSV	AVPFSLDSV
VAPKSTTFL	VAPKSTTFL
NLPANNSSL	NLPANNSSL
TCPGDRSAI	TCPGDRSAI
SSPPLRHAV	SSPPLRHAV
QVIEKTKSL	QVIEKTKSL
LSNAIVGSGI	NAIVG-SGI
TSPGGNAEAL	TSPGGNEAL
AAPDKRSKL	AAPDKRSKL
