Data	Data aligned
DVGGYKLLNNW	DVGGLLNNW
EIIPMFSNL	EIIPMFSNL
ETFSGVYKKL	ETFSVYKKL
EVKGQTSGSVW	EVKGTSGSV
EVIKLKGYTNW	EVIKGYTNW
EAIQDLWQW	EAIQDLWQW
ETLKLISGW	ETLKLISGW
SAIDTWSPSEW	AIDTSPSEW
DMAFRYLSW	DMAFRYLSW
EVPENNGNNSW	EVPEGNNSW
GVIDVITKTW	GVIDITKTW
EVVPEPVARW	EVVPPVARW
ETTVKLLEF	ETTVKLLEF
EVAVKMKQY	EVAVKMKQY
NTVDSIESF	NTVDSIESF
EVKLGELPSW	EVKLELPSW
EVVDNSSNW	EVVDNSSNW
DIIGVAGNHW	DIIGAGNHW
EVMEQQTISI	EVMEQTISI
EISERIVQW	EISERIVQW
EVKKTLQQF	EVKKTLQQF
DSLPSVSSI	DSLPSVSSI
EVVAEVQEF	EVVAEVQEF
AVKVAKGLAW	AVKVKGLAW
DVVKEDAFYSW	VVKEAFYSW
ETFWETTKW	ETFWETTKW
EVAKSLSAL	EVAKSLSAL
AVIGDVIRVY	AVIGVIRVY
EVATRMQSF	EVATRMQSF
VPALEASAP	VPALEASAP
EVTDHNLHEL	EVTDNLHEL
EVISGYEEL	EVISGYEEL
EIFDGNVAHI	EIFDNVAHI
LEVIPGYEE	LEVIPGYEE
EVINGNIKTV	EVINNIKTV
HIIGRIESY	HIIGRIESY
ETTDLLAHW	ETTDLLAHW
EVVAKVMEL	EVVAKVMEL
MAPERVASL	MAPERVASL
EVYDQEVGTSY	EVYDVGTSY
ETTDSILSHF	ETTDILSHF
EIPEQFLSY	EIPEQFLSY
ETFYNEKEESF	ETFYKEESF
SIDISQSRSW	SIDIQSRSW
MPVGPDAILRY	PVGPAILRY
EVFSFKMVSY	EVFSKMVSY
ETSEQVTRW	ETSEQVTRW
NVVGFPLNHF	NVVGPLNHF
ETYRGGMAI	ETYRGGMAI
DVINSRTQGF	DVINRTQGF
QTVDQRLSSW	QTVDRLSSW
ETFGHLGALGF	ETFGHLGAL
DVTGVVRQW	DVTGVVRQW
AKNKLNDLED	-AKNKLNDL
INSDPVDL	-INSDPVDL
NVEIDPEIQ	NVEIDPEIQ
EVIKLKGYTSW	EVIKGYTSW
EAKPHMESY	EAKPHMESY
TVVVRIMEF	TVVVRIMEF
AVIAIFKSY	AVIAIFKSY
DAASGEVVGKF	AASGVVGKF
DVPGFAIGGL	DVPGAIGGL
EIVTTIPTI	EIVTTIPTI
DAVGRVQGW	DAVGRVQGW
SVNDGKQASW	SVNDKQASW
DVRERLQAW	DVRERLQAW
ETIDVHSGY	ETIDVHSGY
EVISVLQKY	EVISVLQKY
FTKPPIGTW	FTKPPIGTW
EVKEDIAKL	EVKEDIAKL
YTKDYTEGW	YTKDYTEGW
GLKETQNMAW	GLKEQNMAW
HVVPDQLMAF	HVVPQLMAF
DVIDNIMRL	DVIDNIMRL
TVIGITPSSF	TVIGTPSSF
ELMDHGIVSW	ELMDGIVSW
ESRDGRVDSW	ESRDRVDSW
NVKDLTQAW	NVKDLTQAW
DLIKETKLS	DLIKETKLS
EVVENLLNY	EVVENLLNY
QVADVVVSRW	QVADVVSRW
ETYIRSGTY	ETYIRSGTY
ETIERLQQL	ETIERLQQL
EQTPIHISW	EQTPIHISW
ETMDKKFGSSW	ETMDFGSSW
FNEKSKEL	-FNEKSKEL
EAYSAKIALF	EAYSKIALF
VGLDVTTFSKP	--VGDVTTF
EIYTRDGNSY	EIYTDGNSY
EIMDKAYDKF	EIMDAYDKF
EVLPSTRLGTL	EVLPRLGTL
STIDDTISKF	STIDTISKF
ETHRDLSSW	ETHRDLSSW
SAPKGSVL	-SAPKGSVL
EAFEKSAATW	EAFESAATW
DTPEEIARW	DTPEEIARW
DLNPRRDISSW	DLNPDISSW
EVAAAIAGY	EVAAAIAGY
EVAADALGEEW	EVAALGEEW
EAYNSLMKSY	EAYNLMKSY
EVPSMASSW	EVPSMASSW
DVKPFVPRF	DVKPFVPRF
EVPKPFPTHY	EVPKFPTHY
AVMDHVSDSF	AVMDVSDSF
IEEHLGKF	-IEEHLGKF
ELMYGGVSSY	ELMYGVSSY
EVYDDFLHY	EVYDDFLHY
MVIEIPVQGW	MVIEPVQGW
ENMWNTGSTY	ENMWTGSTY
EVVTTIPTI	EVVTTIPTI
EVVDSMVQHF	EVVDMVQHF
EVTPQSKIAW	EVTPSKIAW
EIYGGSDSRF	EIYGSDSRF
EVAEESGRLW	EVAEESGRL
EVISSVSEL	EVISSVSEL
EVTTHILSQF	EVTTILSQF
SVPDALQKW	SVPDALQKW
DIVPPASTW	DIVPPASTW
ISPTGHSL	-ISPTGHSL
DTVTKELVSW	DTVTELVSW
AVYERELQTF	AVYEELQTF
EVLEHFQAF	EVLEHFQAF
DTYPEESRSY	DTYPESRSY
DTMEFIRSF	DTMEFIRSF
HVPFKFQSF	HVPFKFQSF
YIYDKDMEII	YIYDKDMEI
ETIASVRSL	ETIASVRSL
EVAGPREAF	EVAGPREAF
DVVNKDDIIEW	DVVNDIIEW
ELSSQMSSF	ELSSQMSSF
NVREALQAW	NVREALQAW
YINPAKLTPY	YINPKLTPY
SVPRDLPSW	SVPRDLPSW
EVRGGGLTRY	EVRGGLTRY
ELIQAKVGSF	ELIQKVGSF
EVLPAALAVY	EVLPALAVY
EVIPLVQTF	EVIPLVQTF
ETPPLFHSY	ETPPLFHSY
EVKEMMTTW	EVKEMMTTW
HVFDANTLTW	HVFDNTLTW
EPVERVSTW	EPVERVSTW
FVYDVTKMTSF	YDVTKMTSF
DVIADIQTI	DVIADIQTI
ETPRSVPGF	ETPRSVPGF
SIKEKISMW	SIKEKISMW
EVIESTNLKY	EVIETNLKY
YVLISKPTEW	YVLIKPTEW
EIKEVILEF	EIKEVILEF
EVNDIKTRSW	EVNDKTRSW
EVPTQLVSY	EVPTQLVSY
DVIRLIMQY	DVIRLIMQY
FVVEQVESY	FVVEQVESY
EIYDRREYSRF	EIYDEYSRF
TVYTGIDHHW	TVYTIDHHW
EVIQEIKSF	EVIQEIKSF
ETVNHHYLLF	ETVNHYLLF
VVKERVTEW	VVKERVTEW
ETVTIEQTSW	ETVTEQTSW
EVHEKLRGW	EVHEKLRGW
SAPYGRITL	SAPYGRITL
NVVGGRRSAW	NVVGRRSAW
TTVERRFSSW	TTVERFSSW
ETFQQKMLRF	ETFQKMLRF
DVTGPHEAF	DVTGPHEAF
EVEGAGVKAW	EVEGGVKAW
ETIDAHDGALW	ETIDHDGAL
GEIAAAVSF	GEIAAAVSF
EVITGIRII	EVITGIRII
SVVSWKTGVF	SVVSKTGVF
YTKFQIATW	YTKFQIATW
DPDVLNSL	-DPDVLNSL
VPKTAENFRQF	KTAENFRQF
EVVPEYVTL	EVVPEYVTL
HTADVQLHAW	HTADQLHAW
EVRQGLKAY	EVRQGLKAY
ELIERIPEL	ELIERIPEL
DIISRIPKI	DIISRIPKI
EIVPFRVAAY	EIVPRVAAY
ETYNLLSERW	ETYNLSERW
HVFEDSYREL	HVFESYREL
ETKNTLRAF	ETKNTLRAF
DIIDDVDSF	DIIDDVDSF
EVASVYQSY	EVASVYQSY
EVKLKVDSF	EVKLKVDSF
ETFHHSSNW	ETFHHSSNW
ELMTHHVHTY	ELMTHVHTY
EVQDSYEAY	EVQDSYEAY
EVASALRSF	EVASALRSF
TGYAVWLVLW	TGYAWLVLW
YTHEVVTLW	YTHEVVTLW
EIPEGYVPEHW	EIPEVPEHW
HTSSTTSAW	HTSSTTSAW
SVVDDIPEF	SVVDDIPEF
FVADINSGHW	FVADNSGHW
YVQDRVPSY	YVQDRVPSY
ELHNGTTQSW	ELHNTTQSW
ETIETINQL	ETIETINQL
HIYTFPHASF	HIYTPHASF
SVIEEHANW	SVIEEHANW
GVIEKLLTSY	GVIELLTSY
ITPTGTHPL	ITPTGTHPL
HVIEDIKGRW	HVIEIKGRW
NVKDYYQKW	NVKDYYQKW
EIVKQITSI	EIVKQITSI
EAYNIRTDSW	EAYNRTDSW
EVVNLFLHF	EVVNLFLHF
EVHMLDIESF	EVHMDIESF
APPERKYSVW	APPEKYSVW
DVARHFIQRW	DVARFIQRW
SVVGGFVSHY	SVVGFVSHY
QVADAFLSKF	QVADFLSKF
EVAPALSVF	EVAPALSVF
DVISSIRNF	DVISSIRNF
HVKDPQSGEW	HVKDQSGEW
NVHQSVISSW	NVHQVISSW
ETFGFRGEAL	ETFGRGEAL
ETKKQYDSF	ETKKQYDSF
GVFEGKLNVI	GVFEKLNVI
TVVGKTYGLW	TVVGTYGLW
DTIARALPFW	DTIAALPFW
ELVKKIAIY	ELVKKIAIY
DIKPNFPSW	DIKPNFPSW
EIYQKPFQTL	EIYQPFQTL
NIVDKTASF	NIVDKTASF
EANDRNETW	EANDRNETW
EIAPGLTGSEW	EIAPTGSEW
SSLLEKGLD	SSLLEKGLD
EVTEVKVSSW	EVTEKVSSW
EVPKKLTEW	EVPKKLTEW
ETVGKFIQY	ETVGKFIQY
EIVKKYTQF	EIVKKYTQF
EVIDEKVQHI	EVIDKVQHI
ELIRTIMGW	ELIRTIMGW
EVITKFINV	EVITKFINV
EVRTGGMAF	EVRTGGMAF
TVPEKIGVF	TVPEKIGVF
HTIKPALVGW	HTIKALVGW
EVIPPMKEF	EVIPPMKEF
EVAEKAGTF	EVAEKAGTF
EVVAGIKEY	EVVAGIKEY
EIIKHMAKL	EIIKHMAKL
EVAQHLAATY	EVAQLAATY
ETIRPEETAW	ETIREETAW
SVVEKLLTNW	SVVELLTNW
ESAPVHNSF	ESAPVHNSF
DVVSGSEVLHW	DVVSGSEVL
ETIESINQL	ETIESINQL
HIAENILSY	HIAENILSY
EIMRAGMSSL	EIMRGMSSL
EVFTGGIGSY	EVFTGIGSY
SVPEAQSAL	SVPEAQSAL
ETVVERMLSNW	TVVEMLSNW
EVMEIMSRF	EVMEIMSRF
ETIRNIPHL	ETIRNIPHL
HVHSEFESF	HVHSEFESF
DVVKKIESF	DVVKKIESF
ELIAKIPNF	ELIAKIPNF
EVTELLARY	EVTELLARY
LEDALQQAKED	DALQQAKED
EVALGGLQSW	EVALGLQSW
TILPGNLQSW	TILPNLQSW
HIYEKSGAKW	HIYESGAKW
EAVGSVHQAW	EAVGVHQAW
DVIRKPPRNW	DVIRPPRNW
EVFTGGISSY	EVFTGISSY
EVNTEKLTAF	EVNTKLTAF
EVMKYITSL	EVMKYITSL
SVIATIQEY	SVIATIQEY
HTAPSGVGSSW	TAPSVGSSW
EIYEESSTW	EIYEESSTW
EVSQKFTSI	EVSQKFTSI
EVFPLKVFGY	EVFPKVFGY
YVIQKFFEF	YVIQKFFEF
PGPGSSELR	PGPGSSELR
EIMEHRFKTY	EIMERFKTY
FTAGPDEVRAW	AGPDEVRAW
EAAGSSLIGHL	EAAGLIGHL
SIPDIQAHEW	SIPDQAHEW
SVPRGPIAQW	SVPRPIAQW
EVAGHLRTY	EVAGHLRTY
DVISSIRQL	DVISSIRQL
DVNGKIIVW	DVNGKIIVW
EVIEKFDYV	EVIEKFDYV
SVYAFSARPL	SVYASARPL
EVREEYITAF	EVREYITAF
ESSPGGNLGW	ESSPGNLGW
EVYAGSHQY	EVYAGSHQY
EVLDHMGTF	EVLDHMGTF
HVHVHDLQSF	HVHVDLQSF
HVANGPLLHHW	HVANLLHHW
DIPTDFEGW	DIPTDFEGW
DTQKEGTAW	DTQKEGTAW
HVPNFIFDEF	HVPNIFDEF
EVITNRPKGF	EVITRPKGF
EVGRITKW	-EVGRITKW
EIMDRAYDSF	EIMDAYDSF
ETVKEILSI	ETVKEILSI
EVVSPLSSW	EVVSPLSSW
DQKADVSAW	DQKADVSAW
EVFMHVSTAY	EVFMVSTAY
SVVEAIPEF	SVVEAIPEF
LVFPYTHQNW	LVFPTHQNW
YIHSGLYSSF	YIHSLYSSF
ETPTFKDHSF	ETPTKDHSF
ETIESRLSEL	ETIERLSEL
EVIITPNSAW	EVIIPNSAW
EVRVGVTQAY	EVRVVTQAY
ELIRYISEL	ELIRYISEL
ETIDWKVFESW	ETIDVFESW
QVYHGLMERY	QVYHLMERY
TYDDATKTF	TYDDATKTF
EVYEHVYETV	EVYEVYETV
DAAQHTRTW	DAAQHTRTW
EIYPPEVAEF	EIYPEVAEF
QTPAHIAAF	QTPAHIAAF
ETFKEQGNAY	ETFKQGNAY
EVANHVVQAL	EVANVVQAL
ELFMSSFQSY	ELFMSFQSY
EVIDKNSGGW	EVIDNSGGW
EVVGYFGRF	EVVGYFGRF
HTVEDYQAI	HTVEDYQAI
EVIEKKPEKF	EVIEKPEKF
EVIENRMAVL	EVIERMAVL
ETPGQILGW	ETPGQILGW
EVMNQNLAYY	EVMNQNLAY
EVYEGVYTNH	EVYEVYTNH
VGLDVSLPK	VGLDVSLPK
AVFNRAFYSW	AVFNAFYSW
TLPPPKVVDRW	LPPPVVDRW
EVVGPEGMEKF	EVVGGMEKF
ETHTNEFITW	ETHTEFITW
EITPRIRVW	EITPRIRVW
EIVKEVSTY	EIVKEVSTY
IAPTGHSL	-IAPTGHSL
EIIKIIGKY	EIIKIIGKY
DVYWKIYNSI	DVYWIYNSI
EVAPDAKSF	EVAPDAKSF
MVADRFSEL	MVADRFSEL
YSLEGEVTHW	YSLEEVTHW
ETIVIINKF	ETIVIINKF
EAAGPHEAF	EAAGPHEAF
DTISPTLGF	DTISPTLGF
DVVKTYKSF	DVVKTYKSF
SVVGAISSY	SVVGAISSY
EVISKTPTL	EVISKTPTL
FEVDTVAP	-FEVDTVAP
FTVDQIRAI	FTVDQIRAI
DVIIHEISHSW	DVIIISHSW
EVIASIISRY	EVIAIISRY
EVIPGYEEL	EVIPGYEEL
ESIQGLSSW	ESIQGLSSW
STPTPFFHTF	STPTFFHTF
TVETVEVVN	TVETVEVVN
DTYDDRAYSSF	DTYDAYSSF
ELIREYLEF	ELIREYLEF
DTKQMMSSF	DTKQMMSSF
EVFTGHMGKL	EVFTHMGKL
EVAPGALLGL	EVAPALLGL
AIIERTASF	AIIERTASF
EVADRLFSSF	EVADLFSSF
EIHIQIGQF	EIHIQIGQF
EVLGPKPTFW	EVLGPKPTF
EIMTRIQTY	EIMTRIQTY
DLIGHIVEF	DLIGHIVEF
EAATRLSAY	EAATRLSAY
DVIDNDSWRLW	DVIDDSWRL
EVAPAKDVTLL	EVAPKDVTL
EVAPVISSAY	EVAPISSAY
HTFQNDIHVY	HTFQDIHVY
HTAPPENKTW	HTAPENKTW
EALGVPYEQW	EALGPYEQW
SSIDHESSTW	SSIDESSTW
EVAPSFGTL	EVAPSFGTL
HVPGADILNSY	HVPGILNSY
NTINLIHTF	NTINLIHTF
TTISRFEAL	TTISRFEAL
ELMHSIVGSY	ELMHIVGSY
DTFGPRAQGW	DTFGRAQGW
ITKDVVLQW	ITKDVVLQW
SVAVGSGLSW	SVAVSGLSW
EIIHEIAVL	EIIHEIAVL
EVIQNMTEF	EVIQNMTEF
EVINKEDFVAL	EVINDFVAL
EIIGPYASW	EIIGPYASW
EVYPFGIVGM	EVYPGIVGM
HVIEDIKGKW	HVIEIKGKW
EIAGTVVGHW	EIAGVVGHW
HVGPILVGW	HVGPILVGW
EIFFHYSEF	EIFFHYSEF
SLPEHNLITW	SLPENLITW
EIIGKRGIIGY	EIIGGIIGY
TVKETIHMF	TVKETIHMF
TVIEEHLGKF	TVIEHLGKF
EVFDKDLSKL	EVFDDLSKL
HVVAHFHEW	HVVAHFHEW
HTATHILNF	HTATHILNF
DLPQSIGMW	DLPQSIGMW
AVKNQIALW	AVKNQIALW
EVISHIGKL	EVISHIGKL
SVVYGIGTW	SVVYGIGTW
KAPAPRPSL	KAPAPRPSL
EVFDPDANTW	EVFDDANTW
ETVRQIRQI	ETVRQIRQI
TTYKLVINGK	TTYKVINGK
EVFIHKDKGF	EVFIKDKGF
FSAEQIARW	FSAEQIARW
ETVADVRTL	ETVADVRTL
EQVEERLSF	EQVEERLSF
LAADFEIGHF	LAADEIGHF
DVFRATYAAF	DVFRTYAAF
EVKRPGESL	EVKRPGESL
ETRPAGDGTF	ETRPGDGTF
ETVWRLEEF	ETVWRLEEF
ETNTVVQTY	ETNTVVQTY
EVIQHRFESL	EVIQRFESL
DAAAGMLSF	DAAAGMLSF
EVVGVYGSF	EVVGVYGSF
YLPDYRMKEW	YLPDRMKEW
EVSSISSKF	EVSSISSKF
DVTEQISRF	DVTEQISRF
HVATEPVATW	HVATPVATW
STAPGYYSW	STAPGYYSW
ESIEYVQTF	ESIEYVQTF
EVKGFVRENVW	EVKGFVREN
EAVKQYSSY	EAVKQYSSY
ETFDDLPKW	ETFDDLPKW
EVILKNITW	EVILKNITW
EVVRKILLL	EVVRKILLL
LEEALQQAKED	EALQQAKED
DVAPTQPRW	DVAPTQPRW
TVLPGEIQNW	TVLPEIQNW
ETVDPASLWEY	ETVDPASLW
SVIDIINKY	SVIDIINKY
ELIAKIPNFW	ELIAKIPNF
GTIAEVGKW	GTIAEVGKW
DALDIHPVGW	DALDHPVGW
ETMTEKLVKF	ETMTKLVKF
DIYNFPIHAF	DIYNPIHAF
ETITKFLQL	ETITKFLQL
EVVNKDVLDVY	EVVNVLDVY
LVKTEIPNW	LVKTEIPNW
EVADELVSEF	EVADLVSEF
EVMSLMSSL	EVMSLMSSL
PINGNGKQ	-PINGNGKQ
EVIPPYYSY	EVIPPYYSY
EIAGHIMEF	EIAGHIMEF
MVVPEDQLTRW	VVPEQLTRW
EATHVLPLHW	EATHLPLHW
EVYAHAGATL	EVYAAGATL
AVREGSPANW	AVRESPANW
YAPKGSSL	-YAPKGSSL
DSKSKGLQW	DSKSKGLQW
EVIWSHAIQKY	EVIWAIQKY
QVIEKFEAL	QVIEKFEAL
EIYPPKLHQF	EIYPKLHQF
IEKLLTSY	-IEKLLTSY
EVVSVLHVF	EVVSVLHVF
DVAPTRPRW	DVAPTRPRW
EIFPLETPAF	EIFPETPAF
TVAFVPISGW	TVAFPISGW
GTIKKFLSL	GTIKKFLSL
EAAPGTIRGDF	EAAPTIRGD
HTIGKTVEY	HTIGKTVEY
DTTSFDSAW	DTTSFDSAW
HVADENLKAF	HVADNLKAF
YVTGIIGKW	YVTGIIGKW
DVVDKTPVI	DVVDKTPVI
DQIPQQTAW	DQIPQQTAW
IIIPSYASW	IIIPSYASW
PDEVIKKW	-PDEVIKKW
EVIIPHSGW	EVIIPHSGW
EAIEQILKY	EAIEQILKY
ELKEFFMSF	ELKEFFMSF
DVIGTLSGF	DVIGTLSGF
LNLPEAASY	LNLPEAASY
EVADEKMLSGL	EVADKMLSG
EVVGYLGGRW	EVVGLGGRW
TEKPEVID	-TEKPEVID
NVVGARRSSW	NVVGRRSSW
HVAPVTSVEW	HVAPTSVEW
EIAEKMATF	EIAEKMATF
NVIDKLAQF	NVIDKLAQF
EALGTLMRAW	EALGLMRAW
QLIERILEAW	QLIEILEAW
TYDDATKTFT	TYDDATKTF
ELTEEINKW	ELTEEINKW
SVVPPPLPATW	VVPPLPATW
GAPDAKFSGW	GAPDKFSGW
SVVDDWIESY	SVVDWIESY
YIIQNIPGF	YIIQNIPGF
EVNNFPPQSW	EVNNPPQSW
EVAQQGTMW	EVAQQGTMW
EVYAKANSF	EVYAKANSF
YLPDGTASL	YLPDGTASL
AVHDRLLNVW	AVHDLLNVW
FVTEYTPRSW	FVTETPRSW
AVLSSSLTHW	AVLSSLTHW
EVYDPTTNAW	EVYDTTNAW
EVAPAGASY	EVAPAGASY
AVVGQYQSY	AVVGQYQSY
DVISNIETF	DVISNIETF
EVQSLYREI	EVQSLYREI
TTSTRIGKF	TTSTRIGKF
EAIYETHTW	EAIYETHTW
EVISSLEKY	EVISSLEKY
DVVTKYSNF	DVVTKYSNF
HTADISSHF	HTADISSHF
PEGYVPEHW	PEGYVPEHW
DVSPVVSTY	DVSPVVSTY
ETKEVYRHF	ETKEVYRHF
EVIGQVLSTL	EVIGVLSTL
NIPEAIASY	NIPEAIASY
ELKERIREY	ELKERIREY
ETMDREFRKW	ETMDEFRKW
ELRPGLIGW	ELRPGLIGW
EVVTALTTL	EVVTALTTL
DTIYSILHHF	DTIYILHHF
ETKKPEVASW	ETKKEVASW
EIVGTLLGF	EIVGTLLGF
EQINAKVAEW	EQINKVAEW
DTKDPAVTEW	DTKDAVTEW
NVIGARRASW	NVIGRRASW
DTPGHGSGW	DTPGHGSGW
ETAGRYITY	ETAGRYITY
DTMDHYRTF	DTMDHYRTF
DTVPSVSSI	DTVPSVSSI
GTYENLIHVW	GTYELIHVW
DIPDQVIRVF	DIPDVIRVF
ETALGIGGF	ETALGIGGF
EAFPEKIPLF	EAFPKIPLF
YVPEKYLQF	YVPEKYLQF
AVLDSASLY	AVLDSASLY
EVFQTKIQEF	EVFQKIQEF
EVVDARLVSVF	EVVDRLVSV
AVAEEYLSF	AVAEEYLSF
MVADKFTEL	MVADKFTEL
FVIPNSTNTW	FVIPSTNTW
ITPEVLPGW	ITPEVLPGW
SAPVGVTAL	SAPVGVTAL
FTKTSQGRSW	FTKTQGRSW
DVANKIGII	DVANKIGII
ETAGPWGQAAW	ETAGGQAAW
DTHKATLVW	DTHKATLVW
DVLDHTYQEL	DVLDTYQEL
SVIRKIPAL	SVIRKIPAL
FVFDKTSQSW	FVFDTSQSW
EVIQWLAKL	EVIQWLAKL
EVVDFIQSKI	EVVDFIQSK
DSVPRDLPSW	SVPRDLPSW
QVAPKTLPW	QVAPKTLPW
ELVKRILNF	ELVKRILNF
EAAYRVLHW	EAAYRVLHW
EVVDFSSHY	EVVDFSSHY
EVTDEDTVKRY	EVTDTVKRY
EVQEGFLRF	EVQEGFLRF
EVTDLLASF	EVTDLLASF
GVADGVGGW	GVADGVGGW
SVIEAVAHF	SVIEAVAHF
DSSPVSTPF	DSSPVSTPF
EINENNVREF	EINENVREF
DIHEVRIGW	DIHEVRIGW
EVLKRLGMW	EVLKRLGMW
YVHDDGRVSY	YVHDGRVSY
EVISKLYAV	EVISKLYAV
EVVKILERW	EVVKILERW
ELQEKMVSF	ELQEKMVSF
DLIEHFSQF	DLIEHFSQF
STYDGFGLAW	STYDFGLAW
EIRQQIPVF	EIRQQIPVF
DPVDIYKSW	DPVDIYKSW
DIIDDVESF	DIIDDVESF
DTISINHNW	DTISINHNW
DVIAQGIGKL	DVIAGIGKL
GVIWKTIGW	GVIWKTIGW
EVISRQATI	EVISRQATI
ETKQFFLQF	ETKQFFLQF
DIYGGDYERF	DIYGDYERF
DLFNGRYHVI	DLFNRYHVI
DTFNHLTTW	DTFNHLTTW
EVPVYVPKW	EVPVYVPKW
ETTEYLKTSW	ETTELKTSW
EVAPGYVVTVL	EVAPYVVTV
FVGPVVGGW	FVGPVVGGW
EVIERLIKSY	EVIELIKSY
HVSDLSSSW	HVSDLSSSW
EVFDKTYQFL	EVFDKTYQF
EIIKNTDSW	EIIKNTDSW
EVYVSRPSHF	EVYVRPSHF
SIPGGYNAL	SIPGGYNAL
ETIPKAVSF	ETIPKAVSF
EVQDSIHRW	EVQDSIHRW
TVTEKPEVID	TVTEKPEVI
DAMNREVSSL	DAMNEVSSL
ETVGEEDIRLF	ETVGEDIRL
ETVWHLEEF	ETVWHLEEF
ETAGAIMAF	ETAGAIMAF
EVIGSELKHW	EVIGELKHW
DVPEKSSLF	DVPEKSSLF
ETQKKRLLSW	ETQKRLLSW
ETLPSKIQQW	ETLPKIQQW
EVAPKQLHSL	EVAPQLHSL
DVAEGDLIEHF	DVAELIEHF
DVIKAVSTI	DVIKAVSTI
EIIDRMPVI	EIIDRMPVI
EAVDGHTVSIF	EAVDHTVSI
TTIAKYAQY	TTIAKYAQY
EVINRSMDTY	EVINSMDTY
YTFDQKIVEW	YTFDKIVEW
EVHESYKHL	EVHESYKHL
IDVITKTW	-IDVITKTW
HTIGPFSSF	HTIGPFSSF
EVVHKIIEL	EVVHKIIEL
HVAPDSIRGSF	HVAPIRGSF
DVIHEVAHSW	DVIHVAHSW
ETPDIKLFGKW	ETPDLFGKW
SVYDTIASW	SVYDTIASW
EVIGGTNHTL	EVIGTNHTL
ETAFKFKAL	ETAFKFKAL
EVMDEFDGRSF	EVMDDGRSF
EIYNYDPETY	EIYNDPETY
YVIEEDKGDGW	YVIEKGDGW
FVKEKLLKW	FVKEKLLKW
TVLPFNPAAF	TVLPNPAAF
ETKEYFESW	ETKEYFESW
FVVQNPSSW	FVVQNPSSW
EIKQKIDSY	EIKQKIDSY
HVAEKETLLAW	HVAETLLAW
ELFHKDIEAF	ELFHDIEAF
DVTGQFPSSF	DVTGFPSSF
EVFPLAMNYL	EVFPLAMNY
TVVERMLSNW	TVVEMLSNW
ETVVRYEKF	ETVVRYEKF
YTADPYHAL	YTADPYHAL
ETLLGTMQSY	ETLLTMQSY
AVAGAISSF	AVAGAISSF
EVVHQLQEI	EVVHQLQEI
ETRKMISTW	ETRKMISTW
EVLTSKGDAW	EVLTKGDAW
SVIRTMWAW	SVIRTMWAW
NAPWAVTSL	NAPWAVTSL
EVVRETGEY	EVVRETGEY
FVNEAISHW	FVNEAISHW
ETIQTYRSV	ETIQTYRSV
STIQDYLGF	STIQDYLGF
QTPDFTPTKY	QTPDTPTKY
EQIDKSGSW	EQIDKSGSW
EVYDPGTNTW	EVYDGTNTW
EVAEVKISHF	EVAEKISHF
AVKERIAKF	AVKERIAKF
EVIDVVRTM	EVIDVVRTM
HVFSDGVTNW	HVFSGVTNW
EVIRELAGI	EVIRELAGI
EAYNIKSNEW	EAYNKSNEW
EVDKRVHMTW	EVDKVHMTW
DVTVKMSTY	DVTVKMSTY
ETFAQKMDAF	ETFAKMDAF
ATNDASLHVW	ATNDSLHVW
HVKDEQIEHW	HVKDQIEHW
SVPYFLFQHW	SVPYLFQHW
EVAAVLLHF	EVAAVLLHF
EVSVPTFSW	EVSVPTFSW
ESIDKIARW	ESIDKIARW
TVGPKTFSW	TVGPKTFSW
EVVERLLSV	EVVERLLSV
TVIEKTESW	TVIEKTESW
ETAFGYKGL	ETAFGYKGL
FSGVYKKL	-FSGVYKKL
HLIQNIPGF	HLIQNIPGF
HVNTKSLISW	HVNTSLISW
AVYGGGSMW	AVYGGGSMW
AVKEKISKF	AVKEKISKF
FVQQRYLSY	FVQQRYLSY
EVIKSQEVF	EVIKSQEVF
EAFTEMMEAY	EAFTMMEAY
DVFGYHGYTF	DVFGHGYTF
SVKDAKIAVY	SVKDKIAVY
ETPLHISGF	ETPLHISGF
EVIQGLLKKF	EVIQLLKKF
ETIKDGVSRF	ETIKGVSRF
KVKKTIPSW	KVKKTIPSW
TTYEGIFKTL	TTYEIFKTL
ETASNEVVYRF	ETASNEVVY
DVVPAVRKW	DVVPAVRKW
NVIETISSL	NVIETISSL
EVIAKNNSF	EVIAKNNSF
DVKSEIYSF	DVKSEIYSF
EVIDLMIKEY	EVIDMIKEY
EVMKRIQSL	EVMKRIQSL
VVPEPGQPL	VVPEPGQPL
EVIHGIFKAY	EVIHIFKAY
NVIHNLATY	NVIHNLATY
EVIQAYETL	EVIQAYETL
HTQTGVSTW	HTQTGVSTW
DIIRGPILSF	DIIRPILSF
EVVSEPFRSF	EVVSPFRSF
EVIGKITAL	EVIGKITAL
EVVGALVTHI	EVVGLVTHI
AVISSVAHY	AVISSVAHY
DVYDIKKQAW	DVYDKKQAW
SIIGVHLDTW	SIIGHLDTW
DTIGYLLTRY	DTIGLLTRY
DTVKKIESF	DTVKKIESF
DVTAQFESY	DVTAQFESY
TTTPHTLPAAW	TTPHLPAAW
SIIQRIQEF	SIIQRIQEF
ETVRELTEF	ETVRELTEF
ELKDFFQSY	ELKDFFQSY
EIITPYRSF	EIITPYRSF
ELAENILKW	ELAENILKW
VNLPINGNGKQ	NLPINGNGK
YVAPAYGVY	YVAPAYGVY
ETVKKFMAL	ETVKKFMAL
AVYPQATQTY	AVYPATQTY
DVPERDLTAF	DVPEDLTAF
ETIQGTGSW	ETIQGTGSW
DSHGGSLEW	DSHGGSLEW
ELFPDRALSSW	ELFPALSSW
HVIDDFVQF	HVIDDFVQF
FTINGITNW	FTINGITNW
EVIKELAQI	EVIKELAQI
YFAERVTSL	YFAERVTSL
ESAGIHETTY	ESAGHETTY
EVISQHLVSY	EVISHLVSY
HVKDANGNSF	HVKDNGNSF
FVEEEHQTW	FVEEEHQTW
EVYNLESNEW	EVYNESNEW
DVAPSTLLPSY	DVAPLLPSY
DVIERVIQY	DVIERVIQY
DIADNFEAF	DIADNFEAF
EVIDKNSGGWW	EVIDNSGGW
SVVKELSSF	SVVKELSSF
ETLPFHSGGQW	ETLPSGGQW
EVLDKRYNVY	EVLDRYNVY
AVIEANIRSY	AVIENIRSY
DTSGPRKEW	DTSGPRKEW
EVADYEATTF	EVADEATTF
HVITGLLEHY	HVITLLEHY
ETIDRFNNY	ETIDRFNNY
HTVGLSSTW	HTVGLSSTW
EILHFHYTTW	EILHHYTTW
ISPSRTEAL	ISPSRTEAL
EVAPAPKSW	EVAPAPKSW
DIITDVATF	DIITDVATF
ETIPDGIGKL	ETIPGIGKL
YAAPHPLQSY	YAAPPLQSY
DAISAGKNW	DAISAGKNW
TTREPSLATW	TTRESLATW
MTNGFHMTW	MTNGFHMTW
EVVAFIQHF	EVVAFIQHF
ESIAWFTVF	ESIAWFTVF
ELIRKIEAY	ELIRKIEAY
TTFEHDIQAL	TTFEDIQAL
NVKVDPEIQ	NVKVDPEIQ
EVINRIQKL	EVINRIQKL
STIDWEGTSF	STIDEGTSF
EVASNITSF	EVASNITSF
DLPDHLLSY	DLPDHLLSY
EVVGEQVTSY	EVVGQVTSY
DSFSDLYSSY	DSFSLYSSY
EVIQALPKL	EVIQALPKL
ETFPDAKGWIF	ETFPDAKGW
EVMEQGRVTI	EVMEGRVTI
ETVSGLKGY	ETVSGLKGY
SVKTTTHSW	SVKTTTHSW
YAADIFYSRY	YAADFYSRY
DVMKRSESW	DVMKRSESW
SVPLAATSM	SVPLAATSM
VTFPFKPESW	VTFPKPESW
ATAQRVAAW	ATAQRVAAW
ETIHPRKSY	ETIHPRKSY
DLIEKLLNY	DLIEKLLNY
EAIPDEVIKKW	AIPDVIKKW
DVNESRINAW	DVNERINAW
EVFPKEMTKW	EVFPEMTKW
ETIQHTEAF	ETIQHTEAF
EVTSKLKSY	EVTSKLKSY
DVPDGTVVTVM	DVPDTVVTV
DTSDIVHIW	DTSDIVHIW
SVIERQVGTF	SVIEQVGTF
TVIESDLGVW	TVIEDLGVW
NVIESFTEL	NVIESFTEL
SPAGHSFLSW	SPAGSFLSW
EVTEIISQF	EVTEIISQF
EVYTEEDAASY	EVYTDAASY
EAIEEVKNGGW	EAIEKNGGW
ELFDKKLKEL	ELFDKLKEL
ETAEPWFSTF	ETAEWFSTF
DVPAHLQNSW	DVPALQNSW
DLFTKYYSEW	DLFTYYSEW
DSIQEFRLSGW	SIQERLSGW
ETVNLRSLGF	ETVNRSLGF
EVPVHKLQSL	EVPVKLQSL
DVANFYVSQL	DVANYVSQL
SVYSIVPQSW	SVYSVPQSW
SIDYTVHEAW	SIDYVHEAW
EVHIQLSEW	EVHIQLSEW
MTAGVDGHSW	MTAGDGHSW
EVPGSIPNSW	EVPGIPNSW
HAATTSLSW	HAATTSLSW
DTPIFDFRVF	DTPIDFRVF
DTPGHTLSW	DTPGHTLSW
EVYRLAIQSF	EVYRAIQSF
EVVERVLTF	EVVERVLTF
EVSTAKLTAF	EVSTKLTAF
AAPATRAAL	AAPATRAAL
PSNHVIDRW	PSNHVIDRW
DVAEPYKVY	DVAEPYKVY
LTIDHVPIW	LTIDHVPIW
EVDVSKKTAW	EVDVKKTAW
STFDDIVHSF	STFDIVHSF
DVKKRILEF	DVKKRILEF
HVQELYQEW	HVQELYQEW
DLYPSNPVSW	DLYPNPVSW
ELLNSKLPRW	ELLNKLPRW
EVEVGDRTSW	EVEVDRTSW
ELFEGVQKW	ELFEGVQKW
NVVAQIKPF	NVVAQIKPF
ETVRSILKI	ETVRSILKI
EAYDPETRAW	EAYDETRAW
EVMQKYIRY	EVMQKYIRY
EVKKLMRKY	EVKKLMRKY
EVLHVKTESL	EVLHKTESL
ETKSRFTEY	ETKSRFTEY
EVIPTHTVY	EVIPTHTVY
TVIENIHTI	TVIENIHTI
SVIEQILHY	SVIEQILHY
DLPSNHVIDRW	DLPSVIDRW
YIATKIGAF	YIATKIGAF
EVVAGIKEYF	EVVAGIKEY
MTPDQKFIQW	MTPDKFIQW
EVHDYIRAY	EVHDYIRAY
EAISYYSKY	EAISYYSKY
SIPEKNRPL	SIPEKNRPL
HVQAPQIGAW	HVQAQIGAW
AVFEKGMKAF	AVFEGMKAF
ETIHIRGGVF	ETIHRGGVF
EALERSSSW	EALERSSSW
EVTFIYQKL	EVTFIYQKL
EVIALLHSL	EVIALLHSL
EVFHPTHEW	EVFHPTHEW
ETHPVQETTF	ETHPQETTF
STVPGYYSW	STVPGYYSW
EAVQAISMF	EAVQAISMF
HVVEFSTAW	HVVEFSTAW
TVMGRIATL	TVMGRIATL
EVAEAYEVL	EVAEAYEVL
EIVWSIKSF	EIVWSIKSF
DVKDYIQEY	DVKDYIQEY
SVIDSAELQAY	SVIDELQAY
PDIKLFGKW	PDIKLFGKW
EIIETGLAAF	EIIEGLAAF
EVYHKSMTL	EVYHKSMTL
HTKTTLPTF	HTKTTLPTF
VTIKKDVDG	VTIKKDVDG
FTVGPKTFSW	FTVGKTFSW
YVNPANTHQF	YVNPNTHQF
EVISEDAFYKW	EVISEDAFY
EVVGKIRSL	EVVGKIRSL
AAADHNYQSY	AAADNYQSY
EVTGPHEAF	EVTGPHEAF
DAADKAAVVKF	DAADAVVKF
EVPHEVAQY	EVPHEVAQY
ETADTLMGLRY	ETADTLMGL
TVSGTTQSW	TVSGTTQSW
EVVKNSVHSW	EVVKSVHSW
STIETVPYW	STIETVPYW
EVIKEVQEF	EVIKEVQEF
NAIEHTLQW	NAIEHTLQW
EMMKSYVAW	EMMKSYVAW
ELIPEYLNF	ELIPEYLNF
YVIPHPVHAF	YVIPPVHAF
