Data	Data aligned
DRFLSRTFL	DRFLSRTFL
DQLVRIAKV	DQLVRIAKV
DRHMYHSL	DRHMY-HSL
DRFERLVEL	DRFERLVEL
APLQRSQSL	APLQRSQSL
VRLAGRPQL	VRLAGRPQL
NALMRLNQI	NALMRLNQI
SEFGRNYSL	SEFGRNYSL
NRIRVRQDL	NRIRVRQDL
NRFKLVNSA	NRFKLVNSA
SLVNLGGSK	SLVNLGGSK
TRLKSRVL	TRLKS-RVL
KRYDREFLL	KRYDREFLL
TRILKRITV	TRILKRITV
YEVHHQKL	YEVHH-QKL
DRNAHLNAL	DRNAHLNAL
ERIDHIKL	ERIDH-IKL
DRYGGQPLF	DRYGGQPLF
DRYPGSTFM	DRYPGSTFM
VRFTRQDKL	VRFTRQDKL
LKPPHPHHRAL	PPHPHHRAL
NRFYHEEL	NRFYH-EEL
NELQRKDAL	NELQRKDAL
DRFTKSISI	DRFTKSISI
DRFNGVSEA	DRFNGVSEA
YRFSRAAL	YRFSR-AAL
SRLGSSRVL	SRLGSSRVL
SRLVVKTAL	SRLVVKTAL
SSPQPGSAL	SSPQPGSAL
SRMIRWTKL	SRMIRWTKL
DRMRLSTAL	DRMRLSTAL
ERKERLESL	ERKERLESL
HRVIHRDI	HRVIH-RDI
DRALHAKL	DRALH-AKL
DQVSRLVTI	DQVSRLVTI
NRALRTDL	NRALR-TDL
DRMFHIRAVI	DRMFHIRAV
NRYPASSLVV	NRYPA-SSL
YDYLRPIAL	YDYLRPIAL
MEFERQAEI	MEFERQAEI
APYMRSMMQSL	MRSMM-QSL
ERMLRLSL	ERMLR-LSL
SRTNRPPL	SRTNR-PPL
NRYDGIYKVV	NRYDGIYKV
YRVPAKSTL	YRVPAKSTL
NQWSRIASL	NQWSRIASL
SQFWRMVAL	SQFWRMVAL
LRIERESAL	LRIERESAL
NRLSVSSL	NRLSV-SSL
EGFDRSTSL	EGFDRSTSL
KAPAPRPSL	KAPAPRPSL
DRIISVNSV	DRIISVNSV
VRYPDRITL	VRYPDRITL
ARYQGREL	ARYQG-REL
IAPTGHSL	IAPTG-HSL
NRLDAELQL	NRLDAELQL
DQVTHIRI	DQVTH-IRI
DDFERISEL	DDFERISEL
KRYSRSLTI	KRYSRSLTI
TPHLRNLAV	TPHLRNLAV
ERIKRLEEL	ERIKRLEEL
DEYEKLQVL	DEYEKLQVL
DRFENQVDM	DRFENQVDM
QDNRALRGQSL	NRALRGQSL
SRFPEALRL	SRFPEALRL
HPVPHAAL	HPVPH-AAL
DGYRRILNL	DGYRRILNL
LDATHQQL	LDATH-QQL
DRFRNNSL	DRFRN-NSL
HRDQRDVSL	HRDQRDVSL
QRIIRNAL	QRIIR-NAL
AEQRGENALKD	AEQRGENAL
LRFDKEVAL	LRFDKEVAL
RDVVHSTL	RDVVH-STL
TVTEKPEVIDA	TVTEKPEVI
MRFDGRLGF	MRFDGRLGF
LQASHSEL	LQASH-SEL
LRYADRVKEL	LRYADRKEL
LQIDNARLA	LQIDNARLA
ERFDGMLLAM	ERFDG-MLL
LELERKQAL	LELERKQAL
NRLETPMEL	NRLETPMEL
DRFDGYVFL	DRFDGYVFL
DQARHYLL	DQARH-YLL
NRFTHVLTA	NRFTHVLTA
SRLVKREYL	SRLVKREYL
DRYFRIQEV	DRYFRIQEV
EQYIRRLAA	EQYIRRLAA
DRFDFVHDL	DRFDFVHDL
VRFKHRYL	VRFKH-RYL
NEFVRDTAL	NEFVRDTAL
NRFAGFGIGL	NRFAGFIGL
LRFLHENQL	LRFLHENQL
NRYDGQVAV	NRYDGQVAV
ARLSRSSAL	ARLSRSSAL
YQQPRGVAL	YQQPRGVAL
VRFLEQQTL	VRFLEQQTL
ERLIRTIAA	ERLIRTIAA
GRYIRSAL	GRYIR-SAL
NRLTKIEGL	NRLTKIEGL
MGYLRIADL	MGYLRIADL
FNFLRNVSL	FNFLRNVSL
DRFERDTRV	DRFERDTRV
NRFQIATV	NRFQI-ATV
NGQPIHAEL	NGQPIHAEL
VRVGHSEL	VRVGH-SEL
NRLHDRIVF	NRLHDRIVF
NRLQAVEAL	NRLQAVEAL
ERLKIRGSL	ERLKIRGSL
DRMYRSAV	DRMYR-SAV
LPHNRLVSL	LPHNRLVSL
DRFRDSIL	DRFRD-SIL
SRLAGRDAL	SRLAGRDAL
GRVAPRSGL	GRVAPRSGL
AVSSDTLVAA	VSSDTLVAA
NQVIHWEI	NQVIH-WEI
DHWVHVLV	DHWVH-VLV
DRFEKTNEM	DRFEKTNEM
NRYVGRTF	NRYVG-RTF
NREVPREAL	NREVPREAL
ERFDSRSNL	ERFDSRSNL
AAPATRAAL	AAPATRAAL
QGVVHRDL	QGVVH-RDL
ERFPTHAKL	ERFPTHAKL
DRYPRKVTA	DRYPRKVTA
MRSLKRAAL	MRSLKRAAL
VPYPRKITL	VPYPRKITL
DRVGRQEL	DRVGR-QEL
SPFKRQLSL	SPFKRQLSL
NGFMHHVL	NGFMH-HVL
TRLPTPVLL	TRLPTPVLL
DRVIKASL	DRVIK-ASL
DRDRRGPPL	DRDRRGPPL
TRILRQTL	TRILR-QTL
HEIAHAVL	HEIAH-AVL
AAERRGPL	AAERR-GPL
ERYAKIVEI	ERYAKIVEI
DRVLRIHRI	DRVLRIHRI
TASDLLLHSAL	DLLLH-SAL
ELSRSVNEFL	SRSVN-EFL
NDGTHMAL	NDGTH-MAL
QRYDHYSVL	QRYDHYSVL
TYDDATKTF	TYDDATKTF
DRYIQQKRL	DRYIQQKRL
NRYMNHMQSL	NRYMNHQSL
ERFLKGEGL	ERFLKGEGL
LQYNRAQVL	LQYNRAQVL
VRLAHREQV	VRLAHREQV
SRFAGYVTSI	SRFAGYTSI
VQVAHEKL	VQVAH-EKL
NRIYRMIKL	NRIYRMIKL
DRLSASSL	DRLSA-SSL
DVTLHQAL	DVTLH-QAL
DRYYERNEL	DRYYERNEL
YRNAYTMVL	YRNAYTMVL
NRYSTVSL	NRYST-VSL
DRIKARMSL	DRIKARMSL
DEINHQSL	DEINH-QSL
MELERIVSA	MELERIVSA
DRALRAAL	DRALR-AAL
IPYKREESL	IPYKREESL
NRVNFRGSL	NRVNFRGSL
LQVAHEEI	LQVAH-EEI
NRYIPTAAA	NRYIPTAAA
NQIIRHNEL	NQIIRHNEL
LRYDHQSRLTA	LRYDHQSRL
DRLLALNSL	DRLLALNSL
DRYMRLKEEL	DRYMRLEEL
FRYHGLSSL	FRYHGLSSL
DRYDGLRRL	DRYDGLRRL
VQALRTVSL	VQALRTVSL
ERFQTTTTL	ERFQTTTTL
NTLKRVSSL	NTLKRVSSL
LQNAHGEL	LQNAH-GEL
NRYLYFSST	NRYLYFSST
MGYEREQVI	MGYEREQVI
VRYKQVHAL	VRYKQVHAL
TRYETYVQL	TRYETYVQL
DRMLRSAMRL	DRMLR-SAM
NQLKRIAKM	NQLKRIAKM
DRFDGYIFL	DRFDGYIFL
DRFQPNMTL	DRFQPNMTL
ILTTHTTL	ILTTH-TTL
DQYMRTGEGFL	DQYMRTEGF
MRLPGGPTL	MRLPGGPTL
SEYMRLRQL	SEYMRLRQL
FEMATRAAL	FEMATRAAL
SRYFKGPEL	SRYFKGPEL
ARLDHKFDL	ARLDHKFDL
DIKRALGI	DIKRA-LGI
MQAPGRGPL	MQAPGRGPL
GIDRYPRKVTA	DRYPRKVTA
DSVVRRQL	DSVVR-RQL
LRHNGPPPV	LRHNGPPPV
DEVQRRLQL	DEVQRRLQL
NQVVREAIL	NQVVREAIL
DEVERTQTL	DEVERTQTL
NRHLRDEGL	NRHLRDEGL
NAAPGVDL	NAAPG-VDL
NQISDRAAL	NQISDRAAL
DRYDSFIEL	DRYDSFIEL
NGATRKLAL	NGATRKLAL
MGFSRDQAL	MGFSRDQAL
DKMTHRIL	DKMTH-RIL
NELVRTKTL	NELVRTKTL
NRGDFFMTL	NRGDFFMTL
TAIRHHVL	TAIRH-HVL
YERERVVAA	YERERVVAA
HRMNREEIL	HRMNREEIL
LRFKKPQSL	LRFKKPQSL
DNTVRIISL	DNTVRIISL
VRAPPHVRF	VRAPPHVRF
NRRYHPAL	NRRYH-PAL
DSFARLDAL	DSFARLDAL
VRVDRDYVL	VRVDRDYVL
DRMLRSAM	DRMLR-SAM
DNVTHAHL	DNVTH-AHL
TRHPFLTAL	TRHPFLTAL
DRLKFFETL	DRLKFFETL
DELLRIVSI	DELLRIVSI
LEDALQQAKED	DALQQAKED
HRVLHNSL	HRVLH-NSL
VRVKHKLL	VRVKH-KLL
DRTTISRAL	DRTTISRAL
AAKNLANTI	AAKNLANTI
DRMVGQVL	DRMVG-QVL
ERQDRISRL	ERQDRISRL
DAHLRPTSL	DAHLRPTSL
LPNIHPEL	LPNIH-PEL
LEAVHDLL	LEAVH-DLL
NVAQHTSL	NVAQH-TSL
DRYQGNQDRVL	DRYQGNRVL
DPYLRSLEL	DPYLRSLEL
DNQERFNSL	DNQERFNSL
NRYDKKIDSL	NRYDKKDSL
SRYEHVMKL	SRYEHVMKL
DEAIRAVL	DEAIR-AVL
DRLPKFLIV	DRLPKFLIV
DRRERVLKL	DRRERVLKL
HSVLHRAL	HSVLH-RAL
GRYNPRRSL	GRYNPRRSL
TAFKRNLSL	TAFKRNLSL
DEVERVITI	DEVERVITI
LQIQRNVTL	LQIQRNVTL
SQLRVAKV	SQLRV-AKV
IRKERPISL	IRKERPISL
DRYLAIVHA	DRYLAIVHA
SPVVHQSL	SPVVH-QSL
VGLIRNLAL	VGLIRNLAL
TQTRHGVL	TQTRH-GVL
NRLTFASTL	NRLTFASTL
KDMERLTSL	KDMERLTSL
NQLLKPTL	NQLLK-PTL
VRIKDRNKL	VRIKDRNKL
NRNPRNLEL	NRNPRNLEL
DRSTREVEL	DRSTREVEL
GEGLKRSAL	GEGLKRSAL
ARFSARSSL	ARFSARSSL
LRHLGRTL	LRHLG-RTL
NRFSPKASL	NRFSPKASL
DRRAFIITI	DRRAFIITI
NGYKRVLAL	NGYKRVLAL
YQLYRNTTL	YQLYRNTTL
DRYYTPTI	DRYYT-PTI
DQFVRGEVL	DQFVRGEVL
DRRSRIEAL	DRRSRIEAL
NQYLRVSL	NQYLR-VSL
DRYNPENLATL	DRYNP-ENL
ERFARNSTL	ERFARNSTL
NEVVRSDL	NEVVR-SDL
AQNVGTTHDL	QNVGTTHDL
TRILRSAKL	TRILRSAKL
IRNHHVASL	IRNHHVASL
LRHLGLTR	LRHLG-LTR
ARYAVRRSL	ARYAVRRSL
MRVSNRSLL	MRVSNRSLL
NRLTHRLL	NRLTH-RLL
EAYEREVSL	EAYEREVSL
DASVHPTL	DASVH-PTL
NPYSRLMAL	NPYSRLMAL
DNYVRTSEI	DNYVRTSEI
DAYELKHAL	DAYELKHAL
TEMERTLAL	TEMERTLAL
LQYTRKAEF	LQYTRKAEF
YRNESARESL	NESAR-ESL
VEASHLAL	VEASH-LAL
DRRERLRQL	DRRERLRQL
EPATHNAL	EPATH-NAL
DRLARDYAA	DRLARDYAA
DRMKTVSV	DRMKT-VSV
SRMSERQVAL	SRMSERVAL
EVYAHAVL	EVYAH-AVL
NRIKGIPKL	NRIKGIPKL
NELVRISSM	NELVRISSM
DRYHEKLAV	DRYHEKLAV
DRQWKKISA	DRQWKKISA
SQFTRNAL	SQFTR-NAL
LRFLFENKL	LRFLFENKL
HRYEREEAF	HRYEREEAF
VRVGPQPSL	VRVGPQPSL
DEQVRLYKL	DEQVRLYKL
SRFEFNQSL	SRFEFNQSL
ARVGSRAAL	ARVGSRAAL
LQALHDAL	LQALH-DAL
DRRLRIPEL	DRRLRIPEL
DQYARIWNAL	DQYARINAL
DRYIFVSLL	DRYIFVSLL
QRLPRPSSL	QRLPRPSSL
HSVVHALL	HSVVH-ALL
NRYIHILMI	NRYIHILMI
TAPTGHTL	TAPTG-HTL
NRFPWPKVL	NRFPWPKVL
NRYLYLSTM	NRYLYLSTM
GQPMVHGAL	GQPMVHGAL
DRYIFVSL	DRYIF-VSL
RTLSPRGSL	RTLSPRGSL
NRLQWVQL	NRLQW-VQL
SRFARLQKL	SRFARLQKL
NRWLRTISV	NRWLRTISV
LRYDHQSRL	LRYDHQSRL
QHATRFIAL	QHATRFIAL
IRYERDNNFL	IRYERDNNF
VSPLHRVL	VSPLH-RVL
LPFLRITSL	LPFLRITSL
DRYLNIVHA	DRYLNIVHA
NRMIKSEL	NRMIK-SEL
SRYSMYNSV	SRYSMYNSV
QQVVRIAL	QQVVR-IAL
DRFQAHSKL	DRFQAHSKL
SRYGGGPRL	SRYGGGPRL
QNLERGTAV	QNLERGTAV
ARISRSISL	ARISRSISL
DRLKSALL	DRLKS-ALL
TGWVHDVL	TGWVH-DVL
ERIPKALEV	ERIPKALEV
VRLDREHRV	VRLDREHRV
DQLMRQLDL	DQLMRQLDL
DRVYIHPFHL	RVYIHPFHL
VQEIHQVL	VQEIH-QVL
DDARRLTVM	DDARRLTVM
DQAVHAEV	DQAVH-AEV
LQLWNGLL	LQLWN-GLL
LRTMHHLL	LRTMH-HLL
SSVSHSVL	SSVSH-SVL
VRVIRLSSL	VRVIRLSSL
TRVKAVRIL	TRVKAVRIL
NRFVGILM	NRFVG-ILM
LPAEHGVL	LPAEH-GVL
DRVATQLVV	DRVATQLVV
ENYDRGYSSL	ENYDRGSSL
NRKEGLRL	NRKEG-LRL
SRLEKRSEF	SRLEKRSEF
AIPMIHAVL	AIPMIHAVL
MPTVHYEF	MPTVH-YEF
IEFQREAL	IEFQR-EAL
MRHLISSL	MRHLI-SSL
KLQNNSLLP	KLQNNSLLP
HAAEYGAEALE	AEYGA-EAL
VEALHEVL	VEALH-EVL
TQTVRVVAL	TQTVRVVAL
NRLIGQIV	NRLIG-QIV
DRLKSLTM	DRLKS-LTM
DRYKNLPTA	DRYKNLPTA
RPFERTITM	RPFERTITM
DRYDAPGIAL	DRYDAPIAL
DRHLRTLQI	DRHLRTLQI
SRFQGTLYL	SRFQGTLYL
IPLAKRVAL	IPLAKRVAL
GRLGRSESL	GRLGRSESL
IEISRNEAL	IEISRNEAL
DRLPGPRAV	DRLPGPRAV
DRVTRSTL	DRVTR-STL
SRYLNEKAV	SRYLNEKAV
MRYNLQSAL	MRYNLQSAL
LPSIHSLL	LPSIH-SLL
DEGRHLTL	DEGRH-LTL
NRVRPLVL	NRVRP-LVL
TEELAYLK	TEELA-YLK
FRYQGYIGA	FRYQGYIGA
DALVHARL	DALVH-ARL
NEVQRTML	NEVQR-TML
MRHKLKTAF	MRHKLKTAF
NRALRGQSL	NRALRGQSL
SQRQGRPTL	SQRQGRPTL
DRDTRRDVTL	DRDTRRVTL
ENVAHNAL	ENVAH-NAL
AELERNVAL	AELERNVAL
LRYPMAVGL	LRYPMAVGL
VRLPRQDAL	VRLPRQDAL
DRAGSIVL	DRAGS-IVL
ESTLHLVL	ESTLH-LVL
MNGIHSEL	MNGIH-SEL
LEAVHDVL	LEAVH-DVL
HRFPFSSAL	HRFPFSSAL
LERERAAQL	LERERAAQL
HHFQRGDGAAL	QRGDG-AAL
DRFKESLTL	DRFKESLTL
DQTIRIHGL	DQTIRIHGL
NPNLRKNVL	NPNLRKNVL
MRNVTMAI	MRNVT-MAI
DEALRRSDL	DEALRRSDL
TEKPEVID	TEKPE-VID
IRVIAHTQM	IRVIAHTQM
SQAMRYRAL	SQAMRYRAL
DNMPRILSL	DNMPRILSL
NGAARLTAL	NGAARLTAL
DRYLQDNPA	DRYLQDNPA
TNAENEFVTIK	AENEF-VTI
EQMERLEAL	EQMERLEAL
DRTAQLTSL	DRTAQLTSL
MRLEQRDSL	MRLEQRDSL
MRLGPRTAAL	MRLGPRTAA
DRFNHFSLTL	DRFNH-FSL
NRLDYHISV	NRLDYHISV
DNARRLTGF	DNARRLTGF
NRALKRFSL	NRALKRFSL
IQILHQVL	IQILH-QVL
ERVVHYEI	ERVVH-YEI
DKLIRISAL	DKLIRISAL
LRFPHHSQL	LRFPHHSQL
NRLLQRKQM	NRLLQRKQM
IRAFREEAI	IRAFREEAI
LSYLRESSL	LSYLRESSL
AQYEDIAQK	AQYEDIAQK
DQAVRTMEI	DQAVRTMEI
DRALRSFL	DRALR-SFL
TRLVRGEL	TRLVR-GEL
DMYLKLVQL	DMYLKLVQL
DRAYVRQL	DRAYV-RQL
DRILIHSL	DRILI-HSL
LRLLIHQSL	LRLLIHQSL
DRLRTERDSL	LRTER-DSL
NRHPNFLVV	NRHPNFLVV
LEAQHQAL	LEAQH-QAL
SRLSSTSSL	SRLSSTSSL
YEVQRAVSL	YEVQRAVSL
ERFEKTFQL	ERFEKTFQL
FRVLHTAL	FRVLH-TAL
ERIMKAQAL	ERIMKAQAL
VHYDRSGRSL	VHYDRSRSL
ERLGQFMTL	ERLGQFMTL
DEYVRGLHAQL	VRGLH-AQL
DQMMRAIAM	DQMMRAIAM
SRYMRINSL	SRYMRINSL
DRMFHIRA	DRMFH-IRA
ERYSASKPL	ERYSASKPL
NEATRQVAL	NEATRQVAL
MELQGERAI	MELQGERAI
TRMPPRSVL	TRMPPRSVL
YPAERKQAL	YPAERKQAL
KRYAGALRA	KRYAGALRA
DAFAKSLAL	DAFAKSLAL
DRVDREITM	DRVDREITM
DNVERADAL	DNVERADAL
DHFIRTLSL	DHFIRTLSL
DGYLKTSAL	DGYLKTSAL
MRMVLNESL	MRMVLNESL
DRYVAIARAL	DRYVAIRAL
SRALRQAL	SRALR-QAL
VEFQRAQSL	VEFQRAQSL
NRYHVPVVV	NRYHVPVVV
NESTRSVL	NESTR-SVL
DRYHRFKEL	DRYHRFKEL
FQVKRQVL	FQVKR-QVL
NKYERELML	NKYERELML
DQYKRETIL	DQYKRETIL
IEFSRLTSL	IEFSRLTSL
NQTVHRLL	NQTVH-RLL
MRIFRDQSL	MRIFRDQSL
IRQKALKL	IRQKA-LKL
HQFSRDASV	HQFSRDASV
HPGSHTVL	HPGSH-TVL
HRAFHLAL	HRAFH-LAL
MRFLIKGSV	MRFLIKGSV
YRFNGQYSSL	YRFNGQSSL
DRLKPLKM	DRLKP-LKM
DRIKRAFL	DRIKR-AFL
ERYLLTQEL	ERYLLTQEL
DRIRYVQSL	DRIRYVQSL
DRLRTLLQL	DRLRTLLQL
DEKLRLQQL	DEKLRLQQL
NREARNYTL	NREARNYTL
NRYVKPGL	NRYVK-PGL
SRVLRTSL	SRVLR-TSL
LRFPGQLNA	LRFPGQLNA
NRLLKQREEL	NRLLKQEEL
DRLQWVTI	DRLQW-VTI
DERLRINSL	DERLRINSL
NKTIHAEL	NKTIH-AEL
IRYDTVLAL	IRYDTVLAL
VPMFRNVSL	VPMFRNVSL
DQQVRYNAL	DQQVRYNAL
DRLHKVKTV	DRLHKVKTV
DRLAHEIEAL	DRLAHEEAL
NRVKTEAL	NRVKT-EAL
TRQERILAL	TRQERILAL
NRVQNMAL	NRVQN-MAL
DLYTRFDTL	DLYTRFDTL
NRLPRSVTT	NRLPRSVTT
DNLLRLKEL	DNLLRLKEL
QRLVRVLQI	QRLVRVLQI
DQVLHLSF	DQVLH-LSF
SVPIQIKD	SVPIQ-IKD
HPAGHLVL	HPAGH-LVL
DRVVVIRF	DRVVV-IRF
DRLYSRKI	DRLYS-RKI
MRLSLPLLL	MRLSLPLLL
VATVSLPR	VATVS-LPR
DRLNVTEEL	DRLNVTEEL
AVHYDRSGRSL	VHYDRSRSL
IEYEKKQTL	IEYEKKQTL
LEYERQLVL	LEYERQLVL
NGSLHQEL	NGSLH-QEL
GLEFAHMAL	GLEFAHMAL
EQYEHASI	EQYEH-ASI
LRHPRINVL	LRHPRINVL
SRVIRNAL	SRVIR-NAL
ERYLKFIEL	ERYLKFIEL
YRFKKRTEL	YRFKKRTEL
QRFSHQTL	QRFSH-QTL
SRYLYTLVI	SRYLYTLVI
GRFGSRDAL	GRFGSRDAL
LRLPRRESL	LRLPRRESL
DRRGRPVGF	DRRGRPVGF
HETLHQSL	HETLH-QSL
SRYLRPPNTSL	SRYLRPTSL
SRYWRITNA	SRYWRITNA
DRFLWSQQA	DRFLWSQQA
SPAGHSFL	SPAGH-SFL
EEFRRLAAL	EEFRRLAAL
RQVTGVTRV	RQVTGVTRV
DRVQRMLEV	DRVQRMLEV
DERLRIFAL	DERLRIFAL
NRAVVGVV	NRAVV-GVV
LRDRPLLL	LRDRP-LLL
ISPSRTEAL	ISPSRTEAL
TRVDTILEF	TRVDTILEF
SDLLLHSAL	SDLLLHSAL
NRYHVPVVVV	NRYHVPVVV
DQMQRKLTL	DQMQRKLTL
DRITGRAGL	DRITGRAGL
DSFARLVEL	DSFARLVEL
DRLDREEAF	DRLDREEAF
ENSLHRAL	ENSLH-RAL
EALVRTVAL	EALVRTVAL
DGFQHGEL	DGFQH-GEL
YRYPRPASV	YRYPRPASV
SFEDAKEAL	SFEDAKEAL
DRITRYQGV	DRITRYQGV
YQYLLVTAL	YQYLLVTAL
DRVFRNETL	DRVFRNETL
VQATRTSL	VQATR-TSL
LNVLHSEL	LNVLH-SEL
YRFGDSQQL	YRFGDSQQL
TAQARIIMLIV	TAQARIIML
VRWFHRDL	VRWFH-RDL
LATLHTAL	LATLH-TAL
ERHWRIFSL	ERHWRIFSL
TRIIHRLL	TRIIH-RLL
TFTVTEKPE	TFTVTEKPE
YRFLFNSNT	YRFLFNSNT
QRIDRLAL	QRIDR-LAL
LRFQSSAVM	LRFQSSAVM
DEVKRGVL	DEVKR-GVL
NQVAHLEL	NQVAH-LEL
RNVSTGDVNVE	NVSTGDVNV
LSYLRVNVL	LSYLRVNVL
DELRRAGSL	DELRRAGSL
KRFSGTVRL	KRFSGTVRL
DQFERIKTL	DQFERIKTL
DGSLRVTAL	DGSLRVTAL
NELERNITI	NELERNITI
IQVVREEL	IQVVR-EEL
NRIEKREVL	NRIEKREVL
LAAARLAAA	LAAARLAAA
LPWKRIVAV	LPWKRIVAV
NRVSSRLGL	NRVSSRLGL
GQWKKGFVL	GQWKKGFVL
DRVFHESI	DRVFH-ESI
MKMTHSEL	MKMTH-SEL
TRIEQNLVL	TRIEQNLVL
YQMEHRASL	YQMEHRASL
HRAVREVL	HRAVR-EVL
ERFKNKITV	ERFKNKITV
MRLTPRAL	MRLTP-RAL
AQLAHAVL	AQLAH-AVL
DRLIVGTA	DRLIV-GTA
SQMLRAVSL	SQMLRAVSL
SRQQRLSAL	SRQQRLSAL
DGMERPSSL	DGMERPSSL
FRYLMGERL	FRYLMGERL
SPARTALTG	SPARTALTG
SAYQRYYSL	SAYQRYYSL
IRFGGRKEI	IRFGGRKEI
DTFIRHIAL	DTFIRHIAL
DDMQHQVL	DDMQH-QVL
TQTAHTEL	TQTAH-TEL
DLYTRTTNL	DLYTRTTNL
DEFLRISTA	DEFLRISTA
MEQLRGEAL	MEQLRGEAL
DQSLHREL	DQSLH-REL
NRYPASSL	NRYPA-SSL
LDRERILSL	LDRERILSL
NAVLHKVL	NAVLH-KVL
DRLNKVISEL	DRLNKVSEL
TRLAQRLIM	TRLAQRLIM
NRAVVGVVA	NRAVVGVVA
VEFVRFTSL	VEFVRFTSL
ENATHTQL	ENATH-TQL
MRYVASYLL	MRYVASYLL
DGYRHEML	DGYRH-EML
MELERVKAL	MELERVKAL
YRLAVRTVI	YRLAVRTVI
VPFPRLHFF	VPFPRLHFF
HGYERYNAM	HGYERYNAM
DMLVKVNAL	DMLVKVNAL
ARLQTALLV	ARLQTALLV
DRRDHPLP	DRRDH-PLP
TRAIVRAL	TRAIV-RAL
RPYVHKIL	RPYVH-KIL
SRYSFIQAL	SRYSFIQAL
QRLKFRLNL	QRLKFRLNL
TDYLRQRAL	TDYLRQRAL
QQYQRRLAA	QQYQRRLAA
PQYSRQNSL	PQYSRQNSL
DQFLRDNL	DQFLR-DNL
LAALRLQSL	LAALRLQSL
NQTPHLLL	NQTPH-LLL
IRQERDQRL	IRQERDQRL
NRFPAVNSL	NRFPAVNSL
LRMAVRNNL	LRMAVRNNL
ERFHHVTVL	ERFHHVTVL
IEYLAHWLYH	IEYLA-HWL
AAPEGVPL	AAPEG-VPL
DRFHKQEEL	DRFHKQEEL
DRLQGLSSL	DRLQGLSSL
DKYERLVKL	DKYERLVKL
DRYRQDPQL	DRYRQDPQL
DQYMRTGEGF	DQYMRTEGF
SSSKGSLGGGF	SSSKG--SL
DRALRSFKL	DRALRSFKL
FRYQGHVGA	FRYQGHVGA
ERFSHVAM	ERFSH-VAM
DEFQRGDQL	DEFQRGDQL
VPNVHGAL	VPNVH-GAL
NRYEDALVL	NRYEDALVL
NRSIHRVF	NRSIH-RVF
KAYERGISL	KAYERGISL
DQVQHMEL	DQVQH-MEL
SPTVHLGL	SPTVH-LGL
MRVERSTL	MRVER-STL
DRFINGSAL	DRFINGSAL
ERYELLNVL	ERYELLNVL
TRYNKIKAI	TRYNKIKAI
YRSAVRATL	YRSAVRATL
VNDPRPQHKYN	VNDPRPQHK
MRQKAVSL	MRQKA-VSL
DQMSRLAKL	DQMSRLAKL
ERLNRLETL	ERLNRLETL
DRIPERDKL	DRIPERDKL
DMLERAVSV	DMLERAVSV
TRYNHMLSA	TRYNHMLSA
SGTLGHPGSL	GTLGHPGSL
DRIVSMTL	DRIVS-MTL
GRVAERSQL	GRVAERSQL
QEYERRAQL	QEYERRAQL
IDYQRNVPA	IDYQRNVPA
NRFVRTVL	NRFVR-TVL
DSPLHKAL	DSPLH-KAL
GELFLRRISL	ELFLRRISL
NRFEKRINV	NRFEKRINV
DRYLKSESL	DRYLKSESL
DRYPNQTL	DRYPN-QTL
NRIEERLNL	NRIEERLNL
MRHVVSHAL	MRHVVSHAL
MEAVRVNPL	MEAVRVNPL
NRFLHMHEL	NRFLHMHEL
SPYKRDNTF	SPYKRDNTF
DFATHGKL	DFATH-GKL
TEAVHTML	TEAVH-TML
VQVVREETL	VQVVREETL
FRSGSSRVL	FRSGSSRVL
RFTEKGPLL	RFTEKGPLL
TRFDPTWESL	TRFDPTESL
EELERVSAL	EELERVSAL
NETYHLTL	NETYH-LTL
VQNSHTEL	VQNSH-TEL
KEAIHSQL	KEAIH-SQL
HGIVHRAL	HGIVH-RAL
NRLIPTEL	NRLIP-TEL
VRNPRITSL	VRNPRITSL
VVPEPGQPL	VVPEPGQPL
DRFRSQIL	DRFRS-QIL
NQIVHRDI	NQIVH-RDI
LSSPATLNSR	SPATL-NSR
NRVQRDSVI	NRVQRDSVI
DRFDRDRPL	DRFDRDRPL
DQTKRLEL	DQTKR-LEL
IRYSGQYREL	IRYSGQREL
EQYLRIISH	EQYLRIISH
DQISHRASL	DQISHRASL
NRVLRISQL	NRVLRISQL
TRFSLARQV	TRFSLARQV
NRMLAQQAV	NRMLAQQAV
LQHIRNSL	LQHIR-NSL
DRVALRNLL	DRVALRNLL
IPYARDAVI	IPYARDAVI
KAPSAARSL	KAPSAARSL
LRYDHQQRL	LRYDHQQRL
ELFLRRISL	ELFLRRISL
DAVKREAAL	DAVKREAAL
DHFSRPVGL	DHFSRPVGL
HGIIHRDL	HGIIH-RDL
DNVIRIYSL	DNVIRIYSL
ERLERIFQL	ERLERIFQL
QRVPEREAL	QRVPEREAL
MENIHSEM	MENIH-SEM
SQVPRSSSM	SQVPRSSSM
VEMHHEAL	VEMHH-EAL
SQYQRFTYL	SQYQRFTYL
NMTVHSAL	NMTVH-SAL
DRNIRYVAL	DRNIRYVAL
SQHLHEVL	SQHLH-EVL
DRLLWARSV	DRLLWARSV
NRYPNIEL	NRYPN-IEL
HPGTHTVL	HPGTH-TVL
IPMIHAVL	IPMIH-AVL
DRNIKKITL	DRNIKKITL
DRAPSRKDSL	DRAPSRDSL
HGIVHSDL	HGIVH-SDL
LETGHRAL	LETGH-RAL
NRYLPTDTL	NRYLPTDTL
DRQVVSEL	DRQVV-SEL
DRLDLARKEL	DRLDLAKEL
DRENRRISI	DRENRRISI
MQIKHELL	MQIKH-ELL
TRYSRNDLHL	TRYSR-NDL
SRYTGASL	SRYTG-ASL
ERFDGMLLA	ERFDGMLLA
IGTFHTSL	IGTFH-TSL
DRVLREERA	DRVLREERA
MERERKVSM	MERERKVSM
LRHLQTITL	LRHLQTITL
DHLKRVKDL	DHLKRVKDL
TVTEKPEVID	TVTEKPEVI
DRHVGMAV	DRHVG-MAV
ERLERQERL	ERLERQERL
DHISHFIL	DHISH-FIL
FRHDRSLEL	FRHDRSLEL
LRDDRVLPL	LRDDRVLPL
TRYLKQFHL	TRYLKQFHL
TVYLRDIAL	TVYLRDIAL
VRLWDHATM	VRLWDHATM
RPTARINSI	RPTARINSI
DRFLRKITI	DRFLRKITI
QQQARTAAL	QQQARTAAL
TQYSKVLAL	TQYSKVLAL
NALAHHVL	NALAH-HVL
DVVKRLLSL	DVVKRLLSL
SHYERVQML	SHYERVQML
SYDPTIENTF	DPTIE-NTF
HRLHHVSSL	HRLHHVSSL
TQAIHDVF	TQAIH-DVF
QRFHFASAL	QRFHFASAL
NRHAVVMEL	NRHAVVMEL
YENEVALRQ	YENEVALRQ
DRTAIHEVM	DRTAIHEVM
DRAPAQPAM	DRAPAQPAM
HLPETKFSEL	LPETKFSEL
VKYVIIQQNL	YVIIQ-QNL
SRFNRYYSL	SRFNRYYSL
ARLEGRSSL	ARLEGRSSL
MQYLKENSL	MQYLKENSL
DRVKMGFVM	DRVKMGFVM
FQRQRVDAL	FQRQRVDAL
YRYMNPAIV	YRYMNPAIV
FEAEVLHTVL	AEVLH-TVL
NAFRRFSSL	NAFRRFSSL
LRYGGNLSL	LRYGGNLSL
DHYEKPEL	DHYEK-PEL
SPYQRKAGL	SPYQRKAGL
YRHQRIHSL	YRHQRIHSL
NRQDRYVFL	NRQDRYVFL
SRMANRDLL	SRMANRDLL
DRIEITSL	DRIEI-TSL
IQAIHSTI	IQAIH-STI
SIPEKNRPL	SIPEKNRPL
DEVLRRVTL	DEVLRRVTL
TRLEFQQQL	TRLEFQQQL
MEALHYML	MEALH-YML
DANLRKNEL	DANLRKNEL
NRLPKPVLL	NRLPKPVLL
HPYQRIVTA	HPYQRIVTA
NQLIRTSGV	NQLIRTSGV
DEVIHGIF	DEVIH-GIF
NRVLHQEL	NRVLH-QEL
VQAPRLAAL	VQAPRLAAL
TQQLHPVL	TQQLH-PVL
LQAVRQAL	LQAVR-QAL
DRLKPLLV	DRLKP-LLV
NRLMGRTL	NRLMG-RTL
GRAGRSVSL	GRAGRSVSL
NPQERTLTL	NPQERTLTL
IRAAPPPLF	IRAAPPPLF
DRVLRVYSI	DRVLRVYSI
VPFNHEIL	VPFNH-EIL
DRILREEL	DRILR-EEL
LPASHMEL	LPASH-MEL
NSVVHKVL	NSVVH-KVL
DRLKAIRTTL	DRLKAITTL
RRFHFSQSL	RRFHFSQSL
AEVLHTVL	AEVLH-TVL
DAFVRLIAL	DAFVRLIAL
VRLHQRLQL	VRLHQRLQL
SRNLRSSL	SRNLR-SSL
IRVLGRKEL	IRVLGRKEL
DGLIHTSL	DGLIH-TSL
DRLKVFKEV	DRLKVFKEV
VVVDRKHVPEE	VVVDRKHVP
NRFSDHVAL	NRFSDHVAL
ERLQRFQNL	ERLQRFQNL
DRFKVKEV	DRFKV-KEV
SRVNRLSVL	SRVNRLSVL
DVYRKLIEL	DVYRKLIEL
DRNDRAIRV	DRNDRAIRV
NRYDGQVAVF	NRYDGQVAV
DRYERLTSV	DRYERLTSV
DRYGGQPL	DRYGG-QPL
TRIPKIQKL	TRIPKIQKL
DEVGHLAL	DEVGH-LAL
NRYGMGTSV	NRYGMGTSV
QDLRRTNSL	QDLRRTNSL
YRYYQQLKL	YRYYQQLKL
DRVVIQEM	DRVVI-QEM
DMYSHYVL	DMYSH-YVL
DQDVRHLAL	DQDVRHLAL
DRYEFSSHI	DRYEFSSHI
YSVEHNQL	YSVEH-NQL
IQAVRRSL	IQAVR-RSL
GRYLRRELL	GRYLRRELL
DRYLRPHAF	DRYLRPHAF
IRNIGKTL	IRNIG-KTL
SQLNRPNSL	SQLNRPNSL
IGYARNPSL	IGYARNPSL
TRILFKNTL	TRILFKNTL
NELERLSNL	NELERLSNL
DHYQRQRVL	DHYQRQRVL
SRWAGRAL	SRWAG-RAL
DRVRHSML	DRVRH-SML
ADYKRSSSL	ADYKRSSSL
VRYAHEKL	VRYAH-EKL
NAPWAVTSL	NAPWAVTSL
DSAMHLAL	DSAMH-LAL
DRYPKKLVQ	DRYPKKLVQ
LQNEHRVL	LQNEH-RVL
DGVKRTTPL	DGVKRTTPL
DDLKRATEL	DDLKRATEL
NRYIMKSFL	NRYIMKSFL
DRFNHFSL	DRFNH-FSL
QQAVRQNGL	QQAVRQNGL
IAYIRDLAL	IAYIRDLAL
LRFQSSAV	LRFQS-SAV
NVKVDPEIQ	NVKVDPEIQ
QRYNSFISL	QRYNSFISL
NRHYYSITI	NRHYYSITI
DAFERIDSF	DAFERIDSF
DRQKSRIL	DRQKS-RIL
DAQSRPTSL	DAQSRPTSL
SRHPFLTAL	SRHPFLTAL
IRLTGGEPLI	IRLTGGEPL
NRYGQLTIL	NRYGQLTIL
SRTPGRSEL	SRTPGRSEL
SRYYRAPEI	SRYYRAPEI
ISPTGHSL	ISPTG-HSL
IQSIRMGM	IQSIR-MGM
DRFQAEGSL	DRFQAEGSL
TQVKRLESL	TQVKRLESL
QRYLRSSRF	QRYLRSSRF
SRYLRAVL	SRYLR-AVL
DHIQRIMTL	DHIQRIMTL
IKYNRKISA	IKYNRKISA
DPVVHSAL	DPVVH-SAL
ERALRELAL	ERALRELAL
HHYLRPSL	HHYLR-PSL
DRAFHFTAM	DRAFHFTAM
QRFARMEL	QRFAR-MEL
SRVAKTNSL	SRVAKTNSL
SAPVGVTAL	SAPVGVTAL
DRVAIHEAM	DRVAIHEAM
MRKIREIVL	MRKIREIVL
DRYDGMVGF	DRYDGMVGF
QLFQRPNAL	QLFQRPNAL
DRLRYRNVI	DRLRYRNVI
NRYDGIYKV	NRYDGIYKV
HVFHHSVL	HVFHH-SVL
NGYLRAAEL	NGYLRAAEL
HRFYFENAL	HRFYFENAL
IRYFPTQAL	IRYFPTQAL
AAGPPISEGK	AAGPPISEG
MRMATPLLM	MRMATPLLM
DALVHFAL	DALVH-FAL
ERFADRSLL	ERFADRSLL
SRYGGGPAV	SRYGGGPAV
DRLTNGNSL	DRLTNGNSL
HRFGGLVL	HRFGG-LVL
DQIVRHDL	DQIVR-HDL
TPISRLVAL	TPISRLVAL
SRMSERQLAL	SRMSERLAL
NRFDAVQSA	NRFDAVQSA
DSYSHIMAL	DSYSHIMAL
DESIHLQL	DESIH-LQL
DRFGGALDA	DRFGGALDA
DQLRHGGL	DQLRH-GGL
HMVVHRDL	HMVVH-RDL
AFEAEVLHTVL	AEVLH-TVL
NHFDRSVVL	NHFDRSVVL
YEFVHHAL	YEFVH-HAL
FRYFRMPEL	FRYFRMPEL
SMPRINHGVL	PRINH-GVL
FQTIHKTI	FQTIH-KTI
NEVLHQEL	NEVLH-QEL
SSALHQTL	SSALH-QTL
DALQRSVQL	DALQRSVQL
LQAERRAL	LQAER-RAL
QRKERLYPL	QRKERLYPL
YRGERINQL	YRGERINQL
SRLKSILKL	SRLKSILKL
TEENRVLHQEL	NRVLH-QEL
GEELLHSVL	GEELLHSVL
RPTVHQTL	RPTVH-QTL
NRANRAVAI	NRANRAVAI
SLYRREESL	SLYRREESL
DRQIRLWGL	DRQIRLWGL
SRIARTLGL	SRIARTLGL
NRLKVGLQV	NRLKVGLQV
AGAGIALNDH	AGAGI--AL
SRLEERSVL	SRLEERSVL
HQIIHTGL	HQIIH-TGL
TRQLRNSTL	TRQLRNSTL
YRYNPRPRL	YRYNPRPRL
ERLKREAQL	ERLKREAQL
DRFLSSMSV	DRFLSSMSV
GRAFRTVTL	GRAFRTVTL
DHMLRGMPLSL	DHMLRGMPL
MRFDGLLGF	MRFDGLLGF
SRYFRMSDI	SRYFRMSDI
DKLKREIEL	DKLKREIEL
VVYKRYASL	VVYKRYASL
LRPGVRHPL	LRPGVRHPL
EQVLRWSSL	EQVLRWSSL
DEFVKSVL	DEFVK-SVL
MRYLGKVL	MRYLG-KVL
DQYSRFSL	DQYSR-FSL
QEYQRESML	QEYQRESML
SQAARLLSL	SQAARLLSL
DRFKVMKA	DRFKV-MKA
LAITHHVL	LAITH-HVL
DRDYRREVM	DRDYRREVM
MRTVKRETL	MRTVKRETL
TRRVHPAL	TRRVH-PAL
QLFQRTNAL	QLFQRTNAL
NRLPLVVSF	NRLPLVVSF
ERFNVPVSL	ERFNVPVSL
DMFYRNWAL	DMFYRNWAL
DRWWHATL	DRWWH-ATL
DRSLRVWSM	DRSLRVWSM
LAVLHTVL	LAVLH-TVL
NRHLHFTL	NRHLH-FTL
DQLSRLGSSSL	SRLGS-SSL
DGVPREGL	DGVPR-EGL
HPNVHFVL	HPNVH-FVL
DRMTLLLRL	DRMTLLLRL
NRLTWIVV	NRLTW-IVV
DRILRPEL	DRILR-PEL
YEFERTTSI	YEFERTTSI
NRMTHKLL	NRMTH-KLL
MRKVPRVSL	MRKVPRVSL
SVPLAATSM	SVPLAATSM
EEFTHTTL	EEFTH-TTL
EDYTRYNQL	EDYTRYNQL
LQSRHVAL	LQSRH-VAL
QQEQRTNAL	QQEQRTNAL
MEAEHNTL	MEAEH-NTL
YRYGREEML	YRYGREEML
IRAAWTRAL	IRAAWTRAL
DRANRFEYL	DRANRFEYL
LRYLRDDGL	LRYLRDDGL
SRLTAREAM	SRLTAREAM
DRIERMLRL	DRIERMLRL
MSARHMAL	MSARH-MAL
QRVFPHAEF	QRVFPHAEF
DELERITKL	DELERITKL
VVVDRKHVP	VVVDRKHVP
HELQRFYSL	HELQRFYSL
YQFLHHTL	YQFLH-HTL
SDLERVTSL	SDLERVTSL
SQFSHMSL	SQFSH-MSL
DVYERLTNL	DVYERLTNL
DTYSHQAL	DTYSH-QAL
NEFLRSGL	NEFLR-SGL
HRLTDRLQV	HRLTDRLQV
MRYLLKVQF	MRYLLKVQF
SRMIRKMKL	SRMIRKMKL
LRLEHTKL	LRLEH-TKL
AAPAYSRAL	AAPAYSRAL
QEVLRTLAL	QEVLRTLAL
SGYVRGQTL	SGYVRGQTL
VAVIHQSL	VAVIH-QSL
VRYVLKEGL	VRYVLKEGL
QRFEGTTSL	QRFEGTTSL
SRLPLRAQI	SRLPLRAQI
SQTQRLEAL	SQTQRLEAL
DVYQRIVWL	DVYQRIVWL
TRTEQTFIL	TRTEQTFIL
LRIQQREQL	LRIQQREQL
LPDERTISL	LPDERTISL
IEIIHEEL	IEIIH-EEL
VRIYDRRML	VRIYDRRML
LRLPGRKL	LRLPG-RKL
ERLSRETAL	ERLSRETAL
ERSIHDAL	ERSIH-DAL
ERYFISHVL	ERYFISHVL
DRSAHFSTL	DRSAHFSTL
ERISRGGSL	ERISRGGSL
SRVLKVLSV	SRVLKVLSV
VRFDVHDVTL	VRFDVHVTL
DRARYSAF	DRARY-SAF
SRFEGLSPL	SRFEGLSPL
LQLERAQSL	LQLERAQSL
EVLQRGEAL	EVLQRGEAL
NAAERRGPL	NAAERRGPL
DLEERKNSL	DLEERKNSL
APFQHSPL	APFQH-SPL
DHFASVHSV	DHFASVHSV
DVMIRKEEL	DVMIRKEEL
YRATHRLL	YRATH-RLL
DELRRHLEL	DELRRHLEL
DRIIRGNQL	DRIIRGNQL
DRFEFPEQL	DRFEFPEQL
IEYARQLEM	IEYARQLEM
DRYTIHSQL	DRYTIHSQL
SVPEAQSAL	SVPEAQSAL
DMYNRMTSA	DMYNRMTSA
DRLINSEL	DRLIN-SEL
ERLEHPVL	ERLEH-PVL
DRYSGNVTI	DRYSGNVTI
YRLKAHQRL	YRLKAHQRL
AVITRAPVL	AVITRAPVL
QDYKRMNML	QDYKRMNML
FRVPTANVS	FRVPTANVS
DNYKRVTGTSL	KRVTG-TSL
NQLTHTDL	NQLTH-TDL
DEATRLMAL	DEATRLMAL
FRLPRKEKL	FRLPRKEKL
VRMVRVLTV	VRMVRVLTV
SIPYKREESL	IPYKREESL
HRGHHTFL	HRGHH-TFL
DAVIRNNTL	DAVIRNNTL
FEAIHHEL	FEAIH-HEL
DRMLRSALL	DRMLRSALL
HGLIHNVL	HGLIH-NVL
ERLLTYNSL	ERLLTYNSL
NRYDKKYSW	NRYDKKYSW
ERWARPPAV	ERWARPPAV
RPWLRPAAL	RPWLRPAAL
EELERTAEL	EELERTAEL
DRFKSHPSL	DRFKSHPSL
QRLIRESAL	QRLIRESAL
DRVRALEL	DRVRA-LEL
VRHGRSLAL	VRHGRSLAL
QEAVRNQSL	QEAVRNQSL
RVYIHPFHL	RVYIHPFHL
DNYVRETKL	DNYVRETKL
DRYLAVVHA	DRYLAVVHA
IRQQRLISI	IRQQRLISI
AAPSAAREL	AAPSAAREL
ERIDTRNEL	ERIDTRNEL
DTYPRKWGL	DTYPRKWGL
SRFSHLTSL	SRFSHLTSL
LAPTDVKEL	LAPTDVKEL
NRHLFKDKV	NRHLFKDKV
NSFTHEAL	NSFTH-EAL
LEFLRDEEL	LEFLRDEEL
NRIHHKLVL	NRIHHKLVL
IGTTHVTL	IGTTH-VTL
VRSLRTAAL	VRSLRTAAL
AHFPHQVL	AHFPH-QVL
IRFGRKPSL	IRFGRKPSL
SRMPGELVL	SRMPGELVL
SRIEDRRIL	SRIEDRRIL
DRLLRIRAL	DRLLRIRAL
NRVIHRDL	NRVIH-RDL
DRVAHMEF	DRVAH-MEF
DRAKHLEF	DRAKH-LEF
LRVVRVVDL	LRVVRVVDL
DRIQRNKAAAL	DRIQRNKAA
QRLQRLERL	QRLQRLERL
SQLERENTL	SQLERENTL
IRMEREALL	IRMEREALL
SRVIRVSEL	SRVIRVSEL
NVATHSTL	NVATH-STL
IHAKRVTIM	IHAKRVTIM
DPRHGRYLTV	PRHGRYLTV
YFAERVTSL	YFAERVTSL
EEWERHEAL	EEWERHEAL
NQRHRDLEL	NQRHRDLEL
VRLIMDSL	VRLIM-DSL
VRYPGTTRV	VRYPGTTRV
DAYVRRMAA	DAYVRRMAA
NPQLRSVAL	NPQLRSVAL
MAAQRQRAL	MAAQRQRAL
DQRERLAPF	DQRERLAPF
DELLRVTDL	DELLRVTDL
LRYAAVRTL	LRYAAVRTL
NRIVHISV	NRIVH-ISV
NRYIANTV	NRYIA-NTV
DRFHEMHVAL	DRFHEMVAL
MRLGGRLVL	MRLGGRLVL
QRVADRLGL	QRVADRLGL
AIQVVRSAL	AIQVVRSAL
DHYQRILQL	DHYQRILQL
SFSKAFGQ	SFSKA-FGQ
DAYALNHTL	DAYALNHTL
DRMFHIRAV	DRMFHIRAV
NRISHHKIL	NRISHHKIL
SRLERREQL	SRLERREQL
DQVARTHL	DQVAR-THL
LEVARNVAL	LEVARNVAL
HDKYERLVKL	DKYERLVKL
DNAVRNAAL	DNAVRNAAL
DRYQYPFVL	DRYQYPFVL
TEFKRGLPL	TEFKRGLPL
SPYLRPLTL	SPYLRPLTL
SRLLKGTSL	SRLLKGTSL
DQVVKTIGL	DQVVKTIGL
LRELEREVL	LRELEREVL
SRYQAQHGAL	SRYQAQGAL
DRYIFASNL	DRYIFASNL
VPHFHHEL	VPHFH-HEL
VQQKRPTAL	VQQKRPTAL
SQLSRTAAL	SQLSRTAAL
VDLERTIAL	VDLERTIAL
DRVIHLLAL	DRVIHLLAL
DRTMRQRAL	DRTMRQRAL
DVQLRLNSI	DVQLRLNSI
MEVVHKEL	MEVVH-KEL
LRHDRPYTL	LRHDRPYTL
SRYMKLTVV	SRYMKLTVV
DRFLRQLDF	DRFLRQLDF
DTLQRVNQL	DTLQRVNQL
DVAYHNSL	DVAYH-NSL
LEETHKAL	LEETH-KAL
DQFQKVLSL	DQFQKVLSL
DRLNHLLSV	DRLNHLLSV
DQFLREVL	DQFLR-EVL
LQVLHRKL	LQVLH-RKL
NRFNYPFEL	NRFNYPFEL
KRINWRTVL	KRINWRTVL
EQVLHKQL	EQVLH-KQL
VRNNLRSAL	VRNNLRSAL
QQYLRQEVL	QQYLRQEVL
NHTTHMSL	NHTTH-MSL
MEYLRFREL	MEYLRFREL
TRVQSRLAL	TRVQSRLAL
DQIIRLEKL	DQIIRLEKL
NVTNHGAL	NVTNH-GAL
DAVERHAL	DAVER-HAL
MRLGPRTAA	MRLGPRTAA
SRVEFRLSL	SRVEFRLSL
NRFGGGPAV	NRFGGGPAV
YRLMRDNNL	YRLMRDNNL
APAYQRFHAL	PAYQRFHAL
NRLISQIV	NRLIS-QIV
YEMQRNLSL	YEMQRNLSL
QQLQRIAQL	QQLQRIAQL
EEQLQQIRAE	EQLQQIRAE
NRMADAIIL	NRMADAIIL
NRIIHRDL	NRIIH-RDL
TRLESRTQL	TRLESRTQL
NNMQRQLAL	NNMQRQLAL
DQVKRYYSV	DQVKRYYSV
RRYSATRAAL	RRYSATAAL
DRHERITKL	DRHERITKL
LQAQRENL	LQAQR-ENL
LEGRHAEL	LEGRH-AEL
HVVIHQSL	HVVIH-QSL
HRLPHVLLL	HRLPHVLLL
ADRERKVAL	ADRERKVAL
ERYRAITSA	ERYRAITSA
ESALRKQSL	ESALRKQSL
TRIKKHLSL	TRIKKHLSL
AQYEDIAQKS	AQYEDIAQK
DRQYKDYKI	DRQYKDYKI
DQASRLQSL	DQASRLQSL
AEFQHLVL	AEFQH-LVL
DRLLRTMAF	DRLLRTMAF
DAAIRVWSL	DAAIRVWSL
LRFGNPLLV	LRFGNPLLV
NRAPSLTL	NRAPS-LTL
DRHIWITAA	DRHIWITAA
VRAKWFPEV	VRAKWFPEV
HRQVRKYVM	HRQVRKYVM
DRFSDSHNAL	DRFSDSNAL
ERLVRAYEL	ERLVRAYEL
DGFRHQAL	DGFRH-QAL
DPFNPFELTNH	DPFNP-FEL
NRYQGGFLI	NRYQGGFLI
NRRLKKYAL	NRRLKKYAL
HEVLHHTL	HEVLH-HTL
IRMEHVKIV	IRMEHVKIV
DQFSRSVNVSL	DQFSRSVSL
DQKERDVIM	DQKERDVIM
IRYVTPRAL	IRYVTPRAL
DRFLSKMKV	DRFLSKMKV
MRLSRELQL	MRLSRELQL
DRFLKVYDL	DRFLKVYDL
DSYRKKVVL	DSYRKKVVL
NQVARFNDL	NQVARFNDL
HTSDRALHAKL	DRALH-AKL
DQVIHSNPA	DQVIHSNPA
SEYQRFAVM	SEYQRFAVM
IRLDKKLSV	IRLDKKLSV
MRFLAATFL	MRFLAATFL
HYDRSGRSL	HYDRSGRSL
VRFHRPYRL	VRFHRPYRL
DRVTRLEFL	DRVTRLEFL
DELKRSVAL	DELKRSVAL
NRLENDGATAL	LENDGATAL
DRYLQSGGGM	DRYLQSGGM
MRLLPRLL	MRLLP-RLL
NQIIHRDL	NQIIH-RDL
MEYERQVASL	MEYERQASL
MEALHLHL	MEALH-LHL
VRTVMRVPL	VRTVMRVPL
DRYLPDTL	DRYLP-DTL
DQLLRNNDL	DQLLRNNDL
QRYARPPVL	QRYARPPVL
SPASRSISL	SPASRSISL
DRYISKMFL	DRYISKMFL
