Data	Data aligned
LEKLNDIQL	LEKLNDIQL
KELKKSLKI	KELKKSLKI
GEYFAIKAL	GEYFAIKAL
AEIDPKQLVDI	AEIDPKQLV
AEAVNRAITI	AEAVNAITI
AENPFLTHL	AENPFLTHL
IEVNPQTRI	IEVNPQTRI
IEEYVHRI	IEEY-VHRI
TEIESDLRSV	TEIESLRSV
TEYGVHFHRV	TEYGVFHRV
LEEKGKRVI	LEEKGKRVI
IEPELPMQLV	IEPELMQLV
AAGPPISEGK	AAGPPISEG
IEIVGGATRI	IEIVGATRI
SESRYPQALV	SESRYQALV
AEVDNSKQLI	AEVDNKQLI
YEYASKGIFV	YEYASGIFV
GESGKSTIV	GESGKSTIV
AEYAHPLETLI	AEYAHLETL
VEIPPNKAV	VEIPPNKAV
VESEHQVKI	VESEHQVKI
TEKPTVTV	TEKP-TVTV
AEKNLGESEI	AEKNLESEI
TEMESMKTTL	TEMESKTTL
RELDLQRNYI	RELDLRNYI
LEPEYYFSTI	LEPEYFSTI
YEYDRKWGI	YEYDRKWGI
KEHPLFKKL	KEHPLFKKL
KEYDALKAA	KEYDALKAA
AENPDIFAV	AENPDIFAV
LENFPLNTI	LENFPLNTI
VEYETKAGRI	VEYETAGRI
GEILNEVKI	GEILNEVKI
SELNQKRPQYI	SELNQPQYI
VEDPRVLLL	VEDPRVLLL
YENEVALRQ	YENEVALRQ
AEIRHVLV	AEIR-HVLV
GEGNIRSV	GEGN-IRSV
ISSSSFSR	ISSS-SFSR
KNTVELLTDR	VELL-----
SENGALPVV	SENGALPVV
VESEAHVKI	VESEAHVKI
AEKGGSLVV	AEKGGSLVV
LEVRLQAV	LEVR-LQAV
RENFFPVTV	RENFFPVTV
FEHENKFYI	FEHENKFYI
GERPQITI	GERP-QITI
AEVNSSGKTI	AEVNSGKTI
REHDWNNSI	REHDWNNSI
KEFPGLAGVKI	KEFPGLAGV
AERDKALRV	AERDKALRV
MENDLPQKI	MENDLPQKI
LERESKVVV	LERESKVVV
AELQRVQKV	AELQRVQKV
VENKKAQLV	VENKKAQLV
SENGWLKAV	SENGWLKAV
AEVYGIADKI	AEVYGADKI
AEIVPVTTTV	AEIVPTTTV
AEVELASRV	AEVELASRV
GLTSVINQK	GLTSVINQK
REMENYEKI	REMENYEKI
LEAEPIRML	LEAEPIRML
IELPNIQKV	IELPNIQKV
GEYIKTWRP	GEYIKTWRP
SEDKGALAKLV	SEDKGLAKL
IEMDKGTYI	IEMDKGTYI
GEIQETSKKI	GEIQESKKI
IEKDIAAHI	IEKDIAAHI
QENPFLFSTI	QENPFFSTI
RENGKTVIRV	RENGKVIRV
HEQLTVAEI	HEQLTVAEI
REVTSPNSTV	REVTSNSTV
HELEQMQLI	HELEQMQLI
AEWRPEEGFV	AEWRPEGFV
TELISVSEV	TELISVSEV
SEQTGLLKI	SEQTGLLKI
SELYRPSFV	SELYRPSFV
VEIGVFPLI	VEIGVFPLI
MEDTGHYSI	MEDTGHYSI
LQIDNARLA	LQIDNARLA
GEPSHSVKV	GEPSHSVKV
AEYENLTNKL	AEYENTNKL
LEFPVEVNTV	LEFPVVNTV
MEHPQRQNV	MEHPQRQNV
TETVFVPVI	TETVFVPVI
HAAEYGAEALE	AEYG-AEAL
KEAHEPLAV	KEAHEPLAV
REPLSLINV	REPLSLINV
REAPERPSL	REAPERPSL
GEIDKRVEV	GEIDKRVEV
SELANKLITV	SELANLITV
SEIGDASRV	SEIGDASRV
GEIVALKKV	GEIVALKKV
KEAGKFSAV	KEAGKFSAV
GEVHPSEMI	GEVHPSEMI
VEIRNLHNV	VEIRNLHNV
GEFILKTYV	GEFILKTYV
HENAFIVFI	HENAFIVFI
WEIDNNPKV	WEIDNNPKV
QEVYIPFSAI	QEVYIFSAI
FEAPNQEKV	FEAPNQEKV
SEAKSVKV	SEAK-SVKV
MEELLQNEV	MEELLQNEV
AEILGSGAGI	AEILGGAGI
SEAEAKAQI	SEAEAKAQI
FETIVKQQI	FETIVKQQI
LEFLDRESI	LEFLDRESI
KEQETALRV	KEQETALRV
AEGPVVEKI	AEGPVVEKI
SESAAVKEI	SESAAVKEI
QEFQNFKTL	QEFQNFKTL
FESGDVKATV	FESGDKATV
NEWVAVNTV	NEWVAVNTV
IEHISSLI	IEHI-SSLI
AEGEKVKQV	AEGEKVKQV
AEMANILVI	AEMANILVI
LENIFDWNV	LENIFDWNV
GEERLRSTI	GEERLRSTI
LEDLNFPEI	LEDLNFPEI
YEYHWADGTNI	YEYHWGTNI
AETSQRLV	AETS-QRLV
KEYDGFTITI	KEYDGTITI
LEGSEVRTI	LEGSEVRTI
SELEKPQKV	SELEKPQKV
AEKLQRITV	AEKLQRITV
IENESVKI	IENE-SVKI
YEFKGHSLL	YEFKGHSLL
AEEKNGVVFI	AEEKNVVFI
REKEDGAFSFV	KEDGAFSFV
VGEFSGANK	VGEFSGANK
GEIPTLKTL	GEIPTLKTL
AEAEASRLTA	AEAE-ASRL
AEKVDAVRI	AEKVDAVRI
GETDPLLI	GETD-PLLI
AERLFENQL	AERLFENQL
GEKVNIISV	GEKVNIISV
MEVKPSSVTA	MEVK-PSSV
QEMEKMTKKI	QEMEKTKKI
VEIQTPKII	VEIQTPKII
QEATHFPKV	QEATHFPKV
LEDGNFLKL	LEDGNFLKL
AELGKLYSV	AELGKLYSV
LEVPRSISV	LEVPRSISV
SELIPGTTV	SELIPGTTV
KEVDGLLRI	KEVDGLLRI
GEIAPRTVV	GEIAPRTVV
NLLSVAYK	NLLS-VAYK
GEHALGTPEV	GEHALTPEV
ESYSIYVYK	ESYSIYVYK
VENPFFGQRYI	VENPFFGQR
SEVEQYVKV	SEVEQYVKV
TEALPVKLI	TEALPVKLI
GEGKSTTTI	GEGKSTTTI
TEEVSKNLV	TEEVSKNLV
TELIKVDKV	TELIKVDKV
LEDIYRPTI	LEDIYRPTI
GETYNGHLV	GETYNGHLV
IEVENKNNL	IEVENKNNL
KEFKEVEKV	KEFKEVEKV
YEIHDGMNL	YEIHDGMNL
DPFNPFELTNH	FELT-----
GEIVGSQGSRL	GEIVGQGSR
VQVEYKGETK	VEYK-GETK
READAALFSEL	READAFSEL
KESIPFAVV	KESIPFAVV
GEMPAEPMTI	GEMPAPMTI
AESLHKTIV	AESLHKTIV
AEIVTKTI	AEIV-TKTI
GERDDQQVFI	GERDDQVFI
VESKFERTV	VESKFERTV
SEILRMERI	SEILRMERI
REMENIIATV	REMENIATV
DYNVTANSK	DYNVTANSK
REYSEFKRQQL	SEFK-RQQL
LEKEQVAHI	LEKEQVAHI
YEQAWYAKL	YEQAWYAKL
AEDYIFKAV	AEDYIFKAV
LTVGNNKTL	LTVGNNKTL
KEQIKWSLL	KEQIKWSLL
AEDPPMVVV	AEDPPMVVV
VEIQTPKI	VEIQ-TPKI
GEHPGVAGI	GEHPGVAGI
GENPHGVKAV	GENPHVKAV
AEREQEEAI	AEREQEEAI
GEFIIGRVI	GEFIIGRVI
IENSIVHRV	IENSIVHRV
HEVDELTQII	HEVDELTQI
AEMRPFIEII	AEMRPFIEI
KELATVRTI	KELATVRTI
GEVVTTIPTI	GEVVTIPTI
AEKDNAEIRV	AEKDNEIRV
AEVTTKSQI	AEVTTKSQI
LEVILRPKI	LEVILRPKI
TEVFLHVV	TEVF-LHVV
VEAAFQTI	VEAA-FQTI
STFSTNYR	STFS-TNYR
YEEFLSKV	YEEF-LSKV
GEFEKGGKSV	GEFEKGKSV
REYLRVNVV	REYLRVNVV
AETEPKFNSV	AETEPFNSV
AENKPGLQI	AENKPGLQI
KEDVKPYQV	KEDVKPYQV
YEQVSTPEI	YEQVSTPEI
YEIQKGQALI	YEIQKQALI
REVQAEIGKL	REVQAIGKL
GEISRMREV	GEISRMREV
DSETGENIR	DSETGENIR
VLENAEGAR	VLENAEGAR
QEFGPISYV	QEFGPISYV
KEGKPPISV	KEGKPPISV
AEVGDGTTSV	AEVGDTTSV
REYQDLLNVKM	REYQDLLNV
SEQQALHTV	SEQQALHTV
REGDVITII	REGDVITII
HEVSLQESI	HEVSLQESI
RENGKPVTV	RENGKPVTV
LEFDTGIHYI	LEFDTIHYI
REMPLLKSEV	REMPLKSEV
QEVLEMRKI	QEVLEMRKI
KEKEFEETM	KEKEFEETM
EEYGKILEV	EEYGKILEV
YEIDKTLGI	YEIDKTLGI
AELEKSTQTI	AELEKTQTI
GEHLPFLTSV	GEHLPLTSV
AENPFQEPRTV	AENPFPRTV
REFDFFNKI	REFDFFNKI
TEQQPQPYV	TEQQPQPYV
LEHPFVSSI	LEHPFVSSI
SEYLKLGYV	SEYLKLGYV
HEFFHILNL	HEFFHILNL
LEHSLPHSV	LEHSLPHSV
AELFVETI	AELF-VETI
GEAELNWSRL	GEAELWSRL
AEIEALEKM	AEIEALEKM
IEYAKPTRL	IEYAKPTRL
AEIVTPEI	AEIV-TPEI
KESLPLFKI	KESLPLFKI
FEFDIHQVI	FEFDIHQVI
YEFSSHIV	YEFS-SHIV
GEITGHNKV	GEITGHNKV
AEKLDEIYV	AEKLDEIYV
AEGQGQGQLLI	AEGQGGQLL
QEYAQVIKM	QEYAQVIKM
AEAGPIVI	AEAG-PIVI
TENPHGVKAV	TENPHVKAV
AEPDIISTI	AEPDIISTI
AEVRAVQEI	AEVRAVQEI
YEDLINKI	YEDL-INKI
AEYLTPVL	AEYL-TPVL
MEIPVTLI	MEIP-VTLI
ELQTHPEL	ELQT-HPEL
RETDVAKKI	RETDVAKKI
SEVESLRL	SEVE-SLRL
GEVTFKSI	GEVT-FKSI
GEVGKTTGI	GEVGKTTGI
KEMGGHHIV	KEMGGHHIV
REQDQTLLL	REQDQTLLL
APGEVLRSVP	APGEVLRSV
QEYIDAHPETI	QEYIDPETI
EEIAQVATI	EEIAQVATI
TEKQWLRAI	TEKQWLRAI
AAQEEYVK	AAQE-EYVK
AERPTVARI	AERPTVARI
HEIPSLQSI	HEIPSLQSI
AEAVLYEHL	AEAVLYEHL
SEAPPSKMV	SEAPPSKMV
AELADREKI	AELADREKI
REFGNLHNTV	REFGNHNTV
VEAPPSVVL	VEAPPSVVL
QEIKDLKQKI	QEIKDKQKI
TELKQVAYI	TELKQVAYI
KELEFYLRKI	KELEFLRKI
GELLPQIFV	GELLPQIFV
REIDKKMNSI	REIDKMNSI
SEHKVFDLV	SEHKVFDLV
QEFGILDKV	QEFGILDKV
AEWEESQTQKI	WEESQTQKI
QEVDLQQLI	QEVDLQQLI
QEIASLDVKI	QEIASDVKI
SEDRIITI	SEDR-IITI
KETIDNNSV	KETIDNNSV
REMQSVVQLI	REMQSVQLI
KEYPPHVQKV	KEYPPVQKV
ESLRLILV	ESLR-LILV
IEKNIELF	IEKN-IELF
AETGLLSAI	AETGLLSAI
GEFEGFVAV	GEFEGFVAV
KEVIKTNNV	KEVIKTNNV
SEVERPASI	SEVERPASI
IESKHEVTI	IESKHEVTI
YEVRLNDTI	YEVRLNDTI
AENQRITAV	AENQRITAV
GEIYTGTSV	GEIYTGTSV
KENGRTLVV	KENGRTLVV
SERKTKFAKV	SERKTFAKV
REHANKLIEV	REHANLIEV
SEDSSVTQI	SEDSSVTQI
TEAEKQMLV	TEAEKQMLV
AEMEKATEV	AEMEKATEV
GEVDKRELI	GEVDKRELI
KEYQPHVIV	KEYQPHVIV
VEQILPTLV	VEQILPTLV
LEDELRQEV	LEDELRQEV
KEFEGKTLV	KEFEGKTLV
KEDDVRQYV	KEDDVRQYV
IEIDSPYEI	IEIDSPYEI
EEFLSKVSI	EEFLSKVSI
REFLFNAI	REFL-FNAI
IESDRLALLQV	IESDRLALL
LENSKQPSV	LENSKQPSV
TEIEGTQKL	TEIEGTQKL
NEQPPVVL	NEQP-PVVL
HEFTTSARI	HEFTTSARI
KEAEPIPETV	KEAEPPETV
AEAPNMAVV	AEAPNMAVV
REYQELMSV	REYQELMSV
LEIEQSMNRV	LEIEQMNRV
AEDGSAGVRV	AEDGSGVRV
AEIVTPFNI	AEIVTPFNI
IEKLGGLVI	IEKLGGLVI
REYHTDTTV	REYHTDTTV
HEIERHFIEI	HEIERFIEI
AEAPHIVV	AEAP-HIVV
NESELFGRTI	SELF-GRTI
SEVDKVVEV	SEVDKVVEV
NEVDRMVLV	NEVDRMVLV
LESEEFQKI	LESEEFQKI
AEVEDMASRI	AEVEDASRI
REEPPGTFSVI	REEPPTFSV
ESFDGSVR	ESFD-GSVR
GEFGKPYFI	GEFGKPYFI
LEDPSSGLGV	LEDPSGLGV
SETPQLFTV	SETPQLFTV
GEIIGKRGII	GEIIGKRGI
SEIKSIPGV	SEIKSIPGV
LEDRGIRKI	LEDRGIRKI
IEKEGVTLV	IEKEGVTLV
QEVIITKFI	QEVIITKFI
REIQEREMKV	REIQEEMKV
KEMEQLLEM	KEMEQLLEM
GEIKWIDFV	GEIKWIDFV
TEEERLVTI	TEEERLVTI
QEVPASGLFRI	QEVP-ASGL
AEYISTVKT	AEYISTVKT
KELELPENI	KELELPENI
SEIGTKQI	SEIG-TKQI
KEYTNPEQI	KEYTNPEQI
FEQFLREKV	FEQFLREKV
IEQDTDTKI	IEQDTDTKI
EEYFMRETV	EEYFMRETV
KEAPAKVEV	KEAPAKVEV
SESVLRTQI	SESVLRTQI
GEGPQSQKI	GEGPQSQKI
AEVGVPVSV	AEVGVPVSV
QETELSQRI	QETELSQRI
VETHTIHKI	VETHTIHKI
QEAEMAQNAV	QEAEMQNAV
TEYAGPLFI	TEYAGPLFI
AERWIVNLI	AERWIVNLI
LESKLGKTI	LESKLGKTI
YETPTGIKV	YETPTGIKV
VEVKRPRGV	VEVKRPRGV
GEFPDLHRTI	GEFPDHRTI
AEALVGQVLV	AEALVQVLV
LELEKHIRV	LELEKHIRV
IEDPKLGKV	IEDPKLGKV
MEHGTVTVV	MEHGTVTVV
TEFDQLRSI	TEFDQLRSI
AEYEFISSGL	AEYEFSSGL
HLPETKFSEL	PETK-FSEL
TENHLIRKI	TENHLIRKI
QEENITRALI	EENITRALI
LEKKFHTV	LEKK-FHTV
REIEGRAIRL	REIEGAIRL
SEMDSVLMKI	SEMDSLMKI
AELDKLTSV	AELDKLTSV
RNVSTGDVNVE	RNVSTDVNV
WELEKKSAV	WELEKKSAV
TETLHFVSI	TETLHFVSI
GEEALLRYV	GEEALLRYV
LEVDTKKQI	LEVDTKKQI
SEKEFKAYV	SEKEFKAYV
IEKKATATI	IEKKATATI
KEYEPEMGKVI	KEYEPMGKV
QELNELSAI	QELNELSAI
TEFGGSIYQKV	TEFGGIYQK
GELLPARKI	GELLPARKI
KEIFETPTEI	KEIFEPTEI
AEQLPVAQI	AEQLPVAQI
REEEHKPVAV	REEEHPVAV
QEIANQKGV	QEIANQKGV
YEYQPLQI	YEYQ-PLQI
LEVQSNPKI	LEVQSNPKI
GEIVIGGQNI	GEIVIGQNI
YEQILNTKL	YEQILNTKL
GEYFPGTGDL	GEYFPTGDL
IEILGVRNV	IEILGVRNV
HEGFVRGI	HEGF-VRGI
VEFRNFKIIY	VEFRNFKII
HEKIFNTV	HEKI-FNTV
GEFEKKYVA	GEFEKKYVA
RETSLAENI	RETSLAENI
AEVDKVARL	AEVDKVARL
REQHFHSQV	REQHFHSQV
REVPEYLNHV	REVPELNHV
VENLPPHII	VENLPPHII
HEYPDLVHKV	HEYPDVHKV
AERIFSEV	AERI-FSEV
KEYDSISRL	KEYDSISRL
READFARV	READ-FARV
HEVAPPRLV	HEVAPPRLV
AEYPEGFEI	AEYPEGFEI
QEYPTLKV	QEYP-TLKV
AEIRVHTV	AEIR-VHTV
SEQSRSVNI	SEQSRSVNI
HEVDKLYKV	HEVDKLYKV
FEHKAQHI	FEHK-AQHI
LERQGQGQLV	LERQGGQLV
FEAQVVRV	FEAQ-VVRV
FESGNLRKV	FESGNLRKV
AEFLSEHPNV	AEFLSHPNV
QEMPSLEVI	QEMPSLEVI
AETPEGHAV	AETPEGHAV
AEEEAATRI	AEEEAATRI
REQPYYLNLI	REQPYLNLI
RELPTSSAI	RELPTSSAI
AELEGKSSSI	AELEGSSSI
SELSPGRSV	SELSPGRSV
REFDKRFTSV	REFDKFTSV
YEVVDKDSI	YEVVDKDSI
KESDHIHII	KESDHIHII
RETVIKQTM	RETVIKQTM
AENLFRAFL	AENLFRAFL
IEALLHTV	IEAL-LHTV
IESNHPVVI	IESNHPVVI
SEDQRTPLM	SEDQRTPLM
AEWVRAGATTV	AEWVRATTV
IEYDPERRLGI	IEYDPERRL
KEFSSEARV	KEFSSEARV
AESTLPGRHTV	STLPGRHTV
AEYANYYTREV	AEYANYYTR
MEMFQPSAV	MEMFQPSAV
LEFPQLIRV	LEFPQLIRV
YEILLHEV	YEIL-LHEV
IEEPSAKI	IEEP-SAKI
YELPENIRV	YELPENIRV
YETIDKELI	YETIDKELI
QEIKSAHKI	QEIKSAHKI
LEALPTGTVL	LEALPTGTV
LEYEARQI	LEYE-ARQI
YEELVRMV	YEEL-VRMV
FEDNDFVFV	FEDNDFVFV
FEVKKWNAV	FEVKKWNAV
EVIEPSDTL	EVIEPSDTL
AEKLGGSAVI	AEKLGGSAV
LEGPPSRNV	LEGPPSRNV
HEAAALNAV	HEAAALNAV
READPMTKV	READPMTKV
SEWKSGTKV	SEWKSGTKV
AEYLILHLI	AEYLILHLI
SEFRAFSSF	SEFRAFSSF
GEGFQTVRV	GEGFQTVRV
KEHIAASV	KEHI-AASV
YGIYNVTMVV	GIYNVTMVV
KEIAAVIETV	KEIAAIETV
SEHFRIDGPVI	SEHFRGPVI
AEAALKKEV	AEAALKKEV
LEAFVKMV	LEAF-VKMV
TEVLVSKV	TEVL-VSKV
KEGEIIHLI	KEGEIIHLI
GEFGGFGSV	GEFGGFGSV
GEAQPTKSL	GEAQPTKSL
AELGVPLSQV	AELGVLSQV
KGEFGGFGSV	GEFGGFGSV
HERANLLEI	HERANLLEI
AEKLVTQII	AEKLVTQII
LEFLHSNQVI	LEFLHSNQV
RESPRPLQL	RESPRPLQL
TEDNGFHAI	TEDNGFHAI
SEDIKNLVV	SEDIKNLVV
LEIWKESTTV	LEIWKSTTV
QEAPSVARI	QEAPSVARI
AEVGRVLQV	AEVGRVLQV
HEYVPWVTV	HEYVPWVTV
YEFFAKRQLV	YEFFARQLV
IEAVLLNSL	IEAVLLNSL
EEDQGSKLIR	EEDQGSKLI
GEDLPTIVI	GEDLPTIVI
IEIGVQHI	IEIG-VQHI
SEVFHQAMV	SEVFHQAMV
AEEPRGGLKI	AEEPRGLKI
AEIMQAVRL	AEIMQAVRL
REAEFTKSIA	REAEFTKSI
SEGNGSHTI	SEGNGSHTI
EEFNQPLSV	EEFNQPLSV
YEYSGYNYL	YEYSGYNYL
KESEPAEEV	KESEPAEEV
AERENFHRL	AERENFHRL
IEIVPGKVFV	IEIVPKVFV
DAREILKQI	DAREILKQI
AEDPLGAIHL	AEDPLAIHL
REISDGLVEI	REISDLVEI
KEVFIRELI	KEVFIRELI
STLANVVTSL	TLANVVTSL
AEGDIGKAEV	AEGDIKAEV
QEVLKTALI	QEVLKTALI
LEEQASRQI	LEEQASRQI
RELKGAKLV	RELKGAKLV
YENIPIRHH	YENIPIRHH
LEGNFAKEV	LEGNFAKEV
AELLFNTI	AELL-FNTI
QEVEDRPEV	QEVEDRPEV
FEEIPIAHI	FEEIPIAHI
SEGPIVATL	SEGPIVATL
HEVPYPDARI	HEVPYDARI
TELPKKTEV	TELPKKTEV
LETTGGHSV	LETTGGHSV
KEIFFNILV	KEIFFNILV
AEPSFPFQVA	AEPSFPFQV
AEIIKQLKI	AEIIKQLKI
TESKTVIKV	TESKTVIKV
LEPSETLVV	LEPSETLVV
SESFIQHIV	SESFIQHIV
TESTPITAV	TESTPITAV
GESDELIGQKV	GESDEGQKV
AEAERTFAEV	AEAERFAEV
GEAPSKTLV	GEAPSKTLV
TEHKALTSEI	TEHKATSEI
TELEHSGIGRI	LEHSGIGRI
GEPIGRGTKV	GEPIGGTKV
SEYARPHVM	SEYARPHVM
QEVSQLNKI	QEVSQLNKI
GELKITSV	GELK-ITSV
EVEEDEYK	EVEE-DEYK
AEHPNVTLTI	AEHPNTLTI
REYMGFIQA	REYMGFIQA
REDSITVHI	REDSITVHI
REVSTGTTI	REVSTGTTI
VEITPTSSRI	VEITPSSRI
AETGQVQKI	AETGQVQKI
GEDSSFLVV	GEDSSFLVV
VEILMRPTI	VEILMRPTI
LESDPQQVV	LESDPQQVV
IESQDAGIKTI	SQDAGIKTI
VEVDSGRQI	VEVDSGRQI
AEYDNFFQHL	AEYDNFQHL
GEYTHIRNI	GEYTHIRNI
SEQNDILKV	SEQNDILKV
TEINFTQKL	TEINFTQKL
AEAVGVKI	AEAV-GVKI
KEALYALTV	KEALYALTV
AEDHINFTI	AEDHINFTI
VEIILHVV	VEII-LHVV
SEVSTVLKL	SEVSTVLKL
REIEIQAHL	REIEIQAHL
TEQGGAHFSV	TEQGGHFSV
VETGYLNSV	VETGYLNSV
AEGPETKI	AEGP-ETKI
EEIEREVNI	EEIEREVNI
LESLPSPTL	LESLPSPTL
AEMETQKEKI	AEMETKEKI
REMEQKHSTI	REMEQHSTI
LEALVPVTI	LEALVPVTI
SETRSITNTTV	SETRSITNT
KEVNFTSEL	KEVNFTSEL
SESPDHYLV	SESPDHYLV
MEFKAVQQV	MEFKAVQQV
AEFVGVSHL	AEFVGVSHL
GEARPGPTA	GEARPGPTA
AENPPSGSV	AENPPSGSV
TEKGGLVEV	TEKGGLVEV
YEDISRGL	YEDI-SRGL
RELQLQEV	RELQ-LQEV
AELTVIKV	AELT-VIKV
GEYTYYFRV	GEYTYYFRV
SEDDIHRSI	SEDDIHRSI
IEAELTRRV	IEAELTRRV
KEIEEAMKRV	KEIEEMKRV
IEDEKMVVV	IEDEKMVVV
REDGEKTFV	REDGEKTFV
KEIIPTSEFI	KEIIPSEFI
AELFHLSGI	AELFHLSGI
LEKKIGKSI	LEKKIGKSI
AEAQPMAV	AEAQ-PMAV
GEGAEPLKV	GEGAEPLKV
KEIQGHQPRI	KEIQGQPRI
FEAPTIVKV	FEAPTIVKV
FEMAVAKV	FEMA-VAKV
RAQYESIAAKN	AQYESIAAK
GEAEFNRI	GEAE-FNRI
AEGLTLAQV	AEGLTLAQV
AEMLEDLHI	AEMLEDLHI
LEFKGRKI	LEFK-GRKI
WEYDESHVI	WEYDESHVI
VRFLEQQNK	VRFLEQQNK
AEGKPYLHV	AEGKPYLHV
GEISKKVAQI	GEISKVAQI
REMIPFAVV	REMIPFAVV
LEEAVYRNI	LEEAVYRNI
AELNFFQRI	AELNFFQRI
TEAKLVRKV	TEAKLVRKV
AEFEWENKV	AEFEWENKV
TENFYFREI	TENFYFREI
KELLYVPLI	KELLYVPLI
SEGSVSTKQI	SEGSVTKQI
QEWDGKESTI	QEWDGESTI
TEVDKILKV	TEVDKILKV
VENPTATEI	VENPTATEI
TEISSAEKV	TEISSAEKV
IEDSRVYEL	IEDSRVYEL
TEIEDSHTLV	TEIEDSHTL
FEQGGARVV	FEQGGARVV
TEKDPSYFV	TEKDPSYFV
TEAPPIIFA	TEAPPIIFA
REVLHKFTV	REVLHKFTV
YESEHGINI	YESEHGINI
IESNHPIVL	IESNHPIVL
RENTFVVKV	RENTFVVKV
FEGEKGAVV	FEGEKGAVV
SETEGTPKL	SETEGTPKL
HEVSNGSVV	HEVSNGSVV
AEIYGVTHT	AEIYGVTHT
HEAHKFLKV	HEAHKFLKV
SETPTFAKV	SETPTFAKV
SETSSVSHI	SETSSVSHI
SVPEAQSAL	SVPEAQSAL
MEFAQISRV	MEFAQISRV
REGEWQTMI	REGEWQTMI
FERKLDQTI	FERKLDQTI
IEFNPPKTV	IEFNPPKTV
GEYSQKYSTM	GEYSQYSTM
GEYEERKLIRA	GEYEERKLI
AEIDAHLV	AEID-AHLV
GETHPFTKL	GETHPFTKL
SEILHRVI	SEIL-HRVI
TELPQTSHV	TELPQTSHV
LEFPSGETI	LEFPSGETI
IEGTPLETI	IEGTPLETI
REVVKPAAV	REVVKPAAV
GELSARLLSI	GELSALLSI
LLLPGELAK	LLLPGELAK
QEMQLIHEI	QEMQLIHEI
TEDPTILRI	TEDPTILRI
SEKEATPVV	SEKEATPVV
RETPHSPGV	RETPHSPGV
VETDQRVRV	VETDQRVRV
AEVRKIIRV	AEVRKIIRV
AEYVPEKV	AEYV-PEKV
AEEKLQASV	AEEKLQASV
LEWKIIYV	LEWK-IIYV
FEIERDLRL	FEIERDLRL
QEIDGRFTSI	QEIDGFTSI
YEMEVSQRL	YEMEVSQRL
REIEGRAI	REIE-GRAI
IETPPTRNI	IETPPTRNI
LEYGVPVTL	LEYGVPVTL
VEDPQGNTI	VEDPQGNTI
GEAMLRKI	GEAM-LRKI
KENDQILAI	KENDQILAI
IESRTLAI	IESR-TLAI
AEILMKTLL	AEILMKTLL
REIQQRVVRV	REIQQVVRV
KESNDLLLI	KESNDLLLI
QEIEKPVAV	QEIEKPVAV
AELKTESV	AELK-TESV
AEQRVPLSV	AEQRVPLSV
GEAPLHKAAKV	GEAP-LHKA
HEILEKSGRI	HEILESGRI
AEAPGLVDV	AEAPGLVDV
HESAAHAIV	HESAAHAIV
TEIEGSKLV	TEIEGSKLV
SESSTVRTV	SESSTVRTV
KENVKPIKV	KENVKPIKV
AENVAGHQI	AENVAGHQI
AEIVKRLNGI	AEIVKLNGI
AELETQLQQI	AELETLQQI
QEVTHSVRI	QEVTHSVRI
IEDPSLLNSRV	IEDPSLNSR
YEFEGGVKL	YEFEGGVKL
AEALLHPFF	AEALLHPFF
QEMQEVQSSR	QEMQEQSSR
AELFLDTV	AELF-LDTV
REAELQAVL	REAELQAVL
GEYLFERL	GEYL-FERL
AEMAVSRV	AEMA-VSRV
QEYDALAKVI	QEYDALAKV
EEYGEFYKSL	EEYGEYKSL
AEIDLRQGRL	AEIDLQGRL
FETEPVSKL	FETEPVSKL
SEVPSSSGI	SEVPSSSGI
AEAEAWYQTK	AEAEAWYQT
EAASQGLK	EAAS-QGLK
AENVPQTEV	AENVPQTEV
YEALPQHKL	YEALPQHKL
KEVEKKLTV	KEVEKKLTV
KEEEPVKKI	KEEEPVKKI
AEIRRFSSV	AEIRRFSSV
SEIERMGLVMD	SEIERMGLV
HEYPPGLLV	HEYPPGLLV
VEISQVTIV	VEISQVTIV
AEILAEIARI	AEILAIARI
IEDEVTRQV	IEDEVTRQV
TPAQYDASELK	AQYD-ASEL
AEGEGISKV	AEGEGISKV
AEFFSSENV	AEFFSSENV
IEFDEHINV	IEFDEHINV
KEVEYFTGI	KEVEYFTGI
KEDENVPFLLV	KEDENVPFL
TESNQKLGL	TESNQKLGL
TEDLVLKI	TEDL-VLKI
YESEKVGVA	YESEKVGVA
AENSLLAKVFI	AENSLLAKV
GEVPISFV	GEVP-ISFV
KEVKVSSV	KEVK-VSSV
QELPTTLV	QELP-TTLV
REINPAPYTI	REINPPYTI
IEMAYARQI	IEMAYARQI
LEMEHTQQM	LEMEHTQQM
AEIIPGVLFI	AEIIPVLFI
GEVESAKLI	GEVESAKLI
AETLLNSEV	AETLLNSEV
AEMEMKNRQV	AEMEMNRQV
LEYERQLVL	LEYERQLVL
MEIMTREV	MEIM-TREV
AEKLYLRSI	AEKLYLRSI
IEQDTDTKITI	IEQDTDTKI
WLLSLGATDRQ	LLSLGATDR
SENKAFISV	SENKAFISV
KEVAKIIYI	KEVAKIIYI
REFLFNAIE	REFLFNAIE
IEIGPDGRV	IEIGPDGRV
NEIVKLHEI	NEIVKLHEI
SEMRAPPAA	SEMRAPPAA
SEDELKRSV	SEDELKRSV
MEFPKIESV	MEFPKIESV
TEKDFLEAV	TEKDFLEAV
IEYQFVERL	IEYQFVERL
QEIEVRPGI	QEIEVRPGI
TEIKKIPGI	TEIKKIPGI
SENDVIRLI	SENDVIRLI
AEIEQSQRVV	AEIEQSQRV
READRLLSL	READRLLSL
VELDHATLV	VELDHATLV
RETPRVTAV	RETPRVTAV
AEYQAFREAI	AEYQAREAI
GEVVAIKKI	GEVVAIKKI
LEKFFETRV	LEKFFETRV
AEVFHVPLL	AEVFHVPLL
YEGLPIGKV	YEGLPIGKV
EITALAPSTMK	ITALAPSTM
LESFLKQV	LESF-LKQV
FETPGSILV	FETPGSILV
SEVDNWRII	SEVDNWRII
AERLFNLV	AERL-FNLV
GEALPFIQRV	GEALPIQRV
FEWENKVTV	FEWENKVTV
TEFQGKRMHV	TEFQGRMHV
YEWDVAEARKI	AEAR---KI
FEFTGSHLTV	FEFTGHLTV
GEARKQVEV	GEARKQVEV
AEVLTVKEV	AEVLTVKEV
KEGLPTRAL	KEGLPTRAL
SEKDAVSREI	SEKDASREI
LEAWPALQI	LEAWPALQI
GEGTFGRVV	GEGTFGRVV
REIEATNAVL	REIEATNAV
LEIEKSLLV	LEIEKSLLV
QEHLDYEII	QEHLDYEII
GEIDKVQYI	GEIDKVQYI
FEISNRALI	FEISNRALI
AENNHLEAV	AENNHLEAV
AEGLNLHTI	AEGLNLHTI
AEAERVGLHKV	AERVGLHKV
AEYGEIKNI	AEYGEIKNI
GEAPKPGEEV	GEAPKGEEV
SEYTSGHSV	SEYTSGHSV
SEISDEFKVV	SEISDFKVV
SEEKRIYRV	SEEKRIYRV
IEEVHAVVTV	IEEVHVVTV
AEANAFSVL	AEANAFSVL
REDGSIVIV	REDGSIVIV
SETVKAAKV	SETVKAAKV
AEDGSRVYVV	AEDGSRVYV
MEAPKIDRI	MEAPKIDRI
GEIPNFPRSTV	GEIPNPRST
HELFSKSFI	HELFSKSFI
REAEHGPEV	REAEHGPEV
IEPEHVNTV	IEPEHVNTV
REIMGTPEYV	REIMGPEYV
YIDQEELNK	YIDQEELNK
LEAFVRMV	LEAF-VRMV
SEFIDLSEKI	SEFIDSEKI
GEATNTVTKI	GEATNVTKI
QELQAKLAEI	QELQALAEI
HEVISRQATI	HEVISQATI
NAPWAVTSL	NAPWAVTSL
IEDGSIHRI	IEDGSIHRI
TEHGEFLAL	TEHGEFLAL
KEDPELAKSFI	KEDPEAKSF
SEYPIVDGKL	SEYPIDGKL
AEDPQQVSTV	AEDPQVSTV
GEWPTMPHTI	GEWPTPHTI
QEQAVSPKV	QEQAVSPKV
AEQFRLEQI	AEQFRLEQI
HEVMEQGRVTI	HEVMEQGRV
TEDAKPVKI	TEDAKPVKI
AEIDFKYALI	AEIDFYALI
AEHAVVGEI	AEHAVVGEI
FKDPNAPK	FKDP-NAPK
RELDLRGYKI	RELDLGYKI
GEAPFAQRI	GEAPFAQRI
IEAAIERKI	IEAAIERKI
LESPRPALV	LESPRPALV
SENPPSFTI	SENPPSFTI
SELERPHKV	SELERPHKV
IEVLQPLI	IEVL-QPLI
GENLVSMTV	GENLVSMTV
EEVPEFTKI	EEVPEFTKI
REVVFVEDV	REVVFVEDV
AEVYKELRL	AEVYKELRL
LEYIHALTL	LEYIHALTL
GEFPYLGRL	GEFPYLGRL
EEYNKEFAEV	EEYNKFAEV
AENPVENHI	AENPVENHI
QELQAKIEAL	QELQAIEAL
QEAEQLKNQI	QEAEQKNQI
AEYRHLRKL	AEYRHLRKL
REDAGAEKI	REDAGAEKI
SELDVPFKV	SELDVPFKV
AEINATMSV	AEINATMSV
GEHLGTLKV	GEHLGTLKV
AEIDASNIV	AEIDASNIV
YEYEGGHIKT	YEYE-GGHI
VEIVGGATRI	VEIVGATRI
SEFDRQAEI	SEFDRQAEI
SESPGKLHV	SESPGKLHV
YESINHVVV	YESINHVVV
QEAEPLKQV	QEAEPLKQV
SEVGVGGAQV	SEVGVGAQV
IEVSFREL	IEVS-FREL
QEDLLREMI	QEDLLREMI
AEYESFLRTG	AEYESFLRT
AELRPDSPAHV	AELRPPAHV
HELPVDMETI	HELPVMETI
AAQDRDQIYR	AAQD-RDQI
GELARAVVL	GELARAVVL
HEVDPEGDRTI	HEVDPDRTI
LESLPEPVI	LESLPEPVI
SEVTDPLSV	SEVTDPLSV
VEKQSALLI	VEKQSALLI
SENELFGATI	SENELGATI
HELPKYGVKV	HELPKGVKV
SEVANAGIKL	SEVANGIKL
AEMVFATRV	AEMVFATRV
TEYQPRAV	TEYQ-PRAV
GETKVWQYI	GETKVWQYI
LEPGFFTHI	LEPGFFTHI
AESKLQTEV	AESKLQTEV
FEFRPELV	FEFR-PELV
REQLKKLLV	REQLKKLLV
SEFFTDLLNHI	SEFF-TDLL
REIVSAAKV	REIVSAAKV
HEAMEQQTI	HEAMEQQTI
REDLNQVITI	REDLNVITI
GEWYIRGQTI	GEWYIGQTI
REHPVPLL	REHP-VPLL
TEIFYHRGV	TEIFYHRGV
KELEHLSHI	KELEHLSHI
KEFEDAVRKV	KEFEDVRKV
LELGFSKV	LELG-FSKV
TERKDFIKT	TERKDFIKT
AERESAEVV	AERESAEVV
TEYENFKVQVL	TEYENKVQV
AESLIAKKI	AESLIAKKI
KEVERILGL	KEVERILGL
AELTPHQTFV	AELTPQTFV
SEAIKGAVV	SEAIKGAVV
KEEVTTREV	KEEVTTREV
AQYEDIANR	AQYEDIANR
QEYEEVKLV	QEYEEVKLV
SEDVSRVLI	SEDVSRVLI
SEFKEFSQSF	SEFKESQSF
REFSDFIQAV	REFSDIQAV
GESSAPPRKV	GESSAPRKV
KEHEAITKV	KEHEAITKV
SEWDGIVTV	SEWDGIVTV
AEVGIIESI	AEVGIIESI
SEYNPWRKL	SEYNPWRKL
LETTKKLKI	LETTKKLKI
REYEDNDEVHI	REYEDNDEV
DGYNYTLSK	DGYNYTLSK
REIQELGQL	REIQELGQL
AERERGITI	AERERGITI
RENVNLAQI	RENVNLAQI
SEFEIVKAI	SEFEIVKAI
SEFTGTHYI	SEFTGTHYI
SELPSVNI	SELP-SVNI
KEKVPGITI	KEKVPGITI
QEAKELKKV	QEAKELKKV
FESKGTGRI	FESKGTGRI
MEHPYFYTV	MEHPYFYTV
LERYLQRTV	LERYLQRTV
AEALIKVFV	AEALIKVFV
AETIAWVRI	AETIAWVRI
KEFQEGLKI	KEFQEGLKI
SEDKSIKV	SEDK-SIKV
FEISDIGAKI	FEISDGAKI
REDGSHILTV	REDGSILTV
AERPGEAAV	AERPGEAAV
AEAKFREI	AEAK-FREI
AEILTTKV	AEIL-TTKV
LEVERVEMI	LEVERVEMI
GEYDVKYPALI	GEYDVYPAL
AELLSGKRL	AELLSGKRL
QELDMKQRTI	QELDMQRTI
SEYITHEI	SEYI-THEI
QEMKSRILVI	QEMKSILVI
SEHSMDTLL	SEHSMDTLL
AEAEPPSEVV	AEAEPPSEV
YEYIIKDKHIL	YEYIIDKHI
GEYGKFFVTI	GEYGKFVTI
EEIDRALGI	EEIDRALGI
LEDDPQGARKI	LEDDPARKI
SEYNNFKSM	SEYNNFKSM
KEFEKASKI	KEFEKASKI
HESRQITQV	HESRQITQV
HEEQPRPFV	HEEQPRPFV
HEIDYILLV	HEIDYILLV
LEKLFLQKI	LEKLFLQKI
SEVKPKMVV	SEVKPKMVV
HELVYEAII	HELVYEAII
AESEGLSLLNV	AESEGLSLL
GESAGAASV	GESAGAASV
VELDPSKVEV	VELDPKVEV
TEIPTAITI	TEIPTAITI
SEFGAPVSV	SEFGAPVSV
IEFTYTAKL	IEFTYTAKL
AEEARLLHV	AEEARLLHV
QASEGPLK	QASE-GPLK
AEGDLVRLL	AEGDLVRLL
KELLLKRTV	KELLLKRTV
IEIAKNYNV	IEIAKNYNV
LENPSNIRG	LENPSNIRG
SEFYKNLTSI	SEFYKLTSI
REQVVNETV	REQVVNETV
VEFPHSPEI	VEFPHSPEI
REAEHLYHTL	REAEHYHTL
KEEQAERLV	KEEQAERLV
AEYAHPLETL	AEYAHLETL
YEEMFSPNI	YEEMFSPNI
AEDGPRVVFM	AEDG-PRVV
TEIHNINII	TEIHNINII
HEYVHGDI	HEYV-HGDI
AETASPVAV	AETASPVAV
RQIDQFLVV	RQIDQFLVV
REPQLPTAEI	REPQLTAEI
KETNIQLFV	KETNIQLFV
SEVTDLRR	SEVT-DLRR
FEHHGQVRL	FEHHGQVRL
RELQPGVKAV	RELQPVKAV
AEDEGTQRL	AEDEGTQRL
MEDGGVKLL	MEDGGVKLL
REAELKQRV	REAELKQRV
AEREIVRDI	AEREIVRDI
FEDENFILK	FEDENFILK
TEKHFFHKV	TEKHFFHKV
GELDHVVEI	GELDHVVEI
SEAQPARQI	SEAQPARQI
IEIDPHRTV	IEIDPHRTV
AEAPSQKVTV	AEAPSKVTV
FEDPQRREV	FEDPQRREV
AEVGGVPYL	AEVGGVPYL
TEQQQRFHEI	TEQQQFHEI
REFPVISVV	REFPVISVV
SEAPNEMVI	SEAPNEMVI
AEFEKNFKEV	AEFEKFKEV
AESPVIEV	AESP-VIEV
SEAIKTSQI	SEAIKTSQI
AEDKKGHLI	AEDKKGHLI
AEIQGNVKV	AEIQGNVKV
FEYILSHV	FEYI-LSHV
IEKSGWLFI	IEKSGWLFI
HEIQNLTLI	HEIQNLTLI
AEFWDGKIVLV	AEFWDGKIV
TELTNLIKI	TELTNLIKI
AEAAGLHKV	AEAAGLHKV
REVDDLGPEV	REVDDGPEV
AEVARAQAAL	AEVARQAAL
LESDDVLRL	LESDDVLRL
AELPAKILV	AELPAKILV
AEEESLKERLI	AEEESKERL
LEEGKEILV	LEEGKEILV
TEASFQKVI	TEASFQKVI
AEYISTVKTL	AEYISVKTL
REVVKHPSV	REVVKHPSV
KEHEVTIFV	KEHEVTIFV
ETALRLTEL	ETALRLTEL
GEYIAPEKI	GEYIAPEKI
SEVTAALRV	SEVTAALRV
AEIEKFDKS	AEIEKFDKS
AEFHQIEGVV	AEFHQIEGV
GEDGFLLKI	GEDGFLLKI
REWEAQDMRV	REWEADMRV
KEIPVTVV	KEIP-VTVV
GEVPVLNV	GEVP-VLNV
SEDDRLPVI	SEDDRLPVI
HEAMEQQSI	HEAMEQQSI
RENKTAVVV	RENKTAVVV
REFGNLTRM	REFGNLTRM
SFEMVKGGYTL	FEMVKGYTL
SEMHSFIQI	SEMHSFIQI
AEIENLANRI	AEIENANRI
AEHKEFITA	AEHKEFITA
QEIATLDNKI	QEIATDNKI
GEFQSALPKI	GEFQSLPKI
HEFLQTEI	HEFL-QTEI
REFEKMNQSL	REFEKNQSL
KETLPGARI	KETLPGARI
HEAPTTKI	HEAP-TTKI
YESQPIRQT	YESQPIRQT
SESEIVPKV	SESEIVPKV
QEEKRQRVI	QEEKRQRVI
LEASFARTV	LEASFARTV
KELEENLNI	KELEENLNI
AEAISGHSV	AEAISGHSV
SEDGRSPISI	SEDGRPISI
QEINVEAKHV	QEINVAKHV
KEVDSKSQVI	KEVDSKSQV
VEQWPYRAV	VEQWPYRAV
SEYPVILSI	SEYPVILSI
AEFIVAKAI	AEFIVAKAI
QEAPAVRKL	QEAPAVRKL
KEYFPVQVV	KEYFPVQVV
AEFEVHEV	AEFE-VHEV
KEYGQIESV	KEYGQIESV
REESGARINI	REESGRINI
VEAPPKILV	VEAPPKILV
IEDRPMPKL	IEDRPMPKL
LSHGSSTFSL	LSHGSTFSL
KEGDKPSATI	KEGDKSATI
VEVKDIELV	VEVKDIELV
HESPAVKLM	HESPAVKLM
AEAEKIRKI	AEAEKIRKI
QEAEARFREI	QEAEAFREI
QEIQEGQINI	QEIQEQINI
AEFVVQKI	AEFV-VQKI
HELMFSTKI	HELMFSTKI
VEEDEAGGRFV	EEDEAGRFV
TELQRAWATI	TELQRWATI
AEEERRKIEV	AEEERKIEV
AEVPTQLV	AEVP-TQLV
GTLDPVEK	GTLD-PVEK
AEAEKSQLIM	AEAEKSQLI
GYSFTTTAER	YSFTTTAER
AEPSKLNSI	AEPSKLNSI
KEFSGNPIKV	KEFSGPIKV
GEYQRMGVM	GEYQRMGVM
MEFQVPVI	MEFQ-VPVI
TEDEVERVI	TEDEVERVI
AEPIRMLEI	AEPIRMLEI
LEYDQDLSV	LEYDQDLSV
KQQLELDSI	KQQLELDSI
LTQALKDNK	LTQALKDNK
QEAEPGSRV	QEAEPGSRV
TEDSKRIAV	TEDSKRIAV
TEVPTASI	TEVP-TASI
NEAQLLRKI	NEAQLLRKI
TAKAAPLPSV	AKAAPLPSV
AEASMISKL	AEASMISKL
HEIVPGSLI	HEIVPGSLI
SEIPKLPAV	SEIPKLPAV
GEVGRWLVI	GEVGRWLVI
AEVLQILTQV	AEVLQLTQV
VENEQILNV	VENEQILNV
SEVGDTQVV	SEVGDTQVV
GESTVRTI	GEST-VRTI
LENVWLHFI	LENVWLHFI
AEHPTIKIFW	AEHP-TIKI
HEQLRAVIV	HEQLRAVIV
EALAAAELLK	ALAA-AELL
SEYVRNQQTI	SEYVRQQTI
GEYSGIEHVI	GEYSGIEHV
VEKDAVFI	VEKD-AVFI
RETIIMNQI	RETIIMNQI
SESEKQWKA	SESEKQWKA
IEKLFQSV	IEKL-FQSV
SEYEATNLLI	SEYEANLLI
AERSEASLKV	AERSESLKV
REYNEYENI	REYNEYENI
REFKGAVREI	REFKGVREI
TEVAPAKDV	TEVAPAKDV
GEIKHLLGEI	GEIKHLGEI
KEQVPPPAV	KEQVPPPAV
KEFSPFGTIT	KEFSPFGTI
AESWGTGRAV	AESWGGRAV
AEDKDTPAL	AEDKDTPAL
KEYEELLASV	KEYEELASV
TEIIPKSAV	TEIIPKSAV
YEDGSIRIF	YEDGSIRIF
REAESFTQL	REAESFTQL
FEVKKGDRI	FEVKKGDRI
KEFKSQLFV	KEFKSQLFV
YEQAARVAI	YEQAARVAI
QELQEINRV	QELQEINRV
YEDGNVQLV	YEDGNVQLV
AEKGPMIVL	AEKGPMIVL
AEVINAREV	AEVINAREV
GELIHDLLTI	GELIHLLTI
IEVEAPITV	IEVEAPITV
TELQQVILI	TELQQVILI
KEFITALI	KEFI-TALI
TETEPSKTV	TETEPSKTV
AEHNFVAKA	AEHNFVAKA
GEVFPTTEV	GEVFPTTEV
GPSSVEDIK	GPSSVEDIK
GEWGAFNDI	GEWGAFNDI
GELPNGTRV	GELPNGTRV
LEIPAVSHV	LEIPAVSHV
HEYVAQNGI	HEYVAQNGI
LEEAGFHTV	LEEAGFHTV
REKELAKV	REKE-LAKV
REFEPDAI	REFE-PDAI
QEQDPTNLYI	QEQDPNLYI
AEVKPILQA	AEVKPILQA
NEKKNFHLV	NEKKNFHLV
REASIYTGI	REASIYTGI
KEYVGIVRL	KEYVGIVRL
IENVIFNRV	IENVIFNRV
RKFVGNLELI	KFVGNLELI
QEKPMHLEI	QEKPMHLEI
AERINNINI	AERINNINI
NEQPSSPRV	NEQPSSPRV
AEFHVQRV	AEFH-VQRV
SEYVEKFYRI	SEYVEFYRI
SEITGLSTA	SEITGLSTA
GETPTTEV	GETP-TTEV
HENPDLAKV	HENPDLAKV
REAGITEKV	REAGITEKV
HEGDIILKI	HEGDIILKI
YERDHAVVV	YERDHAVVV
FEDETIRNI	FEDETIRNI
REWYSAKITI	REWYSKITI
AEQRGENALKD	AEQRGENAL
SEGKVFINI	SEGKVFINI
YEFKPIVV	YEFK-PIVV
RENPQLLQQI	RENPQLQQI
AEDPAGLKV	AEDPAGLKV
LEIGENRLV	LEIGENRLV
AEAPPPSVV	AEAPPPSVV
EATLLQKL	EATL-LQKL
AEGTFPGKI	AEGTFPGKI
AETPVHKQI	AETPVHKQI
GEVRFSAV	GEVR-FSAV
SENSYVSPRI	SENSYSPRI
KEAIKSSLI	KEAIKSSLI
GELHSKLI	GELH-SKLI
AEGYFISI	AEGY-FISI
SEEDFLRQV	SEEDFLRQV
NDLAVVDVR	NDLAVVDVR
LEMNLGLQKI	LEMNLLQKI
SERETAVRI	SERETAVRI
AEDAMRLYYV	AEDAMLYYV
GEISSPVI	GEIS-SPVI
TEAEVRGL	TEAE-VRGL
REYPNLVTIY	REYPNLVTI
AEAEFYRQV	AEAEFYRQV
SENPSVYV	SENP-SVYV
GEEHAFLTV	GEEHAFLTV
TEIIGGVVV	TEIIGGVVV
AEEVWARV	AEEV-WARV
HEKEDGAISTI	KEDGAISTI
VEIDNKNKTI	VEIDNNKTI
FEWDRKLEL	FEWDRKLEL
IEPDYKFSTL	IEPDYFSTL
LESAPVLRT	LESAPVLRT
GELPFLTHV	GELPFLTHV
REYQDLLNV	REYQDLLNV
AEINNIIKIV	AEINNIIKI
LEETSIRYV	LEETSIRYV
SEIVQNGRLI	SEIVQGRLI
GEYGKFFVT	GEYGKFFVT
AEAGHLNIL	AEAGHLNIL
GEANPINMV	GEANPINMV
AEFKNITRI	AEFKNITRI
KEFDGKSLVSV	KEFDGKSLV
FEITPEGRRI	FEITPGRRI
SEYIATKI	SEYI-ATKI
FEDPRLILI	FEDPRLILI
QESNVRLKL	QESNVRLKL
GEIKHVSSL	GEIKHVSSL
REGLVVVKV	REGLVVVKV
TEVSFLDYI	TEVSFLDYI
VEIIANDQGNR	VEIIANDQG
AENVSSKV	AENV-SSKV
KELRKFRKI	KELRKFRKI
LEVVDKSQV	LEVVDKSQV
AEIYAKLEEI	AEIYALEEI
KEVDEQMLNV	KEVDEMLNV
AEAPAGPAL	AEAPAGPAL
AEMAKVSEI	AEMAKVSEI
TEVGSVSEV	TEVGSVSEV
IEVDPVLTV	IEVDPVLTV
YEILTPNSI	YEILTPNSI
GEIERLINL	GEIERLINL
SETGALKTFI	SETGAKTFI
AELSEFRMV	AELSEFRMV
AEIENLQSL	AEIENLQSL
IEYIHSKNFI	IEYIHKNFI
HEEKVFRAV	HEEKVFRAV
LEKIISQL	LEKI-ISQL
IEESGEHII	IEESGEHII
QEYNVGGKVI	QEYNVGGKV
KENEELTRI	KENEELTRI
FESPNILRI	FESPNILRI
AEELGASKV	AEELGASKV
VEHVVVYV	VEHV-VVYV
SEVISQHLV	SEVISQHLV
YELDLGLNHVV	YELDLLNHV
NEYVFRETV	NEYVFRETV
REIFLSQPIL	REIFLSQPI
FEHFIEGGRTV	HFIEGGRTV
YELDLGLNHV	YELDLLNHV
KEIGQLKAI	KEIGQLKAI
GEDVRSALL	GEDVRSALL
GGGVGKSALTI	GGVGKALTI
FGVQTDRQDK	GVQTDRQDK
AEAEKSQLI	AEAEKSQLI
GEWPDQPRI	GEWPDQPRI
TEIPQIVEI	TEIPQIVEI
AETLPALKI	AETLPALKI
TEFPGVVV	TEFP-GVVV
AEVHRLVVV	AEVHRLVVV
AEISSKSPVAV	AEISSKSPV
AETHFGFETV	AETHFFETV
EEFPGGLTI	EEFPGGLTI
TEILGTQEI	TEILGTQEI
IETRVILV	IETR-VILV
TETDLRVV	TETD-LRVV
IESTTQKI	IEST-TQKI
SEVGKTPTL	SEVGKTPTL
RELVSRQV	RELV-SRQV
GEISTIDKV	GEISTIDKV
YEGPAKIEV	YEGPAKIEV
AETKQEAVV	AETKQEAVV
WEIENNPTV	WEIENNPTV
AERKFKQV	AERK-FKQV
EDAANNYAR	EDAANNYAR
HEAFPLRVI	HEAFPLRVI
TESLKSPKV	TESLKSPKV
FEKTLTPII	FEKTLTPII
QEIPKSRGV	QEIPKSRGV
KEFVGKPTI	KEFVGKPTI
AGLQFPVGR	AGLQFPVGR
REYHSVGVQV	REYHSGVQV
REELNREL	REEL-NREL
KEDPKALAV	KEDPKALAV
QEILTKDSVTI	QEILTKDSV
LEIPHQGVQV	LEIPHGVQV
LETIFVRKV	LETIFVRKV
TEDSPGLKV	TEDSPGLKV
HEVPGHQSV	HEVPGHQSV
LEHTGFSKA	LEHTGFSKA
RESHTHVSV	RESHTHVSV
RERHPGSFDVV	RERHPSFDV
TEIAKFLKV	TEIAKFLKV
FEEKDFSQI	FEEKDFSQI
HEIEVETI	HEIE-VETI
TEVQLQQKV	TEVQLQQKV
VEFDLKQTL	VEFDLKQTL
AEYLGANSV	AEYLGANSV
SEELRVSKV	SEELRVSKV
VEISAKELI	VEISAKELI
FEQVSGVTV	FEQVSGVTV
SEQTFMYYV	SEQTFMYYV
GEPGPVRSV	GEPGPVRSV
AERSGLRVV	AERSGLRVV
REYLSEEVQAV	REYL-SEEV
SEIEYYAML	SEIEYYAML
SEISSATKL	SEISSATKL
VETSRVVHI	VETSRVVHI
REVEHFLKA	REVEHFLKA
MEFPTAEV	MEFP-TAEV
REIVQQLI	REIV-QQLI
TEIEQTKI	TEIE-QTKI
GEAEGLMKV	GEAEGLMKV
TENKELKTV	TENKELKTV
GEVHTGTTI	GEVHTGTTI
YEVQQVPKV	YEVQQVPKV
AEDDNIYQQKI	AEDDNYQQK
AEYPTISI	AEYP-TISI
VETDGFISYI	VETDGISYI
LESSAKSKI	LESSAKSKI
LEVEKSLVL	LEVEKSLVL
READFFWSL	READFFWSL
FEVPAGKKV	FEVPAGKKV
REDEFHISVI	REDEFHISV
IEVETHKV	IEVE-THKV
VSTEVDAR	VSTE-VDAR
PEYDGRGVLI	PEYDGGVLI
WEEERQPIL	WEEERQPIL
YEVVQSQRV	YEVVQSQRV
AEDPRMIKV	AEDPRMIKV
YEDATKITV	YEDATKITV
KEVEQFTQV	KEVEQFTQV
METSAKANI	METSAKANI
GEVAMGRVV	GEVAMGRVV
HEFTDLNLV	HEFTDLNLV
AEFQELLKV	AEFQELLKV
SENEEFVEV	SENEEFVEV
VEKGHFAEL	VEKGHFAEL
REMGSATSV	REMGSATSV
KEQEPMPTV	KEQEPMPTV
HEQSRIITV	HEQSRIITV
GEKQPELQI	GEKQPELQI
VETPPMVVV	VETPPMVVV
SEIATTGV	SEIA-TTGV
AGFAGDDAPR	AGFAGDDAP
GEEARVTQLI	GEEARVTQL
AEMAQNAV	AEMA-QNAV
IEEVGIYRI	IEEVGIYRI
FEYKPEVI	FEYK-PEVI
LEVRKLMHV	LEVRKLMHV
LEDKRQVSV	LEDKRQVSV
GEFAKLSKI	GEFAKLSKI
SEAYLVGL	SEAY-LVGL
REIPSHVLSKV	REIP-SHVL
FEELTNLI	FEEL-TNLI
IEYDPVIILI	IEYDPIILI
TELDHIMEV	TELDHIMEV
KEPELFQTV	KEPELFQTV
LQDAEIAR	LQDA-EIAR
YEVQLESKV	YEVQLESKV
GEFTHEMQV	GEFTHEMQV
KEDSQILKI	KEDSQILKI
YEDFHIVKL	YEDFHIVKL
AELKDLLLQV	AELKDLLQV
SELPTTVTV	SELPTTVTV
SEAKPLAV	SEAK-PLAV
VESLFRVI	VESL-FRVI
SEYSQSPKM	SEYSQSPKM
REFDRFGTIRT	REFDRFGTI
SEAPGPSKV	SEAPGPSKV
FEYVINEVI	FEYVINEVI
REKEFVARV	REKEFVARV
SEAAPLLV	SEAA-PLLV
QEYLSGRSI	QEYLSGRSI
REPRPFPKL	REPRPFPKL
HEAAFPIAV	HEAAFPIAV
GEKSESISV	GEKSESISV
TEVKTSTVI	TEVKTSTVI
GEGKSTVTI	GEGKSTVTI
TEQATVTMV	TEQATVTMV
LEDLFPTTKI	LEDLFTTKI
YETNKVTRI	YETNKVTRI
GEFPVRVQV	GEFPVRVQV
GEHVKAIEI	GEHVKAIEI
MEEGSIGRFI	EEGSIGRFI
VEIEKAPKV	VEIEKAPKV
REDIYSSAKKV	REDIYSAKK
AEAYHFFIL	AEAYHFFIL
IEVDSSPSV	IEVDSSPSV
LEIPAATTI	LEIPAATTI
HEQALFIYV	HEQALFIYV
SEFYTLHEV	SEFYTLHEV
YEILNNPEL	YEILNNPEL
TEVLVTQEI	TEVLVTQEI
GEGVIVKI	GEGV-IVKI
SEINIAPRI	SEINIAPRI
TETSNALKV	TETSNALKV
AELMGLKQV	AELMGLKQV
REIEGDLLL	REIEGDLLL
KEIEQKDNEI	KEIEQDNEI
QELQKLRAV	QELQKLRAV
LEHGADPTV	LEHGADPTV
IESDKIVEI	IESDKIVEI
GEFDYSGSQAI	GEFDYGSQA
SEWDSSRTPII	SEWDSRTPI
GEIGFENHETV	GEIGFNHET
HELFTPPVI	HELFTPPVI
AEYLKLEFI	AEYLKLEFI
LEKEDLGTRI	LEKEDGTRI
IEMETKTSI	IEMETKTSI
TETKGTVLI	TETKGTVLI
AEVDASVVREI	AEVD-ASVV
TEIGPRMTL	TEIGPRMTL
IEDDTILKT	IEDDTILKT
KETESLRKI	KETESLRKI
TEAEKIAKV	TEAEKIAKV
IEHVFNII	IEHV-FNII
GELVRLILV	GELVRLILV
TEQERGVGI	TEQERGVGI
AELDPSIAV	AELDPSIAV
AEAIHSPQV	AEAIHSPQV
TEDPSVHEI	TEDPSVHEI
LEITARPVL	LEITARPVL
RELEFNEI	RELE-FNEI
SEPMLSHTV	SEPMLSHTV
WEIDPKDLTFL	WEIDPKDLT
QELPSHGVPLI	QELP-SHGV
LEDGPKRYTI	LEDGPRYTI
GETPQVAVI	GETPQVAVI
AESPGFSQA	AESPGFSQA
AEDVATYKV	AEDVATYKV
GELGDFRAV	GELGDFRAV
GEITRLLNHI	GEITRLNHI
AEQDFWRAV	AEQDFWRAV
KEGVFAKEV	KEGVFAKEV
AEHSESGQLV	AEHSEGQLV
GEAPVLIMI	GEAPVLIMI
FERNKAIKV	FERNKAIKV
AEGPKVSIV	AEGPKVSIV
GESQVDHSTI	GESQVHSTI
TEGPETKPVL	TEGPEKPVL
AEGEVTFKSI	AEGEVFKSI
AEPHVSGV	AEPH-VSGV
AELHQNVNV	AELHQNVNV
LESPPKGVTI	LESPPGVTI
LDIDSPPITAR	LDIDSPITA
NEYLIFQKI	NEYLIFQKI
AEANHFIDL	AEANHFIDL
AEYEPVLIEI	AEYEPLIEI
SEEELKTHI	SEEELKTHI
AEGPRAVFV	AEGPRAVFV
HEYPWILSA	HEYPWILSA
LERTEGLSV	LERTEGLSV
TEIGQKHGLV	TEIGQHGLV
HELIPGGKTI	HELIPGKTI
SEVKRIRSI	SEVKRIRSI
KEDGAFSFV	KEDGAFSFV
TEAPTQVTV	TEAPTQVTV
REVVETPLL	REVVETPLL
EAILLHFST	EAILLHFST
SEVQLKQHI	SEVQLKQHI
SENPVPLTV	SENPVPLTV
AEYTHKSPRV	AEYTHSPRV
SEHPGLSI	SEHP-GLSI
AEVLEAHTI	AEVLEAHTI
AEVETLKTQI	AEVETKTQI
AEYRHPTV	AEYR-HPTV
REMLIRVNM	REMLIRVNM
IEDLVVHI	IEDL-VVHI
LEEKTRLINQ	LEEK-TRLI
VELDLQRSV	VELDLQRSV
GEYEDVSRV	GEYEDVSRV
AELARRSLA	AELARRSLA
SLVNLGGSK	SLVNLGGSK
KEATYGERVV	KEATYGERV
YEYADERLRI	YEYADRLRI
DKGEFGGFGSV	GEFGGFGSV
SEIKLDGV	SEIK-LDGV
KEGENRAVI	KEGENRAVI
FELPEIKKV	FELPEIKKV
SEFSEPSFI	SEFSEPSFI
LEKSGDLLV	LEKSGDLLV
YEIDDRDVNKI	YEIDDVNKI
KETQPPETV	KETQPPETV
REGSFKETI	REGSFKETI
AEVTSGARV	AEVTSGARV
GVSVSSAR	GVSV-SSAR
KEQEFRSI	KEQE-FRSI
KEKASWSSL	KEKASWSSL
VEEENIRVV	VEEENIRVV
WEEEGFRQI	WEEEGFRQI
RELGEFRTT	RELGEFRTT
GETNLKTHV	GETNLKTHV
SEIDQLFRI	SEIDQLFRI
AEYEKTIAQMI	AEYEKIAQM
LEDSNVKLV	LEDSNVKLV
GEDPNGTLII	GEDPNGTLI
VEFRSNLYI	VEFRSNLYI
TELKEKLRSI	TELKELRSI
GEYPLTAMTL	GEYPLAMTL
GEAGPIHHL	GEAGPIHHL
FEHQRAPRV	FEHQRAPRV
NELDHIMEI	NELDHIMEI
VELEHSTKV	VELEHSTKV
EEARAFNRI	EEARAFNRI
LELDTIKNLV	LELDTKNLV
IEIETPTQI	IEIETPTQI
SELADARRV	SELADARRV
QEVENFKKV	QEVENFKKV
AEALRISDV	AEALRISDV
IESTYGTHI	IESTYGTHI
GESPELLLV	GESPELLLV
IEKEKPLLI	IEKEKPLLI
GEYDFRYIFV	GEYD-FRYI
AEIMKTLEV	AEIMKTLEV
DSYVGDEAQSK	YVGDEAQSK
REHFVFTDI	REHFVFTDI
SEAAPLLVHV	SEAAPLVHV
SEVSAENILTV	SEVS-AENI
SEAGTQPQV	SEAGTQPQV
HESKPVNV	HESK-PVNV
GELYNEVKV	GELYNEVKV
TEEKSVRQI	TEEKSVRQI
ESNVQILKL	ESNVQILKL
AEDDVKQITV	AEDDVQITV
REVSQVDTI	REVSQVDTI
QEIERLNKL	QEIERLNKL
ADDHTVKL	ADDH-TVKL
GESAILDRV	GESAILDRV
REVFKTQGV	REVFKTQGV
SEDFPRPLV	SEDFPRPLV
KEISGKIIFV	KEISGIIFV
MEIQVNGGTV	MEIQVGGTV
LEAHFVPLV	LEAHFVPLV
AEVHKAITI	AEVHKAITI
SEFKAMDSI	SEFKAMDSI
KEIELPSGQL	KEIELSGQL
LGIHEDSQNR	GIHEDSQNR
AEVITKFINV	AEVITFINV
AEALRQPVL	AEALRQPVL
LEFPAGSVHV	LEFPASVHV
AEAEIIQLL	AEAEIIQLL
EAGPGRALV	EAGPGRALV
SEKRKQISV	SEKRKQISV
VESELRSI	VESE-LRSI
REVDEIDEI	REVDEIDEI
AEAPHLVQV	AEAPHLVQV
AEVETDKATV	AEVETKATV
TEDPHTVLV	TEDPHTVLV
KEQYYVRKV	KEQYYVRKV
LSLDWKTEI	LSLDWKTEI
QEVPEKVTV	QEVPEKVTV
AEIKRKLGI	AEIKRKLGI
AEYKRYLEM	AEYKRYLEM
YELLKQMSI	YELLKQMSI
KEMEKSFEVV	KEMEKFEVV
IEEELGSK	IEEE-LGSK
AEALRVVKI	AEALRVVKI
VATVSLPR	VATV-SLPR
REFDAFVETL	REFDAVETL
LEKSVSQKV	LEKSVSQKV
SEKGASSPLI	SEKGASPLI
REIAEAKQI	REIAEAKQI
REHVEAIKI	REHVEAIKI
SESPIVVVL	SESPIVVVL
GEYGNLVTI	GEYGNLVTI
LEQPVGMTTV	LEQPVMTTV
TEISTKEV	TEIS-TKEV
TEIPTKITI	TEIPTKITI
KEVAELTRL	KEVAELTRL
SEEVVSREV	SEEVVSREV
SEATHIITI	SEATHIITI
TEDGDSFLHL	TEDGDFLHL
HEVNRILKV	HEVNRILKV
KELPTVTTNV	KELPTTTNV
SEKPTVTTV	SEKPTVTTV
KELWAHKEV	KELWAHKEV
FEHLAPVLV	FEHLAPVLV
LEGDFAWERV	LEGDFWERV
AEYGGHQRL	AEYGGHQRL
QELGEARATV	QELGERATV
SELDLISRL	SELDLISRL
SEAQKIKEV	SEAQKIKEV
TEYEPRVINQM	TEYE-PRVI
SEAPEAPLL	SEAPEAPLL
AEFNSTPAVF	AEFNSTPAV
FEHSDIVVI	FEHSDIVVI
AELLQKIEV	AELLQKIEV
KEIQSAFVSV	KEIQSFVSV
TEIIKTAKI	TEIIKTAKI
KEHDPRVITV	KEHDPVITV
SEVELMKV	SEVE-LMKV
KELDHPRIV	KELDHPRIV
IERLINLL	IERL-INLL
LAQFIDKPV	LAQFIDKPV
IERATRLV	IERA-TRLV
HEAERINNI	HEAERINNI
RQGVDADINGL	GVDADINGL
QENTQTPTV	QENTQTPTV
MEHLKSLKI	MEHLKSLKI
KEVDPQGLRTI	KEVDPLRTI
SELEKQKGV	SELEKQKGV
GEKTSNLRV	GEKTSNLRV
TEIGTMISV	TEIGTMISV
SEFENFKTKM	SEFENFKTK
VEVPETPKA	VEVPETPKA
RELLPSFHEV	RELLPFHEV
FEHAHNMRV	FEHAHNMRV
REDFKTAVV	REDFKTAVV
RELDVSYVLV	RELDVYVLV
SENPVLQNI	SENPVLQNI
REYRLQARI	REYRLQARI
AETAVQLFI	AETAVQLFI
LEVIPRTLI	LEVIPRTLI
GEIRTITVV	GEIRTITVV
AEAAVPRTI	AEAAVPRTI
NEDPATPRV	NEDPATPRV
SIPEKNRPL	SIPEKNRPL
REYPNLVTI	REYPNLVTI
KEEEPVKKV	KEEEPVKKV
IEDSHTLVTV	IEDSHLVTV
TEIEKSISA	TEIEKSISA
FEDDAIQLV	FEDDAIQLV
AEPNLKQTI	AEPNLKQTI
AETGVGKTV	AETGVGKTV
YESLPATHI	YESLPATHI
LEQLRPVTV	LEQLRPVTV
GEHEIDYILLV	HEIDYILLV
LLEGEESR	LLEG-EESR
RENPQLKQI	RENPQLKQI
LEKSDQTNI	LEKSDQTNI
KEAAYHPEV	KEAAYHPEV
AELDISNNKI	AELDINNKI
KEIENTYANV	KEIENYANV
KEVEVQAKTV	KEVEVAKTV
IETTHGVVHV	IETTHVVHV
SEGPKVVSV	SEGPKVVSV
YEIKKLIYV	YEIKKLIYV
YEKVKLLEI	YEKVKLLEI
KEDALVTKNLV	KEDALTKNL
TERLIKHAV	TERLIKHAV
AEAAEVILRV	AEAAEILRV
IEHYARQV	IEHY-ARQV
QENVSNLVI	QENVSNLVI
GESGPMGNI	GESGPMGNI
REKLPSSEV	REKLPSSEV
TATQLAVNK	TATQLAVNK
AEVAPVAQV	AEVAPVAQV
FEMKELPQL	FEMKELPQL
AEEESERLL	AEEESERLL
REITDQEHNVV	REITDEHNV
GEVEKMQILV	GEVEKQILV
KEIGGLTQV	KEIGGLTQV
HEIGFGSKV	HEIGFGSKV
MEYKGYLVSV	MEYKGLVSV
LEAAIRTV	LEAA-IRTV
AEKQPSQEV	AEKQPSQEV
AEKPVLTAV	AEKPVLTAV
LEYPTISLH	LEYPTISLH
AEHKHIEVI	AEHKHIEVI
AELTKVFEI	AELTKVFEI
EEFGDFRLV	EEFGDFRLV
QENPGPWGEL	QENPGWGEL
RELDRFSVL	RELDRFSVL
GELERALSAV	GELERLSAV
SEHERQYLL	SEHERQYLL
SEYSVHSSL	SEYSVHSSL
KEFEGKTLVSV	KEFEGKTLV
AYEKPPEK	AYEK-PPEK
QEFELPYVSV	QEFELYVSV
VVPPFLQPEV	VVPPFQPEV
READFKETL	READFKETL
REFLFNAIETM	REFL-FNAI
LEFLHANQVI	LEFLHANQV
REIQQRVV	REIQ-QRVV
IEIERILSV	IEIERILSV
GEDPYPHKF	GEDPYPHKF
YESDHPVRV	YESDHPVRV
AEDGPTTRF	AEDGPTTRF
KELDGFLSI	KELDGFLSI
QELPGLPLV	QELPGLPLV
KEHNSKLTI	KEHNSKLTI
LENTHLLEV	LENTHLLEV
GEGPSSLI	GEGP-SSLI
SEVNLKLQNI	SEVNLLQNI
KEDTKELVV	KEDTKELVV
VEDDARGTVVL	VEDDAGTVV
AEADLRALL	AEADLRALL
GETTFMAKL	GETTFMAKL
GEIGHFDSV	GEIGHFDSV
VEHGGFYRT	VEHGGFYRT
KEVIKSQEV	KEVIKSQEV
SEHHLQRAI	SEHHLQRAI
SESEAKSVKV	SESEASVKV
VEPKMQVTI	VEPKMQVTI
LEHQVFTVL	LEHQVFTVL
QDRLNIILK	QDRLNIILK
RENGFNIYV	RENGFNIYV
AEAAALEVL	AEAAALEVL
GEYKFGPLFV	GEYKFPLFV
REVEIQSHL	REVEIQSHL
REDVNRNVYV	REDVNNVYV
TEIREIITSI	TEIREITSI
VENEETFMNRV	NEETFMNRV
MEEIGRISI	MEEIGRISI
HELITLEI	HELI-TLEI
YEFDTKDLV	YEFDTKDLV
GERPSNEEI	GERPSNEEI
GEFKVHRV	GEFK-VHRV
TEIAKRLNTI	TEIAKLNTI
GEIQAGAKL	GEIQAGAKL
TETVLRQAI	TETVLRQAI
QENGSLVEI	QENGSLVEI
VEDPVRKV	VEDP-VRKV
AEKAFQEGI	AEKAFQEGI
DTSPFAKSL	DTSPFAKSL
GEFDLVQRI	GEFDLVQRI
SEAEKLTLV	SEAEKLTLV
AEIRHVLVT	AEIRHVLVT
TELQDVQRI	TELQDVQRI
KEIPRIFQI	KEIPRIFQI
QEKLGLTRI	QEKLGLTRI
KEITEGKTV	KEITEGKTV
FEDRGFVQV	FEDRGFVQV
GEAPFSSTKV	GEAPFSTKV
AEVEKIIAV	AEVEKIIAV
FETLQAQAGK	FETLQQAGK
AEASQLGHKV	AEASQGHKV
FEDPKFEVI	FEDPKFEVI
REPERIPVTV	REPERPVTV
AEKGVARVV	AEKGVARVV
GENLKVLTV	GENLKVLTV
RELENLIGI	RELENLIGI
TEDSHLSTV	TEDSHLSTV
AEFRDYPPVL	AEFRDPPVL
TVTEKPEVID	TVTEKPEVI
FEVGARKV	FEVG-ARKV
FEHGDTNEV	FEHGDTNEV
TEFHELEKI	TEFHELEKI
AEVPLLDEV	AEVPLLDEV
GEAGAKFIEV	GEAGAFIEV
FERPQYAEI	FERPQYAEI
DPDKRISI	DPDK-RISI
SEGGQLRSI	SEGGQLRSI
SEIHPGMLLI	SEIHPMLLI
LEVDHIRTI	LEVDHIRTI
TETKYGIRI	TETKYGIRI
TEFGHPAAI	TEFGHPAAI
IEKPGGIIV	IEKPGGIIV
ELSERLELV	ELSERLELV
QEVFEKATFI	QEVFEATFI
SEDIHIIYI	SEDIHIIYI
TELLTTQRV	TELLTTQRV
SEFETHNV	SEFE-THNV
GEVSFINI	GEVS-FINI
LESHWFVWV	LESHWFVWV
IEFSYELSKV	IEFSYLSKV
AEIAALRFL	AEIAALRFL
FEELTNLIRTI	EELTNIRTI
LEHKIIIRV	LEHKIIIRV
GEIVRNILI	GEIVRNILI
REIPIVHRV	REIPIVHRV
AEPHRPLKI	AEPHRPLKI
KEHTGRLVI	KEHTGRLVI
IETVQKETI	IETVQKETI
KEIENGVYLI	KEIENVYLI
TEIEKARAV	TEIEKARAV
LEVDGQKVEV	LEVDGKVEV
MELSQPEV	MELS-QPEV
AEITELIHI	AEITELIHI
AEVDKLELM	AEVDKLELM
GEIPKQVKV	GEIPKQVKV
HEQEYKNNI	HEQEYKNNI
SEFPVRLSV	SEFPVRLSV
AEATLPTVI	AEATLPTVI
SENQPFPSL	SENQPFPSL
GEKGKNIKI	GEKGKNIKI
FEKVAAGV	FEKV-AAGV
GEEIRFRVV	GEEIRFRVV
SEGRPTIEV	SEGRPTIEV
NEISEITSI	NEISEITSI
HEITVLII	HEIT-VLII
GESVQGSHV	GESVQGSHV
IEDGKVVTV	IEDGKVVTV
QEHHTLRV	QEHH-TLRV
AEISSNSLERI	AEIS-SNSL
AEVKPEVKI	AEVKPEVKI
AEAKKLAAIT	AEAKKLAAI
AEAQKSSLV	AEAQKSSLV
REFVMQVKV	REFVMQVKV
AERKSPEI	AERK-SPEI
TEIQHKSI	TEIQ-HKSI
GEVHTGTTIM	GEVHTGTTI
AEIGFLTV	AEIG-FLTV
VEQQQLITV	VEQQQLITV
AERIGVDHV	AERIGVDHV
TEQYKWLEI	TEQYKWLEI
AENNVFHLV	AENNVFHLV
AEIAPFVEI	AEIAPFVEI
KEIEDFDSL	KEIEDFDSL
GEAQRLIEI	GEAQRLIEI
AEIGADGIAVI	AEIGAGIAV
AEAPTALV	AEAP-TALV
LEFPDQPDI	LEFPDQPDI
LEIPKGEMV	LEIPKGEMV
AEKPVGALL	AEKPVGALL
READLIFLL	READLIFLL
GEFVDDYTV	GEFVDDYTV
IEDNNTLVFI	IEDNNLVFI
MEVQTKKV	MEVQ-TKKV
QEGDQILKV	QEGDQILKV
GEIIGKRGI	GEIIGKRGI
GEIRGFETA	GEIRGFETA
GEDKGGYVI	GEDKGGYVI
AENESMAKI	AENESMAKI
RESDLENYI	RESDLENYI
YERGFENIM	YERGFENIM
GEFEEFSRRI	GEFEESRRI
HEYTTKEI	HEYT-TKEI
GENIEPVKI	GENIEPVKI
QEQVIAVHI	QEQVIAVHI
HETLFILGV	HETLFILGV
VISSIEQK	VISS-IEQK
DGDGTITTK	DGDGTITTK
KEALVQVEV	KEALVQVEV
LEDAFSRQV	LEDAFSRQV
IEFSDKESV	IEFSDKESV
AEINNIIKI	AEINNIIKI
RELVSGGRSV	RELVSGRSV
SERYTWIVL	SERYTWIVL
MEIERILGV	MEIERILGV
IEDHFDVTV	IEDHFDVTV
REAVHIEKI	REAVHIEKI
LEFLSVKEI	LEFLSVKEI
YEKINVNEI	YEKINVNEI
SELRSMLEV	SELRSMLEV
TEIQLVQSL	TEIQLVQSL
MEWDTQVV	MEWD-TQVV
SEALEAARI	SEALEAARI
SEAGKSTSI	SEAGKSTSI
HEGLPGLAV	HEGLPGLAV
GEWSDQPRI	GEWSDQPRI
SEMTQVKEV	SEMTQVKEV
TENMPIKINLI	TENM-PIKI
LEEKTRLI	LEEK-TRLI
QEFPDLENV	QEFPDLENV
AETEQHIKV	AETEQHIKV
LEVPGLRSV	LEVPGLRSV
KELLLQPVTI	KELLLPVTI
AELFIPPKI	AELFIPPKI
TEYSFLDYV	TEYSFLDYV
QEALNLFKSI	QEALNFKSI
SEIERQAQV	SEIERQAQV
SEEQFVHHI	SEEQFVHHI
GEAGPHAMV	GEAGPHAMV
LEHEGLVSL	LEHEGLVSL
GEIDRARAI	GEIDRARAI
VEIFHPLRL	VEIFHPLRL
GEFPDLHRTIV	GEFPDHRTI
YEATTGNLHV	YEATTNLHV
GELGGFAAI	GELGGFAAI
TEFDYPSVGQV	TEFD-YPSV
VEVTGHAHV	VEVTGHAHV
VEIENLGNL	VEIENLGNL
AEVPTGTNV	AEVPTGTNV
REAQKFALA	REAQKFALA
AEHLFLENDV	AEHLFENDV
LEKPDFINV	LEKPDFINV
KEGDIVTLI	KEGDIVTLI
LEAAIPERV	LEAAIPERV
AEYSRFVNQI	AEYSRVNQI
LESLPLSKL	LESLPLSKL
GEGQLGPAER	GEGQLPAER
VEAALVSKI	VEAALVSKI
REKEFTVKI	REKEFTVKI
SELGYVFQAI	SELGYFQAI
AEPEKVLRV	AEPEKVLRV
KEYEPEMGKV	KEYEPMGKV
EEFQNVRII	EEFQNVRII
SEFLIEPTV	SEFLIEPTV
SEDKSIRV	SEDK-SIRV
TEAPVPVSV	TEAPVPVSV
SEHGVGIYV	SEHGVGIYV
GEEWKGYVV	GEEWKGYVV
KEIIGLEGV	KEIIGLEGV
NELERNITI	NELERNITI
IEHIIENIV	IEHIIENIV
LEYGVPVTLI	LEYGVVTLI
GELSLPVHL	GELSLPVHL
GEELVTKPV	GEELVTKPV
GELWNKFFV	GELWNKFFV
VEFNGKLLA	VEFNGKLLA
VEHQNGKVVV	VEHQNGKVV
REIVSGMKYI	REIVSMKYI
AEAVVNTV	AEAV-VNTV
GEVVTIRV	GEVV-TIRV
AEDLRREMI	AEDLRREMI
LEYPDFYRKL	LEYPDYRKL
KEGPSPKV	KEGP-SPKV
SEHLAFERQV	SEHLAERQV
SELDRINAQYL	SELDRINAQ
VEGRDVVALI	VEGRDVALI
GEKTAGINV	GEKTAGINV
LEYDPAKRITL	LEYDPAKRI
AETILLKAV	AETILLKAV
VELPAVASV	VELPAVASV
REEVGNISI	REEVGNISI
GESKFITV	GESK-FITV
AEFKQIRSI	AEFKQIRSI
LELKTATKI	LELKTATKI
KEFIGQQLI	KEFIGQQLI
HEAQLSEKI	HEAQLSEKI
SEIKTSIEV	SEIKTSIEV
LEIVEPVTV	LEIVEPVTV
HEAAFPIAVV	HEAAFPIAV
AEAYLGKKV	AEAYLGKKV
KELDPTNMTYI	KELDPTNMT
HEVFNHREV	HEVFNHREV
EEIQNLIKI	EEIQNLIKI
AEISTLAKM	AEISTLAKM
IEYARQLEM	IEYARQLEM
AEEIKVARI	AEEIKVARI
AETVRPEEV	AETVRPEEV
SEFDFFERL	SEFDFFERL
LEKLGILI	LEKL-GILI
YEDRGITSV	YEDRGITSV
FEQGGARVVV	FEQGGARVV
AEIITNQI	AEII-TNQI
AEITDKLGL	AEITDKLGL
AETLSKQSI	AETLSKQSI
LEELQKRFI	LEELQKRFI
QEVQLMTKI	QEVQLMTKI
FERPDGFLLV	FERPDFLLV
HEWLQQHGI	HEWLQQHGI
AEDEWKAQV	AEDEWKAQV
REYTSRESKI	REYTSESKI
AEPESVLLV	AEPESVLLV
KEAPAPPKA	KEAPAPPKA
QESPLFNNV	QESPLFNNV
SEASYLITSV	SEASYITSV
HETTFNSI	HETT-FNSI
AELDRQWKKI	AELDRWKKI
FEAQGALANI	FEAQGLANI
REEEGTLII	REEEGTLII
NEVNFREI	NEVN-FREI
YEEDQGSKLIR	EEDQGSKLI
AEHNPQYLI	AEHNPQYLI
AEDPETQVV	AEDPETQVV
AELPGSSAV	AELPGSSAV
AEKVHFILV	AEKVHFILV
VRQEESEQIK	VRQEESEQI
KEIGDIAGV	KEIGDIAGV
IEQHPVVVI	IEQHPVVVI
AEVVKAPQV	AEVVKAPQV
REDAARAI	REDA-ARAI
RPPGFSPFR	RPPGFSPFR
SEMSRVIRV	SEMSRVIRV
GEYSGIEHV	GEYSGIEHV
AEFKEAFQLF	AEFKEAFQL
REYMVEKI	REYM-VEKI
TESLFFDKV	TESLFFDKV
VEAFIIQNI	VEAFIIQNI
FEILPGLSV	FEILPGLSV
KEIEQEAAV	KEIEQEAAV
GEYAVRAI	GEYA-VRAI
LEVDTKKQIV	LEVDTKKQI
SEWERFISKV	SEWERISKV
IEDGKGTILI	IEDGKTILI
IEIYVQKV	IEIY-VQKV
AEIEEDKARRI	IEEDKARRI
SEFEGGKSTV	SEFEGKSTV
KELSELVSI	KELSELVSI
VEYDAEGFTKL	VEYDAFTKL
SEIQNVLGV	SEIQNVLGV
LSELEAALQR	SELEAALQR
LENITSKEI	LENITSKEI
IELDMRTI	IELD-MRTI
KEFPELVARI	KEFPEVARI
IEISGPKV	IEIS-GPKV
REIQKVTKL	REIQKVTKL
PEYGGFTSYI	PEYGGTSYI
TEDPNQLTV	TEDPNQLTV
AEKNGYVTV	AEKNGYVTV
AEVPTMAV	AEVP-TMAV
AEINSRTGSKL	AEINSTGSK
HEVDELTQI	HEVDELTQI
KEHLYFETV	KEHLYFETV
HEVPFPANI	HEVPFPANI
KELESRLQQV	KELESLQQV
AETGKVVII	AETGKVVII
AELQELLTV	AELQELLTV
AEIAQLMSL	AEIAQLMSL
REDISIMI	REDI-SIMI
KEPPLSLTI	KEPPLSLTI
LEFIPSDQQVI	LEFIPDQQV
AEQPTALTV	AEQPTALTV
SEKSNLIRI	SEKSNLIRI
REVEVEYSTV	REVEVYSTV
SEAQPQPEV	SEAQPQPEV
KELPQVSFV	KELPQVSFV
SEYDQIRYI	SEYDQIRYI
KEDVRILKV	KEDVRILKV
AELDQLLAV	AELDQLLAV
GEFELMHV	GEFE-LMHV
SEDVLRLLI	SEDVLRLLI
AETPGAEKI	AETPGAEKI
SEIDQINKV	SEIDQINKV
REDISSIEI	REDISSIEI
KEFQDLREV	KEFQDLREV
MEHDGSLFQAV	MEHDGFQAV
SEDKVRQLV	SEDKVRQLV
RELVAIKKV	RELVAIKKV
SETQFSHL	SETQ-FSHL
AEWIQQNNI	AEWIQQNNI
AEALATHIL	AEALATHIL
REYDTSKIEA	REYD-TSKI
AERLGMGLV	AERLGMGLV
FEDDDITHV	FEDDDITHV
TETGSNINV	TETGSNINV
SEHPNVTLTI	SEHPNTLTI
FEQFLQERI	FEQFLQERI
AEHDLWHII	AEHDLWHII
MEHPYFYTVV	MEHPYFYTV
AELNFGAITL	AELNFAITL
GEWDKALSI	GEWDKALSI
IEVGVVTV	IEVG-VVTV
KEDIPRQLV	KEDIPRQLV
LEDEKPVSV	LEDEKPVSV
FEEASNQLI	FEEASNQLI
GELGMKLSEI	GELGMLSEI
GEKVWQIRV	GEKVWQIRV
AEVPGAGAV	AEVPGAGAV
SEFGKLERV	SEFGKLERV
QEHQIVLV	QEHQ-IVLV
SEFTGVWKYI	SEFTGWKYI
LEWGADPHI	LEWGADPHI
TEKAPEPHV	TEKAPEPHV
YEGSVAKV	YEGS-VAKV
SEGRDPLTI	SEGRDPLTI
SEYHRIQHQL	SEYHRQHQL
YEDISRGLQGT	YEDI-SRGL
AELKSSTV	AELK-SSTV
AETGLLGAHFV	AETG-LLGA
IELKNGTQV	IELKNGTQV
AEMDARTILL	AEMD-ARTI
FEAQGGLANI	FEAQGLANI
GEPLHSLII	GEPLHSLII
KEPEKVNPQI	KEPEKNPQI
HEYFPEMQI	HEYFPEMQI
AESPTVHV	AESP-TVHV
REIIINAV	REII-INAV
GETINTRLI	GETINTRLI
REFFKLQKI	REFFKLQKI
AEWPKEQFI	AEWPKEQFI
MEEIRNLTV	MEEIRNLTV
TENPGKSISV	TENPGSISV
HEGLPQPLI	HEGLPQPLI
YEEMYPPEI	YEEMYPPEI
GEISSSKPAI	GEISSKPAI
AEIKVKLI	AEIK-VKLI
YEHLGELLTV	YEHLGLLTV
AENVAVPEA	AENVAVPEA
GELRHITKL	GELRHITKL
AEFEVVRTI	AEFEVVRTI
REQELFNRI	REQELFNRI
AEVYRILSV	AEVYRILSV
TEIFSGKSV	TEIFSGKSV
AEAKVNGTTV	AEAKVGTTV
SEILDGNQLHI	SEILDGNQL
GEMKPGRKGI	GEMKPRKGI
KEGFPITAI	KEGFPITAI
AEADKTIKV	AEADKTIKV
SENPLPTVEI	SENPLTVEI
KENERWNVI	KENERWNVI
SEVGHWRHI	SEVGHWRHI
AEFGAAGVNRL	AEFG-AAGV
REALTHRKI	REALTHRKI
AEIKTTNEV	AEIKTTNEV
LENDKILQI	LENDKILQI
LEVLVKGV	LEVL-VKGV
AEVIPLAL	AEVI-PLAL
LESLPATHI	LESLPATHI
AEAVASLATRI	AEAVALATR
EEINYLTRI	EEINYLTRI
AEYPGSSAQL	AEYPGSAQL
KETELNKVI	KETELNKVI
AESDKPVVI	AESDKPVVI
LEVIDIFKI	LEVIDIFKI
AEHPVYNMV	AEHPVYNMV
AENDKDVKI	AENDKDVKI
AEAERLLLI	AEAERLLLI
RLDEVLRTL	RLDEVLRTL
HEGETSYI	HEGE-TSYI
AEKGPMIVLV	AEKGPIVLV
IREEYPDR	IREE-YPDR
TEHYDIPKV	TEHYDIPKV
GEIRELKQL	GEIRELKQL
GEEVAMRTV	GEEVAMRTV
REIQEAIAV	REIQEAIAV
SELEKKLVAI	SELEKLVAI
YEHDDIVSTV	YEHDDVSTV
GEYAKLEKI	GEYAKLEKI
KELSEALTR	KELSEALTR
GEHKIMDYI	GEHKIMDYI
AEVSLMEV	AEVS-LMEV
SETESMLKI	SETESMLKI
IEHHLASNV	IEHHLASNV
REYDDQRALEI	REYDDQRAL
KEHPFILNL	KEHPFILNL
AEAAGTTFV	AEAAGTTFV
FESDLHSLL	FESDLHSLL
AQYEDIAQK	AQYEDIAQK
TELDRVHIV	TELDRVHIV
LEHNFSAI	LEHN-FSAI
AEAGGMHTV	AEAGGMHTV
YEGKFANHV	YEGKFANHV
REIEELHKL	REIEELHKL
GEAFLPLREV	GEAFLLREV
KEFLVVASV	KEFLVVASV
KEFAQIIKI	KEFAQIIKI
QEVNFQEYV	QEVNFQEYV
LELEQLRSV	LELEQLRSV
LEHSPFSYL	LEHSPFSYL
AEARPFEVL	AEARPFEVL
KESEDKPEI	KESEDKPEI
SEELRSRIV	SEELRSRIV
LELEAPLKI	LELEAPLKI
TENASEVKI	TENASEVKI
AELRNASAV	AELRNASAV
TEVHPDYGSHI	TEVHPGSHI
GEYGGWYKA	GEYGGWYKA
REDQINRLI	REDQINRLI
TEVREIKRI	TEVREIKRI
AEAHRIQQI	AEAHRIQQI
HELPEFNLI	HELPEFNLI
QEALGVAVI	QEALGVAVI
TEVLFNEKI	TEVLFNEKI
AEVLRTMEL	AEVLRTMEL
YEYEGGHIKTA	YEYE-GGHI
SEIRAPIVTV	SEIRAIVTV
GETQSRTITV	GETQSTITV
GEFSLHEQTV	GEFSLEQTV
TEFYEQESI	TEFYEQESI
TEYETQVKV	TEYETQVKV
WEAGKPLSI	WEAGKPLSI
TEIEDMPTL	TEIEDMPTL
VEIITKEFI	VEIITKEFI
DQVANSAFVER	VANSAFVER
LENVAITV	LENV-AITV
REDPKEGIKI	REDPKGIKI
VEYTEKMVSI	VEYTEMVSI
KEHFEVNVV	KEHFEVNVV
SETTSTRKI	SETTSTRKI
KESSPLSSRKI	KESSPLSSR
GEDPRPGGQI	GEDPRGGQI
QEIEVRPGIV	QEIEVRPGI
FEIFADPRTV	FEIFAPRTV
AEIIRFLTN	AEIIRFLTN
SEVPNGKEV	SEVPNGKEV
REHQFTKIDTI	REHQ-FTKI
REFPTHRSV	REFPTHRSV
YELKEGRQI	YELKEGRQI
IEAKFYEEV	IEAKFYEEV
VELGPRPTV	VELGPRPTV
LELQHALQAI	LELQHLQAI
VESGDLQKEI	VESGDQKEI
QEMPWNVRM	QEMPWNVRM
TEDQRFPQL	TEDQRFPQL
KEISESRVV	KEISESRVV
FEDEKPALL	FEDEKPALL
QELYFFHEL	QELYFFHEL
TEHSGLTTGV	TEHSGTTGV
REAEIYQTV	REAEIYQTV
AEKELTASV	AEKELTASV
TEGVPSTAI	TEGVPSTAI
AEDGSRVYV	AEDGSRVYV
REFGKALQL	REFGKALQL
AEPGNLAGV	AEPGNLAGV
FEIPKGTQV	FEIPKGTQV
SEAKEVRGV	SEAKEVRGV
LEFDPAQRI	LEFDPAQRI
YEEDSYSHI	YEEDSYSHI
SENPGNKTI	SENPGNKTI
SSSKGSLGGGF	SSSKGSLGG
MEQVFEMKV	MEQVFEMKV
REHEQFQHAI	REHEQQHAI
GELEEMRKV	GELEEMRKV
AEYDRPNLL	AEYDRPNLL
QERHLLVKV	QERHLLVKV
REDGVTPYM	REDGVTPYM
AEIRHVLVTL	AEIRHLVTL
TEFDRQAEV	TEFDRQAEV
SEASPSREAI	SEASPREAI
TEDVPMILV	TEDVPMILV
AELQEVVKV	AELQEVVKV
AEVGRKLLL	AEVGRKLLL
FEGGVSSV	FEGG-VSSV
MEQQSISI	MEQQ-SISI
SEKISLQAI	SEKISLQAI
AENFFVETL	AENFFVETL
LEAERSTNI	LEAERSTNI
LEEPRGQQEV	LEEPRQQEV
AEIQELHQSV	AEIQEHQSV
IEVTPQSKI	IEVTPQSKI
AEAVFASEV	AEAVFASEV
LEADPIKRI	LEADPIKRI
HEIAHDGQRI	HEIAHGQRI
REEEKVSAV	REEEKVSAV
AEFRDPLGYI	AEFRDLGYI
AEQKRLKTV	AEQKRLKTV
KEWAFEESKI	KEWAFESKI
LNVTEQEK	LNVT-EQEK
REHPSLRL	REHP-SLRL
IVEKIDFDSVS	VEKIDFDSV
TEREKFWKI	TEREKFWKI
LEQERQQEI	LEQERQQEI
LEYTQILQTV	LEYTQLQTV
KEISYFVAEFI	KEISYVAEF
SEVTPAMQI	SEVTPAMQI
AEGSVTSV	AEGS-VTSV
RELDLYDNQI	RELDLDNQI
GEFKFTNV	GEFK-FTNV
SELPMPLLI	SELPMPLLI
YEEIMRDYI	YEEIMRDYI
AEQGKALLI	AEQGKALLI
LPNDHSRVI	LPNDHSRVI
YEDGAFGIRI	YEDGAGIRI
AEFPHSFLV	AEFPHSFLV
TEAKPAVV	TEAK-PAVV
REYIEIITSSI	IEII-TSSI
AEAQQLITI	AEAQQLITI
IEKLFPDAI	IEKLFPDAI
VEVDRILEV	VEVDRILEV
AEDPKVTLTI	AEDPKTLTI
LEEDKSLKV	LEEDKSLKV
HELAFSRLI	HELAFSRLI
AEMENYAHL	AEMENYAHL
QEYQEKLQV	QEYQEKLQV
AEVPTALEKI	AEVPTLEKI
SEILIPLQSV	SEILILQSV
AELLLIPKV	AELLLIPKV
YEDPQHHPL	YEDPQHHPL
REKSTLERI	REKSTLERI
HEAEPVRTL	HEAEPVRTL
AEIYEQEYI	AEIYEQEYI
REEEAMKQI	REEEAMKQI
KEVQTVTSI	KEVQTVTSI
KEFENPEV	KEFE-NPEV
SEVYLFSHV	SEVYLFSHV
TEDIPIILV	TEDIPIILV
AERDRWIEDL	AERDRIEDL
AEKNFELVI	AEKNFELVI
KEGLSFLGGL	KEGLSLGGL
FEGLITTI	FEGL-ITTI
LEYFKGAIPL	LEYF-KGAI
VEKIDFDSV	VEKIDFDSV
FEVGAGQVSV	FEVGAQVSV
FEYPEYQKI	FEYPEYQKI
QEIISKGLI	QEIISKGLI
AEFLIGQGAHV	AEFLIGQGA
REYFHKLLI	REYFHKLLI
SEVPVITPYL	SEVPVTPYL
AEIPLRMV	AEIP-LRMV
GEIDENSFHNI	GEIDEFHNI
SEIESVKI	SEIE-SVKI
GEFRTTTV	GEFR-TTTV
GEYSSLEHESV	GEYSSHESV
AERIIILKI	AERIIILKI
QELEQVLGI	QELEQVLGI
VEISLPLSTV	VEISLLSTV
RESQLALIV	RESQLALIV
REAFPAHKV	REAFPAHKV
REKITAQSI	REKITAQSI
LEINPKLQTQV	LEINPKLQT
QETDVRAQI	QETDVRAQI
HEQLSVAEI	HEQLSVAEI
AEFEWENKVTV	AEFEWENKV
HERAAILSV	HERAAILSV
AELDIPQSV	AELDIPQSV
TEHVEAFITI	TEHVEFITI
REKDLFRSV	REKDLFRSV
GEPGFPLNAI	GEPGFLNAI
AEIATRLA	AEIA-TRLA
EQTLPTKL	EQTL-PTKL
AEQLAWLRV	AEQLAWLRV
KEAELRQV	KEAE-LRQV
TEKEDFIEL	TEKEDFIEL
GEVENTPLRV	GEVENPLRV
REFPTVPLV	REFPTVPLV
VERARQVQV	VERARQVQV
VEIDGIGRI	VEIDGIGRI
LEHNYFVSI	LEHNYFVSI
GEVTVRVV	GEVT-VRVV
FEDKWFRKI	FEDKWFRKI
ELLKPTELVP	ELLKPTELV
DRQQQITV	DRQQ-QITV
GEEHPIRVV	GEEHPIRVV
IEYPTLHVV	IEYPTLHVV
VESQLPEKV	VESQLPEKV
REIYDIISMV	REIYDISMV
FEFEYQTKV	FEFEYQTKV
AEQTFEQAI	AEQTFEQAI
AESPAALTEV	AESPALTEV
MEWTSSSKI	MEWTSSSKI
VEQEIQTSV	VEQEIQTSV
AEENGFRYI	AEENGFRYI
GEISPGKINSV	GEIS-PGKI
QETDSSLVV	QETDSSLVV
AEHFAMMVI	AEHFAMMVI
AEGTNFRTV	AEGTNFRTV
GEVEKLLKT	GEVEKLLKT
MEDGPIVKL	MEDGPIVKL
QEVAVKEQLT	QEVAVKEQL
SEVEGVKNI	SEVEGVKNI
GEISPQREV	GEISPQREV
KEFWDGFEEV	KEFWDFEEV
KEFDGKSLV	KEFDGKSLV
RENENHLLV	RENENHLLV
SEIVGKRI	SEIV-GKRI
AEYLGANSVV	AEYLGANSV
AEDDRHYNI	AEDDRHYNI
KERELQNTV	KERELQNTV
QEVGKVIGI	QEVGKVIGI
AENLQALFV	AENLQALFV
KEVAGLRQL	KEVAGLRQL
MEYPNFEET	MEYPNFEET
VENLPRTVI	VENLPRTVI
AEIIGGERSV	AEIIGERSV
LEAERFENL	LEAERFENL
GEIRETSQTKV	RETS-QTKV
QIKEDFTQL	QIKEDFTQL
AENGPGIKI	AENGPGIKI
KEISDLHYL	KEISDLHYL
KEDESIRKTEI	KEDESIRKT
TEQPSHSQV	TEQPSHSQV
SEDGAIHVI	SEDGAIHVI
GEPQVQFKLV	GEPQVFKLV
KEYEEYVLTV	KEYEEVLTV
FEGDTGLIV	FEGDTGLIV
REGKIAGRAV	REGKIGRAV
QGTEIDGR	QGTE-IDGR
QEASEAYLV	QEASEAYLV
AEKSPSVHI	AEKSPSVHI
IAPTGHSL	IAPT-GHSL
GEQRLIHKI	GEQRLIHKI
REFQNPPQL	REFQNPPQL
AEAEQEMQRI	AEAEQMQRI
KEIENGHIFTV	IENGHIFTV
TEIPLQLVTV	TEIPLLVTV
AEVLPSHKV	AEVLPSHKV
FEHVTSEI	FEHV-TSEI
AETQRQMAHV	AETQRMAHV
YENPVVSRI	YENPVVSRI
EVIEEVNKV	EVIEEVNKV
GEAHPSASLI	GEAHPASLI
LEHLSEETV	LEHLSEETV
AEYAGRLGV	AEYAGRLGV
EALITKIG	EALI-TKIG
QEYLGKFRRL	QEYLGFRRL
VEFNGKLLASI	VEFNGKLLA
TSYAQHQQVR	TSYAQHQQV
GEHGDSSVAV	GEHGDSVAV
AEAEGLRAA	AEAEGLRAA
IEAEKVAQV	IEAEKVAQV
SEYQRFAVM	SEYQRFAVM
GEYKMILVV	GEYKMILVV
VEDGPREILI	VEDGPEILI
AEKNGLVKI	AEKNGLVKI
KEIAEVNEI	KEIAEVNEI
VEKILLSVV	VEKILLSVV
EEGPPVTTV	EEGPPVTTV
YEHPKDLKL	YEHPKDLKL
AESIHLWEV	AESIHLWEV
REIEENQKRI	REIEEQKRI
SEIATTGVRV	SEIATGVRV
SEVLLRHI	SEVL-LRHI
APIIAVTR	APII-AVTR
AETPQAKKI	AETPQAKKI
AEVQHQLHV	AEVQHQLHV
VEDDSRALNI	VEDDSALNI
SEHSGPPIVI	SEHSGPIVI
REIEHLSRLY	REIEHLSRL
IERIHREV	IERI-HREV
TERAFIHRL	TERAFIHRL
FESGNMTQV	FESGNMTQV
AEAKKLAAI	AEAKKLAAI
YEGSPIKV	YEGS-PIKV
KENDRSLYI	KENDRSLYI
AEAGPLASV	AEAGPLASV
GEYPKLLRL	GEYPKLLRL
LEADKIRPL	LEADKIRPL
YALYDATYETK	ALYDAYETK
QEIFPAARI	QEIFPAARI
VEAIVKNV	VEAI-VKNV
IEKEYLERV	IEKEYLERV
AELEVVPII	AELEVVPII
QEIPEPLQL	QEIPEPLQL
SEYLSQNPRV	SEYLSNPRV
AEVAGQFVI	AEVAGQFVI
SELITKAV	SELI-TKAV
KEAGDLSTL	KEAGDLSTL
QERPGAAAI	QERPGAAAI
QEYLFERI	QEYL-FERI
HERFPFEIV	HERFPFEIV
SESRPLPRVH	SESRPLPRV
GEISDKWQYI	GEISDWQYI
RELYLSAKV	RELYLSAKV
AEGPPRLAI	AEGPPRLAI
SEYITHEITV	SEYITEITV
REYDVPYHI	REYDVPYHI
REPEKRPPTV	REPEKPPTV
KEAEKSPQL	KEAEKSPQL
SEFQKAVKLV	SEFQKVKLV
RENTQTTI	RENT-QTTI
FEQFLLPVI	FEQFLLPVI
TEDVPRKLL	TEDVPRKLL
AEYDFRNDSV	AEYDFNDSV
YEAPAYHLI	YEAPAYHLI
IEGPSKAEI	IEGPSKAEI
AEIQFAQRL	AEIQFAQRL
VEVGKNINI	VEVGKNINI
LEVGDIVKV	LEVGDIVKV
MEVPVLPKI	MEVPVLPKI
KEAELRTWI	KEAELRTWI
REVNYIDKI	REVNYIDKI
QEAVGNIKV	QEAVGNIKV
AEEYGARVV	AEEYGARVV
TEYSFLKEV	TEYSFLKEV
GEFRAVTEL	GEFRAVTEL
REFEVIAQI	REFEVIAQI
LSIGDRLTAI	LSIGDLTAI
EEDQGSKLI	EEDQGSKLI
QEMPVQFQVV	QEMPVFQVV
AEGTSTRLI	AEGTSTRLI
TEQDRVFFI	TEQDRVFFI
GEILIGGQSV	GEILIGQSV
LEISVGKSV	LEISVGKSV
KEKESTVHI	KEKESTVHI
VEYAFKAI	VEYA-FKAI
REPQGFHKV	REPQGFHKV
LEADGTEKV	LEADGTEKV
KEYERFSKY	KEYERFSKY
REMDRETLI	REMDRETLI
LENPDFREI	LENPDFREI
IENGHIFTV	IENGHIFTV
TEAHPLPVL	TEAHPLPVL
GEADQKGSLV	GEADQGSLV
MEKPSPLLV	MEKPSPLLV
SELERESKV	SELERESKV
VEFMDDTSRSI	VEFMDDTSR
SEVSKIVTV	SEVSKIVTV
SEFDFSWSKI	SEFDFWSKI
QEYQEKGVRV	QEYQEGVRV
SEKQYTIYI	SEKQYTIYI
AEFSSALVSI	AEFSSLVSI
HEIKTIKI	HEIK-TIKI
QEAEQLRNQI	QEAEQRNQI
REYPDGTVKTV	REYPDGTVK
TEQVIISRV	TEQVIISRV
NEGLGQPQV	NEGLGQPQV
AELDPGTISV	AELDPTISV
WEISQKTVL	WEISQKTVL
RERGITIDI	RERGITIDI
REEIGNRYI	REEIGNRYI
VEEDHIPYI	VEEDHIPYI
AEVKAAAEI	AEVKAAAEI
IEFDERGNVI	IEFDEGNVI
AEFPMSPVTSV	AEFP-MSPV
QEIPDLSSNV	QEIPDSSNV
SEIHSGNSV	SEIHSGNSV
QEWDGLVRI	QEWDGLVRI
AELRRVDAL	AELRRVDAL
GEIDGNKVTL	GEID-GNKV
LEDIQTREV	LEDIQTREV
SEVEVIHV	SEVE-VIHV
NEITRLTTV	NEITRLTTV
AESPSRDVV	AESPSRDVV
AEIQGNINKV	AEIQGINKV
REHTALLKI	REHTALLKI
LEFDRIAEII	LEFDRIAEI
REVLINNI	REVL-INNI
EAHYLSYLNNL	HYLSYLNNL
IENHEGVR	IENH-EGVR
GEDFKLGTI	GEDFKLGTI
HETDNMNQI	HETDNMNQI
LEYRVTQV	LEYR-VTQV
IEIGDTIRV	IEIGDTIRV
TEDYYVHLI	TEDYYVHLI
LEDEHLLQAI	LEDEHLQAI
KEIVDDTKV	KEIVDDTKV
GEVDVEQHTL	GEVDVQHTL
IEDPVRPEV	IEDPVRPEV
KEIEYVETV	KEIEYVETV
VEFAKQLATV	VEFAKLATV
HEFGAITFV	HEFGAITFV
SEAPPTNQA	SEAPPTNQA
SEAPFLHYL	SEAPFLHYL
HEDPVIAV	HEDP-VIAV
AEGPVAVVV	AEGPVAVVV
SEIEAKVRYV	SEIEAVRYV
SEHLAAIEI	SEHLAAIEI
SELPKPSSI	SELPKPSSI
YEEPNAWRI	YEEPNAWRI
LEGLSVRSV	LEGLSVRSV
SEAEKVYIV	SEAEKVYIV
QEVNSALSKI	QEVNSLSKI
AENPGKYNI	AENPGKYNI
LEVPSRVTV	LEVPSRVTV
REFQTSAI	REFQ-TSAI
AENEYQTAI	AENEYQTAI
KETGQIVAI	KETGQIVAI
SENRDLKTV	SENRDLKTV
YEITEQRKI	YEITEQRKI
GEFGVRNV	GEFG-VRNV
VEDEHSTLLI	VEDEHTLLI
LEGNPFLTV	LEGNPFLTV
LEQGNNSRTV	LEQGNSRTV
AEDKSWRV	AEDK-SWRV
RELKKTQLI	RELKKTQLI
SEADPSGVASI	SEAD-PSGV
HEAEDLKMLI	HEAEDKMLI
AETDVLFNKV	AETDVFNKV
SEYKINNKV	SEYKINNKV
AEIDFRLV	AEID-FRLV
IESPAFSTL	IESPAFSTL
VEYQMKSV	VEYQ-MKSV
SEDRPTGLVV	SEDRPGLVV
SETDMVRQI	SETDMVRQI
GEDPRVSINVV	GEDPRSINV
KENQNIAYV	KENQNIAYV
GEHHSTPSL	GEHHSTPSL
VEVKKFVKI	VEVKKFVKI
LEATINELV	LEATINELV
AEENLFKLI	AEENLFKLI
LEQGLFSKV	LEQGLFSKV
LERELYHVI	LERELYHVI
FENETAKKV	FENETAKKV
IEDRVKKI	IEDR-VKKI
GELPEHAKI	GELPEHAKI
EDQTEYLEER	TEYL--EER
AEKSEQPTL	AEKSEQPTL
AEIAAQRTI	AEIAAQRTI
IEAQIREI	IEAQ-IREI
AEYNGRLAA	AEYNGRLAA
IEIDQKLQEI	IEIDQLQEI
KESDLNGAQI	KESDLGAQI
LEDIPQALV	LEDIPQALV
SEAPFTHKV	SEAPFTHKV
AEINEIIRV	AEINEIIRV
GEIRTITV	GEIR-TITV
WEAYLSRLGV	WEAYLRLGV
TEAPAAVVI	TEAPAAVVI
SEVSWISSI	SEVSWISSI
VELKKFKRV	VELKKFKRV
SEVPGGQSV	SEVPGGQSV
GEKVGVGKI	GEKVGVGKI
KEAQPVVVI	KEAQPVVVI
IEAVNMASKI	IEAVNASKI
GEITHLQLEI	GEITHQLEI
REAEMRNSIL	REAEMRNSI
TEFEERSATI	TEFEESATI
AEEIYKAFV	AEEIYKAFV
AEHPGFMKT	AEHPGFMKT
SEVFLPNSNHV	SEVFLPNSN
TETDLHGSLRV	TETDLHGSL
GETDWKLIAI	GETDWLIAI
KEFSGHSSL	KEFSGHSSL
YELPDGQVITI	YELPDGQVI
GEMVALPPV	GEMVALPPV
AEYEERAAKV	AEYEEAAKV
REGPYSISV	REGPYSISV
FERATFLVI	FERATFLVI
AEMKAQEV	AEMK-AQEV
AIDSRGGEPL	AIDSRGEPL
RELEVRQV	RELE-VRQV
HEAPMTKI	HEAP-MTKI
AEIQNGVKQI	AEIQNVKQI
SEKLNLDSI	SEKLNLDSI
HEFLRLSQV	HEFLRLSQV
YELDHPGFQI	YELDHGFQI
FEIKDKMLI	FEIKDKMLI
AEMLKENKV	AEMLKENKV
VEILPVPYV	VEILPVPYV
REPDTEVITV	REPDTVITV
RERHQVIQTV	RERHQIQTV
REMDEQIRL	REMDEQIRL
REHQFYETL	REHQFYETL
GEITGEVRM	GEITGEVRM
TEHTEVREI	TEHTEVREI
AEEKAVLI	AEEK-AVLI
LEEGRVREV	LEEGRVREV
YELLFKEGVM	YELLFKEGV
TESSTAGLKV	TESSTGLKV
VEFISQSSV	VEFISQSSV
FEGAVIRTV	FEGAVIRTV
LEDNSIPQV	LEDNSIPQV
AEIVKQTHI	AEIVKQTHI
SEISQVFEI	SEISQVFEI
FETPLRVDV	FETPLRVDV
HETPKQPVV	HETPKQPVV
TEKQYIATI	TEKQYIATI
GEIRNLENVI	GEIRNLENV
HELTIPNNLI	HELTINNLI
YEDRQVPEA	YEDRQVPEA
AEEQFILSQV	AEEQFLSQV
AEKSPLQTI	AEKSPLQTI
AEHPTIKI	AEHP-TIKI
SEVASGQKI	SEVASGQKI
GEFHLWYQV	GEFHLWYQV
AESIANQRI	AESIANQRI
AEAQGSTTL	AEAQGSTTL
QETSVIHKI	QETSVIHKI
HEAEFSKI	HEAE-FSKI
VEAELKSSTV	VEAELSSTV
YERPNETKI	YERPNETKI
RETFPQRHM	RETFPQRHM
KEGLVMVEV	KEGLVMVEV
VQLIRESLKV	QLIRESLKV
RELENGNLEV	RELENNLEV
GEFAWRDGPLL	GEFAWGPLL
GEAGPVGNM	GEAGPVGNM
REAPVDVLTQI	REAP-VDVL
SESLLRGIYA	SESL-LRGI
GELIGNFVRV	GELIGFVRV
KENPNQYNYI	KENPNYNYI
QESEPFSHI	QESEPFSHI
KELGITALHI	KELGIALHI
HEAEIETRI	HEAEIETRI
REFLLGFQFI	REFLLFQFI
NELPDFPHI	NELPDFPHI
AERLTTELI	AERLTTELI
SEWRNLGV	SEWR-NLGV
FEQKGFRLV	FEQKGFRLV
REIVLSYSYI	REIVLYSYI
FEWVVNRI	FEWV-VNRI
IREFLQKI	IREF-LQKI
GEFFKQIGI	GEFFKQIGI
RETAFTHAV	RETAFTHAV
QEYPDLIHI	QEYPDLIHI
KEFGAVSKV	KEFGAVSKV
HEHIEILTV	HEHIEILTV
GEAVGARLI	GEAVGARLI
SEIDQLFRIF	SEIDQLFRI
REILTLLQGV	REILTLQGV
QEERPIRQI	QEERPIRQI
REAEMRNSI	REAEMRNSI
LEDGHSLVI	LEDGHSLVI
REFDVGRHI	REFDVGRHI
REKLPSSEVV	REKLPSSEV
MEVELPYRYI	MEVELYRYI
REDEKPLVL	REDEKPLVL
QERIDAWAQL	QERIDWAQL
SEGGPPLRI	SEGGPPLRI
GENRDAQMLI	GENRDQMLI
LEAIKALEV	LEAIKALEV
SEDDPILQI	SEDDPILQI
METAPHTMI	METAPHTMI
GEIPLPKLYI	GEIPLKLYI
LEIDPQKVNI	LEIDPKVNI
SESDFRQV	SESD-FRQV
ASLENSLR	ASLE-NSLR
AEWEANPLI	AEWEANPLI
QEIVTERSV	QEIVTERSV
YEEDQGSKLI	EEDQGSKLI
IEFLYNENTV	IEFLYENTV
VEQDFHLEI	VEQDFHLEI
SEIPLTLHSV	SEIPLLHSV
KEYQKISNQV	KEYQKSNQV
AEDENGKIV	AEDENGKIV
GESTSKLASV	GESTSLASV
KELQSAFNEI	KELQSFNEI
VEGPSQAKI	VEGPSQAKI
SEAIHPNTI	SEAIHPNTI
LSRGEANVL	LSRGEANVL
GESVPEPRI	GESVPEPRI
AEVRALQAEI	AEVRAQAEI
GETEVLKVI	GETEVLKVI
EAEIRAKQL	EAEIRAKQL
SESSFFAKI	SESSFFAKI
YEVVEKTRI	YEVVEKTRI
REYEKRVSAI	REYEKVSAI
REINYILRV	REINYILRV
EEISGIVEV	EEISGIVEV
VETAITKV	VETA-ITKV
AEIDSIHQLVV	AEIDSIHQL
GEDPRVSINV	GEDPRSINV
TEIREKLAKM	TEIRELAKM
TETIAPKI	TETI-APKI
TERSRVITV	TERSRVITV
IETINFHEV	IETINFHEV
GEYMDKNNV	GEYMDKNNV
TEGKTVQI	TEGK-TVQI
GEVLISRV	GEVL-ISRV
VETQSGKTVI	VETQSGKTV
REKYLYQKI	REKYLYQKI
AEAQLLNKQI	AEAQLNKQI
GESKDLLFI	GESKDLLFI
SERELFNAV	SERELFNAV
ADFAKVLEL	ADFAKVLEL
HEEGYFTAI	HEEGYFTAI
LEIVPNGITL	LEIVPGITL
AEHQQLIPLV	AEHQQIPLV
TEVPSLVV	TEVP-SLVV
SEIFTDNQI	SEIFTDNQI
REVWLYEQV	REVWLYEQV
AETAVSVI	AETA-VSVI
QEIEELTKI	QEIEELTKI
RELGEFRTTTV	GEFR-TTTV
HIAGILAR	HIAG-ILAR
HETPAASKTV	HETPASKTV
AESQDLRHV	AESQDLRHV
AEKLGFAGL	AEKLGFAGL
VEDRGTVVA	VEDRGTVVA
AEILRTMKKV	AEILRMKKV
AEGRPTPTI	AEGRPTPTI
AEAFKAKNV	AEAFKAKNV
AEYSTKNNAL	AEYSTNNAL
AEKKVVKI	AEKK-VVKI
AEIDSIHQL	AEIDSIHQL
AEKSDFEAV	AEKSDFEAV
SEVFEAINI	SEVFEAINI
LENENMMRV	LENENMMRV
SEILERLQKI	SEILELQKI
SEVHSPPNV	SEVHSPPNV
KEMEKSFEV	KEMEKSFEV
VEEEPFHTI	VEEEPFHTI
SEAVNLSKV	SEAVNLSKV
KEALPDGVNI	KEALPGVNI
RELPAGINSIV	RELPAINSI
PEAAEGPEV	PEAAEGPEV
SERGNLVAV	SERGNLVAV
SEVGKLLSA	SEVGKLLSA
GENLFEIHI	GENLFEIHI
LESVSLHEV	LESVSLHEV
AEVVLGNII	AEVVLGNII
VETESVRYV	VETESVRYV
FEDQNTLTSI	FEDQNLTSI
REEFDLDVV	REEFDLDVV
AEKNFLTTV	AEKNFLTTV
SEVSTAVRI	SEVSTAVRI
MEQVAHQTI	MEQVAHQTI
SEAPKEVNI	SEAPKEVNI
REFPKFFTF	REFPKFFTF
REHGAFDAV	REHGAFDAV
AEVVVTEI	AEVV-VTEI
GEANVPFITV	GEANVFITV
MEGKLTHKI	MEGKLTHKI
TEGPFVERV	TEGPFVERV
SEYLPTLWV	SEYLPTLWV
GEAELELRV	GEAELELRV
SEVEIIHV	SEVE-IIHV
AERVGAGAPV	AERVGGAPV
KEATSIKRV	KEATSIKRV
REDWKPVLTI	REDWKVLTI
AESLQLVTV	AESLQLVTV
AEIDDKLNKI	AEIDDLNKI
KEILLKAV	KEIL-LKAV
AEIDAHLVAL	AEID-AHLV
GEITSRAAV	GEITSRAAV
SEKLFRTV	SEKL-FRTV
LEDYSGLSV	LEDYSGLSV
AEKLEALSV	AEKLEALSV
VEWDTTGQNLI	VEWDTGQNL
SEIRHLLTL	SEIRHLLTL
LEHTTLRKV	LEHTTLRKV
AEHPTIAKSV	AEHPTAKSV
AENSQLTERI	AENSQTERI
IEAAQLLQI	IEAAQLLQI
QEAEPQKQV	QEAEPQKQV
YELLFKEGV	YELLFKEGV
KETAVFINI	KETAVFINI
REMQESVQV	REMQESVQV
KEAVLNGL	KEAV-LNGL
AESVEGVVRI	AESVEVVRI
SEDQRQVISV	SEDQRVISV
FEVLPQQVTI	FEVLPQVTI
AEGPITALTF	AEGP-ITAL
TEPYFNFTSI	TEPYFFTSI
LEYGLPIQV	LEYGLPIQV
LENIRPVLV	LENIRPVLV
AESHIILVL	AESHIILVL
VEVGSKIYV	VEVGSKIYV
LEVEHPAAKV	LEVEHAAKV
TEFIFTTI	TEFI-FTTI
KEGPITKHI	KEGPITKHI
SEDYPRKTI	SEDYPRKTI
RENLSVEI	RENL-SVEI
GEFVDDYTVRV	GEFVDDYTV
YEQQTYQVI	YEQQTYQVI
QEIRSQIVSV	QEIRSIVSV
GELKDLTQKV	GELKDTQKV
EEYGKIDTI	EEYGKIDTI
REQEQKVYV	REQEQKVYV
AEKLPGATV	AEKLPGATV
AEAQKLGKP	AEAQKLGKP
REAESLIAKKI	AESLIAKKI
TETEKFSGV	TETEKFSGV
GEIMQETGTRI	GEIMQGTRI
SETLIIPRV	SETLIIPRV
FEWVAERV	FEWV-AERV
GENVFTGQSKI	GENVFQSKI
LENQNKTLI	LENQNKTLI
REAKFYRVV	REAKFYRVV
LVSESSDVLPK	SESSDVLPK
AEYDTQVKEI	AEYDTVKEI
GEWERAAAV	GEWERAAAV
SEAMSVEKI	SEAMSVEKI
REVGKALLI	REVGKALLI
GESEANVREI	GESEAVREI
EEFKYLWNNI	EEFKYWNNI
AEYNVNNLV	AEYNVNNLV
GETQLVQEV	GETQLVQEV
AEETGVHII	AEETGVHII
KEVTDLRKI	KEVTDLRKI
GEIILHSV	GEII-LHSV
VEVLPTETEI	VEVLPETEI
AEMTTRMV	AEMT-TRMV
REMLQQSKI	REMLQQSKI
AEAHARIHL	AEAHARIHL
AEWDKSGVVTV	AEWDKSGVV
GELPNGRHKI	GELPNRHKI
SEYGFAEKV	SEYGFAEKV
KENTPPVVI	KENTPPVVI
SEFSPRSV	SEFS-PRSV
RETGYPLAV	RETGYPLAV
YEIEIVHI	YEIE-IVHI
VEIEREVLL	VEIEREVLL
RESTGAQVQV	RESTGQVQV
GEKELILTV	GEKELILTV
GEVPFNHEI	GEVPFNHEI
QEYLPSQITI	QEYLPQITI
GENVHIYLI	GENVHIYLI
YEFERTTSI	YEFERTTSI
IEPDVELQRI	IEPDVLQRI
EEYQNPHTV	EEYQNPHTV
SERDFFQEV	SERDFFQEV
VEQVHRGTTI	VEQVHGTTI
YEFDFSKV	YEFD-FSKV
GEFQIVNPHL	GEFQINPHL
LEPDKQEALI	LEPDKEALI
FEYRKDNKV	FEYRKDNKV
AESKEISNV	AESKEISNV
LEPGSIRHI	LEPGSIRHI
KDYPFYLTV	KDYPFYLTV
IEHNKLRTI	IEHNKLRTI
MEQQTISI	MEQQ-TISI
FEISDRLIGI	FEISDLIGI
GEIFLLPARV	GEIFLPARV
LEIDFPARAI	LEIDFARAI
TEENKALKI	TEENKALKI
SEFYKHIVL	SEFYKHIVL
GEGPIAVI	GEGP-IAVI
KEIPLSEILTV	KEIP-LSEI
AEVDVTRDIV	AEVDVTRDI
LQAEIEGLK	LQAEIEGLK
REFEPMLQV	REFEPMLQV
RENVAVAKL	RENVAVAKL
KEYEEDGARSI	YEEDGARSI
GEGDIVPKI	GEGDIVPKI
AEFKASKEI	AEFKASKEI
AEKALFRAL	AEKALFRAL
GEFNEVFNDV	GEFNEFNDV
SEVGKAGHI	SEVGKAGHI
TEITHAVVI	TEITHAVVI
AEIEHFIHI	AEIEHFIHI
LETNVPLLV	LETNVPLLV
KEADLDVATI	KEADLVATI
VEFPTDPKVVV	VEFPTDPKV
YEFPDKDWAHI	YEFPDWAHI
AELQELLTI	AELQELLTI
IEYARQLEMI	IEYARLEMI
GELIPKSKV	GELIPKSKV
FEDGQKIVV	FEDGQKIVV
TEINQHPVTV	TEINQPVTV
GEVMPVVVV	GEVMPVVVV
IEIKNKKKLLI	IEIKNKKKL
KELKGFKTI	KELKGFKTI
AEVERARQV	AEVERARQV
GELAQHSRV	GELAQHSRV
AEQIGELFI	AEQIGELFI
GESLDLLKV	GESLDLLKV
GEMKSGVPVL	GEMKSVPVL
AEKDSVLNIA	AEKDSVLNI
KEISITHHV	KEISITHHV
AERYGINTT	AERYGINTT
KELSDIAHRI	KELSDAHRI
IPADLPVVV	IPADLPVVV
HEIDRYTAI	HEIDRYTAI
VEPDHYVVV	VEPDHYVVV
FEEVWGVI	FEEV-WGVI
SEIRELENI	SEIRELENI
AEAEAVREV	AEAEAVREV
YEERVQAVV	YEERVQAVV
TETNVYFKL	TETNVYFKL
REIQTAVRL	REIQTAVRL
GEYFSVGSQV	GEYFSGSQV
IEYEPFRKN	IEYEPFRKN
AEKLGGSAV	AEKLGGSAV
IETASGNKV	IETASGNKV
AESRAEAARI	AESRAAARI
TEPDEAFRQI	TEPDEFRQI
SEAIVTVI	SEAI-VTVI
SEHVWVEVV	SEHVWVEVV
YEFLKSWTV	YEFLKSWTV
YENVKIPSI	YENVKIPSI
YERIYNEI	YERI-YNEI
AEAYLKPVV	AEAYLKPVV
AEIHLRLGQI	AEIHLLGQI
RETDFYLQSV	RETDFLQSV
REHPALRSL	REHPALRSL
SELDASKTV	SELDASKTV
AEIKELFQYI	AEIKEFQYI
GEWIKPGAI	GEWIKPGAI
AEYGGHDQI	AEYGGHDQI
GEEVAVKKV	GEEVAVKKV
AERFHFEAL	AERFHFEAL
REFKLSKV	REFK-LSKV
GEPDKLSMV	GEPDKLSMV
WEVPLPKV	WEVP-LPKV
LEQDFKVTL	LEQDFKVTL
IESSSPEV	IESS-SPEV
TENIRVTVI	TENIRVTVI
RETIPAKLV	RETIPAKLV
LEMNPGYEV	LEMNPGYEV
TEIDEKEYI	TEIDEKEYI
LEHIHSNEV	LEHIHSNEV
LEEIGGGQKV	EEIGGGQKV
HEIGHGIAAI	HEIGHIAAI
KEVAPVPKI	KEVAPVPKI
GEAEDMLMRI	GEAEDLMRI
RETAPRTI	RETA-PRTI
YEIHHGKKI	YEIHHGKKI
KEVYFAERV	KEVYFAERV
GENPLQVLV	GENPLQVLV
KEYFGIVSV	KEYFGIVSV
LEQDFVSRV	LEQDFVSRV
TEDEVERVITI	TEDEVERVI
HEIQSDVLTI	HEIQSVLTI
LSDGVAVLK	LSDGVAVLK
TELDPASFTEI	TELDPFTEI
GENPEDTKTQV	GENPEDTKT
IEDAGFHKV	IEDAGFHKV
LELDLSGQQV	LELDLGQQV
KEFSPFGTI	KEFSPFGTI
FEREVGRQSV	REVG-RQSV
AEYGHFVDIRI	AEYGHFVDI
AEITNGNAV	AEITNGNAV
VEWDPTGRYV	VEWDPGRYV
SEQPLPNKTI	SEQPLNKTI
AETDRLSYV	AETDRLSYV
AEKAGMVHL	AEKAGMVHL
GEIPWSQEL	GEIPWSQEL
AEAADVGAQMI	AEAADGAQM
VEQKQNPTV	VEQKQNPTV
SEINSLPTI	SEINSLPTI
HEVKEVAGI	HEVKEVAGI
KEYDLAKKYI	KEYDLKKYI
AEARHNPSI	AEARHNPSI
TEVGLVEKV	TEVGLVEKV
REIEATNAV	REIEATNAV
AEFEDLDSL	AEFEDLDSL
SENVNKLLV	SENVNKLLV
AEYQELLDV	AEYQELLDV
STTTGHLIYK	STTT-GHLI
REAAFRNI	REAA-FRNI
AEVERLKGL	AEVERLKGL
GEFGGFSEV	GEFGGFSEV
YELLMPHRI	YELLMPHRI
IENPADVSVI	IENPAVSVI
TEFRSLVI	TEFR-SLVI
REIFLSQPILL	REIFLSQPI
MEFERQAEI	MEFERQAEI
VEGHGVNPSV	VEGHGNPSV
LENSGWQKI	LENSGWQKI
GELVTEGV	GELV-TEGV
IEKEHVEEI	IEKEHVEEI
REYIGRSV	REYI-GRSV
GEGKPTPAL	GEGKPTPAL
KETLPSNNTV	KETLPNNTV
AENELGVVV	AENELGVVV
NEYHLFFLL	NEYHLFFLL
AEYIQKNV	AEYI-QKNV
MENESVKSV	MENESVKSV
SSTPEEVK	SSTP-EEVK
SEAFLPQSI	SEAFLPQSI
AEVVHQLQEI	AEVVHLQEI
AEKKEMKTI	AEKKEMKTI
KELDSKTI	KELD-SKTI
GETIHIPTM	GETIHIPTM
QVHPDTGISSK	HPDTGISSK
IEPELNNLI	IEPELNNLI
GEDKGIKAL	GEDKGIKAL
GEYDVTMPKV	GEYDVMPKV
YEERVLPSI	YEERVLPSI
AEIQHAEEFLI	AEIQHEEFL
AEVTELHVI	AEVTELHVI
SEILKNLSQV	SEILKLSQV
AESTGTVRV	AESTGTVRV
SEIYLPEVV	SEIYLPEVV
AEINKSDHV	AEINKSDHV
GEPVSVVTV	GEPVSVVTV
AESLPPPTL	AESLPPPTL
SEFIDSQRV	SEFIDSQRV
QEFAGRLNSV	QEFAGLNSV
GEIGTKTTL	GEIGTKTTL
KEIFLRELI	KEIFLRELI
AEIKNSLKI	AEIKNSLKI
GELEYATKI	GELEYATKI
SEFATTNQI	SEFATTNQI
SEMGVMPEI	SEMGVMPEI
SEYNVTNNSV	SEYNVNNSV
AEEPAASGRII	AEEPASGRI
GEASFPVMV	GEASFPVMV
LEEYEQRVV	LEEYEQRVV
GELPITVSV	GELPITVSV
GEWEPPVI	GEWE-PPVI
KEFGFSGLNV	KEFGFGLNV
VEALNGKEV	VEALNGKEV
AESHVSGI	AESH-VSGI
ETLILLDRL	ETLILLDRL
TEAQYKFIYV	TEAQYFIYV
MEDKNGRFV	MEDKNGRFV
KEVVEAVTI	KEVVEAVTI
SEEDRVVVI	SEEDRVVVI
VEVGRVAYV	VEVGRVAYV
SEVLHQVFI	SEVLHQVFI
YENDYPSVI	YENDYPSVI
GEIPVVAI	GEIP-VVAI
VEYVKSFNI	VEYVKSFNI
REKELAKVTI	REKELKVTI
SELVSNGVQI	SELVSGVQI
AENIFKSV	AENI-FKSV
AEHENMKAVL	AEHENMKAV
TEYPVKIV	TEYP-VKIV
KEYEGEAILW	KEYE-GEAI
LEFPQFETL	LEFPQFETL
IEIEKGEAV	IEIEKGEAV
DVGSLDEK	DVGS-LDEK
IEQYYSTQI	IEQYYSTQI
GEILRVIEI	GEILRVIEI
RENVIMSQI	RENVIMSQI
SEYFRDLFI	SEYFRDLFI
LEQLHAVEI	LEQLHAVEI
GELQHASAV	GELQHASAV
AEHRMLVV	AEHR-MLVV
RETADVIAKV	RETADIAKV
VEIAKQSVTI	VEIAKSVTI
YEAYLPETF	YEAYLPETF
REQSHKVYV	REQSHKVYV
RESQEQSLV	RESQEQSLV
SLAQAEAEK	SLAQAEAEK
REEINFVEI	REEINFVEI
AEFVSTPEL	AEFVSTPEL
VESAPMQVV	VESAPMQVV
GEHGLIIRV	GEHGLIIRV
GEVFKTYNV	GEVFKTYNV
VELPEQPAV	VELPEQPAV
QENNMMVLV	QENNMMVLV
TELMNILNKV	TELMNLNKV
GEYNNRHPNI	GEYNNHPNI
SEDATIKV	SEDA-TIKV
KELEYIVSV	KELEYIVSV
AEADSKLKQV	AEADSLKQV
YEVRLTQTV	YEVRLTQTV
VEDDARGTVV	VEDDAGTVV
VEYEIDKTLGI	YEIDKTLGI
RETSHVTMVV	RETSHVTMV
SYTSGPGSR	SYTSGPGSR
AEEIRYTHI	AEEIRYTHI
TEDDKQLLL	TEDDKQLLL
SEADPAPLL	SEADPAPLL
REVALLRRL	REVALLRRL
SEIIGSMGI	SEIIGSMGI
QEIPFRLREI	QEIPFLREI
GEAEPRTVV	GEAEPRTVV
SEFNFDLHTV	SEFNFLHTV
KEFVFDTI	KEFV-FDTI
REYATKTRI	REYATKTRI
YELPDGQVI	YELPDGQVI
AEFHQIEGV	AEFHQIEGV
VENKTAQI	VENK-TAQI
TELTQNALI	TELTQNALI
FEVIFPERI	FEVIFPERI
VEHFQIRNV	VEHFQIRNV
WEEDRDTVV	WEEDRDTVV
LETNAPESI	LETNAPESI
LEINPDHSII	LEINPDHSI
AEIRQQIPV	AEIRQQIPV
RERIIPRSV	RERIIPRSV
GEDPDKRISI	GEDPDRISI
LEHSGIGRI	LEHSGIGRI
IEREDIEFI	IEREDIEFI
KELGILSKI	KELGILSKI
KEMPSVFQNV	KEMPSFQNV
KDGSELILHFV	SELI-LHFV
AEHPAGHLV	AEHPAGHLV
AEYLYFFRV	AEYLYFFRV
RESIKLVSI	RESIKLVSI
KEILPAAEI	KEILPAAEI
AEAKARAEI	AEAKARAEI
SEGKLEQTV	SEGKLEQTV
KEVDNLYNI	KEVDNLYNI
LEHGITLVI	LEHGITLVI
LEINGRNNLI	LEINGNNLI
IGGIGTVPVGR	GGIG-TVPV
FEYKGKKV	FEYK-GKKV
KEILGTAQSV	KEILGAQSV
AEAPSQVRL	AEAPSQVRL
AEVSQWTRL	AEVSQWTRL
TEMQQILTRV	TEMQQLTRV
YEAAKLLNV	YEAAKLLNV
LEYEPRSGEQV	YEPRSGEQV
REKDWVSKI	REKDWVSKI
GEAPVPASV	GEAPVPASV
REVERALQL	REVERALQL
REKPPSSGV	REKPPSSGV
MELEKPVLI	MELEKPVLI
AEMRPFIEI	AEMRPFIEI
GERIRLEKV	GERIRLEKV
YEGKVSSV	YEGK-VSSV
RETSHVTMV	RETSHVTMV
REAEDMVQKV	REAEDVQKV
LEGNPLRTI	LEGNPLRTI
LEIEEKINKI	LEIEEINKI
AETILKNNI	AETILKNNI
AEDPSKSYV	AEDPSKSYV
AEFVGGVLV	AEFVGGVLV
AEFKRAVKV	AEFKRAVKV
VISELNGK	VISE-LNGK
SEQEHFLIV	SEQEHFLIV
TEVEKIKTTV	TEVEKKTTV
AEFERQRKI	AEFERQRKI
GEAAFPVMV	GEAAFPVMV
QEQPAATKI	QEQPAATKI
GEALPFSHL	GEALPFSHL
LEVTNTIRV	LEVTNTIRV
QENDFSKRI	QENDFSKRI
AEYKGRVTL	AEYKGRVTL
AEYPDGRII	AEYPDGRII
RERWNFDFV	RERWNFDFV
AEIDSIHQLV	AEIDSIHQL
AEVKNQEVTI	AEVKNEVTI
LEQHQVLEV	LEQHQVLEV
KEFNFPEEAVL	KEFNFEEAV
YEETRGVLKV	YEETRVLKV
AEHRPPKI	AEHR-PPKI
QEHGDYSNI	QEHGDYSNI
YEEIVKEV	YEEI-VKEV
AENDFLHSL	AENDFLHSL
AETEPIVKM	AETEPIVKM
REFVEREVI	REFVEREVI
GEVRTHIRV	GEVRTHIRV
KEFKGFGTEV	KEFKGGTEV
GEMKGSAI	GEMK-GSAI
REINGMTGL	REINGMTGL
AEIEHFIHII	AEIEHFIHI
TEFDRLNEI	TEFDRLNEI
AEFEEPRVI	AEFEEPRVI
NEIPTKNI	NEIP-TKNI
LEYPTISL	LEYP-TISL
SEIESKAPTV	SEIESAPTV
GEFQSFPKVF	GEFQSFPKV
AESRQPSENSV	AESRQENSV
VEHPGHPEV	VEHPGHPEV
AEIEETYANFI	IEETYANFI
YEAGKMLAI	YEAGKMLAI
AEIAVNAV	AEIA-VNAV
AEIPGVRSV	AEIPGVRSV
SERPKEIKV	SERPKEIKV
PAPPKPEPK	PAPPKPEPK
VENPSARITI	VENPSRITI
REDITEPAI	REDITEPAI
FEVTGQETV	FEVTGQETV
REAELQMLL	REAELQMLL
SENQESFRTI	SENQEFRTI
YEASLPHQI	YEASLPHQI
GEFHKMREV	GEFHKMREV
LEDVKTAVL	LEDVKTAVL
LEDLGVSRI	LEDLGVSRI
KEYAVNEVV	KEYAVNEVV
NARLAADD	NARL-AADD
GELVKAIVV	GELVKAIVV
GEYSDPVTL	GEYSDPVTL
VEFGNFNNL	VEFGNFNNL
KENGFSEKI	KENGFSEKI
TEDPRVFKV	TEDPRVFKV
GELDLPILKV	GELDLILKV
IETFYNTSI	IETFYNTSI
IEKTGKIKI	IEKTGKIKI
REAEFTKSI	REAEFTKSI
SEYLHINI	SEYL-HINI
SELITHQRI	SELITHQRI
GELPQGFARL	GELPQFARL
KEAELRSGI	KEAELRSGI
QEQIGWRNV	QEQIGWRNV
REDAVSKEV	REDAVSKEV
SEMDRVPFV	SEMDRVPFV
GEFFPVPESI	GEFFPPESI
LVQAFQFTDK	VQAFQFTDK
AEISKYLTL	AEISKYLTL
RETLLGKVV	RETLLGKVV
TEDSGLQTQVI	TEDSGQTQV
REDDPVRML	REDDPVRML
KEFLMENRV	KEFLMENRV
SENLPERSV	SENLPERSV
AENVGKPTI	AENVGKPTI
LEIEPGKRI	LEIEPGKRI
VETLTETKI	VETLTETKI
LELPGQPSV	LELPGQPSV
LEFYLRKI	LEFY-LRKI
DLYDAGVK	DLYD-AGVK
SEFEGHKRI	SEFEGHKRI
KEMEVKPSSV	KEMEVPSSV
EELDKWAKI	EELDKWAKI
AEHIKSLLI	AEHIKSLLI
LEFDSIIQKV	LEFDSIQKV
GEIKEPLEI	GEIKEPLEI
AEAYLGKTV	AEAYLGKTV
AEVERVKDV	AEVERVKDV
AEDKVFNEI	AEDKVFNEI
AEEAGKTMV	AEEAGKTMV
EEFTIFNRV	EEFTIFNRV
AEVAGSKVV	AEVAGSKVV
YEEQRTVDP	YEEQRTVDP
YEEDGARSI	YEEDGARSI
FEFDTKTSA	FEFDTKTSA
YEFQASQLL	YEFQASQLL
WESEPHPYVF	WESEPHPYV
RELPAGINSI	RELPAINSI
MEIKITTV	MEIK-ITTV
KEYFEFSEF	KEYFEFSEF
SEKDIFDYI	SEKDIFDYI
DSHGVAQVR	DSHGVAQVR
HEAIVKNV	HEAI-VKNV
AEVEQNGGLFI	AEVEQNGGL
REVSVELAKV	REVSVLAKV
GEREIWNQI	GEREIWNQI
AEQNTQITSI	AEQNTITSI
TESSPVSAV	TESSPVSAV
APSIHGGSGGR	SIHGGSGGR
QEAYVRVV	QEAY-VRVV
RESERQLRL	RESERQLRL
AEGTITGVI	AEGTITGVI
RETEATNAI	RETEATNAI
IAGQVAAANK	AGQVAAANK
SESNAPLLI	SESNAPLLI
REIALLREL	REIALLREL
MEADARSIYV	MEAD-ARSI
FEREFYSEI	FEREFYSEI
YEEQGKPEV	YEEQGKPEV
KESVPARTV	KESVPARTV
GEFKKYLEV	GEFKKYLEV
REIGVRNI	REIG-VRNI
VVSSIEQK	VVSS-IEQK
AEAESAQTRV	AEAESQTRV
KEFEFSQL	KEFE-FSQL
EELEYFNHI	EELEYFNHI
QEFTELLKV	QEFTELLKV
GEVSGLMRKV	GEVSGMRKV
TEGIPVLIV	TEGIPVLIV
AEISQPPAL	AEISQPPAL
YEDGWLIKM	YEDGWLIKM
GEFREIGTVI	GEFREIGTV
YERLFGTTV	YERLFGTTV
HEISNLKNLV	HEISNKNLV
KEAEFQRHV	KEAEFQRHV
AEKDFTVNTV	AEKDFVNTV
AEVDRLLEI	AEVDRLLEI
SEVSQLNHI	SEVSQLNHI
SEIGGLSEQI	SEIGGSEQI
SEEGYLAKV	SEEGYLAKV
ISSPTETER	ISSPTETER
SEDKEMVTTV	SEDKEVTTV
NVKVDPEIQ	NVKVDPEIQ
GEHTLLVTV	GEHTLLVTV
REVLELDSI	REVLELDSI
TEADGKSYV	TEADGKSYV
TEWLKGQQI	TEWLKGQQI
FEGTSTKTV	FEGTSTKTV
AEWLGVLKA	AEWLGVLKA
AEKAFTRSI	AEKAFTRSI
SEVKPPRDI	SEVKPPRDI
VEFRDFLKI	VEFRDFLKI
IVTDRETGSSK	TDRETGSSK
TEDHVMHLL	TEDHVMHLL
LEQQKPTVI	LEQQKPTVI
TGAAPIIDVVR	GAAPIIDVV
QEATAGFTI	QEATAGFTI
TEIPPGAVI	TEIPPGAVI
GEITTGPRV	GEITTGPRV
HELNVPFFKV	HELNVFFKV
LEDPHVDII	LEDPHVDII
GETVKIVRI	GETVKIVRI
VEDLNIIQV	VEDLNIIQV
KELQAEATV	KELQAEATV
TNQELQEINR	QELQ-EINR
IEEQKIVVKV	IEEQKVVKV
SEMERVRLV	SEMERVRLV
FENMGAYTV	FENMGAYTV
AENPFLTHLI	AENPFTHLI
LEKPFAVLV	LEKPFAVLV
KEIEHNLSKI	KEIEHLSKI
IEVEKPFAI	IEVEKPFAI
GEPEPTPVV	GEPEPTPVV
RERADAPSV	RERADAPSV
VESIISPKV	VESIISPKV
AEFQTDSQGKI	AEFQTSQGK
REFAIQSQI	REFAIQSQI
KEIVGVVNV	KEIVGVVNV
GEFGEIEAI	GEFGEIEAI
SEDGSLLAV	SEDGSLLAV
SEDAAFNKI	SEDAAFNKI
AEKTPYVVV	AEKTPYVVV
YETPQGLRI	YETPQGLRI
AEALPKQSV	AEALPKQSV
REFERFQEM	REFERFQEM
GELALKKKI	GELALKKKI
SEHPFVNGV	SEHPFVNGV
AELHNHGIQI	AELHNGIQI
REGDLLFTV	REGDLLFTV
YEAPGVREA	YEAPGVREA
TIAPALVSK	TIAPALVSK
IEFQEPVPASI	QEPV-PASI
TEYPEKEVTLI	TEYPEEVTL
TEHAHQVVV	TEHAHQVVV
KEAEEVFERI	KEAEEFERI
GEGEPVKEV	GEGEPVKEV
AEIPEHFGAV	AEIPEFGAV
FENKPMILL	FENKPMILL
KELIKPPTI	KELIKPPTI
MEYDQPLYV	MEYDQPLYV
SELPRIPKI	SELPRIPKI
AETVTKGGI	AETVTKGGI
KEFAPVYPIMV	KEFAPVYPI
KEVYLFERI	KEVYLFERI
REATQILSV	REATQILSV
FEDQMVYTV	FEDQMVYTV
LEHQLQNII	LEHQLQNII
LENNRPLLT	LENNRPLLT
LEALVMPTL	LEALVMPTL
QEMINFHTI	QEMINFHTI
GEVDFKEFI	GEVDFKEFI
TEIRGPVTI	TEIRGPVTI
LEVPATEEI	LEVPATEEI
KEMEAFLVSV	KEMEALVSV
KEIERFQEI	KEIERFQEI
REYELRKNNF	REYELKNNF
LETMFGVKV	LETMFGVKV
TEYENFKVQ	TEYENFKVQ
AEYQDLTFL	AEYQDLTFL
AELAGEGISV	AELAGGISV
AELAEHREV	AELAEHREV
QEHPSIRTL	QEHPSIRTL
GEFADPFKL	GEFADPFKL
AEFGPDSGGRV	AEFGPGGRV
VEYQMKSVL	VEYQMKSVL
LEYEDHKTA	LEYEDHKTA
AEVPFSPGLF	AEVPFSPGL
AEIETDKATI	AEIETKATI
YEYYVQGQI	YEYYVQGQI
MERNADKLTV	MERNAKLTV
AEAVGASRV	AEAVGASRV
KIEISQHAK	KIEISQHAK
AELEGKLRV	AELEGKLRV
KELFFEDSI	KELFFEDSI
AEVKDTTRV	AEVKDTTRV
HEIPSLQSIY	HEIPSLQSI
QEAERARFV	QEAERARFV
QEGHSVPEI	QEGHSVPEI
IEMELRQMEV	IEMELQMEV
RESPPTRDV	RESPPTRDV
SEFVFNNPNI	SEFVFNPNI
QEHITTVVV	QEHITTVVV
KEMDSNTVI	KEMDSNTVI
VELNKIPTV	VELNKIPTV
FEAQFQKNV	FEAQFQKNV
IEYGDMQLI	IEYGDMQLI
IEAGLPQKV	IEAGLPQKV
HEVMEQQTI	HEVMEQQTI
ELAAPGQAKI	LAAPGQAKI
GEIKGFTGI	GEIKGFTGI
LEERFRVAI	LEERFRVAI
KEYEQEFDFI	KEYEQFDFI
SEIVMEHSI	SEIVMEHSI
GEFTSARAV	GEFTSARAV
FEVILTRI	FEVI-LTRI
KEMTEVPRV	KEMTEVPRV
SEFHKHYARI	SEFHKYARI
EEAKKFGTI	EEAKKFGTI
RELKLSKV	RELK-LSKV
KEFQLFQGV	KEFQLFQGV
LEASERQSL	LEASERQSL
AEETSSPVI	AEETSSPVI
KEVDLIPKV	KEVDLIPKV
TEGKGLIV	TEGK-GLIV
HENDAIHKI	HENDAIHKI
SEHSKVRLV	SEHSKVRLV
AEDAPWKKI	AEDAPWKKI
TEKPSLMQV	TEKPSLMQV
GEENGAHTI	GEENGAHTI
QEFDIYREV	QEFDIYREV
VEILNGEKV	VEILNGEKV
SELRSVLV	SELR-SVLV
PEARFLNVI	PEARFLNVI
QEYEEFKEL	QEYEEFKEL
RERDFLKKV	RERDFLKKV
KEVISVVKV	KEVISVVKV
LEKPSRTV	LEKP-SRTV
RELAQQIQKV	RELAQIQKV
GEDHQITEV	GEDHQITEV
REFDDPGQQV	REFDDGQQV
EEHGNFLITV	EEHGNLITV
QEMADSLGVRI	QEMADSLGV
AEVSPMYGV	AEVSPMYGV
LEEDQAGFRI	LEEDQGFRI
AEYAHPLET	AEYAHPLET
YEEDAIVRMI	YEEDAVRMI
FEASDPRII	FEASDPRII
LEADRMAAL	LEADRMAAL
AEAAAAVV	AEAA-AAVV
KEVTPEGLQMV	KEVTPGLQM
AELEGREQV	AELEGREQV
LEEFITPIV	LEEFITPIV
HEKISSPKV	HEKISSPKV
KELKLLQTI	KELKLLQTI
HENEALWREV	HENEAWREV
AEDKPRAQL	AEDKPRAQL
QEFSFFDKV	QEFSFFDKV
AEKELVTII	AEKELVTII
LELGSGVTV	LELGSGVTV
ISPTGHSL	ISPT-GHSL
GEITLRGLV	GEITLRGLV
YEAAVKKV	YEAA-VKKV
AERVGLHKV	AERVGLHKV
SERDLQELSI	SERDLELSI
AEPKLAFVI	AEPKLAFVI
GEAPALVAV	GEAPALVAV
HEGKPLKL	HEGK-PLKL
VEALTTLEV	VEALTTLEV
AEVRVINLI	AEVRVINLI
LETTVQKV	LETT-VQKV
MEAPAAGLF	MEAPAAGLF
LEIAQNNVEV	LEIAQNVEV
AEDGTTSKYFV	AEDGTTSKY
GELGKLDLI	GELGKLDLI
YEELQSLAGK	EELQSLAGK
KEHPDAWTRV	KEHPDWTRV
LEYGKAELEI	LEYGKELEI
SEASDFNKV	SEASDFNKV
AEIERETSV	AEIERETSV
HESGASIKI	HESGASIKI
AEKIPGEST	AEKIPGEST
AEHPIVIV	AEHP-IVIV
KEYLVSLI	KEYL-VSLI
PEHDFSKISI	PEHDFKISI
IEQVPQQPTYV	IEQVPPTYV
GEYSKVLAI	GEYSKVLAI
