Data	Data aligned
AEINNIIKI	AEINNIIKI
KEEQMDGTVTL	EEQMGTVTL
KEEPSNNVKL	KEEPNNVKL
AEEALKYLL	AEEALKYLL
KESGQVVAI	KESGQVVAI
AEAKEKIYL	AEAKEKIYL
AEKWEVAEVVL	WEVA-EVVL
SEVKDEIRTSL	SEVKIRTSL
SELRSVEGL	SELRSVEGL
KELHEKFDRL	KELHKFDRL
SELEGDTITL	SELEDTITL
AEFVSTPEL	AEFVSTPEL
VEQPEDYTL	VEQPEDYTL
KEHEVTIFV	KEHEVTIFV
AEMAQNAVRL	AEMANAVRL
GEPAGTDPGL	GEPATDPGL
REKDDANFKL	REKDANFKL
AEGPYKIIL	AEGPYKIIL
SETTERTVL	SETTERTVL
SELRETPSSL	SELRTPSSL
VEIEERGVKL	VEIERGVKL
YEEEQFTVL	YEEEQFTVL
SEISQVFEI	SEISQVFEI
REESGARINI	REESARINI
KEPDVSEEL	KEPDVSEEL
AEGPPAASL	AEGPPAASL
GEVPFNHEIL	GEVPNHEIL
FEVEKELFAL	FEVEELFAL
FEIPIKVRL	FEIPIKVRL
REDYIEPAL	REDYIEPAL
SEGVVAVLL	SEGVVAVLL
HEVSGETVVF	HEVSETVVF
AEIQETITAL	AEIQTITAL
KEKPEEESL	KEKPEEESL
KEMLPHVGV	KEMLPHVGV
READAALFSEL	READLFSEL
REKDLEVYL	REKDLEVYL
KEAEGKEPEL	KEAEKEPEL
KETSPLTAEKL	KETSTAEKL
REELLPHLL	REELLPHLL
GEAGPIHHL	GEAGPIHHL
AEDVPVRIAL	AEDVVRIAL
KETAVFINI	KETAVFINI
LEHDPQYAVIL	LEHDQYAVI
EEVNIAGDSL	EEVNAGDSL
KEIEAEKVEL	KEIEEKVEL
AEELLRIGL	AEELLRIGL
REEPEKIIL	REEPEKIIL
KEVEAVVYL	KEVEAVVYL
TEILERKTVL	TEILRKTVL
SEDPSGKKAVL	SEDPKKAVL
GETPQVAVI	GETPQVAVI
REDETDVKAVL	DETDVKAVL
PSEDDGTVLL	SEDDGTVLL
KEYVGIVRL	KEYVGIVRL
GEVQDLLVRL	GEVQLLVRL
YELLIKGLGL	YELLKGLGL
SEFHEKLLNTL	SEFHLLNTL
QEVVDFEKL	QEVVDFEKL
HEDKIRVVL	HEDKIRVVL
TEAVVKEKL	TEAVVKEKL
ELQSTGRLL	ELQSTGRLL
GEGHTQDTEL	GEGHQDTEL
AEMLHNVTL	AEMLHNVTL
AEEGVMTPEL	AEEGMTPEL
FEDESEGLL	FEDESEGLL
KENDFDRLVL	KENDDRLVL
AEQNGKGVAL	AEQNKGVAL
HEEQPRPFVL	HEEQRPFVL
LEFSPKNTVL	LEFSKNTVL
REAELRKQRL	REAERKQRL
GEVKGTSGSL	GEVKTSGSL
LESQVRELL	LESQVRELL
VDVEQHTL	VDVE-QHTL
SESNHLIHL	SESNHLIHL
HEAEVHAESL	HEAEHAESL
LENDGATAL	LENDGATAL
QEIIIRDGSL	QEIIRDGSL
IEMNEPVQL	IEMNEPVQL
SEMEDKTTANL	MEDKTTANL
VEDDIQQLL	VEDDIQQLL
RETDLQELF	RETDLQELF
YEVQSEAKL	YEVQSEAKL
KELEEKVMEL	KELEKVMEL
KETTIDGEEL	KETTDGEEL
YENMVTEIM	YENMVTEIM
SEENKATPL	SEENKATPL
DEVHLLNDTL	DEVHLNDTL
QESNVRLKL	QESNVRLKL
WEIDPKDLTFL	WEIDKDLTF
REYTLMELL	REYTLMELL
EEVNLNGSGKL	EEVNGSGKL
AEFREPLILL	AEFRPLILL
LEAEIKEAQL	LEAEKEAQL
HEIGHIFGL	HEIGHIFGL
SESPVWVKL	SESPVWVKL
KEAPEEAQL	KEAPEEAQL
GEGHFGKVSL	GEGHGKVSL
LENKDNIRL	LENKDNIRL
EGEAVPVAI	EGEAVPVAI
KETGGVEKL	KETGGVEKL
LEALVNEGSL	LEALNEGSL
SEDKGALAKL	SEDKALAKL
WEYDESHVI	WEYDESHVI
GESILPTTL	GESILPTTL
AEVKERVTL	AEVKERVTL
GEPEVQYVAL	GEPEQYVAL
VEALPYNTSL	VEALYNTSL
KELLGQGLLL	KELLQGLLL
NESVVKEML	NESVVKEML
QETADVKASVL	QETAVKASV
GEEPGQSGASL	EEPGSGASL
LEAPPEVSL	LEAPPEVSL
EEVYLVHDEL	EEVYVHDEL
RELLPGSVML	RELLGSVML
AEGIVNGHTL	AEGINGHTL
IENRDVAKTVL	IENRAKTVL
VESSLDKVVL	VESSDKVVL
REITFENGEEL	REITNGEEL
YEERVQAVV	YEERVQAVV
LEDFDIHEL	LEDFDIHEL
SELEEEKQQL	SELEEKQQL
IEYAKPTRL	IEYAKPTRL
REGLLFTAL	REGLLFTAL
AEEPHALEL	AEEPHALEL
AEFFLQEERL	AEFFQEERL
GEPEKLGQAL	GEPELGQAL
AEAEAAVGL	AEAEAAVGL
SETEGTPKL	SETEGTPKL
KEVKEVATL	KEVKEVATL
AEINKSLLAL	AEINSLLAL
REAVPEPVL	REAVPEPVL
IEIHEQEAIL	IEIHQEAIL
AETRAGLTL	AETRAGLTL
GELQGERGEL	GELQERGEL
TEIDDLKTQL	TEIDLKTQL
AEYGEIKNIHL	GEIK-NIHL
GEDSGARALL	GEDSARALL
GEVSARQEL	GEVSARQEL
TEYPVEKL	TEYP-VEKL
FEEISRSGEL	EEISRSGEL
AEAPGEAFL	AEAPGEAFL
QENVDYVIL	QENVDYVIL
AEATLGSGNL	AEATGSGNL
AEAATGFLEQL	AEAAFLEQL
GETGIGKSTL	GETGGKSTL
GEALGFVSL	GEALGFVSL
KEKEPEEEL	KEKEPEEEL
GEVLEQEKGAL	GEVLEKGAL
AELKGLDVDSL	AELKDVDSL
YEDFHIVKL	YEDFHIVKL
AEILHEIAVL	AEILEIAVL
AELDSHTPAL	AELDHTPAL
AETPGHTPSL	AETPHTPSL
FEQANIKTQL	FEQAIKTQL
GESDDSILRL	GESDSILRL
KETEVGNVSL	KETEGNVSL
LEDKYNLQL	LEDKYNLQL
HEFDPSADML	HEFDSADML
AEHLRKYNEAL	AEHLYNEAL
REYEDGPLSL	REYEGPLSL
LEENSTPQL	LEENSTPQL
YEDIKNVVL	YEDIKNVVL
QENAEIIKL	QENAEIIKL
AEFPLEPML	AEFPLEPML
REYEAELETQL	YEAELETQL
QEFPAHSL	QEFP-AHSL
LETSTGHSL	LETSTGHSL
SEAPEAPLL	SEAPEAPLL
KEVTAAREAL	KEVTAREAL
KEIAFPKAEEL	KEIAKAEEL
SEDDVKMAL	SEDDVKMAL
LENASDIKL	LENASDIKL
AESEDGKLTL	AESEGKLTL
GEDDKMPPL	GEDDKMPPL
LEIADPIVL	LEIADPIVL
GEFEKKYVATL	FEKKYVATL
WEEAAHDLAL	EEAAHDLAL
AEGLLQEAL	AEGLLQEAL
AEVEKQTSL	AEVEKQTSL
REAVSKEDL	REAVSKEDL
KEFQDLREVM	KEFQLREVM
VEDDARGTVVL	VEDDRGTVV
YELYEKLEL	YELYEKLEL
GESLVREPL	GESLVREPL
AEVSQNIEKL	AEVSNIEKL
AEPLEIILHL	AEPLIILHL
TEETTHVVM	TEETTHVVM
HEEIDLVSL	HEEIDLVSL
GEENQVLEL	GEENQVLEL
SEPSQHVVL	SEPSQHVVL
YEAAGEIVRL	YEAAEIVRL
AEITKEQRL	AEITKEQRL
SELEHENAQL	SELEENAQL
GEWEESEVKL	GEWESEVKL
GELSLPVHL	GELSLPVHL
REEWKFDTL	REEWKFDTL
VENEDKKGVQL	NEDKKGVQL
KEMGGHHIVAL	KEMGHIVAL
AENEKIQNEQL	NEKIQNEQL
RELREREALL	RELREREAL
REIDERNRPL	REIDRNRPL
GEFTLHGRAIL	GEFTHGRAI
AEEQKTSGIM	AEEQKTSGI
KEKEPDYVLL	KEKEDYVLL
GELANEVKVLL	GELAEVKVL
GEKSGIEIL	GEKSGIEIL
KEIISSEML	KEIISSEML
SEAERVSEL	SEAERVSEL
HEVEEATNIL	HEVEATNIL
SIPEKNRPL	SIPEKNRPL
SIPGGYNAL	SIPGGYNAL
SEVSTVLKL	SEVSTVLKL
GEAKTDPAGL	GEAKDPAGL
AEPEADKGTVL	PEADKGTVL
SELDLPLGTQL	SELDLGTQL
AESLPPPTL	AESLPPPTL
REAVPEPVLL	REAVEPVLL
KEFETAETLL	KEFETAETL
LEYLTAEVL	LEYLTAEVL
REDSLDSVLFL	REDSLDSVL
AESHIILVL	AESHIILVL
AELEIQKDAL	AELEQKDAL
KEYDEPYVLL	KEYDPYVLL
LEIVPNGITL	LEIVNGITL
AEHERELAL	AEHERELAL
GELFSSPHL	GELFSSPHL
SEDAAAGTVL	SEDAAGTVL
QEAKPSTEDL	QEAKSTEDL
QEENITRAL	QEENITRAL
KEAEILEVL	KEAEILEVL
TEAFDIATL	TEAFDIATL
QELPSHGVPL	QELPHGVPL
IEQEQKLAL	IEQEQKLAL
REEVGNISIL	REEVNISIL
FEVETPAVL	FEVETPAVL
QELNSENERL	QELNENERL
AESISLLEL	AESISLLEL
HEGPTNQL	HEGP-TNQL
GEEAVPVAL	GEEAVPVAL
GEVTNDFVML	GEVTDFVML
SEVEKGEAL	SEVEKGEAL
SEVVEASSL	SEVVEASSL
AETEVEQAL	AETEVEQAL
QEMPGDVPL	QEMPGDVPL
GEANEEFAL	GEANEEFAL
AEILEVLHSL	AEILVLHSL
FEQQMVEKL	FEQQMVEKL
QEIDLTGVKL	QEIDTGVKL
SEPHILETL	SEPHILETL
TEIAPTGIESL	TEIAGIESL
REGDVITII	REGDVITII
LESPTVSTL	LESPTVSTL
GETNDFELL	GETNDFELL
KEVYAAAAEVL	KEVYAAEVL
EISTPVTIS	EISTPVTIS
HELLQPFNVL	HELLPFNVL
EEFEHKEEVL	EEFEKEEVL
AELAGTEEQL	AELATEEQL
HEQKEQISL	HEQKEQISL
GGLPERSVSL	GGLPRSVSL
GEVYSADREDL	GEVYDREDL
GEEYKLQNETL	EEYKQNETL
AEPTIVAQL	AEPTIVAQL
AESPSFLSL	AESPSFLSL
KEDSGKIKL	KEDSGKIKL
AEHADTVQL	AEHADTVQL
KEDSAVFYEL	KEDSVFYEL
TEFQGHKVIL	TEFQHKVIL
KEEGAGLGFSL	EEGALGFSL
AEIQAELERL	AEIQELERL
REFREEESL	REFREEESL
REEEQAFLVSL	EEEQFLVSL
SEARLRDVL	SEARLRDVL
IEFKETQAL	IEFKETQAL
AETRVGSAL	AETRVGSAL
SELDVPVEIL	SELDPVEIL
SEFQKAVKL	SEFQKAVKL
AEAGADLVL	AEAGADLVL
TEKEDFIEL	TEKEDFIEL
QEVQERLNFL	QEVQRLNFL
GEVELVEPGL	GEVEVEPGL
SEEMIKSEL	SEEMIKSEL
GELEYATKI	GELEYATKI
YEDIAVKL	YEDI-AVKL
YELGGPMTL	YELGGPMTL
AEHLEKSSL	AEHLEKSSL
GEDHPEMAL	GEDHPEMAL
YEEILNTKL	YEEILNTKL
REHAEKLMKL	REHAKLMKL
TEEDVKFYL	TEEDVKFYL
DTRGLKAEL	DTRGLKAEL
VEHFMPILM	VEHFMPILM
TESQVVITL	TESQVVITL
GEEGSFRGSVL	EEGSRGSVL
REKLAEKKELL	REKLEKKEL
SEAGSRIVL	SEAGSRIVL
LEYGVPVTL	LEYGVPVTL
TETQEKNPL	TETQEKNPL
REVLPSTRL	REVLPSTRL
KEFEQLAPVL	KEFELAPVL
HEAVKAIVL	HEAVKAIVL
EIISEISKL	EIISEISKL
KEIEGEEIEI	KEIEEEIEI
TEIDPINAL	TEIDPINAL
GETQKTISL	GETQKTISL
RETIIMNQI	RETIIMNQI
MEAPGDVEAL	MEAPDVEAL
AEKIQTIIL	AEKIQTIIL
AELTGDHQL	AELTGDHQL
AEVANEIENL	AEVAEIENL
MEDETQKEL	MEDETQKEL
GEVIRTLPSL	GEVITLPSL
SELEKTFNL	SELEKTFNL
REGSASTEVL	REGSSTEVL
REENPEFTSL	REENEFTSL
REVDLKNGHNL	REVDNGHNL
VERINQAL	VERI-NQAL
LEIQDKEYL	LEIQDKEYL
KEVQDGIEL	KEVQDGIEL
QEIKDIYGL	QEIKDIYGL
TEMEQDYQL	TEMEQDYQL
VEFPLDPAL	VEFPLDPAL
HEPEKSFSL	HEPEKSFSL
HEEDHTLGNSL	EEDHLGNSL
AELPGSSAVRL	AELPSAVRL
TEEEVSERVTL	EEVSERVTL
GEPHSSPEL	GEPHSSPEL
KEFIDNEMI	KEFIDNEMI
AELELLGLEKL	LELLGLEKL
AEISQPPAL	AEISQPPAL
LETDSVQRL	LETDSVQRL
KEEVSRQEL	KEEVSRQEL
AEVHSEEAL	AEVHSEEAL
SEVSQDGKSLL	SEVSDGKSL
TEAAVPKVTL	TEAAPKVTL
AEVLNKHSL	AEVLNKHSL
HEHRGTPVGL	HEHRTPVGL
GEEKEAATL	GEEKEAATL
GEDRSPPTAL	GEDRPPTAL
SEFAKDPSL	SEFAKDPSL
TETEIVTSL	TETEIVTSL
EEQLQQIR	EEQL-QQIR
HEFFHILNL	HEFFHILNL
KEVDALLHL	KEVDALLHL
GEHHEKAVEL	GEHHKAVEL
GESGKSTFI	GESGKSTFI
LEEPYEIQL	LEEPYEIQL
SEIPPKGGAL	SEIPKGGAL
SESVASSQL	SESVASSQL
AELILHDAL	AELILHDAL
AELRSTASLL	AELRSTASL
AEAEERGELAL	AEAEERGEL
ENITKQVEI	ENITKQVEI
LERLSELAL	LERLSELAL
FELLEKEVGL	FELLKEVGL
RETDEETKQIL	RETDTKQIL
AEFAERTVAKL	AEFARTVAK
GEHYSEKL	GEHY-SEKL
TEVDMKEVEL	TEVDKEVEL
VEEPTVLVL	VEEPTVLVL
NERAIAGALI	NERAIAGAL
AEDITTGQVL	AEDITGQVL
SEEGITKSTL	SEEGTKSTL
AEVTTKSQIPL	AEVTTKSQI
AEVKDMEQLL	AEVKDMEQL
GEIHDLKDML	GEIHLKDML
FEISDIGAKI	FEISIGAKI
GEFSASPML	GEFSASPML
REAFEAEYRL	REAFAEYRL
FEMPYVVRL	FEMPYVVRL
REAQELEAQL	REAQLEAQL
FEDVGRQVL	FEDVGRQVL
SEFSLVDKL	SEFSLVDKL
AEEKAAVTSL	AEEKAVTSL
SELPIVTPAL	SELPVTPAL
AETAEAVEL	AETAEAVEL
KEFAGEDTSDL	KEFADTSDL
AEVLEQSAQTL	AEVLSAQTL
SEFLLTHPVL	SEFLTHPVL
YEETRQEVL	YEETRQEVL
TESRQVVEL	TESRQVVEL
VESGLKTIL	VESGLKTIL
KEDDLDVVL	KEDDLDVVL
KEAEKSPQL	KEAEKSPQL
KIEELRQR	KIEE-LRQR
GEIHDSKMRL	GEIHSKMRL
QEVDAIGQTL	QEVDIGQTL
AEIENENGPTL	IENENGPTL
KEWSGLLEEL	KEWSLLEEL
YEDISRGL	YEDI-SRGL
TEIPPALISL	TEIPALISL
SETAVAKNQAL	SETAKNQAL
NEANLREEVL	NEANREEVL
TEDVGSGVAL	TEDVSGVAL
AEVDPDTIL	AEVDPDTIL
REIATEKKNSL	REIAKKNSL
KELPEYYEL	KELPEYYEL
FEFGSLEQKL	FEFGLEQKL
REQIDNLATEL	REQILATEL
SEDGDTLVHL	SEDGTLVHL
QEQAAKAVL	QEQAAKAVL
AEEKLPMTL	AEEKLPMTL
IEGPIIKL	IEGP-IIKL
AEIRHVLVTL	AEIRVLVTL
GEFEKIMQL	GEFEKIMQL
KEITGETAL	KEITGETAL
RENVDQEALL	RENVDQEAL
AEVAGQFVI	AEVAGQFVI
KIENKIESIGL	IENKESIGL
TEFEDTPTSQL	FEDTPTSQL
AELSEKSGML	AELSKSGML
AEAGGLEEL	AEAGGLEEL
REDLTQVEL	REDLTQVEL
SEADPAPLL	SEADPAPLL
AEHENMKAVL	AEHEMKAVL
RESDSAKPASL	RESDKPASL
REIKSSQGL	REIKSSQGL
SEVSQVKETL	SEVSVKETL
SEPPVYANL	SEPPVYANL
TESDEKSSIAL	TESDEKSSI
AEAHARIHL	AEAHARIHL
AEFQEHEHAL	AEFQHEHAL
SESALPTSL	SESALPTSL
TETEPPVAL	TETEPPVAL
SEFKAMDSI	SEFKAMDSI
METPELIEL	METPELIEL
HEWMKSEEL	HEWMKSEEL
YEELVRMVL	YEELVRMVL
AEIRDQMQQQL	AEIRMQQQL
KEEETNSVATL	EEETSVATL
SEVNIPLSL	SEVNIPLSL
KEEDLQWVL	KEEDLQWVL
GEGTGEVVL	GEGTGEVVL
TEAEAAALEVL	AEAAALEVL
AEIPNIKPDIL	AEIPIKPDI
HEQGLSTAL	HEQGLSTAL
KESSIIGVTL	KESSIGVTL
SEEDRATVL	SEEDRATVL
RELRVEQESL	RELREQESL
SEEVVKAIL	SEEVVKAIL
TEIEDMPTL	TEIEDMPTL
GEPMNFVHL	GEPMNFVHL
SEVGKTPTL	SEVGKTPTL
VEIEQKVVAL	VEIEKVVAL
SEEPFTTVL	SEEPFTTVL
GEPFASHSL	GEPFASHSL
AEPPLTAVL	AEPPLTAVL
KEEELQAAL	KEEELQAAL
SEGPHHVAL	SEGPHHVAL
KELSMVTEL	KELSMVTEL
SEIKGEVL	SEIK-GEVL
GELKHGPLAL	GELKGPLAL
REEGAAEPAL	REEGAEPAL
VESKVKDIL	VESKVKDIL
WEEGKAALEQL	EEGKALEQL
SEGKDSVVL	SEGKDSVVL
TEAEIDAHL	TEAEIDAHL
KESEKIIAEL	KESEIIAEL
AEARINAQL	AEARINAQL
GEPNIDSPL	GEPNIDSPL
AELKNLEVL	AELKNLEVL
TENQEAKRVAL	QEAK-RVAL
REVDEQHQL	REVDEQHQL
REFLQNLDAL	REFLNLDAL
NEISIYDKL	NEISIYDKL
REENKQIAL	REENKQIAL
GEFGTIPLVL	GEFGIPLVL
GESAETRALL	GESATRALL
QEFGVGDGSKL	QEFGDGSKL
LESEITYDKL	LESETYDKL
REVSSLKNKL	REVSLKNKL
FEFPNKVVL	FEFPNKVVL
SEAEIRVFL	SEAEIRVFL
SEEGLRNAL	SEEGLRNAL
SESASPSAL	SESASPSAL
SEMRYGIEI	SEMRYGIEI
AEAMADKAEL	AEAMDKAEL
QENEPEPLSL	QENEEPLSL
REAAAVFQETL	REAAFQETL
GEPHGLENMEL	GEPHENMEL
AELEGRQEELL	AELERQEEL
QELNELSAISL	QELNELSAI
AEALEKLFL	AEALEKLFL
YEEEVKKTL	YEEEVKKTL
LEVVTPEVL	LEVVTPEVL
GEADAQNITVL	GEADQNITV
LEDAETKNVAL	AETK-NVAL
SELMDITKL	SELMDITKL
KEFSEENVL	KEFSEENVL
QETMIKTDFL	QETMKTDFL
HEIQSDVL	HEIQ-SDVL
GEIPVQEHL	GEIPVQEHL
RELQGETKL	RELQGETKL
FEEDKQRIELL	FEEDQRIEL
YEDQTKPVL	YEDQTKPVL
FETEVDKIL	FETEVDKIL
REFDQKALL	REFDQKALL
SEIEDAAFL	SEIEDAAFL
AEADGAAWVL	AEADAAWVL
REDESYGYVL	REDEYGYVL
AESLVAEGL	AESLVAEGL
SELATALAL	SELATALAL
REIMGTPEYL	REIMTPEYL
GEIQEIVKTGL	GEIQVKTGL
AELASNKEWL	AELANKEWL
SETLKGSFSL	SETLGSFSL
QEEASGVAL	QEEASGVAL
VSEASLVSSI	SEASLVSSI
REASLSILEQL	REASILEQL
REDISSIEI	REDISSIEI
MEISELNAKL	MEISLNAKL
AEVVPTEGL	AEVVPTEGL
KEETNIVKL	KEETNIVKL
YELQESNVQL	YELQSNVQL
GETLGIIGL	GETLGIIGL
KEDSHPFDL	KEDSHPFDL
HEGTDSYEL	HEGTDSYEL
KEFKGDEIL	KEFKGDEIL
TEADVKIVI	TEADVKIVI
SEMAVAHAL	SEMAVAHAL
HEWGELVQL	HEWGELVQL
AELQQQQAVL	AELQQQAVL
TEISLKDSTL	TEISKDSTL
AEADEIFQEL	AEADIFQEL
QETKVTRDAL	QETKTRDAL
RELISDLEHRL	RELILEHRL
SEWDGIVTV	SEWDGIVTV
GEAVDRSLL	GEAVDRSLL
AETHIKGFTL	AETHKGFTL
FEEDPEISL	FEEDPEISL
HEDDHNFEL	HEDDHNFEL
TEIGQTLDL	TEIGQTLDL
AETLYKEIL	AETLYKEIL
GEVLDILTRL	GEVLILTRL
SEDEVKLAL	SEDEVKLAL
QELFPAPIL	QELFPAPIL
IEVIENRMAVL	IEVIRMAVL
SETTVAPSL	SETTVAPSL
AETDPGMVHL	AETDGMVHL
KETTYYDVL	KETTYYDVL
QEVPGPAAAL	QEVPPAAAL
KELKDAGAGLL	KELKAGAGL
GEKKDEVYL	GEKKDEVYL
YEIEKEPLL	YEIEKEPLL
GEEGDLKTSL	GEEGLKTSL
HEVPEKTSI	HEVPEKTSI
SEEVHQAVL	SEEVHQAVL
AEIQHAEEFL	AEIQAEEFL
KEESAATQAL	KEESATQAL
AEIPLNEQTTL	AEIPEQTTL
GEVKDFPDL	GEVKDFPDL
HESGYDAGKAL	HESGAGKAL
MELPTEKEVAL	MELPKEVAL
REALTETTL	REALTETTL
VEERNTISL	VEERNTISL
AEINDLENL	AEINDLENL
AESIISPSL	AESIISPSL
LESVDSEAL	LESVDSEAL
FEVNIPTDL	FEVNIPTDL
SEVQGMVEL	SEVQGMVEL
KELEEIYML	KELEEIYML
REWGEELQAVL	GEEL-QAVL
AEKAYHEQL	AEKAYHEQL
AEVETRKVVL	AEVERKVVL
KEDNIGNQLL	KEDNGNQLL
RETSSDVAL	RETSSDVAL
ITPTGTHPL	ITPTGTHPL
AEVEDVASHVL	VEDVASHVL
VEASGGITL	VEASGGITL
GETEESEKL	GETEESEKL
AESHPSSNLL	AESHSSNLL
HEAAARIQL	HEAAARIQL
SEPDIAKVPL	SEPDAKVPL
TELGDELTL	TELGDELTL
RESFDGRNIL	RESFGRNIL
QELEDTKVTAL	LEDTKVTAL
AEVKEEGSQL	AEVKEGSQL
QEEQTRVAL	QEEQTRVAL
REITDKKKINL	REITDKKKI
QEPLHNEEL	QEPLHNEEL
TLRGGEHEAI	GEHE---AI
AETRESTQL	AETRESTQL
RETSMVHEL	RETSMVHEL
GEIVEKIGV	GEIVEKIGV
REMDESLANL	REMDSLANL
AEEKAAQAL	AEEKAAQAL
IEYDSPEQL	IEYDSPEQL
LENMHIEQL	LENMHIEQL
GEPVDDKSATL	GEPVKSATL
WEGAFLDRVL	WEGALDRVL
AEHGETLAM	AEHGETLAM
AEFLMKNSDL	AEFLKNSDL
SEQGLIEIL	SEQGLIEIL
REPDQTFSL	REPDQTFSL
KELDEEHSQEL	KELDHSQEL
SEILDGNQL	SEILDGNQL
LEPHDSPVL	LEPHDSPVL
GEDARNVTVL	GEDANVTVL
AELKTDVFQSL	AELKVFQSL
HESEGGRTPL	HESEGRTPL
VEHTDGQSVL	VEHTGQSVL
LEIQHTTAL	LEIQHTTAL
YEDKTALSL	YEDKTALSL
REVEGLKDLL	REVELKDLL
VETAEGVAL	VETAEGVAL
GEFQIVNPHLL	GEFQVNPHL
AELNKIFAL	AELNKIFAL
YESPGKIFL	YESPGKIFL
HEEQKSVRL	HEEQKSVRL
SEAAIRSVEL	SEAARSVEL
QEALEPAVRL	QEALPAVRL
SEFTNSNNHL	SEFTSNNHL
SEVKGLDAFVL	SEVKDAFVL
GEIKRDFIATL	GEIKFIATL
PVTDGAISTLL	VTDGISTLL
LEFLDRESI	LEFLDRESI
GEITGEVRM	GEITGEVRM
KEEGNLEAVL	KEEGLEAVL
SEMVELVEL	SEMVELVEL
KEFMPPGLQEL	KEFMGLQEL
GESRVPLTL	GESRVPLTL
AETEKQVAL	AETEKQVAL
KEINEKSSQL	KEINKSSQL
AEFNRIMSL	AEFNRIMSL
EPPVDSEP	EPPV-DSEP
AEVPAVKDML	AEVPVKDML
GEPFSEEATL	GEPFEEATL
SEEPFVVKL	SEEPFVVKL
REITKPLRPL	REITPLRPL
KEAVIKHSL	KEAVIKHSL
DDIVHSFVSL	DIVHSFVSL
SEERPPAQAL	SEERPAQAL
QEEDYRYEVL	QEEDRYEVL
VEIVKNDDGVI	VEIVNDDGV
RELESQLHVL	RELEQLHVL
SEAPFLHYL	SEAPFLHYL
AEEKHLHVL	AEEKHLHVL
FEVDLSHVYL	FEVDSHVYL
RELEEIRAKL	RELEIRAKL
VEFFDEKLNSL	VEFF-DEKL
YEDPQHHPL	YEDPQHHPL
REYQDLLNVKM	REYQDLLNV
SEVGSDHEL	SEVGSDHEL
IEYQGDPEL	IEYQGDPEL
RELDQKTWL	RELDQKTWL
GELITQREL	GELITQREL
KEVNEGIQAL	KEVNGIQAL
SEAEPGGGSL	SEAEGGGSL
LEAKVKDLL	LEAKVKDLL
HEEDRQELL	HEEDRQELL
KEKEFQEEL	KEKEFQEEL
VEMRDNPEL	VEMRDNPEL
YEHETGRESTL	HETGRESTL
AEEDFYEKL	AEEDFYEKL
KEVQEAFLTL	KEVQAFLTL
KETIEIIDL	KETIEIIDL
AEVDTRESL	AEVDTRESL
REAGIQPSLL	REAGIQPSL
KELEQKKSYL	KELEKKSYL
QEDNVANKQTL	QEDNNKQTL
SETETATSNAL	TETATSNAL
VEIGAHKDEL	VEIGHKDEL
SEFYEPEAL	SEFYEPEAL
REDENKSIL	REDENKSIL
GQDIAENLQL	QDIAENLQL
MEIIHEIAVL	MEIIEIAVL
YEKEDSDEVHL	KEDSDEVHL
GEDEGYFQEL	GEDEYFQEL
YETFISDVL	YETFISDVL
HEFSSPSHLL	HEFSPSHLL
GENEDNRIGL	GENENRIGL
AEQKIKADIL	AEQKKADIL
FEEAERTYL	FEEAERTYL
HEFEELFRL	HEFEELFRL
KEEEHAPEL	KEEEHAPEL
SDDSILRL	SDDS-ILRL
REFWAKPKP	REFWAKPKP
QELLSDTKL	QELLSDTKL
RELEDPESAML	LEDPESAML
KESAAINQIL	KESAINQIL
VEETSHQAL	VEETSHQAL
GEISEKAKL	GEISEKAKL
AEFEDLDSL	AEFEDLDSL
AEEESTLTKL	AEEETLTKL
LEFGSEPSL	LEFGSEPSL
TEISSAEKVAL	TEISEKVAL
SEPEIPEPSL	SEPEPEPSL
KEAEPDLLAVL	AEPDLLAVL
SEGPIVATL	SEGPIVATL
SEAREDMAAL	SEARDMAAL
AENEPPEKETL	NEPPEKETL
IENRDVAKSVL	IENRAKSVL
SEFDFKPQQL	SEFDKPQQL
FEFEYQTKV	FEFEYQTKV
KEETQPPVAL	KEETPPVAL
QETAVAPSL	QETAVAPSL
IENEEPVVL	IENEEPVVL
GEAPPELL	GEAP-PELL
YLPDGTASL	YLPDGTASL
FEENTQHLL	FEENTQHLL
SENKLPAEL	SENKLPAEL
SEVDINTTL	SEVDINTTL
SAPVGVTAL	SAPVGVTAL
YSKYYKTID	YSKYYKTID
VEGDPIVAL	VEGDPIVAL
HEVDTQYSAL	HEVDQYSAL
AEIRETLTQGL	AEIR--ETL
RELDIYNNL	RELDIYNNL
GEGSGVEIL	GEGSGVEIL
REDGSFSFYSL	REDGSFYSL
REASIYTGITL	REASIYTGI
AEAENKAAAL	AEAEKAAAL
REWQGRDLL	REWQGRDLL
SEHLAAIEI	SEHLAAIEI
GEVEGHPVWAL	VEGHPVWAL
GEVFPTTEVLL	GEVFTTEVL
YEMEVSQRL	YEMEVSQRL
AEDDIRGIQL	AEDDRGIQL
KEDENVPFL	KEDENVPFL
KEKYPDAVYL	KEKYDAVYL
GISLEDTQKEL	LEDT-QKEL
GEMREMQQL	GEMREMQQL
REDYPQKEIL	REDYQKEIL
REIFLSQPIL	REIFSQPIL
AESGAMEGETL	AESGEGETL
AEIEEREAL	AEIEEREAL
AENPAMTRELL	AENPMTREL
QEHLQLQNL	QEHLQLQNL
SEYSVHSSL	SEYSVHSSL
KEFPEKQEL	KEFPEKQEL
SEMHVPSVAL	SEMHPSVAL
GETPEAAAL	GETPEAAAL
VEESGEHVIL	VEESEHVIL
KEFNIPLEML	KEFNPLEML
IEHALGGSSAL	HALGGSSAL
AEFTAKIAL	AEFTAKIAL
HEDPGQATL	HEDPGQATL
GEKSQAPTL	GEKSQAPTL
GEAAEKNLYL	GEAAKNLYL
VETEIKELIL	VETEKELIL
AEDYTESLL	AEDYTESLL
AEAKPELSL	AEAKPELSL
GEYGKFFVTI	GEYGFFVTI
KEEEVQQQKL	KEEEQQQKL
YEVVPQQPAL	YEVVQQPAL
KEIDEVGDLL	KEIDVGDLL
REDSGTFSL	REDSGTFSL
SEERVQVAL	SEERVQVAL
KEFEGKTLV	KEFEGKTLV
EIEERGVKL	EIEERGVKL
PEARIYEETL	PEARYEETL
AEDKPSTDL	AEDKPSTDL
AELLLKSSDL	AELLKSSDL
GEDPTSVAI	GEDPTSVAI
REDEKPLVL	REDEKPLVL
HEFHSPAL	HEFH-SPAL
TELQGMNEYL	TELQMNEYL
REEAVALGVGL	EEAVLGVGL
SELNGHHTL	SELNGHHTL
REMDEQIRL	REMDEQIRL
HLPETKFSEL	LPETKFSEL
KESEDKPEI	KESEDKPEI
REKQDTFAL	REKQDTFAL
QEDSKPITL	QEDSKPITL
KEGFPITAI	KEGFPITAI
REAVVNTQEL	REAVNTQEL
GEIDEETDSAL	GEIDTDSAL
HEEDRKDFL	HEEDRKDFL
FESSPDPEL	FESSPDPEL
GEAQRLIEIL	GEAQLIEIL
GEVNVLDNL	GEVNVLDNL
AEVSQEVTRSL	AEVSVTRSL
SEFQRVVEVL	SEFQVVEVL
QEIEEFKERL	QEIEFKERL
RENYDRGYSSL	RENYGYSSL
KEDPMGWQSLL	KEDPGWQSL
FESDLHSLL	FESDLHSLL
VETDWHMITV	VETDHMITV
REPLLVNESL	REPLVNESL
EMEKGSPSL	EMEKGSPSL
HEKQPDVIL	HEKQPDVIL
HEAQLSEKISL	HEAQLSEKI
KESEGVVNDEL	SEGVVNDEL
REAQNDLEQVL	REAQLEQVL
GEVDGKAIPDL	GEVDGKAIP
GEAEKGAVL	GEAEKGAVL
KEYENIIAL	KEYENIIAL
AEQQGKGVAL	AEQQKGVAL
IEIGDGAEL	IEIGDGAEL
VEALPGPSL	VEALPGPSL
SEDGLPEGIHL	SEDGLPEGI
MEEKGSISL	MEEKGSISL
FEMKELPQL	FEMKELPQL
GEISQEEVL	GEISQEEVL
AESAPAWRL	AESAPAWRL
SELKSENESL	SELKENESL
GEDSAVLMERL	GEDSLMERL
TENNDHINL	TENNDHINL
KEDSKLIAL	KEDSKLIAL
YEVSDSAPHL	YEVSSAPHL
GETVAREATEL	GETVEATEL
EPNFPEILL	EPNFPEILL
YEEQGKPEVL	YEEQKPEVL
AEVLAKKEEL	AEVLKKEEL
GEQPLQPVL	GEQPLQPVL
KESGNSIVL	KESGNSIVL
REAVEAAGQEL	REAVAGQEL
KETDLLILF	KETDLLILF
WEISQKTVL	WEISQKTVL
SEVVEIQAL	SEVVEIQAL
QEEPLPPLAL	QEEPPPLAL
REVEIQSHL	REVEIQSHL
GETLPEQHL	GETLPEQHL
REIESSPQYRL	IESSPQYRL
RENLEEEAIIM	RENLEEEAI
WEAGTHEELL	WEAGTHEEL
QETDVRAQI	QETDVRAQI
KEEPDGPAL	KEEPDGPAL
RIDPESGDL	RIDPESGDL
REAQMAAKL	REAQMAAKL
AEPEDHYFLL	AEPEHYFLL
GEEALLRYVL	GEEALRYVL
AEDVQHQIL	AEDVQHQIL
IEVDGKQVEL	IEVDKQVEL
IEENIPELL	IEENIPELL
EAKEKIYL	EAKE-KIYL
REDPAPGLL	REDPAPGLL
TEVRELVSL	TEVRELVSL
SETLPLLAL	SETLPLLAL
ELIEGEREL	ELIEGEREL
HETSLPVQL	HETSLPVQL
GEKLLPGIEVL	GEKLGIEVL
IEDNELNIVL	IEDNLNIVL
GESEKLVRL	GESEKLVRL
VEIGDSTFTVL	VEIGTFTVL
EEFQNISPEEL	EEFQSPEEL
SEFEQNLSEKL	FEQNLSEKL
AEYGAEALERM	AEYG-AEAL
VETPTGYIESL	VETPYIESL
REWTGIDRL	REWTGIDRL
QEVFEKATFI	QEVFKATFI
GEFDPSKERL	GEFDSKERL
TVLVPTRHP	TVLVPTRHP
LESDNNTAL	LESDNNTAL
SEFKGDLETL	SEFKDLETL
REPESVEQL	REPESVEQL
EEVEIEREVL	EEVEEREVL
RELQEVESTL	RELQVESTL
RELAEDDSIL	RELADDSIL
SEHGINIDL	SEHGINIDL
AEYRLGPLL	AEYRLGPLL
YEAPDVMNL	YEAPDVMNL
KEESQQMVL	KEESQQMVL
HEWEESNVQIL	HEWESNVQI
AEHEDFLLAL	AEHEFLLAL
REHSVHDSVEL	REHSDSVEL
RELDALGHEL	RELDLGHEL
HENEDIYKL	HENEDIYKL
AEMPDSAAAL	AEMPSAAAL
GEIPTYGL	GEIP-TYGL
GEDGAGKTSL	GEDGGKTSL
REKAEGDVAAL	AEGD-VAAL
REENNESEVSL	EENNSEVSL
FELDYPKYEVL	FELDKYEVL
HEGTDVIML	HEGTDVIML
RELQSKEFL	RELQSKEFL
NEIPVEVVL	NEIPVEVVL
SEDGDAHVL	SEDGDAHVL
TEFEQQERL	TEFEQQERL
AEVEEKIDQL	AEVEKIDQL
TEDQRFPQL	TEDQRFPQL
REDTKAAVL	REDTKAAVL
VENNDIIIL	VENNDIIIL
KEFNEDGAL	KEFNEDGAL
HEEALSFVSL	HEEASFVSL
KELEKTLAL	KELEKTLAL
SELESIQEVL	SELEIQEVL
KEEEPSVKL	KEEEPSVKL
REIAQDFKTDL	REIAFKTDL
AEDNADTLAL	AEDNDTLAL
GEDSSFLVVRL	GEDSSFLVV
AEFAHHNYL	AEFAHHNYL
AEAQFTTAL	AEAQFTTAL
LEFDPAQRITL	LEFDPAQRI
KETEARKVVL	KETERKVVL
GEVHIGGVML	GEVHGGVML
AEIEKFDKSKL	IEKFDKSKL
MEDGGVKLL	MEDGGVKLL
AEYIRTEML	AEYIRTEML
AENTSEVSTVL	AENTVSTVL
GEHTLLVTV	GEHTLLVTV
KEPEINTTL	KEPEINTTL
HEMIESGVINL	HEMIESGVI
SEHAVEAML	SEHAVEAML
PPVADSLANP	VADS----L
REIKDTQAQL	REIKTQAQL
REALGHQEKL	REALHQEKL
GEGAPAWVL	GEGAPAWVL
SETHKAIQAL	SETHAIQAL
YEVKSENL	YEVK-SENL
KEDELRTVL	KEDELRTVL
REEKVKAVL	REEKVKAVL
HEQQALPVDL	HEQQLPVDL
GELEKDPKL	GELEKDPKL
AEVAAKNQSL	AEVAKNQSL
GEGKPTPAL	GEGKPTPAL
KEKPGSEVL	KEKPGSEVL
SEAVIWEVL	SEAVIWEVL
GEHGTEYDTL	GEHGEYDTL
AEYAHPLETL	AEYAPLETL
KEVYEGEVTEL	KEVYEVTEL
SEVIFGHVL	SEVIFGHVL
TEVLEEANTL	TEVLEANTL
TEEGQKIVL	TEEGQKIVL
KEMQPTHPIRL	KEMQPTHPI
SEESRPQSL	SEESRPQSL
HEIEVIDQRL	HEIEIDQRL
AEAAVIEAM	AEAAVIEAM
KEYVQPVQL	KEYVQPVQL
HELEKKIEL	HELEKKIEL
REMEEKVTL	REMEEKVTL
MEEKTSHIL	MEEKTSHIL
AELPASVHAL	AELPSVHAL
GELDLDKQSEL	GELDKQSEL
REFEKMNQSL	REFEMNQSL
REENPSSVL	REENPSSVL
SEMSEEKRAKL	SEEK-RAKL
KESGAINTSL	KESGINTSL
LETLVSPKL	LETLVSPKL
TEIQGENVTL	TEIQENVTL
QEPLEGTEQTL	QEPLTEQTL
GEHGLIIRV	GEHGLIIRV
LEFQTPELL	LEFQTPELL
SEILSKKQNEL	SEILKQNEL
SEAQLRQFTL	SEAQRQFTL
RELPETDADL	RELPTDADL
REVSEEHNL	REVSEEHNL
GEVDLPSEL	GEVDLPSEL
GEFSEPVTL	GEFSEPVTL
VEFESQNKEFL	FESQNKEFL
KEYDEPYVL	KEYDEPYVL
AEAQGSTTL	AEAQGSTTL
KEIDIYANL	KEIDIYANL
KEVVHTVSL	KEVVHTVSL
REATSTPEISL	REATSTPEI
FEDSFSSIL	FEDSFSSIL
GEDREATGVLL	GEDRATGVL
AEDELRDAVL	AEDERDAVL
SESKIRVLL	SESKIRVLL
REEAIAVTM	REEAIAVTM
GEVLEPANLL	GEVLPANLL
KEDNTIYRL	KEDNTIYRL
GEMKSGVPVL	GEMKGVPVL
SEDGAIHVI	SEDGAIHVI
QEVQAMFDTL	QEVQMFDTL
TEIDSKWQEL	TEIDKWQEL
REVQAEIGKL	REVQEIGKL
AELHDLKEVVL	AELHKEVVL
AEFPGLPEAL	AEFPLPEAL
GEMKELPEQL	GEMKLPEQL
KENDAVTIQVL	KENDTIQVL
AETEHENTVL	AETEENTVL
GETKAKVLL	GETKAKVLL
SETSGHTQESL	SETSTQESL
QEDLDNPVL	QEDLDNPVL
SETSSVSHI	SETSSVSHI
TEIDGRSISL	TEIDRSISL
QEASEAYLVGL	SEAY-LVGL
REITEKEVKL	REITKEVKL
TEIKKTEVL	TEIKKTEVL
EESQIRIEL	EESQIRIEL
REAEHGYASL	REAEGYASL
NEAIVKDVL	NEAIVKDVL
YEENAKAEL	YEENAKAEL
GEARVGSEL	GEARVGSEL
REDKVHLKL	REDKVHLKL
SEVQDRVML	SEVQDRVML
KEISNNDKL	KEISNNDKL
KEIESRVVF	KEIESRVVF
SEGPAQVYL	SEGPAQVYL
TEIQQQSAL	TEIQQQSAL
KELEEELQHL	KELEELQHL
SEDGDAHVLL	SEDGDAHVL
AEYPEGFEI	AEYPEGFEI
KEIEKDLRL	KEIEKDLRL
TEVEIINQQL	TEVEINQQL
AEMALFEQEVL	AEMAEQEVL
GEAQVGKTSL	GEAQGKTSL
QEHPASAEFVL	QEHPAEFVL
AENAGSYSL	AENAGSYSL
KEFEVKDPEL	KEFEKDPEL
GEAGSITHL	GEAGSITHL
SEVESVKEFL	SEVEVKEFL
RELDVSYVL	RELDVSYVL
KEFSLQDIEVL	KEFSDIEVL
GEAQSKETL	GEAQSKETL
REDYTRYNQL	REDYRYNQL
KESSTVFEL	KESSTVFEL
LESKTYHAL	LESKTYHAL
LEVQVRESL	LEVQVRESL
KEIEFGTSL	KEIEFGTSL
TEVKTSTVI	TEVKTSTVI
TEIAEERQYL	TEIAERQYL
REIEGSQVTF	REIESQVTF
KEILDQLESL	KEILQLESL
AELKSSTVGL	AELKSTVGL
SEHSMDTLL	SEHSMDTLL
GETSVGKTSL	GETSGKTSL
AEYIQKNVQL	AEYIKNVQL
HEVKEAQTL	HEVKEAQTL
AELDEKISAL	AELDKISAL
KEVMQEVAQL	KEVMEVAQL
SEIQVLEHL	SEIQVLEHL
LLAENPQSTPQ	AENPQSTPQ
AELKQAQTL	AELKQAQTL
REFGEEALNSL	REFG-EEAL
HEILREAYAL	HEILEAYAL
TEHGEFLAL	TEHGEFLAL
AEYQDLTFL	AEYQDLTFL
LEDGQAVQL	LEDGQAVQL
SEIGEKQDTEL	SEIGQDTEL
FEFGGPEVL	FEFGGPEVL
SEVVTGSGL	SEVVTGSGL
SEHSGPPIVI	SEHSPPIVI
REFDGTEVL	REFDGTEVL
GEEGTRPEAL	GEEGRPEAL
AEVERVKDVL	AEVEVKDVL
REAEFTKSI	REAEFTKSI
GENSRNSIL	GENSRNSIL
RDSISKEDL	RDSISKEDL
AETHDATAL	AETHDATAL
AEEQSGGQYEL	EEQSGQYEL
TDTYKLILNGK	TDTY-KLIL
TELLWPGAALL	TELLPGAAL
SEPQEHRYTL	SEPQHRYTL
SEHLTESIL	SEHLTESIL
SESRYPQAL	SESRYPQAL
GELPEINGKL	GELPINGKL
TELTTKSSL	TELTTKSSL
TESTARVEL	TESTARVEL
YEEVHVPAL	YEEVHVPAL
NEILSDPEVL	NEILDPEVL
REIEGDLLL	REIEGDLLL
SEEEDSGKQAL	EEEDGKQAL
REEHIVVEL	REEHIVVEL
AEHIESRTL	AEHIESRTL
SENKEEPVKL	SENKEPVKL
AEERAEVSEL	AEEREVSEL
GEYFPGTGDL	GEYFGTGDL
FETPTEISL	FETPTEISL
SEVVLAGERL	SEVVAGERL
KENDELDIQL	KENDLDIQL
GELSIQPSL	GELSIQPSL
FEKEETFTL	FEKEETFTL
GEAPPPTESL	GEAPPTESL
GELAVGREIL	GELAGREIL
AEANHFIDL	AEANHFIDL
QETEPSKEL	QETEPSKEL
AESDGSFLL	AESDGSFLL
HEDPVIAVF	HEDPVIAVF
REDQDKVAVL	REDQKVAVL
AENKDEIALVL	AENKDEIAL
KEMQDVQGAL	KEMQVQGAL
AEYESLRDLL	AEYELRDLL
AEENGNVQALL	AEENNVQAL
QESGNGRDVL	QESGGRDVL
REAEMRNSIL	REAERNSIL
IEDEIATIL	IEDEIATIL
AEVSQRFEQL	AEVSRFEQL
HESQLSVEL	HESQLSVEL
KEESIVSSL	KEESIVSSL
LEKIADPTL	LEKIADPTL
YEDATKITV	YEDATKITV
SEIYIHGLGL	SEIYHGLGL
GEVDPKVAL	GEVDPKVAL
AETKAESEQL	AETKESEQL
AEIAEKETL	AEIAEKETL
HEIDRYTAI	HEIDRYTAI
REVGIPPEQSL	REVGPEQSL
LGNGNIKL	LGNG-NIKL
AEAKPITEML	AEAKITEML
LEFGEPVLL	LEFGEPVLL
VEVSIPAKL	VEVSIPAKL
KEVFDSAIL	KEVFDSAIL
GEEEFSYGYSL	EEFSYGYSL
AAPATRAAL	AAPATRAAL
SESRLEKAEL	SESREKAEL
KEIKEVIEL	KEIKEVIEL
SEPGPAEEL	SEPGPAEEL
GEAAKREIL	GEAAKREIL
TEKTKPEVL	TEKTKPEVL
SEAPGQRAL	SEAPGQRAL
KEDEQPQVVVL	KEDEQVVVL
HEMLAHRAVL	HEMLHRAVL
GETKISQSEL	GETKSQSEL
HEVRIQPSL	HEVRIQPSL
GELEAAKALVL	LEAAKALVL
AEEPKARVL	AEEPKARVL
AEIKELFQYI	AEIKLFQYI
YEPKLIIDL	YEPKLIIDL
MESDFEQKL	MESDFEQKL
GEIQAGAKL	GEIQAGAKL
GEALPHVVPTL	GEALVVPTL
AEDEGTQRL	AEDEGTQRL
VEDPTFLNQL	VEDPFLNQL
HEVEKMFTL	HEVEKMFTL
SESQKAVEL	SESQKAVEL
RESLPIYKL	RESLPIYKL
KEKVEPEVL	KEKVEPEVL
GEIVEKIGVHL	GEIVEKIGV
SELGESSLI	SELGESSLI
GEVAKEWQEL	GEVAEWQEL
RELGFSSNL	RELGFSSNL
KEAERDVSL	KEAERDVSL
REYNEYENIKL	REYNEYENI
LTQALKDNK	LTQALKDNK
GEERATEAGSL	GEEREAGSL
HEDLLNITL	HEDLLNITL
REKEDLVDLVL	KEDLVDLVL
GEVLPDIDTL	GEVLDIDTL
AEVLIQQGGL	AEVLQQGGL
RENGEATDTIL	RENGATDTI
AEITDKLGL	AEITDKLGL
AEALKKLIL	AEALKKLIL
AESGVERQVL	AESGERQVL
AESDTSPVL	AESDTSPVL
SEYGEEPIL	SEYGEEPIL
SVPEAQSAL	SVPEAQSAL
GEIKNIHLNL	GEIKIHLNL
LEDFPTISL	LEDFPTISL
QENVQKIIL	QENVQKIIL
YEIDDRDVNKI	YEIDDRDVN
AEPWPENATL	AEPWENATL
QEIADAHGLL	QEIADAHGL
GEPSLYNSL	GEPSLYNSL
VEVTAGNRL	VEVTAGNRL
NVKVDPEIQ	NVKVDPEIQ
KEFVSEVDVL	KEFVEVDVL
SEITGLSTAVL	SEITSTAVL
AESVEEYVL	AESVEEYVL
KEAAIGVLVL	KEAAGVLVL
REVVNKDVL	REVVNKDVL
GEDTPVTKL	GEDTPVTKL
SEFLKEEKL	SEFLKEEKL
VEFEDGSQI	VEFEDGSQI
KELQAHGADEL	KELQGADEL
TELLWPGAAL	TELLPGAAL
SEQDILRQEL	SEQDLRQEL
LEHVPDTVL	LEHVPDTVL
AEFLDDQETRL	AEFLQETRL
AEELGRGIAL	AEELRGIAL
AEYQELLDVKL	AEYQLDVKL
SENNRIFTL	SENNRIFTL
KEENVGLHQTL	EENVLHQTL
QEEPLPHEL	QEEPLPHEL
IEMQAITAL	IEMQAITAL
KEMEDWISSL	KEMEWISSL
SEERFHVEL	SEERFHVEL
REAPNPIHL	REAPNPIHL
GEEHFKGLVL	GEEHKGLVL
KEEIGNVQL	KEEIGNVQL
VEITEESKALL	VEITESKAL
SEILETSSTKL	SEILSSTKL
FEVSPDGSFL	FEVSDGSFL
TEYLSNADERL	TEYLADERL
READEESLQL	READESLQL
VELDDLGKDEL	VELDGKDEL
VEERPAVSL	VEERPAVSL
HEDFVVEL	HEDF-VVEL
QEAVAGAAVL	QEAVGAAVL
REAFLVNSDL	REAFVNSDL
QEFGADVRL	QEFGADVRL
FEEGKKISL	FEEGKKISL
KEAGSIVRL	KEAGSIVRL
AEETSSPVI	AEETSSPVI
KELQLLSETL	KELQLSETL
REVENPQNQL	REVEPQNQL
GEVGHHIDL	GEVGHHIDL
REDSNLESSQL	REDSESSQL
SELYEESSDL	SELYESSDL
REWGSGSDTL	REWGGSDTL
REESNTKIDL	REESTKIDL
QEFLERIHL	QEFLERIHL
LEVEKSLVL	LEVEKSLVL
SEMPAEIVEL	SEMPEIVEL
TETQAEKVVL	TETQEKVVL
HEASAILVHL	HEASILVHL
AEEHNIVFM	AEEHNIVFM
GEDMTPTLL	GEDMTPTLL
TEANVIKEAL	TEANIKEAL
GEDLGADYNL	GEDLADYNL
GEAEYVVAL	GEAEYVVAL
AEETGVHII	AEETGVHII
KETFLTSPEEL	KETFSPEEL
QEIDGKSLLL	QEIDGKSLL
VEAIESYVL	VEAIESYVL
TEDITRYFL	TEDITRYFL
QEAPSSTSQEL	QEAPTSQEL
GEEAKPIIL	GEEAKPIIL
GEVPFNHEI	GEVPFNHEI
TETNVYFKL	TETNVYFKL
TEVEIVDEKM	TEVEVDEKM
GEVVDQGSTNL	GEVVGSTNL
KEFHLEYDKL	KEFHEYDKL
SEVDKTKEEL	SEVDTKEEL
SELQVHSAL	SELQVHSAL
AEVAEHVQYM	AEVAHVQYM
KEALQDPFTL	KEALDPFTL
AEEKMPLSL	AEEKMPLSL
IEVEIAKQAL	IEVEAKQAL
AEFRDYPPVL	AEFRYPPVL
TEFDAAQVL	TEFDAAQVL
AEIDREMISSL	AEIDMISSL
IEESSKPVRL	IEESKPVRL
KEVFEDKQSVL	KEVFKQSVL
NEVFNDVRL	NEVFNDVRL
TEITHAVVI	TEITHAVVI
TEHPENFNL	TEHPENFNL
HEEFSEHALL	HEEFSEHAL
RELDLEENKL	RELDEENKL
REKVIKGAEIL	REKVKGAEI
GELTLEGGAL	GELTEGGAL
SEESYKDSTL	SEESKDSTL
GENRGPILL	GENRGPILL
FEDGQKIVV	FEDGQKIVV
KELFIHTEEL	KELFHTEEL
SEKDTKEEIL	SEKDKEEIL
GELKYVRIVL	GELKVRIVL
GEGSFSTVVL	GEGSSTVVL
AELTIAKDQL	AELTAKDQL
HEMDTSNGVLL	HEMDSNGVL
REQESKYIEEL	QESKYIEEL
IENEDMRVQL	IENEMRVQL
REHVEAIKI	REHVEAIKI
WEEERQPIL	WEEERQPIL
YEALLNLAERL	ALLNLAERL
KEVHQERIAL	KEVHERIAL
LETVTKDIL	LETVTKDIL
KELHIQGNRL	KELHQGNRL
LEVEDRTSL	LEVEDRTSL
GELQHASAVL	GELQASAVL
REQEEIVRL	REQEEIVRL
EEEKRNPAL	EEEKRNPAL
GESHVSGTTTL	GESHGTTTL
AEERVSFGL	AEERVSFGL
YEAFPHDSQL	YEAFHDSQL
GEMKAEVTKL	GEMKEVTKL
REIDDHDAVL	REIDHDAVL
AEEGEVHVAL	AEEGVHVAL
AESEEYDQVL	AESEYDQVL
REDYYDIQL	REDYYDIQL
GEDIPREML	GEDIPREML
MEENPGIFAVL	EENPIFAVL
YEADPLKKELL	YEADLKKEL
YEEITKWYL	YEEITKWYL
AEEEAARVAL	AEEEARVAL
FEEGLETTAL	FEEGETTAL
AEPAVTEPGL	AEPATEPGL
GEKNVFEAL	GEKNVFEAL
KEAPTAYSL	KEAPTAYSL
KEVEETIEGML	KEVETIEGM
RELEGASDPLL	RELEASDPL
KELEEKVAEL	KELEKVAEL
QEIQQAGERL	QEIQAGERL
KEISFAYEVL	KEISAYEVL
AENIPENPL	AENIPENPL
KESTATTFL	KESTATTFL
GELPSWIL	GELP-SWIL
IEVDLAHTTL	IEVDAHTTL
QEMGNGKANRL	QEMGKANRL
SEAPPSKMVL	SEAPSKMVL
GELDHVVEI	GELDHVVEI
LEAEIAHGSL	LEAEAHGSL
VEEAVATRTAL	EEAVTRTAL
HEESQTATLL	HEESQTATL
KEVSTGTVL	KEVSTGTVL
RELAQPASVL	RELAPASVL
AEIDAHLVAL	AEIDHLVAL
TESPENVAL	TESPENVAL
AEQKVEYTL	AEQKVEYTL
KAPSAARSL	KAPSAARSL
LEHQVFTVL	LEHQVFTVL
HESAVTGLSL	HESATGLSL
ADFAKVLEL	ADFAKVLEL
LEVDKDEAL	LEVDKDEAL
AEPEDHYFL	AEPEDHYFL
KEVGEAFTIL	KEVGAFTIL
REDSVKPGAHL	REDSPGAHL
FEMATRAAL	FEMATRAAL
SEFEENTNL	SEFEENTNL
AELMKVQAL	AELMKVQAL
QEIDPTKENQL	QEIDKENQL
SELQGERIVSL	SELQRIVSL
VEFDEVDSL	VEFDEVDSL
AETGKVVII	AETGKVVII
KELKDAGAGL	KELKAGAGL
GEVGSAHSSL	GEVGAHSSL
LEEKDPVPL	LEEKDPVPL
SELIRNVTL	SELIRNVTL
KEDNGIGILTL	KEDNGIGIL
REDEDGLFTL	REDEGLFTL
IEELPTQISSL	EELPQISSL
SEIKELQLVL	SEIKLQLVL
KEFDNGHLLL	KEFDNGHLL
REWPESVSL	REWPESVSL
GEVGSEVHL	GEVGSEVHL
EESAARVVL	EESAARVVL
RETELKVHL	RETELKVHL
HEAQLKNGSL	HEAQKNGSL
KELQDVGQSL	KELQVGQSL
MESEGKTVL	MESEGKTVL
AVEEEKGEEL	VEEEKGEEL
GEHHSTPSL	GEHHSTPSL
YEQLLDVKI	YEQLLDVKI
QEHPELAVL	QEHPELAVL
GEEPGSQGL	GEEPGSQGL
SEKSLENETL	SEKSENETL
KEIVAEAERL	KEIVEAERL
KEAALSTAL	KEAALSTAL
LEVPSTTAL	LEVPSTTAL
SEPKDVTVL	SEPKDVTVL
GEIREQNGDSL	GEIRNGDSL
AELEPLKEQL	AELELKEQL
SENQEKVKALL	SENQKVKAL
SEQEEPIEL	SEQEEPIEL
REVEEENRAL	REVEENRAL
GEAGLHFDEL	GEAGHFDEL
GEAVRGLETAL	GEAVLETAL
REMEEEAEKL	REMEEAEKL
TEAGALHVLL	TEAGLHVLL
GEQREPETL	GEQREPETL
HEADKTYML	HEADKTYML
AEVDKNIELL	AEVDKNIEL
TESKDDPSL	TESKDDPSL
SEAAFIENL	SEAAFIENL
AEQPSVKL	AEQP-SVKL
AEASMISKL	AEASMISKL
AEEHSIATL	AEEHSIATL
REEGKENAFSL	EEGKNAFSL
SEASFQEAL	SEASFQEAL
AEVAEMRQML	AEVAMRQML
KEIAEAYDVL	KEIAAYDVL
VEFRNDYEEL	VEFRDYEEL
GEYRAVTEL	GEYRAVTEL
FEWAKNSPL	FEWAKNSPL
AESRALAQL	AESRALAQL
RELQGRHEQL	RELQRHEQL
KEEESQQQAVL	EESQQQAVL
GEIGTKTTL	GEIGTKTTL
GEDKGIKAL	GEDKGIKAL
YAPKGSSL	YAPK-GSSL
KEVGIEFMDL	KEVGEFMDL
REGEIAQFL	REGEIAQFL
TEIEGTQKL	TEIEGTQKL
IDGNKVTL	IDGN-KVTL
DAVTKTVGL	DAVTKTVGL
ADHVQSLLL	ADHVQSLLL
GEMKFQWDL	GEMKFQWDL
GEEKLKEIL	GEEKLKEIL
KQQLELDSI	KQQLELDSI
KEHVDKAIAL	KEHVKAIAL
KEDPTSFRL	KEDPTSFRL
YEEGLRVVI	YEEGLRVVI
HEELIGAATAL	EELIAATAL
AEALLTYETL	AEALTYETL
SEFDFFERL	SEFDFFERL
AEVAATEIKM	AEVATEIKM
HEVSEIIDGL	HEVSIIDGL
LERIEETAL	LERIEETAL
REIVIGVLHQL	REIV-IGVL
YEIDDVERL	YEIDDVERL
SEFYKHIVL	SEFYKHIVL
KEILSLDKL	KEILSLDKL
KEIDMLLKEYL	KEIDLKEYL
SEVTEPDHPVL	SEVTDHPVL
GEAHAELDSL	GEAHELDSL
REIEGRAIRL	REIERAIRL
GEFADPFKL	GEFADPFKL
KELSDSVTL	KELSDSVTL
AEESKALIPSL	EESKLIPSL
KEQNYSDDVL	KEQNSDDVL
IELDPRFNDIL	IELDRFNDI
VEEGKISTSL	VEEGISTSL
FEARLVQGSIL	FEARVQGSI
SEFVDPSSL	SEFVDPSSL
SESPIVVVL	SESPIVVVL
GEIRTITVV	GEIRTITVV
SEMDPSTQISL	SEMDPSTQI
QESLAQARL	QESLAQARL
FESGISQALL	FESGISQAL
RENEVLKVQL	RENELKVQL
GEIDGNKVTL	GEIDNKVTL
SEHELDVAL	SEHELDVAL
RELQELQDSL	RELQLQDSL
GEHQINQIAL	GEHQNQIAL
REIKFLDVL	REIKFLDVL
KEFDAGIIEL	KEFDGIIEL
RELEETNQKL	RELETNQKL
GEALPFSHLIL	GEALPFSHL
AEFSSAGHSL	AEFSAGHSL
AELEGRQEEL	AELERQEEL
NESRAVITSL	NESRVITSL
HEVMEQGRVTI	HEVMEQGRV
RESNEVVHL	RESNEVVHL
RETQAINSSL	RETQINSSL
TEVLEGNPTVL	TEVLNPTVL
IEGLIEREYL	IEGLEREYL
AETEEIKTIL	AETEIKTIL
GEDPNKAEEL	GEDPKAEEL
SELILSKEQL	SELISKEQL
AEDTITALL	AEDTITALL
AEPDIIEQL	AEPDIIEQL
KAPAPRPSL	KAPAPRPSL
KEIEERLHGL	KEIERLHGL
GEFGYDKDTSL	GEFGKDTSL
AEILQANDLL	AEILANDLL
AEDGADPNL	AEDGADPNL
AEYGAEAL	AEYG-AEAL
AELESKTNTL	AELEKTNTL
SESMATRDVVL	SESMRDVVL
LEAAGIGKL	LEAAGIGKL
GEHHEKAVELL	GEHHKAVEL
YEVDINGPEIL	YEVDNGPEI
TEIEDSHTL	TEIEDSHTL
GEVPKFKAL	GEVPKFKAL
GEFSGANKEKL	GEFSNKEKL
GEIEGLNDTF	GEIELNDTF
GEERQEASSSL	GEERASSSL
SEQRLLIVL	SEQRLLIVL
REVTPDQKL	REVTPDQKL
HEIQEKLGL	HEIQEKLGL
HEHRLPHVL	HEHRLPHVL
SEFQDDPVL	SEFQDDPVL
KEINTNQEAL	KEINNQEAL
KEITEKTRVAL	KEITTRVAL
RESERQLRL	RESERQLRL
AELAVPIEL	AELAVPIEL
FEGPDAKL	FEGP-DAKL
AEIEPPHHEL	AEIEPHHEL
SEDTSKLYAL	SEDTKLYAL
REAVSKTAL	REAVSKTAL
SEILPTKETL	SEILTKETL
GEELLHSVL	GEELLHSVL
HEMEIQLKDAL	MEIQLKDAL
GEEARVTQL	GEEARVTQL
AEKPVGALL	AEKPVGALL
TEARTMAAEVL	TEARAAEVL
HEIEVIGGYL	HEIEIGGYL
SEAVLWEAL	SEAVLWEAL
MEDGPIVKL	MEDGPIVKL
AEAQGSTTLL	AEAQGSTTL
SEDFRGSMTSL	SEDFSMTSL
GEEQNKEAL	GEEQNKEAL
IEEKGAVEAL	IEEKAVEAL
AEEALRTDIL	AEEARTDIL
SESTAESHL	SESTAESHL
GETQDFHSL	GETQDFHSL
TELESDFRDVL	LESDFRDVL
GEAGPSAEAL	GEAGSAEAL
GEDHPEMALL	GEDHEMALL
HEYYQPTAL	HEYYQPTAL
SESPGATEL	SESPGATEL
AEINSRTGSKL	AEINTGSKL
REYNEVEPIIL	REYNVEPII
IEQEIRILL	IEQEIRILL
GEDSRPPRL	GEDSRPPRL
MEVSEPHIL	MEVSEPHIL
SEWNTVERL	SEWNTVERL
TEAVEDLTTTL	TEAVLTTTL
KEVTEKEVTL	KEVTKEVTL
RETVSEESNVL	RETVESNVL
REVELDPDIQL	VELDPDIQL
GELAPSHGL	GELAPSHGL
QEHAQEVVL	QEHAQEVVL
YEIERTIVQL	YEIETIVQL
GEMTLKSALAL	GEMTLKSAL
GEDVRSALL	GEDVRSALL
VEMDIVEKL	VEMDIVEKL
LETKVAELL	LETKVAELL
QEADSPTL	QEAD-SPTL
TELEAKLQVL	TELEKLQVL
SEERETEISL	SEERTEISL
SEIEDVNTL	SEIEDVNTL
VEVDDPLKAQM	VEVDDPLKA
AEVPESVFL	AEVPESVFL
AEALKAVLL	AEALKAVLL
RELPGHTGYL	RELPHTGYL
RELLESNFTL	RELLSNFTL
HEEFSEHAL	HEEFSEHAL
GEVTYVELL	GEVTYVELL
GEFGEIEAI	GEFGEIEAI
TEIQLVQSL	TEIQLVQSL
KEMRNLIRL	KEMRNLIRL
AEVLVKSNNL	AEVLKSNNL
FEVLVEKEWL	FEVLEKEWL
QEAEEAGAAL	QEAEAGAAL
FSGANKEKL	FSGANKEKL
KEEDGSLSL	KEEDGSLSL
KEIEELKELL	KEIELKELL
FESGISQAL	FESGISQAL
RESIVLHGATL	SIVLHGATL
KESAEFQTQL	KESAFQTQL
KESPPHEDL	KESPPHEDL
KEFEENTQHL	KEFENTQHL
KEALIAASETL	KEALASETL
AEEPRGSSL	AEEPRGSSL
HENSDHIIL	HENSDHIIL
AEEPAGTSL	AEEPAGTSL
QELYFFHEL	QELYFFHEL
GEIINTHTL	GEIINTHTL
REESDSLGQDL	EESDLGQDL
RELQEAPLSL	RELQAPLSL
TEVSKVPSL	TEVSKVPSL
AENRLTEMETL	AENREMETL
ISPTGHSL	ISPT-GHSL
KEALTYDGAL	KEALYDGAL
GEDEPLHAL	GEDEPLHAL
HEDSSHIIAL	HEDSHIIAL
KEEHLYILI	KEEHLYILI
TEYPEKEVTL	TEYPKEVTL
LEVPVSDLL	LEVPVSDLL
GEVPVHKL	GEVP-VHKL
PEARIFEETL	PEARFEETL
GEERVDSLVSL	GEERSLVSL
QETEEKILL	QETEEKILL
AELEELKQVLL	AELELKQVL
SESDKTAVLTL	SESDKTAVL
RELYLFDVL	RELYLFDVL
GEFSPNVPKSL	GEFSVPKSL
AEAVVNDVL	AEAVVNDVL
LEMNSDLKAQL	LEMNLKAQL
KEPDSEQQPL	KEPDEQQPL
IESHPDNAL	IESHPDNAL
LEAHLTRDEL	LEAHTRDEL
AQYEDIAQKS	AQYEDIAQK
NETDTPAQL	NETDTPAQL
AEERPRVAL	AEERPRVAL
AEKVEIATL	AEKVEIATL
AELAEEVNL	AELAEEVNL
KEVEASHLAL	KEVESHLAL
REIIQKLML	REIIQKLML
GEVRFSAVAL	GEVRSAVAL
AEDKDTPAL	AEDKDTPAL
GEENIGGVEWL	EENIGVEWL
AESPERVLL	AESPERVLL
AELMQQVNVL	AELMQVNVL
LEENVHEVL	LEENVHEVL
IEESIDRVYSL	EESIRVYSL
GELGNGNIKL	GELGGNIKL
REFEERRSL	REFEERRSL
REKEIKSEL	REKEIKSEL
AESPTPQAL	AESPTPQAL
AEEDMPQRVVL	EEDMQRVVL
AEIAAKDKL	AEIAAKDKL
GEPAEVTTTVL	AEVT-TTVL
AEDNIREML	AEDNIREML
REDSQRPGAHL	REDSPGAHL
TEDDKQLLL	TEDDKQLLL
SEYLPEVKDLL	SEYLVKDLL
QEFVYKEPAI	QEFVKEPAI
KEFEDKKVEL	KEFEKKVEL
AEFPEKEAQL	AEFPKEAQL
GEETGIDVTL	GEETIDVTL
GEESEGIHEVL	EESEIHEVL
DEIPETVSL	DEIPETVSL
GEGTQGPELSL	GEGTQGPEL
REAEHLYHTL	REAELYHTL
QEYSSISEKL	QEYSISEKL
YEVGDPGQRTL	YEVGGQRTL
SESLVYTTL	SESLVYTTL
GEHLVSVTL	GEHLVSVTL
AEDASKFEL	AEDASKFEL
KEEEGIGEEL	KEEEIGEEL
QEKLPDEVVL	QEKLDEVVL
AELPLRLFL	AELPLRLFL
HEDIVAVEL	HEDIVAVEL
EQLNEQLVT	EQLNEQLVT
SELISKSSEIL	SELIKSSEI
GEHVKAIEI	GEHVKAIEI
AEQHFADVVL	AEQHADVVL
AELEELKQVL	AELELKQVL
HEAQHGVTSL	HEAQGVTSL
GEANVTGSQL	GEANTGSQL
REMFGYMKL	REMFGYMKL
REHMGQLLHQL	REHM-GQLL
SEYSRSEITL	SEYSSEITL
REAQAELAQKL	REAQLAQKL
REMENKETL	REMENKETL
MEIDIPHVWL	MEIDPHVWL
SEVMGEPHL	SEVMGEPHL
KEIEQEAAVEL	IEQEAAVEL
SEVDSPNVL	SEVDSPNVL
TEVTPVTGASL	TEVTTGASL
TEFLDISQL	TEFLDISQL
SEPEIEIKL	SEPEIEIKL
KEFDGTKVFL	KEFDTKVFL
AEIQNVEGQNL	AEIQEGQNL
REHDIAIKF	REHDIAIKF
AELRSTASL	AELRSTASL
GEGDSVITQVL	GEGDITQVL
AEPLRPGPAL	AEPLPGPAL
GEANVMKAL	GEANVMKAL
GEHSSRVVQEL	GEHSVVQEL
GEVLEKSLL	GEVLEKSLL
QEFGIPIERL	QEFGPIERL
REQWANLEQL	REQWNLEQL
TELEYIHAL	TELEYIHAL
SEGLPEPVL	SEGLPEPVL
VEDRPQDPL	VEDRPQDPL
KEDEQQQAL	KEDEQQQAL
KEIAENQEAKL	KEIAQEAKL
KEIEDFDSL	KEIEDFDSL
HEQEEIFKL	HEQEEIFKL
SEVESTASIL	SEVETASIL
IEESGEHII	IEESGEHII
REVSPAHQYAL	REVSHQYAL
TTYKLVINGK	TTYKVINGK
SEAADSKSLVL	SEAADSKSL
RELREREGPSL	RELREGPSL
AENKDEIAL	AENKDEIAL
KEAPPPVLL	KEAPPPVLL
AEEVGVEHL	AEEVGVEHL
VDGKQVEL	VDGK-QVEL
REGDMPIHELL	REGDPIHEL
AEAVAALLL	AEAVAALLL
VEWNKKEEL	VEWNKKEEL
LEYDPTQRITL	LEYDPTQRI
SEFREDMPSIL	SEFRDMPSI
SEGPPAPAL	SEGPPAPAL
GESSGKNVTL	GESSKNVTL
AESELTVTQL	AESETVTQL
SELREPLKVVL	SELRLKVVL
KEINQNVEI	KEINQNVEI
SESSVKVRL	SESSVKVRL
AEIDSIHQL	AEIDSIHQL
REAQVFVRL	REAQVFVRL
AEESQIRIEL	AEESIRIEL
SEPGKVIVL	SEPGKVIVL
AEADAIIQM	AEADAIIQM
TEATQEKYVL	TEATEKYVL
TEIGQTLDLL	TEIGTLDLL
REMESNWVSL	REMENWVSL
KEINEKSNIL	KEINKSNIL
AEIGQVKQEL	AEIGVKQEL
FEDAAEIRL	FEDAAEIRL
GEYSDPVTL	GEYSDPVTL
REWKGIDRL	REWKGIDRL
IEFVADRL	IEFV-ADRL
REHFTPEATQL	REHFEATQL
KEIFLRELI	KEIFLRELI
SEEKGGVEVL	SEEKGVEVL
REANQAINPKL	REANINPKL
GEPEEDIVGL	GEPEDIVGL
REDDVGTGAGL	REDDTGAGL
SETNKGAFSL	SETNGAFSL
FEDEKPALL	FEDEKPALL
GETAFAFHL	GETAFAFHL
QEIQTSVATL	QEIQSVATL
GEDQTQDTEL	GEDQQDTEL
AEAEIIQLL	AEAEIIQLL
KEMESIWNL	KEMESIWNL
AEIETRIAEL	AEIERIAEL
AEVAQREAETL	AEVAEAETL
GELREQLKAL	GELRQLKAL
SEVVVVKEEL	SEVVVKEEL
REIEELHKL	REIEELHKL
KEEKDFTIL	KEEKDFTIL
SELRNQYVTL	SELRQYVTL
RELFEPWNNL	RELFPWNNL
GEFNEQVLRL	GEFNQVLRL
YEEDSKETL	YEEDSKETL
AEIDSVKMTL	AEIDVKMTL
EEENSKVEL	EEENSKVEL
PEADKGTVL	PEADKGTVL
REAVVNTQELL	REAVNTQEL
REKEAAYQERL	KEAAYQERL
IEASNIDNVVL	IEASDNVVL
EEVGLFNEL	EEVGLFNEL
AERNVYTSEVL	RNVYTSEVL
IEPADAHVL	IEPADAHVL
SETVVTGSL	SETVVTGSL
HEIQRTENSL	HEIQTENSL
GELTENGLTL	GELTNGLTL
AEPILPYAL	AEPILPYAL
AEFAERSVAKL	AEFARSVAK
VEFNHSGELL	VEFNSGELL
LEAFGDVKL	LEAFGDVKL
GELLMHPVL	GELLMHPVL
SELPDSIESAL	SELPIESAL
REIADLGEAL	REIALGEAL
NEIRTLIDL	NEIRTLIDL
RELQAKFEHL	RELQKFEHL
AEDTPVVQL	AEDTPVVQL
SEAVERLSVL	SEAVRLSVL
AEVETGDKL	AEVETGDKL
AELPEPQQTAL	AELPQQTAL
AEDPLGAIHL	AEDPGAIHL
AEIAHIALETL	AEIA-HIAL
KEASVKFHVL	KEASKFHVL
SEFGRNYSL	SEFGRNYSL
SEAYGQKDLL	SEAYQKDLL
AEHYTETAL	AEHYTETAL
AEWAAANHVL	AEWAANHVL
SEPDAVHVVL	SEPDVHVVL
TEDKISLLL	TEDKISLLL
TEAAHPIRL	TEAAHPIRL
LEGQIHPEL	LEGQIHPEL
AEVDGASFLL	AEVDASFLL
FEFDEQGREL	FEFDQGREL
AELDETKIIL	AELDTKIIL
KEMDIVVHTL	KEMDVVHTL
GEVTKQTVL	GEVTKQTVL
IEISMQHEQL	IEISQHEQL
REDFKGKKIEL	REDFKKIEL
AEAQALRQEL	AEAQLRQEL
VEHVPGADIL	VEHVGADIL
RESEIETNTEL	SEIETNTEL
REAATQAQQTL	AATQAQQTL
REFDAFVETL	REFDFVETL
NEFGEKWEL	NEFGEKWEL
VEAPPSVVL	VEAPPSVVL
KEVANSTANL	KEVASTANL
NAPWAVTSL	NAPWAVTSL
KEENTQEAAVL	EENTEAAVL
FENGKELVEL	FENGELVEL
VEEQRPPEL	VEEQRPPEL
GEIIMGNIEL	GEIIGNIEL
SELKETVEL	SELKETVEL
HEYKGPKADL	HEYKPKADL
GESSLSPSL	GESSLSPSL
AEAYHFFIL	AEAYHFFIL
REAEIYQTV	REAEIYQTV
QEFQPEPSL	QEFQPEPSL
REAEQSNVAL	REAESNVAL
LESDFRDVL	LESDFRDVL
AEFQRDIML	AEFQRDIML
SESPRSTSL	SESPRSTSL
AEKSEQPTL	AEKSEQPTL
SEDASIHRL	SEDASIHRL
RETEKTLTEL	RETETLTEL
TEVRVANEL	TEVRVANEL
WESSNKALL	WESSNKALL
HEVPSGNSL	HEVPSGNSL
AEEGGAARL	AEEGGAARL
WESSIVDRL	WESSIVDRL
SEFEARVISL	SEFERVISL
VNLPINGNGKQ	LPINGNGKQ
AEASVDPSL	AEASVDPSL
AEVGIIESI	AEVGIIESI
GEFTSARAVL	GEFTARAVL
SEAPVDLASKL	SEAPLASKL
REKQPMVPESL	REKQVPESL
GEISDIHTKL	GEISIHTKL
REDDPGEAASM	REDDGEAAS
RELEEEFYSL	RELEEFYSL
KELDSNPFASL	KELDPFASL
VEFPHSPEI	VEFPHSPEI
LEVEVIEGTL	LEVEIEGTL
HESGASIKI	HESGASIKI
QEEKPEPVL	QEEKPEPVL
KELGLAEHQL	KELGAEHQL
SEIDPRENPDL	SEIDENPDL
IENDEAFAIL	IENDAFAIL
IENGEKITSL	IENGKITSL
KEIYNEKELL	KEIYEKELL
YEASLPHQI	YEASLPHQI
KEVDIEGTTVI	KEVDEGTTV
GETGKGTLL	GETGKGTLL
AEESAFSTVL	AEESFSTVL
GEIATSQERL	GEIASQERL
RELESREAEL	RELEREAEL
HELLEGSEIYL	HELLEGSEI
VEALEPEVSL	VEALPEVSL
IEIDSPYEI	IEIDSPYEI
AEIEIVKDL	AEIEIVKDL
QESNVQLKL	QESNVQLKL
SEDLNKHVL	SEDLNKHVL
AENPDTPAL	AENPDTPAL
KEESVESSL	KEESVESSL
FELEKSESL	FELEKSESL
TEAWLQEKL	TEAWLQEKL
GEEPAPEAEAL	EEPAEAEAL
SEDGSLHVFVL	SEDGSLHVF
LEHIKTHEL	LEHIKTHEL
GEHLKTDLL	GEHLKTDLL
AEYTAKIAL	AEYTAKIAL
KELGSSTNAL	KELGSTNAL
GELSGDFEKL	GELSDFEKL
SEEDRVVVI	SEEDRVVVI
REFNEEGAL	REFNEEGAL
SEVDGNRMTL	SEVDNRMTL
IEEPSAKINVL	EEPSKINVL
TEEKLTPVL	TEEKLTPVL
LEVIPGYEEL	LEVIGYEEL
REIQDAYLQL	REIQAYLQL
SEIKVPDVEL	SEIKPDVEL
EIDNSELLL	EIDNSELLL
GEIRNVGTGL	GEIRVGTGL
TYDDATKTF	TYDDATKTF
HEFDGDEEF	HEFDGDEEF
AEFKEAFSL	AEFKEAFSL
TENLNDDEKL	TENLDDEKL
HEAPAVLL	HEAP-AVLL
EELASLGLDRL	EELAGLDRL
GEEGYGRSL	GEEGYGRSL
AETGQVQKIVL	AETGQVQKI
LESPTTPLL	LESPTTPLL
SEDPGTKVLL	SEDPTKVLL
AEEPPTPAL	AEEPPTPAL
SENVLQVHL	SENVLQVHL
AELLDATQHTL	AELLTQHTL
KEAQKTAAVAL	KEAQKTAAV
TEVAPAKDVTL	TEVAKDVTL
GEAPGAETPSL	GEAPETPSL
AEGPVGSTL	AEGPVGSTL
SELDDRADAL	SELDRADAL
HEFEEATNLL	HEFEATNLL
AEAHAKVRL	AEAHAKVRL
FEITPPVVL	FEITPPVVL
RETLQQHKL	RETLQQHKL
GEHSGRYEEL	GEHSRYEEL
KEVADAIRL	KEVADAIRL
VEHLDDLPGAL	VEHLLPGAL
GEFGKKADGLL	GEFGKADGL
YEHNSIDSEL	YEHNIDSEL
AEGPGETVL	AEGPGETVL
AEHKIFPAAL	AEHKFPAAL
QEQIEAVLL	QEQIEAVLL
REHVEAIKIGL	REHVEAIKI
AELVPSEVL	AELVPSEVL
YESPEIAL	YESP-EIAL
RETLPAEQDL	RETLAEQDL
GEQGVGKSTL	GEQGGKSTL
AEMPEKGAL	AEMPEKGAL
AETFHTPSL	AETFHTPSL
RELDQQKLWL	RELDQKLWL
SEAVFKEEL	SEAVFKEEL
YEVKNKKDEL	YEVKKKDEL
REFQVISEQL	REFQISEQL
AEAAPDGPAL	AEAADGPAL
TEDHVMHLL	TEDHVMHLL
GESGNIKAGL	GESGIKAGL
RETGVIEKL	RETGVIEKL
AEAEKKVQL	AEAEKKVQL
GEAHLKTIL	GEAHLKTIL
GEVTEGLDVL	GEVTGLDVL
VEDPYTASL	VEDPYTASL
LEEPSADAKL	LEEPADAKL
TEVGEKIAL	TEVGEKIAL
GEGNWSKILL	GEGNSKILL
QEVGDGTNFVL	QEVGTNFVL
AELKIVADQL	AELKVADQL
VEDVSWHLL	VEDVSWHLL
AEFKEAFQL	AEFKEAFQL
AEPDLEQAAHL	AEPDQAAHL
AQYEDIAQK	AQYEDIAQK
KEVDEDFDSKL	KEVDFDSKL
IEFDPSKPFSL	IEFDKPFSL
SEMRFVQDL	SEMRFVQDL
NEAKVKETL	NEAKVKETL
AEAAALEVL	AEAAALEVL
REDPSGVILTL	REDPSGVIL
FEHHGQVRL	FEHHGQVRL
KEEPVAPEL	KEEPVAPEL
AENGLTVRL	AENGLTVRL
KESTLHLVL	KESTLHLVL
RETEGGTVL	RETEGGTVL
REKLQEEML	REKLQEEML
SEERAGAPL	SEERAGAPL
REEGFDRSTSL	EEGFRSTSL
KEVAQAVLL	KEVAQAVLL
SETYETKTAL	SETYTKTAL
KEPAFEDITL	KEPAEDITL
YEAGPDAVL	YEAGPDAVL
IEAPVDADL	IEAPVDADL
QREEAAEVASL	REEAEVASL
AEPELQYVAL	AEPEQYVAL
AEQATKSVL	AEQATKSVL
GELPTSPLHLL	GELPSPLHL
AEPKLAFVI	AEPKLAFVI
GEPDHNEAL	GEPDHNEAL
AEMETFRDIL	AEMEFRDIL
SEFTPLPREVL	SEFTPREVL
REEAIHQSQL	REEAHQSQL
QEIQDQLSL	QEIQDQLSL
QEEWFKAEL	QEEWFKAEL
GEQSPNVSL	GEQSPNVSL
FEDHNPPQL	FEDHNPPQL
RENEVDWLTEL	NEVDWLTEL
AEEAPKTPL	AEEAPKTPL
YAPSGNYV	YAPS-GNYV
YEAQDPEIASL	YEAQEIASL
RENPGGSEESL	RENPSEESL
VEENWTHLQSL	EENWHLQSL
SETTAAHSL	SETTAAHSL
TEIEEELKSL	TEIEELKSL
KELEEEWVKL	KELEEWVKL
NEEDSKIEL	NEEDSKIEL
REAFVHVVTL	REAFHVVTL
GEENGAHTI	GEENGAHTI
AEVEHLTEVL	AEVELTEVL
HEESQTATL	HEESQTATL
KEDEDDKTVL	KEDEDKTVL
FETFNTPAM	FETFNTPAM
HEHQANLL	HEHQ-ANLL
KEHEVEKMFTL	HEVEKMFTL
WEEKPINTAL	WEEKINTAL
REYRPEYERL	REYREYERL
GEIKHVSSL	GEIKHVSSL
GELQKAIDL	GELQKAIDL
GEEELASKL	GEEELASKL
REMLIRVNM	REMLIRVNM
AEGEIYTKL	AEGEIYTKL
AEVDKVARL	AEVDKVARL
SESDKTAVL	SESDKTAVL
LEVVQTEKL	LEVVQTEKL
GEPESFGDNL	GEPEFGDNL
RELEDMYLKL	RELEMYLKL
GEAPVLIMI	GEAPVLIMI
SEENITIKL	SEENITIKL
AEFKTKYKL	AEFKTKYKL
REENAEQQAL	REENEQQAL
KEEYLKPVL	KEEYLKPVL
KEDGAISTIVL	KEDGSTIVL
SEEAVQVLI	SEEAVQVLI
AEQLGTFTTL	AEQLTFTTL
HEAERTEVL	HEAERTEVL
VSDAETESI	VSDAETESI
RENIESLAHAL	RENILAHAL
AEMDERFQQIL	AEMDRFQQI
REEDLAPFSL	REEDAPFSL
KEAPTPKEGTL	KEAPKEGTL
VETVYTHVL	VETVYTHVL
AETVDPASL	AETVDPASL
VEFREVTEL	VEFREVTEL
KEEENLQVVL	KEEELQVVL
SEINSNSDSL	SEINNSDSL
KEFIINDIL	KEFIINDIL
REESAARVVL	REESARVVL
HETAVSVSL	HETAVSVSL
ETGGSEKLSL	TGGSEKLSL
SEEENSKVEL	SEEESKVEL
HEEAGIFKL	HEEAGIFKL
KEYEGKWLL	KEYEGKWLL
KEGEIQAGAKL	GEIQAGAKL
REVWPEGDVF	REVWEGDVF
AEQDLVQTL	AEQDLVQTL
GEDLPTIVI	GEDLPTIVI
KEEEKPVML	KEEEKPVML
GENDETVQTTL	GENDVQTTL
MEYLESKQFL	MEYLSKQFL
GESVTKLTL	GESVTKLTL
KEFSGHSSL	KEFSGHSSL
MEVAGVTAL	MEVAGVTAL
TEIFIHSLEL	TEIFHSLEL
KESEDAELL	KESEDAELL
HELDQGQQL	HELDQGQQL
SETRVLVDI	SETRVLVDI
GEIQQIPVQL	GEIQIPVQL
KEVDPSTGEL	KEVDSTGEL
RELHEKFEHL	RELHKFEHL
AEERPTFDYL	AEERTFDYL
GETSDIYVL	GETSDIYVL
KESHEMGQAL	KESHMGQAL
AEVSELETRL	AEVSLETRL
GEDLEKVTL	GEDLEKVTL
KESSHSGVVL	KESSSGVVL
REAMNDPLL	REAMNDPLL
GEPENTYIL	GEPENTYIL
KELYVPENKL	KELYPENKL
TEHPVPIIL	TEHPVPIIL
VESHIQHSL	VESHIQHSL
AELGSSTSL	AELGSSTSL
VEVQLKDLIL	VEVQKDLIL
REVIQSDSL	REVIQSDSL
IEFKETQALVL	IEFKETQAL
KEYEKTQTVL	KEYETQTVL
LEDVVRAYL	LEDVVRAYL
AEITSGESL	AEITSGESL
KEWEKVFEM	KEWEKVFEM
KEVMVDDRL	KEVMVDDRL
VEVPDGPTL	VEVPDGPTL
GEGMGISHEL	GEGMISHEL
GETLAMKGLTL	GETLAMKGL
KESEVFYEL	KESEVFYEL
REEEVSYQL	REEEVSYQL
FESQSEDEL	FESQSEDEL
QEATPEKESL	QEATEKESL
GEINVIGEPFL	GEINGEPFL
YEAYRTLAIL	YEAYTLAIL
AEDENTQIAL	AEDETQIAL
KESVEDKLEL	KESVDKLEL
KEAIVTSEEL	KEAITSEEL
SEAEIFTTL	SEAEIFTTL
GELEAKLNENL	LEAKLNENL
SEVHDLRVVL	SEVHLRVVL
LEQDFKVTL	LEQDFKVTL
HEMALRIVL	HEMALRIVL
REIFLSQPILL	REIFSQPIL
TEADVEEAL	TEADVEEAL
REEQIVQLL	REEQIVQLL
RELDATATVL	RELDTATVL
GEVPTIESL	GEVPTIESL
YELPTDSHASL	YELPSHASL
KETPDKVEL	KETPDKVEL
SEDDTVLDL	SEDDTVLDL
REIFLFNDL	REIFLFNDL
GESHIGGVLL	GESHGGVLL
QEEDTFHSL	QEEDTFHSL
SESLPVETL	SESLPVETL
SEIEQAVQSL	SEIEAVQSL
AEAEERGEL	AEAEERGEL
AELKQVQTL	AELKQVQTL
REDIVVPVYL	REDIVPVYL
SESEAVAVAL	SESEVAVAL
SEDKKNIIL	SEDKKNIIL
SESRIFNEL	SESRIFNEL
NPIDSLPGE	NPIDSLPGE
TESDIREMM	TESDIREMM
IESNHPIVL	IESNHPIVL
KESEEKEVL	KESEEKEVL
SEDRSVQEVL	SEDRVQEVL
YEVVDKDSI	YEVVDKDSI
AEHGGGMDSL	AEHGGMDSL
SEAREKAVL	SEAREKAVL
VEAKFVQDTL	VEAKVQDTL
KENSPEKFAL	KENSEKFAL
KEDDPKAAL	KEDDPKAAL
KEVDVSKQL	KEVDVSKQL
AEVDKNIEL	AEVDKNIEL
GEFRAVTEL	GEFRAVTEL
KEFESHLDKL	KEFEHLDKL
HEFSSPSHL	HEFSSPSHL
AEIDLRQGRL	AEIDRQGRL
TEHINIHQL	TEHINIHQL
KEVNFTSEL	KEVNFTSEL
KEQESYDNRL	KEQEYDNRL
SESQPHSSAL	SESQHSSAL
KEYESKSLEEL	YESKSLEEL
KEKQWSRDEL	KEKQSRDEL
VEADLVEAL	VEADLVEAL
FEVDTVAP	FEVD-TVAP
AESAVSRDHL	AESASRDHL
REIQEAIAV	REIQEAIAV
GELDLERAPAL	GELDRAPAL
GELIRPTTL	GELIRPTTL
RESLETENVL	RESLTENVL
HEVEVNGTDTL	VEVNGTDTL
AEERWEVVL	AEERWEVVL
VEADIKEFTTL	ADIKEFTTL
REMQEKLARL	REMQKLARL
TEDFIVESL	TEDFIVESL
HEFSKTEEL	HEFSKTEEL
SEYRFPEEL	SEYRFPEEL
SEIFHSQSFL	SEIFSQSFL
FEVDDGTSVL	FEVDGTSVL
QFDDQGKAVIL	FDDQKAVIL
SEEEVKLAL	SEEEVKLAL
RELEEKEQERL	LEEKEQERL
AEVFALIHEL	AEVFLIHEL
GEEENQKRYYL	EEENKRYYL
SEFSGDVDSL	SEFSDVDSL
LENPEGVIL	LENPEGVIL
AEMDARTILL	AEMDRTILL
GEDAMGHTIVL	GEDAMGHTI
AEASVMTQL	AEASVMTQL
IEPGVSVSL	IEPGVSVSL
AESGAKEEL	AESGAKEEL
GELARAVVL	GELARAVVL
GEAGSDVSL	GEAGSDVSL
AEIKDGERL	AEIKDGERL
NEFPVIVRL	NEFPVIVRL
HEADVDVLM	HEADVDVLM
KEAFAKVDL	KEAFAKVDL
SEFGSKIILL	SEFGKIILL
AEALATHIL	AEALATHIL
REVNLVELAL	REVNVELAL
HEIKSLEDL	HEIKSLEDL
AEAEIILQL	AEAEIILQL
HEAATKAVL	HEAATKAVL
LEISKMEVL	LEISKMEVL
VEEAQVITL	VEEAQVITL
LEALPTGTVL	LEALTGTVL
TEATAGNVL	TEATAGNVL
YEEGINIHL	YEEGINIHL
AEFEDLDSLL	AEFEDLDSL
TEEEASKLTAL	EEEAKLTAL
REEEAELVRL	REEEELVRL
GEAEVRTLL	GEAEVRTLL
AEFRKQEEVL	AEFRQEEVL
VELDPEGVAL	VELDEGVAL
AETKDIPAAIL	AETKIPAAI
GEEVGPSVYL	GEEVPSVYL
SEDRAALL	SEDR-AALL
TEIDEKEYISL	TEIDEKEYI
GESAVGKSSL	GESAGKSSL
AEAFAEEL	AEAF-AEEL
KESIIIHQL	KESIIIHQL
KEQLEAEAQAL	LEAE-AQAL
KELEALIQNL	KELELIQNL
KEDEIKQWL	KEDEIKQWL
RELETVRELL	RELEVRELL
REVVAGSHEL	REVVGSHEL
RELYANVVL	RELYANVVL
GEVRLGGSL	GEVRLGGSL
GEDNGQRGYLL	GEDNQRGYL
AEAEHKIDL	AEAEHKIDL
REFPTHRSVL	REFPHRSVL
IEDPGQAYVL	IEDPQAYVL
AEATEEVSL	AEATEEVSL
QEKEAIERL	QEKEAIERL
AEEKIPPSTL	AEEKPPSTL
EIKDLEEQL	EIKDLEEQL
SEKVDRAVL	SEKVDRAVL
AEVEIPGEFL	AEVEPGEFL
GEIKDGLEVML	GEIKGLEVM
KELEANVL	KELE-ANVL
AEAKKIERL	AEAKKIERL
AEASSVKNEL	AEASVKNEL
AEFAALHGPAL	AEFAHGPAL
AEGAYQVRL	AEGAYQVRL
KELEDSLLARL	LEDSLLARL
KEIFETPTEI	KEIFTPTEI
LEADVNIKL	LEADVNIKL
TEYLEPVVL	TEYLEPVVL
FEYFGPDFKL	FEYFPDFKL
GEVGATSAL	GEVGATSAL
EESGAQLLL	EESGAQLLL
FEFGSLDQKL	FEFGLDQKL
KEFLSRSDQL	KEFLRSDQL
GESPVPHTVL	GESPPHTVL
AEAQLAYEL	AEAQLAYEL
LEHLTNEAL	LEHLTNEAL
SEEAKSILL	SEEAKSILL
QEGPVGSTL	QEGPVGSTL
KEAELTEI	KEAE-LTEI
YESHYALPL	YESHYALPL
SESHRFTVL	SESHRFTVL
REIQTAVRL	REIQTAVRL
TEYEKDFSL	TEYEKDFSL
HETPVEVEL	HETPVEVEL
QELFLAHIL	QELFLAHIL
SEMEEEKSIL	SEMEEKSIL
KEAELHLTYL	KEAEHLTYL
AEDTRLIEL	AEDTRLIEL
GEFGEIEAIEL	GEFGEIEAI
KEVEEISLL	KEVEEISLL
GELDHVVEIL	GELDVVEIL
LESNDFEML	LESNDFEML
LEGSKDALL	LEGSKDALL
LEFQKSLETL	LEFQSLETL
LEQQNKILL	LEQQNKILL
REEQAKYYEL	REEQKYYEL
AEIKTTNEVVL	AEIKTNEVV
KELEEEITL	KELEEEITL
EELGLVTHL	EELGLVTHL
KEIYDDLQAL	KEIYDLQAL
REVLSALSQL	REVLALSQL
GEASFPVMV	GEASFPVMV
SEHVVQGDAL	SEHVQGDAL
IEGPDAKL	IEGP-DAKL
GEFKKYLEVVL	GEFKKYLEV
HEILSRDPLLL	HEILRDPLL
GEFSLHEQTVL	GEFSEQTVL
AEDPALKEIVL	AEDPKEIVL
GESATLRSL	GESATLRSL
TETIDTSRVSL	TIDTSRVSL
QEGDLPNAVL	QEGDPNAVL
REQRESLKL	REQRESLKL
GEVLIDTHL	GEVLIDTHL
AEAPSQVRL	AEAPSQVRL
QEVISRAEL	QEVISRAEL
HEVGIGSVL	HEVGIGSVL
GEAHQAETEVL	GEAHETEVL
GELKIAYQL	GELKIAYQL
SEDSSNVVQL	SEDSNVVQL
REFDYVINDL	REFDVINDL
KELGLVDGQEL	KELGDGQEL
REELSNVLAAM	REEL-SNVL
RETKVLGAL	RETKVLGAL
GEHEIDYILL	GEHEDYILL
REFEDVVNIL	REFEVVNIL
KEIIQDVTL	KEIIQDVTL
SETYETKTALL	SETYTKTAL
KENSAPVKL	KENSAPVKL
KETKDVSAL	KETKDVSAL
GEVDDGARKL	GEVDGARKL
AESDKPVVI	AESDKPVVI
SEEGGHVAV	SEEGGHVAV
IEAQINNEDL	IEAQNNEDL
RENWHEEVL	RENWHEEVL
IESPGQDLL	IESPGQDLL
GEVREDLRL	GEVREDLRL
AEFDTPGHTL	AEFDPGHTL
REEPSNPFL	REEPSNPFL
REVLPEHVSVL	REVLEHVSV
AEMQEVGVGL	AEMQVGVGL
QEDEVMRAYL	QEDEMRAYL
TEVPVEPVL	TEVPVEPVL
AEISDVWEEM	AEISVWEEM
QEESLRTYL	QEESLRTYL
TEIGEKGVNL	TEIGKGVNL
ESMVELLDL	ESMVELLDL
REKIDQERL	REKIDQERL
IEFSIPDSL	IEFSIPDSL
KEVEQFTQV	KEVEQFTQV
VEESVTGVHRL	EESVGVHRL
KEDEIPETVSL	DEIPETVSL
AEDELRDAVLL	AEDERDAVL
SEEPAGQIL	SEEPAGQIL
KEFEENTQHLL	KEFENTQHL
GEKFEDENFIL	FEDE-NFIL
AEAIIHGLSSL	AEAIGLSSL
QEEDRTVSL	QEEDRTVSL
SEARVKAEL	SEARVKAEL
QEHEEMNAKL	QEHEMNAKL
AEHKPHIDKL	AEHKHIDKL
QEFVKAFYL	QEFVKAFYL
AEMAMKVEL	AEMAMKVEL
TEHEKVAIL	TEHEKVAIL
AEFPLDPQL	AEFPLDPQL
FESEKEIEL	FESEKEIEL
AEVELKKGATL	VELKKGATL
YEILNNPEL	YEILNNPEL
SELFESPVYL	SELFSPVYL
KEFDGKSLVSV	KEFDGKSLV
REAESFTQL	REAESFTQL
EAHAKVRL	EAHA-KVRL
KELESEKEQL	KELEEKEQL
GEIDVPSHEL	GEIDPSHEL
KEKYIDQEEL	KEKYDQEEL
GETSTDLKL	GETSTDLKL
GEYSEAIPIL	GEYSAIPIL
NEYFTNEVL	NEYFTNEVL
SEEETRVVF	SEEETRVVF
KEVLLENTNL	KEVLENTNL
AEVLRTMEL	AEVLRTMEL
GEIEARYSTGL	IEARYSTGL
QEIEEFQKL	QEIEEFQKL
VEHDAFIFAL	VEHDFIFAL
AEPSSDLASKL	AEPSLASKL
SEESVKSTTL	SEESKSTTL
MELLDGKQTL	MELLGKQTL
SESAPGDFSL	SESAGDFSL
KEAGNINTSL	KEAGINTSL
RESQVSILQSL	RESQ-VSIL
REEDAEKAVI	REEDEKAVI
SEHVASSPAL	SEHVSSPAL
SETEPEPVTL	SETEEPVTL
KEYFSTFGEVL	KEYFFGEVL
RELGFSSNLL	RELGSSNLL
SESSLSGEEL	SESSSGEEL
AEEKSIPTL	AEEKSIPTL
EEAPVQPIL	EEAPVQPIL
REQQAGKDVTL	REQQKDVTL
NEHPGGEEVL	NEHPGEEVL
SELVPGKEEL	SELVGKEEL
KEVAELTRL	KEVAELTRL
AEVETRIEAL	AEVERIEAL
SEVEGGRTAL	SEVEGRTAL
GEVVGKFYL	GEVVGKFYL
HEFHSQENL	HEFHSQENL
HEVQEHFPEAL	HEVQFPEAL
SEFDIEREQL	SEFDEREQL
KEVEQQTGL	KEVEQQTGL
HEAPSSEPSL	HEAPSEPSL
KESQFLKEEL	KESQLKEEL
AEALERMFL	AEALERMFL
LEVAEGGKAEL	LEVAGKAEL
SEIRSDLEQL	SEIRDLEQL
HEAEPVRTL	HEAEPVRTL
AEDPTISLL	AEDPTISLL
SEYEKEITSL	SEYEEITSL
GENEDLLKL	GENEDLLKL
GEIASFDKAKL	GEIADKAKL
SEKVSHVL	SEKV-SHVL
VEVETQGDDL	VEVEQGDDL
GEMEHSAAL	GEMEHSAAL
AEVEVSIPAKL	VEVSIPAKL
AEVEPGVHL	AEVEPGVHL
HEAPSLQEAAL	HEAPQEAAL
FEITQPPLL	FEITQPPLL
GETSTVEKL	GETSTVEKL
GEAVEVIHKL	GEAVVIHKL
REFFDSNGNFL	REFFNGNFL
SEISSATKL	SEISSATKL
REEQGSGGYSL	EEQGGGYSL
VEALTKEEL	VEALTKEEL
WESKSDALETL	WESK-SDAL
IEVDPDTKEML	IEVDTKEML
LESEDEVKL	LESEDEVKL
MEVDTERAML	MEVDERAML
KESEKQLLL	KESEKQLLL
GEIFELKAEL	GEIFLKAEL
IESVIKSNL	IESVIKSNL
REYQELMSVKL	REYQMSVKL
LEAPDETTL	LEAPDETTL
KEDSDEVHL	KEDSDEVHL
REQHDAQVRL	REQHAQVRL
LEAPVSGNQQL	LEAPGNQQL
KEVSMDDHKL	KEVSDDHKL
SEIGQKQKL	SEIGQKQKL
REAEETQSTL	REAETQSTL
AELERNVAL	AELERNVAL
YEDVNPVLL	YEDVNPVLL
RESYVETEL	RESYVETEL
FEEKPEEPVVL	EEKPEPVVL
GEKRPEEVAL	GEKREEVAL
AELQEKFLSL	AELQKFLSL
SEIHSGNSVSL	SEIHNSVSL
KEFNFPEEAVL	KEFNEEAVL
KETGQIVAI	KETGQIVAI
SESQDQVFL	SESQDQVFL
KEGEEQPVL	KEGEEQPVL
TETVVTEYL	TETVVTEYL
LEFPAQEL	LEFP-AQEL
KEVRDLKETL	KEVRLKETL
EEYGGTWEL	EEYGGTWEL
AEPDYVQPQL	AEPDVQPQL
SETINTELL	SETINTELL
GEQGGGKLVL	GEQGGKLVL
SEDQSFVVL	SEDQSFVVL
SELQAIKTEL	SELQIKTEL
QEEDESPRSVL	EEDEPRSVL
REIVRDIKEKL	REIVIKEKL
GESGIKVAVL	GESGKVAVL
NEDGALAVL	NEDGALAVL
HEIQDGTIHL	HEIQGTIHL
REVLEKQPVL	REVLKQPVL
REQEAREPVL	REQEREPVL
MAPERVASL	MAPERVASL
GEIAKSYAEL	GEIASYAEL
RENKTAVVV	RENKTAVVV
REEKDGELNVL	EEKDELNVL
SEDPEPLLL	SEDPEPLLL
KEIGELTQL	KEIGELTQL
KELEAFREEL	KELEFREEL
AEHNPQYLIEL	AEHNPQYLI
REAIDSPVSFL	REAISPVSF
REIEEKLHKL	REIEKLHKL
KEPDRIVGEFL	KEPDVGEFL
RELKEKEATL	RELKKEATL
LEFDEKAVL	LEFDEKAVL
AEADQIIEYL	AEADIIEYL
KEIYNQVNVVL	KEIYVNVVL
GEADPSIQL	GEADPSIQL
KEESMKETL	KEESMKETL
HEVEPRYVVL	HEVERYVVL
TEFLIEPSL	TEFLIEPSL
LEVKENSGYL	LEVKNSGYL
GEITEERDIL	GEITERDIL
KEENSTEEQAL	EENSEEQAL
RELWNQGAGLL	RELWQGAGL
LEPGHTELL	LEPGHTELL
GEARKTEVL	GEARKTEVL
REPLVRQVL	REPLVRQVL
GELTDLHGL	GELTDLHGL
QEAESAVRL	QEAESAVRL
KEDPTVSALL	KEDPTVSAL
EEFDRGIDVSL	EEFDIDVSL
REIQDDMQTL	REIQDMQTL
SEDSHLESL	SEDSHLESL
SELDEEKKIRL	SELDKKIRL
KEFAQIIKI	KEFAQIIKI
TEAQLRYGSAL	AQLRYGSAL
SEIEGIQSL	SEIEGIQSL
RETAEALLQVL	AEAL-LQVL
SEAANRNNDAL	SEAANNDAL
REVEELKSEL	REVELKSEL
REFIAPVTL	REFIAPVTL
KEILSGTKL	KEILSGTKL
EEVQEFHQL	EEVQEFHQL
AEAPLPSPKL	AEAPPSPKL
NESGVRELL	NESGVRELL
LEIDGLEEKL	LEIDLEEKL
KEMDLSVVRL	KEMDSVVRL
RETTEVDLL	RETTEVDLL
TEEPGTGVRL	TEEPTGVRL
YEIHDGMNL	YEIHDGMNL
GEVDVEQHTL	GEVDEQHTL
AEEDHVDLSL	AEEDVDLSL
SSPQPGSAL	SSPQPGSAL
KEESGADQEL	KEESADQEL
HETVTIEL	HETV-TIEL
REILETLIKGL	REIL--ETL
GEFQIVNPHL	GEFQVNPHL
KEIFDKIHSL	KEIFKIHSL
TESDTAVRL	TESDTAVRL
KEFGDDKVQL	KEFGDKVQL
SEHTGAIDVL	SEHTAIDVL
AEFEQGHQFL	AEFEGHQFL
KELEENKRSL	KELENKRSL
AEERRDVSL	AEERRDVSL
YELDLREPAL	YELDREPAL
HEAQAVLGVLL	HEAQVLGVL
AESDEGKLHVL	AESDKLHVL
SEAASSGISL	SEAASGISL
MEYIPEGEIL	MEYIEGEIL
VETATELLL	VETATELLL
GEAPAKSSTL	GEAPKSSTL
KEESIVSSLRL	KEESIVSSL
REIEGDLL	REIE-GDLL
KELILHNPVTL	KELINPVTL
EASDPLPPTAL	ASDPPPTAL
TELPVMVEL	TELPVMVEL
FEEKSGRTFL	FEEKGRTFL
KELENANDLL	KELEANDLL
KELDTVEVL	KELDTVEVL
AEARKSPAL	AEARKSPAL
AEAWMSEQEL	AEAWSEQEL
REGHEEMVAL	REGHEMVAL
YELQESNVRL	YELQSNVRL
AEIKVKELEVL	AEIKELEVL
HEALKENGVT	HEALKENGV
KEAEVQTWL	KEAEVQTWL
AEFVGVSHL	AEFVGVSHL
LEALVPVTI	LEALVPVTI
LESLPSPTL	LESLPSPTL
MESKEKDRQVL	KEKD-RQVL
TEMEEGKDLSL	MEEGKDLSL
IEVENKEVL	IEVENKEVL
RELESQISEL	RELEQISEL
HELSGLNKEEL	HELSNKEEL
REDLALGTQL	REDLLGTQL
PIGRGTKVIL	PIGRTKVIL
IESSDVIRL	IESSDVIRL
KEISDLHYL	KEISDLHYL
GEELPHPKSML	EELPPKSML
SEAPATVEL	SEAPATVEL
AEVEAQKAQQL	VEAQKAQQL
REAAYNAITL	REAANAITL
FEAQGKPEL	FEAQGKPEL
REIVAISSAQL	REIVSSAQL
AEERSQFEIL	AEERQFEIL
KEHVIEKEEL	KEHVEKEEL
EEKAAVTSL	EEKAAVTSL
KELESVGIRL	KELEVGIRL
GEGALVNDVL	GEGAVNDVL
HEVMEQQTI	HEVMEQQTI
IEWRDRRITL	IEWRRRITL
HEQANVESL	HEQANVESL
REPFPDGAEL	REPFDGAEL
GEAPAEMGAL	GEAPEMGAL
TESDPDNVVL	TESDDNVVL
AEPAEALVL	AEPAEALVL
AENPGKYNIL	AENPKYNIL
EDLAHSSI	EDLA-HSSI
GSETLKHLVL	SETLKHLVL
SEDYIKSGALL	SEDYKSGAL
AEFHTELERL	AEFHELERL
FEDKSAYAL	FEDKSAYAL
GEVFRVVDTL	GEVFVVDTL
SEWDGHEEL	SEWDGHEEL
VEIDGERIKI	VEIDERIKI
REPGENGTSL	REPGNGTSL
KEIESTKGEL	KEIETKGEL
REIGTVIDQI	REIGVIDQI
SEGDPDLVL	SEGDPDLVL
REHSSLGHADL	REHSGHADL
AEIAQLMSL	AEIAQLMSL
NEFNPMGDTL	NEFNMGDTL
GEEEDGPVL	GEEEDGPVL
QEDLWTKIIL	QEDLTKIIL
QESVPDPEL	QESVPDPEL
REAPERPSL	REAPERPSL
GEDGLPTPAL	GEDGPTPAL
SEHSTEGSVSL	SEHSGSVSL
GESKYLMAL	GESKYLMAL
KEDRGRPYTL	KEDRRPYTL
QEIEDWSKL	QEIEDWSKL
SESAAVKEIL	SESAVKEIL
IEDSRVYEL	IEDSRVYEL
GEDGSGKTTL	GEDGGKTTL
GEMTALREEL	GEMTLREEL
REFTDSAEAKL	REFTAEAKL
AELIEEEVAKL	AELIEVAKL
GEEQTQDTEL	GEEQQDTEL
TAPTGHTL	TAPT-GHTL
KEVATDVRL	KEVATDVRL
SEVKEDVVL	SEVKEDVVL
RETELSSVTL	RETESSVTL
KEIDKEEHL	KEIDKEEHL
AEFDDRRGVL	AEFDRRGVL
KEYSDDKVQL	KEYSDKVQL
AEMVSENDVI	AEMVENDVI
HEAWQGLGEVL	HEAWLGEVL
SEEHIELVVL	SEEHELVVL
SEIKGEVLYL	SEIKEVLYL
GEHIIAGAGEL	GEHIGAGEL
VEHWGLDQPL	VEHWLDQPL
SEAKGLVTL	SEAKGLVTL
RELEEKAMEEL	LEEKAMEEL
YELPDGQVI	YELPDGQVI
QELEILTDRL	QELELTDRL
WEIEDNQLL	WEIEDNQLL
HEDLGHVAL	HEDLGHVAL
TEAQVTQEL	TEAQVTQEL
GEHVILGTGEL	GEHVGTGEL
AEQVDAVTL	AEQVDAVTL
FEAEVLHTVL	FEAELHTVL
QEDNPSGVIL	QEDNSGVIL
KEIASEIIGL	KEIAEIIGL
SEPQDPAAVSL	SEPQAAVSL
FEFPEFQL	FEFP-EFQL
SEDGQPMVL	SEDGQPMVL
QEEPVQPLL	QEEPVQPLL
VEEPSDGTIL	VEEPDGTIL
KETQEKMTIL	KETQKMTIL
REFPEADAEKL	REFPDAEKL
SEPSSTVSL	SEPSSTVSL
SEVVGSSTL	SEVVGSSTL
REVSEEHNLL	REVSEHNLL
GEIINTHTLL	GEIINTHTL
NEFPEPIKL	NEFPEPIKL
KEYEEKGGEYL	YEEKGGEYL
REWTEQETL	REWTEQETL
SEHPDQAQAIL	SEHPQAQAI
AEVEGIGEAL	AEVEIGEAL
VEALIQSADTL	ALIQSADTL
KEIQWETRL	KEIQWETRL
TETPSPVL	TETP-SPVL
AELKQIVDQSL	AELKVDQSL
YESGEYEML	YESGEYEML
HEGLPEPVTL	HEGLEPVTL
SEFHPNPDVL	SEFHNPDVL
RENGQEILL	RENGQEILL
AEVSPDAKTSL	AEVSAKTSL
TEHGVEVVL	TEHGVEVVL
TEADVEEALRL	TEADVEEAL
TEAVVDSIL	TEAVVDSIL
GEEILITVL	GEEILITVL
VEQPAQEL	VEQP-AQEL
QEQQENPRL	QEQQENPRL
AEAKSVWAL	AEAKSVWAL
LEFEGGEVSL	LEFEGEVSL
GEPLDNFESL	GEPLNFESL
IEHLLPLFL	IEHLLPLFL
FEVEKQALL	FEVEKQALL
NEFHSPIGL	NEFHSPIGL
KEEADGVHNTL	EEADVHNTL
AEIDASNIVSL	AEIDNIVSL
LEEAADLLV	LEEAADLLV
HELDMQVAAL	HELDQVAAL
REFEDQKLTML	FEDQKLTML
KENATVAHL	KENATVAHL
GEIKSHDL	GEIK-SHDL
HESLQNPLL	HESLQNPLL
SEVNPSVEL	SEVNPSVEL
TEPTEDSGISL	TEDS-GISL
TEDRIQHAL	TEDRIQHAL
QEETGVRVEL	QEETVRVEL
AEAFEAIPRAL	AEAFIPRAL
KEKIQPEIL	KEKIQPEIL
RETDDTLVL	RETDDTLVL
KESESSLDVSL	SESSLDVSL
SEDRNAGVIL	SEDRAGVIL
VEEGKSITL	VEEGKSITL
REDEEQNVKL	REDEQNVKL
AEHPAGHLVL	AEHPGHLVL
VEFADEVRL	VEFADEVRL
GELQESQSRL	GELQSQSRL
HEQASNVL	HEQA-SNVL
GEDKGGYVI	GEDKGGYVI
LEVDLRDPVL	LEVDRDPVL
AELKEKYISL	AELKKYISL
REIAEVNKKL	REIAVNKKL
AEQEIARLVL	AEQEARLVL
AEAAEKGDVGL	AEAAGDVGL
DPLGAIHL	DPLG-AIHL
KEALTYDGALL	KEALYDGAL
AESSPDPQAL	AESSDPQAL
REEIEKQAL	REEIEKQAL
TEVGITNVDL	TEVGTNVDL
AESSPAKKDVL	AESSKKDVL
SEVMSKEEIL	SEVMKEEIL
SEAPSQPSL	SEAPSQPSL
AEMGSERALVL	AEMGSERAL
SEEQNSQFQSL	EEQNQFQSL
KELTIGSKL	KELTIGSKL
REEVGNISI	REEVGNISI
KEAENPREVL	KEAEPREVL
AEHRTPDVL	AEHRTPDVL
FEAPDQKTL	FEAPDQKTL
LEAEADKIGL	LEAEDKIGL
HEYFPEMQIL	HEYFEMQIL
GEDTLMEYL	GEDTLMEYL
AEDPLVQSL	AEDPLVQSL
AEFEKSAKENL	FEKSAKENL
KELPITGTDL	KELPTGTDL
SEDPSHPSM	SEDPSHPSM
TEVLVTAEKL	TEVLTAEKL
NEFKEKGIGTL	KEKG-IGTL
GEAGPGRAL	GEAGPGRAL
KESDNNVKL	KESDNNVKL
VEANYPETL	VEANYPETL
IEFSDKESV	IEFSDKESV
TEIGKDVIGL	TEIGDVIGL
HEVTSQTSHL	HEVTQTSHL
YEHEDIKKGIL	HEDIKKGIL
AEIEDIRVL	AEIEDIRVL
SEEVSRSEL	SEEVSRSEL
TENLVRELL	TENLVRELL
GEEQNRVQL	GEEQNRVQL
SEVIGPVSL	SEVIGPVSL
SEVEPSVNADL	VEPSVNADL
AEKLGETEKL	AEKLETEKL
REPVQLETL	REPVQLETL
REMEENFAV	REMEENFAV
KEFDGKSLV	KEFDGKSLV
SEDKQLHEL	SEDKQLHEL
KEIEDAEKYSF	KEIEDAEKY
KEKDFSPEAL	KEKDSPEAL
VEIKELQGQL	VEIKLQGQL
REKDDDVVSL	REKDDVVSL
IEEERNVPL	IEEERNVPL
YEGSPIKVTL	YEGSIKVTL
GELEAERQAL	GELEERQAL
TESGLNVTL	TESGLNVTL
TASGVNQLVDI	SGVNQLVDI
GEDGAWQGSQL	GEDGQGSQL
SEIEEFYQKL	SEIEFYQKL
KEEMGIGGVL	KEEMIGGVL
AEDPETQVVL	AEDPTQVVL
KEDFSSFQL	KEDFSSFQL
TEEKLTPVLL	TEEKTPVLL
KEMEDTQRL	KEMEDTQRL
EDKKITVLL	EDKKITVLL
GELHGHFML	GELHGHFML
REFQNPPQL	REFQNPPQL
SEQTGKELL	SEQTGKELL
GEIRGYEL	GEIR-GYEL
GEADNLDEFL	GEADLDEFL
REDAPIGPHL	REDAIGPHL
GEEPGIKSQL	GEEPIKSQL
REESESVLTL	REESSVLTL
LEEPRGQQEVL	EEPRQQEVL
LESQGIERL	LESQGIERL
REMTSKLLSDL	REMT-SKLL
TEGEDKITL	TEGEDKITL
SELKKVVAL	SELKKVVAL
SEWKDTNYTL	SEWKTNYTL
KEAELKDLLL	KEAELKDLL
SEFKYNKPAFL	SEFKNKPAF
AEALPRPNWEL	AEALPNWEL
KEYQNVHEEVL	KEYQHEEVL
SESHVHSLL	SESHVHSLL
QEEMDSNKVSL	EEMDNKVSL
EEEPLHTIL	EEEPLHTIL
REMEEKVTLL	REMEEKVTL
REIRHPNIITL	REIRHPNII
MEHAGKNQVL	MEHAKNQVL
REMEQSMNML	REMESMNML
SEDPNQAKL	SEDPNQAKL
HETLEQRLLVT	HETLEQRLL
GEEHPRGSIL	GEEHRGSIL
KEFDQNVKL	KEFDQNVKL
REVLPESLPVL	REVL-PESL
REHEIGEWEAF	HEIGEWEAF
VEINEKFTEL	VEINKFTEL
YEFEGGVKL	YEFEGGVKL
GEGPLDVRL	GEGPLDVRL
REYEDNDEVHI	REYEDNDEV
REAQVWEML	REAQVWEML
SETEAKALL	SETEAKALL
REHALLAYTL	REHALAYTL
AEPEEVEVL	AEPEEVEVL
SEMIDKLTL	SEMIDKLTL
IESPLFLKL	IESPLFLKL
GEVFPTTEVL	GEVFTTEVL
FEEHNSMNEL	FEEHSMNEL
HEFSREPSL	HEFSREPSL
REIAGKMDL	REIAGKMDL
AELQPTESL	AELQPTESL
VEFFHVEDL	VEFFHVEDL
AEFLPDPSAL	AEFLDPSAL
KEIPIPFYL	KEIPIPFYL
GENPASHSYVL	GENPHSYVL
AEAGADLVLL	AEAGDLVLL
REGRPIWQL	REGRPIWQL
VEDITPPRL	VEDITPPRL
KEYLDNVQL	KEYLDNVQL
AEEREKTVL	AEEREKTVL
