Data	Data aligned
RELKKLLVA	RELKKLLVA
MELERIVSA	MELERIVSA
READGILKP	READGILKP
REIQDAVARA	REIQAVARA
KEAEFLQKLLP	AEFLQKLLP
LAPTDVKEL	LAPTDVKEL
RESTKISSLLA	RESTKISSL
GEFGGFGSVT	GEFGGFGSV
KEMEVSPSA	KEMEVSPSA
REHQFYETLP	REHQFYETL
QETSSIVSV	QETSSIVSV
AENELGVVVA	AENEGVVVA
TEHGVKVTA	TEHGVKVTA
LELEMNSDLKA	LEMNSDLKA
KEFENPEVP	KEFENPEVP
GEGTFGRVV	GEGTFGRVV
TEIGSIHSA	TEIGSIHSA
IENIQRVAA	IENIQRVAA
SEWKFTITPP	SEWKFTITP
AELADVLTEA	AELAVLTEA
HEMFPAVHAA	HEMFAVHAA
QEFPFPETP	QEFPFPETP
TELRTEEKVVA	TELRTEEKV
RDGSFTVSA	RDGSFTVSA
KEISAQIRA	KEISAQIRA
REHFFTSRA	REHFFTSRA
KEYAAFVLGA	KEYAFVLGA
HESGELNQYSA	GEL-NQYSA
GEIRGFETA	GEIRGFETA
AEFHQIEGV	AEFHQIEGV
ADIRGFVA	ADI-RGFVA
GELREQLKA	GELREQLKA
AEARLISA	AEA-RLISA
FEFTGSHLTV	FEFTSHLTV
REYSRYLHA	REYSRYLHA
LETTVQKVA	LETTVQKVA
KEYFGIVSV	KEYFGIVSV
KEFEGKTLVSV	KEFEGKTLV
FEIKKPPVS	FEIKKPPVS
GEAPSKTLVET	GEAPSKTLV
REALVKFEA	REALVKFEA
RELAQQVQQVA	RELAQVQQV
SEYNFEDLSA	SEYNEDLSA
REIDVRIDRNA	REIDRIDRN
SSEFQIPTA	SSEFQIPTA
AELLRGFVA	AELLRGFVA
KEGVFAKEV	KEGVFAKEV
GENPHPITP	GENPHPITP
RELVKNWVP	RELVKNWVP
KEVNLFLQA	KEVNLFLQA
VDVTLPKA	VDV-TLPKA
GEIASFDKA	GEIASFDKA
REIVAISSA	REIVAISSA
NELPQPPVP	NELPQPPVP
SEHSKAILA	SEHSKAILA
HEKQVYDIAA	HEKQYDIAA
REYQVKLQA	REYQVKLQA
RENFFPVTV	RENFFPVTV
KEIPHLVAV	KEIPHLVAV
SELITKAVAA	SELIKAVAA
TEYTKLWTP	TEYTKLWTP
AEMTTRMVA	AEMTTRMVA
SEAKQMPRA	SEAKQMPRA
GELRISVLP	GELRISVLP
AEVSPMYGV	AEVSPMYGV
KEMGGHHIV	KEMGGHHIV
SEYNMLWHA	SEYNMLWHA
HEISEGNVA	HEISEGNVA
GERDFGVKA	GERDFGVKA
AEHGSFRVT	AEHGSFRVT
KEYGQIESVRF	KEYGQIESV
GEWPDQPRI	GEWPDQPRI
LELVNIHAV	LELVNIHAV
REPPADVWTPP	REPPDVWTP
AELVRLREA	AELVRLREA
REAIIVGSIIT	REA-IIVGS
KELASALKSA	KELAALKSA
AEWKDGLNEA	AEWKGLNEA
YEREQVIAA	YEREQVIAA
TEFEKILKT	TEFEKILKT
KEVEASHLA	KEVEASHLA
AEVAKITAEA	AEVAITAEA
AAPAYSRAL	AAPAYSRAL
AELYHIISS	AELYHIISS
SEHGLVVIAP	SEHGLVVIA
GETDLIQKA	GETDLIQKA
HESRQITQV	HESRQITQV
GEQEPPPPP	GEQEPPPPP
VENPGGYVA	VENPGGYVA
RETTISKV	RET-TISKV
IELTPPKGYEA	IELTKGYEA
REYKTSFHA	REYKTSFHA
KEAEPIPETV	KEAEPIPET
KEFHKQITA	KEFHKQITA
GELKTQMTSA	GELKQMTSA
AEYAGLKVA	AEYAGLKVA
VESASETIRSA	SASETIRSA
RETYGHLSA	RETYGHLSA
GELKVVNGAAA	GELKVVNGA
AEGEGISKV	AEGEGISKV
AEHFSMIRA	AEHFSMIRA
GEVPTAVAP	GEVPTAVAP
SSSKGSLGGGF	SSSKGSLGG
KEIAAVIETV	KEIAVIETV
REFPTHRSV	REFPTHRSV
REALTHRKIIA	REALTHRKI
IEVSLPEAA	IEVSLPEAA
KEIGGLTQV	KEIGGLTQV
AEVRVIAPP	AEVRVIAPP
REVKTGALLSA	REVKALLSA
HEIIQHEV	HEI-IQHEV
SEHVMPYAA	SEHVMPYAA
AEIYEQHVT	AEIYEQHVT
RELVAIKKV	RELVAIKKV
GEYQGIPRA	GEYQGIPRA
HEVDTQYSA	HEVDTQYSA
AEALNVFQQA	AEALVFQQA
KEGPVASPP	KEGPVASPP
GEIDASLKA	GEIDASLKA
REMLIRVN	REM-LIRVN
RELENGNLEV	RELEGNLEV
AEKKFIDIAA	AEKKIDIAA
AEIKQGIREV	AEIKGIREV
IIHEIAVLEL	HEI-AVLEL
AEINKSDHVAA	AEINSDHVA
KELVIPDSA	KELVIPDSA
REVEILNKT	REVEILNKT
HESAAHAIV	HESAAHAIV
LTQALKDNK	LTQALKDNK
LERDPIPAA	LERDPIPAA
HEVQMDHRP	HEVQMDHRP
SEILMQNWDA	SEILQNWDA
KEWTGLHDA	KEWTGLHDA
KELEEIVQP	KELEEIVQP
KEHEEFQITA	KEHEFQITA
REFLFNAIET	REFLNAIET
KEIYVISA	KEI-YVISA
AEIKIIREA	AEIKIIREA
KEFAAIVDV	KEFAAIVDV
GEIPAELRAA	GEIPELRAA
REVSDGIIAP	REVSGIIAP
AEPPPIKSA	AEPPPIKSA
HLPETKFSEL	PET-KFSEL
KEIQYGIRA	KEIQYGIRA
YEFGQIINA	YEFGQIINA
AEINQKLPVA	AEINKLPVA
QEHPVVLLP	QEHPVVLLP
LEQGGLRAA	LEQGGLRAA
YESLVHAVA	YESLVHAVA
KEFGAVSKVDF	KEFGAVSKV
GEALGLKQA	GEALGLKQA
KEAQLYAA	KEA-QLYAA
KEKEIQWET	KEKEIQWET
GELPRQPTT	GELPRQPTT
AEVLITTRTA	AEVLTTRTA
RELEKAKVAA	RELEKAKVA
AEHPGFMKT	AEHPGFMKT
REYPNLVTI	REYPNLVTI
GEKVLVKAA	GEKVLVKAA
RELQGLQNFP	RELQLQNFP
SEVSIDHKA	SEVSIDHKA
GEYLPSKGA	GEYLPSKGA
YEWARDHRA	YEWARDHRA
SELPIVTPA	SELPIVTPA
REHEIGEWEA	REHEGEWEA
AEAGPLASVPA	AEAGPLASV
KEAPAQPAP	KEAPAQPAP
KEFQKSLGA	KEFQKSLGA
KEFGDQAEAA	KEFGQAEAA
REGNLRYSA	REGNLRYSA
REMIPFAVV	REMIPFAVV
LEIAKANAA	LEIAKANAA
REIFLSQPILL	REI-FLSQP
REVSTGTTIMA	REVSTGTTI
RESEVVSTITA	SEVVSTITA
TTPTIVPVIP	TPTIVPVIP
HEIESLYTKL	HEIESLYTK
QEFVRALAA	QEFVRALAA
AEQPSELVSA	AEQPELVSA
KEVEVQLLP	KEVEVQLLP
GDVLTPEQA	GDVLTPEQA
SEYEKPEAP	SEYEKPEAP
GEVNVLDNLAA	GEVNLDNLA
REHSVFTGV	REHSVFTGV
TVGNNKTL	TVG-NNKTL
AELLVRHGA	AELLVRHGA
KEVVIVSA	KEV-VIVSA
LEAIITPPPA	LEAITPPPA
KEYLQGLEA	KEYLQGLEA
AEVELKRDEA	AEVEKRDEA
GEYAKLEKI	GEYAKLEKI
FEVKKWNAV	FEVKKWNAV
QEFEIPTGREA	FEIPTGREA
REFAKALET	REFAKALET
GEFEKKYVAT	GEFEKKYVA
GEPDPPPAA	GEPDPPPAA
QEIADLKTA	QEIADLKTA
HEFRDKLAA	HEFRDKLAA
SETANYISA	SETANYISA
SELQLPFQA	SELQLPFQA
GEFQEVVRA	GEFQEVVRA
TELIQHSA	TEL-IQHSA
KELEKTYSA	KELEKTYSA
YEVQQVPKV	YEVQQVPKV
KEIYPGQFQP	KEIYGQFQP
GEADVPFYYA	GEADPFYYA
SEKKAEIPP	SEKKAEIPP
AETPIRSP	AET-PIRSP
QETISLVVV	QETISLVVV
YEHIQVSRA	YEHIQVSRA
QEFQRAQAA	QEFQRAQAA
AEFYRQVAS	AEFYRQVAS
RELEAERQIVA	LEAERQIVA
KEFQLFQGV	KEFQLFQGV
DAAPPSAPP	DAAPPSAPP
GEIVRLTTP	GEIVRLTTP
REWLRVTTV	REWLRVTTV
VEFHRLWSA	VEFHRLWSA
KEFQDLREV	KEFQDLREV
KEMPVKVEA	KEMPVKVEA
GEFEKKYVA	GEFEKKYVA
REIELKVMKF	REIEKVMKF
REIIINAV	REI-IINAV
AEINNIIKI	AEINNIIKI
GEYIKTWRP	GEYIKTWRP
GEAEAFAIGA	GEAEFAIGA
AELLVKHGA	AELLVKHGA
GENTRSVIP	GENTRSVIP
KEIQSSNLETA	KEIQSNLET
KEIGDVENWA	KEIGVENWA
HEQFIPIA	HEQ-FIPIA
SEGRPVGPA	SEGRPVGPA
SVPEAQSAL	SVPEAQSAL
AEYDNFFQHL	AEYDFFQHL
RDFAARLV	RDF-AARLV
DEFHPFIEA	DEFHPFIEA
SEHVIAIRA	SEHVIAIRA
SEVQFGHAGA	SEVQGHAGA
FEMATRAALQA	FEM-ATRAA
RESDKMWLV	RESDKMWLV
REAEMRNSILA	AEMRNSILA
EEYEWKETA	EEYEWKETA
LDFLAPAKA	LDFLAPAKA
AEVSVPKELVA	AEVSVPKEL
SEGNVVNKP	SEGNVVNKP
MEFAQISRV	MEFAQISRV
AEIDEEPVS	AEIDEEPVS
KEFPNQTGA	KEFPNQTGA
REIAVQIHSV	REIAQIHSV
SEIDQVVPA	SEIDQVVPA
YEFLVGKPP	YEFLVGKPP
KEPEYVPWTA	KEPEVPWTA
AEFKEAFSLF	AEFKEAFSL
GEMKGSAIT	GEMKGSAIT
SEMRAVIKA	SEMRAVIKA
QEYFGSLAA	QEYFGSLAA
GEVVQIRP	GEV-VQIRP
GEWKGPQVS	GEWKGPQVS
NERAIAGALIA	RAIAGALIA
TELELFKA	TEL-ELFKA
HEIEVIGGYLA	IEVIGGYLA
READFARVA	READFARVA
SEHSVIKPP	SEHSVIKPP
YESLVHAVAGA	YESLVHAVA
AEYLQPKAA	AEYLQPKAA
AELEGREQVA	AELEREQVA
KEHVKWVHA	KEHVKWVHA
SEADKIKVA	SEADKIKVA
SESEKQWKA	SESEKQWKA
YETPTGIKVV	YETPGIKVV
GETFKFKEA	GETFKFKEA
KEIFLRELI	KEIFLRELI
HEHPLYRA	HEH-PLYRA
FEWENKVTV	FEWENKVTV
RETQNLQVP	RETQNLQVP
AEMNGKLIAA	AEMNKLIAA
REYQDLLNV	REYQDLLNV
YEAALNSKDAA	YEAANSKDA
KQQAPPPPP	KQQAPPPPP
RESPFSTSA	RESPFSTSA
GEISRMREV	GEISRMREV
KEAEQILAT	KEAEQILAT
AEKIDGVFAA	AEKIGVFAA
TVTEKPEVID	TVTEKPEVI
REKLIQDHMA	REKLQDHMA
RDKYEPAAV	RDKYEPAAV
AEEGPGVPAA	AEEGGVPAA
GEQEGAMVAA	GEQEAMVAA
REAQFGTTA	REAQFGTTA
TEIDPINALQA	TEIDPINAL
KEYFPVQVV	KEYFPVQVV
QEMPVQFQV	QEMPVQFQV
KELNEAVAA	KELNEAVAA
AELQRRFQAA	AELQRRFQA
SELRAMAKA	SELRAMAKA
LEYDPLSNYSA	LEYDSNYSA
AELGKLYSV	AELGKLYSV
SELGKGPLAA	SELGGPLAA
KEAEAQLWWAA	AEAQLWWAA
REAEFTKSIA	REAETKSIA
MEHIHKLKA	MEHIHKLKA
AEQQKAQFTA	AEQQAQFTA
AENRRLHELRI	AENRRLHEL
SEYNNFKSMVV	SEYNFKSMV
SEYEGILDA	SEYEGILDA
SEVELMKVA	SEVELMKVA
VEALIHAA	VEA-LIHAA
TEADPEMIKRA	ADPEMIKRA
GEIVALKKV	GEIVALKKV
LEFPQLIRV	LEFPQLIRV
AEALLHPFFA	AEALHPFFA
GEYSKVLAI	GEYSKVLAI
HEASGTTAITA	HEA-SGTTA
AEYLYFFRV	AEYLYFFRV
AELATRAIP	AELATRAIP
GEFAKLSKI	GEFAKLSKI
AEMTTRMVAS	AEMTTRMVA
KQFAEMYVA	KQFAEMYVA
LEHDVPHQP	LEHDVPHQP
KDYLAAIA	KDY-LAAIA
REKFPEKIP	REKFPEKIP
AEFVSTPELAA	AEFVTPELA
EEFDHLPPP	EEFDHLPPP
FEVAMQKMIP	FEVAQKMIP
KEFTEAVEA	KEFTEAVEA
REFPVISVV	REFPVISVV
RETHILRQV	RETHILRQV
KEIEVGGGRKA	IEVGGGRKA
LELPGQPVA	LELPGQPVA
GEALMYHT	GEA-LMYHT
SEFKSIKKT	SEFKSIKKT
GEFPDLHRT	GEFPDLHRT
KEISKLYQDM	KEISKLYQD
LEFADQENQVA	LEFAQENQV
KEINKIVAA	KEINKIVAA
IEGQGVFREA	IEGQVFREA
SEYLQQHVA	SEYLQQHVA
KEILAQVA	KEI-LAQVA
SEKSAPEVTA	SEKSPEVTA
KEIFQTTVP	KEIFQTTVP
KEFLVVASV	KEFLVVASV
TEVAPPPPP	TEVAPPPPP
AEHDSILAEKA	AEHDLAEKA
HDITVPLEV	HDITVPLEV
GEMASAQYITA	GEMAAQYIT
REGDLLFTV	REGDLLFTV
REFSDFIRV	REFSDFIRV
GEFGTIPLVL	GEFGTIPLV
YEKEEDWRNAA	KEEDWRNAA
VEYEVPEAA	VEYEVPEAA
QEVDRIKEA	QEVDRIKEA
AETKDLLVAA	AETKLLVAA
NEPSQFSEP	NEPSQFSEP
RELSEQIQRA	RELSQIQRA
KEFTKLEEV	KEFTKLEEV
NNGSFLAIKAA	GSFLAIKAA
SEQIMKTGA	SEQIMKTGA
AEVAGQFVI	AEVAGQFVI
REIMPVSTQA	REIMVSTQA
GEMLGRHIVA	GEMLRHIVA
KELALNTA	KEL-ALNTA
SEKLASYQA	SEKLASYQA
AEKSITQVA	AEKSITQVA
GETLLHRA	GET-LLHRA
SEIEMAKA	SEI-EMAKA
GEIRDLKTKT	GEIRLKTKT
REMANLPVPSL	REMANLPVP
AEIKMLYEQL	AEIKLYEQL
KEQIIHHVA	KEQIIHHVA
SESGIQMVP	SESGIQMVP
FEKSPPVSA	FEKSPPVSA
ADIQVSAA	ADI-QVSAA
TELELFKAA	TELELFKAA
REFSDFIQAV	REFSDFIQA
RERPPEEVA	RERPPEEVA
SEFGAPVSV	SEFGAPVSV
QEVNGLYRA	QEVNGLYRA
RENGFHGLVA	RENGHGLVA
GELNQYSA	GEL-NQYSA
SELERLIVP	SELERLIVP
HETPKQPVVRF	HETPKQPVV
REWGEELQA	REWGEELQA
KEFKGFGTEV	KEFKFGTEV
KEIDAYIVQA	KEIDYIVQA
GEFPDLHRTIV	GEFPDLHRT
KEVPLAQTA	KEVPLAQTA
REVAAAVRA	REVAAAVRA
AEAQLRIDSA	AEAQRIDSA
GENSILGQLKA	GENSGQLKA
AEAIRILAA	AEAIRILAA
SEVLLRHIA	SEVLLRHIA
KEVEILKDIRA	VEILKDIRA
AEIEKFDKS	AEIEKFDKS
KEFLGHRIV	KEFLGHRIV
AETAVSVIP	AETAVSVIP
AERDLERAEVA	RDLERAEVA
REVTVKGIDA	REVTKGIDA
FEHAHNMRV	FEHAHNMRV
LSEFMNPSP	LSEFMNPSP
REWAHPRSI	REWAHPRSI
KELERLKSV	KELERLKSV
GELKEQYST	GELKEQYST
REHPKLKAP	REHPKLKAP
GEARPGPTA	GEARPGPTA
AELYFHDSA	AELYFHDSA
REMEEKYIVSA	REMEEKYIV
KEMEKSFEV	KEMEKSFEV
KELEALMPSA	KELELMPSA
AEIKNLFTKT	AEIKLFTKT
REIEWREKA	REIEWREKA
HELITTERA	HELITTERA
REWVAPEKA	REWVAPEKA
HEWVVKES	HEW-VVKES
GERSGLKPP	GERSGLKPP
AELQEQLRA	AELQEQLRA
GEKALLVSA	GEKALLVSA
FENLGIQPP	FENLGIQPP
AEIQELHQS	AEIQELHQS
TEFDRQAEV	TEFDRQAEV
AEAGALPAAA	AEAGALPAA
REHDIAIKF	REHDIAIKF
AETRVFLEV	AETRVFLEV
AEVEKIIAV	AEVEKIIAV
KEFIKIVEA	KEFIKIVEA
GEITTGPRVSA	GEITTGPRV
EEIKDFLLTA	EEIKFLLTA
KEAGDFHFQPA	KEAGFHFQP
WEVDVSKKTA	WEVDSKKTA
YEKEGEFVA	YEKEGEFVA
HEYPWILSA	HEYPWILSA
SEADIRGFVAA	ADIRGFVAA
AELLPLVSA	AELLPLVSA
SEINSLPTI	SEINSLPTI
GEVIVKGATSA	GEV-IVKGA
AEITELILKA	AEITLILKA
GEFREPRPP	GEFREPRPP
TISSNVASKA	ISSNVASKA
REALFNEFVA	REALNEFVA
VEFNGKLLA	VEFNGKLLA
HEVVAHWIA	HEVVAHWIA
TETDSLVSA	TETDSLVSA
REASSEELKAA	REASEELKA
AEAAAAVVAA	AEAAAVVAA
KEIESIVKA	KEIESIVKA
IESRTLAIA	IESRTLAIA
RETYGHLGA	RETYGHLGA
GEYGKFFVT	GEYGKFFVT
REMILADFQA	REMIADFQA
REAEIYQTV	REAEIYQTV
AEFPLGPVTTA	AEFPGPVTT
KEFIGNMITTA	KEFINMITT
REVEVFKSS	REVEVFKSS
YEKILFTEA	YEKILFTEA
LELIGHAVA	LELIGHAVA
VEAFLKEAA	VEAFLKEAA
AEVKQELAA	AEVKQELAA
IEYARQLEMIV	IEYARQLEM
REAGFQVKA	REAGFQVKA
GEMPRHFAA	GEMPRHFAA
TATPGAPAQP	TATPAPAQP
REIEATGLQT	REIETGLQT
YPGPDEKAP	YPGPDEKAP
REILRPWHA	REILRPWHA
KDFIIFEA	KDF-IIFEA
SEWDGIVTV	SEWDGIVTV
SELRAMAKAA	SELRAMAKA
AETPGVPSP	AETPGVPSP
AEAVFASEV	AEAVFASEV
MEYKGYLVS	MEYKGYLVS
GESNRLLSA	GESNRLLSA
FEKALEEKP	FEKALEEKP
AETELQRAA	AETELQRAA
REAQSFISA	REAQSFISA
TELDRVHIV	TELDRVHIV
KEAFAIVSV	KEAFAIVSV
EKLDVREKSK	EKLDVREKS
TEINRLPSA	TEINRLPSA
HEIGHGIAA	HEIGHGIAA
KEFEQLRKV	KEFEQLRKV
REGNVPNIIIA	REGNNIIIA
AELSQPLTA	AELSQPLTA
GEFVDLYVP	GEFVDLYVP
QETEFLSPP	QETEFLSPP
REVWLYEQV	REVWLYEQV
IELPNIQKV	IELPNIQKV
IEHDVVMKA	IEHDVVMKA
MEYPNFEET	MEYPNFEET
LEIPRLPPP	LEIPRLPPP
SEAKSVPKP	SEAKSVPKP
AELDQLLAV	AELDQLLAV
KEYLFYAEA	KEYLFYAEA
YEFLKSWTV	YEFLKSWTV
QETVAQIKA	QETVAQIKA
KEMENFEAP	KEMENFEAP
IEYPTLHVV	IEYPTLHVV
SELSGVISSA	SELSVISSA
AEGKGGFIRA	AEGKGFIRA
AEIDLFRAA	AEIDLFRAA
MELQRMIAA	MELQRMIAA
KEVDLIPKV	KEVDLIPKV
KEFLMENRV	KEFLMENRV
AEQRLKAIVA	AEQRKAIVA
AESPGVPVA	AESPGVPVA
SETPQLFTV	SETPQLFTV
KEVEQFTQV	KEVEQFTQV
GAEMIRAAPP	AEMIRAAPP
REYEIEFIYA	REYEEFIYA
LEYTGIYRV	LEYTGIYRV
EEHEWFIPA	EEHEWFIPA
AEAFGKIVA	AEAFGKIVA
AEFVPQLEA	AEFVPQLEA
SETALIHIA	SETALIHIA
REVADFAVQPA	REVAFAVQP
YEVTPDDKRKA	YEVTDKRKA
REAEHLYHTL	REAEHLYHT
REFVGQLVA	REFVGQLVA
TEAPLNPKA	TEAPLNPKA
GEYDVTMPKV	GEYDTMPKV
VETSKKWAA	VETSKKWAA
RELDVEEAHAA	REL-DVEEA
GEFHLWYQV	GEFHLWYQV
LEALPQIAA	LEALPQIAA
KEANVKLRA	KEANVKLRA
AEYRHPTVP	AEYRHPTVP
SEFKDLILP	SEFKDLILP
YELDLGLNHVV	YELDGLNHV
YEAPGVREA	YEAPGVREA
GETKLLQA	GET-KLLQA
KEYDALKAA	KEYDALKAA
REIRIYTDA	REIRIYTDA
SEVKPPRDITA	SEVKRDITA
AEGPVAVVV	AEGPVAVVV
SEWLGVLKA	SEWLGVLKA
AEFQVKITA	AEFQVKITA
SEGARNIVAA	SEGANIVAA
KEVVGTFKA	KEVVGTFKA
HELLKTNAA	HELLKTNAA
AEVKVEAIP	AEVKVEAIP
KEFGAVSKV	KEFGAVSKV
KEIEELSEA	KEIEELSEA
GEVPKIERA	GEVPKIERA
RELENIIQET	RELEIIQET
AEYGHFVDI	AEYGHFVDI
REQINKLEA	REQINKLEA
KEFDGKSLVSV	KEFDKSLVS
AEILLSNHYT	AEILSNHYT
SEAQPQPEV	SEAQPQPEV
REGDREAIVA	REGDEAIVA
SEFMKWKEA	SEFMKWKEA
KEIEGIFHAT	KEIEGIFHA
VDITTPKAA	VDITTPKAA
AEVEGLGKGVA	AEVELGKGV
LEIVNPQAA	LEIVNPQAA
AEPSFPFQVA	AEPSPFQVA
EEYGKILEV	EEYGKILEV
SEFKTLPET	SEFKTLPET
SDPVVIVSA	SDPVVIVSA
RDFAARLVA	RDFAARLVA
REFLQNLDA	REFLQNLDA
KENPVVVA	KEN-PVVVA
SETKVFTA	SET-KVFTA
AEVNGLKAS	AEVNGLKAS
EEWHGHVTA	EEWHGHVTA
GEYGGWYKA	GEYGGWYKA
GEFKKYLEV	GEFKKYLEV
SEFYTLHEV	SEFYTLHEV
REHAIDAFRP	REHADAFRP
PRIEPRLPP	PRIEPRLPP
AETKVLQA	AET-KVLQA
KEFLEFRKA	KEFLEFRKA
HEVIVSAA	HEV-IVSAA
IEYIHQETA	IEYIHQETA
REGDLLFTVA	REGDLFTVA
AEFLEKRRAA	AEFLKRRAA
HENESVYKA	HENESVYKA
KEAEQILATA	KEAEQILAT
AEAKPITEMLP	AEAKPITEM
GEIGLLPKA	GEIGLLPKA
AEFEWENKV	AEFEWENKV
MEVNDIKKA	MEVNDIKKA
GEFTHEMQV	GEFTHEMQV
REMPVKVEA	REMPVKVEA
SEVTFALHSA	SEVTALHSA
AEAPPSVAP	AEAPPSVAP
AEVETRIEA	AEVETRIEA
GEYTEHLHSA	GEYTHLHSA
REFVMQVKV	REFVMQVKV
KEFEKEISA	KEFEKEISA
KETDSLKVAA	KETDLKVAA
REWEEAERQA	REWEAERQA
KEISFAYEV	KEISFAYEV
RERIQEVA	RER-IQEVA
REVIKAMTKA	REVIAMTKA
AEFLQKLLP	AEFLQKLLP
REAEREALLAA	AEREALLAA
HEMQIQHPT	HEMQIQHPT
GEYINQIAA	GEYINQIAA
AEKVIPAA	AEK-VIPAA
AEYSYVKST	AEYSYVKST
GEYGNLVTI	GEYGNLVTI
REMTILGSA	REMTILGSA
EAKDLQEFIP	KDL-QEFIP
SELQKIHRA	SELQKIHRA
VEFEDVLGA	VEFEDVLGA
AELQRLVAA	AELQRLVAA
SEAEKVYIV	SEAEKVYIV
HEHHTTIVA	HEHHTTIVA
MEIDQKKPLSA	MEIDKPLSA
AEISAMLKA	AEISAMLKA
AEISSKSPVA	AEISKSPVA
SETDALRSSA	SETDLRSSA
GEIQRLKSA	GEIQRLKSA
REFDKRFTSV	REFDRFTSV
REIAQDFKT	REIAQDFKT
REAFEAIKAA	REAFAIKAA
REMPGVWGA	REMPGVWGA
EEIQKKLEAA	EEIQKKLEA
KEFDSPETA	KEFDSPETA
SEIEVPREA	SEIEVPREA
RERPPEEVAA	RERPEEVAA
AEASMVIA	AEA-SMVIA
AEEFVIVKA	AEEFVIVKA
SEADMRFYAA	SEADRFYAA
KEMFPIEAG	KEMFPIEAG
KEYDGFTITI	KEYDGFTIT
GESIASSHVKA	GESIASSHV
VEFETKEQA	VEFETKEQA
GEKRFADAA	GEKRFADAA
GETVFHYAV	GETVFHYAV
QEAPPIHSS	QEAPPIHSS
KEFQVPMA	KEF-QVPMA
AEYALKRQEA	AEYAKRQEA
KELIFQETA	KELIFQETA
HEQFIPIAA	HEQFIPIAA
FEVNIPTDLRA	FEVNIPTDL
AEVYRILSV	AEVYRILSV
REILHHVNQA	REILHVNQA
KEWDEFQKA	KEWDEFQKA
KEILLKAV	KEI-LLKAV
RENVIMSQILP	RENVIMSQI
HEYFALQHA	HEYFALQHA
GESDDSILRLA	GESDSILRL
SETKVFTAS	SETKVFTAS
SEIDESVKLIP	SEIDESVKL
AEAAAAVVA	AEAAAAVVA
YESQPIRQTA	YESQIRQTA
LAGEYFLQAEL	GEYFLQAEL
SEEKPVPAA	SEEKPVPAA
GETIFVTAP	GETIFVTAP
TEVKDLPGA	TEVKDLPGA
AEHGIFLPP	AEHGIFLPP
AEEFKVPAA	AEEFKVPAA
SEFKEFSQS	SEFKEFSQS
QEFNRLLEA	QEFNRLLEA
EEFSFIPSA	EEFSFIPSA
GEPRVKHFEA	GEPRKHFEA
REFTYHFRVA	REFTHFRVA
SEIDMSVKA	SEIDMSVKA
REFVAVTGA	REFVAVTGA
KDFAQTTSA	KDFAQTTSA
REYQAGDFEA	REYQGDFEA
KEIQAPASA	KEIQAPASA
KEVEASHLALA	KEVEASHLA
IEVSLPEAAA	IEVSLPEAA
KEVEQFDVA	KEVEQFDVA
AEVQVQAPP	AEVQVQAPP
AETTHALPIP	AETTALPIP
AEHPLSRAEAA	AEHPSRAEA
REREVEERL	REREVEERL
HESGHAIIA	HESGHAIIA
KEFKEHIAA	KEFKEHIAA
GEIQEIVKT	GEIQEIVKT
REIQVQHPA	REIQVQHPA
SELPPKPAA	SELPPKPAA
QEVSRIPAS	QEVSRIPAS
AEWVSLSKA	AEWVSLSKA
KDTTLPASA	KDTTLPASA
AEVAPVISSA	AEVAVISSA
LEQEKAYQA	LEQEKAYQA
REVIITPNSA	REVITPNSA
REIENIEKT	REIENIEKT
AERPPSKPP	AERPPSKPP
AELEVVPIIA	AELEVPIIA
RELELLPPPP	RELELLPPP
REILLETPAP	REILLETPA
LENSRKLLSA	LENSKLLSA
SELRSLPPP	SELRSLPPP
AEALLKKHEA	AEALKKHEA
GEMVALPPV	GEMVALPPV
KEQDHIIIIP	KEQDIIIIP
AEKLEALSV	AEKLEALSV
SENEYIMKA	SENEYIMKA
AEVLITTRTAA	AEVLTTRTA
SEAVLWEA	SEA-VLWEA
VEILIPVAA	VEILIPVAA
KEFPITEA	KEF-PITEA
SEFIKEKSA	SEFIKEKSA
REMENIIATV	REMENIIAT
LELQSPPKA	LELQSPPKA
AEVIILPKKH	AEVIILPKK
ADLVFPSSA	ADLVFPSSA
AEFKRAVKV	AEFKRAVKV
AELWKNPTA	AELWKNPTA
GEMKPVAAGA	GEM-KPVAA
IEAHLKENAA	IEAHKENAA
IELRGAAAA	IELRGAAAA
REHEVLIHV	REHEVLIHV
AELPAIMTHA	AELPIMTHA
REIEELLAEA	REIELLAEA
PARLATAPAP	ARLATAPAP
KEPELFQTVA	KEPEFQTVA
RDMTMFVTA	RDMTMFVTA
NEVRHIFTA	NEVRHIFTA
AEFLLEKGYEV	AEFLKGYEV
SEVGKLLSA	SEVGKLLSA
REYDRFYVINY	REYDRFYVI
SEAELLTKTLP	SEAELLTKT
REFQTSVV	REF-QTSVV
FEHAVGYALLA	FEHAVGYAL
ISPTGHSL	ISP-TGHSL
LEHQIQVRP	LEHQIQVRP
REFQWLRAN	REFQWLRAN
TERLIGDAA	TERLIGDAA
REAQKFALA	REAQKFALA
GEFAKLSKIEL	GEFAKLSKI
REGSFKVLVA	REGSKVLVA
SEYTPGNPEA	SEYTGNPEA
KESDVGFIP	KESDVGFIP
REQERQWRA	REQERQWRA
REQGEVRFSA	REQGVRFSA
GELHDLRGQVA	GELHLRGQV
LEHYFHAVV	LEHYFHAVV
AEFVGVSHL	AEFVGVSHL
HEAWLIHKT	HEAWLIHKT
HEFDEQVAA	HEFDEQVAA
YEKLTEIIP	YEKLTEIIP
EELRDIPQA	EELRDIPQA
SELPVSEVA	SELPVSEVA
RESKVVVPP	RESKVVVPP
GEHGLIIRV	GEHGLIIRV
AEALPSLAA	AEALPSLAA
AEINNIIKIV	AEINIIKIV
TEYEVKDQA	TEYEVKDQA
QEIDQLRNA	QEIDQLRNA
VEAVLAGHEA	VEAVAGHEA
HEFTDLNLVQA	HEFTNLVQA
KERPEISPP	KERPEISPP
WEVDVQGSKA	WEVDQGSKA
SELSRSPVA	SELSRSPVA
GEIRTITVV	GEIRTITVV
SEILDKPHEA	SEILKPHEA
REMSWIADTYA	REMSWIADT
HEMVIYEA	HEM-VIYEA
NEFRENISA	NEFRENISA
KEIEIDIEP	KEIEIDIEP
LETASILRS	LETASILRS
HETHLFTA	HET-HLFTA
GEMKGSAITGP	GEMKGSAIT
AEIIEKNLKSA	AEIIKNLKS
GEFKQPIP	GEF-KQPIP
HEVVGVFTVP	HEVVGVFTV
GEIPAELRAAA	GEIPELRAA
REWYSAKITIA	REWYSAKIT
AERIGVDHVA	AERIVDHVA
RETSHVTMV	RETSHVTMV
AEVSQFAA	AEV-SQFAA
TEKALPLSA	TEKALPLSA
RESELSSNPAA	SELSSNPAA
TAPTGHTL	TAP-TGHTL
AESYHQHFAA	AESYQHFAA
REYDTSKIEAA	REYDSKIEA
SERVTIEHA	SERVTIEHA
GEFSITYK	GEF-SITYK
KEIQSAFVSV	KEIQAFVSV
KEAPAPPKAEA	KEAPAPPKA
GEHIHYGA	GEH-IHYGA
REYQELMSV	REYQELMSV
AEYHQSILA	AEYHQSILA
KEYGQIESV	KEYGQIESV
AEVPDVTATP	AEVPDVTAT
REITNQVVP	REITNQVVP
EEHNIVFMP	EEHNIVFMP
VEIKKIMKA	VEIKKIMKA
SETSLIGTAA	SETSIGTAA
REINITSA	REI-NITSA
GETPQVAVIVR	GETPVAVIV
YEQSLHIKSA	YEQSHIKSA
KEMTEVPRV	KEMTEVPRV
KEVEQFTQVA	KEVEQFTQV
AELMGLKQV	AELMGLKQV
REINTILKA	REINTILKA
AEVDPDTILKA	AEVDTILKA
AEVDKLRAA	AEVDKLRAA
GEIIPHIPA	GEIIPHIPA
WEVYLRETA	WEVYLRETA
AEAILGQNAA	AEAIGQNAA
YEILLHEV	YEI-LLHEV
REHFQHVAA	REHFQHVAA
HEFPMNFNP	HEFPMNFNP
GEQTLHYIA	GEQTLHYIA
AENYDIPSA	AENYDIPSA
AEADKIGLLLA	AEADGLLLA
HEEAIHAVA	HEEAIHAVA
AEVELKKGA	AEVELKKGA
RDYVAPTA	RDY-VAPTA
KEKSIFLVA	KEKSIFLVA
FEVTGQETVA	FEVTQETVA
TEIAINVKA	TEIAINVKA
FESEDVAKIV	FESEVAKIV
GELERALSA	GELERALSA
WEREIDERNRP	REIDERNRP
AELEKHMAAA	AELEKHMAA
KEFAPVYPIMV	KEFAPVYPI
SEAKMRLKAA	SEAKRLKAA
TEKPEVID	TEK-PEVID
GEFKEQLQA	GEFKEQLQA
HEMQPLAHGA	HEMQLAHGA
KELYKGINQA	KELYGINQA
REFEIIWVT	REFEIIWVT
SEFDPPGPNVA	SEFDGPNVA
GEIKQFVS	GEI-KQFVS
GEIPVVAIRTA	GEIPAIRTA
MEFQRFVTP	MEFQRFVTP
REHPVPLLP	REHPVPLLP
SEYQQYQDATA	SEYQQYQDA
MEHPYFYTV	MEHPYFYTV
REYMGFIQA	REYMGFIQA
ADAAPDEKVLD	ADAAPDEKV
AEITELIHIA	AEITLIHIA
RELLNVHSA	RELLNVHSA
FESSGIHVA	FESSGIHVA
REAFGFEQA	REAFGFEQA
KEHQVVVVA	KEHQVVVVA
RETAFTHAV	RETAFTHAV
GEIPKVLVA	GEIPKVLVA
SEIESVKISA	SEIEVKISA
AEFKIDFPT	AEFKIDFPT
KEVKIHVA	KEV-KIHVA
GERLIGDAA	GERLIGDAA
FEKIEEVSA	FEKIEEVSA
RELEVQHPAA	RELEVQHPA
GEHTIRNYP	GEHTIRNYP
AEVLEVFHPT	AEVLEVFHP
YDYKAEAAA	YDYKAEAAA
YELGEDTIRQA	YELGTIRQA
PIRLLAAAA	PIRLLAAAA
WEVPLPKV	WEV-PLPKV
LEIAPHALLQA	LEIAALLQA
HENILGFIAA	HENIGFIAA
FEFTHVEKP	FEFTHVEKP
YEFAPKKAA	YEFAPKKAA
KELLGPPEA	KELLGPPEA
AEIDMLDIRA	AEIDLDIRA
RESTGAQVQVA	RESTAQVQV
HDLLVHKA	HDL-LVHKA
REYLIKKINA	REYLKKINA
VVPEPGQPL	VVPEPGQPL
SETSALPRP	SETSALPRP
AEWEGKGTAS	AEWEGKGTA
AEGTGLQIPP	AEGTLQIPP
GENPHGVKAV	GENPHGVKA
QEFAEGFVKA	QEFAGFVKA
SELPGAFEA	SELPGAFEA
KEADFLAQEA	KEADLAQEA
AEVILKKQQA	AEVIKKQQA
SESFIQHIV	SESFIQHIV
GEWERAAAV	GEWERAAAV
VEVRFVSSA	VEVRFVSSA
RDFVARNV	RDF-VARNV
RERPEFQAV	RERPEFQAV
LEAANLSHAA	LEAALSHAA
REVDAEYEA	REVDAEYEA
REFEKMNQS	REFEKMNQS
SEAKPAAVAA	SEAKAAVAA
GEIQHMSQA	GEIQHMSQA
AETHYQLGLA	AETHQLGLA
KEFETPEKA	KEFETPEKA
AEYNGRLAA	AEYNGRLAA
SELSRTYLP	SELSRTYLP
AELETDIRA	AELETDIRA
GEIRVGPSHQA	GEIRPSHQA
ARPEAPPAK	ARPEAPPAK
REVDIGIPDA	REVDGIPDA
AEFTVETRSA	AEFTETRSA
LEIIMKNGSTA	LEIIKNGST
KEIEYVETV	KEIEYVETV
KELIFEETA	KELIFEETA
RELLRIPQA	RELLRIPQA
HEIEVETIP	HEIEVETIP
KEKEEFAVP	KEKEEFAVP
YEWSLGIKSV	YEWSGIKSV
AEIPEGYVP	AEIPEGYVP
GELLFVVPRAA	GELLVVPRA
TEVKIPKP	TEV-KIPKP
KEIDAEGKYMA	KEIDGKYMA
RESIVKDFAA	RESIKDFAA
SEHVFDHPWET	SEH-VFDHP
AEMKAQEVA	AEMKAQEVA
YETVLPVVEK	YET-VLPVV
AEIEDVKPA	AEIEDVKPA
KEHGVVPQA	KEHGVVPQA
SEVVIHSA	SEV-VIHSA
LENSKQPSV	LENSKQPSV
IEQETPVSA	IEQETPVSA
LESELIKSA	LESELIKSA
KEARIFDRAVA	KEARIFDRA
KELPQLVAS	KELPQLVAS
REIPMDPEA	REIPMDPEA
SEFLGKRPWFA	SEF-LGKRP
GELAGERVAA	GELAERVAA
WELGSISKP	WELGSISKP
AEIRKDISA	AEIRKDISA
LEIEFKETQA	LEIEKETQA
AELEKHMAA	AELEKHMAA
LDVVHPAA	LDV-VHPAA
GERDFQTSA	GERDFQTSA
AEGEFFIHDA	AEGEFIHDA
SEIRSAWQA	SEIRSAWQA
HEMQIQHPTA	HEMQQHPTA
AEVEHVVNA	AEVEHVVNA
SEIDQVVPAA	SEIDVVPAA
REFEPASAREA	REF-EPASA
AEFGTLKKA	AEFGTLKKA
GEYKMILVV	GEYKMILVV
REFKPGPRIP	REFKGPRIP
AETLALLKA	AETLALLKA
GEWPTQLDV	GEWPTQLDV
REVDPLRIPP	REVDPLRIP
GEPTNFVHTA	GEPTFVHTA
KEVEPKLAA	KEVEPKLAA
AELENLVNQAA	AELELVNQA
FEKPFLWLA	FEKPFLWLA
KEAILKEA	KEA-ILKEA
SEIQASEVLVA	SEIQEVLVA
AENNVFHLVA	AENNFHLVA
GELKSVPTT	GELKSVPTT
SEVSAENILTV	SEVSNILTV
RESSLILAVTP	RESSLILAV
HDITDWVV	HDI-TDWVV
REAQRGFNKV	REAQGFNKV
ETKKINPTA	ETKKINPTA
SETVMVHQA	SETVMVHQA
SEIERQAQV	SEIERQAQV
GEINVIGEP	GEINVIGEP
QETSFTKEA	QETSFTKEA
AEIELPDVEP	AEIEPDVEP
AENYLGHTA	AENYLGHTA
SEFKYNKPA	SEFKYNKPA
AENQRITAV	AENQRITAV
LEFEHQRAP	LEFEHQRAP
SEHASSPVP	SEHASSPVP
KEHLYFETV	KEHLYFETV
QEILMHHPP	QEILMHHPP
REYWNEQSA	REYWNEQSA
SELEQYFTA	SELEQYFTA
AETVVVSA	AET-VVVSA
REFLWQEGHSA	REFLEGHSA
KDINAVAA	KDI-NAVAA
KEAIETIVAA	KEAITIVAA
MELITPISA	MELITPISA
AELLINHAQA	AELLNHAQA
REIDDFFKA	REIDDFFKA
VEHGGFYRT	VEHGGFYRT
QEAQKIFKA	QEAQKIFKA
AEDGSRVYVV	AEDGRVYVV
SEVAELKIVA	SEVALKIVA
KELELPFEV	KELELPFEV
QELHFIEKA	QELHFIEKA
AEIIQLVNA	AEIIQLVNA
KEFPITEAV	KEFPITEAV
SENPSVYVP	SENPSVYVP
AEAMALGREA	AEAMLGREA
AEFAERTVA	AEFAERTVA
AEMLYGLIHA	AEMLGLIHA
WEIENNPTV	WEIENNPTV
REFIERQHA	REFIERQHA
AEYQAFREA	AEYQAFREA
REFDVGRHIA	REFDGRHIA
TELSFSREYTA	TELSREYTA
KEMFLDYRA	KEMFLDYRA
RETGVIEKLLT	RETGVIEKL
VEFQHIIPISA	VEFQIIPIS
SEYQWITSP	SEYQWITSP
FEFEYQTKV	FEFEYQTKV
REAPALVAA	REAPALVAA
QTMLAPVAA	QTMLAPVAA
VERPAEPVA	VERPAEPVA
IAPTGHSL	IAP-TGHSL
FEFKDMRVP	FEFKDMRVP
TEFEDIKSG	TEFEDIKSG
AEMVALVEQRA	AEMVALVEQ
GEVIQRPA	GEV-IQRPA
HEYVPWVTV	HEYVPWVTV
YAPKGSSL	YAP-KGSSL
ASDFLSPEA	ASDFLSPEA
REAEILHKA	REAEILHKA
GETRQWQT	GET-RQWQT
AEVAPVKDMA	AEVAVKDMA
REIEEGQPEA	REIEGQPEA
KEGQFKDIIT	KEGQKDIIT
GEKNNAFIVA	GEKNAFIVA
GEKPPPPPA	GEKPPPPPA
AEKHPEVLPA	AEKHEVLPA
RELENSLHEA	RELESLHEA
GEIQQIPVQL	GEIQIPVQL
FNEKSKEL	FNE-KSKEL
AETTKLSKP	AETTKLSKP
AEPYMIFKEA	AEPYIFKEA
REALRALRAA	REALALRAA
AEVTVHAA	AEV-TVHAA
QEINTLLEA	QEINTLLEA
RDIVQFVP	RDI-VQFVP
EEFPAFPRA	EEFPAFPRA
SEVRVETSA	SEVRVETSA
KETVFTKSP	KETVFTKSP
AEERIEGRVA	AEEREGRVA
GEAEGLMKV	GEAEGLMKV
AEHENLRTP	AEHENLRTP
REYQLVVQT	REYQLVVQT
LEAHFVPLV	LEAHFVPLV
KEKYIDQEEL	KEKYDQEEL
KEFKGDEILAA	KEFKEILAA
GEFLSQHKAEA	GEFLSQHKA
GEINPVKVA	GEINPVKVA
HNPADILLHP	ADI--LLHP
SEYWDRETRSA	RET---RSA
GEVGKLRIA	GEVGKLRIA
KEIRFTEAV	KEIRFTEAV
FEFMQVEKP	FEFMQVEKP
YEIEKRLSTA	YEIERLSTA
VDFYAPTA	VDF-YAPTA
TEFPGVVA	TEF-PGVVA
TEWDDIHVV	TEWDDIHVV
GELLFVVPRA	GELLVVPRA
GELRSYLVSV	GELRYLVSV
FEFDTKTSA	FEFDTKTSA
KEVIVKAISA	KEVIKAISA
SERVEVVSP	SERVEVVSP
REYEIPSNLTP	YEIPSNLTP
AEIDITNVA	AEIDITNVA
HEYVHGDIKA	HEYVGDIKA
RELANQLEA	RELANQLEA
KEYLAILKA	KEYLAILKA
YEFSQRLEA	YEFSQRLEA
KEYSFDSRHKP	KEYSSRHKP
HELRVLTAP	HELRVLTAP
AEVHRLVVV	AEVHRLVVV
RDFLTHVSA	RDFLTHVSA
REFGNLHNTV	REFGLHNTV
REWKGIDRL	REWKGIDRL
KDFGGDVAA	KDFGGDVAA
TEKLQEPPA	TEKLQEPPA
FESPNISVP	FESPNISVP
VERVEELRR	VERVEELRR
AEFFLSQQA	AEFFLSQQA
SEVTVQPSP	SEVTVQPSP
GEHERPEFIA	GEHEPEFIA
AEAPNMAVV	AEAPNMAVV
NEIKDSVVA	NEIKDSVVA
KEFNFPEEA	KEFNFPEEA
AEAVLKHIA	AEAVLKHIA
SIPGGYNAL	SIPGGYNAL
GELILHKV	GEL-ILHKV
NVKVDPEIQ	NVKVDPEIQ
YERKLIEVA	YERKLIEVA
LEMLTGQERVA	LEMLGQERV
TVTEKPEVIDA	TEKPEVIDA
AEWEIKTITSA	WEIKTITSA
KELGSLTTA	KELGSLTTA
KEWIQIIQA	KEWIQIIQA
KDIAAYRA	KDI-AAYRA
AEAKFFTES	AEAKFFTES
FEANFGKIQA	FEANGKIQA
REFDELNPSA	REFDLNPSA
KEAYVNANQA	KEAYNANQA
AEIIFNPSA	AEIIFNPSA
AEALVREAEA	AEALREAEA
AELQEQLKA	AELQEQLKA
KETPFELIEA	KETPELIEA
AEAFLRQQQA	AEAFRQQQA
KEFSQSFDAA	KEFSSFDAA
RMWATQGLAVA	WATQGLAVA
REYQLNDSAA	REYQNDSAA
SERPLPRAA	SERPLPRAA
REVERVAMTA	REVEVAMTA
AEIEELTASA	AEIELTASA
RELQSQIQEA	RELQQIQEA
HELLEQQKRAA	HELLQQKRA
TEVSKTPEA	TEVSKTPEA
RENKTAVVV	RENKTAVVV
AENAGLSSTA	AENALSSTA
AEILKEIREA	AEILEIREA
LELDTNLPA	LELDTNLPA
RAFKALIAA	RAFKALIAA
TETDLHGSLRV	TETDLHGSL
AETDVLFNKV	AETDLFNKV
KEMEKSFEVV	KEMEKSFEV
AEMPADSGYPA	AEMPSGYPA
REVQYLLNKA	REVQLLNKA
KEAGFLMGA	KEAGFLMGA
SEHWLVLVP	SEHWLVLVP
FEKEPLPPP	FEKEPLPPP
AELLVSHGA	AELLVSHGA
REIQEAIAV	REIQEAIAV
GESPTHFKA	GESPTHFKA
KEISLWFKP	KEISLWFKP
AEAQVTPKP	AEAQVTPKP
KEASEVKPP	KEASEVKPP
AERPGEAAVA	AERPEAAVA
GDRPEPLSA	GDRPEPLSA
KELEGPQIAV	KELEPQIAV
AELKALLQSSA	AELKALLQS
AAPAKKPYR	AAPAKKPYR
AEANLVGREA	AEANVGREA
REVSQHFNQA	REVSHFNQA
SETSGIARP	SETSGIARP
GEVNVLDNLA	GEVNLDNLA
KEFKPLPGRTA	KEFKPGRTA
KETLSIVAV	KETLSIVAV
SEFINSKLTA	SEFISKLTA
TETYVRWSP	TETYVRWSP
KELHESAIVKA	HES-AIVKA
GEHRLVTVT	GEHRLVTVT
FEYVKVPLA	FEYVKVPLA
REVDDLEQWIA	REVDEQWIA
AEMRLFYTT	AEMRLFYTT
HEISEGNVATA	HEISEGNVA
VEIRSGFLAA	VEIRGFLAA
KEVPIHRV	KEV-PIHRV
LEMEQVWRA	LEMEQVWRA
HEFLHEVPA	HEFLHEVPA
KELDKVVTT	KELDKVVTT
AEIDAHLVA	AEIDAHLVA
KEIDVDAVA	KEIDVDAVA
EEISGIVEV	EEISGIVEV
KEIENTYANVA	KEIENTYAN
RERHPGSFDVV	RERHGSFDV
TEMEISRAA	TEMEISRAA
GELSKVTKV	GELSKVTKV
AEGPYKIILTA	AEGPKIILT
HEIDYILLV	HEIDYILLV
VETDHIVAA	VETDHIVAA
AETKDLLVA	AETKDLLVA
REAAAVRALVA	REA-AAVRA
HEQQFAHPP	HEQQFAHPP
RELTSRVTA	RELTSRVTA
GEFSDTNAA	GEFSDTNAA
SEFQPSFHQA	SEFQSFHQA
RELPHFTEA	RELPHFTEA
YEGKDLIAQA	YEGKLIAQA
HEMDRQVAA	HEMDRQVAA
RELAQPASV	RELAQPASV
HDVLLPEEA	HDVLLPEEA
FETPIGWHA	FETPIGWHA
KETLQLESA	KETLQLESA
AEIRIIPA	AEI-RIIPA
KEYAVNEVV	KEYAVNEVV
GETPQVAVIV	GETPVAVIV
IEIPIHIV	IEI-PIHIV
AEMPQNYRP	AEMPQNYRP
SELAVILKA	SELAVILKA
SESPVITKA	SESPVITKA
MEFKAVQQV	MEFKAVQQV
AERNSNLVGAA	AERNNLVGA
SEKHIEVEV	SEKHIEVEV
SEVIVRDWLV	SEVIRDWLV
KEAPPMEKP	KEAPPMEKP
QEHMSISGSSA	QEHMSISGS
AEIDRRISA	AEIDRRISA
RDYYQPLAA	RDYYQPLAA
RERGPPQPLP	RERGPQPLP
TEYSFLKEV	TEYSFLKEV
REFNFEKWNA	REFNEKWNA
TEMDAKTVTA	TEMDKTVTA
AEVEIQVKP	AEVEIQVKP
AETKQLTEMLP	AETKQLTEM
GEFQLIRQT	GEFQLIRQT
RDWEQFHQP	RDWEQFHQP
GEITLRGLVLP	GEITRGLVL
GETGRIILP	GETGRIILP
TEINSQRIAA	TEINQRIAA
GEIALLMNRP	GEIALMNRP
AEKPAVPETA	AEKPVPETA
YEYEGGHIKTA	YEGGHIKTA
HEFVEEKTKVA	HEFVEKTKV
KEPSSGTIPQA	KEPSSGTIP
SEIPKLPAV	SEIPKLPAV
HELPRIHKA	HELPRIHKA
REYMGFIQAM	REYMGFIQA
RELPFTKSA	RELPFTKSA
GEWFGPNTV	GEWFGPNTV
RELDPSLVSA	RELDSLVSA
NEAWNGFVAA	NEAWGFVAA
YEVIYLTEP	YEVIYLTEP
HEFLHEVPAA	HEFLEVPAA
QEFLLSKSA	QEFLLSKSA
REVLPVDITTA	REVLVDITT
AELDKLTSV	AELDKLTSV
SEALALTQTWA	SEALALTQT
SEFPDNYEA	SEFPDNYEA
FEQEMATAA	FEQEMATAA
REFDKRFTS	REFDKRFTS
KETVVTTQA	KETVVTTQA
AEVSTLKDT	AEVSTLKDT
SESRFFVSS	SESRFFVSS
GEVGRQPEP	GEVGRQPEP
KELKIDIIP	KELKIDIIP
GEFGDINAV	GEFGDINAV
SELILLPVT	SELILLPVT
AEIPAGPGREP	AEIPPGREP
SEFPGHTGP	SEFPGHTGP
AEAQLHTTA	AEAQLHTTA
AEYMAPEVV	AEYMAPEVV
AEIRRFIKA	AEIRRFIKA
YETVVKVKP	YETVVKVKP
SADLRDLAT	SADLRDLAT
REIEEQLRA	REIEEQLRA
SEFVKIMEP	SEFVKIMEP
YESEKVGVA	YESEKVGVA
AEFLKQVKP	AEFLKQVKP
REEIIPVAA	REEIIPVAA
KEVVLSEKP	KEVVLSEKP
AEVRVQQQTA	AEVRQQQTA
REKNPDGFLSA	REKNGFLSA
RELGLIRKP	RELGLIRKP
VLSAADKGNV	LSAADKGNV
FEGAVIRTV	FEGAVIRTV
LEYTQILQT	LEYTQILQT
GEIIIDGINIA	GEIIGINIA
VEFATHEEA	VEFATHEEA
AELEEKLPVA	AELEKLPVA
AEAFEAIPRA	AEAFAIPRA
KELTGLNEA	KELTGLNEA
REMEENFAVEA	REMEENFAV
NEFDAIQKA	NEFDAIQKA
SEIAFHTIP	SEIAFHTIP
GEINVVVKV	GEINVVVKV
REMEENFAV	REMEENFAV
AEHNAALQA	AEHNAALQA
SEVKFAVQA	SEVKFAVQA
AESVVKLTA	AESVVKLTA
HEAKGLPRAA	HEAKLPRAA
AEYKNWVKA	AEYKNWVKA
SEHKIKQLSA	SEHKKQLSA
GEVAHVSA	GEV-AHVSA
AEMDKVEGHVA	AEMDEGHVA
NKPVFIVPP	NKPVFIVPP
FEFKKPVRP	FEFKKPVRP
RELTAQIAA	RELTAQIAA
HEHYLVHKP	HEHYLVHKP
AEVDAAMAA	AEVDAAMAA
KEHEYRLLA	KEHEYRLLA
VEHNIRIMA	VEHNIRIMA
KEMEAFLVSV	KEMEFLVSV
SEVILPVPA	SEVILPVPA
AEIKHFVS	AEI-KHFVS
SELASQNKP	SELASQNKP
QETLVKIQA	QETLVKIQA
AELSELHSA	AELSELHSA
AEAIKAWTA	AEAIKAWTA
LELDVDKRLTA	LDVDKRLTA
SEVQLGKTTTA	SEVQGKTTT
QEFSNIVIP	QEFSNIVIP
QEIATVVVP	QEIATVVVP
KAPSAARSL	KAPSAARSL
KESDIVLYA	KESDIVLYA
LEKQDWEHA	LEKQDWEHA
SEKEATPVV	SEKEATPVV
EEINLQRNIA	EEINQRNIA
KEIEELQSQA	KEIELQSQA
KEFEGKTLV	KEFEGKTLV
REIPIVHRV	REIPIVHRV
IEWDKPPVP	IEWDKPPVP
GELVHPKA	GEL-VHPKA
QEVDASIFKA	QEVDSIFKA
REGMFERIP	REGMFERIP
AERPGEAAV	AERPGEAAV
RELQTKINEA	RELQKINEA
SEYEIQRQA	SEYEIQRQA
KELDYGSMTEA	KELDSMTEA
RELMGGIGKT	RELMGIGKT
AEQIVPLSA	AEQIVPLSA
AEIDAHLVALA	AEIDAHLVA
AEFKEAFQLF	AEFKEAFQL
SEVKNIIDKA	SEVKIIDKA
GEYFAIKA	GEY-FAIKA
QEYPMSIQQA	QEYPSIQQA
RDVAIEFSP	RDVAIEFSP
LADKEAGAVAA	KEA-GAVAA
KEQEPMPTV	KEQEPMPTV
FEALVGTLKAA	FEALGTLKA
YEFSKLIFT	YEFSKLIFT
GETRQWQTA	GETRQWQTA
AEAQLRFIQA	AEAQRFIQA
GEALASISHVA	GEALSISHV
AEMPDSAAA	AEMPDSAAA
AESRVLSN	AES-RVLSN
TEAPPIIFATP	TEAPPIIFA
AEATLKLLQA	AEATKLLQA
AEVKPILQA	AEVKPILQA
YEAADKWVAA	YEAAKWVAA
GEMKEIERP	GEMKEIERP
KEGAVVSAP	KEGAVVSAP
QEVQITEA	QEV-QITEA
AELRRMQEMIA	AELRRMQEM
WEYGDPHSP	WEYGDPHSP
SEIEVAQA	SEI-EVAQA
VELSQLRVA	VELSQLRVA
AESTVIAKV	AESTVIAKV
SEHGLVVIA	SEHGLVVIA
TESQALVSA	TESQALVSA
AELLQSQGSQA	AELLQSQGS
LEFENPHVT	LEFENPHVT
AELQARIQA	AELQARIQA
ERARPPPPP	ERARPPPPP
REVLVDHVVEF	REVLVDHVV
AEYNSIKGT	AEYNSIKGT
RESAFAYAIAA	RESAAYAIA
SEVSKIVTV	SEVSKIVTV
SEWLIRPP	SEW-LIRPP
GETPKHFAV	GETPKHFAV
GEFKQPIPA	GEFKQPIPA
KELKQLAA	KEL-KQLAA
AELQQHDVA	AELQQHDVA
GETEVLKVI	GETEVLKVI
REVIHPLAT	REVIHPLAT
AEAQVLSVVA	AEAQLSVVA
LETTALFVAA	LETTLFVAA
KEYILVEEA	KEYILVEEA
GETIFVERP	GETIFVERP
AEITNIRPS	AEITNIRPS
KEFSVQSSA	KEFSVQSSA
YELLKHAEA	YELLKHAEA
REFRLVAA	REF-RLVAA
REGWFSVTP	REGWFSVTP
REFVSGLSA	REFVSGLSA
KEFGDQAEA	KEFGDQAEA
TEAPPIIFA	TEAPPIIFA
GEGKFPSAA	GEGKFPSAA
QEYDALAKV	QEYDALAKV
SEADIRGFVA	SEADRGFVA
YERDHAVVV	YERDHAVVV
KDFIIFEAA	KDFIIFEAA
YEIQNAPEQA	YEIQAPEQA
KEALGIPAAA	KEALGIPAA
EEMPQVHTP	EEMPQVHTP
KEGDFNNLTA	KEGDNNLTA
RELNQPASA	RELNQPASA
RDFDRFIGA	RDFDRFIGA
REFLTKTA	REF-LTKTA
AEIDLGVPPP	AEIDGVPPP
GEVLMVQV	GEV-LMVQV
EEFVFIPAA	EEFVFIPAA
REILVKELTT	REILKELTT
AELNSYVPVTA	AELNSYVPV
FEVALPKTA	FEVALPKTA
GESIDIITRA	GESIIITRA
REKVEVFRA	REKVEVFRA
SERDPIQPP	SERDPIQPP
SELLKGIPLA	SELLGIPLA
READPMTKV	READPMTKV
IEHFIHIIT	IEHFIHIIT
AEQPYFIEA	AEQPYFIEA
YEVKELYVP	YEVKELYVP
EEFERIHQA	EEFERIHQA
KEMIFRDMA	KEMIFRDMA
AENVAVPEA	AENVAVPEA
AEYVGHLRA	AEYVGHLRA
REYNEVEPIIL	REY-NEVEP
HEMVVYEAA	HEMVVYEAA
SEVENKNVP	SEVENKNVP
RERFIEQEKA	RERFEQEKA
REVTIVEKA	REVTIVEKA
RDIQAVAT	RDI-QAVAT
KEFVGGNTP	KEFVGGNTP
AEAEPGADPP	AEAEGADPP
AEVGKWLQA	AEVGKWLQA
SSEVVIHSA	SSEVVIHSA
AEFLKVFIP	AEFLKVFIP
SEIRAIRQA	SEIRAIRQA
KEIHIQPHLA	KEIHQPHLA
GLFDDAAAA	GLFDDAAAA
REILAGKPAA	REILGKPAA
AETYYQTAP	AETYYQTAP
GEVGKKFSA	GEVGKKFSA
IEKFEKEAA	IEKFEKEAA
YEVEILDAKT	YEV-EILDA
LEGENIVSAA	LEGENIVSA
HENPDIIIA	HENPDIIIA
RERIIPRSV	RERIIPRSV
AEIDAITAP	AEIDAITAP
KEIQETWTV	KEIQETWTV
REFAFPPPV	REFAFPPPV
AESLQPVAA	AESLQPVAA
RELIEKGHTAA	RELIKGHTA
REHDIAIKFF	REHDIAIKF
GEYVSLGKVEA	GEYVSLGKV
AELYGPFTSA	AELYPFTSA
AEAALGGLVNA	AEAAGLVNA
SENAIGVAA	SENAIGVAA
HENPEWEKA	HENPEWEKA
KEVLVLTSV	KEVLVLTSV
AEYLLGPLYA	AEYLGPLYA
REIPDPDSA	REIPDPDSA
AETQNIAPS	AETQNIAPS
KESDIYIVA	KESDIYIVA
RETEGGTVLTA	TEGGTVLTA
AEALQLPVV	AEALQLPVV
GETVPAPSA	GETVPAPSA
KEYAVNEVVA	KEYANEVVA
RELQPGVKAV	RELQPGVKA
SEMDRVPFV	SEMDRVPFV
KEFQKIAMA	KEFQKIAMA
KEMELPAKEA	KEMEPAKEA
GENHGVRPP	GENHGVRPP
QEYPTLKVP	QEYPTLKVP
VEYKGLRAG	VEYKGLRAG
AEAEKLFKQA	AEAELFKQA
REANFTVSS	REANFTVSS
AEIKVREA	AEI-KVREA
VEFDSVQSA	VEFDSVQSA
KEVEYFTGA	KEVEYFTGA
REMENIIAT	REMENIIAT
AEAGGMHTV	AEAGGMHTV
AEWREALRA	AEWREALRA
GEIESKFNQA	GEIEKFNQA
KEIEEYIHKP	KEIEYIHKP
KEFKAYVS	KEF-KAYVS
AESLGQYAA	AESLGQYAA
IEFPVSEA	IEF-PVSEA
GEAPKVPVT	GEAPKVPVT
REINYILRV	REINYILRV
FEAPNQEKV	FEAPNQEKV
RELEQTAENKP	RELEQTAEN
MEYKGYLVSV	MEYKYLVSV
TEKAVELAA	TEKAVELAA
RESELQVHSA	RESEQVHSA
SEARGRIPVA	SEARRIPVA
RELVPQDLWAA	RELVDLWAA
RDFLAPHRA	RDFLAPHRA
KELEGVITKA	KELEVITKA
IELPSMAVA	IELPSMAVA
GEMDPNFISV	GEMDNFISV
GENLLTHLP	GENLLTHLP
AEVPNLWSV	AEVPNLWSV
AEAVAHFEA	AEAVAHFEA
REWHHFLVV	REWHHFLVV
REYIEIITS	REYIEIITS
TEHAHQVVV	TEHAHQVVV
HEAPSLQEA	HEAPSLQEA
REALVKKFGA	REALKKFGA
SEIDQINKV	SEIDQINKV
TEADLQFRP	TEADLQFRP
REVVFVEDV	REVVFVEDV
GEKGIGGAVTA	GEKGGAVTA
GENTRIAQP	GENTRIAQP
KELELVTKA	KELELVTKA
REYPRMQVT	REYPRMQVT
LEKITEGQAA	LEKIEGQAA
HEISNLKNLV	HEISLKNLV
REIKSVMNTA	REIKVMNTA
SELGGIWSV	SELGGIWSV
AETKDIPAA	AETKDIPAA
KELYADFIAA	KELYDFIAA
KEHEVTIFVR	KEHEVTIFV
AEHNDLQYAA	AEHNLQYAA
AETKDIPAAIL	AETKDIPAA
SETSNWIAA	SETSNWIAA
VERVIEFAA	VERVIEFAA
RELEVERQIVA	LEVERQIVA
AEIPEHFGA	AEIPEHFGA
REMFNPMYA	REMFNPMYA
REKEEELEV	REKEEELEV
HEIGPSLYAA	HEIGSLYAA
SIPEKNRPL	SIPEKNRPL
VEFGNHMES	VEFGNHMES
REFVMQEA	REF-VMQEA
EALIKHKP	EAL-IKHKP
SEFMFEKAP	SEFMFEKAP
SEIAALLVKP	SEIALLVKP
IEFSRIREA	IEFSRIREA
QENTQTPTV	QENTQTPTV
REAPAGALAAV	REAPGALAA
RDFLQRHRA	RDFLQRHRA
REAERLVRQA	REAELVRQA
AEIKAIIKKA	AEIKIIKKA
QEVLVITRA	QEVLVITRA
EEIQIKEPA	EEIQIKEPA
QELDVKRREA	QELDKRREA
SEITGLSTA	SEITGLSTA
REYSVAVEA	REYSVAVEA
KEFSQSFDA	KEFSQSFDA
YELGQGHAQA	YELGGHAQA
AEIRHVLVT	AEIRHVLVT
AEIAHNVSS	AEIAHNVSS
AELENLVNQA	AELELVNQA
TEFEQQERLLA	TEFEQQERL
REKKFSVEV	REKKFSVEV
AEAAYQTGA	AEAAYQTGA
AEVLITTRT	AEVLITTRT
AELGLTRAA	AELGLTRAA
SEHPFVNGV	SEHPFVNGV
KEAPLHVA	KEA-PLHVA
VDITTPKA	VDI-TTPKA
IEHIIENIVA	IEHIENIVA
SEYTGPTSA	SEYTGPTSA
KEHEAITKV	KEHEAITKV
EEFDAITKA	EEFDAITKA
SEYEKLLHS	SEYEKLLHS
AEFGQAESA	AEFGQAESA
KEATYGERVVA	KEATGERVV
HEVDKLYKV	HEVDKLYKV
REIDDYIVQA	REIDYIVQA
REIQGQVQA	REIQGQVQA
GEILKKIIP	GEILKKIIP
GEFRQGLISA	GEFRGLISA
GEYEWVHKP	GEYEWVHKP
KEWEKFQEEA	KEWEFQEEA
ETISALLQA	ETISALLQA
NDVLAHQA	NDV-LAHQA
GELKLADFGLA	GELKADFGL
AELEKAHLA	AELEKAHLA
VEFAKQLAT	VEFAKQLAT
AENPKLISA	AENPKLISA
VEVPETPKA	VEVPETPKA
KEWPQTHQA	KEWPQTHQA
KEFEGKTLVS	KEFEGKTLV
YEFGESDLRSA	GES-DLRSA
KELPSHVQA	KELPSHVQA
FENQDIHSA	FENQDIHSA
GEAYAPQGWIA	GEAYQGWIA
AEVLLRTA	AEV-LLRTA
AEWEPPEA	AEW-EPPEA
AEIEDPPIP	AEIEDPPIP
TEKNKEFLP	TEKNKEFLP
REMRGLTSA	REMRGLTSA
AETQQPPAA	AETQQPPAA
SEIRLPLKA	SEIRLPLKA
AEEAGAALRTA	EEAGALRTA
REEKLLRDA	REEKLLRDA
ADINTKWAA	ADINTKWAA
GERVIVEHA	GERVIVEHA
GEYLEKIIP	GEYLEKIIP
KEVDWSQNTA	KEVDSQNTA
RELGEFRTT	RELGEFRTT
KELSRIEEA	KELSRIEEA
VEIILHVV	VEI-ILHVV
GEIILHSV	GEI-ILHSV
AELQLRAA	AEL-QLRAA
REAELGARA	REAELGARA
KEIGDIAGV	KEIGDIAGV
LDLGNNNIATV	LDLGNNNIA
AEVNGGLPSA	AEVNGLPSA
AEIGKLRAQA	AEIGLRAQA
SELITKAVA	SELITKAVA
REHGIRLLEA	REHGRLLEA
REKGPVKEVP	REKGPVKEV
KEVPIHRVA	KEVPIHRVA
AEYINEAAA	AEYINEAAA
AELGMEHQA	AELGMEHQA
SEYRTFAA	SEY-RTFAA
REASDLQIAA	REASLQIAA
MEVELPAAA	MEVELPAAA
SETSLIGTA	SETSLIGTA
AEIQELHQSV	AEIQELHQS
REVEHFLKA	REVEHFLKA
QEYEAIYLA	QEYEAIYLA
VEFSGKPAA	VEFSGKPAA
GEWDLAQKA	GEWDLAQKA
AEYHKLARKL	AEYHLARKL
GEFSFEEIRA	GEFSEEIRA
READLDHYSA	READDHYSA
KEAVLNGLVA	KEAVNGLVA
GEFPVRVQV	GEFPVRVQV
GEQRFASIVA	GEQRASIVA
KEVATAIRGA	KEVAAIRGA
REFPQFEP	REF-PQFEP
AEAQPMAVV	AEAQPMAVV
REYDTSKIEA	REYDSKIEA
GEITQLLVPP	GEITQLLVP
FEAPATINSA	FEAPTINSA
AEVIQAFSA	AEVIQAFSA
REGDKIIYQA	REGDIIYQA
REIFFPETA	REIFFPETA
GEFGEIEAIEL	GEF-GEIEA
QEFSFFDKV	QEFSFFDKV
RESNNMVVP	RESNNMVVP
HEFGAITFV	HEFGAITFV
REIQGLFDEL	REIQLFDEL
KEIFISNITQA	KEIFISNIT
SEGTFGIHVA	SEGTGIHVA
NEIGAIEKA	NEIGAIEKA
KEFEQLAPVL	KEFEQLAPV
HEVVGVFTV	HEVVGVFTV
REFGNPNRPVA	REFGNPNRP
AETDKIVVG	AETDKIVVG
SAPKGSVL	SAP-KGSVL
GEFFLKNLVA	GEFFKNLVA
AEFAERSVA	AEFAERSVA
REYLRVNVV	REYLRVNVV
AEHQQLIP	AEH-QQLIP
HEVGALVRA	HEVGALVRA
SEAEIQAKA	SEAEIQAKA
AEMYVAKFAA	AEMYAKFAA
LEHYFHAVVA	LEHYHAVVA
GEFLPIQPA	GEFLPIQPA
GEHTLLVTV	GEHTLLVTV
HELHFVEKA	HELHFVEKA
KELHHIWQS	KELHHIWQS
RELLIIGGVA	RELLIGGVA
REPPLNTAA	REPPLNTAA
GETLLQRAA	GETLLQRAA
REALFNEFVAA	REALNEFVA
REFEERHIP	REFEERHIP
REHAPFLVA	REHAPFLVA
AEVAPVISS	AEVAPVISS
GETLLHIA	GET-LLHIA
PEFKFWHAA	PEFKFWHAA
VEFEELLKA	VEFEELLKA
SEGFAVIKEA	SEGFVIKEA
EEFVFIHAV	EEFVFIHAV
RPEAPPPPP	RPEAPPPPP
AELPWAVKP	AELPWAVKP
KEWSQHINGA	KEWSHINGA
RETLLAQPAA	RETLAQPAA
AEIASSLPAA	AEIASLPAA
REIQVQHPAA	REIQVQHPA
KDFEAIIQA	KDFEAIIQA
AEKPLQVAA	AEKPLQVAA
GEKGTWVQP	GEKGTWVQP
AELKQLVA	AEL-KQLVA
KEYPFILDA	KEYPFILDA
FESSGIHVAA	FESSGIHVA
GEPGTRVVA	GEPGTRVVA
AEIRVHTV	AEI-RVHTV
TELDKIRQA	TELDKIRQA
GEMKSGVPVL	GEMKSGVPV
WENISRPEA	WENISRPEA
VEVVVKHEA	VEVVVKHEA
SELQKIHKA	SELQKIHKA
EEFKKIRSA	EEFKKIRSA
GEVIVKGA	GEV-IVKGA
AEVQGMQEA	AEVQGMQEA
KDVFISAA	KDV-FISAA
FESHPAPSA	FESHPAPSA
AEILHEIA	AEI-LHEIA
RDISIVFTP	RDISIVFTP
KEVEIAYSDVA	VEIAYSDVA
RELEVQHPA	RELEVQHPA
AEKVEEIVA	AEKVEEIVA
QEVYIPFSA	QEVYIPFSA
KEIFLRELIS	KEIFRELIS
AELGALHSA	AELGALHSA
HEGPVYAV	HEG-PVYAV
AEYIPLTPAAA	AEYILTPAA
GETPLIKAT	GETPLIKAT
KEMGLPVGTA	KEMGPVGTA
SEYERIEIP	SEYERIEIP
KEADLPMTA	KEADLPMTA
REAELKKLQEA	AELKKLQEA
AEFIVAKA	AEF-IVAKA
LEHKIIIRV	LEHKIIIRV
KEFLNPVAT	KEFLNPVAT
KEIDVISIP	KEIDVISIP
SEIEARIAA	SEIEARIAA
SERIIVRAS	SERIIVRAS
AEMGKNLKEA	AEMGNLKEA
FEADPPGQVAA	ADPPGQVAA
IETENIRLT	IETENIRLT
REIEATNAV	REIEATNAV
SEIAPPGVRGA	SEI-APPGV
RETVAYLQA	RETVAYLQA
YEVRLTQTV	YEVRLTQTV
GEMEPPALP	GEMEPPALP
AEKRDPQELVA	AEKRPQELV
SEIFPLFRA	SEIFPLFRA
REHMGNVVEA	REHMNVVEA
AEYAYVLRV	AEYAYVLRV
KEVDVGLAA	KEVDVGLAA
SESSTILVV	SESSTILVV
REKPEEFQT	REKPEEFQT
REYQAGDFEAA	REYQGDFEA
REKKLFVIA	REKKLFVIA
RESSFQPEA	RESSFQPEA
AEIRLDKVVP	AEIRDKVVP
EEFQFIKKA	EEFQFIKKA
IEKQIVLPP	IEKQIVLPP
AEFNLVNNA	AEFNLVNNA
YETLTITQA	YETLTITQA
SEMSKVSKP	SEMSKVSKP
QEFEAALKA	QEFEAALKA
SELEKTQVA	SELEKTQVA
RDLLQPRRA	RDLLQPRRA
SEIRVYSA	SEI-RVYSA
TEIRALVAA	TEIRALVAA
REGTFALRA	REGTFALRA
GEWDKALSI	GEWDKALSI
FEARIALLP	FEARIALLP
REITDQEHNVA	REITQEHNV
AEIQRFAFSA	AEIQFAFSA
AEIRAINEA	AEIRAINEA
KELETILET	KELETILET
LELEDAIHTA	LELEAIHTA
REFRFTSEV	REFRFTSEV
AEFNSTPAVF	AEFNSTPAV
GETSYIRVYP	GETSIRVYP
SELATAVKA	SELATAVKA
AEAYLGKTVT	AEAYLGKTV
KEIRMEAA	KEI-RMEAA
AESKVSVAV	AESKVSVAV
AEFHQIEGVVA	AEFHQIEGV
SESVNLRIA	SESVNLRIA
KEIVVFEA	KEI-VVFEA
VETNKVPVA	VETNKVPVA
AEWEPPEARA	AEWEPEARA
REFDAFVETL	REFDAFVET
SELSSNPAA	SELSSNPAA
GEYRGSDFTA	GEYRSDFTA
SEFSFEELRA	SEFSEELRA
RELQSKEFLSA	RELQEFLSA
AEGQRLFSA	AEGQRLFSA
MEVKPSSVTA	MEVKSSVTA
AEAYRSLAS	AEAYRSLAS
REIKFTVQA	REIKFTVQA
AAPATRAAL	AAPATRAAL
QEYDFKMAQA	QEYDKMAQA
AEGAFPNLA	AEGAFPNLA
SELREFPAA	SELREFPAA
KEGDLIAAQA	KEGDIAAQA
AENQGFVAA	AENQGFVAA
SEWEKMRQS	SEWEKMRQS
KELEKQLVA	KELEKQLVA
KENDRIFVSV	KENDIFVSV
LEKSEGGLSA	LEKSGGLSA
YEKLLWTT	YEK-LLWTT
REFGNPNRP	REFGNPNRP
REFKLSKV	REF-KLSKV
HETDLHSSHTP	HET-DLHSS
HEVEDLIKTA	HEVELIKTA
REVQSALSTA	REVQALSTA
REWERPPMA	REWERPPMA
GEAPPGTPP	GEAPPGTPP
AENTIQNEA	AENTIQNEA
RETQALILAP	RETQLILAP
REVYVKGLLA	REVYKGLLA
YEVAVRKSA	YEVAVRKSA
TEVAPLKEA	TEVAPLKEA
ADYLAHES	ADY-LAHES
RELKTKISA	RELKTKISA
AEGKFFHRS	AEGKFFHRS
KEIENGHIFTV	KEIEHIFTV
KEIEQGDVTA	KEIEGDVTA
YEHDDIVST	YEHDDIVST
IEKPVDPPP	IEKPVDPPP
KEVFDSAILSA	KEVFAILSA
AEIDSIHQLVV	AEIDSIHQL
TEIEKSISA	TEIEKSISA
GEEGPQAVA	GEEGPQAVA
NEVVQVHAA	NEVVQVHAA
KEISITHHV	KEISITHHV
KEVEYIVST	KEVEYIVST
AEAEFYRQVSA	AEFYRQVSA
KELFILDEA	KELFILDEA
GEFHKMREV	GEFHKMREV
KEWIRPLAS	KEWIRPLAS
QEFDYQPIAA	QEFDQPIAA
LEVAKSLSA	LEVAKSLSA
QELPGLPLV	QELPGLPLV
SEVQDLHLA	SEVQDLHLA
IEWNLSPVG	IEWNLSPVG
SEVEVIHVP	SEVEVIHVP
AEWDMVNTV	AEWDMVNTV
GETSVRFTA	GETSVRFTA
GEVAILNST	GEVAILNST
AELIHQIEA	AELIHQIEA
AEAASKWAA	AEAASKWAA
SEIESKVREA	SEIEKVREA
LEAEKAAVGYS	LEA-EKAAV
KENPNQYNYIA	KENPYNYIA
AERYDDMAA	AERYDDMAA
KEFDGKSLVS	KEFDKSLVS
SLVNLGGSK	SLVNLGGSK
QEIMTVPPP	QEIMTVPPP
VEFMHYIIA	VEFMHYIIA
VEFATHEEAVA	VEFATHEEA
GEMWNNTAA	GEMWNNTAA
VEVDMEKIAA	VEVDEKIAA
TEVDKILKV	TEVDKILKV
TEFLFHTA	TEF-LFHTA
QELEFLRVA	QELEFLRVA
HEFANLNLVQA	HEFANLNLV
REKELIRQA	REKELIRQA
AEMLEIVQA	AEMLEIVQA
KETELNKVIA	KETENKVIA
KDIVINEA	KDI-VINEA
YEYEGGHIKGA	YEGGHIKGA
REFEVEKQTA	REFEEKQTA
SSPQPGSAL	SSPQPGSAL
KEHEVTIFV	KEHEVTIFV
RETSHVTMVVA	RETSHVTMV
AEAFRLPTA	AEAFRLPTA
HEHIEILTV	HEHIEILTV
YEVRLTQTVA	YEVRTQTVA
RELIAEHKP	RELIAEHKP
GEMKPVAA	GEM-KPVAA
TEGNGTESLNS	TEGNGTESL
GEFLSQHKA	GEFLSQHKA
AEIINPKTA	AEIINPKTA
AEIKVKLIEA	AEIKKLIEA
AEVAPMLKA	AEVAPMLKA
GEISTIDKV	GEISTIDKV
REYEKYVQDV	REYEYVQDV
SEVESLRPP	SEVESLRPP
HELLAIREA	HELLAIREA
AAGPPISEGK	AAGPPISEG
GETEILRKA	GETEILRKA
REFLAHSA	REF-LAHSA
AELPAAAQPSA	AELPAAAQP
RERWNFDFV	RERWNFDFV
KESWPKPLAVP	KESWKPLAV
GEFIIGRVIKA	GEFIRVIKA
RELGVKIAKA	RELGKIAKA
SEIHIKVKP	SEIHIKVKP
KELDSKTIRA	KELDKTIRA
GEFEIIDDHRA	FEIIDDHRA
REFVRQYYT	REFVRQYYT
GEFGGFGSV	GEFGGFGSV
AEFKLIPGL	AEFKLIPGL
GEMMVEQRAA	GEMMEQRAA
SEAAELRSTA	SEAALRSTA
AEYDRPNLLP	AEYDPNLLP
HEKDVIGIA	HEKDVIGIA
GELSDTIPVV	GELSTIPVV
EHNFVAKA	EHN-FVAKA
GELKVVNGA	GELKVVNGA
LELQLHQIAA	LELQHQIAA
GEFPQAIKA	GEFPQAIKA
GEYTDHLHSA	GEYTHLHSA
SEAPLEHKP	SEAPLEHKP
FKQYANDNGVD	KQYANDNGV
GERIITQGEKA	RIITQGEKA
RELHLMRNEA	RELHMRNEA
LEMDLKDLEA	LEMDKDLEA
SETAMFSV	SET-AMFSV
SETDLSLLTA	SETDSLLTA
HEYNSQPSV	HEYNSQPSV
TEIGVLAKA	TEIGVLAKA
REAAKVALSA	REAAVALSA
KEYLKALAA	KEYLKALAA
SEAHSEFLKAA	SEAHEFLKA
ADTIFVTAP	ADTIFVTAP
REIFDKARQA	REIFKARQA
KELEKILTTA	KELEILTTA
SEVNLFLVP	SEVNLFLVP
AEFLTSKLIA	AEFLSKLIA
KEKDPKVPSA	KEKDKVPSA
SENQHLVSP	SENQHLVSP
GEFTSARAV	GEFTSARAV
REIKDFFEVA	REIKFFEVA
AEIQETITA	AEIQETITA
HEFQAPFGMEA	HEFQFGMEA
TESSHFYSA	TESSHFYSA
REYDGNIRQA	REYDNIRQA
HAAEYGAEALE	AEY-GAEAL
TEIPEQLVP	TEIPEQLVP
AEALIKHKP	AEALIKHKP
HEVRIKIIA	HEVRIKIIA
VELNKIPTV	VELNKIPTV
RDFEGKVV	RDF-EGKVV
REHPWEVMP	REHPWEVMP
AEYQALVKA	AEYQALVKA
RELEDLIIEA	RELELIIEA
RELLIIGGVAA	RELLIGGVA
REAPPLPTVA	REAPLPTVA
SEFEIVKA	SEF-EIVKA
AEFGLLQRT	AEFGLLQRT
REKEPNRLESL	REKENRLES
WEMNNIHSV	WEMNNIHSV
GEVGDGFKVA	GEVGGFKVA
RERLEQQVP	RERLEQQVP
REFDFFNKI	REFDFFNKI
KEAPAPPKA	KEAPAPPKA
AELLQKIEV	AELLQKIEV
AEQVVARVA	AEQVVARVA
NEFSILKSP	NEFSILKSP
QEVVLDKSA	QEVVLDKSA
KEQVSIKAA	KEQVSIKAA
LEVEKITTS	LEVEKITTS
REFESAIVEA	REFEAIVEA
KELTGLLTTA	KELTLLTTA
SEFGKLERV	SEFGKLERV
RESIVLHGA	RESIVLHGA
LETDAGPAA	LETDAGPAA
RGYAFNHSA	RGYAFNHSA
GEVSKIVAS	GEVSKIVAS
RETIIMNQILP	RETIIMNQI
SEMRAPPAA	SEMRAPPAA
AEQRGENALKD	AEQRGENAL
VEFTIKEA	VEF-TIKEA
KEILTIREA	KEILTIREA
KELTDLHKA	KELTDLHKA
RERRDNYVP	RERRDNYVP
REARDVFAQV	REARVFAQV
SEIYGLMKA	SEIYGLMKA
GEMVPSRQA	GEMVPSRQA
GEVTNVTTA	GEVTNVTTA
IELDMRTIA	IELDMRTIA
LEYHVPVTA	LEYHVPVTA
DEFEFLEKA	DEFEFLEKA
GELLFVHSA	GELLFVHSA
GELKLVTA	GEL-KLVTA
AEFLIGQGA	AEFLIGQGA
AELDSVFSSA	AELDVFSSA
SEFGQFLPEA	SEFGFLPEA
SELPGAFEAA	SELPAFEAA
HEFADLNLVQA	HEFANLVQA
SEQPTLVTA	SEQPTLVTA
EIRAIRQA	EIR-AIRQA
KELYPGQFKP	KELYGQFKP
AEYLQPKA	AEY-LQPKA
GEYAGLATIRA	GEYAGLATI
GENPLQVLV	GENPLQVLV
AEMDGFKPN	AEMDGFKPN
SEAKIIQQA	SEAKIIQQA
KELEDLLSP	KELEDLLSP
KEGLVMVEV	KEGLVMVEV
REVLPLNQA	REVLPLNQA
AELLLIPKV	AELLLIPKV
KEGNVQITA	KEGNVQITA
RENVFKLLP	RENVFKLLP
LEKPNEPVP	LEKPNEPVP
SELPTQSKA	SELPTQSKA
AEILELAGNAA	AEILAGNAA
AENVTFWKA	AENVTFWKA
HEIDRYTAIA	HEIDYTAIA
HEQEYKNNIA	HEQEKNNIA
HEMVVYEA	HEM-VVYEA
SETKIFTA	SET-KIFTA
AEKEPVPVP	AEKEPVPVP
GLSSEFQIPTA	SEF-QIPTA
HELDMQVAA	HELDMQVAA
TEVQSLYREI	TEVQLYREI
IEPVIKWTA	IEPVIKWTA
AERLFPANVA	AERLPANVA
AEFKQIRSI	AEFKQIRSI
REMDQTMAA	REMDQTMAA
HEKQVYDIA	HEKQVYDIA
AEYAHPLET	AEYAHPLET
KEADLPMTAA	KEADPMTAA
HEATAMMKA	HEATAMMKA
AEIDALYKDL	AEIDALYKD
KENQISVRA	KENQISVRA
MEALPLLAA	MEALPLLAA
REGSFRVTTA	REGSRVTTA
MEFPKIESV	MEFPKIESV
HEVLLISA	HEV-LLISA
AETLFDILVA	AETLDILVA
REFWAKPKP	REFWAKPKP
TEFIHLISS	TEFIHLISS
FEVKKWNAVA	FEVKKWNAV
RERVFSEDRA	RERVSEDRA
GEFGGFGSVTG	GEFGGFGSV
LEVQHPAA	LEV-QHPAA
NAPWAVTSL	NAPWAVTSL
AEADRTAIHEV	ADRTAIHEV
SELIQLVAV	SELIQLVAV
AEHKEFITA	AEHKEFITA
AEIQGVIDA	AEIQGVIDA
QEWPGAGSSA	QEWPAGSSA
REFVSISSP	REFVSISSP
TEADIFHQA	TEADIFHQA
AEVEPTPEA	AEVEPTPEA
FESGDVKAT	FESGDVKAT
AELQKQWEV	AELQKQWEV
SETLSQAGQKA	SETLAGQKA
VEIAIDNTA	VEIAIDNTA
AETILLKAV	AETILLKAV
HEAAFPIAVVA	HEAAFPIAV
KEGMNIVEA	KEGMNIVEA
RELNRGVIKQV	RELNVIKQV
AEILNGKEISA	AEILKEISA
KEFGLLKPTSA	KEF-GLLKP
LEVKIGDFGLA	LEVKGDFGL
TEKRDFVSA	TEKRDFVSA
KEGILPERA	KEGILPERA
SEFLPSMQSA	SEFLSMQSA
VEFMHYIIAA	VEFMYIIAA
AESPGFSQA	AESPGFSQA
AEHPIVIV	AEH-PIVIV
AEVIVDWRP	AEVIVDWRP
RERFLEDLVA	RERFEDLVA
SSDFQSNIA	SSDFQSNIA
RETGQQFAV	RETGQQFAV
GEAVALSTSQG	GEAVALSTS
GEFREAFKEA	GEFRAFKEA
AEHNFVAKA	AEHNFVAKA
FERLEKEEA	FERLEKEEA
VEKPPHLAA	VEKPPHLAA
KEGDFNNLTAA	KEGDNNLTA
AEFQELLKV	AEFQELLKV
TEIALPGEVSA	TEIALPGEV
REFEPMLQV	REFEPMLQV
KEAQLYAAQA	KEAQYAAQA
FEFLTKELA	FEFLTKELA
AERDFIHTA	AERDFIHTA
REMSPLVDNIA	REMSVDNIA
GEGSFGKAILV	GEGSFGKAI
VEKPVGVAA	VEKPVGVAA
GDRLIVGTA	GDRLIVGTA
REYELVTPVST	REYELVTPV
SARLGELGPA	ARLGELGPA
AEIAHLYIA	AEIAHLYIA
KEAGVVAQA	KEAGVVAQA
GEVIVTKDDA	GEVITKDDA
AEFAAKAA	AEF-AAKAA
GEHLNAVQA	GEHLNAVQA
GEAFRSLVPA	GEAFSLVPA
QELGGLHSA	QELGGLHSA
MEIQVNGGTVA	MEIQGGTVA
TEFGHPAA	TEF-GHPAA
FEKNEAIQA	FEKNEAIQA
KELEPLKEMTA	KELEKEMTA
REYNWNVKNKA	REYNVKNKA
TEWLEPLEA	TEWLEPLEA
AEFPGLPEAL	AEFPGLPEA
YELLFKEGV	YELLFKEGV
TEFQGKITP	TEFQGKITP
AEIDARLKA	AEIDARLKA
REQEITAVQA	REQETAVQA
REIKDIFYKA	REIKIFYKA
SENAHIIEA	SENAHIIEA
MEVELPAA	MEV-ELPAA
GEIDASLKAP	GEIDASLKA
NEYRFAWVEA	NEYRAWVEA
RESFFRVVP	RESFFRVVP
IEGKDVFREA	IEGKVFREA
QEFPQVEA	QEF-PQVEA
GESVLVHGA	GESVLVHGA
WEKPDDFIP	WEKPDDFIP
REAEARLAA	REAEARLAA
SEIKMEQA	SEI-KMEQA
HEVIVSFTP	HEVIVSFTP
KESQVYVHA	KESQVYVHA
AEFPHSFLV	AEFPHSFLV
IEMHLPYTA	IEMHLPYTA
KEILQVITS	KEILQVITS
