Data	Data aligned
LQFLAPKI	LQFL-APKI
SIPGGYNAL	SIPGGYNAL
HQRIPQSV	HQRI-PQSV
VMSILPKI	VMSI-LPKI
IQRVAAGV	IQRV-AAGV
AQLVQLRV	AQLV-QLRV
HQIIVQNV	HQII-VQNV
TAYVSPTV	TAYV-SPTV
NQVVKPRV	NQVV-KPRV
HSHLLYSTI	HSHLLYSTI
VQYEINLL	VQYE-INLL
AQITMKVI	AQIT-MKVI
AQYEANKV	AQYE-ANKV
AQYDGAYKV	AQYDGAYKV
AMIALNTV	AMIA-LNTV
QQITQTEV	QQIT-QTEV
HVYELLNTI	HVYELLNTI
YSFSFHVV	YSFS-FHVV
TQFKWIHI	TQFK-WIHI
HAFIQPEI	HAFI-QPEI
HQLKQLLL	HQLK-QLLL
AFPKAVSV	AFPK-AVSV
VQVAVAHV	VQVA-VAHV
VMTDLPVI	VMTD-LPVI
SAPAVLEI	SAPA-VLEI
RQISLNKV	RQIS-LNKV
SQYRALSV	SQYR-ALSV
YQHKFPEV	YQHK-FPEV
GAGGGFGSRSL	GGFG-SRSL
SMYQTKAV	SMYQ-TKAV
GTQYTFSSI	GTQYTFSSI
SQFAFESVV	SQFAFESVV
LMRKVPRV	LMRK-VPRV
QQNPQPLI	QQNP-QPLI
AQFPESFTV	AQFPESFTV
VQREYQLVV	VQREYQLVV
HQVVLPVLGY	HQVV-LPVL
SFPGANII	SFPG-ANII
RAYLFAHAV	RAYLFAHAV
YEYQPLQI	YEYQ-PLQI
AQVALVNEV	AQVALVNEV
VQKELQSI	VQKE-LQSI
RQFLLKSLI	RQFLLKSLI
RLYSKQITI	RLYSKQITI
QQWPVRSI	QQWP-VRSI
RQIEIPKV	RQIE-IPKV
HQYVVPKI	HQYV-VPKI
IQTMLRQI	IQTM-LRQI
HSWAPLKV	HSWA-PLKV
HQYIFSHIL	HQYIFSHIL
HQVLMKTV	HQVL-MKTV
GQYSFLVV	GQYS-FLVV
TSPEALEI	TSPE-ALEI
VQKLSRVI	VQKL-SRVI
VQVEQSKV	VQVE-QSKV
HQMEMERI	HQME-MERI
KQYQIVERI	KQYQIVERI
HMQIVHKI	HMQI-VHKI
HQRTFVLEVM	HQRTFVLEV
QTYAVPLI	QTYA-VPLI
FEWENKVTV	FEWENKVTV
HSYVIGFVV	HSYVIGFVV
HGMIMLRI	HGMI-MLRI
RMITAMNTI	RMITAMNTI
IQVVVATV	IQVV-VATV
TQIISKKI	TQII-SKKI
GMDPITRQV	GMDPITRQV
LQHELQTI	LQHE-LQTI
VQKLVQKV	VQKL-VQKV
TQIYIKLV	TQIY-IKLV
VQTVLPLVM	VQTVLPLVM
YQIHLKSV	YQIH-LKSV
YQHMLANSI	YQHMLANSI
AMRQVNTI	AMRQ-VNTI
AQFSVQKV	AQFS-VQKV
TSPQASII	TSPQ-ASII
RQWLIEQI	RQWL-IEQI
LQHPFVTV	LQHP-FVTV
QQSKILKV	QQSK-ILKV
MQYPISINV	MQYPISINV
TFGKVILV	TFGK-VILV
SQFLVSSV	SQFL-VSSV
LQYIFAHV	LQYI-FAHV
LQFDGIHVV	LQFDGIHVV
AFYKAQPVI	AFYKAQPVI
VMEQGRVTI	VMEQGRVTI
KFFEMVNTI	KFFEMVNTI
AQLIVQAI	AQLI-VQAI
SSYPTRLI	SSYP-TRLI
SQALILKI	SQAL-ILKI
AMFGKLMTI	AMFGKLMTI
AQAEALRI	AQAE-ALRI
FPYAFKEVI	FPYAFKEVI
GMYIFLHTV	GMYIFLHTV
LYPKVAKI	LYPK-VAKI
TQQILPYI	TQQI-LPYI
HQRITEEL	HQRI-TEEL
VQKSVRTI	VQKS-VRTI
SQVALKII	SQVA-LKII
HQNGSMAAV	HQNGSMAAV
QHSNLTQV	QHSN-LTQV
YQGPVLLI	YQGP-VLLI
MQRYASKV	MQRY-ASKV
KLLEQALVI	KLLEQALVI
VQVEVITI	VQVE-VITI
GAGKNRAGLEL	KNRA-GLEL
GQFPFYDSI	GQFPFYDSI
LSHLSLIV	LSHL-SLIV
VQRVQNEV	VQRV-QNEV
IQFEVRRV	IQFE-VRRV
VGFVLLTV	VGFV-LLTV
VFPTIATI	VFPT-IATI
EQKIVVKV	EQKI-VVKV
IRMISVNI	IRMI-SVNI
HQALHSISV	HQALHSISV
SQTPLPTI	SQTP-LPTI
LQYTPPVV	LQYT-PPVV
MQNPRQYKI	MQNPRQYKI
HQLYVLQV	HQLY-VLQV
RMLPHAPGV	RMLPHAPGV
FQVLQPQV	FQVL-QPQV
AMKEDPTV	AMKE-DPTV
AMAPGTVTV	AMAPGTVTV
HQYTPEMI	HQYT-PEMI
MQKEITAL	MQKE-ITAL
QQVVIHLI	QQVV-IHLI
QQFQYAVRV	QQFQYAVRV
QQISFVNSI	QQISFVNSI
VMKTEPSI	VMKT-EPSI
LQLKPRTV	LQLK-PRTV
SMPDVLKI	SMPD-VLKI
QQALMRSTV	QQALMRSTV
HSYLSKEEI	HSYLSKEEI
SQLILHLI	SQLI-LHLI
QGYTVARI	QGYT-VARI
FNEKSKEL	FNEK-SKEL
RQYPWGVAEV	RQYPWVAEV
RQYRMKKL	RQYR-MKKL
YQYMLEHVI	YQYMLEHVI
DNQYRLIVNV	NQYRLIVNV
SQVIFNSV	SQVI-FNSV
HQLQPRRV	HQLQ-PRRV
AQYAQRASV	AQYAQRASV
VQNAVIKI	VQNA-VIKI
FEYKPEVI	FEYK-PEVI
VGYLQPLV	VGYL-QPLV
SSFVTKSV	SSFV-TKSV
RNVSTGDVNVE	VSTG-DVNV
SQLTTHKI	SQLT-THKI
HSQELPAI	HSQE-LPAI
LEYRVTQV	LEYR-VTQV
HQLAALYI	HQLA-ALYI
EQILIQWI	EQIL-IQWI
SQIQYMNTV	SQIQYMNTV
QQFTSRRV	QQFT-SRRV
IAYKFGKTV	IAYKFGKTV
LSSPATLNSR	SSPATLNSR
NQYRLIVNV	NQYRLIVNV
NAAPGVDL	NAAP-GVDL
QSTQVPTI	QSTQ-VPTI
SQRAGLQV	SQRA-GLQV
SVQTSLIV	SVQT-SLIV
LQRVIDYI	LQRV-IDYI
GEYAVRAI	GEYA-VRAI
RQLYSKVI	RQLY-SKVI
EEYEQRVV	EEYE-QRVV
EQFILSQV	EQFI-LSQV
IQFKLEKI	IQFK-LEKI
TQFLPRTI	TQFL-PRTI
AQHKFLVAV	AQHKFLVAV
VQAVIPTI	VQAV-IPTI
AQQEIKATV	AQQEIKATV
VQYDGRRVV	VQYDGRRVV
GQFKTYAI	GQFK-TYAI
FEYQVRSI	FEYQ-VRSI
VEIEQKVV	VEIE-QKVV
ASVKISKV	ASVK-ISKV
LQKQILKI	LQKQ-ILKI
LSFPFHESI	LSFPFHESI
SQIEKPKI	SQIE-KPKI
QQRAQTLRV	QQRAQTLRV
HSLQVAGI	HSLQ-VAGI
HGYIFSSL	HGYI-FSSL
HQQLPPLV	HQQL-PPLV
SGTVLPAV	SGTV-LPAV
ESILLPRI	ESIL-LPRI
VQRSQVSSI	VQRSQVSSI
VQQLVLRTV	VQQLVLRTV
KSLKILRI	KSLK-ILRI
HSQLMRLMV	HSQLMRLMV
RSFQTSAI	RSFQ-TSAI
QSLRLRTI	QSLR-LRTI
SSYPTTTI	SSYP-TTTI
TVGNNKTL	TVGN-NKTL
AQFKLLLV	AQFK-LLLV
MGYKTIMV	MGYK-TIMV
SQITPHAI	SQIT-PHAI
GLGSGGSIRSS	SGGS-IRSS
RQVLALRI	RQVL-ALRI
LQKEMQVI	LQKE-MQVI
GQDDKIRVV	GQDDKIRVV
VQLRLNSI	VQLR-LNSI
AMIERITFI	AMIERITFI
VSYPGKNKI	VSYPGKNKI
FEVILTRI	FEVI-LTRI
HGIEFSVI	HGIE-FSVI
IMRQTLEI	IMRQ-TLEI
SQARFGQSV	SQARFGQSV
QQQQALQV	QQQQ-ALQV
YQRLLHEV	YQRL-LHEV
ATYVFLHTV	ATYVFLHTV
VGILITTI	VGIL-ITTI
MQIRIHQI	MQIR-IHQI
QALEVLKI	QALE-VLKI
VAPGKDLTK	VAPGKDLTK
SQDPGTHVV	SQDPGTHVV
IQRGPVRGI	IQRGPVRGI
VQSQLRHI	VQSQ-LRHI
NQFVVHTV	NQFV-VHTV
NAPWAVTSL	NAPWAVTSL
GQDMFRETI	GQDMFRETI
RQHVLTRI	RQHV-LTRI
AQMLIRIV	AQML-IRIV
AQSKILFV	AQSK-ILFV
RQLPSQKTV	RQLPSQKTV
RQMELVSV	RQME-LVSV
AQYDPAKPNYI	AQYD-PAKP
KMPSVIKI	KMPS-VIKI
RQLAVLNV	RQLA-VLNV
HGKILNGV	HGKI-LNGV
RQKEIPRV	RQKE-IPRV
HQSVTKVV	HQSV-TKVV
FKQYANDNGVD	KQYANDNGV
GQYYAIKKI	GQYYAIKKI
VMYGFKGV	VMYG-FKGV
SQRELDTV	SQRE-LDTV
MQVTLKTL	MQVT-LKTL
SQYPLEKV	SQYP-LEKV
HQMQLVDSI	HQMQLVDSI
ERLKIRGSL	ERLKIRGSL
VQYPPKKV	VQYP-PKKV
QQHAQFPII	QQHAQFPII
AQLLQLKV	AQLL-QLKV
KQFESKII	KQFE-SKII
KQGTQYTFSSI	TQYT-FSSI
TISSNVASKA	SSNV-ASKA
QQVQIHQI	QQVQ-IHQI
HQQKLTEI	HQQK-LTEI
HSYLSRLI	HSYL-SRLI
AQLLNMPVV	AQLLNMPVV
RQMIMIRSI	RQMIMIRSI
LMAPAPSTV	LMAPAPSTV
LQYSLTKI	LQYS-LTKI
SQFELLKV	SQFE-LLKV
SQRYQVGV	SQRY-QVGV
TKSQIPLSKI	SQIP-LSKI
RQHPQPYI	RQHP-QPYI
RQYYLSKI	RQYY-LSKI
NQVAVNTTI	NQVAVNTTI
TIRYPDPLI	TIRYPDPLI
TQRAFKEV	TQRA-FKEV
RMARTPQTV	RMARTPQTV
IFYKTKEI	IFYK-TKEI
SQLVIHQRI	SQLVIHQRI
HGLTVPLI	HGLT-VPLI
SSRLILSNV	SSRLILSNV
HSTIMPRLSE	HSTI-MPRL
QKDKTSVI	QKDK-TSVI
AQYKFFIV	AQYK-FFIV
GQFLVRII	GQFL-VRII
HQQQVAQAV	HQQQVAQAV
EQLELERI	EQLE-LERI
HQLVPLQV	HQLV-PLQV
SQNILPTI	SQNI-LPTI
VMLHALLI	VMLH-ALLI
ESLRLILV	ESLR-LILV
HQEVLREI	HQEV-LREI
QSYIFPSSI	QSYIFPSSI
YQYPVIIHL	YQYPVIIHL
VQRTQAPAV	VQRTQAPAV
AQVLLQKV	AQVL-LQKV
HQNKILSSV	HQNKILSSV
MQRSTLSV	MQRS-TLSV
AAPAYSRAL	AAPAYSRAL
AQYEDIAQK	AQYEDIAQK
HQATFRLNV	HQATFRLNV
SQMPIRKI	SQMP-IRKI
HSMKMEEI	HSMK-MEEI
YQRETPQV	YQRE-TPQV
VQLLIPRI	VQLL-IPRI
AQKALAKV	AQKA-LAKV
EQQKVRTI	EQQK-VRTI
YQHLLVNSI	YQHLLVNSI
VQKVLGSV	VQKV-LGSV
HQHQVELI	HQHQ-VELI
LSFILHTI	LSFI-LHTI
HQIFHVLVV	HQIFHVLVV
SMFEPPQV	SMFE-PPQV
EQRKIPLV	EQRK-IPLV
MEFQVPVI	MEFQ-VPVI
RQLEKIKTI	RQLEKIKTI
EQIKVLEV	EQIK-VLEV
IQSIMAIV	IQSI-MAIV
HLPETKFSEL	HLPETFSEL
AQHALTSV	AQHA-LTSV
EQVSTPEI	EQVS-TPEI
MQTEFHHV	MQTE-FHHV
KMMKIAEI	KMMK-IAEI
HQREIQVM	HQRE-IQVM
AQLELISRI	AQLELISRI
FQRTNALTV	FQRTNALTV
AQRVQENMI	AQRVQENMI
VMYRVIQV	VMYR-VIQV
TAPTASKI	TAPT-ASKI
SAPVGVTAL	SAPVGVTAL
VQYIVLQNI	VQYIVLQNI
VQHVVMTAI	VQHVVMTAI
GLMRKVPRV	GLMRKVPRV
TQVLIKLI	TQVL-IKLI
TSPTVLYV	TSPT-VLYV
VQTVLPLV	VQTV-LPLV
ESFTFRNHV	ESFTFRNHV
YENEVALRQ	YENEVALRQ
YSSEQLLI	YSSE-QLLI
SQRLQTQI	SQRL-QTQI
YQHIVTTLV	YQHIVTTLV
AEYIQKNV	AEYI-QKNV
AMLAVLHTV	AMLAVLHTV
LSAPLPLL	LSAP-LPLL
SQYPELLV	SQYP-ELLV
GQYAGHVV	GQYA-GHVV
RQQQQLLI	RQQQ-QLLI
QQVQQVHV	QQVQ-QVHV
GSYVFENTV	GSYVFENTV
GQILMPNIGY	GQIL-MPNI
HQIMHLLSV	HQIMHLLSV
GQKHFGATV	GQKHFGATV
AQRLVRVL	AQRL-VRVL
AQYKFVYQV	AQYKFVYQV
SSPSVLEI	SSPS-VLEI
EQYRQVISV	EQYRQVISV
DFIRILVI	DFIR-ILVI
TAYYALVV	TAYY-ALVV
HQLKTKVV	HQLK-TKVV
RSVLIANTV	RSVLIANTV
AQFEHTLLV	AQFEHTLLV
AQYENPPHI	AQYENPPHI
GMMPPQPGI	GMMPPQPGI
SAVELPKI	SAVE-LPKI
AQLTQRSV	AQLT-QRSV
SQTKLKEV	SQTK-LKEV
GQIAILYV	GQIA-ILYV
AAVEEILPSLK	VEEI-LPSL
GQERFRTI	GQER-FRTI
AMVRVISV	AMVR-VISV
HQVVLPVL	HQVV-LPVL
QQMENRPSV	QQMENRPSV
FQNTFPHSI	FQNTFPHSI
VQYQAPQL	VQYQ-APQL
HQTISALI	HQTI-SALI
HQRTFVLEV	HQRTFVLEV
EQFLLPVI	EQFL-LPVI
GQILMPNI	GQIL-MPNI
SQLKLWNV	SQLK-LWNV
HGHPQPQV	HGHP-QPQV
AQRAFILTV	AQRAFILTV
LQQAKDEI	LQQA-KDEI
AQHPNIVTV	AQHPNIVTV
RQFSHRAI	RQFS-HRAI
YMFATKVV	YMFA-TKVV
QSKILKVI	QSKI-LKVI
EQIELHNSI	EQIELHNSI
YSKMLAKV	YSKM-LAKV
EEIAALVI	EEIA-ALVI
TSNQMLVPVI	NQML-VPVI
IQDEIRSVI	IQDEIRSVI
VQRLEPVIM	VQRLEPVIM
VMHPFWNTI	VMHPFWNTI
SFYEHIITV	SFYEHIITV
RMFDGKFVV	RMFDGKFVV
RMLAHPLHV	RMLAHPLHV
EQYKFPVVI	EQYKFPVVI
HQAKMREI	HQAK-MREI
REFQTSVV	REFQ-TSVV
QSYVVNRV	QSYV-VNRV
HSYSPITV	HSYS-PITV
TQVVVSRI	TQVV-VSRI
SQLRVAKV	SQLR-VAKV
VQKLYEHIV	VQKLYEHIV
FQITPKTV	FQIT-PKTV
AMAPVTTRI	AMAPVTTRI
AQLSVKQV	AQLS-VKQV
HSQLMQLI	HSQL-MQLI
REYPNLVTI	REYPNLVTI
HQVPAVSSV	HQVPAVSSV
YQYMHETI	YQYM-HETI
AAPATRAAL	AAPATRAAL
AFLKVSSV	AFLK-VSSV
TEYPVKIV	TEYP-VKIV
AQYLINVRL	AQYLINVRL
SQQLVHVTV	SQQLVHVTV
HQYITKMT	HQYI-TKMT
GQRVIPRI	GQRV-IPRI
IQSIIAII	IQSI-IAII
HSHLALSV	HSHL-ALSV
RQHEIVLKV	RQHEIVLKV
HSLYTPVI	HSLY-TPVI
RGYKLPKV	RGYK-LPKV
VSLLVQRTI	VSLLVQRTI
KQMRILMV	KQMR-ILMV
HQFQMQLL	HQFQ-MQLL
IQTKVNYV	IQTK-VNYV
SLYGGTITI	SLYGGTITI
EEQLQQIRAE	EQLQQIRAE
NAFATPTI	NAFA-TPTI
AQITTLLV	AQIT-TLLV
RMFFGKNKV	RMFFGKNKV
VEYAFKAI	VEYA-FKAI
IQYDRTLLV	IQYDRTLLV
HQAWLQSI	HQAW-LQSI
ASIDLPGI	ASID-LPGI
VQDLAKAV	VQDL-AKAV
TSFILRAV	TSFI-LRAV
RQVLIRQI	RQVL-IRQI
VMEYHPRII	VMEYHPRII
AQRFILRHV	AQRFILRHV
MQWVLPKI	MQWV-LPKI
TQTVISSI	TQTV-ISSI
HQLSLRTV	HQLS-LRTV
SQFAFESV	SQFA-FESV
ISPTGHSL	ISPT-GHSL
YQFRLIVI	YQFR-LIVI
PWPKVLKI	PWPK-VLKI
LQRTLNEL	LQRT-LNEL
QQLQIIHRV	QQLQIIHRV
SQYPFPVTL	SQYPFPVTL
VFFMPATV	VFFM-PATV
HQQVVSRI	HQQV-VSRI
HQFYPTVV	HQFY-PTVV
SSYIVKNI	SSYI-VKNI
HQVVVANI	HQVV-VANI
AMAPTSPQI	AMAPTSPQI
KQLQLTTV	KQLQ-LTTV
HQYRLLHT	HQYR-LLHT
FQHVFVIV	FQHV-FVIV
MMQQPARSV	MMQQPARSV
HQGILSRV	HQGI-LSRV
GGLYAKLVQ	GGLYAKLVQ
QQYQWLEKV	QQYQWLEKV
HSLQMLHTI	HSLQMLHTI
VMLKAIRI	VMLK-AIRI
LQYQQPSI	LQYQ-QPSI
AQFAQPEI	AQFA-QPEI
AQFGYYFRV	AQFGYYFRV
AQYFLDKI	AQYF-LDKI
KLYGKPIRV	KLYGKPIRV
VQVALSRV	VQVA-LSRV
HSILIANI	HSIL-IANI
IQKLSKAV	IQKL-SKAV
EQWQTMEI	EQWQ-TMEI
YQLPLSKI	YQLP-LSKI
HEYTTKEI	HEYT-TKEI
EYLTAEIL	EYLT-AEIL
FQRLTVTI	FQRL-TVTI
GQLKSLTI	GQLK-SLTI
EQYGKIEVI	EQYGKIEVI
TMIKIVLI	TMIK-IVLI
EMYVPRVV	EMYV-PRVV
NEYVFRETV	NEYVFRETV
RQDYARLV	RQDY-ARLV
KQYVLLSI	KQYV-LLSI
AQYVLLAL	AQYV-LLAL
LQFPVGRV	LQFP-VGRV
FQTILTEI	FQTI-LTEI
HQRSFDIGI	HQRSFDIGI
MMYQTGMKI	MMYQTGMKI
HQHEEIQNV	HQHEEIQNV
SQMGIRSSI	SQMGIRSSI
VSRVVTQNI	VSRVVTQNI
DPFNPFELTNH	NPFE-LTNH
VQFLIYQI	VQFL-IYQI
IQQPQPLI	IQQP-QPLI
AQYKFIYV	AQYK-FIYV
EQLALPVL	EQLA-LPVL
AQTPIAVI	AQTP-IAVI
QQIELLEV	QQIE-LLEV
QQYVFINQM	QQYVFINQM
VQFVFDAV	VQFV-FDAV
AMYFIQQKV	AMYFIQQKV
AMNSQILEV	AMNSQILEV
TQVQTTLV	TQVQ-TTLV
AMAASPHAV	AMAASPHAV
FSFAHQTI	FSFA-HQTI
AQHMNISTV	AQHMNISTV
AQNARALKI	AQNARALKI
SFFKSLVI	SFFK-SLVI
QSTLLREI	QSTL-LREI
HQFIQEENI	HQFIQEENI
QMLTRILVI	QMLTRILVI
QQIQAQLV	QQIQ-AQLV
SEYPVILSI	SEYPVILSI
RQIKINEV	RQIK-INEV
SLYPIAVLI	SLYPIAVLI
SHVVTTSV	SHVV-TTSV
SQTLQRSI	SQTL-QRSI
AQFAARAI	AQFA-ARAI
RQLGHALLV	RQLGHALLV
FQYFVKVV	FQYF-VKVV
TQLPQSMKI	TQLPQSMKI
VQYLVKEV	VQYL-VKEV
IQYLSKIKI	IQYLSKIKI
HQALINQV	HQAL-INQV
IERATRLV	IERA-TRLV
VQVPVPVTV	VQVPVPVTV
ASYVNLPTI	ASYVNLPTI
GQLELKSV	GQLE-LKSV
HQYITKMTA	HQYITKMTA
HSYILVKI	HSYI-LVKI
RFIQLLKV	RFIQ-LLKV
HSKLIAKV	HSKL-IAKV
LERTFIAI	LERT-FIAI
HQFLMDTI	HQFL-MDTI
TQVKKPVI	TQVK-KPVI
TQFSHLTV	TQFS-HLTV
HGPKALKV	HGPK-ALKV
LQVLVNAI	LQVL-VNAI
HQHEYFFLI	HQHEYFFLI
VEYQMKSV	VEYQ-MKSV
HQHPHPPVGP	HQHP-HPPV
HMFAPRHV	HMFA-PRHV
HQQTLQRV	HQQT-LQRV
VAIPLPGV	VAIP-LPGV
ESRQFPVTV	ESRQFPVTV
IQYALRTL	IQYA-LRTL
LMNAVVQTV	LMNAVVQTV
TTYKLVINGK	TTYK--LVI
VQIRIFKI	VQIR-IFKI
IQLKTSVI	IQLK-TSVI
LSFTMPQI	LSFT-MPQI
AQQIQKVV	AQQI-QKVV
SQTIQPKV	SQTI-QPKV
SDNQYRLIVNV	NQYRLIVNV
SQIVFRSV	SQIV-FRSV
YQTELTFI	YQTE-LTFI
ITLNRHVI	ITLN-RHVI
FQHPARLV	FQHP-ARLV
AQKQLRSI	AQKQ-LRSI
AVRVPAPSI	AVRVPAPSI
IQLELDTV	IQLE-LDTV
TIQVLPTV	TIQV-LPTV
LAPLAKVI	LAPL-AKVI
ASIALARI	ASIA-LARI
YAPAAATV	YAPA-AATV
HQFETLDV	HQFE-TLDV
ALYEQSLHI	ALYEQSLHI
HQFSPHIL	HQFS-PHIL
VMQKTPII	VMQK-TPII
SQFMYDEHI	SQFMYDEHI
SQHPGLLV	SQHP-GLLV
HQIQNVVTV	HQIQNVVTV
SSFVFSTV	SSFV-FSTV
AFPQAAKI	AFPQ-AAKI
KMFEVDMKI	KMFEVDMKI
MQQILTRV	MQQI-LTRV
QQRLVVVSV	QQRLVVVSV
AQYLINARL	AQYLINARL
SQYSGQLKV	SQYSGQLKV
AEQNRKDAEAW	EQNRKDAEA
TYDDATKTF	TYDDATKTF
KQIEINTI	KQIE-INTI
YEILLHEV	YEIL-LHEV
VMKKIIETV	VMKKIIETV
VMTIPIPIV	VMTIPIPIV
AMAKPQVVV	AMAKPQVVV
NVKVDPEIQ	NVKVDPEIQ
MQIFLPRI	MQIF-LPRI
TGYLNTVTV	TGYLNTVTV
AFMPVLKV	AFMP-VLKV
AQYNFILV	AQYN-FILV
VMAEALGV	VMAE-ALGV
NMPKVKTI	NMPK-VKTI
IQKRFGLNI	IQKRFGLNI
AQTFLSEI	AQTF-LSEI
AQYGKKVMV	AQYGKKVMV
SQYNIRGV	SQYN-IRGV
QQYENLVV	QQYE-NLVV
LQRTMNEI	LQRT-MNEI
RVYIHPFHL	RVYIHPFHL
NQIQMKETV	NQIQMKETV
FEYILSHV	FEYI-LSHV
GQLLVKPTI	GQLLVKPTI
VEIQTPKI	VEIQ-TPKI
NSMLVSIV	NSML-VSIV
QQKVLHETI	QQKVLHETI
SSPEALTV	SSPE-ALTV
SMPTEKKI	SMPT-EKKI
QQLALQWV	QQLA-LQWV
AMLGVTTV	AMLG-VTTV
HQIIHAGV	HQII-HAGV
QQHSPQQI	QQHS-PQQI
LEHPFVSSI	LEHPFVSSI
EQRVVKRI	EQRV-VKRI
VQIVSKKV	VQIV-SKKV
NQFRVDYI	NQFR-VDYI
SQHKFASNV	SQHKFASNV
AQYPKGRSV	AQYPKGRSV
AQYRLVTEI	AQYRLVTEI
NQIILNKV	NQII-LNKV
VQIRIKLM	VQIR-IKLM
HQALVRKL	HQAL-VRKL
HQFLVSET	HQFL-VSET
KQIVLTGI	KQIV-LTGI
HSIQIMKV	HSIQ-IMKV
HEITVLII	HEIT-VLII
GMFKIARV	GMFK-IARV
SFYPYIHVV	SFYPYIHVV
HQNQAKLVV	HQNQAKLVV
VQMALSKV	VQMA-LSKV
HQQTFLNQL	HQQTFLNQL
VQIEQLYV	VQIE-QLYV
QQVFIQKV	QQVF-IQKV
AMYKKSLHI	AMYKKSLHI
EQYEHASI	EQYE-HASI
HQYDGLVEL	HQYDGLVEL
EQYAAKVSI	EQYAAKVSI
TEKPEVID	TEKP-EVID
KQRLTPKLF	KQRLTPKLF
RQIDQFLVV	RQIDQFLVV
AQAVIREV	AQAV-IREV
LQFIFTNI	LQFI-FTNI
SQRPVLKV	SQRP-VLKV
TQYEFQVRV	TQYEFQVRV
SMYDKVLML	SMYDKVLML
QQVQRLPFL	QQVQRLPFL
IQTELHHV	IQTE-LHHV
SQIFARKV	SQIF-ARKV
NSRAFTNLV	NSRAFTNLV
NQTPLPLI	NQTP-LPLI
QQKVVITKV	QQKVVITKV
LQFQFAEV	LQFQ-FAEV
AQYHLMLHI	AQYHLMLHI
VFFPEEPKV	VFFPEEPKV
HAHPFFFTI	HAHPFFFTI
TGTEMRTV	TGTE-MRTV
TQYKFRLTA	TQYKFRLTA
RQYPWGTVQV	RQYPWTVQV
VQKLVVVI	VQKL-VVVI
SSRIIKNNI	SSRIIKNNI
RQYVVRAV	RQYV-VRAV
LQFPVGRI	LQFP-VGRI
HQITVLHV	HQIT-VLHV
GSRLYAHTI	GSRLYAHTI
SQKIKPQV	SQKI-KPQV
YQIAVTKV	YQIA-VTKV
FELDLPTV	FELD-LPTV
AMLERQFTV	AMLERQFTV
HQLPLPHNV	HQLPLPHNV
KMYGKIIRV	KMYGKIIRV
YQYGFNLV	YQYG-FNLV
HQMETHYRV	HQMETHYRV
SQFIADVI	SQFI-ADVI
GQIFKPII	GQIF-KPII
IFLKTRVV	IFLK-TRVV
TQVQQMQV	TQVQ-QMQV
VSYLFSHV	VSYL-FSHV
SSYPVALI	SSYP-VALI
FQYAVRVI	FQYA-VRVI
AQILQILTV	AQILQILTV
YSKAFTLTI	YSKAFTLTI
YFAERVTSL	YFAERVTSL
TAPTGHTL	TAPT-GHTL
YENEVALR	YENE-VALR
EQIKIKKI	EQIK-IKKI
VQIPIMLV	VQIP-IMLV
FQQYLPVV	FQQY-LPVV
TQRNVEVI	TQRN-VEVI
ISPASPKI	ISPA-SPKI
VQVTFGRTI	VQVTFGRTI
TQRISLEI	TQRI-SLEI
EMLKTIKTV	EMLKTIKTV
VMFGGKQVV	VMFGGKQVV
EQYPTRPHI	EQYPTRPHI
VFIELNHI	VFIE-LNHI
MLFGHPLLV	MLFGHPLLV
VQVSTSNI	VQVS-TSNI
VQRSFTQV	VQRS-FTQV
VMKHADPRI	VMKHADPRI
FSYAFPKAV	FSYAFPKAV
HGPKAVTI	HGPK-AVTI
FQTEIQTV	FQTE-IQTV
HQRIHPGI	HQRI-HPGI
GSNQYLFSVI	NQYL-FSVI
IEKIMAQI	IEKI-MAQI
NQTVMTTI	NQTV-MTTI
NQRNVPGI	NQRN-VPGI
VVYGGKSTI	VVYGGKSTI
SNQMLVPVI	SNQMLVPVI
SSYVVKKV	SSYV-VKKV
VERVKPRI	VERV-KPRI
QSYKVRLV	QSYK-VRLV
HQRSFTETM	HQRSFTETM
MQHPPSTI	MQHP-PSTI
TQKKPSISI	TQKKPSISI
GQTIIHHHI	GQTIIHHHI
RAPLVPKV	RAPL-VPKV
SQRYVVAV	SQRY-VVAV
AQVKQLEM	AQVK-QLEM
SSWRVISSI	SSWRVISSI
AMYEHKIFV	AMYEHKIFV
LMPPVKQV	LMPP-VKQV
AMPLISLV	AMPL-ISLV
TQLTTEKI	TQLT-TEKI
NQYIAEMV	NQYI-AEMV
RQKALRMV	RQKA-LRMV
NQIRLTNV	NQIR-LTNV
SAYLVAEKV	SAYLVAEKV
SAWRVISSI	SAWRVISSI
NQYQFDKV	NQYQ-FDKV
RQAFIRKV	RQAF-IRKV
IQYIRPVFV	IQYIRPVFV
VFIKAVHV	VFIK-AVHV
LLRQLLKL	LLRQ-LLKL
SQQLQLRV	SQQL-QLRV
HQLFHIFVV	HQLFHIFVV
HQVPQANTI	HQVPQANTI
ELKLLQSL	ELKL-LQSL
EQFKFKNMV	EQFKFKNMV
RQLKIKEV	RQLK-IKEV
TMPVTMLI	TMPV-TMLI
HQNDKQISI	HQNDKQISI
HQNVFPNHI	HQNVFPNHI
EQRLFTEKV	EQRLFTEKV
HQSRLASI	HQSR-LASI
VQATPSKV	VQAT-PSKV
FMYKPKKV	FMYK-PKKV
SIPEKNRPL	SIPEKNRPL
GQIVQSKI	GQIV-QSKI
AQNISKTI	AQNI-SKTI
VQNPQAQTI	VQNPQAQTI
HQDILSTI	HQDI-LSTI
VPYPLPKI	VPYP-LPKI
SQILVNQI	SQIL-VNQI
AQTTLRNV	AQTT-LRNV
SQLSVPEI	SQLS-VPEI
YQIRLESV	YQIR-LESV
QMLENQMEV	QMLENQMEV
YEKQLAQI	YEKQ-LAQI
IMYKGRTV	IMYK-GRTV
TQYSAVRTV	TQYSAVRTV
YQTSPPKV	YQTS-PPKV
HSNEVIMTI	HSNEVIMTI
HGHLYVNKV	HGHLYVNKV
LSRPQPEI	LSRP-QPEI
NQMLVPVI	NQML-VPVI
HQVVTHLL	HQVV-THLL
KQLYLRSV	KQLY-LRSV
VQIPVSAV	VQIP-VSAV
FEILTPKI	FEIL-TPKI
VQYKFSHL	VQYK-FSHL
TVDEKNYTKAM	EKNY-TKAM
MQTEVHHV	MQTE-VHHV
GQSPPLPRI	GQSPPLPRI
SQVAVQKV	SQVA-VQKV
SEYITHEI	SEYI-THEI
TQVVISRI	TQVV-ISRI
EQRIVQQV	EQRI-VQQV
AQVPMNMTI	AQVPMNMTI
AASLLPVL	AASL-LPVL
SQFSYQHAI	SQFSYQHAI
EQYRIRQV	EQYR-IRQV
TQYTTHHI	TQYT-THHI
YQTKAVII	YQTK-AVII
VFYGHHAKI	VFYGHHAKI
SAPAVLVV	SAPA-VLVV
SSYIVSQI	SSYI-VSQI
HQIIQRHL	HQII-QRHL
HQFSTLRI	HQFS-TLRI
HAPEIVSTV	HAPEIVSTV
KMIGIKKV	KMIG-IKKV
HQIMPKEI	HQIM-PKEI
YMLKANLI	YMLK-ANLI
HQAQLISKI	HQAQLISKI
SQYLTRITI	SQYLTRITI
VQRRFVQEV	VQRRFVQEV
HGMTLKSV	HGMT-LKSV
HQKEITVI	HQKE-ITVI
QSTRLPLI	QSTR-LPLI
HSVTVPLV	HSVT-VPLV
VQRLEPVI	VQRL-EPVI
HQRYDVLI	HQRY-DVLI
SFPMTPSI	SFPM-TPSI
TQRVISFI	TQRV-ISFI
RQYLAINQI	RQYLAINQI
FALYPINIS	FALYPINIS
MSLMIRQTI	MSLMIRQTI
AQVLLHNV	AQVL-LHNV
HQTELSNL	HQTE-LSNL
NQLELLRV	NQLE-LLRV
HQQHTTVI	HQQH-TTVI
VQLETLSI	VQLE-TLSI
AQNLIGISI	AQNLIGISI
SQIITSVV	SQII-TSVV
NQRVLVTSV	NQRVLVTSV
EQLAWLRV	EQLA-WLRV
HQQEISKI	HQQE-ISKI
HQTIVMQFI	HQTIVMQFI
SQRSFVEFI	SQRSFVEFI
TQVTVQKI	TQVT-VQKI
RQYYPVTI	RQYY-PVTI
LLQAIAQL	LLQA-IAQL
IQKVHPAI	IQKV-HPAI
TVTEKPEVID	TVTE-KPEV
QALILKIA	QALI-LKIA
HQKGGIPNV	HQKGGIPNV
RQYPETKII	RQYPETKII
RMGFPQHTI	RMGFPQHTI
AQNPSLFV	AQNP-SLFV
TQMKLMAI	TQMK-LMAI
NQVEQLRV	NQVE-QLRV
QQYRALTV	QQYR-ALTV
HQHEMSVL	HQHE-MSVL
SQHMTEVV	SQHM-TEVV
AQYEHDLEV	AQYEHDLEV
SQASMKQV	SQAS-MKQV
SAPEVLLV	SAPE-VLLV
AQRSFRVSI	AQRSFRVSI
RQLTLRKL	RQLT-LRKL
SFPTAKYI	SFPT-AKYI
KQYDKALEI	KQYDKALEI
TQRTFLKEV	TQRTFLKEV
ASPAVLEL	ASPA-VLEL
QQIEQKSI	QQIE-QKSI
VQFQPNTV	VQFQ-PNTV
VQFLVPQSI	VQFLVPQSI
GQQVIRSV	GQQV-IRSV
KMMDVTVTI	KMMDVTVTI
RQMTVIRKV	RQMTVIRKV
HQQLIPLV	HQQL-IPLV
FQALLTVV	FQAL-LTVV
HSYLQENKI	HSYLQENKI
EAWPALQI	EAWP-ALQI
MMPAVFHTV	MMPAVFHTV
RQMVFNEI	RQMV-FNEI
KQLIAKKI	KQLI-AKKI
LSPVVPQI	LSPV-VPQI
RQIVLAKV	RQIV-LAKV
EFPTVLDI	EFPT-VLDI
IQNRIIEV	IQNR-IIEV
RQFPGSHRV	RQFPGSHRV
RQYLILRNI	RQYLILRNI
RQMFVQRV	RQMF-VQRV
AQIRYLTQV	AQIRYLTQV
SQWEVSQV	SQWE-VSQV
KQVQQPSV	KQVQ-QPSV
SMHDRSLKV	SMHDRSLKV
TQRIFQEAV	TQRIFQEAV
EMYNRPVEV	EMYNRPVEV
SQAMLNAV	SQAM-LNAV
RQQIKPAV	RQQI-KPAV
SQSLLPAI	SQSL-LPAI
HMAKAFKEV	HMAKAFKEV
HQRVLYIDI	HQRVLYIDI
SGRTFLHTV	SGRTFLHTV
SQFVMEGV	SQFV-MEGV
HSYAVSSV	HSYA-VSSV
RMPIARKI	RMPI-ARKI
VEYITRYI	VEYI-TRYI
QQLVSHEV	QQLV-SHEV
LLYGHTVTV	LLYGHTVTV
VQLAVNRV	VQLA-VNRV
AQAVFPAI	AQAV-FPAI
TTSQYLMHEV	SQYL-MHEV
FQHVFLVV	FQHV-FLVV
YSQVFKETV	YSQVFKETV
VFLRVSEV	VFLR-VSEV
HQLSQHVTV	HQLSQHVTV
ARLGVISKV	ARLGVISKV
SQRSVTSV	SQRS-VTSV
AQARAAEI	AQAR-AAEI
SQTTVLVV	SQTT-VLVV
IQYQAVPQI	IQYQAVPQI
SQYSFAGSSI	SQYSFGSSI
VLYDRPLKI	VLYDRPLKI
VQQVSLVI	VQQV-SLVI
NQYKFILL	NQYK-FILL
KQLSILKV	KQLS-ILKV
AQILLKAL	AQIL-LKAL
MQFRSILI	MQFR-SILI
SSHLVATV	SSHL-VATV
VQYKATSL	VQYK-ATSL
HSRALVGI	HSRA-LVGI
FQRLVREI	FQRL-VREI
SSFAHAQV	SSFA-HAQV
HSRPVPKL	HSRP-VPKL
QQQVIRKI	QQQV-IRKI
YQRAPRNI	YQRA-PRNI
IQRVGQAV	IQRV-GQAV
HQIIMPSAI	HQIIMPSAI
SMFSPASI	SMFS-PASI
VSTYIKKI	VSTY-IKKI
KQMLVSEV	KQML-VSEV
AQFKQLLI	AQFK-QLLI
VQSLKRKI	VQSL-KRKI
LNRKIVQV	LNRK-IVQV
HQRQVYLQI	HQRQVYLQI
GQAGALRALG	GQAGALRAL
LQTALLVV	LQTA-LLVV
MQIFVKTL	MQIF-VKTL
GQQIQIQTV	GQQIQIQTV
AGFAGDDAPR	AGFAGDDAP
AQRIMTLSV	AQRIMTLSV
DAPVALVV	DAPV-ALVV
SMPTVTQI	SMPT-VTQI
AQVKVAEV	AQVK-VAEV
NSYPVTMSI	NSYPVTMSI
HQLAMTVV	HQLA-MTVV
GSTLTPKI	GSTL-TPKI
HSPYVAQI	HSPY-VAQI
GLQYIFAHV	GLQYIFAHV
LQRVIDTI	LQRV-IDTI
AQIYVDKV	AQIY-VDKV
IIHEIAVLEL	HEIA-VLEL
IQHIQNAI	IQHI-QNAI
GQLHVLRV	GQLH-VLRV
RQHVIDVQI	RQHVIDVQI
VSPRVLEV	VSPR-VLEV
HSPKVNLV	HSPK-VNLV
KMPEVITI	KMPE-VITI
HSTIMPRL	HSTI-MPRL
AMYPPSMI	AMYP-PSMI
GQVQVLKV	GQVQ-VLKV
KQIIKPFI	KQII-KPFI
MQRHIRLV	MQRH-IRLV
HSFIFFNKV	HSFIFFNKV
YQYTTLTSV	YQYTTLTSV
GQKITHVV	GQKI-THVV
EFPTVPLV	EFPT-VPLV
IQRIFLITL	IQRIFLITL
VQFASQEI	VQFA-SQEI
GQWEVKKI	GQWE-VKKI
SQYPGAKYI	SQYPGAKYI
AQHLQAAV	AQHL-QAAV
VGYILSVV	VGYI-LSVV
QMVIGFLV	QMVI-GFLV
HQIAQMGV	HQIA-QMGV
TQYGLERI	TQYG-LERI
HQKIQYVV	HQKI-QYVV
QQFYQPKI	QQFY-QPKI
HSMITRKV	HSMI-TRKV
VQYEMRTLY	VQYEMRTLY
FQKAIQETV	FQKAIQETV
VMGPQEKKV	VMGPQEKKV
QQLEFLNEI	QQLEFLNEI
IQKTIQMV	IQKT-IQMV
AMINRFQFV	AMINRFQFV
RQKLQLEKV	RQKLQLEKV
TEFIFTTI	TEFI-FTTI
YQHGIFQSI	YQHGIFQSI
TQQKVPTI	TQQK-VPTI
QQLEMYSI	QQLE-MYSI
GMYLISKYI	GMYLISKYI
SMFGAGLTV	SMFGAGLTV
YDAEISQIHQ	YDAE-ISQI
GQVAVRNV	GQVA-VRNV
VQYAYFKKV	VQYAYFKKV
SQNPYHNAV	SQNPYHNAV
YQFRMEEI	YQFR-MEEI
NMLKVNLI	NMLK-VNLI
LQKELKKV	LQKE-LKKV
SQYKSHFV	SQYK-SHFV
IQREVSLM	IQRE-VSLM
AMIKGLQV	AMIK-GLQV
FQTIHKTI	FQTI-HKTI
YSKIFTENI	YSKIFTENI
NQLKNTNTI	NQLKNTNTI
SQIKLYNI	SQIK-LYNI
HQLILSKL	HQLI-LSKL
VFPKAKQV	VFPK-AKQV
HSFISNAV	HSFI-SNAV
ISKIQPSV	ISKI-QPSV
MQYQVLNEV	MQYQVLNEV
SQKKTVTI	SQKK-TVTI
VQFKLVLV	VQFK-LVLV
GMYVFLHAV	GMYVFLHAV
TQNVVTKV	TQNV-VTKV
SFYKIRTI	SFYK-IRTI
VSKILPRV	VSKI-LPRV
LSYAVRKV	LSYA-VRKV
TAPLVVVV	TAPL-VVVV
SQYYIRAV	SQYY-IRAV
LPYQVVEV	LPYQ-VVEV
SQMIVKEI	SQMI-VKEI
TQHTPTSI	TQHT-PTSI
LQWPSLTV	LQWP-SLTV
RQYPWGVVQV	RQYPWVVQV
RQNLVALTV	RQNLVALTV
HQYPNFKDI	HQYPNFKDI
AQIRTIAI	AQIR-TIAI
TGYTTRNI	TGYT-TRNI
EQYYVRKV	EQYY-VRKV
LEYEARQI	LEYE-ARQI
KQYYALEV	KQYY-ALEV
QFQAVLRV	QFQA-VLRV
AQYLLQNSV	AQYLLQNSV
VSHAIIRTI	VSHAIIRTI
IQMSVQRI	IQMS-VQRI
QSHTFISSV	QSHTFISSV
GQHAFYQLI	GQHAFYQLI
VFPRPEPFV	VFPRPEPFV
FRVPTANVS	FRVPTANVS
ASLPLPLL	ASLP-LPLL
LQYEFTKL	LQYE-FTKL
RQFVPIKV	RQFV-PIKV
IGLQHKSV	IGLQ-HKSV
HQYTGSAL	HQYT-GSAL
ELGAQLLEL	ELGAQLLEL
EEIPALKI	EEIP-ALKI
HSWLILQV	HSWL-ILQV
EMVALPPV	EMVA-LPPV
SSTPLPTI	SSTP-LPTI
GMYDGSALI	GMYDGSALI
VQNGIALV	VQNG-IALV
SQLLVHVL	SQLL-VHVL
TQRAQPAV	TQRA-QPAV
GQRIQNVNV	GQRIQNVNV
HQLIVVDI	HQLI-VVDI
HSFTQPRL	HSFT-QPRL
GSFILPHI	GSFI-LPHI
SQRITNQV	SQRI-TNQV
SQMTFHKI	SQMT-FHKI
AFIKRTPVI	AFIKRTPVI
RQHLQQSI	RQHL-QQSI
QQISILTV	QQIS-ILTV
HSYSPRAI	HSYS-PRAI
SQPPVFKV	SQPP-VFKV
VQYQVIPQI	VQYQVIPQI
YQQALSRV	YQQA-LSRV
HQKQISSL	HQKQ-ISSL
HSKIVAGV	HSKI-VAGV
TMLATKTV	TMLA-TKTV
IMDRILQI	IMDR-ILQI
VMYGKVYRI	VMYGKVYRI
QQLQQRQI	QQLQ-QRQI
GQELARVV	GQEL-ARVV
LQAALARV	LQAA-LARV
QQVILVQV	QQVI-LVQV
AQYQFTGI	AQYQ-FTGI
RQIGQRTI	RQIG-QRTI
KYYLAPKI	KYYL-APKI
SQVEILQRV	SQVEILQRV
LFLRTPKI	LFLR-TPKI
HQHTISTL	HQHT-ISTL
GQREPLTV	GQRE-PLTV
VMADIRELI	VMADIRELI
SQLQVHMV	SQLQ-VHMV
TQVRIQTV	TQVR-IQTV
ASYRAQPSV	ASYRAQPSV
VQRHLTAV	VQRH-LTAV
AQTALTVV	AQTA-LTVV
KIYEGQVEV	KIYEGQVEV
EQYLLKMV	EQYL-LKMV
LQVAIKVI	LQVA-IKVI
QQLVLRTV	QQLV-LRTV
HSIATRVI	HSIA-TRVI
VFPVVPRL	VFPV-VPRL
VGYYIFRV	VGYY-IFRV
HQILTPFL	HQIL-TPFL
VQYNMKIVI	VQYNMKIVI
QMLAVVETI	QMLAVVETI
VQIRILDV	VQIR-ILDV
RLYDTHITV	RLYDTHITV
RQILAPVV	RQIL-APVV
VMFKTPVSI	VMFKTPVSI
DQYKFYSV	DQYK-FYSV
LQLKMIGI	LQLK-MIGI
NQQLALKV	NQQL-ALKV
GQLLIKTV	GQLL-IKTV
QQVLVRKL	QQVL-VRKL
VLYENKVAV	VLYENKVAV
HQYIFSHI	HQYI-FSHI
HQTLLVVV	HQTL-LVVV
GLYSRQLYV	GLYSRQLYV
AQVKVLFV	AQVK-VLFV
VMLVQPRV	VMLV-QPRV
AQKISVRTV	AQKISVRTV
AQVLIREV	AQVL-IREV
GFYPGQVLI	GFYPGQVLI
HAFKISKI	HAFK-ISKI
TQTVIHTV	TQTV-IHTV
EQIEIIRI	EQIE-IIRI
GNQIETPSI	GNQIETPSI
FEFEYQTKV	FEFEYQTKV
EQYVTKTV	EQYV-TKTV
SQLQALHI	SQLQ-ALHI
EQRAIAKI	EQRA-IAKI
KAWKALEI	KAWK-ALEI
AQSTQPVV	AQST-QPVV
KMAPALRKV	KMAPALRKV
HMQQQPVV	HMQQ-QPVV
RQLVFNEI	RQLV-FNEI
HQLILAFL	HQLI-LAFL
KQFHHQLRV	KQFHHQLRV
LQYLVPIL	LQYL-VPIL
AMFRPFVEV	AMFRPFVEV
SQLLLAHV	SQLL-LAHV
HQEYLNSI	HQEY-LNSI
HQYPFVVL	HQYP-FVVL
VMFGGKQVVV	VMFG-GKQV
AQFETKKL	AQFE-TKKL
HSPSVAKI	HSPS-VAKI
SQQRLAQV	SQQR-LAQV
YAYRHPLI	YAYR-HPLI
HQYVVGDTI	HQYVVGDTI
EQYLFLVRV	EQYLFLVRV
QQLRLVRI	QQLR-LVRI
HALELLVI	HALE-LLVI
RQLIHRSV	RQLI-HRSV
RQYMFSSL	RQYM-FSSL
SQTILKPL	SQTI-LKPL
VMRIMDPEI	VMRIMDPEI
KQFLVKVLI	KQFLVKVLI
ASPTALLI	ASPT-ALLI
HAVYALKV	HAVY-ALKV
AQFKFTVL	AQFK-FTVL
FQKEVAQV	FQKE-VAQV
KQYQAGQTV	KQYQAGQTV
AVDSRTGKLT	DSRT-GKLT
YDYILPQV	YDYI-LPQV
SQFIEPKI	SQFI-EPKI
TQYIPLSI	TQYI-PLSI
VQVLIEHI	VQVL-IEHI
HQQSIPAV	HQQS-IPAV
HATIIPKV	HATI-IPKV
YERLFGTTV	YERLFGTTV
AQFRFYRHV	AQFRFYRHV
RAYQKQPTI	RAYQKQPTI
FMPLVIKV	FMPL-VIKV
KMLKVKIV	KMLK-VKIV
GQYPPPTV	GQYP-PPTV
HQVQVNHI	HQVQ-VNHI
VQYPYQLYI	VQYPYQLYI
TQYRFTII	TQYR-FTII
VFRDQEPKI	VFRDQEPKI
YSIVIRQI	YSIV-IRQI
KQIDQFLVV	KQIDQFLVV
HQFLQYHV	HQFL-QYHV
IMRSPQMV	IMRS-PQMV
HQLLALAI	HQLL-ALAI
HQNMARAI	HQNM-ARAI
FTGKVLLV	FTGK-VLLV
IQFPIQKI	IQFP-IQKI
QQHVIETLI	QQHVIETLI
TAPLAPTI	TAPL-APTI
NSYVSPRI	NSYV-SPRI
LPFRVLLV	LPFR-VLLV
VQYAAVRRV	VQYAAVRRV
IQKLFSERI	IQKLFSERI
LQQAKEDL	LQQA-KEDL
AQLRVSEI	AQLR-VSEI
TFLPFIHTI	TFLPFIHTI
AQIQVQHV	AQIQ-VQHV
QQAQPQQTV	QQAQPQQTV
HQREITSL	HQRE-ITSL
TGFIFQKV	TGFI-FQKV
LQLQIPRI	LQLQ-IPRI
VQLKKLPKV	VQLKKLPKV
SQIPLSKI	SQIP-LSKI
IQHQTIHI	IQHQ-TIHI
IAPTGHSL	IAPT-GHSL
VEIILHVV	VEII-LHVV
QQIRVLLM	QQIR-VLLM
SQVQVPQI	SQVQ-VPQI
HQHMVKYI	HQHM-VKYI
TSREIQTAV	TSREIQTAV
RQFAAQTV	RQFA-AQTV
VQKAVTAI	VQKA-VTAI
VGTTIAEL	VGTT-IAEL
TMPVVPSV	TMPV-VPSV
AAKDPSPSV	AAKDPSPSV
LQYKPTVI	LQYK-PTVI
LGLAMMVA	LGLA-MMVA
QSLATPVV	QSLA-TPVV
KFLKILQV	KFLK-ILQV
AMFPVTHI	AMFP-VTHI
ASYPIPLV	ASYP-IPLV
HGSYVLRV	HGSY-VLRV
HGVELLKI	HGVE-LLKI
VQRIAERV	VQRI-AERV
GQVIIHNI	GQVI-IHNI
QQVIQHNTI	QQVIQHNTI
HQHNPVQV	HQHN-PVQV
IQKLTKAV	IQKL-TKAV
NQTIFEQTI	NQTIFEQTI
SQYPWSQRV	SQYPWSQRV
AQVATKNV	AQVA-TKNV
RMFFHFSEI	RMFFHFSEI
AQILRLLHI	AQILRLLHI
RFMKITVI	RFMK-ITVI
NQISLPRL	NQIS-LPRL
IQHLIPKI	IQHL-IPKI
HQRLEPATL	HQRLEPATL
LRQHIAEL	LRQH-IAEL
LEKLLPPV	LEKL-LPPV
VSYKPQKI	VSYK-PQKI
QMPSDKTI	QMPS-DKTI
GMYPNLVHV	GMYPNLVHV
MQYLPQHTI	MQYLPQHTI
HQINLIKV	HQIN-LIKV
SQFQIHHL	SQFQ-IHHL
TEYQPRAV	TEYQ-PRAV
AQLAVTKI	AQLA-VTKI
QQSVLQRI	QQSV-LQRI
YGHKLPVI	YGHK-LPVI
AQELMPVV	AQEL-MPVV
RGSQQYRALTV	QQYR-ALTV
TQWRVRMI	TQWR-VRMI
RQKLDPKI	RQKL-DPKI
LQTAFRTV	LQTA-FRTV
TMVETKKV	TMVE-TKKV
TQLAVNKI	TQLA-VNKI
KMLKPTGRVV	KMLKPTGRV
EQLIIPQV	EQLI-IPQV
AAPEGVPL	AAPE-GVPL
KMFQVHQV	KMFQ-VHQV
SQRFTVQI	SQRF-TVQI
NQRVLWWSI	NQRVLWWSI
SQYQLNSI	SQYQ-LNSI
VSAPPMPSV	VSAPPMPSV
SQRPGAHLTV	SQRPGHLTV
HGVFLPLV	HGVF-LPLV
YFPVVKLV	YFPV-VKLV
HGLEMRTI	HGLE-MRTI
NMYGFRKV	NMYG-FRKV
HQNLVTGV	HQNL-VTGV
QMLKARSV	QMLK-ARSV
SVPEAQSAL	SVPEAQSAL
EQRVPLSV	EQRV-PLSV
DPASLPRVLRV	ASLPRVLRV
GQIKLREI	GQIK-LREI
VQSQPPRV	VQSQ-PPRV
VQIKQETI	VQIK-QETI
SQIYLHHI	SQIY-LHHI
TQIQALKV	TQIQ-ALKV
HQTGLKVV	HQTG-LKVV
HGIPMSHV	HGIP-MSHV
HQSVEPVV	HQSV-EPVV
RQMSVNSSI	RQMSVNSSI
YSHIMALI	YSHI-MALI
PFPTVLRV	PFPT-VLRV
EFPIAPEI	EFPI-APEI
IQWIVVRI	IQWI-VVRI
TQTPSLKV	TQTP-SLKV
EEFITPIV	EEFI-TPIV
TMFVQRQV	TMFV-QRQV
RQVKLVNI	RQVK-LVNI
SQHVSPKI	SQHV-SPKI
NMPAVKAI	NMPA-VKAI
SQVLSQKI	SQVL-SQKI
VQKKLESI	VQKK-LESI
KFYESIMKI	KFYESIMKI
SMKIMHEI	SMKI-MHEI
TQFVLSTL	TQFV-LSTL
SQYLMHEV	SQYL-MHEV
KLYEQHHVV	KLYEQHHVV
AQYSPQQL	AQYS-PQQL
TQTLLKEI	TQTL-LKEI
RQKLVRNI	RQKL-VRNI
VQYNEPLKV	VQYNEPLKV
KEIKGRTV	KEIK-GRTV
VSPVVRVAV	VSPVVRVAV
SNIVIPLI	SNIV-IPLI
VQRTMLELI	VQRTMLELI
AQVHIPSI	AQVH-IPSI
NQFPGFKEV	NQFPGFKEV
HSRFIFNYV	HSRFIFNYV
TQRSFQKI	TQRS-FQKI
NMLKILAI	NMLK-ILAI
GQFNFVHVI	GQFNFVHVI
AQAALQAV	AQAA-LQAV
SQLELKSLI	SQLELKSLI
SGYAPLSV	SGYA-PLSV
IGYKIKTLI	IGYKIKTLI
SQLAVLKV	SQLA-VLKV
SQVKATVI	SQVK-ATVI
SMLRISTI	SMLR-ISTI
RMYPPPLI	RMYP-PPLI
SQWSPALTI	SQWSPALTI
HSVFQLQI	HSVF-QLQI
TQYTFSSI	TQYT-FSSI
EFYRALYI	EFYR-ALYI
IMMNTPVI	IMMN-TPVI
SMIGTSTI	SMIG-TSTI
QQIQIQTV	QQIQ-IQTV
VQRQMVVSV	VQRQMVVSV
HQLPIKTV	HQLP-IKTV
SQFPKHLIV	SQFPKHLIV
LQRKQMVI	LQRK-QMVI
AQTFIQRV	AQTF-IQRV
QQFLLKVV	QQFL-LKVV
SAYRVKTV	SAYR-VKTV
HSLKLWRI	HSLK-LWRI
GQFKIGLI	GQFK-IGLI
IGGNAYQHSKV	NAYQ-HSKV
TQKTFLTEV	TQKTFLTEV
GQFIARAV	GQFI-ARAV
TMKKLPIV	TMKK-LPIV
VQHIPSPKV	VQHIPSPKV
GQYKSKLV	GQYK-SKLV
RQFTVRKV	RQFT-VRKV
YQHSPSSTV	YQHSPSSTV
HQKVLNVSI	HQKVLNVSI
AQIVTRSV	AQIV-TRSV
VMVISPVI	VMVI-SPVI
TQLTIHQRV	TQLTIHQRV
AQKSPAPKV	AQKSPAPKV
GQYFEPVV	GQYF-EPVV
QMYRTEIRM	QMYRTEIRM
VATVSLPR	VATV-SLPR
MMPPPVGMV	MMPPPVGMV
TSQYLMHEV	TSQYLMHEV
RQVVLKYTV	RQVVLKYTV
IFIRILQV	IFIR-ILQV
QLPNVPHSLP	QLPNVPHSL
LFLQTPKI	LFLQ-TPKI
QQRLIREQI	QQRLIREQI
AQRLATVV	AQRL-ATVV
EQWTPSHV	EQWT-PSHV
IQLGITHTV	IQLGITHTV
RQLEIKQI	RQLE-IKQI
IQHVFQNLI	IQHVFQNLI
TSPKALVI	TSPK-ALVI
