Data	Data aligned
LPTSGAAATAA	LPTSGAATA
VPQQPTYVQA	VPQQPYVQA
SPLQKALLA	SPLQKALLA
LPHGAISEDQA	LPHGAISED
APNRFWASVEP	APNRFWASV
TPAPSAPAAA	TPAPSAPAA
SPTFQHAV	SPTF-QHAV
IPYDQSGFVSA	IPYDQFVSA
RPAAAPPAGA	RPAAAPAGA
IPAAAIGEKA	IPAAAGEKA
APHPGLSEA	APHPGLSEA
APNEFQGQVIA	APNEFQGQV
RPLSRLQAA	RPLSRLQAA
HPWETVTTAA	HPWETTTAA
APAALFLAA	APAALFLAA
APFGKISDA	APFGKISDA
IIHEIAVLEL	IIHEIVLEL
RPAPLPAAV	RPAPLPAAV
MPILIDFHA	MPILIDFHA
QPYRFPQA	QPYR-FPQA
YPLEKVAEA	YPLEKVAEA
RPNSGIIDA	RPNSGIIDA
KPVLPHKVA	KPVLPHKVA
TPNQNFSTA	TPNQNFSTA
HPFPGPGLAI	HPFPGGLAI
LPFLAPGARA	LPFLAGARA
YLKDGPYITA	YLKDGYITA
SPMPGTLTA	SPMPGTLTA
QPHSSALTA	QPHSSALTA
APLEEARQFAA	APLEERQFA
APYTHFTQA	APYTHFTQA
RPIVIDGSNVA	IVIDGSNVA
SPFDHSRIKL	SPFDHRIKL
TPQEKIFIAA	TPQEKFIAA
MPQLNAIIAA	MPQLNIIAA
KPQPNIIPTV	KPQPNIPTV
HPIEPVLITA	HPIEPLITA
FPMEIRQYLA	FPMEIQYLA
YPIALTRA	YPIA-LTRA
SPFSSFISV	SPFSSFISV
VPKSAVQQVA	VPKSAQQVA
SPFHFQPSAA	SPFHFQPSA
QPAPAIHSA	QPAPAIHSA
RPIYIKDYVT	RPIYIKDYV
APARAVSAV	APARAVSAV
SLVNLGGSK	SLVNLGGSK
IPTEVRSKA	IPTEVRSKA
HPITAKAIA	HPITAKAIA
VPAEPSPKA	VPAEPSPKA
APRSLPAAMA	APRS-LPAA
LPAPAEVAA	LPAPAEVAA
APHLEKQPA	APHLEKQPA
TPQEDYVEA	TPQEDYVEA
LPVPQKIEA	LPVPQKIEA
SPSTVFFGA	SPSTVFFGA
RPIDHWDAV	RPIDHWDAV
FPKPYPNSEA	FPKPYNSEA
MPLLKSEVA	MPLLKSEVA
YPVESSKSA	YPVESSKSA
APFPKTQIA	APFPKTQIA
LPARTQETPSA	LPARTTPSA
HPFYTRAA	HPFY-TRAA
NPAPPIDAV	NPAPPIDAV
KPKPIGKLA	KPKPIGKLA
APAPAAHVA	APAPAAHVA
RPYTGKVGA	RPYTGKVGA
KPNTTVQVPA	KPNTTQVPA
GPMPFLGRAA	GPMPFGRAA
LPWKPVFITA	LPWKPFITA
RPKPPNVRT	RPKPPNVRT
LLLPGELAK	LLLPGELAK
APGPAPPVSA	APGPAPVSA
NPFGGASHA	NPFGGASHA
LPAAKGFVA	LPAAKGFVA
TPFKPILEA	TPFKPILEA
KPLEPVSTV	KPLEPVSTV
APVNIAGSRTA	APVNIAGSR
EIKKPPVSER	IKKPPVSER
RPLQDEPAAA	RPLQDPAAA
RPYLQRKDV	RPYLQRKDV
KPFQPALPLVV	KPFQPLPLV
APFQNILPRV	APFQNLPRV
APIEETAAA	APIEETAAA
LPEEIREPA	LPEEIREPA
SPGLQKEAV	SPGLQKEAV
TPKPVSIAT	TPKPVSIAT
SPNPFSVHTA	SPNPFVHTA
RPATDLPEA	RPATDLPEA
SPDSPVTSA	SPDSPVTSA
APFYSSDILIA	APFYSILIA
YPFPGRLLP	YPFPGRLLP
APAKFQPASA	APAKFPASA
APAPVIISS	APAPVIISS
SPAGSIARNSA	SPAGSRNSA
FPWPQPLST	FPWPQPLST
VPYGTPLSV	VPYGTPLSV
RPKSAFKVQNA	RPKSAFKVQ
SPQGQVLSA	SPQGQVLSA
LPAGINSIVA	LPAGISIVA
APRQPGLMA	APRQPGLMA
QPSPAQPRAEA	SPAQPRAEA
IPRSFMMEV	IPRSFMMEV
RPLQDEPAA	RPLQDEPAA
RPAPLPAAVV	RPAPLPAAV
VPAPAHLVAT	VPAPAHLVA
MPATLARAA	MPATLARAA
VPFQVPEILRT	VPFQVPEIL
LPQSYIHTSA	LPQSYHTSA
VPNLQTVSV	VPNLQTVSV
IPYTGPFNLL	IPYTGPFNL
LPKSSSQEVEA	LPKSSSQEV
VPWGGAAAV	VPWGGAAAV
VAVLQEVAA	VAVLQEVAA
EYLEKIKQR	EYLEKIKQR
KAQLQQVEA	KAQLQQVEA
HPYLFPVAAM	HPYLFPVAA
APYGNPKNMA	APYGNKNMA
APSRVVVVA	APSRVVVVA
HPIYLATGTSA	IYLATGTSA
RPHAPGRPA	RPHAPGRPA
RPNGVSAVA	RPNGVSAVA
SPFGTITSA	SPFGTITSA
APAEPGWKA	APAEPGWKA
SPLSAAAATAA	SPLSAAATA
TPSAGAVAA	TPSAGAVAA
TPYNYPVPV	TPYNYPVPV
MPQSGTGVSV	MPQSGGVSV
SIPEKNRPL	SIPEKNRPL
SPNMANTVNA	SPNMATVNA
RPGPVLPAV	RPGPVLPAV
IPAHDSPLAA	IPAHDPLAA
RPYFPADATA	RPYFPDATA
APTSAGKTLVA	APTSAGKTL
LPHHRVIEV	LPHHRVIEV
MPPPVSPSTA	MPPPVPSTA
LPHDRMTSQEA	LPHDRMTSQ
QPPSLPAVSA	QPPSLAVSA
SPVTDFREA	SPVTDFREA
IPKGKISIVEA	IPKGKISIV
SPSNVTLPQV	SPSNVLPQV
KPAKPLISV	KPAKPLISV
YPLDLLLKL	YPLDLLLKL
DPPSNPVAA	DPPSNPVAA
FPIKQPITV	FPIKQPITV
HPSHVQLKVVA	HPSHVLKVV
RPLSGSGISA	RPLSGGISA
IPWGISATA	IPWGISATA
RARVPGPPA	RARVPGPPA
TPTPVPVV	TPTP-VPVV
RPLSKQLSA	RPLSKQLSA
SPREELHYA	SPREELHYA
SPNSILKAA	SPNSILKAA
IAAQGFTVAA	AAQGFTVAA
APHEILIQIV	APHEIIQIV
SPRPVVVET	SPRPVVVET
LPAPPHIDV	LPAPPHIDV
VPAGGAVA	VPAG-GAVA
SPAKTLPGA	SPAKTLPGA
RVAEVIFPTA	RVAEVFPTA
ESLPRVVKR	ESLPRVVKR
SPLIQKSAA	SPLIQKSAA
RPSHFLNFA	RPSHFLNFA
IPYDQSPGPK	IPYDQSPGP
SPVLPLTSA	SPVLPLTSA
IFFNVHSA	IFFN-VHSA
TPMPPISSV	TPMPPISSV
NPAAAAAAVAA	AAAAAAVAA
KPQNMPKA	KPQN-MPKA
HPKPEGLAA	HPKPEGLAA
LPGPLTPVA	LPGPLTPVA
KPHSGFHVA	KPHSGFHVA
RPHNLPVV	RPHN-LPVV
LPNIQKVEV	LPNIQKVEV
KPKPAGVLGA	KPKPAVLGA
APGVLPSA	APGV-LPSA
EYTINIHKR	EYTINIHKR
SPAYRDLAA	SPAYRDLAA
VPAPFFLPA	VPAPFFLPA
PQSREKIIAAL	QSREKIIAA
RPSQAAPAV	RPSQAAPAV
APVLFAKAA	APVLFAKAA
RPYEPINSI	RPYEPINSI
TPHAIVILP	TPHAIVILP
TPFHHRVSV	TPFHHRVSV
SPSDIGIIA	SPSDIGIIA
SPHPSAAVPAA	SPHPSAVPA
LPVQLQRAMA	LPVQLRAMA
YPSTAVRHMA	YPSTARHMA
LPSESMKVVA	LPSESKVVA
IAPTGHSL	IAPT-GHSL
KPFLLPVEA	KPFLLPVEA
APRPTIINA	APRPTIINA
SPARLYAIAA	SPARLAIAA
SPDGRWLISA	SPDGRLISA
VPLSHLINA	VPLSHLINA
HPIHIIPASA	HPIHIPASA
IPVKSSPQA	IPVKSSPQA
SPHPPSEVTA	SPHPPEVTA
SPREPGYKA	SPREPGYKA
IPAGTVTVNAA	IPAGTTVNA
APHALLQAVL	APHALLQAV
SPTRPPVAA	SPTRPPVAA
KPLQPARPV	KPLQPARPV
TPVYLGATA	TPVYLGATA
APFVPVGIAG	APFVPVGIA
RPSSTFNTV	RPSSTFNTV
HPFKGFLLEA	HPFKGLLEA
APAPPKAEAKA	APAPPKAEA
VPVVLVGNKA	VPVVLGNKA
GGGLSVSSSR	GGLSVSSSR
SPLYLAHEV	SPLYLAHEV
SPSVPKTSA	SPSVPKTSA
QPYSKLPGV	QPYSKLPGV
MPNPQLNIKA	MPNPQNIKA
RLPNALRAA	RLPNALRAA
MPRDILIVV	MPRDILIVV
LPNGPLLGT	LPNGPLLGT
LPSDLTRAA	LPSDLTRAA
SPHVAVLEA	SPHVAVLEA
YPAPQVSTA	YPAPQVSTA
RPKGLEGERPA	RPKGLGERP
RPRPAPGSPP	RPRPAGSPP
SPKQILDSA	SPKQILDSA
SPPVPGPSA	SPPVPGPSA
MPWGDPNYRSA	MPWGDYRSA
TPKEVGDVIA	TPKEVDVIA
RPSPPVQSV	RPSPPVQSV
VPKAQKETV	VPKAQKETV
LPTDASTTAV	LPTDASTTA
TVYEGFISA	TVYEGFISA
TPPPFSLPSV	TPPPFLPSV
TPAHVLPSAA	TPAHVLPSA
LPSLSPLSA	LPSLSPLSA
QVFDAKNMMAA	FDAKNMMAA
RPSELLAGVKA	RPSELLAGV
IPIYSKEPNSA	IYSKEPNSA
QPGEALAEA	QPGEALAEA
KPLPPIQVA	KPLPPIQVA
IPRGIPLDAA	IPRGILDAA
RPHRGILAV	RPHRGILAV
RPYAPINANA	RPYAPNANA
QPWAQTVVV	QPWAQTVVV
RPFVAINYA	RPFVAINYA
VPVGILSA	VPVG-ILSA
FPSAAATAA	FPSAAATAA
SPFAEGTSA	SPFAEGTSA
IPTPIVGV	IPTP-IVGV
QPQPQPYAV	QPQPQPYAV
SPHQVTPQA	SPHQVTPQA
TPHFSGLAA	TPHFSGLAA
VPATPRLPA	VPATPRLPA
NPNQYHYVA	NPNQYHYVA
IPYQPMPAS	IPYQPMPAS
IPKPEQLSA	IPKPEQLSA
APAGVFGVA	APAGVFGVA
PLSPMLYSSSA	SPMLYSSSA
YPSEHLIQA	YPSEHLIQA
IPYRPKPSS	IPYRPKPSS
RPIQVKPAA	RPIQVKPAA
SPSPPSVAV	SPSPPSVAV
RPLAQLREV	RPLAQLREV
SPLSAARAA	SPLSAARAA
APTKALVNQVA	APTKAVNQV
APHFVHPNDHA	APHFVHPND
APAEEPAAAAA	APAEEPAAA
APFAAHGYGA	APFAAGYGA
MPQIPVASV	MPQIPVASV
AVDSRTGKLT	AVDSRGKLT
IPYHSEVPVSL	IPYHSEVPV
APLNLGMIAA	APLNLMIAA
SPFPPAKSA	SPFPPAKSA
IPAQGHFGISA	IPAQGGISA
HPWVTGKAA	HPWVTGKAA
LPHGAISED	LPHGAISED
KPTVQPWIA	KPTVQPWIA
KPAGPLGATA	KPAGPGATA
VPKKPGPPVL	VPKKPGPPV
VVRPAHISA	VVRPAHISA
IPHSLPGA	IPHS-LPGA
RPAFVIPEV	RPAFVIPEV
TPLLSGKAA	TPLLSGKAA
APFQTSQASA	APFQTQASA
HPHLVAEA	HPHL-VAEA
TYDDATKTF	TYDDATKTF
RPAPHFERTA	RPAPHERTA
RPSSLHGLAA	RPSSLGLAA
KPAPPFNVT	KPAPPFNVT
LPHAILRLDLA	LPHAIRLDL
VTIKKDVDGAY	TIKKDVDGA
MPAPPPKENA	MPAPPKENA
MPNGDHIVSA	MPNGDIVSA
KPVLTQESA	KPVLTQESA
FPVRLLVAA	FPVRLLVAA
VPIKPLPNV	VPIKPLPNV
SPILVATAVA	SPILVTAVA
IPKTINRAA	IPKTINRAA
APAAATVAVA	APAAATVAV
APTEMAKAA	APTEMAKAA
APLAVLQGHSA	APLAVGHSA
RPAPALAPAA	RPAPAAPAA
VPVEPVLTV	VPVEPVLTV
IPVESIEEV	IPVESIEEV
LPASAGHPRA	LPASAHPRA
APAALPSSTAA	APAALSSTA
MPYLIGVHA	MPYLIGVHA
SPKPALRYAA	SPKPARYAA
SPNGKLTVA	SPNGKLTVA
SPKQILDSAA	SPKQILDSA
VTIKKDVDG	VTIKKDVDG
LPKPRMRGLLA	KPRMRGLLA
SPAHAVDAV	SPAHAVDAV
IPFYGILGA	IPFYGILGA
APWPPKGLVPA	APWPPLVPA
SPLPQYVTV	SPLPQYVTV
APASVVPAPA	APASVPAPA
HPFDLGLYNEA	HPFDLYNEA
NARLAADD	NARL-AADD
EVRKLIIRR	EVRKLIIRR
LTKPVEISA	LTKPVEISA
APVNVTTEV	APVNVTTEV
APKAGPGVV	APKAGPGVV
SPIENIQRVA	SPIENQRVA
YPHQVPLVL	YPHQVPLVL
APGYSYTAA	APGYSYTAA
APWSGRFYS	APWSGRFYS
QPYYATRVNAA	QPYYARVNA
MPLSTIREV	MPLSTIREV
RPAPPRAPA	RPAPPRAPA
NVEIDPEIQ	NVEIDPEIQ
SPLSTPTSAQA	SPLSTPTSA
TPRPVIVEP	TPRPVIVEP
RPALPVSYLQA	RPALPYLQA
DPHSGHFVA	DPHSGHFVA
RPAPVAVAA	RPAPVAVAA
AVFHLEHAA	AVFHLEHAA
RPITPPRNSA	RPITPRNSA
KPAMPMQQA	KPAMPMQQA
RPREVQDPAPA	RPREVQDPA
HPHPFLNSV	HPHPFLNSV
GPFGQIFRP	GPFGQIFRP
APAPSLFPAA	APAPSFPAA
LPELLGLEA	LPELLGLEA
RNVSTGDVN	RNVSTGDVN
SPLSSHPVV	SPLSSHPVV
IPKKLMHQA	IPKKLMHQA
RPYSRKLEA	RPYSRKLEA
APRFGGSRA	APRFGGSRA
SPSTVIHGA	SPSTVIHGA
LPVDKAFYEA	LPVDKFYEA
TPHTVTAISA	TPHTVAISA
VPIEVLPTVL	VPIEVLPTV
KPLRPLGKAA	KPLRPGKAA
SPHPSPLGA	SPHPSPLGA
RPYLGYDWIA	RPYLGDWIA
APYPGFLSV	APYPGFLSV
IPRNQLQSV	IPRNQLQSV
MPQNPHIIA	MPQNPHIIA
LPLSAHGIVV	LPLSAGIVV
SPHRPILQA	SPHRPILQA
APIRLPEHVTV	APIRLPEHV
MPMERQMSV	MPMERQMSV
AAAAAAKVPA	AAAAAKVPA
RQGVDADING	QGVDADING
RPIASGPVV	RPIASGPVV
VPHNVQVAA	VPHNVQVAA
APAPPPAEA	APAPPPAEA
IDNNIEQISSY	IDNNIQISS
RPKSSQIGAVV	RPKSSQIGA
QPYSKLPGVSL	QPYSKLPGV
SPSSSSLAA	SPSSSSLAA
SPTGKEFVSA	SPTGKFVSA
LPYKWVVEA	LPYKWVVEA
IPKDKSWKA	IPKDKSWKA
IPVNGGLAA	IPVNGGLAA
TPAALDGTVA	TPAALGTVA
VPAPSPLSA	VPAPSPLSA
RPVKIRKI	RPVK-IRKI
RPKPDYFAV	RPKPDYFAV
RPFTNLESA	RPFTNLESA
VPNKFLVTA	VPNKFLVTA
LVGPVLGAA	LVGPVLGAA
PAKKITAA	PAKK-ITAA
SPRTPVSPVKF	SPRTPVSPV
APRLQSEVA	APRLQSEVA
SPLNTHAA	SPLN-THAA
TPFYFKEPS	TPFYFKEPS
HPKPEGLAAA	HPKPEGLAA
SPYAAMLAA	SPYAAMLAA
IPKDYKTMAA	IPKDYTMAA
HPSPVVLKVY	HPSPVVLKV
YPGFNPFRA	YPGFNPFRA
LHPAPPNGL	LHPAPPNGL
RPWSPAVSA	RPWSPAVSA
RPPGFSPFR	RPPGFSPFR
SPLPDTSLLQV	LPDTSLLQV
LVRPVVPSA	LVRPVVPSA
APQETRGIPS	APQETGIPS
APFQGLLQA	APFQGLLQA
VPKPLFPVA	VPKPLFPVA
YPFANKESI	YPFANKESI
NAPWAVTSL	NAPWAVTSL
VPYEIQKGQA	VPYEIKGQA
VPKNSDPWAA	VPKNSPWAA
IPFYLQPHA	IPFYLQPHA
APQLRPAGTA	APQLRAGTA
LAQQVQQVAA	LAQQVQVAA
TPMYTHSIAA	TPMYTSIAA
AQYEDIAQK	AQYEDIAQK
SYTSGPGSR	SYTSGPGSR
APLDSIHSLAA	APLDSIHSL
LPIDLNNKSA	LPIDLNKSA
HPHLRKVSV	HPHLRKVSV
LPVAFKVVA	LPVAFKVVA
SPHPAIQPLQA	HPAIQPLQA
ATVLQAVSA	ATVLQAVSA
RPSLLRPVSA	RPSLLPVSA
IPASKLVEA	IPASKLVEA
IPLYLKGGVA	IPLYLGGVA
APVAVEPGAA	APVAVPGAA
RPPLNPVSA	RPPLNPVSA
SPSELFAQHIV	SPSELFAQH
SPYHGFTIV	SPYHGFTIV
RPAPLSAELQA	APLSAELQA
LPSRFIESA	LPSRFIESA
SPNMANTVNAA	SPNMATVNA
QPIFAVTSA	QPIFAVTSA
IPFWRNTAV	IPFWRNTAV
RPVNDMNIA	RPVNDMNIA
HPSPVVLKV	HPSPVVLKV
AEQRGENALKD	AEQRGENAL
MPHPATGKTVA	HPATGKTVA
LVYQGYLAA	LVYQGYLAA
YPTHVKVTA	YPTHVKVTA
SPHLPGTSSA	SPHLPTSSA
KPQATVVSA	KPQATVVSA
IAKGWQDVTA	IAKGWDVTA
VPFKDMPAT	VPFKDMPAT
GPFDEFQIA	GPFDEFQIA
LPKAGKFGPA	LPKAGFGPA
SPHGGLTVSA	SPHGGTVSA
SPRPPLISV	SPRPPLISV
VPAKGLATSV	VPAKGATSV
LPYNGVVLA	LPYNGVVLA
APITGQVSA	APITGQVSA
VPHQPFSQA	VPHQPFSQA
APDEKYVAA	APDEKYVAA
VPYGEFKSV	VPYGEFKSV
SPYHNFDSV	SPYHNFDSV
FPTHPYFSA	FPTHPYFSA
KPAPPQTEQV	KPAPPTEQV
IVSGSLNHAA	IVSGSNHAA
LPAEFPDKVFA	LPAEFPDKV
RIFDRAVAA	RIFDRAVAA
FPGEQFKPA	FPGEQFKPA
APGPATREA	APGPATREA
RPRDSQLYAV	RPRDSLYAV
IPQVMAIA	IPQV-MAIA
LPPSTGTFQEA	PPSTGFQEA
IPFSKPVKV	IPFSKPVKV
SPTLLLAEA	SPTLLLAEA
KPKEPQPEV	KPKEPQPEV
APHAPGPPA	APHAPGPPA
AVFFQSHSA	AVFFQSHSA
LPHSGYSDSA	LPHSGSDSA
SPYIPPHAA	SPYIPPHAA
RPAPVAVAAA	RPAPVAVAA
IPYHIVNIV	IPYHIVNIV
VPSPGLPVSA	VPSPGPVSA
APSPSHPISA	APSPSPISA
LPVGQHIYLSA	LPVGQYLSA
MPNGTPHPTA	MPNGTHPTA
YPRPGTPAA	YPRPGTPAA
SPRIATTTA	SPRIATTTA
SPNSYFMDV	SPNSYFMDV
GPWVGTGLAA	GPWVGGLAA
IPFLVPGIRY	IPFLVGIRY
APMALFYPATF	APMALFYPA
IPKHINPVA	IPKHINPVA
GPRLSAEAA	GPRLSAEAA
IPDGRVSVSA	IPDGRSVSA
APMPYLIGVHA	MPYLIGVHA
APRSFHPPA	APRSFHPPA
SPARGGIGA	SPARGGIGA
TPIGVQAEA	TPIGVQAEA
KPMEIARIVA	KPMEIRIVA
YPSAPFLAA	YPSAPFLAA
GYSFTTTAER	YSFTTTAER
APRIALHTA	APRIALHTA
KPLSSLTPLIA	KPLSSLTPL
FPVGVFVVA	FPVGVFVVA
VPTNIIAA	VPTN-IIAA
IPVETIETTV	IPVETETTV
RPHSALLAV	RPHSALLAV
TPSIPVLTA	TPSIPVLTA
VPAKKITAA	VPAKKITAA
SPYKDLLDPA	SPYKDLDPA
APVAVWAALA	APVA-VWAA
APQSLGSSA	APQSLGSSA
YPNFAGPHAA	YPNFAPHAA
SPNKTGGFGA	SPNKTGFGA
AAGPVGMAA	AAGPVGMAA
NPYHNAVHA	NPYHNAVHA
SPLASGAVA	SPLASGAVA
TPRAATVKA	TPRAATVKA
RPALAVGVTA	RPALAGVTA
VPRPASVSA	VPRPASVSA
IVREDLLSA	IVREDLLSA
KPHSQIPVS	KPHSQIPVS
HPAAFPLPV	HPAAFPLPV
SPAGILVDA	SPAGILVDA
KPHDIFEAN	KPHDIFEAN
IPFGTMVAV	IPFGTMVAV
MPLHVAPLLAA	MPLHVLLAA
SPLNAMPRA	SPLNAMPRA
LPKDVSPTQA	LPKDVPTQA
VPAGGAVAV	VPAGGAVAV
SAFLPARFYQA	LPAR-FYQA
APDGSLILVSA	APDGSLVSA
LAGPLRPAA	LAGPLRPAA
IPTTIYKA	IPTT-IYKA
PYLFPVAA	PYLF-PVAA
YPLLLPKGVVL	YPLLLPKGV
QPYAPPRDFAA	QPYAPRDFA
SPFGLKPRSA	SPFGLPRSA
YPTRPHIAA	YPTRPHIAA
VPQEAQKIQA	VPQEAKIQA
APVVPAVST	APVVPAVST
APILSPEAA	APILSPEAA
RPWYSHPVYA	RPWYSPVYA
MPQPVPTA	MPQP-VPTA
RPIPNQPPTA	RPIPNPPTA
IPRNQLQSVAA	IPRNQLQSV
IPYLSKHRA	IPYLSKHRA
VPSPVAISA	VPSPVAISA
VPMPSNKDYVV	MPSNKDYVV
SPVENVTAA	SPVENVTAA
VPAGSGLSA	VPAGSGLSA
HPAAFPLPVV	HPAAFLPVV
LPAEAVEAA	LPAEAVEAA
SVPSNPVAA	SVPSNPVAA
LPLPYGVSA	LPLPYGVSA
VPLGALNPA	VPLGALNPA
RVYIHPFHL	RVYIHPFHL
APQSIPRSA	APQSIPRSA
SPDEGALVRAA	SPDEGLVRA
IPSSVIHPA	IPSSVIHPA
TPRPPLRPGA	TPRPPRPGA
APLDAYFQV	APLDAYFQV
IPRQLGEVA	IPRQLGEVA
APKLGSNIA	APKLGSNIA
TPFYPRSPYGA	YPRS-PYGA
TPTPPFQQA	TPTPPFQQA
NPSPSTSISA	NPSPSSISA
RPKPPNVRTA	RPKPPVRTA
RDIPRVTAL	RDIPRVTAL
RPRAPIIAVTR	RPRAPIIAV
HPNVTLTISA	HPNVTTISA
HPTSIVKA	HPTS-IVKA
APVAAHTVTA	APVAATVTA
APAPSLFPA	APAPSLFPA
RPQPQPRPA	RPQPQPRPA
APHPPVADV	APHPPVADV
QPLPVILHV	QPLPVILHV
TPHPVLTPVAA	TPHPVTPVA
SPYYFLTSA	SPYYFLTSA
KPIKFLVSV	KPIKFLVSV
HPTASLIAKVA	HPTASIAKV
AGAPGPLPAP	AGAPGPLPA
TPYRPPAAA	TPYRPPAAA
YPFPLSHSV	YPFPLSHSV
SPHAVDGNTV	SPHAVGNTV
QPFPAHIGRSA	FPAHIGRSA
KPATLTTTSA	KPATLTTSA
MPIYVTGI	MPIY-VTGI
LPAPPAVSA	LPAPPAVSA
VPTPAPISA	VPTPAPISA
NPYFPGQAIA	NPYFPQAIA
LPAPDFKVNA	LPAPDKVNA
APAPVIISSSA	APAPVIISS
VPLFVQHDA	VPLFVQHDA
VPFSIPAA	VPFS-IPAA
APAGGDKKVIA	APAGGDKKV
VPHFPTPSIL	VPHFPTPSI
SPLFSQHTA	SPLFSQHTA
TPKPIPILAA	TPKPIILAA
SPYVHLLDA	SPYVHLLDA
TVTEKPEVIDA	TEKPEVIDA
NPYTIFHQA	NPYTIFHQA
IPFGITEEA	IPFGITEEA
KPMEGWIAV	KPMEGWIAV
SPRNLQPQRAA	SPRNLPQRA
RPNSLVGITSA	RPNSLITSA
PAYHSSLMD	PAYHSSLMD
PARFKNTEAI	ARFK-NTEA
RPLPGALGVAA	LPGALGVAA
TPKMPGQSV	TPKMPGQSV
APGPSGQSV	APGPSGQSV
LPHSHDVSA	LPHSHDVSA
IPEPLAPA	IPEP-LAPA
RPRPVVTTT	RPRPVVTTT
YPQELIVPA	YPQELIVPA
IPHQAPGEMT	IPHQAGEMT
APSNGLSVRSA	APSNGVRSA
IPTENSMTA	IPTENSMTA
LPPPPPSHPA	LPPPPSHPA
KPTETLLNTV	KPTETLNTV
RPADVIFAT	RPADVIFAT
EEQLQQIRAE	EEQLQQIRA
RRPPASPPA	RRPPASPPA
SPIEFLENA	SPIEFLENA
APSPVQQHQA	APSPVQHQA
VPKNYKLVAA	VPKNYLVAA
RPVPGYEPG	RPVPGYEPG
VPVSLESKKAA	VPVSLSKKA
RPAGPPREPV	RPAGPREPV
VPNYKLITPA	VPNYKITPA
LPVFQPGVKL	LPVFQGVKL
IPVDSAVAV	IPVDSAVAV
APHTWPHIVA	APHTWHIVA
MPTLPPPSV	MPTLPPPSV
RPLPVTFHRA	RPLPVFHRA
AVEAKKTYVRD	AVEAKKTYV
APHPPLSVV	APHPPLSVV
AAPATRAAL	AAPATRAAL
VTDTNVIL	VTDT-NVIL
APAPAPTPVSA	APAPTPVSA
MPFPNIRSA	MPFPNIRSA
IPVTEIAIAA	IPVTEAIAA
SPLWTSIGA	SPLWTSIGA
SPKTTISVA	SPKTTISVA
NPDDRRRLLSA	NPDDRLLSA
RPISLGHVVVA	RPISLGHVV
VPAHAVVVRA	VPAHAVVRA
LPHQLPEA	LPHQ-LPEA
LPAAMPITA	LPAAMPITA
KPYESYIGA	KPYESYIGA
FPPTFAIPQA	PPTFAIPQA
TPYSGKLMSA	TPYSGLMSA
RPADVIFATV	RPADVFATV
AAGPPLVAA	AAGPPLVAA
RPWYIQGA	RPWY-IQGA
LPVRLATA	LPVR-LATA
SPFGSITSA	SPFGSITSA
LPRPQGAAA	LPRPQGAAA
LAAARLAAA	LAAARLAAA
TPLYTDNTA	TPLYTDNTA
IPQKPSQPA	IPQKPSQPA
VPVGIAGFAA	VPVGIGFAA
LPHPNRIQA	LPHPNRIQA
NPIAQPLA	NPIA-QPLA
VPYPPLLRA	VPYPPLLRA
SPAQVIPLA	SPAQVIPLA
AVTPLPVAA	AVTPLPVAA
SPKQILDPAA	SPKQIDPAA
LPASIPHVIA	LPASIHVIA
APGNPVLAV	APGNPVLAV
IPRPVDGVEV	IPRPVGVEV
LPFSSMPTA	LPFSSMPTA
VPRSSDFEDSA	VPRSSDFED
APVGSRPHTV	APVGSPHTV
AGLQFPVGR	AGLQFPVGR
VPSYPSKSA	VPSYPSKSA
SPRLLGAAA	SPRLLGAAA
TPQPPLLKA	TPQPPLLKA
LPAHSDPVSA	LPAHSPVSA
AAGPPISEGK	AAGPPISEG
SPALLREA	SPAL-LREA
SPHVQVKAA	SPHVQVKAA
HPQFLKNQV	HPQFLKNQV
APTPPTLVA	APTPPTLVA
LPVDAVISV	LPVDAVISV
LPSELIVHI	LPSELIVHI
LPHKIHYAA	LPHKIHYAA
MPRFTEQVEA	MPRFTQVEA
KPVVTPFGQVA	VVTPFGQVA
IPRNTVVPT	IPRNTVVPT
APFPHGDSA	APFPHGDSA
VPQPPPGPAA	VPQPPGPAA
LPQKVLGSPA	LPQKVGSPA
RPLTLFHTV	RPLTLFHTV
SPTTSHVGA	SPTTSHVGA
APVPTAPAA	APVPTAPAA
KPYAHILSV	KPYAHILSV
RPYFPKDEA	RPYFPKDEA
RPHSSLRELLA	RPHSSLREL
SPTKKVAVA	SPTKKVAVA
LPMLQTVA	LPML-QTVA
VLSAADKGNV	LSAADKGNV
KPFYQKREV	KPFYQKREV
APIQSPKGVEA	APIQSPKGV
LPNLQTVTV	LPNLQTVTV
RPHDSHSFQA	RPHDSSFQA
SPFFPLVSA	SPFFPLVSA
SPDGNRFATA	SPDGNFATA
SPLRSPIRSA	SPLRSIRSA
LPHEILEMT	LPHEILEMT
RPAPVAVAAAA	RPAPVAVAA
MPFGNVISA	MPFGNVISA
QPITPGPSI	QPITPGPSI
APIAPLKITV	APIAPKITV
QPTSVLDKA	QPTSVLDKA
RPAQFLPEMVA	RPAQFPEMV
VPHAITVSV	VPHAITVSV
VPRLPATAA	VPRLPATAA
MPHSIMRVDIA	MPHSIMRVD
SPNPARGHSV	SPNPAGHSV
VPAPAPAAA	VPAPAPAAA
KPLQPLPNTA	KPLQPPNTA
APGKGILAA	APGKGILAA
GLINQIQAS	GLINQIQAS
HPLLRPPPSA	HPLLRPPSA
APYDPHFPAPA	APYDPHFPA
TPDPSTPSRLA	TPDPSTPSR
HPYQRIVTA	HPYQRIVTA
VPAGGAVAVSA	VPAGGAVAV
FPRPVTVEP	FPRPVTVEP
LPVSLPTHA	LPVSLPTHA
RPAEKLSTA	RPAEKLSTA
APRPAPVA	APRP-APVA
APTLGLLPA	APTLGLLPA
MPNPSLAQVKI	MPNPSLAQV
SPTSPNALPPA	SPNA-LPPA
NPGVPVPAA	NPGVPVPAA
AVAMPIPAA	AVAMPIPAA
QAAAPVLTPA	AAAPVLTPA
RPSSQYIVA	RPSSQYIVA
QVMQGMGVSA	QVMQGGVSA
IPISNILMV	IPISNILMV
APQPLKESA	APQPLKESA
FPHFDLSHGSA	FPHFDHGSA
HPNQQHVVA	HPNQQHVVA
LPPPDHGAPA	LPPPDGAPA
QPSEVLRTV	QPSEVLRTV
SPLATQIPQA	SPLATIPQA
LPAPHIMPGV	LPAPHMPGV
VPVDTGVAA	VPVDTGVAA
TITGKTFSSR	ITGKTFSSR
LPKGRPGPVA	LPKGRGPVA
ETMQSLNDR	ETMQSLNDR
MPRWAERLFPA	RWAERLFPA
VPFKPQIPEA	VPFKPIPEA
KPYTVVDVSA	KPYTVDVSA
VPHWDPKISA	VPHWDKISA
IPRSFLQEA	IPRSFLQEA
VPYPLPKIDLI	VPYPLKIDL
KPAVPTVAS	KPAVPTVAS
MPNGTPHPTAA	MPNGTHPTA
KPNPNQIISV	KPNPNIISV
RPRITHPPP	RPRITHPPP
SPKPAIKSISA	KPAIKSISA
LPASEIAKLLA	LPASEIAKL
APMPPIIHA	APMPPIIHA
PRRVEPAPAA	RRVEPAPAA
RPRYLEIRA	RPRYLEIRA
APAAATVAV	APAAATVAV
RPPDFISISA	RPPDFSISA
RASLEVTQQQA	ASLEVQQQA
IPLPDEKSRVA	LPDEKSRVA
LPRLIDMSA	LPRLIDMSA
APNLQNQQV	APNLQNQQV
FPRRAFSEA	FPRRAFSEA
APRSFHPPAA	APRSFPPAA
APSPVQHQA	APSPVQHQA
APAAGMNAA	APAAGMNAA
MPRRNFPIA	MPRRNFPIA
SPNGKYILAA	SPNGKILAA
LPFYLIPPSA	LPFYLPPSA
IPQQVFQEV	IPQQVFQEV
YPAAVPQA	YPAA-VPQA
APHIIVGTPG	APHIIGTPG
KPKEPPKVP	KPKEPPKVP
APARPGPAA	APARPGPAA
APTKPQSPA	APTKPQSPA
APRAPRALAAA	APRAPALAA
APHGGDLQPPA	APHGGQPPA
SPKQILDPA	SPKQILDPA
SPKAALRYAA	SPKAARYAA
YDKKGPAAIQK	YDKK-GPAA
APALPAPAA	APALPAPAA
RPFQSIIHA	RPFQSIIHA
RPRHQGVMV	RPRHQGVMV
HPVHPFLAV	HPVHPFLAV
VPLAIVNKA	VPLAIVNKA
LPSASITSTSA	LPSASITST
LPRKPVAGA	LPRKPVAGA
MPFGNVVSA	MPFGNVVSA
KPREAFGFEQA	KPREAFEQA
APWAVTSLYEA	APWAVLYEA
LPAEYLLSA	LPAEYLLSA
TPLPAIVPAA	TPLPAVPAA
MPNDEHWKA	MPNDEHWKA
IRLENEIQTY	IRLENEIQT
TPSPVIRSTA	TPSPVRSTA
FPYPVGVHA	FPYPVGVHA
LPRPSAPSA	LPRPSAPSA
APQELNPAVTA	APQELNPAV
TPYGYFLISA	TPYGYLISA
SPTYQYVTV	SPTYQYVTV
LPKEKQPVA	LPKEKQPVA
SPLLQAHHA	SPLLQAHHA
LPGELFHVV	LPGELFHVV
RPVGGGPSA	RPVGGGPSA
RVREIIINA	RVREIIINA
RPSQVVAET	RPSQVVAET
LPRRPLPPA	LPRRPLPPA
IPFGIFSRA	IPFGIFSRA
ASAPPGPPA	ASAPPGPPA
TPSKVWGSSA	TPSKVGSSA
KPQSINTVSA	KPQSITVSA
HPVAKILHA	HPVAKILHA
AGFAGDDAPR	AGFAGDDAP
AAPGVDLT	AAPG-VDLT
KPRPSAVTTTA	RPSAVTTTA
LPHKLRIKA	LPHKLRIKA
SPVQHLVAA	SPVQHLVAA
APMAGLMEKA	APMAGMEKA
AAMNGHVPA	AAMNGHVPA
IPNPFIQQQDA	NPFIQQQDA
APQPAAPVGA	APQPAPVGA
IPHSLPGAVA	IPHSLGAVA
VPFAAPATA	VPFAAPATA
KYEELQIT	KYEE-LQIT
SPFQPHVPYSP	SPFQPHVPY
LPHAILRLDL	LPHAIRLDL
LPLWVDKEA	LPLWVDKEA
APAPVVEAV	APAPVVEAV
VPWMPPGKSSA	MPPG-KSSA
QPTPIQKA	QPTP-IQKA
VAPVASAL	VAPV-ASAL
IPTNAVSVVSS	IPTNAVSVV
HPVEPVTSV	HPVEPVTSV
TPNKPSVAV	TPNKPSVAV
KPAPPFNVTV	KPAPPNVTV
ITAPPGTAA	ITAPPGTAA
FPRAPSTSDSV	FPRAPSTSD
APSMESRPPA	APSMERPPA
LPNHQVIHTA	LPNHQIHTA
IPVDFKYIA	IPVDFKYIA
TPKPVEPAA	TPKPVEPAA
APTLPGSAA	APTLPGSAA
YPVLLDGV	YPVL-LDGV
APHPFPHPA	APHPFPHPA
RPHPLRPEA	RPHPLRPEA
SPESPVLAA	SPESPVLAA
MPRQLSAAA	MPRQLSAAA
LPVLPVAAA	LPVLPVAAA
SPRNLGFETSA	SPRNLGFET
VPRQPTVTSV	VPRQPVTSV
SPKSPGLKA	SPKSPGLKA
SPAKLQAA	SPAK-LQAA
LPSDIAAEA	LPSDIAAEA
VPVSTINHA	VPVSTINHA
TPPLPVPPAA	TPPLPPPAA
SPREPVLPP	SPREPVLPP
IPMKIRNVSA	IPMKINVSA
APIYPGFPKV	APIYPFPKV
HPYLPINSA	HPYLPINSA
MPVQFKPKSA	MPVQFPKSA
KPMKSVLVVA	KPMKSLVVA
LPASETPKA	LPASETPKA
SPPKIHVSA	SPPKIHVSA
LPWGSQGKPGA	LPWGSKPGA
TPFTGPFISV	TPFTGFISV
VPITFQVKVTA	VPITFQVKV
LVRPPTEQA	LVRPPTEQA
MPTRPGEQA	MPTRPGEQA
APRTPEVRAA	APRTPVRAA
IPLQDLVAA	IPLQDLVAA
RPAGVGVVVEA	RPAGVGVVV
IPADLRIISA	IPADLIISA
APWPIVGL	APWP-IVGL
APSKTLVETA	APSKTVETA
ISSPTETER	ISSPTETER
SPDGSRLLFTV	SPDGSLFTV
VPRPPDTVST	VPRPPTVST
APYAVGREA	APYAVGREA
IPYKIEAV	IPYK-IEAV
APVLPHTAV	APVLPHTAV
TPYVAKISA	TPYVAKISA
APASVPAQA	APASVPAQA
SPILVATAVAA	SPILVTAVA
RPMKVGHVT	RPMKVGHVT
SPRQSDVMIVA	SPRQSMIVA
KPLEKHYSV	KPLEKHYSV
APSPPPAPV	APSPPPAPV
APTGSGKTVAA	APTGSKTVA
SPLPTPFGA	SPLPTPFGA
IPSGTILKA	IPSGTILKA
LPIPDPGVSV	LPIPDGVSV
LPKPHGIRA	LPKPHGIRA
SPLDMKDGFLA	SPLDMKDGF
RPRLVAAAV	RPRLVAAAV
LPVEFTIDA	LPVEFTIDA
SPRTAEGVLAA	SPRTAGVLA
LPFPLPLFA	LPFPLPLFA
KPSESIYSA	KPSESIYSA
WRRIPGGYSA	RRIPGGYSA
LPTESTKAV	LPTESTKAV
RPNDIMAEV	RPNDIMAEV
SPVGNRVTV	SPVGNRVTV
HPASLFTA	HPAS-LFTA
GPYGGAQPSA	GPYGGQPSA
RPVKLFRV	RPVK-LFRV
SPHTKMDVA	SPHTKMDVA
TPLGGIQAA	TPLGGIQAA
LSELEAALQR	SELEAALQR
SPLSAAAATA	SPLSAAATA
APARPSVPP	APARPSVPP
TPMGPGRTV	TPMGPGRTV
SPRVPNSSV	SPRVPNSSV
APMLSTVHSA	APMLSVHSA
HPEPASGLAA	HPEPAGLAA
DGYNYTLSK	DGYNYTLSK
MPHSIMRIDIA	MPHSIMRID
RPRPPVSST	RPRPPVSST
LPHPYAIAV	LPHPYAIAV
APSSILQR	APSS-ILQR
LPSPLPAHPSV	SPLPAHPSV
SPMPWKGVTV	SPMPWGVTV
LPFRVIPLV	LPFRVIPLV
SPLHLAVEA	SPLHLAVEA
FPVGKGLAA	FPVGKGLAA
LQQVDTSTR	LQQVDTSTR
VPHQPDNLAA	VPHQPNLAA
RPPEPRHIPA	RPPEPHIPA
RPAAQPSFHQA	AAQPSFHQA
APSKAAALAAA	APSKAALAA
SPTSVRQMA	SPTSVRQMA
SPFRVNVGA	SPFRVNVGA
QPRDPVRPP	QPRDPVRPP
RPVLPRTEA	RPVLPRTEA
RPFHGISTV	RPFHGISTV
RPPHLYAVA	RPPHLYAVA
APAAAPSSLAV	APAAASSLA
VPMSALKSV	VPMSALKSV
SPTNKISTA	SPTNKISTA
LPVWLENHTA	LPVWLNHTA
TPLQSVPAPA	TPLQSPAPA
IAKNRKDIENQ	IAKNRDIEN
VPIPKSHEA	VPIPKSHEA
VPLIAIMA	VPLI-AIMA
HPNPPVVHSA	HPNPPVHSA
SPYPWPLNHI	SPYPWLNHI
VPITAVIAA	VPITAVIAA
HPYLFPVAA	HPYLFPVAA
HPQPILMGSVA	HPQPIMGSV
TPMSAQGVQA	TPMSAGVQA
RPHHAQLAV	RPHHAQLAV
IPLKEMPAVQL	IPLKEMPAV
RPRLIAELA	RPRLIAELA
APFDSRFPNQ	APFDSFPNQ
LPASNLAGKEA	LPASNGKEA
VPYLVGQVV	VPYLVGQVV
SPHSQVLTA	SPHSQVLTA
AAPREPAIHS	APREPAIHS
NPYNGGGRVA	NPYNGGRVA
APMPTASTA	APMPTASTA
APVHPPNRSA	APVHPNRSA
RPNWSKLVA	RPNWSKLVA
VIRNIVEAA	VIRNIVEAA
QPYQPLREV	QPYQPLREV
PSLSSLPAGAA	LSSLPAGAA
IPQEAYNAV	IPQEAYNAV
MPAFPLPYA	MPAFPLPYA
RPRDSQLYA	RPRDSQLYA
MPYFLLTQA	MPYFLLTQA
KPRPPPPPP	KPRPPPPPP
IPKKEIHTV	IPKKEIHTV
QVRDVIIAA	QVRDVIIAA
RPVLTSVA	RPVL-TSVA
IPITVLQPA	IPITVLQPA
LPNFLPYNV	LPNFLPYNV
IPYRVIHNA	IPYRVIHNA
RPKPSSSPVIF	RPKPSSSPV
APIQWEERNVT	APIQWERNV
YPLDHARAA	YPLDHARAA
QPLLKHWEA	QPLLKHWEA
VPAPGGPAA	VPAPGGPAA
LPEENREAA	LPEENREAA
APELQGVEV	APELQGVEV
LPSPPAVAV	LPSPPAVAV
RPIPNQPPTAA	IPNQPPTAA
YPSKSASVTA	YPSKSSVTA
QPHIAGVFSA	QPHIAVFSA
LVSPPAVSA	LVSPPAVSA
LPYDIPHRA	LPYDIPHRA
SPAAPVITA	SPAAPVITA
LPHSAGRYA	LPHSAGRYA
QPWPQPVPAL	QPWPQPVPA
APAPAAHVAG	APAPAAHVA
RPFEGFQRKA	RPFEGQRKA
SPIENIQRVAA	SPIENQRVA
SPKDVILKV	SPKDVILKV
QPINLIFRY	QPINLIFRY
HPSKALIASA	HPSKAIASA
SPTHSAIPA	SPTHSAIPA
IPMKPYYTKV	IPMKPYTKV
APILVPHTA	APILVPHTA
VPAPAHLVA	VPAPAHLVA
APSEARTTPA	APSEATTPA
GPTNAIFKA	GPTNAIFKA
RPIWLRESTV	RPIWLREST
LPKPPGRGV	LPKPPGRGV
LPRTVIRGSQA	LPRTVIRGS
APAGGFQNIA	APAGGQNIA
SPAHVLLAA	SPAHVLLAA
KPAEFTVDA	KPAEFTVDA
TPLPGGHAA	TPLPGGHAA
MPNHIHMGA	MPNHIHMGA
HPTDASMIEA	HPTDAMIEA
VAPGKDLTKTL	APGKDLTKT
MPKAEKNAV	MPKAEKNAV
APWPIVGLGKF	APWPIGLGK
SPVLFQEA	SPVL-FQEA
IPLGFGVAA	IPLGFGVAA
RPALFSSSA	RPALFSSSA
RNVSTGDVNVE	NVSTGDVNV
APAVLLGGVA	APAVLGGVA
VPNRHFAAA	VPNRHFAAA
IPAQISPEGRA	IPAQISPEG
SPTGGFVDA	SPTGGFVDA
APVTGMVSG	APVTGMVSG
MPPPVGMVA	MPPPVGMVA
APGPGLLLAA	APGPGLLAA
IPVLVPGIIFS	IPVLVGIIF
KPVEVTESA	KPVEVTESA
VPQTPLHTA	VPQTPLHTA
APHIVVGTPG	APHIVGTPG
RPAPPLRPSA	RPAPPRPSA
IPAALPVAA	IPAALPVAA
RAADALLKAVA	RAADALLKA
APASLTSA	APAS-LTSA
SPHSVPFLA	SPHSVPFLA
LPDLRPWTS	LPDLRPWTS
SPREVFFRV	SPREVFFRV
IPLEKADHPA	IPLEKDHPA
EIASFDKAKLK	IASFDKAKL
APYDAIHVGA	APYDAHVGA
TAYKPKYFTSA	KPKY-FTSA
APALLLIPAA	APALLIPAA
LQQAKDEI	LQQA-KDEI
APMPYLIGIHL	APMPYLIGI
HPYSTTFQESA	HPYSTQESA
RPSGAATTTAA	RPSGATTTA
NPYYGGESA	NPYYGGESA
KPMKSVLVV	KPMKSVLVV
AAAAPAAPAA	AAAPAAPAA
LVAPPLPAA	LVAPPLPAA
GPFAPVLSA	GPFAPVLSA
GPFSQFIKA	GPFSQFIKA
APVAVWAA	APVA-VWAA
RPFIGMSSA	RPFIGMSSA
YPLPLRSGKEA	LPLRSGKEA
QPHHLLLPAA	QPHHLLPAA
IPQSAVDTA	IPQSAVDTA
TPFQGQGHGA	TPFQGGHGA
TNAENEFVTIK	TNAENFVTI
QPWRGGAGA	QPWRGGAGA
HPREPLPPIQ	HPREPLPPI
VPFIVPLSV	VPFIVPLSV
LPNQPVEKA	LPNQPVEKA
SPVVPQISA	SPVVPQISA
KPTHFTVNA	KPTHFTVNA
SPAEVAKITA	SPAEVKITA
SPFSGLQKA	SPFSGLQKA
LVKDVFISA	LVKDVFISA
IPQLVSNISA	IPQLVNISA
IPMELVNEV	IPMELVNEV
HPIDDLQSA	HPIDDLQSA
GPAAAFTAA	GPAAAFTAA
SPVTLTKGTSA	SPVTLGTSA
APRTVALTA	APRTVALTA
VPHRSYVST	VPHRSYVST
LPVAVKHVV	LPVAVKHVV
APWGGPAA	APWG-GPAA
LPKHLLHSV	LPKHLLHSV
LPAASQPQVF	LPAASQPQV
SPYSGPKFNSA	SPYSGFNSA
RAFQQSTAA	RAFQQSTAA
APSLNATTV	APSLNATTV
SPSPPFGHSA	SPSPPGHSA
LPFDRFSEV	LPFDRFSEV
IPAFRGHFIAA	IPAFRFIAA
TPWFKIIAA	TPWFKIIAA
SPTKNNIAV	SPTKNNIAV
IPIKFSEKQQA	IPIKFKQQA
IPNSIMTILEA	IPNSIILEA
SPSAGVPRA	SPSAGVPRA
VPVWSGMNVA	VPVWSMNVA
RPLQDYGISV	RPLQDGISV
HLPETKFSEL	LPETKFSEL
YPHGWVETA	YPHGWVETA
HPTEDLVVSA	HPTEDVVSA
DSYVGDEAQSK	SYVGDAQSK
SPVPIAPTA	SPVPIAPTA
APSVGIKAA	APSVGIKAA
LPQSREKIIA	LPQSRKIIA
VPRTVSSTTA	VPRTVSTTA
RPLSGLMETA	RPLSGMETA
RPHTVLTVI	RPHTVLTVI
TPFKLTTEA	TPFKLTTEA
APALALPVA	APALALPVA
RPRTEVSLSA	RPRTESLSA
APVYGRDLL	APVYGRDLL
RPLHEFITA	RPLHEFITA
HPIHIIPAS	HPIHIIPAS
APSKATLIEA	APSKALIEA
SPSPPQAEA	SPSPPQAEA
RPIPNQPPT	RPIPNQPPT
LPHSQLPQA	LPHSQLPQA
HPNQPLTITA	HPNQPTITA
KPPPPPPAP	KPPPPPPAP
YPIGTNAIVA	YPIGTAIVA
VPAKWIHEA	VPAKWIHEA
VPYGVGKAA	VPYGVGKAA
LPTTMGVVA	LPTTMGVVA
FPHLQDAQV	FPHLQDAQV
VPSLQGEKA	VPSLQGEKA
GPTLQGKAV	GPTLQGKAV
VPTPIHPIF	VPTPIHPIF
SPRPALVRSA	SPRPAVRSA
VVAPSIIAA	VVAPSIIAA
IPYGMRFIA	IPYGMRFIA
APFDSRFPN	APFDSRFPN
IPRHPMPFAA	IPRHPPFAA
LVSESSDVLPK	LVSESSDVL
SPKPVSSTV	SPKPVSSTV
SYGGGSGGGF	SYGGGSGGG
RPKDDIKLTA	RPKDDKLTA
KPSPFTPVSA	KPSPFPVSA
SPTAYGVIAA	SPTAYVIAA
RPKPIITSV	RPKPIITSV
VPIRLIINA	VPIRLIINA
SPQDVTTHA	SPQDVTTHA
LPNAVITRI	LPNAVITRI
VPSLPVPHPA	VPSLPPHPA
RPFKGEVV	RPFK-GEVV
SPMIPSIVV	SPMIPSIVV
VPTEPLPAP	VPTEPLPAP
VPFPTPLEA	VPFPTPLEA
YPLLLKELA	YPLLLKELA
YPFSAGLPPAA	YPFSALPPA
LPAQSGSHAA	LPAQSSHAA
MPTQPQVQA	MPTQPQVQA
SPRLFSNHAA	SPRLFNHAA
APFLLNAV	APFL-LNAV
NPYATLPRA	NPYATLPRA
QPLYQPSHA	QPLYQPSHA
LPTKDLLSA	LPTKDLLSA
APYVTFPVA	APYVTFPVA
HPARLTIEA	HPARLTIEA
IPLKHLADRVA	IPLKHADRV
VPWGGAAA	VPWG-GAAA
LPNANYPSA	LPNANYPSA
RQGVDADINGL	QGVDAINGL
TPMAASVVA	TPMAASVVA
GPFPSSSATAA	FPSSSATAA
APGGEFREA	APGGEFREA
LPMDYVQRV	LPMDYVQRV
TPHPVLTPVA	TPHPVTPVA
RPNPPPVSV	RPNPPPVSV
HPMPVLPKA	HPMPVLPKA
RPWLDPAAA	RPWLDPAAA
RPRAPIIAV	RPRAPIIAV
RPAPPPPTV	RPAPPPPTV
SPAGGIPST	SPAGGIPST
HPQPGSANSL	HPQPGANSL
QPLLPYSAV	QPLLPYSAV
LPRPPETTA	LPRPPETTA
VPKPIGGVVVF	VPKPIGVVV
SPVSSVGNSA	SPVSSGNSA
IPKEDGVITA	IPKEDVITA
YPHGINTAIY	YPHG-INTA
HPYLFPVA	HPYL-FPVA
YPKNPHLRA	YPKNPHLRA
FPIKWTAPEA	FPIKWAPEA
APASVFPQNGA	APASVFPQN
PITPRAAPL	PITPRAAPL
APFGRISDA	APFGRISDA
MPVGLIAGA	MPVGLIAGA
SPMSADRVVA	SPMSARVVA
RPWPNPNSA	RPWPNPNSA
IPNEIIHAL	IPNEIIHAL
SPLNTPHTSA	SPLNTHTSA
SPILVATA	SPIL-VATA
APREPVGWPA	APREPGWPA
RPLSYTVVTA	RPLSYVVTA
RPASYQSVSV	RPASYSVSV
HPTENIIASA	HPTENIASA
LPFVPPPAV	LPFVPPPAV
APTAIKAA	APTA-IKAA
QPFSKPVSV	QPFSKPVSV
YPFSSEQKWMA	YPFS-SEQK
VPVETPEA	VPVE-TPEA
LPLLPAPGAAA	LPLLPAPGA
TVARSPVAP	TVARSPVAP
RPRPPVLSV	RPRPPVLSV
IPHSLPGAVAA	IPHSLGAVA
IPWSIPLEA	IPWSIPLEA
FPFKPPQRIEA	FPFKPRIEA
EAGPSIVHRK	EAGPSIVHR
SPFQTPVQSSA	SPFQTQSSA
APGLPTARA	APGLPTARA
LQIDNARLA	LQIDNARLA
VPTNIIAAKAA	VPTN-IIAA
SPITGEKIPA	SPITGKIPA
SPQEAQIIQA	SPQEAIIQA
KPFVEKPVSA	KPFVEPVSA
SPHLGPAPA	SPHLGPAPA
RPAGALVALVV	RPAGALVAL
LEDALQQAKED	LEDA-LQQA
NVKVDPEIQ	NVKVDPEIQ
RPRPTTVTA	RPRPTTVTA
APIKVGDAIPA	APIKVGDAI
SPVDPGARQA	SPVDPARQA
APVAVLQGHSA	APVAVGHSA
APIHKLEEA	APIHKLEEA
APGPGPASA	APGPGPASA
LPHPIIVSI	LPHPIIVSI
RPGPGVPAT	RPGPGVPAT
SPKGTIENI	SPKGTIENI
APAERRQRAA	APAERQRAA
IPHLLGDVV	IPHLLGDVV
RPIPSALTQA	RPIPSLTQA
SPAALKPPA	SPAALKPPA
LPQQPSRPS	LPQQPSRPS
YPVHLAVRA	YPVHLAVRA
RPGPVLPAVAV	RPGPVLPAV
MAMESTATAA	MAMESATAA
PSLSRPGPAAP	SLSRPGPAA
IPKHINPVAA	IPKHIPVAA
TPYTGILYA	TPYTGILYA
APKDVKIRISA	APKDVRISA
VPNTQPKAA	VPNTQPKAA
HPSQELLASA	HPSQELASA
MPADSGYPA	MPADSGYPA
IPLPRPQSA	IPLPRPQSA
PKFEVIEKPQA	EVIE-KPQA
APLAIPSAAAA	APLAIPSAA
APILNIPIVQF	APILNIPIV
FPIHAITGV	FPIHAITGV
YPFKNLPTA	YPFKNLPTA
HPKKPGVGV	HPKKPGVGV
NPNELSVSA	NPNELSVSA
SPEKFQIEA	SPEKFQIEA
VPNPYIISA	VPNPYIISA
HPIRPKPPSA	HPIRPPPSA
APHALLQAV	APHALLQAV
LPIGTLPLA	LPIGTLPLA
QVANVRFNVA	QVANVFNVA
IINEPTAAA	IINEPTAAA
SPEAHTVEA	SPEAHTVEA
RPYHTIIEI	RPYHTIIEI
RPALVEQTA	RPALVEQTA
VPIMPYPPA	VPIMPYPPA
AAAAAAAKVPA	AAAAAKVPA
APNPVVFVA	APNPVVFVA
TPAKAIAAV	TPAKAIAAV
RPVHPALPFA	RPVHPLPFA
SPFPLEAV	SPFP-LEAV
RPYSHALVA	RPYSHALVA
MPAHFSDSA	MPAHFSDSA
IPVLVPGIIF	IPVLVGIIF
RPWLRPAA	RPWL-RPAA
SPMDTVTEA	SPMDTVTEA
VPAPSPLSAA	VPAPSPLSA
VPVAGNPAV	VPVAGNPAV
HPWLFIEEA	HPWLFIEEA
SPHSILVNG	SPHSILVNG
LPASETPKAA	LPASEPKAA
SPVPVPRA	SPVP-VPRA
TPAPVEKSPA	TPAPVKSPA
APFDTVHIPEA	APFDTIPEA
VPIPWVSGTSA	IPWVSGTSA
TPVGGLLMA	TPVGGLLMA
APSLPKQAA	APSLPKQAA
HPYRLILTVA	HPYRLLTVA
HPSPLSFFSA	HPSPLFFSA
TPQSIFIFA	TPQSIFIFA
IPATPGIGA	IPATPGIGA
HPYPPGPGV	HPYPPGPGV
MPIYPTYNEV	MPIYPYNEV
RPISLGHVVV	RPISLGHVV
IIRDEGISA	IIRDEGISA
LPLAVTKEA	LPLAVTKEA
APYAKGFGVAA	APYAKFGVA
APSAKGTISA	APSAKTISA
SPSMAVRIAA	SPSMARIAA
SPIENIQRV	SPIENIQRV
MPAAALNAA	MPAAALNAA
APRPASGPIRP	APRPAGPIR
APGGWLQVA	APGGWLQVA
SPPAGLFTSA	SPPAGFTSA
SPHSILVNGA	SPHSIVNGA
LPQEIKANVA	LPQEIANVA
RPFSGRRLPV	RPFSGRLPV
APAPPVYEA	APAPPVYEA
LPHSAGRYAA	LPHSARYAA
SPVRPLVFAAA	SPVRPVFAA
SPHGYLSDVA	SPHGYSDVA
IPHLVTHDA	IPHLVTHDA
IAHTPGVAA	IAHTPGVAA
RPFLNSISKA	RPFLNISKA
TPFKGVRKA	TPFKGVRKA
HPYKHSFRA	HPYKHSFRA
KPQPSILQA	KPQPSILQA
YQSKYEEL	YQSK-YEEL
SPLVTHQNPA	SPLVTQNPA
HPNVTLTISAA	HPNVTTISA
LPSSPAAAA	LPSSPAAAA
QPYMPTVSA	QPYMPTVSA
QPHTILRVV	QPHTILRVV
HPLPIWTPA	HPLPIWTPA
APSPQVVYQVA	APSPQVYQV
RPVTPPRGMIT	RPVTPPRGM
RPRPVLRSV	RPRPVLRSV
LPIGIPYSISF	LPIGIPYSI
GPLRSVWVA	GPLRSVWVA
NPLGMPVPAA	NPLGMVPAA
QVHPDTGISSK	HPDTGISSK
FPMSPVTSV	FPMSPVTSV
YPIGTNAIVAV	YPIGTAIVA
SPHAHISEQA	SPHAHSEQA
LPDDVAISA	LPDDVAISA
VPSSPPTKR	VPSSPPTKR
QPVPPGRAA	QPVPPGRAA
AAPAPAAHVA	APAPAAHVA
APFEPLASG	APFEPLASG
FPFFNPIQT	FPFFNPIQT
KPEEQWWSA	KPEEQWWSA
NHPYLFPVAA	HPYLFPVAA
APSGGRLLSA	APSGGLLSA
HPTWALKEA	HPTWALKEA
APAEVQITA	APAEVQITA
QPYYATRVNA	QPYYARVNA
HAAEYGAEALE	HAAEYGAEA
LPYKPYFYIA	LPYKPFYIA
VPANPYHTA	VPANPYHTA
IPQATHSVSA	IPQATSVSA
YPNFSLPAA	YPNFSLPAA
SPFPSGSEHSA	FPSGSEHSA
NPNQYNYIA	NPNQYNYIA
LPYAITIVA	LPYAITIVA
RPSPAPPAA	RPSPAPPAA
TPTEFFFHA	TPTEFFFHA
LPHPYAIAVF	LPHPYAIAV
GPWVGTGLAAA	GPWVGGLAA
APALLLIPA	APALLLIPA
RPRPVVTTTT	RPRPVVTTT
LPYHHVIHA	LPYHHVIHA
QPILLELEA	QPILLELEA
SPAPPLLHV	SPAPPLLHV
VPRQPTVTS	VPRQPTVTS
AAFSHPQAA	AAFSHPQAA
ALEEQLQQIR	ALEEQLQQI
RPFQNQTHA	RPFQNQTHA
APAAPLQVHA	APAAPQVHA
LPTRIAYYA	LPTRIAYYA
TPRPLTSARA	TPRPLSARA
MPIYVTGITNH	MPIYVGITN
SPHFPHTAA	SPHFPHTAA
RPVTPPRTA	RPVTPPRTA
YSFYLPIAA	YSFYLPIAA
LVMGDIPAA	LVMGDIPAA
TPVLPAPTAA	TPVLPPTAA
IPQLMKEEA	IPQLMKEEA
VPSAHQPSA	VPSAHQPSA
IPQLNSKAV	IPQLNSKAV
IPHPLIMGVI	IPHPLIMGV
KPYPNSEAA	KPYPNSEAA
APVAEVPTA	APVAEVPTA
TPHYIYPPAIV	TPHYIYPPA
SPASQLVAT	SPASQLVAT
MPVPAQPKA	MPVPAQPKA
QPHDPLVPLSA	QPHDPPLSA
APTAIKAAA	APTAIKAAA
VNLPINGNGKQ	LPINGNGKQ
KPTALPSA	KPTA-LPSA
VPGYISRSVA	VPGYISRSV
APAPTPVSA	APAPTPVSA
APIGGIDHKP	APIGGDHKP
APAPPVADA	APAPPVADA
HPLPPTPSV	HPLPPTPSV
SPHPGLVAA	SPHPGLVAA
APQSSAVAA	APQSSAVAA
FPHLRVLEA	FPHLRVLEA
LPWQGLKAA	LPWQGLKAA
APVPTEPQA	APVPTEPQA
ASFHNGVAA	ASFHNGVAA
FPAPILRAV	FPAPILRAV
SPHGLVMVGV	SPHGLMVGV
QPQAPGVEA	QPQAPGVEA
SPRTAVAPSA	SPRTAAPSA
SPRNLAMEA	SPRNLAMEA
LPRPVPLVA	LPRPVPLVA
LPNQVLKSISV	LPNQVLKSI
LPQPAFIPA	LPQPAFIPA
TAAPSLKNAA	TAAPSKNAA
SPMATTAAA	SPMATTAAA
VPSLFSKSA	VPSLFSKSA
RPVQRLPSV	RPVQRLPSV
LPTREGHHLVA	LPTREGHHL
MPTTLEGAEA	MPTTLGAEA
VPNYLPSV	VPNY-LPSV
APVAVEPGAAV	APVAVPGAA
YPRTPEERAA	YPRTPERAA
NPVTGLLSA	NPVTGLLSA
APIWLEHAA	APIWLEHAA
APVHEIHESA	APVHEHESA
APHVPATGA	APHVPATGA
RPWKAYLSA	RPWKAYLSA
RPSALPFVA	RPSALPFVA
SPHKVFYKS	SPHKVFYKS
LPRGAAKAIA	LPRGAKAIA
RPKMQEVVA	RPKMQEVVA
KPFAYVSEA	KPFAYVSEA
LPLSLLKTA	LPLSLLKTA
TPAHVLPSA	TPAHVLPSA
SPVTVEWKA	SPVTVEWKA
APLPGLPPSA	APLPGPPSA
RPYDKNISP	RPYDKNISP
SPRPALPALLV	SPRPALPAL
APTPAAPA	APTP-AAPA
SPMAERSMMSA	SPMAEMMSA
RPLDIDEVEA	RPLDIEVEA
SPVMVSNPA	SPVMVSNPA
VPMTPLRTV	VPMTPLRTV
IVRDRVTSA	IVRDRVTSA
LPLHPSWEA	LPLHPSWEA
IPNNVKTAV	IPNNVKTAV
FPANVMDVIA	FPANVDVIA
FPFAPPAAA	FPFAPPAAA
APKSIEVYSA	APKSIVYSA
IPIKKSDPV	IPIKKSDPV
IPYSPDVQIHA	IPYSPDVQI
APHDFANIKA	APHDFNIKA
MPQDLRSPA	MPQDLRSPA
LPTGVFQVA	LPTGVFQVA
SPVPSHWMVA	SPVPSWMVA
AKNWAPGE	AKNW-APGE
MPVERILEA	MPVERILEA
LPARFKNTEA	LPARFNTEA
NSVPSNPVAA	VPSN-PVAA
SPLKHFVTA	SPLKHFVTA
RPNGVITGLAA	RPNGVGLAA
APAPPKAEA	APAPPKAEA
SPFPDIPKV	SPFPDIPKV
RPNAFGMAQA	RPNAFMAQA
APSSLVAAA	APSSLVAAA
MPSDVLEVT	MPSDVLEVT
TPNRATFVV	TPNRATFVV
RPRVTEPISA	RPRVTPISA
ETQITQIEHEV	QITQIEHEV
TPLPAIVPA	TPLPAIVPA
SPVAQPVTV	SPVAQPVTV
SPFENTENA	SPFENTENA
LPTKPTQGA	LPTKPTQGA
YPNYPNPAV	YPNYPNPAV
VPAEGAPTA	VPAEGAPTA
TPVEEVPAA	TPVEEVPAA
TPHYIYPPA	TPHYIYPPA
APAAAVVRAA	APAAAVRAA
APRERLIDA	APRERLIDA
TPTFTYKAA	TPTFTYKAA
APTPAQAQITA	TPAQAQITA
APRGTGIVSA	APRGTIVSA
QPFAVPHSA	QPFAVPHSA
SPFHFQPSA	SPFHFQPSA
APAPPQVLPQA	APPQVLPQA
APTKALVNQV	APTKAVNQV
FGPGKPPPPP	GPGKPPPPP
LPRDVLTRA	LPRDVLTRA
AQYDELARK	AQYDELARK
IPVHLPNIQA	IPVHLNIQA
APRPPVSAA	APRPPVSAA
KPRPPLHLL	KPRPPLHLL
APVGSVVSV	APVGSVVSV
HPKPVPGFQVA	KPVPGFQVA
RPFTIPYLTA	RPFTIYLTA
VPYRLLPGIF	VPYRLLPGI
LPHDLAVQA	LPHDLAVQA
APHEILIQIVD	APHEIIQIV
IPISPISPA	IPISPISPA
SPHPGVGVPT	SPHPGGVPT
IPYQDYFYTA	IPYQDFYTA
SPNEVKVVA	SPNEVKVVA
GPHANPVAV	GPHANPVAV
LPVSNVVSV	LPVSNVVSV
LPYDVTPEQA	LPYDVPEQA
LQDAEIAR	LQDA-EIAR
EDAANNYAR	EDAANNYAR
IVKPVKVSA	IVKPVKVSA
SPAKLQAAA	SPAKLQAAA
LPKEDPTAVA	LPKEDTAVA
YPKAEPMPSA	YPKAEMPSA
RPNDSRMLVA	RPNDSMLVA
TVTEKPEVID	TVTE-KPEV
TPHLRNLAV	TPHLRNLAV
SPIRSRSPPA	SPIRSSPPA
LPLLQPRGASA	LPLLQPRGA
YSKYYKTID	YSKYYKTID
VPAPSVPSV	VPAPSVPSV
HPVHYDTSA	HPVHYDTSA
ETILRTNKR	ETILRTNKR
KPGSPYRSV	KPGSPYRSV
MPHLVNGDAA	MPHLVGDAA
LPLRPIIPLVA	LPLRPIPLV
SPGDFSISV	SPGDFSISV
RPAAPLIGA	RPAAPLIGA
SPVSSLPTA	SPVSSLPTA
LPNQSFPHSV	LPNQSPHSV
MPAGSFITA	MPAGSFITA
LPRRPLPPAA	LPRRPPPAA
SPFTVGVAA	SPFTVGVAA
SPARPVSPAP	SPARPVSPA
APTGDLPRA	APTGDLPRA
HPMPHPPQA	HPMPHPPQA
RPVHLDQAA	RPVHLDQAA
AVKKNPGIAA	AVKKNGIAA
APIPNAPPA	APIPNAPPA
GPFPGKFNEV	GPFPGFNEV
LPHHILADV	LPHHILADV
YPASLPDA	YPAS-LPDA
SPILVATAV	SPILVATAV
VPNKIINRA	VPNKIINRA
RPRFVSLRA	RPRFVSLRA
