Data	Data aligned
LILSNKLLY	LILSNKLLY
SIFQSSMTK	SIFQSSMTK
NATDFWRLY	NATDFWRLY
NVSIPWTHK	NVSIPWTHK
ILCGWHLLK	ILCGWHLLK
MLVYCFLGY	MLVYCFLGY
MLINRFTMK	MLINRFTMK
KQIRSAAKK	KQIRSAAKK
KTTLFHTFK	KTTLFHTFK
SSADLSLEK	SSADLSLEK
TVSLAGSYR	TVSLAGSYR
FLRSIAMLK	FLRSIAMLK
MVGVGSLVK	MVGVGSLVK
GQRCHFIKK	GQRCHFIKK
VLLGSFGCK	VLLGSFGCK
VTFKTAHAK	VTFKTAHAK
IVFNLPVSK	IVFNLPVSK
RSNNKFTLK	RSNNKFTLK
GVAMPNLYK	GVAMPNLYK
KMARAGLGH	KMARAGLGH
RFYITTRYK	RFYITTRYK
VFKAMETFK	VFKAMETFK
VSMMSMYGK	VSMMSMYGK
RTLNLFRYK	RTLNLFRYK
FIHMVRCCK	FIHMVRCCK
VAGALVAFK	VAGALVAFK
LIFCHSKKK	LIFCHSKKK
ISYCRAFIY	ISYCRAFIY
VVYCNGQRK	VVYCNGQRK
LSSSVPSQK	LSSSVPSQK
GSTAEQLSK	GSTAEQLSK
VQTKPGLFK	VQTKPGLFK
YLALYNKYK	YLALYNKYK
ATFSVPMEK	ATFSVPMEK
KVGVYKMHK	KVGVYKMHK
RLFKHGLKR	RLFKHGLKR
GLNKLAGFK	GLNKLAGFK
VSLKKTNDK	VSLKKTNDK
LLLRKLTSK	LLLRKLTSK
STIFDIVSK	STIFDIVSK
KTFVELMRR	KTFVELMRR
RMYWGVNPK	RMYWGVNPK
MMAWRMMRY	MMAWRMMRY
TVWNRLIAR	TVWNRLIAR
IISIVTGLK	IISIVTGLK
VFFKQWFEK	VFFKQWFEK
AIFTYTGGY	AIFTYTGGY
MMFINSTCY	MMFINSTCY
TLWKAGILY	TLWKAGILY
KMGAFMYTK	KMGAFMYTK
KQSSKALQR	KQSSKALQR
FTYLCGFIK	FTYLCGFIK
VLHDIGNPK	VLHDIGNPK
TFQLLNMIK	TFQLLNMIK
SSSLTSLLK	SSSLTSLLK
AANEIRISK	AANEIRISK
KTNDINVRR	KTNDINVRR
GTSTDVVYR	GTSTDVVYR
PLHILASNK	PLHILASNK
RMLHLSQMH	RMLHLSQMH
IEITCVYCK	IEITCVYCK
RLASTVIYR	RLASTVIYR
TINAVASRK	TINAVASRK
KSRCGSLGY	KSRCGSLGY
LLANILSEK	LLANILSEK
KILPYQLKR	KILPYQLKR
ALLAVGATK	ALLAVGATK
RLKPVGSAY	RLKPVGSAY
SSVLTILYY	SSVLTILYY
VSWKPWSSK	VSWKPWSSK
AMSTWSFYH	AMSTWSFYH
STYGWNLVR	STYGWNLVR
VIWAASGFY	VIWAASGFY
RVIWMDAYK	RVIWMDAYK
MLAPSTLGY	MLAPSTLGY
LISYGGGWK	LISYGGGWK
EVMPVSMAK	EVMPVSMAK
LTYRHKVVK	LTYRHKVVK
AIMQVFFGY	AIMQVFFGY
MLLNRFTTR	MLLNRFTTR
NTPVFAIKK	NTPVFAIKK
KGHLPLLDK	KGHLPLLDK
STRHPSKLR	STRHPSKLR
KTFPPTEPK	KTFPPTEPK
TVNVILRPK	TVNVILRPK
TMYDKILSY	TMYDKILSY
LTSMKYFVK	LTSMKYFVK
KLFDLHGRR	KLFDLHGRR
KISFPIIAK	KISFPIIAK
VLDCRTAFK	VLDCRTAFK
ALFLEEMLR	ALFLEEMLR
VVLASLIYR	VVLASLIYR
RTFSILNRK	RTFSILNRK
KTFVDLMRR	KTFVDLMRR
FSFEIALLK	FSFEIALLK
GTATLRLVK	GTATLRLVK
KQMYRKFSR	KQMYRKFSR
MSMGDIITY	MSMGDIITY
KVSWRWMVY	KVSWRWMVY
ILSFPYLFK	ILSFPYLFK
ALKYLPIDK	ALKYLPIDK
RGRGVAIHR	RGRGVAIHR
KLYLRPWWH	KLYLRPWWH
RQTVSRFKK	RQTVSRFKK
AVSMANIFR	AVSMANIFR
CLLSHTLAY	CLLSHTLAY
LLFLNDMGK	LLFLNDMGK
QSYEFLGLK	QSYEFLGLK
SSRVDRYSK	SSRVDRYSK
LVTRKCPQK	LVTRKCPQK
IIDYKSSSK	IIDYKSSSK
KMFHGGLRY	KMFHGGLRY
VLRRGALAH	VLRRGALAH
NTTYDFLAR	NTTYDFLAR
LLMPLKAPK	LLMPLKAPK
AIDRQVSVK	AIDRQVSVK
AVCTRGVAK	AVCTRGVAK
RIYCQENPY	RIYCQENPY
MLYILGLFK	MLYILGLFK
MSSAAHLLY	MSSAAHLLY
KIRLGFHWK	KIRLGFHWK
LITLILSNK	LITLILSNK
MIYMGLWLK	MIYMGLWLK
RMGERQLQK	RMGERQLQK
TIDKSSPLY	TIDKSSPLY
LLLNTRQLK	LLLNTRQLK
RTAKVRAFH	RTAKVRAFH
SVMPAWQEK	SVMPAWQEK
YVFSGDPLK	YVFSGDPLK
VVYRGTTTY	VVYRGTTTY
LLNSNALLR	LLNSNALLR
AAYFVGYLK	AAYFVGYLK
STFTRGAQK	STFTRGAQK
LVKSSFVKK	LVKSSFVKK
HSNLTETFR	HSNLTETFR
MTFPVSLEY	MTFPVSLEY
YMSALNHTK	YMSALNHTK
LSARHASGK	LSARHASGK
ITANPVVTK	ITANPVVTK
MVTRFESLK	MVTRFESLK
YLHDPLTPY	YLHDPLTPY
SSQRDTILK	SSQRDTILK
VTYTEIEPK	VTYTEIEPK
MQSSFFMNR	MQSSFFMNR
ILARRPTPK	ILARRPTPK
LVYIFEPEK	LVYIFEPEK
YMFESKSMK	YMFESKSMK
AIFQSSMTR	AIFQSSMTR
MLFTSTNDK	MLFTSTNDK
DIEITCVYC	DIEITCVYC
RTKLMSNIK	RTKLMSNIK
AVVADLSAR	AVVADLSAR
LMWNKQFIK	LMWNKQFIK
RSLQTIASK	RSLQTIASK
ILAEYIRHR	ILAEYIRHR
IQRFSSLRR	IQRFSSLRR
AIFQSSMTK	AIFQSSMTK
ITYGSVSWR	ITYGSVSWR
KVSDSNLHK	KVSDSNLHK
VVSTGYHFR	VVSTGYHFR
ALAAAAAAK	ALAAAAAAK
KVKYLYFIK	KVKYLYFIK
KALKLSWFK	KALKLSWFK
IILAHFLYK	IILAHFLYK
IIVAGFSGK	IIVAGFSGK
IMVASDVCK	IMVASDVCK
LLFADINGK	LLFADINGK
RLLHRTTRH	RLLHRTTRH
QSYKETVHK	QSYKETVHK
LTSRATWAK	LTSRATWAK
ITAVNRYFK	ITAVNRYFK
RVFNNYMPY	RVFNNYMPY
KSNAKCIEY	KSNAKCIEY
RVLGRVLPY	RVLGRVLPY
STYYVHENK	STYYVHENK
SAAAYFVGY	SAAAYFVGY
YTSDYFISY	YTSDYFISY
RLASYGLYY	RLASYGLYY
MSLSEQLRK	MSLSEQLRK
TMLFTMLRK	TMLFTMLRK
LSPAHLINK	LSPAHLINK
ALYRRIQRR	ALYRRIQRR
ATYGWNLVK	ATYGWNLVK
MTNRQFHQK	MTNRQFHQK
LTLKGTSYK	LTLKGTSYK
TTIKPVSYK	TTIKPVSYK
AVAKCNLNH	AVAKCNLNH
SVYGLMGFK	SVYGLMGFK
GMSSRAIAR	GMSSRAIAR
KVMALPIPH	KVMALPIPH
LIKFISDNK	LIKFISDNK
GIFQSSMTK	GIFQSSMTK
ILGGVLHTK	ILGGVLHTK
KMARLGKGY	KMARLGKGY
DAYGFHNYK	DAYGFHNYK
LLARFGLEK	LLARFGLEK
MLQGRGPLK	MLQGRGPLK
RTLGVFRYK	RTLGVFRYK
MQFKLGIPK	MQFKLGIPK
ASYRLCLYR	ASYRLCLYR
LSARNKLFK	LSARNKLFK
KSMLKELIK	KSMLKELIK
RHYKRWPFY	RHYKRWPFY
QLFTFSPRR	QLFTFSPRR
LVENNFFTK	LVENNFFTK
LLQAGASVK	LLQAGASVK
ILYVSCNPA	ILYVSCNPA
AIFGQTGPK	AIFGQTGPK
NVAYNVVNK	NVAYNVVNK
SSIIRSLPK	SSIIRSLPK
YLSTFNMWR	YLSTFNMWR
RSSPRETMK	RSSPRETMK
RLYNFSFLN	RLYNFSFLN
LSYIYSEIK	LSYIYSEIK
KLRIKGMSY	KLRIKGMSY
YLAWVPAHK	YLAWVPAHK
LTYQNKVVK	LTYQNKVVK
VSIRGSHHK	VSIRGSHHK
GLYKSAPRR	GLYKSAPRR
LLSGHNLAK	LLSGHNLAK
YIFFASFYY	YIFFASFYY
TTKDYFSFK	TTKDYFSFK
MLHHYGIHY	MLHHYGIHY
KLITPNYMK	KLITPNYMK
ISNNHIISK	ISNNHIISK
VVNARLRAK	VVNARLRAK
TLARSICEK	TLARSICEK
SLYMAISPK	SLYMAISPK
RLYPFGSYY	RLYPFGSYY
MVAWRVTMH	MVAWRVTMH
TMFLITENK	TMFLITENK
MSHVKSVTK	MSHVKSVTK
FTFERSKIK	FTFERSKIK
VIDPRRCLK	VIDPRRCLK
KVFFGPIYY	KVFFGPIYY
LIWAYLSKK	LIWAYLSKK
MLINRFTMR	MLINRFTMR
SMMGFKMNY	SMMGFKMNY
KLFKKTDFK	KLFKKTDFK
RLYYDSMSY	RLYYDSMSY
ATYGTAVNK	ATYGTAVNK
GVYPSFMSR	GVYPSFMSR
KQYDSTDFK	KQYDSTDFK
VFSFWLLCK	VFSFWLLCK
RLKFSLSYK	RLKFSLSYK
VVYRAFDIY	VVYRAFDIY
TLFGPEREK	TLFGPEREK
GTLSYDNLK	GTLSYDNLK
RVYRRRLAQ	RVYRRRLAQ
KAPNVISSK	KAPNVISSK
RVISDGYFK	RVISDGYFK
TTHSKGATK	TTHSKGATK
CLLNYSGLK	CLLNYSGLK
KAFNHASVK	KAFNHASVK
SSLVKNVNK	SSLVKNVNK
VVNDFTVSY	VVNDFTVSY
NSISARALK	NSISARALK
KLIAVPHTK	KLIAVPHTK
VQMLSDTLK	VQMLSDTLK
YIASIFMPR	YIASIFMPR
AVFKDSFLR	AVFKDSFLR
KLYGLSQGY	KLYGLSQGY
RSHAAIGAY	RSHAAIGAY
NQVKFYFNK	NQVKFYFNK
LIAPRGYFK	LIAPRGYFK
CLRRRVTRK	CLRRRVTRK
MTTSMTMSY	MTTSMTMSY
RLFRSPQVK	RLFRSPQVK
AISKLGINY	AISKLGINY
KTFDSEYVK	KTFDSEYVK
KMQRMLLEK	KMQRMLLEK
RAAPPPPPR	RAAPPPPPR
SLLKETIQK	SLLKETIQK
AVFIHNFKR	AVFIHNFKR
LFKNVRLLK	LFKNVRLLK
RQFVSNNGK	RQFVSNNGK
GTMHQEIFR	GTMHQEIFR
RTRFFCIPK	RTRFFCIPK
FLEFSNRVY	FLEFSNRVY
AIFQRSMTR	AIFQRSMTR
RMGAAVTPY	RMGAAVTPY
GITGGHIPK	GITGGHIPK
KVVQHENLK	KVVQHENLK
QLFKPLTKK	QLFKPLTKK
VTSSGAIYK	VTSSGAIYK
KTLDISSFY	KTLDISSFY
FLLRHYYNK	FLLRHYYNK
ASFDKAKLK	ASFDKAKLK
ASLPTTIAK	ASLPTTIAK
YIFWIRTPR	YIFWIRTPR
HLSGWELAK	HLSGWELAK
STMPLSWMY	STMPLSWMY
KIEAPLLLH	KIEAPLLLH
FLKDDTLSK	FLKDDTLSK
SIYAGNTPK	SIYAGNTPK
RVDGLELKK	RVDGLELKK
KIPATVIAR	KIPATVIAR
IMLEYPHFK	IMLEYPHFK
KTAVNMLTH	KTAVNMLTH
LACAGLAYK	LACAGLAYK
QLCYCPASK	QLCYCPASK
ALDGTFQRK	ALDGTFQRK
LFQLCTFTK	LFQLCTFTK
LMSGRGIGK	LMSGRGIGK
MTMLIKAFK	MTMLIKAFK
KIKLILANK	KIKLILANK
TVKPGNFNK	TVKPGNFNK
IIYVGCGER	IIYVGCGER
KFVFPLNSK	KFVFPLNSK
KLGDQFGRK	KLGDQFGRK
RLFFKCIYR	RLFFKCIYR
RVDEIILFK	RVDEIILFK
LLVWHTWQK	LLVWHTWQK
SLLHESTLK	SLLHESTLK
ALNTITNLK	ALNTITNLK
RTEAKSALK	RTEAKSALK
IAYRNVLLR	IAYRNVLLR
ALTLHWFRK	ALTLHWFRK
MLSIINKRK	MLSIINKRK
KLFFQVIAK	KLFFQVIAK
TTFVTPMLR	TTFVTPMLR
ALCEKALKY	ALCEKALKY
KLMEEYLRR	KLMEEYLRR
HISWQGPGK	HISWQGPGK
KTDIVNTTY	KTDIVNTTY
KMYWITRSK	KMYWITRSK
RMKWMMAMR	RMKWMMAMR
SVANRSKQK	SVANRSKQK
QLVLHQILK	QLVLHQILK
ATVVIGTSK	ATVVIGTSK
MSYTMCSGK	MSYTMCSGK
VLDVGGTGK	VLDVGGTGK
VVNYDNSTK	VVNYDNSTK
QQFANVISK	QQFANVISK
MGYWIESQK	MGYWIESQK
KLFAAETLK	KLFAAETLK
YMFESKRMK	YMFESKRMK
TLISLNSMY	TLISLNSMY
KSPLPSLEY	KSPLPSLEY
RLSVKTFVK	RLSVKTFVK
LIGANYLGK	LIGANYLGK
ATAKAAAAY	ATAKAAAAY
VLRENTSPK	VLRENTSPK
ALFMYYAKR	ALFMYYAKR
GTHVLLPFY	GTHVLLPFY
LMSGKGIGK	LMSGKGIGK
ATAAAAAAK	ATAAAAAAK
SVYGDTLEK	SVYGDTLEK
TVMDIISRK	TVMDIISRK
RSLTGILGK	RSLTGILGK
SLYKYLLLR	SLYKYLLLR
FIFSALDEK	FIFSALDEK
RQFHQKLLK	RQFHQKLLK
LVKSPNHVK	LVKSPNHVK
MLEGETKLY	MLEGETKLY
YSSPHLLRY	YSSPHLLRY
VLGYSRMLY	VLGYSRMLY
VVYKEAKIK	VVYKEAKIK
KVVNPLFEK	KVVNPLFEK
QTPTKLMNK	QTPTKLMNK
TLSERISSK	TLSERISSK
AIFQSSMAK	AIFQSSMAK
CTNTFVLKK	CTNTFVLKK
LLDSYFVVK	LLDSYFVVK
STQSVLCVK	STQSVLCVK
IINNAVYTK	IINNAVYTK
VMAGVFARY	VMAGVFARY
TLADAGFMK	TLADAGFMK
WSYYMATLK	WSYYMATLK
ILKRWGTIK	ILKRWGTIK
HTSALSLGY	HTSALSLGY
LLCLIFLLV	LLCLIFLLV
KVYEGVWKK	KVYEGVWKK
TSYVKVLEY	TSYVKVLEY
RVHGATVFK	RVHGATVFK
ETKITFALK	ETKITFALK
RVYANLGER	RVYANLGER
HTYHLENDK	HTYHLENDK
VLALLAFFR	VLALLAFFR
AMYDPQTYY	AMYDPQTYY
TVYVYSRVK	TVYVYSRVK
TTRYKYLNK	TTRYKYLNK
LVGFLLLKY	LVGFLLLKY
PVYLMTLMK	PVYLMTLMK
HLMGWDYPK	HLMGWDYPK
LFVVYRDSI	LFVVYRDSI
YTDDYPMYK	YTDDYPMYK
ILMKTANNY	ILMKTANNY
KLDDVEKEK	KLDDVEKEK
KGFFRVFKK	KGFFRVFKK
RSFKDLLKK	RSFKDLLKK
AIMATIQRK	AIMATIQRK
RVNKGTGVK	RVNKGTGVK
RLVEEFFNR	RLVEEFFNR
QMRTPLHKY	QMRTPLHKY
KIVNGVLSR	KIVNGVLSR
RTLAKEGIK	RTLAKEGIK
ILYMLSWGK	ILYMLSWGK
VLWDTPSPK	VLWDTPSPK
MTLVPVLEK	MTLVPVLEK
KIFSEVTLK	KIFSEVTLK
SLFRAVITK	SLFRAVITK
RLGVRATRK	RLGVRATRK
QTYDWTLNR	QTYDWTLNR
ITMVNSLTY	ITMVNSLTY
RIYKTIKQY	RIYKTIKQY
VMRGKFGKK	VMRGKFGKK
VIENGILKK	VIENGILKK
QTQTYNIGK	QTQTYNIGK
RIGTAATKR	RIGTAATKR
TSRTLSYYK	TSRTLSYYK
RIGGVLIFR	RIGGVLIFR
TIAGGVCYY	TIAGGVCYY
VQKVNPAPK	VQKVNPAPK
ELYDTSPTK	ELYDTSPTK
RLLAPITAY	RLLAPITAY
YLLVKWIRK	YLLVKWIRK
RIYKRSLKL	RIYKRSLKL
VLIDAGLPK	VLIDAGLPK
KALMQLTTK	KALMQLTTK
GTLTKGVFK	GTLTKGVFK
KVGHVGLYR	KVGHVGLYR
AVYGNIKHK	AVYGNIKHK
ATNNVFRLK	ATNNVFRLK
CVDIPGIPK	CVDIPGIPK
TTYDFLARK	TTYDFLARK
TAVCMKCFK	TAVCMKCFK
VLSLIGLKR	VLSLIGLKR
IAEYIAGLK	IAEYIAGLK
QTMLFTMLR	QTMLFTMLR
YLALIATFK	YLALIATFK
KVVNRWLFR	KVVNRWLFR
VVMQVKVPK	VVMQVKVPK
VSPLAVTWW	VSPLAVTWW
RAGAGVMPK	RAGAGVMPK
RVYAHDAQH	RVYAHDAQH
VLRKRWTAK	VLRKRWTAK
FKDLFVVYR	FKDLFVVYR
RTGTRLLGR	RTGTRLLGR
AVIFTPIYY	AVIFTPIYY
STDDCFANK	STDDCFANK
MVHQAISPR	MVHQAISPR
ELTTVFIKY	ELTTVFIKY
KLCKNHAEK	KLCKNHAEK
TVWFVPSIK	TVWFVPSIK
ALMRWRHPR	ALMRWRHPR
RTWFHGSLY	RTWFHGSLY
KLRHLNEKR	KLRHLNEKR
VLWDIPTPK	VLWDIPTPK
KGMKIQHFK	KGMKIQHFK
AVYSSSMVK	AVYSSSMVK
VSAQNISFK	VSAQNISFK
QLSDHPMVK	QLSDHPMVK
ASLPYGANK	ASLPYGANK
RCYPGYTLK	RCYPGYTLK
ILIKRRQQK	ILIKRRQQK
AAFQSSMTK	AAFQSSMTK
WSYYCGGLK	WSYYCGGLK
YVLGIFLRK	YVLGIFLRK
ALFGQALHK	ALFGQALHK
TLMKTSCSK	TLMKTSCSK
RIRQQLPLY	RIRQQLPLY
HLFGYSWYK	HLFGYSWYK
MTMRRRLFK	MTMRRRLFK
STSPTRTWK	STSPTRTWK
FISFYLINK	FISFYLINK
IVIWGKTPK	IVIWGKTPK
KINSNFLLK	KINSNFLLK
KLSSMAAER	KLSSMAAER
FSNTIQSYK	FSNTIQSYK
VGYYTFHPK	VGYYTFHPK
IVNNQESNK	IVNNQESNK
RMMGKNIFY	RMMGKNIFY
ILNFLDWIK	ILNFLDWIK
STHMENILK	STHMENILK
GTFGPVHFR	GTFGPVHFR
FVYHPDRLK	FVYHPDRLK
STFWPCLLR	STFWPCLLR
SMMVILPDK	SMMVILPDK
AQCFKMFYK	AQCFKMFYK
TLFCASDAK	TLFCASDAK
KTFDTEYQK	KTFDTEYQK
SVFESWLEK	SVFESWLEK
CLNTFVLKK	CLNTFVLKK
KTMNNYMIK	KTMNNYMIK
VSDTTVLLH	VSDTTVLLH
WIYDPRNQK	WIYDPRNQK
YLALLAAFK	YLALLAAFK
AIITPVVFY	AIITPVVFY
HLAIMAVFK	HLAIMAVFK
VTFKNAHAK	VTFKNAHAK
KTDVIDLLY	KTDVIDLLY
RVTDMAPFK	RVTDMAPFK
GIAPLQLGK	GIAPLQLGK
SLMSRVVYK	SLMSRVVYK
LVFNSISAR	LVFNSISAR
ISSVLTILY	ISSVLTILY
FIFQSSMTK	FIFQSSMTK
RAVPGPPAR	RAVPGPPAR
RTRDIYISR	RTRDIYISR
MVIENGILK	MVIENGILK
RAAAPPLPR	RAAAPPLPR
KSDPIMLLK	KSDPIMLLK
NSSIISLFY	NSSIISLFY
TMKPHTFNK	TMKPHTFNK
KILSVFFLA	KILSVFFLA
HAKYMVTDK	HAKYMVTDK
IVFVCVEYY	IVFVCVEYY
LLSGQGPMK	LLSGQGPMK
GTGLWTHDK	GTGLWTHDK
RLRQLPKKK	RLRQLPKKK
WSYYCAGLK	WSYYCAGLK
GSKYRGLPK	GSKYRGLPK
FIMLEGETK	FIMLEGETK
YLLVKWYRK	YLLVKWYRK
RVLFSIFYK	RVLFSIFYK
KILAKAIFK	KILAKAIFK
ALLATSIFK	ALLATSIFK
GNFSWFPHK	GNFSWFPHK
RLLHRTTRK	RLLHRTTRK
VTLFFLSGK	VTLFFLSGK
AIKVLRGFK	AIKVLRGFK
ASLKNTISK	ASLKNTISK
SFYVNRGFK	SFYVNRGFK
LLYILFLVK	LLYILFLVK
KSYEHQTPF	KSYEHQTPF
ISYDPKFEK	ISYDPKFEK
ATMATRRGY	ATMATRRGY
TLMAAILAY	TLMAAILAY
YVLGVFLRK	YVLGVFLRK
YTFFSYLMK	YTFFSYLMK
RVFDKADGK	RVFDKADGK
MTYSHHACR	MTYSHHACR
KTSERSQPR	KTSERSQPR
HLYPVARQR	HLYPVARQR
LLPRVVGGK	LLPRVVGGK
LLNGQGPMK	LLNGQGPMK
KIFSEVTPK	KIFSEVTPK
MTIREFPRK	MTIREFPRK
TTLEQQYNK	TTLEQQYNK
AIFQSSATK	AIFQSSATK
RVAVNKSNK	RVAVNKSNK
VLPHLCLDY	VLPHLCLDY
IMPARFYPK	IMPARFYPK
AIFQSSMTY	AIFQSSMTY
VALSSLVSK	VALSSLVSK
RVWRGEQGK	RVWRGEQGK
ILARWGSFK	ILARWGSFK
AIYESNIGY	AIYESNIGY
RSFAERLDR	RSFAERLDR
KVQEWYLSY	KVQEWYLSY
IVLFQRFLR	IVLFQRFLR
CLRIPMTDK	CLRIPMTDK
KVASAGISY	KVASAGISY
ITFLRPVLK	ITFLRPVLK
IMKQAASMK	IMKQAASMK
ALLSTDGNK	ALLSTDGNK
FLKENKLNK	FLKENKLNK
SLQTIASKK	SLQTIASKK
SQMLLIVLK	SQMLLIVLK
KLGGALQAK	KLGGALQAK
SLFNRGRLK	SLFNRGRLK
RCLKPVILK	RCLKPVILK
ALRANSAVK	ALRANSAVK
KITAEWLWK	KITAEWLWK
ALKLSWFKK	ALKLSWFKK
RQERLQRRR	RQERLQRRR
LLACAGLAY	LLACAGLAY
KLSSEQLSK	KLSSEQLSK
LSYMIGMNY	LSYMIGMNY
RAKWNNTLK	RAKWNNTLK
AIILHQQQK	AIILHQQQK
RSIAMLKSK	RSIAMLKSK
KLRKPKHKK	KLRKPKHKK
GSYFSGFYK	GSYFSGFYK
VSMTYLYNK	VSMTYLYNK
MLRTRVGTK	MLRTRVGTK
AVLQSGFRK	AVLQSGFRK
ISYPPLHER	ISYPPLHER
RIAQGVLQR	RIAQGVLQR
GTMYILLKK	GTMYILLKK
ATSTRHPSK	ATSTRHPSK
PSIFLIITK	PSIFLIITK
GTSNWTGNY	GTSNWTGNY
SVFHEHIFK	SVFHEHIFK
LTRNPAWRK	LTRNPAWRK
GLIVLPFYK	GLIVLPFYK
IISTNTLGK	IISTNTLGK
SVFKGFSDK	SVFKGFSDK
KTYYHHTGY	KTYYHHTGY
LIAATAITH	LIAATAITH
GSWATSSFR	GSWATSSFR
SVRELNFTK	SVRELNFTK
ALYSYASAK	ALYSYASAK
RWFFRPLRK	RWFFRPLRK
HLNIPIGFK	HLNIPIGFK
TVNPIVTEK	TVNPIVTEK
AMYYRRTER	AMYYRRTER
RIYRKGNPL	RIYRKGNPL
FLWWGKWRK	FLWWGKWRK
KTDFKVVKK	KTDFKVVKK
SIHLTKTDK	SIHLTKTDK
ALILAYSNK	ALILAYSNK
RTLHPFGCK	RTLHPFGCK
AISRLRTQK	AISRLRTQK
WILDRLFFK	WILDRLFFK
RLFYTFFSY	RLFYTFFSY
KTFDTEYPK	KTFDTEYPK
KLGEFGRAK	KLGEFGRAK
TLYNHHRQY	TLYNHHRQY
SLLTCAKFK	SLLTCAKFK
VTYDYIIPK	VTYDYIIPK
LLLSFTSFR	LLLSFTSFR
RVYNNTARY	RVYNNTARY
RLCRFRKSK	RLCRFRKSK
LFSKNILKY	LFSKNILKY
FASFYYIWK	FASFYYIWK
SLYGRYNCK	SLYGRYNCK
GMLVGRLGK	GMLVGRLGK
YLYNKYSFK	YLYNKYSFK
IYKGVYQFK	IYKGVYQFK
KLNKFISPK	KLNKFISPK
CVYNMMGKR	CVYNMMGKR
NLLVQYGAK	NLLVQYGAK
GLSFLNPEK	GLSFLNPEK
IITPVVFYR	IITPVVFYR
AMLDRILHH	AMLDRILHH
AIGTSITQK	AIGTSITQK
YLLVKWYKK	YLLVKWYKK
VVRVQRPAK	VVRVQRPAK
KSINKVYGR	KSINKVYGR
ILTYNKTSK	ILTYNKTSK
IMYPSPNGH	IMYPSPNGH
KMFNRASYF	KMFNRASYF
KSSSILARR	KSSSILARR
SLSAYIIRV	SLSAYIIRV
KLLISCWQR	KLLISCWQR
ALFAGDLYR	ALFAGDLYR
YLGSWATGK	YLGSWATGK
MMYTVSLGH	MMYTVSLGH
KLKKKSAFY	KLKKKSAFY
RVMANNVKK	RVMANNVKK
ALNFPGSQK	ALNFPGSQK
FTNDSIISH	FTNDSIISH
GVYSVFYLY	GVYSVFYLY
GIGTFLHYK	GIGTFLHYK
AQYKCVTIK	AQYKCVTIK
HFFMKHPNK	HFFMKHPNK
KFFPSSSYR	KFFPSSSYR
MLIFNVKSK	MLIFNVKSK
KLYKMRIPR	KLYKMRIPR
MIRTWRQNK	MIRTWRQNK
RTFNEDLFR	RTFNEDLFR
LMYPTTLLK	LMYPTTLLK
RQLESRLGY	RQLESRLGY
GIADFIIFK	GIADFIIFK
VCFWSTLFY	VCFWSTLFY
TILDDNLYK	TILDDNLYK
RVIYPANQK	RVIYPANQK
KTMVAFIRK	KTMVAFIRK
KVVDTFISY	KVVDTFISY
MSSAMSMMH	MSSAMSMMH
ALAFHLTSR	ALAFHLTSR
AAYYFMKFR	AAYYFMKFR
ITAKETLYR	ITAKETLYR
KVHAVLTEK	KVHAVLTEK
KMFTFWYMR	KMFTFWYMR
AIFQASMTK	AIFQASMTK
MVSDTIMKR	MVSDTIMKR
RQLANAIFK	RQLANAIFK
MVMCGGSLY	MVMCGGSLY
IIYYQLAGY	IIYYQLAGY
KTQFNYFKK	KTQFNYFKK
SLLGSALLK	SLLGSALLK
KQIANQFNK	KQIANQFNK
HLDKKQRFH	HLDKKQRFH
QLQLLMPLK	QLQLLMPLK
ATNNLGFMY	ATNNLGFMY
FVDINRNNK	FVDINRNNK
TVYDDAARR	TVYDDAARR
MFLTSVINR	MFLTSVINR
KTALTGAMR	KTALTGAMR
KMLTFDVFR	KMLTFDVFR
LGFGAYMSK	LGFGAYMSK
KLPRMFLPK	KLPRMFLPK
VMLFFLSGK	VMLFFLSGK
VLCVKKFYK	VLCVKKFYK
IFEPEKDIR	IFEPEKDIR
KCLNIMLGK	KCLNIMLGK
KINKNPKYK	KINKNPKYK
VTMFEALPH	VTMFEALPH
FSFKKCLVY	FSFKKCLVY
KATTQIAPK	KATTQIAPK
KLDFIRNTK	KLDFIRNTK
GLACYRFVK	GLACYRFVK
QTNFKSLLR	QTNFKSLLR
LMQGSTLPR	LMQGSTLPR
ISRTRLYDY	ISRTRLYDY
IISEEYLSK	IISEEYLSK
TYLGPLNCK	TYLGPLNCK
HMIVGRQEK	HMIVGRQEK
VVVQIDPEY	VVVQIDPEY
TNFESFTVK	TNFESFTVK
SILSLETVK	SILSLETVK
RSTPFNMLK	RSTPFNMLK
QMLTSGEYK	QMLTSGEYK
TVFKGFVNK	TVFKGFVNK
VTRKCPQKK	VTRKCPQKK
ISLWGSLLK	ISLWGSLLK
SQDLSVISK	SQDLSVISK
STELIRRVR	STELIRRVR
MSYSMCTGK	MSYSMCTGK
ALLAGFMAY	ALLAGFMAY
FLLAQFTSA	FLLAQFTSA
GLCAHILLY	GLCAHILLY
IVTDFSVIK	IVTDFSVIK
IQVTISSYK	IQVTISSYK
LLMHLVSLY	LLMHLVSLY
AISDYDYYR	AISDYDYYR
HIVCSKTVK	HIVCSKTVK
AMFQDPQER	AMFQDPQER
VADLSARNK	VADLSARNK
VVFGILIKR	VVFGILIKR
TLVPVLEKK	TLVPVLEKK
SAYERGLRY	SAYERGLRY
RQHGFTPSK	RQHGFTPSK
HLALTCILK	HLALTCILK
SLLSLREVK	SLLSLREVK
HMIVSRQEK	HMIVSRQEK
TYLGPQFCK	TYLGPQFCK
ILRPLGIEY	ILRPLGIEY
TTFITPMLR	TTFITPMLR
HTMLCMCCK	HTMLCMCCK
FMWAHPGKK	FMWAHPGKK
IINAHRIPK	IINAHRIPK
LMHLVSLYK	LMHLVSLYK
KVIQPRVEK	KVIQPRVEK
GMFDWESMK	GMFDWESMK
RLNFFTPTK	RLNFFTPTK
ASTISWMMK	ASTISWMMK
LLALNDMGK	LLALNDMGK
RQILDNAAK	RQILDNAAK
KALKINWYK	KALKINWYK
QLAFFVAGH	QLAFFVAGH
VMLQQQAMK	VMLQQQAMK
KMSTDNAVY	KMSTDNAVY
RVYINVVVK	RVYINVVVK
GLFNYFFGK	GLFNYFFGK
RHYSASFKK	RHYSASFKK
TLNVLAWLY	TLNVLAWLY
KSYSLIRPK	KSYSLIRPK
MLYDRINLR	MLYDRINLR
KVLSHGWAY	KVLSHGWAY
KTTKSWLQK	KTTKSWLQK
KSGAIKVLK	KSGAIKVLK
LQGPPGTGK	LQGPPGTGK
ALMEITSRY	ALMEITSRY
ALALFDLLK	ALALFDLLK
YTFCRLNVK	YTFCRLNVK
LSCIRNASK	LSCIRNASK
FLWTQSLRR	FLWTQSLRR
RLQLSNGNR	RLQLSNGNR
SSNVANYQK	SSNVANYQK
RLNLKTSFH	RLNLKTSFH
ILMARYMSK	ILMARYMSK
YQHLHTAPK	YQHLHTAPK
IIFLKLFKK	IIFLKLFKK
ASANLAATK	ASANLAATK
GTIKESLLK	GTIKESLLK
AINSVPWSK	AINSVPWSK
AAMVLLLRK	AAMVLLLRK
HTFTAPIAK	HTFTAPIAK
VTFKVPHAK	VTFKVPHAK
RSTAIKVTK	RSTAIKVTK
LLTACTIFY	LLTACTIFY
FMLSVHYRK	FMLSVHYRK
RMIESRMSK	RMIESRMSK
CIDFYSRIR	CIDFYSRIR
VMNFIPIIY	VMNFIPIIY
KVFDKSLLY	KVFDKSLLY
RVRQQVIQL	RVRQQVIQL
SMFEPEREK	SMFEPEREK
SILLSSLLK	SILLSSLLK
MMYTVSLGK	MMYTVSLGK
TTLLNETAK	TTLLNETAK
TIMAAILAY	TIMAAILAY
QLKLNWFKK	QLKLNWFKK
LLGPGRPYK	LLGPGRPYK
RVRIPDVAR	RVRIPDVAR
ALTSAMLDR	ALTSAMLDR
NTFPNITLK	NTFPNITLK
QTIASKKDK	QTIASKKDK
KLSSEQLSH	KLSSEQLSH
AINSEMFLR	AINSEMFLR
SAGAGVLDK	SAGAGVLDK
VIYDSKFEK	VIYDSKFEK
HSAARRLFH	HSAARRLFH
AIFQSAMTK	AIFQSAMTK
ALGGSIAVK	ALGGSIAVK
ALCTFLLNK	ALCTFLLNK
SILASSLLK	SILASSLLK
VTSSGTIYK	VTSSGTIYK
ALSPVLIPR	ALSPVLIPR
IIGLLKIFR	IIGLLKIFR
KLYVPLSRH	KLYVPLSRH
TMFLIAENK	TMFLIAENK
TVGPWHLGK	TVGPWHLGK
TLYDRYLIH	TLYDRYLIH
RVCEKMALY	RVCEKMALY
KIVDHIVMY	KIVDHIVMY
IMDKEQLLK	IMDKEQLLK
TIDGFAPFK	TIDGFAPFK
MTLMKGASK	MTLMKGASK
IVYRDGNPY	IVYRDGNPY
PLYRLSPKK	PLYRLSPKK
NATFFIFNK	NATFFIFNK
MVDELVTRK	MVDELVTRK
YLALMATFK	YLALMATFK
ALERLLSLK	ALERLLSLK
LARRPTPKK	LARRPTPKK
AVDLSHFLK	AVDLSHFLK
MSYYCKSHK	MSYYCKSHK
IILAALFMY	IILAALFMY
SSGVFHSYK	SSGVFHSYK
AIFLTTLSR	AIFLTTLSR
GGHGGSTFK	GGHGGSTFK
SSIVRQLFK	SSIVRQLFK
YTQLRFPKK	YTQLRFPKK
KSRLNALGK	KSRLNALGK
MGYWIESSK	MGYWIESSK
RIDGAHLTK	RIDGAHLTK
ILKRWGQLK	ILKRWGQLK
ALSTNHGHK	ALSTNHGHK
VLKAMHDKK	VLKAMHDKK
IMQRGLFGK	IMQRGLFGK
FSFGDYFKK	FSFGDYFKK
LSAGVEFLK	LSAGVEFLK
VTAASPMLY	VTAASPMLY
TLWEGSPGK	TLWEGSPGK
YLFNQHIKK	YLFNQHIKK
SLLFREVWK	SLLFREVWK
KLRMVTGLR	KLRMVTGLR
CVFKFIVAK	CVFKFIVAK
GLYRLNFRR	GLYRLNFRR
VMRSRWSRK	VMRSRWSRK
KLGEFGKAK	KLGEFGKAK
MTDAIRTLK	MTDAIRTLK
AMLTAFFLR	AMLTAFFLR
VTNPAVLRK	VTNPAVLRK
PVNRPIDWK	PVNRPIDWK
GALHLYFDK	GALHLYFDK
AIFASSMTK	AIFASSMTK
AVFDGCVVY	AVFDGCVVY
ALRGLPIRY	ALRGLPIRY
SMFWDGMDY	SMFWDGMDY
HLIFCHSKK	HLIFCHSKK
LVHFLLLKY	LVHFLLLKY
FTFKVNSVK	FTFKVNSVK
ISIRPRVTK	ISIRPRVTK
VLSHNSYEK	VLSHNSYEK
SLLRSTSQK	SLLRSTSQK
LIYRRRLMK	LIYRRRLMK
GLYNRHRGR	GLYNRHRGR
KSCICYGSY	KSCICYGSY
TTAFFNTCK	TTAFFNTCK
MQYMTIQQK	MQYMTIQQK
ILWKDIFHK	ILWKDIFHK
LAMGIMMLK	LAMGIMMLK
TFMIITSTK	TFMIITSTK
MLRLFDFNK	MLRLFDFNK
ATTFARFLY	ATTFARFLY
RVDEIILFH	RVDEIILFH
VFKDSFLRK	VFKDSFLRK
AVSEIQNNK	AVSEIQNNK
ITYTDVLRY	ITYTDVLRY
MSAPPAEYK	MSAPPAEYK
RTLDTLALY	RTLDTLALY
TTLSRTSKK	TTLSRTSKK
FLSGRGLGK	FLSGRGLGK
MLNILNGRK	MLNILNGRK
MLNIMNRRK	MLNIMNRRK
DLAWQRTLK	DLAWQRTLK
STGKSIKFK	STGKSIKFK
ALIRATSTR	ALIRATSTR
IVNEHDIKY	IVNEHDIKY
STYCSTIQK	STYCSTIQK
GLGSFVARK	GLGSFVARK
YMKFFGNFK	YMKFFGNFK
SLSLDYAWK	SLSLDYAWK
LLRALRLTK	LLRALRLTK
QSFLFWFLK	QSFLFWFLK
HLYLQYIRK	HLYLQYIRK
WMNSTGFTK	WMNSTGFTK
AIAQSSMTK	AIAQSSMTK
VVCSMEYKK	VVCSMEYKK
VASAGISYK	VASAGISYK
SADASTFLK	SADASTFLK
AIKVLKGFK	AIKVLKGFK
SVYAWERKK	SVYAWERKK
RLISMMGFK	RLISMMGFK
IIGPMFSGK	IIGPMFSGK
SVNEYHMLK	SVNEYHMLK
NISFKSINK	NISFKSINK
AIYKNTIAY	AIYKNTIAY
FLKSGAVVK	FLKSGAVVK
ALAYYNNSK	ALAYYNNSK
QLLRLMADK	QLLRLMADK
TSFGPLVRK	TSFGPLVRK
STGESSILR	STGESSILR
TVWEVQGYK	TVWEVQGYK
PSRSKMLKR	PSRSKMLKR
KLYEEPLSK	KLYEEPLSK
QMMNVNLQK	QMMNVNLQK
MLYKSSKSR	MLYKSSKSR
MLSHFHMNR	MLSHFHMNR
DMYQSVCRK	DMYQSVCRK
AQALNTLVK	AQALNTLVK
LTFLHTLYK	LTFLHTLYK
VMYNLWKMK	VMYNLWKMK
QMAGVEVRY	QMAGVEVRY
TTSDFFVNY	TTSDFFVNY
LMPILTLTR	LMPILTLTR
KIKQDVRDK	KIKQDVRDK
WFFNNYLRK	WFFNNYLRK
RIYSHIAPY	RIYSHIAPY
TLYVKALTK	TLYVKALTK
SVLNLVIVK	SVLNLVIVK
QLDEKSSIK	QLDEKSSIK
RTYSLLNRK	RTYSLLNRK
TVLEFILQK	TVLEFILQK
SSAYVFSVK	SSAYVFSVK
YSHYSHNPK	YSHYSHNPK
SFIISTLNK	SFIISTLNK
RIRSERPAF	RIRSERPAF
CMLTEFLHY	CMLTEFLHY
VLMHPDFCK	VLMHPDFCK
SIIPSGPLK	SIIPSGPLK
QIGEYTFEK	QIGEYTFEK
HINTLIQYR	HINTLIQYR
ALKKLIIDR	ALKKLIIDR
LVFTRAICK	LVFTRAICK
VTTIMFLAR	VTTIMFLAR
SIQKNTIFK	SIQKNTIFK
RAFKYPFIK	RAFKYPFIK
KYLYLWSFK	KYLYLWSFK
VLAFITFLR	VLAFITFLR
AVYSICKFY	AVYSICKFY
VVLDLFARK	VVLDLFARK
KLMPGSIYV	KLMPGSIYV
ATSIYTIER	ATSIYTIER
RTQNVLGEK	RTQNVLGEK
HLYYFITYY	HLYYFITYY
LLNKEMYLK	LLNKEMYLK
SVYGLMGFH	SVYGLMGFH
MSLQRQFLR	MSLQRQFLR
VLDMCAALK	VLDMCAALK
KLLKSWVSK	KLLKSWVSK
KLKLKGTTY	KLKLKGTTY
KSISSIFGY	KSISSIFGY
TFRERYSYK	TFRERYSYK
MLMFITSSH	MLMFITSSH
KLAETRMGY	KLAETRMGY
MVFVELPSK	MVFVELPSK
CTLPPLRFK	CTLPPLRFK
FSYDLRLNK	FSYDLRLNK
IISYFIFNR	IISYFIFNR
SSTCMMCYK	SSTCMMCYK
IAARILSEK	IAARILSEK
IVSLCPTKK	IVSLCPTKK
HVDIPLQAY	HVDIPLQAY
KSNRIPFLY	KSNRIPFLY
VMANNVKKK	VMANNVKKK
TISSESLVY	TISSESLVY
ATREGKHGK	ATREGKHGK
MILMKMKKK	MILMKMKKK
FLSGKGLGK	FLSGKGLGK
DSMDVLAEK	DSMDVLAEK
EINEWLSSK	EINEWLSSK
NLFSKNILK	NLFSKNILK
RAFDIYNEK	RAFDIYNEK
LIAATAITK	LIAATAITK
VLYNTEKGR	VLYNTEKGR
RGYVWTNGY	RGYVWTNGY
TTINYTLWR	TTINYTLWR
LAMGIMILK	LAMGIMILK
VLARWGTFK	VLARWGTFK
MILLTMKNK	MILLTMKNK
ILHAYCGIK	ILHAYCGIK
LMYALEPRK	LMYALEPRK
ASYQFQLPY	ASYQFQLPY
SLVSAGSGK	SLVSAGSGK
FISIYSRPK	FISIYSRPK
MQKFTILEY	MQKFTILEY
MVNHSTYYV	MVNHSTYYV
TIKIGGQLK	TIKIGGQLK
GVYTGSIGY	GVYTGSIGY
SVLDIISSK	SVLDIISSK
KIRKYTMRR	KIRKYTMRR
TLSLDYAWK	TLSLDYAWK
LLLKERGLK	LLLKERGLK
TFIDVHIPK	TFIDVHIPK
VTFRERYSY	VTFRERYSY
GMWCVTLGY	GMWCVTLGY
ALKISQLQK	ALKISQLQK
ATSRTLSYY	ATSRTLSYY
ILAAWLAPR	ILAAWLAPR
VTFQGKFKK	VTFQGKFKK
VVYDAKFEK	VVYDAKFEK
ELYVSSSYK	ELYVSSSYK
FLKEQHCQK	FLKEQHCQK
SLITCAKFK	SLITCAKFK
ELCGAFLFY	ELCGAFLFY
LLFRRLTSR	LLFRRLTSR
KQNHMQILK	KQNHMQILK
RVHSFFIQY	RVHSFFIQY
KSISKSNAK	KSISKSNAK
MVASDVCKK	MVASDVCKK
IVYKNCVLR	IVYKNCVLR
VLIAGIILL	VLIAGIILL
YSDIPRLKK	YSDIPRLKK
TTYMDTFFR	TTYMDTFFR
TIHDRIPHR	TIHDRIPHR
KVFVLGGCR	KVFVLGGCR
ALFEPEREK	ALFEPEREK
RLNWLTHLK	RLNWLTHLK
HMVRCCKVY	HMVRCCKVY
RVPTVFHKK	RVPTVFHKK
LLFASMGFK	LLFASMGFK
IMFEQYFIY	IMFEQYFIY
LARWSSFKK	LARWSSFKK
IMASLVLAR	IMASLVLAR
MVLASTTAK	MVLASTTAK
KTNTKHCPK	KTNTKHCPK
ITYKCPLLR	ITYKCPLLR
TLHFLTRGK	TLHFLTRGK
KAYKIISLK	KAYKIISLK
SIFEQWLRR	SIFEQWLRR
ILKKLSSIK	ILKKLSSIK
EIIFLKLFK	EIIFLKLFK
TYLGPLSCK	TYLGPLSCK
ATGFKQSSK	ATGFKQSSK
RQLFKPLTK	RQLFKPLTK
VLLGSLGCK	VLLGSLGCK
KVGNFTGLY	KVGNFTGLY
WVAGVQLLY	WVAGVQLLY
KLQARNIQK	KLQARNIQK
LMRTNFLIK	LMRTNFLIK
TVDSLSPLK	TVDSLSPLK
YLTMKAIEK	YLTMKAIEK
AIDAYPLTK	AIDAYPLTK
RTTWSIHAK	RTTWSIHAK
SVLRAVLPR	SVLRAVLPR
EQLSKYVEK	EQLSKYVEK
QLAFFVAGK	QLAFFVAGK
AVMDIISRK	AVMDIISRK
CLFDRYFKY	CLFDRYFKY
GSTHVSWPK	GSTHVSWPK
FMRFFQLLR	FMRFFQLLR
FFVFIHMVR	FFVFIHMVR
FMFGPTIYY	FMFGPTIYY
YTNEIIGYK	YTNEIIGYK
STCFKLMLK	STCFKLMLK
STYGWNIVK	STYGWNIVK
VTFKNPHAK	VTFKNPHAK
ISLGLILLK	ISLGLILLK
VVPDYGTYK	VVPDYGTYK
TLLSLTFIK	TLLSLTFIK
TLWYMWQVK	TLWYMWQVK
WILTHTLYR	WILTHTLYR
SVTKSSSWK	SVTKSSSWK
EVYEGVWKK	EVYEGVWKK
VLLRKNGNK	VLLRKNGNK
GVIADYNYK	GVIADYNYK
CMKTFFGWK	CMKTFFGWK
YIRRNMINK	YIRRNMINK
ITSTKTIEY	ITSTKTIEY
SLVLGVNEK	SLVLGVNEK
STYSDICSK	STYSDICSK
TTINFTRQR	TTINFTRQR
AVDPAKAYK	AVDPAKAYK
KIIAVFDSK	KIIAVFDSK
FLCPTFTLK	FLCPTFTLK
KVNSTLEQY	KVNSTLEQY
SIYSRPKIK	SIYSRPKIK
MLIYSMWGK	MLIYSMWGK
KVYTMDGEY	KVYTMDGEY
KVMFVIRFK	KVMFVIRFK
KSAGFPFNK	KSAGFPFNK
LALGFFLRK	LALGFFLRK
LLIWAYLSK	LLIWAYLSK
KLYEEPLLK	KLYEEPLLK
HLYSHPIIL	HLYSHPIIL
GLYNLLIRC	GLYNLLIRC
RLNAILLLY	RLNAILLLY
MMVIFRLMR	MMVIFRLMR
RLADEGLNR	RLADEGLNR
VVMAYVGIK	VVMAYVGIK
VLGLGLSLK	VLGLGLSLK
YLRNYMVIK	YLRNYMVIK
CLYPWAIFH	CLYPWAIFH
AVAVHDFFK	AVAVHDFFK
FTFDLTALK	FTFDLTALK
GVSENIFLK	GVSENIFLK
ILARWSSFK	ILARWSSFK
ESSIYVILK	ESSIYVILK
RVYAELAAL	RVYAELAAL
STFATVLEY	STFATVLEY
ILAALFMYY	ILAALFMYY
GTSWFITQR	GTSWFITQR
TLNEYKQLY	TLNEYKQLY
GTGSGVSSK	GTGSGVSSK
VSTGSQLAK	VSTGSQLAK
VMAFIAFLR	VMAFIAFLR
KLYSYGIGY	KLYSYGIGY
SVKGLTPSK	SVKGLTPSK
KAFKNNLSR	KAFKNNLSR
NIISRTRLY	NIISRTRLY
KVHAVLTEH	KVHAVLTEH
RSYMSFWCK	RSYMSFWCK
KNYPASLHK	KNYPASLHK
TVAYFNMVY	TVAYFNMVY
KLLNRVIGY	KLLNRVIGY
GTAPPPLTR	GTAPPPLTR
RLGLVLDDY	RLGLVLDDY
MQNCLLRLK	MQNCLLRLK
ISKIYTLIY	ISKIYTLIY
IINFTISMR	IINFTISMR
SLNRQTVSR	SLNRQTVSR
VMHINSPFK	VMHINSPFK
LLLTSSQQK	LLLTSSQQK
YSYATHHDK	YSYATHHDK
RLPTFMTQK	RLPTFMTQK
IVKYKQYLK	IVKYKQYLK
NLQPPALSK	NLQPPALSK
RVVDLYIGR	RVVDLYIGR
IMKSVGTGK	IMKSVGTGK
FGKWRPVQL	FGKWRPVQL
AMAFHLTTR	AMAFHLTTR
RLSVKTFVH	RLSVKTFVH
KSNILMWNK	KSNILMWNK
MLTNAISSR	MLTNAISSR
VQTKPGIFK	VQTKPGIFK
MSHLKVALY	MSHLKVALY
ALFFIIFNK	ALFFIIFNK
KLVKSLVDK	KLVKSLVDK
ISAVYFKAK	ISAVYFKAK
SFNHVLKRK	SFNHVLKRK
VLAYMLFTK	VLAYMLFTK
KMARAGLGK	KMARAGLGK
KLYVNGKAY	KLYVNGKAY
LVKMINHLK	LVKMINHLK
KSFKDILPK	KSFKDILPK
ATAHSELAK	ATAHSELAK
VMAFHLTTR	VMAFHLTTR
KISGSFSPH	KISGSFSPH
SMASLKSLY	SMASLKSLY
STCYVFGLY	STCYVFGLY
SLYDEHIKK	SLYDEHIKK
AVNAATYNR	AVNAATYNR
RINGIPQQH	RINGIPQQH
RLRYNLCKY	RLRYNLCKY
ALAETSYVK	ALAETSYVK
LLIFHINGK	LLIFHINGK
SLCFLLTQK	SLCFLLTQK
KMLEASTIY	KMLEASTIY
VVENPTIQK	VVENPTIQK
YVMCTGSFK	YVMCTGSFK
VIGFLALAK	VIGFLALAK
MGFGHRIYK	MGFGHRIYK
KMLKRGSRK	KMLKRGSRK
IFAFIDFSK	IFAFIDFSK
TLYDRYLIK	TLYDRYLIK
RINEGWPAY	RINEGWPAY
RTFGKLPYR	RTFGKLPYR
AMLFLISGK	AMLFLISGK
IQFMMSRRR	IQFMMSRRR
HAFDAPTLY	HAFDAPTLY
TLNHVLALK	TLNHVLALK
ALRGVAVGR	ALRGVAVGR
GLHATFMPK	GLHATFMPK
FSFGGFTFK	FSFGGFTFK
IGYRLGMGK	IGYRLGMGK
LMLASSAGK	LMLASSAGK
LFFPFGLFK	LFFPFGLFK
AIFQCSMTK	AIFQCSMTK
