Data	Data aligned
QEEVFNTAV	QEEVFNTAV
AELGALHSA	AELGALHSA
QEGNQISII	QEGNQISII
AEHKIFPA	AEHK-IFPA
AEQGHLPPP	AEQGHLPPP
AEAVFASEV	AEAVFASEV
MEELHNQEV	MEELHNQEV
TEKKDVLVP	TEKKDVLVP
AEDEWKAQV	AEDEWKAQV
AELPLLYRA	AELPLLYRA
EEEEPVKEA	EEEEPVKEA
AEEAGAALRTA	EEAGALRTA
AEALAAFTA	AEALAAFTA
AEHSPYYEA	AEHSPYYEA
EEQVRSLEA	EEQVRSLEA
SEIDQVVPA	SEIDQVVPA
AEQILQHMV	AEQILQHMV
EEMGVPVAA	EEMGVPVAA
EKSDSLEQP	EKSDSLEQP
AEGLSHTP	AEGL-SHTP
MENANIPSV	MENANIPSV
MEDDKVAEA	MEDDKVAEA
GEIASFDKA	GEIASFDKA
SEYLSSHLEA	SEYLSHLEA
AEINNIIKI	AEINNIIKI
AENLLVKEA	AENLLVKEA
AEQEFLANA	AEQEFLANA
NEGVATYAA	NEGVATYAA
AEAEALPWA	AEAEALPWA
AEEEYGMKA	AEEEYGMKA
QENDRVVMV	QENDRVVMV
GEYEWVHKP	GEYEWVHKP
AELEKHMAA	AELEKHMAA
MEEMYKKAHAA	EEMYKAHAA
IDLINNDQI	IDLINNDQI
REQDQSFTA	REQDQSFTA
LDTLKLNIV	LDTLKLNIV
KEQPPQLSA	KEQPPQLSA
SELQLPFQA	SELQLPFQA
AENVAVPEA	AENVAVPEA
VEREDFVEA	VEREDFVEA
SEETPLTAA	SEETPLTAA
EENFAVEA	EENF-AVEA
EEAPQTPVA	EEAPQTPVA
SESTFMPVA	SESTFMPVA
SELAFPITA	SELAFPITA
VVESTGVF	VVES-TGVF
AEMKAQEVA	AEMKAQEVA
AEYLLQHGA	AEYLLQHGA
AERGAFIDQS	AERGFIDQS
AEEQLRLVV	AEEQLRLVV
AEHLGEAEVA	AEHLEAEVA
AEIPEGYVP	AEIPEGYVP
AEVGSDGERVA	AEVGGERVA
GEMWSEQSA	GEMWSEQSA
AEQTLSQLP	AEQTLSQLP
AEVEHVVNA	AEVEHVVNA
LEKLFPDTP	LEKLFPDTP
AEVIQAFSA	AEVIQAFSA
AEQAKVVLA	AEQAKVVLA
AEKAYHEQL	AEKAYHEQL
IEEELGSKA	IEEELGSKA
AEALIKHKP	AEALIKHKP
PEDVLKSLL	PEDVLKSLL
AERDLRDIGA	AERDRDIGA
AEEAKSAIA	AEEAKSAIA
REMRGLTSA	REMRGLTSA
NERFFGDSAA	NERFFGDSA
AEGVPVRGA	AEGVPVRGA
FDSIDIDVI	FDSIDIDVI
NEIDAEPPA	NEIDAEPPA
AEQELKIPRL	AEQEKIPRL
AEEDFYEKL	AEEDFYEKL
EEIQRLYEA	EEIQRLYEA
AEAEFYRQV	AEAEFYRQV
NEAAITDAAV	NEAAITDAA
AEAAAAPTV	AEAAAAPTV
AESKVSVAV	AESKVSVAV
QEYPTLKVP	QEYPTLKVP
EEKQKWLDA	EEKQKWLDA
SESPVILTP	SESPVILTP
ENAGEDPGLAR	AGEDPGLAR
GDSSLEDQAL	GDSSLEDQA
AEMTTRMVA	AEMTTRMVA
SEAATPPVA	SEAATPPVA
HEQQKLPAA	HEQQKLPAA
EEETVFPKA	EEETVFPKA
NEKEGFPITA	NEKEFPITA
YLPDGTASL	YLPDGTASL
AEYLQPKAA	AEYLQPKAA
AARELAGPPA	AAREAGPPA
AEEEAYKSELF	AEEEYKSEL
AETDSVVIA	AETDSVVIA
AEIQETITA	AEIQETITA
NEEPPALPP	NEEPPALPP
EEAQPQPQP	EEAQPQPQP
AERDYLDLTA	AERDLDLTA
EEQPRFQSA	EEQPRFQSA
LEMGAVEILI	LEMGAVEIL
AERDILVEA	AERDILVEA
AEAAFGLGA	AEAAFGLGA
AEEERMIAV	AEEERMIAV
AESPGVPVA	AESPGVPVA
SEEKPVPAA	SEEKPVPAA
EETNQKLVA	EETNQKLVA
AEAPHIVVG	AEAPHIVVG
EELQKIYKT	EELQKIYKT
SETKIFTA	SETK-IFTA
SESFIQHIV	SESFIQHIV
AEAVNVAIA	AEAVNVAIA
AENVFFVA	AENV-FFVA
HEFLHEVPAA	HEFLEVPAA
EEDIRDLAA	EEDIRDLAA
AENPKLISA	AENPKLISA
AEKSRTYVA	AEKSRTYVA
QESLPHAGP	QESLPHAGP
NESPGAPPA	NESPGAPPA
KEHEEFQITA	KEHEFQITA
SENEYIMKA	SENEYIMKA
TEIEKSISA	TEIEKSISA
LEENPDPSA	LEENPDPSA
SEEPLLHVA	SEEPLLHVA
AEILELAGNAA	AEILAGNAA
EEQKIVVKV	EEQKIVVKV
HELLKTNAA	HELLKTNAA
EEEGPFHSLP	EEEGPFHSL
AENPGKYNI	AENPGKYNI
EEAPAAMTAA	EEAPAAMTA
KEAPPMEKP	KEAPPMEKP
AEQRPGVAP	AEQRPGVAP
AENAYHIHQA	AENAHIHQA
EEHPVLLTEA	EEHPLLTEA
AEQPYFIEA	AEQPYFIEA
EEIAYKFTP	EEIAYKFTP
AEMVKPSTP	AEMVKPSTP
IDVDKRTKL	IDVDKRTKL
MEAQKSAVP	MEAQKSAVP
QEIPVVSAP	QEIPVVSAP
MEALPLLAA	MEALPLLAA
AEAIHSPQV	AEAIHSPQV
EESSKIRAP	EESSKIRAP
FESSGIHVA	FESSGIHVA
QEEFYRVYP	QEEFYRVYP
SETVMVHQA	SETVMVHQA
AERDFIHTA	AERDFIHTA
MEQQTISIA	MEQQTISIA
IIHEIAVLEL	HEIA-VLEL
AEQTRAVLA	AEQTRAVLA
AEEKAVLIA	AEEKAVLIA
EETPLAVQA	EETPLAVQA
SEAEFLARTA	SEAELARTA
SEALPSDIA	SEALPSDIA
QEQMRPQLP	QEQMRPQLP
VEERPGLPA	VEERPGLPA
QEARVFNETP	QEARFNETP
AEIEDPPIP	AEIEDPPIP
AEAPPSVAP	AEAPPSVAP
QEQVSRFLAA	QEQVRFLAA
AEHFSMIRA	AEHFSMIRA
AEMEKATEV	AEMEKATEV
SQQQEAETPP	QEAE--TPP
NEEQRLASA	NEEQRLASA
QENERLYNQV	QENELYNQV
SENWRVDSA	SENWRVDSA
AEQPSELVSA	AEQPELVSA
SEHASQSVP	SEHASQSVP
NAEVWAYLA	NAEVWAYLA
QEQLRLQLP	QEQLRLQLP
SELTPMLAA	SELTPMLAA
AEAIIRSGA	AEAIIRSGA
KEMLETQVA	KEMLETQVA
AEEENFKKP	AEEENFKKP
AEKYIMTSA	AEKYIMTSA
EEELGLVGA	EEELGLVGA
SEESVGGRVA	EESVGGRVA
AEGQRWLSA	AEGQRWLSA
GENFDKLLA	GENFDKLLA
AETKDLLVA	AETKDLLVA
SEDEPTRSL	SEDEPTRSL
EEIWNDFREA	EEIWDFREA
KEDKPPLAP	KEDKPPLAP
YEAGHLSFYSA	AGHLSFYSA
GEAEAFAIGA	GEAEFAIGA
AESRPTPMG	AESRPTPMG
SEIRVYSA	SEIR-VYSA
AEAEASRLTA	AEAESRLTA
AEELASGHLA	AEELSGHLA
MEQVFEMKV	MEQVFEMKV
AEQDFWRAV	AEQDFWRAV
EEEEFRRLAA	EEEERRLAA
SEITDTVAA	SEITDTVAA
EEVPGSPEA	EEVPGSPEA
EDDEAPSKPA	EDDEPSKPA
AEKEMTSVVA	AEKETSVVA
IDLSSNKNI	IDLSSNKNI
QETSFTKEA	QETSFTKEA
EESVFAVTA	EESVFAVTA
EEYEWKETA	EEYEWKETA
KIVKWDRDM	KIVKWDRDM
SENKAFISV	SENKAFISV
SEEGHPFKA	SEEGHPFKA
SELPIVTPA	SELPIVTPA
NEEPKVATA	NEEPKVATA
AEEKLTHKMEA	EEKLHKMEA
AEEFVIVKA	AEEFVIVKA
EEALPVTTA	EEALPVTTA
AEYGHFVDI	AEYGHFVDI
KEEAKFFTA	KEEAKFFTA
AEEEPNRIP	AEEEPNRIP
SEEVGIAEA	SEEVGIAEA
AELFEKAAA	AELFEKAAA
QELGGLHSA	QELGGLHSA
AELGLTRAA	AELGLTRAA
QEIMTVPPP	QEIMTVPPP
EEAAAVPAA	EEAAAVPAA
TEQSWPHSA	TEQSWPHSA
EEIQIKEPA	EEIQIKEPA
AENEAETKLQA	NEAETKLQA
EEFSFIPSA	EEFSFIPSA
EESPTATVA	EESPTATVA
AEPVASTPA	AEPVASTPA
SETELKDTYA	SETEKDTYA
AERFYGKYTA	AERFGKYTA
GGLPERSVSL	GGLPRSVSL
AESDKYTIDA	AESDYTIDA
EEIDISKAA	EEIDISKAA
LDINDNVPEF	LDINNVPEF
AESIHTGLEVA	AESITGLEV
AEQLEPRVSA	AEQLPRVSA
EEAKRWMEA	EEAKRWMEA
AEEAARLSVAA	AEEARLSVA
GEMAGAFVA	GEMAGAFVA
ADKFGNICVV	ADKFNICVV
MEEQVTKAEA	EEQVTKAEA
AAPATRAAL	AAPATRAAL
EETPEQPTA	EETPEQPTA
KENAFSLGA	KENAFSLGA
SEMHLHDTA	SEMHLHDTA
SEQEHFLIV	SEQEHFLIV
SEPDGPGIAA	SEPDPGIAA
FEEEMKGIAA	EEEMKGIAA
AEQVVARVA	AEQVVARVA
AEEPPAHAP	AEEPPAHAP
EEEEAQPMA	EEEEAQPMA
EEVKQEITA	EEVKQEITA
AEDKKTALP	AEDKKTALP
AEEADVHVA	AEEADVHVA
EEQDSVKVA	EEQDSVKVA
KDEDSAGCHL	KDED---SA
AELGHLVVS	AELGHLVVS
SENLLHLTA	SENLLHLTA
AEEPKPVEA	AEEPKPVEA
AEHRMLVVA	AEHRMLVVA
KEMEKSFEV	KEMEKSFEV
AEMSHIPQS	AEMSHIPQS
AEQDPNVQV	AEQDPNVQV
AEIRDKNFNA	AEIRKNFNA
SEEPGAPLP	SEEPGAPLP
MEMTFTRPA	MEMTFTRPA
EERQPSPEP	EERQPSPEP
AEQAHLWAEL	AEQALWAEL
AELDKLTSV	AELDKLTSV
GEMWNNTAA	GEMWNNTAA
TEDPHTVLVEF	TEDPHTVLV
EELGLVHSP	EELGLVHSP
AEKTLGDFAA	AEKTGDFAA
AEAIRILAA	AEAIRILAA
AELWKNPTA	AELWKNPTA
NEQMHQLVAA	NEQMHQLVA
GEAEVSPTA	GEAEVSPTA
EEASGIPSRTA	EEASGIPSR
AEIKIIREA	AEIKIIREA
AEEARQMAA	AEEARQMAA
AEINATMSV	AEINATMSV
AERMGFTEV	AERMGFTEV
SELSSNPAA	SELSSNPAA
EDRVVVIRF	EDRVVVIRF
SEETPAISP	SEETPAISP
EERPWLWVV	EERPWLWVV
NEQGSYVVA	NEQGSYVVA
AENDVKLGA	AENDVKLGA
SEMDRVPFV	SEMDRVPFV
AENDPFVRP	AENDPFVRP
AESPVNMMP	AESPVNMMP
AEANHFIDL	AEANHFIDL
EEAASAPAV	EEAASAPAV
IDERSDAEIV	DERSDAEIV
SEIELVFRP	SEIELVFRP
EEEETSIKA	EEEETSIKA
QEGAVAFAA	QEGAVAFAA
EEMPQVHTP	EEMPQVHTP
HEALETTQYL	HEALETTQY
VEHPSLQSP	VEHPSLQSP
AEEGPPLGA	AEEGPPLGA
AEAILGQNAA	AEAIGQNAA
SEEMYVPRVVT	SEEMYVPRV
EELRDIPQA	EELRDIPQA
EEHPTLLTEA	EEHPLLTEA
SELERLIVP	SELERLIVP
SELSQNISA	SELSQNISA
EEEPPQNMKP	EEEPQNMKP
QEQRIMKEA	QEQRIMKEA
EEKPHQWSA	EEKPHQWSA
KERAKREKA	KERAKREKA
EEKESWIKA	EEKESWIKA
SEEEFERIHQA	EEFERIHQA
ADASIRLLKA	ADASRLLKA
EEAPGEPSA	EEAPGEPSA
AEAPHLVQV	AEAPHLVQV
TEGKINPLL	TEGKINPLL
AEISSRNLAA	AEISRNLAA
AEELRAQTA	AEELRAQTA
SEKEATPVV	SEKEATPVV
AEKFWYDMA	AEKFWYDMA
VENPGGYVA	VENPGGYVA
HENESVYKA	HENESVYKA
EEYDKIQIA	EEYDKIQIA
DEQNHLVVA	DEQNHLVVA
VDEDLFEII	VDEDLFEII
AEAAVVLEA	AEAAVVLEA
EENPGIFAV	EENPGIFAV
SEAPPTNQA	SEAPPTNQA
EELEHVSAP	EELEHVSAP
AEDVLSGKVSA	AEDVGKVSA
EEELFKMRA	EEELFKMRA
QEQRQAFAP	QEQRQAFAP
AEKFPSTETA	AEKFSTETA
REMPGVWGA	REMPGVWGA
EEEEQRAIA	EEEEQRAIA
AEQDELSQRLA	AEQDSQRLA
AEQMASVQNA	AEQMSVQNA
LRNVSTGD	LRNV-STGD
REKMFVEEV	REKMFVEEV
REHPKLKAP	REHPKLKAP
AEQLAEKINA	AEQLEKINA
AEELEPRAP	AEELEPRAP
SEEGGHVAV	SEEGGHVAV
EEQQRLLEA	EEQQRLLEA
AEGAFPNLA	AEGAFPNLA
REAAFSLAEA	REAASLAEA
GELLFVHSA	GELLFVHSA
LEMKPGPQA	LEMKPGPQA
EELSNVLAA	EELSNVLAA
HEQQFAHPP	HEQQFAHPP
AEQKAFEVIA	AEQKFEVIA
AEYGEIKNIHL	AEYGEIKNI
EDLAAFVEEL	EDLAFVEEL
YDKILSYIY	YDKILSYIY
AEIESIVKP	AEIESIVKP
SEAEKVYIV	SEAEKVYIV
AEIISEIRA	AEIISEIRA
EEVAYEERA	EEVAYEERA
SEIQGLRTV	SEIQGLRTV
AEKYEWDVA	AEKYEWDVA
SETKAWLIAA	SETKWLIAA
AEEEGVKMSA	AEEEVKMSA
KENPDIYKEL	KENPIYKEL
MESDKHLEA	MESDKHLEA
QEEDVYHTV	QEEDVYHTV
RELLIIGGVA	RELLIGGVA
AEAEALYSA	AEAEALYSA
AAPEGKRSL	AAPEGKRSL
SERKIEFDSA	SERKEFDSA
EEEKASKEFAA	EEKAKEFAA
AEQPTRYETL	AEQPTRYET
EEQPVFRLV	EEQPVFRLV
AEAEGLRAA	AEAEGLRAA
VEEEPRPAA	VEEEPRPAA
TETDSLVSA	TETDSLVSA
KEAPAPPKA	KEAPAPPKA
EEAPALDAA	EEAPALDAA
SEEDFQGITP	SEEDQGITP
AELQQHDVA	AELQQHDVA
QEADDIVRVA	QEADIVRVA
AEELPGSHA	AEELPGSHA
GEKFHSEVA	GEKFHSEVA
LAPTDVKEL	LAPTDVKEL
KETDSLKVAA	KETDSLKVA
EERVQIVSA	EERVQIVSA
AEERDKRLAA	AEERKRLAA
AEQLAKWIA	AEQLAKWIA
AEAVLYEHL	AEAVLYEHL
SELQKIHKA	SELQKIHKA
AEEDVQGTQA	AEEDQGTQA
SEHASSPVP	SEHASSPVP
AENELGVVVA	AENEGVVVA
SELITKAVA	SELITKAVA
REMENIIAT	REMENIIAT
QEMNRLFGA	QEMNRLFGA
FEKPFLWLA	FEKPFLWLA
AEAVLKHIA	AEAVLKHIA
EETILKSQV	EETILKSQV
AESWGTGRAVA	AESWGTGRA
EAQPPPPPP	EAQPPPPPP
AEEEFFYEKA	AEEEFYEKA
AEEDAWLRA	AEEDAWLRA
AEFPGLPEA	AEFPGLPEA
AEKLYPLPSA	AEKLPLPSA
HEIGHGIAA	HEIGHGIAA
EEMKGIAA	EEMK-GIAA
EERPPTLSA	EERPPTLSA
KESGVDIAA	KESGVDIAA
GEFGGFGSV	GEFGGFGSV
SEIQNVTGF	SEIQNVTGF
AEGKPGVEA	AEGKPGVEA
EEIKDFLLTA	EEIKFLLTA
AEFAERTVA	AEFAERTVA
SEQVPLMSA	SEQVPLMSA
SEIGGITIA	SEIGGITIA
SESRFFVSS	SESRFFVSS
NELPLTHET	NELPLTHET
EEIPKIFQI	EEIPKIFQI
AEQKLRIQA	AEQKLRIQA
QEINTLLEA	QEINTLLEA
QEDPNSIIA	QEDPNSIIA
KEKPGWVTP	KEKPGWVTP
AEHENLRTP	AEHENLRTP
GERDFQTSA	GERDFQTSA
AEHDSILAEKA	AEHD-SILA
INPEDDTDP	INPEDDTDP
EEMHQVAIA	EEMHQVAIA
QEVLGHAA	QEVL-GHAA
SEKEIYNQV	SEKEIYNQV
SEIESVKISA	SEIEVKISA
AEKAEFYQI	AEKAEFYQI
QEIPKYITA	QEIPKYITA
SETEATPVP	SETEATPVP
EELGAVTVKA	EELGVTVKA
AEAQRWVEA	AEAQRWVEA
SENAHIIEA	SENAHIIEA
SETSPFPPA	SETSPFPPA
GEQEGAMVAA	GEQEGAMVA
QESPIMAKP	QESPIMAKP
VAAAEAVIG	VAAAEAVIG
SESDEALVA	SESDEALVA
TEADIFHQA	TEADIFHQA
EELPKSSSA	EELPKSSSA
AEQIVPLSA	AEQIVPLSA
SESFVSPEA	SESFVSPEA
TEAPRWPLP	TEAPRWPLP
AENQGFVAA	AENQGFVAA
AENGFLPIHL	AENGLPIHL
EEDVLKFLA	EEDVLKFLA
EELDSLIKA	EELDSLIKA
GEARPGPTA	GEARPGPTA
AEAWLLGQEP	AEAWLGQEP
KEYGSGKIVL	KEYGGKIVL
AEQLRGFNA	AEQLRGFNA
LDPETVDNL	LDPETVDNL
EEMIETKGRAA	EEMIKGRAA
AESQTPTPSA	AESQPTPSA
AESAPLPVSA	AESALPVSA
AEYLQPKA	AEYL-QPKA
PETEQVNGLF	PETEQVNGL
AETAVQLFI	AETAVQLFI
EEVVSREV	EEVV-SREV
AEQIKHILA	AEQIKHILA
GEIQPVSVKV	GEIQVSVKV
AEIEYLEKTLP	AEIEYLEKT
AEYALKRQEA	AEYAKRQEA
AEPLEIILHLP	AEPLIILHL
RPEAPPPPP	RPEAPPPPP
EEFDKFLEERA	EEFDKFLEE
AEQHGVWTA	AEQHGVWTA
AEQQALRLEV	AEQQLRLEV
AEKWEVAEV	AEKWEVAEV
TERDSFSLA	TERDSFSLA
KEKSIFLVA	KEKSIFLVA
AESDHMAIP	AESDHMAIP
SERWKTMSA	SERWKTMSA
EEEIDAPKP	EEEIDAPKP
AESSFSQEV	AESSFSQEV
EEQPQEAVP	EEQPQEAVP
GELNTLDIM	GELNTLDIM
SEADIRGFVA	SEADRGFVA
HAIYEEITA	HAIYEEITA
QEKALFAVP	QEKALFAVP
EEEKTTLRA	EEEKTTLRA
SIPGGYNAL	SIPGGYNAL
AEEERRIAA	AEEERRIAA
AEKDFWELA	AEKDFWELA
PAEAPAEAAAA	AEAPAEAAA
AEAPKFPTP	AEAPKFPTP
AEEPDLHGP	AEEPDLHGP
EEHNIVFMP	EEHNIVFMP
AEELALEQA	AEELALEQA
EKEMEGVA	EKEM-EGVA
AEHRIDFVA	AEHRIDFVA
AEMENIKAI	AEMENIKAI
SEHGLVVIA	SEHGLVVIA
AEIEEALQA	AEIEEALQA
TEMEISRAA	TEMEISRAA
AEQQAALLLA	AEQQALLLA
SESSTILVVRY	SESSTILVV
TDYDTLIDV	TDYDTLIDV
SESEAVAVA	SESEAVAVA
SEQQALHTV	SEQQALHTV
AEAPASPAP	AEAPASPAP
REKMGWAQV	REKMGWAQV
AEIEPEAQA	AEIEPEAQA
AEAKFFTES	AEAKFFTES
EESPVQYAA	EESPVQYAA
AELGMEHQA	AELGMEHQA
AEIVLGNVQNA	AEIVNVQNA
AELQSRLAA	AELQSRLAA
AEKLGFAGL	AEKLGFAGL
AELGTEIAA	AELGTEIAA
SEAPPSKMV	SEAPPSKMV
AEYLLGPLYA	AEYLGPLYA
AEQSEIIQA	AEQSEIIQA
EEMRHIDMV	EEMRHIDMV
SEEKLVISA	SEEKLVISA
AEAIGADSA	AEAIGADSA
REHAPFLVA	REHAPFLVA
AEHSLLDLP	AEHSLLDLP
AESAQTRVAP	AESAQTRVA
SESSAIPEA	SESSAIPEA
SDKEKPIFNV	SDKEPIFNV
SEEHNTWEP	SEEHNTWEP
KESDIYIVA	KESDIYIVA
AEEGPGVPAA	AEEGGVPAA
KEGLQNMEA	KEGLQNMEA
AEEPAAAAA	AEEPAAAAA
SETSLIGTA	SETSLIGTA
EEAPPGLSP	EEAPPGLSP
EEANKAFSA	EEANKAFSA
NDIDEILGIA	NDIDILGIA
AERPGEAAVA	AERPEAAVA
GEEDFSLSA	GEEDFSLSA
AEHYLPIFA	AEHYLPIFA
EEFVQMMTA	EEFVQMMTA
AEKKFIDIA	AEKKFIDIA
AEVEGRLPA	AEVEGRLPA
QEEEPQKKLP	EEEPQKKLP
AEAIPGLAA	AEAIPGLAA
ISPTGHSL	ISPT-GHSL
TEHFLTAVA	TEHFLTAVA
QEARPPLVSA	QEARPLVSA
AEEEQKIAA	AEEEQKIAA
AEQLSLVQA	AEQLSLVQA
TEAKPAVVA	TEAKPAVVA
AESLGQYAA	AESLGQYAA
TEAQIKHLA	TEAQIKHLA
AEVVDEIAA	AEVVDEIAA
SEHSVIKPP	SEHSVIKPP
AEEPASVTP	AEEPASVTP
NENYAGIAA	NENYAGIAA
YAPKGSSL	YAPK-GSSL
QESEMKVLA	QESEMKVLA
EEIGKVAAA	EEIGKVAAA
AEREAFELLP	AEREFELLP
SEQGLAKAVA	SEQGAKAVA
EEELFPESERP	EELFESERP
SEVEVIHVP	SEVEVIHVP
TESSHFYSA	TESSHFYSA
AEIAHNVSS	AEIAHNVSS
EELPHIHA	EELP-HIHA
LEHEGLATA	LEHEGLATA
QEEPEARVPA	QEEPEARVP
KEQEPMPTV	KEQEPMPTV
SETDFKVMA	SETDFKVMA
SEKFSPETA	SEKFSPETA
AELYFHDSA	AELYFHDSA
HEMVVYEAA	HEMVVYEAA
MEENFAVEA	MEENFAVEA
SENEEFVEV	SENEEFVEV
SEEFPSFGA	SEEFPSFGA
AESLPGVEA	AESLPGVEA
AEEDAALQA	AEEDAALQA
AEEESTLTKL	AEEETLTKL
QEYFGSLAA	QEYFGSLAA
AENPGKYNIL	AENPGKYNI
NEALWREVA	NEALWREVA
AESLQPVA	AESL-QPVA
SEASETPMA	SEASETPMA
AEQATTVKA	AEQATTVKA
EEQHQLAVTA	EEQHLAVTA
EEAAVAIKA	EEAAVAIKA
AESWGTGRAV	AESWGTGRA
SEEQGARLAA	EEQGARLAA
REAPHLEKQPA	REAPLEKQP
AEMPDMYPP	AEMPDMYPP
MEMPSQPAP	MEMPSQPAP
SEQHIPVSA	SEQHIPVSA
SEILYSAPP	SEILYSAPP
AEMRLFYTT	AEMRLFYTT
KEALGIPAA	KEALGIPAA
SEMSKVSKP	SEMSKVSKP
AESGALIEA	AESGALIEA
QEQIEAIHKA	QEQIAIHKA
SVPEAQSAL	SVPEAQSAL
SESVNLRIA	SESVNLRIA
SEQPTLVTA	SEQPTLVTA
QEEPQSLQA	QEEPQSLQA
LESRPFPAA	LESRPFPAA
SEAAPLLVHV	SEAALLVHV
AETQQPPAA	AETQQPPAA
AEEEETSIKAA	EEEETSIKA
NEKAWFQTP	NEKAWFQTP
TEVANIPVA	TEVANIPVA
AEQFKLIQA	AEQFKLIQA
AESYHQHFAA	AESYQHFAA
VDKVKQLLA	VDKVKQLLA
AENVMQIHA	AENVMQIHA
AEFGQAESA	AEFGQAESA
SSPQPGSAL	SSPQPGSAL
AETSHALVP	AETSHALVP
AEAESAQTRVA	AESAQTRVA
AEEKPAPQM	AEEKPAPQM
NEIRINIGA	NEIRINIGA
EEFQFIKKA	EEFQFIKKA
KSQLQEAP	KSQL-QEAP
QEYPDLIHIY	QEYPDLIHI
EEIEGLISA	EEIEGLISA
MEQQTISIAKA	MEQQTISIA
AEMLEIVQA	AEMLEIVQA
EESKTFVSS	EESKTFVSS
AEAFRLPTA	AEAFRLPTA
AEEDFLAVSP	AEEDLAVSP
EEGPGVPAA	EEGPGVPAA
EEYKATVA	EEYK-ATVA
EENQSVVVDFL	EENQSVVVD
GEIFDHLVA	GEIFDHLVA
AEHDLWHIIKF	AEHDLWHII
QEYLSGRSILA	QEYLSGRSI
AEAGPLASV	AEAGPLASV
EELPQLINA	EELPQLINA
AEQLQEIIA	AEQLQEIIA
LEQYPTRPHIA	LEQYRPHIA
AEEPWGEEA	AEEPWGEEA
AEALPSLAA	AEALPSLAA
EEEEFNTGP	EEEEFNTGP
AEMYTKTGV	AEMYTKTGV
SEADMRFYAA	SEADRFYAA
QEGVEVRVA	QEGVEVRVA
AEKIDGVFAA	AEKIGVFAA
QEAYFRYMA	QEAYFRYMA
SEQREFVMA	SEQREFVMA
AEEEPNRIPS	AEEEPNRIP
AEHGSVALP	AEHGSVALP
AKNKLNDLED	AKNKNDLED
SEELPSTAV	SEELPSTAV
AEAAALEVLA	AEAALEVLA
AEKAGTFGP	AEKAGTFGP
NEDLRSWTA	NEDLRSWTA
EEEREFYNA	EEEREFYNA
REMPVKVEA	REMPVKVEA
AEKRDPQELVA	AEKRQELVA
AEALGSTEA	AEALGSTEA
SEVGKLLSA	SEVGKLLSA
AEDGFFVPP	AEDGFFVPP
PDLAEKNPP	PDLAEKNPP
AEEVLLGVHA	AEEVLGVHA
QEEFQEHEA	QEEFQEHEA
LENALKLIP	LENALKLIP
AEEDMPQRVV	AEEDPQRVV
AEAQPMAVV	AEAQPMAVV
SESDYIVMP	SESDYIVMP
AENTIQNEA	AENTIQNEA
AEFQVKITA	AEFQVKITA
MENEMAHYA	MENEMAHYA
AEMAVQQNP	AEMAVQQNP
AEEIAGKWLQA	EEIAKWLQA
AELPAAAQPSA	AELPAAAQP
AEHPGFMKT	AEHPGFMKT
LEMVYDATIL	LEMVYDATI
AEGDISNVA	AEGDISNVA
HESDINAVA	HESDINAVA
NEIKDSVVA	NEIKDSVVA
QEFPFPETP	QEFPFPETP
SEAEIQAKA	SEAEIQAKA
AEIPQIFDA	AEIPQIFDA
AEIDEEPVS	AEIDEEPVS
AEEAYNAVV	AEEAYNAVV
EENNIVHQA	EENNIVHQA
SESPVTPSA	SESPVTPSA
TEEEKNFKA	TEEEKNFKA
SEQNGAKIVA	SEQNAKIVA
AEYDNFFQHL	AEYDFFQHL
AEEGFTQVT	AEEGFTQVT
QEDRPGLHA	QEDRPGLHA
AETDKITLEVA	AETDITLEV
DEFEFLEKA	DEFEFLEKA
RENVFKLLP	RENVFKLLP
NEVTDYAIA	NEVTDYAIA
AEEGTRNVVA	AEEGRNVVA
EEEDFIRAA	EEEDFIRAA
EEEVMIAHA	EEEVMIAHA
PGSSAVPAAA	GSSAVPAAA
AEAQHLYQS	AEAQHLYQS
AEAPGAVAGA	AEAPAVAGA
AEKGNFEAA	AEKGNFEAA
AELLVSHGA	AELLVSHGA
EEEKWVEVA	EEEKWVEVA
EEADAAMAA	EEADAAMAA
AENLEKVQA	AENLEKVQA
MEMTNSHLA	MEMTNSHLA
AELEKAHLA	AELEKAHLA
AELNGKDGFIP	AELNGKDGF
QEQSFVIRA	QEQSFVIRA
EENYNVVAP	EENYNVVAP
SEAPGQRALP	SEAPGQRAL
VDDIDNGIV	VDDIDNGIV
LEMLTGQERVA	LEMLGQERV
SEQETLVRP	SEQETLVRP
EEDAALFKA	EEDAALFKA
AEMLYGLIHA	AEMLGLIHA
EELIQLVAA	EELIQLVAA
SEESPAIEA	SEESPAIEA
SEIINNITA	SEIINNITA
AETEFFSKA	AETEFFSKA
AERYDDMAA	AERYDDMAA
QEDAARLQAA	QEDARLQAA
REIDDYIVQA	REIDYIVQA
SEKGGQPLP	SEKGGQPLP
VENDKLPPP	VENDKLPPP
SEEGSVYTA	SEEGSVYTA
GEEADFHQA	GEEADFHQA
AEGIKVTDA	AEGIKVTDA
EERNLLSVA	EERNLLSVA
SEDNPTPGI	SEDNPTPGI
AEAGGMHTV	AEAGGMHTV
VEEPSNPEA	VEEPSNPEA
TEAPLNPKA	TEAPLNPKA
QENKNLPQA	QENKNLPQA
SEQVFKVAS	SEQVFKVAS
NEQMHQLVA	NEQMHQLVA
SEQTEALIHRA	SEQTLIHRA
SESAGLATA	SESAGLATA
AEEVWARVA	AEEVWARVA
AEKKFIDIAA	AEKKFIDIA
AEALSQAVA	AEALSQAVA
MEDTGSYRA	MEDTGSYRA
AEAQKLGKP	AEAQKLGKP
EEQTSVFSA	EEQTSVFSA
AEGAYQVAA	AEGAYQVAA
MESLDGLHLP	MESLGLHLP
SEGVRVNVV	SEGVRVNVV
AEEGSLAAAA	AEEGSLAAA
AEAQLWWAA	AEAQLWWAA
QEGPGSLAA	QEGPGSLAA
SEAKQMPRA	SEAKQMPRA
GETKSSYIAA	GETKSYIAA
AEIDASNIV	AEIDASNIV
AEQGVQKPAA	AEQGQKPAA
EEAPAQAKP	EEAPAQAKP
AEYDFRNDSV	AEYDRNDSV
EEEPLYVNA	EEEPLYVNA
NKGNEPPPPP	KGNEPPPPP
EENPEFAVA	EENPEFAVA
REMDQTMAA	REMDQTMAA
AELGKLYSV	AELGKLYSV
QETDPLPVV	QETDPLPVV
EENKIKVVA	EENKIKVVA
AEEDPPWAP	AEEDPPWAP
AEHNDLQYAA	AEHNLQYAA
AEQKDEMVP	AEQKDEMVP
QEGPVGPAP	QEGPVGPAP
AEQWRFSSA	AEQWRFSSA
SEEPETPAA	SEEPETPAA
SEAFHLIKA	SEAFHLIKA
QEQQAFKEA	QEQQAFKEA
SEIDMSVKA	SEIDMSVKA
AEAPNMAVV	AEAPNMAVV
AEIASSLPAA	AEIASLPAA
MELERIVSA	MELERIVSA
AESVVKLTA	AESVVKLTA
AENSAVPTA	AENSAVPTA
AEQRGENALKD	AEQRGENAL
SEEYPNKPP	SEEYPNKPP
QAESPLGIRP	AESPLGIRP
AEFIVAKA	AEFI-VAKA
AENPFLTHL	AENPFLTHL
AEEAPYDAI	AEEAPYDAI
EEERAFLVA	EEERAFLVA
AEAPDAPEA	AEAPDAPEA
MEEPAVPAP	MEEPAVPAP
EELEQTYHA	EELEQTYHA
KEDPFVFIP	KEDPFVFIP
QELLDVHAA	QELLDVHAA
AEIGEHVAP	AEIGEHVAP
GPELEAPGL	GPELEAPGL
AENYLGHTA	AENYLGHTA
AEQLWHQDQVA	AEQLHQDQV
IDVTKVNPL	IDVTKVNPL
AEEEAATRIPA	EEAATRIPA
AEHGIFLPP	AEHGIFLPP
AETSPAPIP	AETSPAPIP
EETPNILRI	EETPNILRI
AENNVFHLV	AENNVFHLV
HESGHAIIA	HESGHAIIA
EEVDISKDI	EEVDISKDI
KEATYGERVVA	KEATGERVV
AEQEYNATV	AEQEYNATV
QESPINVTT	QESPINVTT
REIFFPETA	REIFFPETA
EEAEILHSA	EEAEILHSA
MENRPSVQA	MENRPSVQA
AELSELHSA	AELSELHSA
AEEIPSRIQA	EEIPSRIQA
AERNSNLVGA	AERNNLVGA
EEEKAVAVP	EEEKAVAVP
HEYPWILSA	HEYPWILSA
SELPVSEVA	SELPVSEVA
AEYQAFREA	AEYQAFREA
AEESTAIIA	AEESTAIIA
AEGPPAMLP	AEGPPAMLP
AEAPSPAPTP	AEAPPAPTP
EEGSPTPVL	EEGSPTPVL
AEAQLHTTA	AEAQLHTTA
AEVDRQVIP	AEVDRQVIP
SENGALPVV	SENGALPVV
SEHKLSTDHIP	SEHKTDHIP
AEIEDVKPA	AEIEDVKPA
EERPLFPQI	EERPLFPQI
SEGTFGIHVA	SEGTGIHVA
MEENPGIFA	MEENPGIFA
EEDPQTSREIF	EEDPTSREI
QEYPDLIHI	QEYPDLIHI
HLPETKFSEL	LPETKFSEL
SEESARLVAA	SEESRLVAA
AENYDIPSA	AENYDIPSA
LAGPPFGAEAA	AGPPFGAEA
EENSHLTSV	EENSHLTSV
REMEENFAV	REMEENFAV
AESPGEVQA	AESPGEVQA
MEERYQIAA	MEERYQIAA
REILTELEA	REILTELEA
VEVPETPKA	VEVPETPKA
AEALREVSA	AEALREVSA
PEEIPDFAFY	EEIPDFAFY
AEELGQELKA	AEELQELKA
EHENLRTP	EHEN-LRTP
MEQPDAVPA	MEQPDAVPA
AERYDDMASA	AERYDMASA
SESPVITKA	SESPVITKA
LWAETNFPLAP	AETNFPLAP
AEEPPTPALP	AEEPPTPAL
EEEEPQPLP	EEEEPQPLP
SEEEAFGILP	EEEAFGILP
DEYVHITSA	DEYVHITSA
EEQVSGAKVIA	EEQVSGAKV
EEILFKERA	EEILFKERA
AEVETRIEA	AEVETRIEA
AEHVVQPKA	AEHVVQPKA
EEVEGHVA	EEVE-GHVA
SEALPSDIAA	SEALPSDIA
VEDVFREAA	VEDVFREAA
AEHPTIAKSV	AEHPTIAKS
AEQEPTAEQL	AEQETAEQL
AENDFSVSQA	AENDSVSQA
AEDPETQVV	AEDPETQVV
KVQALEEANND	KVQA-LEEA
LEMESKLAA	LEMESKLAA
AEHLMLLEA	AEHLMLLEA
RESPFSTSA	RESPFSTSA
QELPGLPLV	QELPGLPLV
AEKPLQVAA	AEKPLQVAA
AEHKEFITA	AEHKEFITA
AEQLTAPPSA	AEQLAPPSA
AETPGTVSP	AETPGTVSP
AEIAESVQA	AEIAESVQA
AEAFGKIVA	AEAFGKIVA
EEEEFLKLP	EEEEFLKLP
AENQRITAV	AENQRITAV
SEEVNIKTA	SEEVNIKTA
LDDSNKRKVL	LDDSNKRKV
QEALSALTA	QEALSALTA
EEIIDELKA	EEIIDELKA
REQTTGLAA	REQTTGLAA
EEENFYLEP	EEENFYLEP
AEHKYPTLP	AEHKYPTLP
AEAPSESKPAA	AEAPESKPA
FDPILVEKV	FDPILVEKV
AEHPVYNMV	AEHPVYNMV
TEVSKTPEA	TEVSKTPEA
NEATGGKYVP	NEATGKYVP
AEEFKVPAA	AEEFKVPAA
AEAMALGREA	AEAMLGREA
SESPWLHAP	SESPWLHAP
QEGSYFREA	QEGSYFREA
AEATGAYVP	AEATGAYVP
SEVATLTAA	SEVATLTAA
EEQIKVWTA	EEQIKVWTA
AERLGYPVL	AERLGYPVL
GEAPAALEA	GEAPAALEA
AEIDRRISA	AEIDRRISA
NEQQSVLQRIA	NEQQSVLQR
AEANLVGREA	AEANVGREA
VEDRGTVVA	VEDRGTVVA
KELEKTYSA	KELEKTYSA
VDHPDKFLEL	VDHPKFLEL
SEHPTLQAS	SEHPTLQAS
QEIEQKLEV	QEIEQKLEV
NEGVTNHTP	NEGVTNHTP
SEEFPVPPA	SEEFPVPPA
TEDLPFPPA	TEDLPFPPA
QETPLHLVA	QETPLHLVA
SESGIQMVP	SESGIQMVP
AEQEPTAEQLA	AEQETAEQL
RENKNVVVA	RENKNVVVA
QEQFNSIAA	QEQFNSIAA
AEQIARWIA	AEQIARWIA
AEAVLYEHLF	AEAVLYEHL
AEASASAAYKA	AEASAAYKA
SETGAGKHVP	SETGGKHVP
EESLNIVKYTA	EESLNIVKY
AEKYQTVIA	AEKYQTVIA
SETKVFTA	SETK-VFTA
EEEVQGPPA	EEEVQGPPA
AEELPHIHA	AEELPHIHA
REKETWQNV	REKETWQNV
EEYGPELHVA	EEYGELHVA
AEQSKVLSA	AEQSKVLSA
QEDSLNWVA	QEDSLNWVA
SAPSRATAL	SAPSRATAL
KEVDVGLAA	KEVDVGLAA
MEIEGEPAP	MEIEGEPAP
QEQAVSPKV	QEQAVSPKV
SEIDESVKLIP	SEIDESVKL
IAPTGHSL	IAPT-GHSL
SEHWLVLVP	SEHWLVLVP
QESKLIILA	QESKLIILA
AEEKSKPIP	AEEKSKPIP
KDILNMLNMI	KDILNMLNM
QEEPEARVP	QEEPEARVP
AENISSVVA	AENISSVVA
AEIDITNVA	AEIDITNVA
AEANNLAAVA	AEANNLAAV
EEHEWFIPA	EEHEWFIPA
NENETVFAP	NENETVFAP
MEAPHIIVG	MEAPHIIVG
AEGLMKVEA	AEGLMKVEA
AEISSKSPVA	AEISKSPVA
EEMPSVARP	EEMPSVARP
DEQVIQKAV	DEQVIQKAV
SEEPWTVLP	SEEPWTVLP
AEEAGFPEV	AEEAGFPEV
AEDEPPAPP	AEDEPPAPP
AELATRAIP	AELATRAIP
SEAFLGGHSVA	SEAFGGHSV
QEQAQTTDWRA	QEQAQTTDW
SEEQSRLAA	SEEQSRLAA
FDINSDNSNI	FDINDNSNI
AEDSGLHIIAA	AEDSLHIIA
AEIAKLKAA	AEIAKLKAA
EEMKGIAAV	EEMKGIAAV
SEQLDLPVRQA	SEQLPVRQA
EEGPGKNLP	EEGPGKNLP
AEQEYNATVA	AEQENATVA
MEEKYIVSA	MEEKYIVSA
QEQVTAAVA	QEQVTAAVA
HEEMNYITA	HEEMNYITA
MEDIKILIA	MEDIKILIA
EEQRLVQQA	EEQRLVQQA
MEKAFAFQA	MEKAFAFQA
FEVFVVFILI	FEVFVVFIL
SENMFSFEV	SENMFSFEV
VEPDHFKVA	VEPDHFKVA
QENDKLGTVA	QENDLGTVA
MEHPYFYTV	MEHPYFYTV
LERDPIPAA	LERDPIPAA
AEENGAIAA	AEENGAIAA
SEIEARIAA	SEIEARIAA
AETAVSVIP	AETAVSVIP
EEKVFRAV	EEKV-FRAV
AEAIKAWTA	AEAIKAWTA
EEEAKTVSA	EEEAKTVSA
EEQPKNYQV	EEQPKNYQV
EELRRVVAA	EELRRVVAA
QEQVMAVTA	QEQVMAVTA
AESLQPVAA	AESLQPVAA
EEEEVQGPPA	EEEVQGPPA
AEMPADSGYPA	AEMPSGYPA
AELYHIISS	AELYHIISS
NENKNIPKA	NENKNIPKA
KEAPAQPAP	KEAPAQPAP
AELQRLVAA	AELQRLVAA
TEARFPDVA	TEARFPDVA
EEAALLHEEA	EEAALHEEA
AEEERLKAA	AEEERLKAA
FDSLENSAF	FDSLENSAF
AETTVNVLV	AETTVNVLV
EERRYLQSA	EERRYLQSA
QESPGKVAA	QESPGKVAA
LDIPSLDSL	LDIPSLDSL
AEQLVKEGA	AEQLVKEGA
QETAVAMHVA	QETAAMHVA
PECTLFESL	PECTLFESL
AERRSVLDAA	AERRVLDAA
EEQALTKAA	EEQALTKAA
EETKYLRVA	EETKYLRVA
SEIEKLSAA	SEIEKLSAA
KENSHFFVA	KENSHFFVA
EETRRNFEA	EETRRNFEA
SEDEKQQYLP	SEDEQQYLP
QELPTQPEA	QELPTQPEA
QEELDTLFTTA	EELDLFTTA
AEAPSQKVTV	AEAPQKVTV
VETDHIVAA	VETDHIVAA
AEEANSPDVTA	EEANPDVTA
AEEGGFAVV	AEEGGFAVV
EEEGITFVP	EEEGITFVP
AENIPVHLP	AENIPVHLP
SEYEMSIAA	SEYEMSIAA
AEGIHNFAP	AEGIHNFAP
AEKFRNPKA	AEKFRNPKA
TEGSHFVEA	TEGSHFVEA
INTAVPLPAA	NTAVPLPAA
EEIEVDSRVA	EEIEDSRVA
AESADIARAEV	AESADIARA
VEEPSRPSA	VEEPSRPSA
TEENKSFSA	TEENKSFSA
QEQEIEHHLA	QEQEEHHLA
EEDPYLVVNP	EEDPLVVNP
EELPDIAPP	EELPDIAPP
QEAEAPGAVA	QEAEPGAVA
EEIQKKLEAA	EEIQKKLEA
SESEDRLVA	SESEDRLVA
SENPLTRSI	SENPLTRSI
HEQFIPIAA	HEQFIPIAA
AEHQSFLQA	AEHQSFLQA
SEAQPQPEV	SEAQPQPEV
EEDPVTSIP	EEDPVTSIP
AEAVAHFEA	AEAVAHFEA
EEEAATRIPA	EEAATRIPA
EEEYPGITA	EEEYPGITA
MEQGRVTIA	MEQGRVTIA
AEQPPHLTP	AEQPPHLTP
AEQTMSHLP	AEQTMSHLP
AEMPQNYRP	AEMPQNYRP
SEHGLVVIAP	SEHGLVVIA
EDAIKRVSKI	EDAIRVSKI
SEEEISFRA	SEEEISFRA
QEDSFSAEA	QEDSFSAEA
AEILNGKEISA	AEILNGKEI
SEISAAVERA	SEISAVERA
KEIEYVETVTS	KEIEYVETV
AGFAGDDAPR	AGFAGDDAP
VEQDFHLEIA	VEQDHLEIA
SEGNVVNKP	SEGNVVNKP
AEAPPPSVV	AEAPPPSVV
QEATHFPKV	QEATHFPKV
EEQASRQI	EEQA-SRQI
KDEAIILNGI	DEAIILNGI
AELLKTLAA	AELLKTLAA
LEQDHFQVA	LEQDHFQVA
AESKASLAA	AESKASLAA
TESPPSLAA	TESPPSLAA
AESPALVTP	AESPALVTP
QEKEAWIHA	QEKEAWIHA
EEQTPLHIA	EEQTPLHIA
AETKDIPAA	AETKDIPAA
AEGRPTPTIEW	AEGRPTPTI
MEQQPTRPP	MEQQPTRPP
KELIFQETA	KELIFQETA
QENTQTPTV	QENTQTPTV
AEYINEAAA	AEYINEAAA
AEIRAINEA	AEIRAINEA
GEKRFADAA	GEKRFADAA
QESGFSHSA	QESGFSHSA
EEEAFGILP	EEEAFGILP
AEHNAALQA	AEHNAALQA
MESNVELIA	MESNVELIA
AELRPDSPA	AELRPDSPA
AEKDGVKVP	AEKDGVKVP
EEEEAKTVSA	EEEAKTVSA
AEIRYEGILYT	AEIRYEGIL
AEAPPAYTP	AEAPPAYTP
AEEPNAAVP	AEEPNAAVP
SELELSAHNAA	SELESAHNA
AEKEPVPVP	AEKEPVPVP
AEKAFQEGIA	AEKAQEGIA
AEAASKWAA	AEAASKWAA
AEHFSIIRA	AEHFSIIRA
VEKPVGVAA	VEKPVGVAA
LESVPLPCQL	LESVLPCQL
AEEILEKGLKV	EEILKGLKV
REYALNVGTIA	REYALNVGT
SEEDRVVVIRF	SEEDRVVVI
SETSNWIAA	SETSNWIAA
AEQGKFALEVA	AEQGFALEV
SENPSVYVP	SENPSVYVP
AEAAAAVVAA	AEAAAAVVA
AEIEKFDKS	AEIEKFDKS
AEQLMTLISA	AEQLTLISA
QREEAAEVA	QREEAAEVA
MEDANVRVA	MEDANVRVA
GEIISRGKKV	GEIIRGKKV
AEAPTALVP	AEAPTALVP
SEQLHNVTA	SEQLHNVTA
AEAERWGVA	AEAERWGVA
SETSLIGTAA	SETSIGTAA
EELGGILKA	EELGGILKA
SEYLQQHVA	SEYLQQHVA
KEQTFYHVA	KEQTFYHVA
SEQIMKTGA	SEQIMKTGA
AEKGDVGLVA	AEKGVGLVA
SEIPKLPAV	SEIPKLPAV
SEGGKTPVA	SEGGKTPVA
SEEKPHVVA	SEEKPHVVA
SEKWKQNAP	SEKWKQNAP
EAVDKGFPP	EAVDKGFPP
EEETSIKAA	EEETSIKAA
AEDLSHVA	AEDL-SHVA
NERFFGDSA	NERFFGDSA
SEKPYILEA	SEKPYILEA
AEDLNTRVA	AEDLNTRVA
QEETFRLEA	QEETFRLEA
SEYSGFVNP	SEYSGFVNP
QELPRLLSA	QELPRLLSA
SELSRTYLP	SELSRTYLP
AEAPPGVET	AEAPPGVET
AEGPAVSLP	AEGPAVSLP
QEIVSSVVP	QEIVSSVVP
AEGKGFIA	AEGK-GFIA
AENGLLMTP	AENGLLMTP
VEQWPYRAVA	VEQWYRAVA
MEEGVSAVA	MEEGVSAVA
QEEWNEHNA	QEEWNEHNA
AEGGASRFSA	AEGGSRFSA
AEEEKMALP	AEEEKMALP
AEIDAHLVA	AEIDAHLVA
EPSSPPLAP	EPSSPPLAP
HEETGLKPP	HEETGLKPP
AEIRYEGILY	AEIRYEGIL
AEKAMTALA	AEKAMTALA
SEDFPRPLV	SEDFPRPLV
AEYDLTTRIA	AEYDTTRIA
AEQDRAYLEGL	AEQDRAYLE
MEEVGRWVA	MEEVGRWVA
AEIKDGERLP	AEIKGERLP
AERDLRDIEA	AERDRDIEA
AENALDVAA	AENALDVAA
SDRGKLLAA	SDRGKLLAA
REANFTVSS	REANFTVSS
AEEGTAKLIEF	AEEGTAKLI
AEEQPPFGVYA	EEQPFGVYA
SETQTSHLP	SETQTSHLP
AEEKFTIEP	AEEKFTIEP
AEQRFLAGA	AEQRFLAGA
EEEGTGVVHQA	EEGTVVHQA
EEEMKGIAA	EEEMKGIAA
EEFPAFPRA	EEFPAFPRA
SEAGPGPRP	SEAGPGPRP
AEAGPLASVPA	AEAGPLASV
GEHDKMVAA	GEHDKMVAA
AENVTFWKA	AENVTFWKA
AESGTPSLTAA	AESGPSLTA
SEHPLLSEP	SEHPLLSEP
FEQEMATAA	FEQEMATAA
MEHPGLQAI	MEHPGLQAI
MEQELAHAV	MEQELAHAV
RELPFTKSA	RELPFTKSA
SENQHLVSP	SENQHLVSP
QEEPGQLLP	QEEPGQLLP
GEQEPPPPP	GEQEPPPPP
EEAQHFIKA	EEAQHFIKA
TESSQSFVA	TESSQSFVA
AEAARILAA	AEAARILAA
QEENFRLEA	QEENFRLEA
AEVDAAMAA	AEVDAAMAA
AENQPFLIEA	AENQFLIEA
AEDFTIFKA	AEDFTIFKA
AEKIASIGQTA	AEKIIGQTA
AENAFNLFV	AENAFNLFV
AEMPDSAAA	AEMPDSAAA
AEQFRLEQI	AEQFRLEQI
AEQWKTNEA	AEQWKTNEA
SEMRYGIEILP	SEMRYGIEI
SENVKLFSA	SENVKLFSA
AEEALVDHVA	AEEAVDHVA
AEDPGPAVA	AEDPGPAVA
AEERIEGRVAA	AEEREGRVA
TAPTGHTL	TAPT-GHTL
NELPGLPRA	NELPGLPRA
AEDGEFTSA	AEDGEFTSA
AEARPFEVL	AEARPFEVL
QEDPAKRPSA	QEDPKRPSA
QENPNMRLS	QENPNMRLS
AEAHPELQA	AEAHPELQA
EEIKDFLLT	EEIKDFLLT
NELVLNFKEY	NELVNFKEY
AEAKENPLP	AEAKENPLP
SEADKIKVA	SEADKIKVA
SEEKAMDISA	SEEKMDISA
GETVPAPSA	GETVPAPSA
AEKSDFEAV	AEKSDFEAV
AEAFLRQQQA	AEAFRQQQA
QEVYAQVA	QEVY-AQVA
QEHPVVLLP	QEHPVVLLP
SELEKTQVA	SELEKTQVA
EEESKEPVA	EEESKEPVA
AEGKPPEAP	AEGKPPEAP
MENNLSRVIA	MENNSRVIA
LEEALQQAKED	LEEA-LQQA
EEAPAAMTA	EEAPAAMTA
SEEAPAAMTA	EEAPAAMTA
AEGPPTNPP	AEGPPTNPP
AEAIPEPVV	AEAIPEPVV
AEQVSHHPP	AEQVSHHPP
AEQQKAQFTA	AEQQAQFTA
EALIKHKP	EALI-KHKP
AEEQAAVVTA	AEEQAVVTA
QEIATVVVP	QEIATVVVP
EEAATRIPA	EEAATRIPA
DAAPPSAPP	DAAPPSAPP
SEAKPAAVAA	SEAKPAAVA
TDDEFKCII	TDDEFKCII
KEMEVSPSA	KEMEVSPSA
EEAWRGFAA	EEAWRGFAA
AEMVALVEQRA	AEMVALVEQ
TEAPPQPPP	TEAPPQPPP
EENKLIYTP	EENKLIYTP
AETLPEVEA	AETLPEVEA
AEEQFILSQVA	EEQFLSQVA
AEYAGLKVA	AEYAGLKVA
SELPGAFEA	SELPGAFEA
AEDLNLLIA	AEDLNLLIA
AEHNFVAKA	AEHNFVAKA
QEDAARLQA	QEDAARLQA
SEYEGILDA	SEYEGILDA
EEASPLHPA	EEASPLHPA
REIKFTVQA	REIKFTVQA
EEALVDHVA	EEALVDHVA
VESGDLQKEIA	SGDLQKEIA
AEHKHIEVIRM	AEHKHIEVI
EEFPSFGA	EEFP-SFGA
SEQRFPVA	SEQR-FPVA
REYWNEQSA	REYWNEQSA
SEDPKNNIP	SEDPKNNIP
SEAKPAAVA	SEAKPAAVA
SERPGLRGA	SERPGLRGA
AEVRVIAPP	AEVRVIAPP
AEVDKLRAA	AEVDKLRAA
SENAIGVAA	SENAIGVAA
EEHNFFLAP	EEHNFFLAP
HENEALWREVA	NEALWREVA
AEEAPKMVP	AEEAPKMVP
TEIGSIHSA	TEIGSIHSA
IDMIDNLNI	IDMIDNLNI
LEQEKAYQA	LEQEKAYQA
AESPGFSQA	AESPGFSQA
MEERAQLEA	MEERAQLEA
NEIGAIEKA	NEIGAIEKA
AEQLRVLQA	AEQLRVLQA
AESASFAAVVA	AESASFAAV
AEQAERYDDM	AEQAERYDD
EEVRAGAVSA	EEVRGAVSA
AEEAPQLMRT	EEAPQLMRT
EERAKYLAA	EERAKYLAA
SENPVPLTV	SENPVPLTV
AEAQVTPKP	AEAQVTPKP
MEMLVEHQA	MEMLVEHQA
REGITVIDV	REGITVIDV
SEQPPNSVLP	SEQPNSVLP
AEHPTIAKS	AEHPTIAKS
AELDEKISA	AELDEKISA
HHSVEAAGPP	VEAA---GP
EEIRKTFNI	EEIRKTFNI
AEEVLLGVHAA	EEVLGVHAA
AEVEPTPEA	AEVEPTPEA
ESLAGILGT	ESLAGILGT
SEITGLSTA	SEITGLSTA
AEQAFERISA	AEQAERISA
AEIPAGPGREP	AEIPPGREP
EEAQPMAAP	EEAQPMAAP
AESNKAFLA	AESNKAFLA
QELPGLPAP	QELPGLPAP
QEHPELAVL	QEHPELAVL
SEEQYNKIVIP	EEQYNKIVI
AEYGGWYKA	AEYGGWYKA
AEHSELKSP	AEHSELKSP
MEQSPDMHNA	MEQSDMHNA
SEQVTRWAA	SEQVTRWAA
MEIQTTQPAA	MEIQTQPAA
EEKERWIRA	EEKERWIRA
AEAAAAPTVAP	AEAAAPTVA
AETTTTFSP	AETTTTFSP
EEEHNFFLA	EEEHNFFLA
AEEYGARVV	AEEYGARVV
FENQDIHSA	FENQDIHSA
REAQSFISA	REAQSFISA
REEEEKLLHLA	EEEKLLHLA
AEEKDWKTA	AEEKDWKTA
QEAQKIFKA	QEAQKIFKA
LEDALQQAKED	LEDA-LQQA
AEMRQKEIP	AEMRQKEIP
AEVKQELAA	AEVKQELAA
EEEAATRIP	EEEAATRIP
AEYENLTNKL	AEYELTNKL
AENEQMLKP	AENEQMLKP
SEAFSVASA	SEAFSVASA
QEISHLIEP	QEISHLIEP
AEAEAFLKKA	AEAEFLKKA
AEHGSFRVT	AEHGSFRVT
SEAPSPVNA	SEAPSPVNA
EEISNLKAA	EEISNLKAA
EEEFFYEKA	EEEFFYEKA
NEQGNFPPP	NEQGNFPPP
REYMGFIQA	REYMGFIQA
TEMDAKTVTA	TEMDKTVTA
LEALPQIAA	LEALPQIAA
SEMRAPPAA	SEMRAPPAA
EEQSRLIAA	EEQSRLIAA
AEEIANYRP	AEEIANYRP
EEWGQLKAP	EEWGQLKAP
EEAFHQGLISA	EEAFGLISA
AERLQTDAA	AERLQTDAA
QEPDSPLPPA	QEPDPLPPA
RENEYLTLQVP	NEYLTLQVP
SEEEGVPST	SEEEGVPST
QEEDLKAQA	QEEDLKAQA
EEKNNWMAA	EEKNNWMAA
AEDDLNTVA	AEDDLNTVA
YEEAAMAIA	YEEAAMAIA
SEDDPILQI	SEDDPILQI
AEEAPYDAIHV	AEEAPYDAI
SEEAIKVIA	SEEAIKVIA
SENVYVNTA	SENVYVNTA
REAEFTKSIA	REAETKSIA
AEEFPNLAVA	AEEFNLAVA
AEEESRVLA	AEEESRVLA
SPSESTVVS	SPSESTVVS
SERDFFQEV	SERDFFQEV
EEMMELREA	EEMMELREA
LDVLSILKL	LDVLSILKL
AEQLSHSVA	AEQLSHSVA
AEIFHSADA	AEIFHSADA
AEVKGSVSA	AEVKGSVSA
QEATASKVIVA	QEATKVIVA
TEKRDFVSA	TEKRDFVSA
AEGVRVLGP	AEGVRVLGP
NEVADELVA	NEVADELVA
SEEAFVKES	SEEAFVKES
AEMNGKLIA	AEMNGKLIA
EEVQSLPLP	EEVQSLPLP
RELEVQHPA	RELEVQHPA
MEHNRVLEA	MEHNRVLEA
AEMYVAKFAA	AEMYAKFAA
SAPVGVTAL	SAPVGVTAL
SEAPPTNQATA	SEAPPTNQA
QEHIIIEAA	QEHIIIEAA
EELSHLEVA	EELSHLEVA
KEIENTYANVA	IENTYANVA
SETANYISA	SETANYISA
AEMAPYMKR	AEMAPYMKR
AEGKYMAEA	AEGKYMAEA
AEFAERSVA	AEFAERSVA
NAPWAVTSL	NAPWAVTSL
QEHGLKYPA	QEHGLKYPA
EEFDHLPPP	EEFDHLPPP
AEYGEIKNI	AEYGEIKNI
AGHSLELIEP	AGHSELIEP
QELEDNSNHL	QELENSNHL
QENEHIYNLW	QENEHIYNL
MEDAKVYVA	MEDAKVYVA
AEAEALARSA	AEAELARSA
EEEKRMLEA	EEEKRMLEA
AESETFLTS	AESETFLTS
HEMVVYEA	HEMV-VYEA
