Data	Data aligned
FPASPPKGYFL	FPASPPKGY
YPDPMVRGF	YPDPMVRGF
MPDHVIPEI	MPDHVIPEI
HALVGSPIIW	HALVGSIIW
FPDTGSDHSY	FPDTGSHSY
YPYNAPTVKF	YPYNAPVKF
APIASIHSF	APIASIHSF
NVFKNDQDTW	NVFKNDDTW
VPAHLQNSW	VPAHLQNSW
LPNAVITRI	LPNAVITRI
QPHVSSPRF	QPHVSSPRF
DPFRDLHSL	DPFRDLHSL
TPFLGQHGF	TPFLGQHGF
MPKKGGRWW	MPKKGGRWW
FPHLLQPVLW	FPHLLQVLW
VPAAVSHSEFW	VPAAVSSEF
MPADTNKAF	MPADTNKAF
SPSGRATVW	SPSGRATVW
MPSGEFARI	MPSGEFARI
EPEGEGQAW	EPEGEGQAW
RPLSKTVRF	RPLSKTVRF
HPNSNLLDL	HPNSNLLDL
LPAEYATHF	LPAEYATHF
LPIGDVATQYF	LPIGDVTQY
NPFPHSHTF	NPFPHSHTF
HPIKQVDVL	HPIKQVDVL
SADKLIKIW	SADKLIKIW
FPDRALSSW	FPDRALSSW
TALPLTQLRW	TALPLTLRW
HPFFSKIDW	HPFFSKIDW
FPTEAERQQW	FPTEAEQQW
MALEHLVVW	MALEHLVVW
HPDPDSSVKI	HPDPDSVKI
LPHQPLATY	LPHQPLATY
NPPEYEFLW	NPPEYEFLW
LPSDKALVL	LPSDKALVL
LPSPHPVRY	LPSPHPVRY
MPDVVVRSF	MPDVVVRSF
HPSDIEVDL	HPSDIEVDL
DAAQGYRY	DAAQG-YRY
DAGPPTHAF	DAGPPTHAF
VPEGQIILAKW	VPEGQIILA
QPMEVQEGY	QPMEVQEGY
SPAEFVTRF	SPAEFVTRF
FAVPDKVLW	FAVPDKVLW
HPVLSKDRNF	HPVLSKRNF
VPDLAPMLW	VPDLAPMLW
NPYHVVILF	NPYHVVILF
TVDPTKLTW	TVDPTKLTW
LPEEPITRW	LPEEPITRW
NPDPHFQGF	NPDPHFQGF
HAMEEVKKF	HAMEEVKKF
LPTEQEVRF	LPTEQEVRF
PIRLLAAAA	PIRLLAAAA
FPHPVNQVTF	FPHPVNVTF
YPLEVTKLIY	YPLEVTKLI
LPWNITVHF	LPWNITVHF
FPNKPPLTF	FPNKPPLTF
QAAEFREAW	QAAEFREAW
HPPNYIVLW	HPPNYIVLW
LPQEAEEERW	LPQEAEERW
NPNSGDFRF	NPNSGDFRF
LPHSGEAQL	LPHSGEAQL
MPFTTVSEL	MPFTTVSEL
YPGPGNHFW	YPGPGNHFW
LPIKDGKLVF	LPIKDGLVF
MPIRSLTF	MPIRS-LTF
TPHDFIEHI	TPHDFIEHI
YPDPRGAPW	YPDPRGAPW
TPEENQASW	TPEENQASW
YPFSSEQKW	YPFSSEQKW
IPSELFSSF	IPSELFSSF
IPRPDGIEW	IPRPDGIEW
TKEETTPPSAS	TPPSA----
EPGNFIPLF	EPGNFIPLF
MPHEKHYTL	MPHEKHYTL
NAAADRVKW	NAAADRVKW
HPTVVISAY	HPTVVISAY
HSYPGASGW	HSYPGASGW
DADSLQRAW	DADSLQRAW
TISPIILYF	TISPIILYF
MPTMRLLSF	MPTMRLLSF
YPLQDPKNLIL	YPLQDPKNL
HPSLIPLFV	HPSLIPLFV
YPSSDNSLY	YPSSDNSLY
EPTNVRYLW	EPTNVRYLW
SPDSGVYEM	SPDSGVYEM
LPSHLNISY	LPSHLNISY
LPYTNPSKF	LPYTNPSKF
HPESPSTGHYW	SPSTG-HYW
VPGLTFHW	VPGLT-FHW
EPQEDTRLW	EPQEDTRLW
FPHLTVVLL	FPHLTVVLL
HPERGIRQW	HPERGIRQW
LPDGSYEDW	LPDGSYEDW
ALAPILDDGW	LAPILDDGW
FPYPYAERL	FPYPYAERL
MPIQSHVI	MPIQS-HVI
LPTVGELW	LPTVG-ELW
IPMPGHPVNF	IPMPGHVNF
FPSSVAALRF	FPSSVALRF
HPFLTALKY	HPFLTALKY
LPNGPTAHF	LPNGPTAHF
VADSNIVRW	VADSNIVRW
FPEEVIATIF	FPEEVIATI
LREESEADQW	LREESEDQW
MPVGPDAILRY	MPVGPDAIL
IPAEFSGVW	IPAEFSGVW
TAVGEGLDRVW	AVGEGLRVW
LPNAVGPPFTW	LPNAVGPPF
YPMSSTIPHNF	MSSTIPHNF
YPTSKAVYI	YPTSKAVYI
MPGKELEW	MPGKE-LEW
LPADVQNYY	LPADVQNYY
LPTDTLQEL	LPTDTLQEL
FPSTTTPQI	FPSTTTPQI
HAADPIITRW	AADPIITRW
LPDQSFLWN	LPDQSFLWN
LPVGALATEQW	LPVGALEQW
GVAGPKGPAGE	VAGPKGPAG
FPLKVFGY	FPLKV-FGY
IPVSQISTI	IPVSQISTI
IPDKQYTDW	IPDKQYTDW
LPSDFEHTI	LPSDFEHTI
TVYPKPEEW	TVYPKPEEW
TQAPVVPYW	TQAPVVPYW
LPIGDVATQY	LPIGDVTQY
TAADDHQALIW	TAADDHQAL
LPGLTQVRW	LPGLTQVRW
HADTTKWEW	HADTTKWEW
YPYQERVFL	YPYQERVFL
FPSTAEHTL	FPSTAEHTL
EASAVTVRF	EASAVTVRF
FPPESNYLF	FPPESNYLF
SPITEYQFW	SPITEYQFW
FPAGIYDTKY	FPAGIYTKY
FADGHLILW	FADGHLILW
TVYTGIDHHW	TVYTGIHHW
MPEDVKNFYL	MPEDVKNFY
HPIEVSVGH	HPIEVSVGH
LPQGTSGQLW	LPQGTSQLW
YPYTETQMY	YPYTETQMY
LPSEHQTIL	LPSEHQTIL
NPMRVLLKI	NPMRVLLKI
LPNDGDEKY	LPNDGDEKY
FPLQPGKVATF	QPGKV-ATF
IPYQDRESY	IPYQDRESY
IPYTGPFNLL	IPYTGPFNL
FPYGDASKF	FPYGDASKF
TPQSLFILF	TPQSLFILF
HPNSLMKKI	HPNSLMKKI
HPDRSQPAF	HPDRSQPAF
TASPPTDLIW	TASPPTDLI
YPFKPPKVTF	YPFKPPVTF
IPYAGETLKW	IPYAGELKW
EAAAFDDEW	EAAAFDDEW
LPIDPNEPTY	LPIDPNPTY
QPAPISPHL	QPAPISPHL
TEKPEVID	TEKPE-VID
VPVGFGESW	VPVGFGESW
SPVDVLQIF	SPVDVLQIF
EAYPDHTQF	EAYPDHTQF
TPSDKLFFW	TPSDKLFFW
HPTAFVVSY	HPTAFVVSY
YPDRIMNTF	YPDRIMNTF
HPTADVQTF	HPTADVQTF
HPDKDVRLL	HPDKDVRLL
YPGPGNHF	YPGPG-NHF
FPFAVANQL	FPFAVANQL
IPAESYTFF	IPAESYTFF
SGPGPAAAL	SGPGPAAAL
HPEVTPLRF	HPEVTPLRF
LPELEPPTTL	LPELEPTTL
MVLENVKEMW	MVLENVEMW
HPITSIEYQW	HPITSIYQW
QAAERPQEW	QAAERPQEW
LPTGIPIVY	LPTGIPIVY
VGPPGRSSL	VGPPGRSSL
TAVPTLLKY	TAVPTLLKY
YPTKVDPFY	YPTKVDPFY
FPGKAFSW	FPGKA-FSW
FPIEYHDIW	FPIEYHDIW
NPIQGLASKW	NPIQGLSKW
NPLQEPFKNAW	LQEPFKNAW
LPGPSLDQW	LPGPSLDQW
YPASTVQIL	YPASTVQIL
NPQHVQLLF	NPQHVQLLF
HALVAGIDRY	HALVAGDRY
HGDSSVAVW	HGDSSVAVW
TVTEKPEVID	TVTEKPEVI
VPEEVEAHQSW	VPEEVEQSW
QPLEGSDLW	QPLEGSDLW
LPIEAVYHRY	LPIEAVHRY
FPDFPTPGVVF	FPTPG-VVF
IPEEILGKVSI	IPEEILGKV
MPMGSLEHEGL	MPMGSLHEG
YAEPAVLQW	YAEPAVLQW
FPLIEVNKVYY	FPLIEVKVY
HVGAFGELW	HVGAFGELW
AAPEGVPL	AAPEG-VPL
FPQTALVSF	FPQTALVSF
SASDDGTVRIW	SASDDGVRI
IPYPRPIHL	IPYPRPIHL
IPESLKSITW	IPESLKITW
FPVGRVHRL	FPVGRVHRL
HPISDHEATL	HPISDHATL
HPVSEYKAHF	HPVSEYAHF
LPFQFAHHL	LPFQFAHHL
HAATTSLSW	HAATTSLSW
HPVPVPADW	HPVPVPADW
MPMRLDDGW	MPMRLDDGW
NPNRHQMGW	NPNRHQMGW
YPNPYSKHVL	YPNPYSHVL
EPVELAQEF	EPVELAQEF
YPHEPTAVFNI	YPHEPTAVF
HPNAKVLLH	HPNAKVLLH
SPHEDMRTW	SPHEDMRTW
IAPTGHSL	IAPTG-HSL
YPWWEQQGF	YPWWEQQGF
LPDGSTIEI	LPDGSTIEI
FSLPAQPLW	FSLPAQPLW
SPDDQVYSF	SPDDQVYSF
NPADITVLF	NPADITVLF
HPLPGTQLL	HPLPGTQLL
NPDEQARQF	NPDEQARQF
LPFEPVPVI	LPFEPVPVI
YPNVGKSSF	YPNVGKSSF
HPHPEDIKF	HPHPEDIKF
HASSEQLYF	HASSEQLYF
NPADRAYSW	NPADRAYSW
HPMYGAGHKF	HPMYGAHKF
EAEGVIVGHW	EAEGVIGHW
LPIAPDLEHF	LPIAPDEHF
LPATPWGVW	LPATPWGVW
MPAPHTSITM	MPAPH-TSI
FPAVDPEKI	FPAVDPEKI
PHSAHQKY	PHSAH-QKY
YPVYQDYHTVW	YPVYQDHTV
FPQPPGAARW	FPQPPGARW
ELFEGVQKW	ELFEGVQKW
SAVVEDVAW	SAVVEDVAW
YPMTPAIEQRL	TPAIE-QRL
DLWLEREVF	DLWLEREVF
HARPEEPSW	HARPEEPSW
QPLESGTHF	QPLESGTHF
TAAPTGTTI	TAAPTGTTI
LPGPHYYTW	LPGPHYYTW
MPHANMNVHY	MPHANMVHY
RPAGDGTFQKW	PAGDGTQKW
HLPETKFSEL	LPETKFSEL
HPNDDDVHF	HPNDDDVHF
YPLEKGHLF	YPLEKGHLF
HPMAYQLQL	HPMAYQLQL
HPVDFLDAF	HPVDFLDAF
YSKYYKTID	YSKYYKTID
AASSISSPW	AASSISSPW
SPFDLEQQW	SPFDLEQQW
EATYINHNF	EATYINHNF
FPEQANNNEW	FPEQANNEW
TPSSDVLVF	TPSSDVLVF
MPSSDTTVTF	MPSSDTVTF
FPLATESNI	FPLATESNI
LPRDEADEL	LPRDEADEL
YGTEIISKW	YGTEIISKW
YPTSVPVLY	YPTSVPVLY
YPNEEKDAW	YPNEEKDAW
IPFISPKRW	IPFISPKRW
FPDPNVKYVF	FPDPNVYVF
IARREEEFDLF	IARRE-EEF
VPASTGLGW	VPASTGLGW
SPVRAFQW	SPVRA-FQW
LPADTQAW	LPADT-QAW
NVEGAAKLLW	NVEGAALLW
TPAEIREEF	TPAEIREEF
TALLQKLTW	TALLQKLTW
IPDTLQELF	IPDTLQELF
HPDTWNPAW	HPDTWNPAW
SAPVGVTAL	SAPVGVTAL
LPFGPTAYF	LPFGPTAYF
TVIEKTESW	TVIEKTESW
VPAESHIY	VPAES-HIY
LPDLSGPHSY	LPDLSGHSY
TPLQNNLHELW	TPLQNNHEL
TADGNTWMW	TADGNTWMW
LPEAHQRTW	LPEAHQRTW
SLVNLGGSK	SLVNLGGSK
FPEEDKKTY	FPEEDKKTY
SPEELLLRW	SPEELLLRW
NAGDRADFW	NAGDRADFW
SPYPEVDHF	SPYPEVDHF
SVTEIQEKW	SVTEIQEKW
SPTEVVERL	SPTEVVERL
FPFHEVIQEF	FPFHEVQEF
YPSETFTRV	YPSETFTRV
QASDGIHHW	QASDGIHHW
TAAPVVPEL	TAAPVVPEL
HAGPIVSVW	HAGPIVSVW
YPVEHPDKF	YPVEHPDKF
EADGLSTNHW	EADGLSNHW
LPLPSNTPTF	LPLPSNPTF
LPSDVQTAI	LPSDVQTAI
MPDDYGAPRF	MPDDYGPRF
RPAPIQAMW	RPAPIQAMW
LPHGGEGW	LPHGG-EGW
MADHLANSW	MADHLANSW
FPEELTQTF	FPEELTQTF
LPRTDYSF	LPRTD-YSF
LPDLDSENW	LPDLDSENW
NPISNNSQTF	NPISNNQTF
HADGTIVRY	HADGTIVRY
ITTTINPRF	ITTTINPRF
LPAGINSIVAI	LPAGI-NSI
SPEQTVPYLW	SPEQTVYLW
LPVALQTRL	LPVALQTRL
YPFHKQPPTY	YPFHKQPTY
IPYSPDVQI	IPYSPDVQI
MATESILHF	MATESILHF
FPHDNVEDLI	FPHDNVDLI
NPIEQDQKW	NPIEQDQKW
LPALFTDLY	LPALFTDLY
HADINLLYW	HADINLLYW
YPNTLLRTW	YPNTLLRTW
APSADAPMF	APSADAPMF
LPFEVLQHI	LPFEVLQHI
MPEPTVLSL	MPEPTVLSL
DAFQHMQHF	DAFQHMQHF
EASPSSLHF	EASPSSLHF
FPVGPGTGF	FPVGPGTGF
IPSAEVEKW	IPSAEVEKW
VPEEQEHMRRW	VPEEQ-EHM
LPNNRELYI	LPNNRELYI
FPHGDLTEF	FPHGDLTEF
MPLNVADLI	MPLNVADLI
HPVSLEQYL	HPVSLEQYL
YPVNTPERW	YPVNTPERW
NAGPPSHII	NAGPPSHII
LPAEFFEVL	LPAEFFEVL
NVKVDPEIQ	NVKVDPEIQ
IADEDRGNW	IADEDRGNW
FPVEIKSFY	FPVEIKSFY
FPSEYVPTVF	FPSEYVTVF
QAADTVVIF	QAADTVVIF
DAYPEIEKF	DAYPEIEKF
MPSVKVSVF	MPSVKVSVF
LPVQAPANDSW	LPVQAPDSW
LREDGALSI	LREDGALSI
YPNKLDTITW	YPNKLDITW
MPAPPPKENAW	APPPKENAW
DAHVDSTTY	DAHVDSTTY
VPHSIINGY	VPHSIINGY
YPHEAPSW	YPHEA-PSW
TAATAGIIGW	AATAGIIGW
MPHHTPHQL	MPHHTPHQL
SPVLFQEALW	SPVLFQALW
TPSAEPSTSW	TPSAEPTSW
SPTEMVAKF	SPTEMVAKF
HPHGSYSRL	HPHGSYSRL
QASSKILKY	QASSKILKY
LPSEQQEQW	LPSEQQEQW
MPVSKPTSW	MPVSKPTSW
GPGGPGGGGQR	GPGGPGGGG
PDDHARKI	PDDHA-RKI
IAAQTGTRW	IAAQTGTRW
FPLEAITAF	FPLEAITAF
APAAGYHVW	APAAGYHVW
MPVFPDFKM	MPVFPDFKM
TALLAEGITW	TALLAEITW
SPVAQSQEF	SPVAQSQEF
IPNENEAQF	IPNENEAQF
IPFQAGLPRW	IPFQAGPRW
NPDSAQPYKW	NPDSAQYKW
LPHSVNSKL	LPHSVNSKL
IPYSEPMPLSF	YSEPMPLSF
LPDVSLQEF	LPDVSLQEF
SPHPTSNHW	SPHPTSNHW
LPGSSHSF	LPGSS-HSF
VPEASRPHQW	VPEASRHQW
HPFEAQTLI	HPFEAQTLI
SPLTSYRW	SPLTS-YRW
HAYEGVPNGGW	HAYEGVPNG
SADHLIILW	SADHLIILW
TPIEERGDLF	TPIEERDLF
MPLHVAPLL	MPLHVAPLL
NADPASHEIW	NADPASHEI
FPVSEQRLW	FPVSEQRLW
IPTEQVNEL	IPTEQVNEL
LPEGEDLNEW	LPEGEDNEW
LPDPIIIHL	LPDPIIIHL
EAEPQGAAW	EAEPQGAAW
FPAPGKTVTL	FPAPGKVTL
MPTKETTKL	MPTKETTKL
SPYGHLPNW	SPYGHLPNW
LPFIPPQRW	LPFIPPQRW
FPTISLEF	FPTIS-LEF
HAIPLRSSW	HAIPLRSSW
GPAAIREGW	GPAAIREGW
TASEMILVL	TASEMILVL
FPQDQIRLW	FPQDQIRLW
LPSSLYLKI	LPSSLYLKI
TEVTGHRW	TEVTG-HRW
IPAATTIAY	IPAATTIAY
YPFKPPKVAF	YPFKPPVAF
LPIAIINDRF	LPIAIIDRF
TPSPEEVQSW	TPSPEEQSW
TSVPDHVVW	TSVPDHVVW
VPVWIIHYY	VPVWIIHYY
LPVDIRQYL	LPVDIRQYL
LPYPFASEI	LPYPFASEI
FPQFEPQRY	FPQFEPQRY
NPAASSNHW	NPAASSNHW
FPYARDDLSLY	FPYARDLSL
IPSQLNVNF	IPSQLNVNF
LPLAHVLEL	LPLAHVLEL
WPHEDAAQF	WPHEDAAQF
HPFFKTINW	HPFFKTINW
QPWEEIKTSY	QPWEEITSY
HPEASIQAVF	HPEASIAVF
QASPSNTVW	QASPSNTVW
SAVDVHINM	SAVDVHINM
IPRIDYDRI	IPRIDYDRI
HPTSHVSLL	HPTSHVSLL
HPTTISPRY	HPTTISPRY
YPYEHSYGL	YPYEHSYGL
KPFQAVFKF	KPFQAVFKF
APLKLQMEF	APLKLQMEF
EPSTEAPRW	EPSTEAPRW
FPSPIRLEF	FPSPIRLEF
SASTTTLRY	SASTTTLRY
FPLSSPISKF	FPLSSPSKF
MPSSVPLRA	MPSSVPLRA
TASAVVQHM	TASAVVQHM
MVESSRHNW	MVESSRHNW
YPETLGRLLIL	YPETLGRLL
HPDESGSKF	HPDESGSKF
QATPTFHQW	QATPTFHQW
NPLAATHEF	NPLAATHEF
HAADVFEAY	HAADVFEAY
FPHSAHQKY	FPHSAHQKY
HPVSREWTL	HPVSREWTL
TPVKSELLW	TPVKSELLW
SSEDYIHRI	SSEDYIHRI
LPLQENVTI	LPLQENVTI
FPASIPITKF	FPASIPTKF
MPTEQAEGF	MPTEQAEGF
HANDQTVIF	HANDQTVIF
LPDEIYHVY	LPDEIYHVY
TGHADTTKW	TGHADTTKW
APANISNSTW	APANISSTW
HPHDLVILM	HPHDLVILM
NATGVAMLF	NATGVAMLF
HVVIVVQDW	HVVIVVQDW
EPVPASIPNYY	VPASIPNYY
NPDDVFREF	NPDDVFREF
SPFVEHILW	SPFVEHILW
QPITPGPSI	QPITPGPSI
SADKTVKLW	SADKTVKLW
YPFDSPQVMF	YPFDSPVMF
NVADVVIKF	NVADVVIKF
YPAESPDYF	YPAESPDYF
VANLTNLVW	VANLTNLVW
FPLLPQDVHLL	FPLLPQVHL
HPQYEVVEI	HPQYEVVEI
QPATPTRTI	QPATPTRTI
IPVAIRTQI	IPVAIRTQI
FPNNYVTKI	FPNNYVTKI
HPGTHTVLW	HPGTHTVLW
NPVDILTYVTW	NPVDI-LTY
FPSGSVHSF	FPSGSVHSF
NPTDISYVY	NPTDISYVY
HAQLSEVLW	HAQLSEVLW
VPSNLALKF	VPSNLALKF
RPIDHDLANW	RPIDHDANW
YAPKGSSL	YAPKG-SSL
SPHLDKTSW	SPHLDKTSW
PAASSFGSPG	AASSFGSPG
MPNENIPEL	MPNENIPEL
VPTPTAPLL	VPTPTAPLL
HPLGMAIFL	HPLGMAIFL
MPYNHQHKYFF	MPYNHQHKY
TAENVAKKW	TAENVAKKW
IPTEEKPYKW	IPTEEKYKW
FASTQPTHSW	FASTQPHSW
IPDASKLQF	IPDASKLQF
MPSSSHLF	MPSSS-HLF
SVPLAATSM	SVPLAATSM
HPYEVAEVI	HPYEVAEVI
MANDLKEVW	MANDLKEVW
VPVTTKEDAW	VPVTTKDAW
MPLGARILF	MPLGARILF
SALEKFFYF	SALEKFFYF
HPSASYNQL	HPSASYNQL
AADSAVRLW	AADSAVRLW
PSHTKIKY	PSHTK-IKY
NSSPVINHL	NSSPVINHL
TAIESGQHYW	TAIESGQHY
HAAVPTPGY	HAAVPTPGY
SVGPAEPTW	SVGPAEPTW
FPNTGARIMLF	FPNTGAIML
HPEEHIRIW	HPEEHIRIW
TPAPPTHAL	TPAPPTHAL
IPSRLPLLL	IPSRLPLLL
EAIEEVKNGGW	EAIEEVKNG
FPAKPGSLTL	FPAKPGLTL
FPESASDAIKF	FPESASDAI
NPTDIYPSKW	NPTDIYSKW
MPVDPNEPTY	MPVDPNPTY
VPISAHHRW	VPISAHHRW
EAWNEEGKAVW	AWNEEGAVW
LPDDISHGY	LPDDISHGY
HPIPGEYKF	HPIPGEYKF
MPALRPALLW	MPALRPLLW
EALPGPHYYTW	LPGPHYYTW
MPEPDAQRFF	MPEPDAQRF
HPFFKNDQW	HPFFKNDQW
LPNDKTLLY	LPNDKTLLY
HAAYNLLFF	HAAYNLLFF
FPSLQRLVY	FPSLQRLVY
TPYHVNLLL	TPYHVNLLL
IPHHIIVKF	IPHHIIVKF
NATTIANHW	NATTIANHW
MPLRDAAKL	MPLRDAAKL
FPNRVVFQEF	FPNRVVQEF
FPLTISERW	FPLTISERW
LPTYGVHYY	LPTYGVHYY
YPPPHQVFTW	YPPPHQFTW
FPGPIFHL	FPGPI-FHL
YPETLVNLI	YPETLVNLI
TPAGEFKW	TPAGE-FKW
GGLPERSVSL	LPERS-VSL
SALPLYNLY	SALPLYNLY
DPSGAYFAW	DPSGAYFAW
DPDEVARLW	DPDEVARLW
IPNFDVREI	IPNFDVREI
MPAAGGVLY	MPAAGGVLY
LPNGMKEERF	LPNGMKERF
FPYEESKEKF	FPYEESEKF
SAASPHYQEW	AASPHYQEW
YPVDLGDKF	YPVDLGDKF
SADGTIKLW	SADGTIKLW
FPVPGSGLVL	FPVPGSLVL
MPGEDLKF	MPGED-LKF
EADGGLKSW	EADGGLKSW
EAVSRILEEW	EAVSRIEEW
YPIEHGIVTNW	YPIEHGTNW
LPTEEPSVW	LPTEEPSVW
MPADIATLL	MPADIATLL
QARIEIESF	QARIEIESF
IPDQVIRVF	IPDQVIRVF
IPEKGLEPEHS	IPEKGLPEH
MPSGIKTNI	MPSGIKTNI
TPIYAGHSW	TPIYAGHSW
HPYQMEGLNW	HPYQMELNW
SATEVDSRW	SATEVDSRW
APAPPGPGTRW	APPGPGTRW
TPAEVSHRF	TPAEVSHRF
FPEHMANVEL	FPEHMAVEL
TWSALPVL	TWSAL-PVL
HPFTNKPTTF	HPFTNKTTF
IIISTPEKW	IIISTPEKW
VPIDLQKVDQF	VPIDLQDQF
SPFTGTTTI	SPFTGTTTI
FPDPQRQRKL	FPDPQRRKL
FPLREPGVNW	FPLREPVNW
HRGFSGLDGAK	RGFSGLDGA
LPQAQQPQW	LPQAQQPQW
TANGIALLW	TANGIALLW
LPGGPTLTF	LPGGPTLTF
TAGVDGHSW	TAGVDGHSW
LPDEKVELF	LPDEKVELF
FPWEKPTTL	FPWEKPTTL
QATELVHQL	QATELVHQL
TNIPFDVKW	TNIPFDVKW
MPVNKVVQSF	MPVNKVQSF
VPGPGGIW	VPGPG-GIW
FAYKDPEKNW	FAYKDPKNW
PSLTGSPWP	PSLTGSPWP
EALHASHGF	EALHASHGF
HPIIPEQSTF	HPIIPESTF
FPDPEPVRNL	FPDPEPRNL
SPVELQSLF	SPVELQSLF
YPDMESDIRSW	DMESDIRSW
NPQPMTPPW	NPQPMTPPW
LPNSIASRF	LPNSIASRF
HAAAPTSTL	HAAAPTSTL
HASRTMPLL	HASRTMPLL
EAVSHLLQDW	EAVSHLQDW
MAFLDSQTATF	FLDSQTATF
LVHAVQALW	LVHAVQALW
SPTQVVSQL	SPTQVVSQL
IANVAHTF	IANVA-HTF
FPEALARLLL	FPEALARLL
YPDSHQLFV	YPDSHQLFV
HPASPRGSSF	HPASPRSSF
MPVHAAVQM	MPVHAAVQM
SASPFQSAW	SASPFQSAW
KPTHVVVTL	KPTHVVVTL
IPHDVLPDW	IPHDVLPDW
IPIEGATEW	IPIEGATEW
FPWGDGNHTLF	FPWGDGHTL
YPPHPDYTW	YPPHPDYTW
HAIDGTNNW	HAIDGTNNW
MAAEPYETI	MAAEPYETI
APEPLIPFHQW	EPLIPFHQW
HPVYILKGGY	HPVYILGGY
MPDPTPFLL	MPDPTPFLL
IAMDLILKM	IAMDLILKM
TPGPAFKI	TPGPA-FKI
HPLEDRNTI	HPLEDRNTI
TAEEKAIVQQW	TAEEKAQQW
TASADPSIW	TASADPSIW
MPFQRAGVNF	MPFQRAVNF
MPNVKVAVF	MPNVKVAVF
SPEPGQRTF	SPEPGQRTF
MPTKTIEVL	MPTKTIEVL
SPIRGLPHW	SPIRGLPHW
QAESAAAVW	QAESAAAVW
LPYNHQHEYFF	LPYNHQHEY
EAINVEQAF	EAINVEQAF
FPQEGMHQM	FPQEGMHQM
FPEHRAAEI	FPEHRAAEI
SVPEAQSAL	SVPEAQSAL
VPLMSAHW	VPLMS-AHW
HPDPFANKSL	HPDPFAKSL
FPDVEKAEW	FPDVEKAEW
TPSTGMYHF	TPSTGMYHF
FPIEVRHYL	FPIEVRHYL
IPLHYLLSY	IPLHYLLSY
FPGPSKPF	FPGPS-KPF
TAHDDRGIRF	TAHDDRIRF
FPYADGPHQF	FPYADGHQF
TPSPSPHAW	TPSPSPHAW
IVWDEKKNQW	IVWDEKNQW
HPNNVVSVKY	HPNNVVVKY
SPNSISIMG	SPNSISIMG
LPVSQPKSW	LPVSQPKSW
RPTDVAISF	RPTDVAISF
LPFGKVTNI	LPFGKVTNI
LPSETIQTY	LPSETIQTY
HPFEDGAKLRI	HPFEDGAKL
MPSQSVETY	MPSQSVETY
LRPLLAAAA	LRPLLAAAA
TPIDSTGKF	TPIDSTGKF
HPGDQAYEF	HPGDQAYEF
SPYDGNETL	SPYDGNETL
HPYPTTKLMW	HPYPTTLMW
MPAGEIEQF	MPAGEIEQF
FPSADVRTW	FPSADVRTW
MPSSLAHRI	MPSSLAHRI
LPAGIVAVL	LPAGIVAVL
YPLSSKRW	YPLSS-KRW
TPVPSAEAFRW	TPVPSAEAF
HAGPVINTL	HAGPVINTL
FPNAIEHTL	FPNAIEHTL
LPEESGGRHL	LPEESGRHL
VPWEELHNRF	VPWEELNRF
LPVPDPILL	LPVPDPILL
LPLEEAYRF	LPLEEAYRF
QPMEVQEGYGF	QPMEVQEGY
LPAESNEKI	LPAESNEKI
YPMKSEKI	YPMKS-EKI
LPFLEASTL	LPFLEASTL
MPEVRGALF	MPEVRGALF
VPIEQKHEVW	VPIEQKEVW
LPSPSTPRF	LPSPSTPRF
IPFDPKFITY	IPFDPKITY
WPDDLQNHTF	WPDDLQHTF
HPATVFILF	HPATVFILF
MPNPSLAQVKI	NPSLAQVKI
NPINMVSKL	NPINMVSKL
DAYTHLETF	DAYTHLETF
MPTPVIKAF	MPTPVIKAF
LPFEGKVNL	LPFEGKVNL
IAPETRRSI	IAPETRRSI
YPFESAEAQLL	YPFESAAQL
LPDHPHFHW	LPDHPHFHW
EPVNLFQHL	EPVNLFQHL
FPEHYAPSVF	FPEHYASVF
DPDSHFPAW	DPDSHFPAW
LPEEEHEFF	LPEEEHEFF
LGELQMALEW	LGELQMLEW
DVGPTAEW	DVGPT-AEW
HPLDYELTY	HPLDYELTY
LPHHVHLTW	LPHHVHLTW
HPKYPDGKTF	HPKYPDKTF
FPQPEKESF	FPQPEKESF
HPYPHNHYM	HPYPHNHYM
VPSAVALVL	VPSAVALVL
YPAGFMDVI	YPAGFMDVI
YPNPEYDNW	YPNPEYDNW
HPIRIADGY	HPIRIADGY
TASPVAVSL	TASPVAVSL
LPDDSKDTW	LPDDSKDTW
FPNKQGYVL	FPNKQGYVL
NAPLVHATL	NAPLVHATL
HPWTHTERF	HPWTHTERF
MPNGTVQRF	MPNGTVQRF
YPHPDWIW	YPHPD-WIW
FPATPLLDY	FPATPLLDY
NSSAVLLQW	NSSAVLLQW
HPVSDHEATL	HPVSDHATL
GPQQDPRLYW	GPQQDPRLY
APFSKVITF	APFSKVITF
FPANNIVKF	FPANNIVKF
FPIIIHDEPTY	IIIHDEPTY
QATRTVPVF	QATRTVPVF
SPVALNVQY	SPVALNVQY
YPASDPRW	YPASD-PRW
APSPEEKEEW	APSPEEEEW
NPFGGRGLAW	NPFGGRLAW
HLAWVQEEW	HLAWVQEEW
APMHDLLLW	APMHDLLLW
DPDEVARRW	DPDEVARRW
TASDDATIKAW	TASDD-ATI
YPAAPLPGF	YPAAPLPGF
HPVDQANTL	HPVDQANTL
TPASAGHVW	TPASAGHVW
HAAPILYAVW	HAAPILAVW
IPFRPSIQF	IPFRPSIQF
YPDFAPQKF	YPDFAPQKF
SADNTVILW	SADNTVILW
SPTNISSLL	SPTNISSLL
TPLEDVGKQVW	TPLEDVQVW
APSDTVLMF	APSDTVLMF
HAAGFAYTY	HAAGFAYTY
SPAGAALLW	SPAGAALLW
EANSNAVRF	EANSNAVRF
RAGDPILTYF	RAGDPILTY
LPAAGKTTW	LPAAGKTTW
FPHTTPSM	FPHTT-PSM
LPAPPKIYF	LPAPPKIYF
QPEELIQKW	QPEELIQKW
LPSLPMTSW	LPSLPMTSW
EAFRKDMIRW	EAFRKDIRW
YPLQEVERF	YPLQEVERF
SPSANIPEHW	SPSANIEHW
IAHLFNVEW	IAHLFNVEW
SPFSASGGW	SPFSASGGW
IPGSVLLW	IPGSV-LLW
LPLLSVYQL	LPLLSVYQL
LPSGEVVKI	LPSGEVVKI
HPISSEELL	HPISSEELL
EPHSKPIKF	EPHSKPIKF
HAGPTAHEL	HAGPTAHEL
LPGKTYSF	LPGKT-YSF
HIDPNVDYQF	HIDPNVYQF
HPDEPLYSF	HPDEPLYSF
FPVEKQLDL	FPVEKQLDL
LPNHLAMMETL	LPNHLAETL
YPAAVPQAL	YPAAVPQAL
LPSHGRVQW	LPSHGRVQW
DASKVVTVF	DASKVVTVF
LPHTGYIY	LPHTG-YIY
TASDVAQHL	TASDVAQHL
APVKENIPYSW	APVKENIPY
YMDPTGKTRTW	DPTGKTRTW
FPVEVNTVL	FPVEVNTVL
TAHSEPSLW	TAHSEPSLW
YPSETTVKY	YPSETTVKY
FPPEANYLF	FPPEANYLF
YPENIVPSF	YPENIVPSF
NADGHGEVW	NADGHGEVW
HAEDSVMDHHF	HAEDSVHHF
LPVTPILEGF	LPVTPIEGF
QPETRVSYW	QPETRVSYW
PVGRVHRL	PVGRV-HRL
HAQDYVLTY	HAQDYVLTY
YPFTGDHKQKF	YPFTGDQKF
QAWEEPTNW	QAWEEPTNW
HTAPVLDIAW	TAPVLDIAW
LPLQTVQRL	LPLQTVQRL
LPDDKLTLF	LPDDKLTLF
QPVTPLGTSRW	TPLGT-SRW
EAISDLQQLW	EAISDLQLW
SPRQAEAERW	SPRQAEERW
LPASEGEVW	LPASEGEVW
NARMPEKVTW	MPEKV--TW
VPLPASAKW	VPLPASAKW
FPNSFNDKF	FPNSFNDKF
HADGSLNQW	HADGSLNQW
PVSSSAWLL	PVSSSAWLL
YPLDLLLKL	YPLDLLLKL
TAIQEIVVTHW	IQEIVVTHW
FPYGTTVTY	FPYGTTVTY
FPSEYVPTV	FPSEYVPTV
HPSGLSLHL	HPSGLSLHL
DPLSDYNVW	DPLSDYNVW
LPNNIVDVW	LPNNIVDVW
FPEEIQQQI	FPEEIQQQI
FPSEITDTV	FPSEITDTV
SPAQILLRW	SPAQILLRW
EPSESNMRW	EPSESNMRW
SVTEIQEK	SVTEI-QEK
FPEGSVELY	FPEGSVELY
HPDQTGTNQHF	HPDQTGQHF
HPLGDIVAF	HPLGDIVAF
IPFTGNVKL	IPFTGNVKL
AASPHYQEW	AASPHYQEW
LPVSHGAHF	LPVSHGAHF
IAAPDSRRW	IAAPDSRRW
RPNETDIKI	RPNETDIKI
HAAHIISEL	HAAHIISEL
LPLEPEQFL	LPLEPEQFL
EGNPDTHSW	EGNPDTHSW
IPDIKKDRW	IPDIKKDRW
LPEHNLITW	LPEHNLITW
LPDKGAQRL	LPDKGAQRL
MPHSSSAKL	MPHSSSAKL
LQWLLLLF	LQWLL-LLF
LPSGAVFVI	LPSGAVFVI
YPHEPTAVF	YPHEPTAVF
HAGVVPDLLW	HAGVVPLLW
IPYKDTFW	IPYKD-TFW
HPVNLTWPF	HPVNLTWPF
SADKTVALW	SADKTVALW
SPIDVVEKY	SPIDVVEKY
MPVQDLPRL	MPVQDLPRL
IPFEFPLHL	IPFEFPLHL
LPYAGDVSM	LPYAGDVSM
IPDIQAHEW	IPDIQAHEW
FPVGDVNNF	FPVGDVNNF
EPEGTATDRW	EPEGTADRW
VPFNIPLEF	VPFNIPLEF
SNPGGRPAL	SNPGGRPAL
HTNPVGTEW	HTNPVGTEW
VAADALGEEW	VAADALEEW
FAYKDQNENRW	FAYKDQNRW
NPEYTTVSW	NPEYTTVSW
YPQSVPRLFI	YPQSVPRLF
MPESGPSYEF	MPESGPYEF
AAPTSAAAL	AAPTSAAAL
TAAAVGAVF	TAAAVGAVF
TPSQGTHTF	TPSQGTHTF
IPDEVIKKW	IPDEVIKKW
MPAATDNRY	MPAATDNRY
TAVVEDVSW	TAVVEDVSW
FPMAKLLYL	FPMAKLLYL
QANDDARTF	QANDDARTF
EAYNPETDTW	EAYNPEDTW
DIMKDKDNFW	DIMKDKDNF
EALGDNVKQYW	LGDNVKQYW
MPHRISSHF	MPHRISSHF
QAAFLEERDAW	AAFLEEDAW
FPVKPHNKSF	FPVKPHKSF
YPYPPVPETF	YPYPPVETF
FAYDGKDYI	FAYDGKDYI
KPNGLILQY	KPNGLILQY
HAFEIIHLL	HAFEIIHLL
LPTGAAFRW	LPTGAAFRW
LPVALPARW	LPVALPARW
SAVASKEDSW	SAVASKDSW
IPLALEGKDLL	LALEGKDLL
VPSNAELW	VPSNA-ELW
TPTENELKF	TPTENELKF
SPHFKVFKW	SPHFKVFKW
TAEGQATLERL	TAEGQ-ATL
YPLEDHTEF	YPLEDHTEF
DPLNMHVTW	DPLNMHVTW
TPSPSADLL	TPSPSADLL
LPISKIDQW	LPISKIDQW
HPTSVISGY	HPTSVISGY
TAWDEADVRF	TAWDEAVRF
GDTLLIENI	GDTLLIENI
RVYIHPFHL	RVYIHPFHL
MPQELIEASNW	MPQELISNW
GPVEVISHW	GPVEVISHW
SPAPVPVTY	SPAPVPVTY
YGTLTSFDIHI	TLTSFDIHI
YPVPDVSTY	YPVPDVSTY
FPAAPAPKM	FPAAPAPKM
QPEESYSHW	QPEESYSHW
MPLEEGDTF	MPLEEGDTF
TVTEVLLKY	TVTEVLLKY
LPNELIELL	LPNELIELL
LPSSNYSNI	LPSSNYSNI
MAAAGNYAW	MAAAGNYAW
SPTIIFDNW	SPTIIFDNW
LPSDVVTGY	LPSDVVTGY
HPSHVQPAY	HPSHVQPAY
ISPTGHSL	ISPTG-HSL
FPAPEERIKW	FPAPEEIKW
VNLPINGNGKQ	LPINGNGKQ
LPLLSPVTF	LPLLSPVTF
HPFLYDRETY	HPFLYDETY
LPSLADFSP	LPSLADFSP
FPYPFQVVY	FPYPFQVVY
HAVPIYEGF	HAVPIYEGF
LPFPDETHERY	FPDETHERY
LPSHVAVDVW	LPSHVADVW
TPHGLFILF	TPHGLFILF
DPYADGDPAW	DPYADGPAW
DPSGNAHKW	DPSGNAHKW
NPISTVTEL	NPISTVTEL
IPLPLGTVTI	IPLPLGVTI
SAPSSDKPL	SAPSSDKPL
TPLPREVLHKW	LPREVLHKW
LPIDDVLRI	LPIDDVLRI
TAAPTGTTIKF	APTGTTIKF
LPIQARLGSI	LPIQARGSI
TGYAETYRW	TGYAETYRW
HPTLGPKITY	HPTLGPITY
DAFNVPVFW	DAFNVPVFW
EPSDLIVKI	EPSDLIVKI
EAIKQASEW	EAIKQASEW
HVSLVQLTL	HVSLVQLTL
MPDSGRPAF	MPDSGRPAF
EAFRGVHRY	EAFRGVHRY
SAYDSKADIW	SAYDSKDIW
FPDKPITQY	FPDKPITQY
MPVSSQHRY	MPVSSQHRY
SATEVTGHRW	SATEVTHRW
HPQEVYNEY	HPQEVYNEY
FPFDVAVKF	FPFDVAVKF
YADVGGKQF	YADVGGKQF
MPQGGGQHY	MPQGGGQHY
DASALRILF	DASALRILF
TAIATEQQSW	TAIATEQSW
TPDPSTPSRL	TPDPSTSRL
FPSEDILLV	FPSEDILLV
FPDPNVKYV	FPDPNVKYV
TPEKEPPLW	TPEKEPPLW
SASPDATIRIW	SPDATIRIW
YPLDLEGGSEY	YPLDLESEY
VPDPNKPQKL	VPDPNKQKL
YPGPAVVL	YPGPA-VVL
MPHSTSRW	MPHST-SRW
QALELPLRI	QALELPLRI
FVILRDEKW	FVILRDEKW
HPETRSAFL	HPETRSAFL
DPSGTYHAW	DPSGTYHAW
WPFLIDKRW	WPFLIDKRW
FPAGTNSRW	FPAGTNSRW
FPEDVVRVIF	FPEDVVRVI
LPSSTKSGW	LPSSTKSGW
HAIIDEQPLIF	HAIIDEPLI
IPSSWRLLF	IPSSWRLLF
YPAPAGLHI	YPAPAGLHI
FPFNPLDFESF	NPLDF-ESF
YPAPGLKTF	YPAPGLKTF
LPAPGVPAW	LPAPGVPAW
MPQKERESI	MPQKERESI
LPIPESQVITI	LPIPESQVI
FPFKEPEKRTI	FPFKEPEKR
FPNAIEHTLQW	FPNAIEHTL
SPFPSSIPHAF	FPSSIPHAF
HAADLSLWW	HAADLSLWW
IPSSKLLFL	IPSSKLLFL
LPHITDVSW	LPHITDVSW
LPYRATENDIY	LPYRATNDI
IPIEPDYKF	IPIEPDYKF
GADPGNKKW	GADPGNKKW
IPAESYTF	IPAES-YTF
YPFKPPKITF	YPFKPPITF
FPDEDSYQKF	FPDEDSQKF
YPMENGIVRNW	MENGIVRNW
YPLEKIGFW	YPLEKIGFW
RPVPKGATY	RPVPKGATY
HVAPVTSVEW	HVAPVTVEW
IPSSVPATF	IPSSVPATF
YARDETEFY	YARDETEFY
LPVEEFNEL	LPVEEFNEL
PYNHQHEY	PYNHQ-HEY
YPFYKTDPF	YPFYKTDPF
YAEPAVLKW	YAEPAVLKW
MVDHNIYVW	MVDHNIYVW
HPYPFSGIFEI	YPFSGIFEI
SPTENSFTL	SPTENSFTL
HPYIYRVTF	HPYIYRVTF
TASRDDRSTW	TASRDDSTW
HPLPRVKAETY	LPRVKAETY
HVSRIPDYLW	HVSRIPYLW
HPHVYSPVI	HPHVYSPVI
LPNQTVLKI	LPNQTVLKI
LPSSSPEHL	LPSSSPEHL
HPHIFPYLL	HPHIFPYLL
NPLPSKETI	NPLPSKETI
SPSRILLLF	SPSRILLLF
LPEELVHAGW	LPEELVAGW
YPEGKLPHW	YPEGKLPHW
FPEEDDPTNW	FPEEDDTNW
FASHLGDQTW	FASHLGQTW
MPNQIVQIL	MPNQIVQIL
MPALFSDHTF	MPALFSHTF
HPVSALMEI	HPVSALMEI
AAPATRAAL	AAPATRAAL
LPEDKPRLI	LPEDKPRLI
MPFAPAIQTF	MPFAPAQTF
RPLQDLQLW	RPLQDLQLW
VLFPEPLTW	VLFPEPLTW
FPHHVIPDSF	FPHHVIDSF
YPLEDATHI	YPLEDATHI
YVLGTATRW	YVLGTATRW
LPYPFTHHW	LPYPFTHHW
LPSGAILSL	LPSGAILSL
MARYEREQY	MARYEREQY
HAYPDFAPQKF	YPDFAPQKF
EPVNSSKW	EPVNS-SKW
TAIEAQHLL	TAIEAQHLL
SAPYGRITL	SAPYGRITL
LPWVGKELY	LPWVGKELY
APLEDEATL	APLEDEATL
TPIREQHVL	TPIREQHVL
HAHVDKVTY	HAHVDKVTY
IPASKVSKW	IPASKVSKW
NPYEFALKF	NPYEFALKF
TPTSVIPKL	TPTSVIPKL
MPIPGGNQRF	MPIPGGQRF
VPRKAEERW	VPRKAEERW
VPRNPTIGDKF	NPTIG-DKF
VPAATPAPRG	VPAATPPRG
SPEVPLPGMKW	VPLPG-MKW
QARVEELERW	ARVEELERW
SPDHTNNSF	SPDHTNNSF
GPFETVHRW	GPFETVHRW
IAANEENRKW	AANEENRKW
FPSEVVGKM	FPSEVVGKM
TAYSEKHHW	TAYSEKHHW
VPVQVDGEAW	VPVQVDEAW
APEEHPVLL	APEEHPVLL
IPYHSEVPVSL	YHSEVPVSL
FPDVPDKENF	FPDVPDENF
HPQIMSPLAKW	QIMSPLAKW
HPTLIQRTY	HPTLIQRTY
SPMEIPKELW	SPMEIPELW
ISPSRTEAL	ISPSRTEAL
NPTSVFSRI	NPTSVFSRI
FPWGDGNHTL	FPWGDGHTL
IPNEIIHAL	IPNEIIHAL
NAFEELVAF	NAFEELVAF
TPGSSQNPW	TPGSSQNPW
QPFGDTGGFHF	QPFGDTGGF
LPDGPAGSW	LPDGPAGSW
NANRIALDF	NANRIALDF
TADPGATMTF	TADPGAMTF
MPEKLSHKL	MPEKLSHKL
LPIDESNTI	LPIDESNTI
YPVEIHEYL	YPVEIHEYL
HPIEGSTTVF	HPIEGSTVF
WPNAEVDRF	WPNAEVDRF
SPNELILGW	SPNELILGW
QADTTRLEL	QADTTRLEL
VVPEPGQPL	VVPEPGQPL
HASTSWYW	HASTS-WYW
KAPSAARSL	KAPSAARSL
LPLNSVYVY	LPLNSVYVY
AQAAATAAAMA	QAAATAAAM
VPTQESVKW	VPTQESVKW
FPANVMDVI	FPANVMDVI
FPAAIEHTIQW	FPAAIEHTI
LPFPNPERNF	LPFPNPRNF
HPDPNWKNF	HPDPNWKNF
MPIREGDTVTL	MPIREGDTV
TAADTVIIY	TAADTVIIY
TVHQGDTSW	TVHQGDTSW
HPTIISESF	HPTIISESF
HPIDGFLQSL	HPIDGFQSL
VPEKGSGDKW	VPEKGSDKW
NPVPDGHSRW	NPVPDGSRW
EAASVPVVY	EAASVPVVY
HAYLHDQFW	HAYLHDQFW
LPGAGKTTW	LPGAGKTTW
FPEYTHQLF	FPEYTHQLF
HPGVFRGDKW	HPGVFRDKW
HPEPLAGRHF	HPEPLARHF
FPQTFAGPII	FPQTFAPII
MPYLEHESF	MPYLEHESF
LPLHVLPLY	LPLHVLPLY
DPHQQIYTF	DPHQQIYTF
DFFRDPLNW	DFFRDPLNW
YPNVNIHNF	YPNVNIHNF
LPVDSSHGF	LPVDSSHGF
MPDDHARKI	MPDDHARKI
SPHSNVSDW	SPHSNVSDW
SAAPLFFSW	SAAPLFFSW
SAPSRATAL	SAPSRATAL
YPDSNGMPVW	YPDSNGPVW
MPAEQAFW	MPAEQ-AFW
DPSGNYGGW	DPSGNYGGW
LPSDHSVKY	LPSDHSVKY
HPSSVPGPDF	HPSSVPPDF
YPQEVIPTF	YPQEVIPTF
TPSAVFRVW	TPSAVFRVW
TPSENSDLF	TPSENSDLF
FPTESTWRW	FPTESTWRW
YPHDGKIFF	YPHDGKIFF
HAVEGAEQW	HAVEGAEQW
MPAPEIVSY	MPAPEIVSY
AANPIESQW	AANPIESQW
NPYPGDVTKF	NPYPGDTKF
NPINTFTKF	NPINTFTKF
WPLAVRKW	WPLAV-RKW
MPPQDAFTTQW	PPQDAFTQW
HAANIVTAI	HAANIVTAI
HADHSSLTL	HADHSSLTL
HPETWQPSW	HPETWQPSW
MPHDLITQL	MPHDLITQL
APLSLAEGW	APLSLAEGW
SPDGSFLLI	SPDGSFLLI
FPNIHPPQI	FPNIHPPQI
SPANSFHF	SPANS-FHF
VAPRSGLAA	VAPRSGLAA
KPFIDREWW	KPFIDREWW
HPYQPDPKM	HPYQPDPKM
APINSKSDEW	APINSKDEW
DPIPAAHSF	DPIPAAHSF
FPIPGEPGF	FPIPGEPGF
SPFDEFNLW	SPFDEFNLW
LPLLRTVLW	LPLLRTVLW
LATASSPKF	LATASSPKF
SPIQFESAW	SPIQFESAW
TAAETHYTY	TAAETHYTY
YPDSSQSRF	YPDSSQSRF
MPAVKAIIY	MPAVKAIIY
HPMRAIFMI	HPMRAIFMI
MPEDGQVNI	MPEDGQVNI
FPFKHPDEW	FPFKHPDEW
MPVNTNQNF	MPVNTNQNF
YPNGVVVHY	YPNGVVVHY
LPSHTKIKY	LPSHTKIKY
VPTTEVNAW	VPTTEVNAW
SPNALVLLI	SPNALVLLI
HASHGFMW	HASHG-FMW
FPFPETPTKV	FPFPETTKV
EPSAVALEL	EPSAVALEL
EPEGTSHEF	EPEGTSHEF
YVHPVNLTW	YVHPVNLTW
TAQSDNKITW	TAQSDNITW
IPTRVITNF	IPTRVITNF
LPSPAHHLW	LPSPAHHLW
MPNSASRDEF	MPNSASDEF
HAASESLKF	HAASESLKF
YPETLGRLLI	YPETLGRLL
FPHHVSPGF	FPHHVSPGF
AGPLRKSSL	AGPLRKSSL
HPYQFLLKY	HPYQFLLKY
FPFFDIAHY	FPFFDIAHY
LPPGAEHW	LPPGA-EHW
QPDPDAIKMF	QPDPDAIKM
AAQDFFQRW	AAQDFFQRW
IPEPEAAVLF	IPEPEAVLF
LPNSTERAITI	LPNSTERAI
HAMGGVPAW	HAMGGVPAW
TPAHVYYRW	TPAHVYYRW
HAATIRLIF	HAATIRLIF
FPAGKVPAF	FPAGKVPAF
LPSEMQTRI	LPSEMQTRI
VPVDLQHQF	VPVDLQHQF
SPFHPATHW	SPFHPATHW
EPDPHVVRI	EPDPHVVRI
TPLEGDFAW	TPLEGDFAW
IPLAPISKSLW	LAPISKSLW
LPFPIIQQY	LPFPIIQQY
SPLDIYPKI	SPLDIYPKI
TASGAKSMW	TASGAKSMW
IPEEELTDNW	IPEEELDNW
FPAVGEPNI	FPAVGEPNI
HPSESLEKM	HPSESLEKM
TAVKIAPRY	TAVKIAPRY
FVGPVVGGW	FVGPVVGGW
HPDGKILII	HPDGKILII
VAPVASAL	VAPVA-SAL
DPSQPQQW	DPSQP-QQW
IPEGYVPEHW	IPEGYVEHW
HAVGPEAHTI	HAVGPEHTI
FPEPEHSSF	FPEPEHSSF
QPEAELGRLLF	EAELGRLLF
NALNQVVLW	NALNQVVLW
SPLNTHAAELW	SPLNTHAEL
SASSLTSKW	SASSLTSKW
SPSPGGDAAW	SPSPGGAAW
NASDLPLSI	NASDLPLSI
SPAEETVVW	SPAEETVVW
MVLDIVQHW	MVLDIVQHW
FPSAKDPTW	FPSAKDPTW
LPDQSFLW	LPDQS-FLW
IPHTDPVDYEF	IPHTDPVDY
SPFEFGFTF	SPFEFGFTF
SAARLYYYW	SAARLYYYW
DPDKDVQGW	DPDKDVQGW
LPNGLDVTF	LPNGLDVTF
LVNNTPLNW	LVNNTPLNW
IPAAVKLTY	IPAAVKLTY
MPVGMTHGL	MPVGMTHGL
HPAPFSKVITF	APFSKVITF
LPALEPSTRYW	LPALEPTRY
VPAEPKLAF	VPAEPKLAF
HPTDVDYRV	HPTDVDYRV
HPLGIVQGF	HPLGIVQGF
SVTEVQLRF	SVTEVQLRF
LPAEHQFSF	LPAEHQFSF
TPSPIIQQL	TPSPIIQQL
QPAPPEKVGW	QPAPPEVGW
MPLQLLLLL	MPLQLLLLL
MTNGFHMTW	MTNGFHMTW
YPLKPTWW	YPLKP-TWW
HAIEESVVLI	HAIEESVVL
MPQGNPLLL	MPQGNPLLL
HVSGAVLTF	HVSGAVLTF
ITPTGTHPL	ITPTGTHPL
YPLDPTTEHIY	YPLDPTEHI
MAIEAQQKF	MAIEAQQKF
TASPTHSTW	TASPTHSTW
HALESSFVGW	HALESSVGW
AAAAATAAW	AAAAATAAW
HVFSDGVTNW	HVFSDGTNW
HVATEPVATW	VATEPVATW
TASQVASTW	TASQVASTW
HPFEDGAKL	HPFEDGAKL
LVSDLQQVW	LVSDLQQVW
YPSRVFVGDTF	YPSRVFDTF
VPNMQDKTEW	VPNMQDTEW
HVGPILVGW	HVGPILVGW
YPTEKGLSF	YPTEKGLSF
LPDTLKVTY	LPDTLKVTY
EAIRISPTF	EAIRISPTF
HPSNVLHFF	HPSNVLHFF
FPFEKGSVQY	FPFEKGVQY
HPVVDRSIKI	HPVVDRIKI
MPEQWARLL	MPEQWARLL
VPVPGESTW	VPVPGESTW
HPDTIYSVDW	HPDTIYVDW
VAPVTHVSV	VAPVTHVSV
DPHKADLVW	DPHKADLVW
HPSQTVELF	HPSQTVELF
NADHTTLLL	NADHTTLLL
SPLDSIHTI	SPLDSIHTI
SAANIQPIF	SAANIQPIF
LPIDGANDLF	LPIDGADLF
LPYRRSVPTW	LPYRRSPTW
APIPTVEEKW	APIPTVEKW
DALPEYSTF	DALPEYSTF
MPRPDKNHQW	MPRPDKHQW
FVIPLDPRW	FVIPLDPRW
TAAPSLKNAAF	APSLKNAAF
VPATDPHSW	VPATDPHSW
VPVEEQEEF	VPVEEQEEF
VPFSIFDEF	VPFSIFDEF
SAFPYAHRF	SAFPYAHRF
LPSSEVVKF	LPSSEVVKF
KAPAPRPSL	KAPAPRPSL
VPTELALLY	VPTELALLY
APNEMVYRF	APNEMVYRF
FPFGYVSNI	FPFGYVSNI
MPHNQFIKM	MPHNQFIKM
IPSTGDATEW	IPSTGDTEW
GTEYTGPKLY	TEYTGPKLY
HAGNINFKW	HAGNINFKW
FPMEIRQYL	FPMEIRQYL
DAMQLNDKW	DAMQLNDKW
LPNDVISSL	LPNDVISSL
NPSPYHLYY	NPSPYHLYY
HAHISEQAVW	HAHISEAVW
HPSFHNINF	HPSFHNINF
LPTGVYLNF	LPTGVYLNF
TAFPGTGGF	TAFPGTGGF
HPQTLSHAD	HPQTLSHAD
QPTPHTQHW	QPTPHTQHW
HPILNDPIY	HPILNDPIY
HPFPGPGLAI	HPFPGPLAI
NPLGGGREVW	NPLGGGEVW
LPLEEHYRF	LPLEEHYRF
FPLSPDPRW	FPLSPDPRW
YPIDPVTQEF	YPIDPVQEF
DANPLKTLW	DANPLKTLW
VPLPGPPGPPG	VPLPGPPGP
YPESNSRAIF	YPESNSRAI
SPIPFPPLSY	SPIPFPLSY
YPYEYEGGHI	YPYEYEGHI
APAGDAGRW	APAGDAGRW
FPSIYDVKY	FPSIYDVKY
KPIESFNEY	KPIESFNEY
DPFIDLNYM	DPFIDLNYM
SAEEAMKHVYF	SAEEAMHVY
HPTGKMFIL	HPTGKMFIL
YAYSPLEDSW	YAYSPLDSW
YPYPPPPPEF	YPYPPPPEF
MPVPVILNF	MPVPVILNF
FPDSGHFNV	FPDSGHFNV
MPFQDGKPFNL	MPFQDGKPF
HASMLNIWW	HASMLNIWW
FPHYGFPTY	FPHYGFPTY
HPHKIIVMY	HPHKIIVMY
VPSSELQIYTW	VPSSELQIY
SPSPENLKF	SPSPENLKF
HAVGDIPGVRF	HAVGDIVRF
NAHMDSLQW	NAHMDSLQW
NALPDTLKVTY	LPDTLKVTY
MPTRPVPSY	MPTRPVPSY
HPIADGGTPDI	IADGGTPDI
FPMTMDEKY	FPMTMDEKY
HPVTGQFLY	HPVTGQFLY
HPNYHKEPFL	HPNYHKEPF
NPEPELLVRW	NPEPELVRW
LPVPAFNVI	LPVPAFNVI
FPIGSSGF	FPIGS-SGF
VPTPIHPIF	VPTPIHPIF
AAQAAATAAAM	QAAATAAAM
SPASSEYSW	SPASSEYSW
LPVADYFKQW	LPVADYKQW
LPYPDPAIAQF	YPDPAIAQF
LPYNHQHEY	LPYNHQHEY
KAPGSTSNL	KAPGSTSNL
RPAPVEVTY	RPAPVEVTY
FPWSEIRNI	FPWSEIRNI
YPNERFELL	YPNERFELL
YPESIPRKF	YPESIPRKF
LPTASASKF	LPTASASKF
MPNSPAPHF	MPNSPAPHF
NAIEHTLQW	NAIEHTLQW
HPIQTQAQY	HPIQTQAQY
MPFNKEPKW	MPFNKEPKW
MPMGPDQKY	MPMGPDQKY
NPVSWVQTF	NPVSWVQTF
TAPTGHTL	TAPTG-HTL
FPFPKPDLI	FPFPKPDLI
LPVNESFGF	LPVNESFGF
HATTALLHY	HATTALLHY
NPGPGPRW	NPGPG-PRW
SAYDGKDYI	SAYDGKDYI
QPAGPATHTW	QPAGPAHTW
HAFVELHEF	HAFVELHEF
HAENNEFITW	HAENNEITW
VPLDKQITI	VPLDKQITI
SAPKGSVL	SAPKG-SVL
VPESSLAGHSF	VPESSLHSF
HPNPGSITHL	HPNPGSTHL
IPLDDPTLLF	IPLDDPTLL
HAYDGKDYI	HAYDGKDYI
MPLEDMNEF	MPLEDMNEF
KPNDQSSRW	KPNDQSSRW
YPSEFSTYL	YPSEFSTYL
LPWASTHSL	LPWASTHSL
YPNGVVVHYF	YPNGVVVHY
HAGFFVEDNF	HAGFFVDNF
FPIHVQTSL	FPIHVQTSL
MPGGNKEAW	MPGGNKEAW
HAYIHSVQF	HAYIHSVQF
FPSLELGHW	FPSLELGHW
MPVPTTPEF	MPVPTTPEF
FPAEKGQLF	FPAEKGQLF
DASPVQAVF	DASPVQAVF
LPAKILVEF	LPAKILVEF
YPVGHMPYGW	YPVGHMYGW
HAVGNVELYL	HAVGNVELY
EAMRLGPGW	EAMRLGPGW
MPAFIFEHI	MPAFIFEHI
MPESGAGSEF	MPESGASEF
FKQYANDNGVD	YANDN----
LPDNYTQDTW	LPDNYTDTW
LPSEKAIFL	LPSEKAIFL
SADRNVKIW	SADRNVKIW
FPLQWFGVPA	FPLQWFVPA
ASRDTVIVW	ASRDTVIVW
YPSETTVKYVF	YPSETTVKY
MPHDAIILL	MPHDAIILL
TPIPVPAYF	TPIPVPAYF
YAGPEVDIW	YAGPEVDIW
FPAVDDNLLKF	FPAVDDNLL
LPFPFPSKL	LPFPFPSKL
FPSTVSTVY	FPSTVSTVY
TPADVFIVF	TPADVFIVF
MPDEATPHYF	MPDEATPHY
LPFQVANVW	LPFQVANVW
FPHPHIHEY	FPHPHIHEY
MPDHTDVSL	MPDHTDVSL
LPLESLGW	LPLES-LGW
NPVPYNSSW	NPVPYNSSW
HAETATASSTW	TATAS-STW
FPQLDSTSF	FPQLDSTSF
HPDPNNENI	HPDPNNENI
FPSSGRFW	FPSSG-RFW
DPQDFIQEW	DPQDFIQEW
MPDGKIQKL	MPDGKIQKL
HPSDESGYRW	HPSDESYRW
QPAQDIFSVY	QPAQDISVY
IPMNPNTNDLF	NPNTN-DLF
YPGSIEVRW	YPGSIEVRW
YPGDIKIKW	YPGDIKIKW
LPAALLSRF	LPAALLSRF
APIAGETKVW	APIAGEKVW
FPYAQRQFL	FPYAQRQFL
LPDADTLLHF	LPDADTLHF
HSGPVIPVY	HSGPVIPVY
HPESPNTGSHW	SPNTG-SHW
MPSQSVEQTY	MPSQSVQTY
QAADPAISQAW	AADPAIQAW
FPNIVIKGSEL	FPNIVISEL
SPTHISRSW	SPTHISRSW
LPDGQVITI	LPDGQVITI
LPSLVPLRI	LPSLVPLRI
SPDATIRIW	SPDATIRIW
GAVRENYTW	GAVRENYTW
HAAPQPQKL	HAAPQPQKL
DALAHGADVNW	LAHGADVNW
LPSTTIVSM	LPSTTIVSM
IPTKQTQTF	IPTKQTQTF
IPNENELQF	IPNENELQF
DPQNDKPSKW	DPQNDKSKW
HPIDDLQSAY	HPIDDLSAY
FPFSRPELL	FPFSRPELL
MATAHVTEI	MATAHVTEI
MPVRAADKL	MPVRAADKL
LPQPLILRW	LPQPLILRW
TATEITESF	TATEITESF
HPENPKAVETF	HPENPKETF
LPGSGKTQW	LPGSGKTQW
YPLNSYEL	YPLNS-YEL
LPAGSKKNW	LPAGSKKNW
EAIQDLWQW	EAIQDLWQW
LPASVHPQL	LPASVHPQL
VPATSHHF	VPATS-HHF
YPNIEETHW	YPNIEETHW
FPAKELHTI	FPAKELHTI
MPSEDVVSL	MPSEDVVSL
FPHHGTFEVI	FPHHGTEVI
EEQLQQIR	EEQLQ-QIR
HPIPGEYKFFW	HPIPGEYKF
LPENYKQLTW	LPENYKLTW
HPNPDVLKI	HPNPDVLKI
KPIPKSDKF	KPIPKSDKF
NAAPSHTKF	NAAPSHTKF
FPITASQKI	FPITASQKI
HPDPTRLLLF	HPDPTRLLL
YPSEFATYL	YPSEFATYL
LPIENDVYKY	LPIENDYKY
FPAEKESEW	FPAEKESEW
TAEGEINNVQW	TAEGEIVQW
MPDSAAALL	MPDSAAALL
LPYNHQHEYF	LPYNHQHEY
LPHEDLPFW	LPHEDLPFW
EPEGGFSKW	EPEGGFSKW
LPSHGVPLI	LPSHGVPLI
EALALTQTW	EALALTQTW
YPASSSVF	YPASS-SVF
FPIPDLQKY	FPIPDLQKY
HPSGATPTL	HPSGATPTL
HPASSDPRF	HPASSDPRF
LPNKDGVVRF	LPNKDGVRF
HPDQAQAIL	HPDQAQAIL
FPQFYPLGI	FPQFYPLGI
DPVLGDKW	DPVLG-DKW
DANPETHAF	DANPETHAF
SPEDSWVSKW	SPEDSWSKW
LPPELRGDLW	LPPELRDLW
YAFDVNTHKW	YAFDVNHKW
YPADLAHKI	YPADLAHKI
FPLDKMTYL	FPLDKMTYL
FPAAPIPTL	FPAAPIPTL
SALDMTRYW	SALDMTRYW
YPSPTGVLI	YPSPTGVLI
FPEPNPRVI	FPEPNPRVI
TAMDVVYAL	TAMDVVYAL
LPEDLYHLI	LPEDLYHLI
LPVDLAEEL	LPVDLAEEL
LADPDEVARRW	DPDEVARRW
HPDPDAELQRM	HPDPD-AEL
IPYEGFASL	IPYEGFASL
QPNPLPLRL	QPNPLPLRL
HPHEVMQRM	HPHEVMQRM
TPAGVVNKY	TPAGVVNKY
IPFNQALVF	IPFNQALVF
EAVGNIVKF	EAVGNIVKF
SAAADETLRLW	AAADETLRL
SAVPDSLRW	SAVPDSLRW
TPAPPIKRW	TPAPPIKRW
MAGDIYSVF	MAGDIYSVF
YPDEEGPKHW	YPDEEGKHW
SIPKGNSAL	SIPKGNSAL
HVNPYIGLFF	HVNPYILFF
LPADITEDEF	LPADITDEF
VGGEFDLEMNF	VGGEFDLEM
ATADTVIIY	ATADTVIIY
LPSHVVTML	LPSHVVTML
YADLVKQAW	YADLVKQAW
HPYHFKPKKI	HPYHFKKKI
NAAEELWKW	NAAEELWKW
LPVPVIPSF	LPVPVIPSF
DPVDIYKSW	DPVDIYKSW
HPLEGTHEL	HPLEGTHEL
SSPQPGSAL	SSPQPGSAL
LPAAARPLW	LPAAARPLW
NPEDVARLIF	NPEDVARLI
LPEGKSSATKW	LPEGKSTKW
TAYPGQTQY	TAYPGQTQY
TPISQAQKL	TPISQAQKL
LPNIQAVLL	LPNIQAVLL
NASESKLEL	NASESKLEL
LPFFNDRPW	LPFFNDRPW
FPIGEKQDIW	FPIGEKDIW
QPDHLFRKF	QPDHLFRKF
EALRLPYEQW	EALRLPEQW
SPVDSVLFY	SPVDSVLFY
HPQPGSANSL	HPQPGSNSL
TSENITQKVVW	TSENITQKV
MPFEIRLPEF	MPFEIRPEF
VPTQLVSYF	VPTQLVSYF
YPRSDVDLY	YPRSDVDLY
NTTAIAEAW	NTTAIAEAW
MANGAVIHL	MANGAVIHL
MPIGPDVSL	MPIGPDVSL
NADPASHEI	NADPASHEI
HPSKGYWW	HPSKG-YWW
SPEKGAETW	SPEKGAETW
HPTDDTTTL	HPTDDTTTL
MPDAAHGI	MPDAA-HGI
TPQDYNLRW	TPQDYNLRW
SAFSAAHEEQW	FSAAHEEQW
LPSDVSILY	LPSDVSILY
YPYPYPHTL	YPYPYPHTL
LAPTDVKEL	LAPTDVKEL
HPVTGEPATW	HPVTGEATW
MPDDLLTTL	MPDDLLTTL
FPIDSHTW	FPIDS-HTW
DPFKDIILY	DPFKDIILY
HAIEDKETI	HAIEDKETI
MPEPDAQRF	MPEPDAQRF
HPTAHAPMM	HPTAHAPMM
FPSPFDPLTL	FPSPFDLTL
EPIYPEVVHMF	YPEVV-HMF
LPWEEREKI	LPWEEREKI
LPYQGHNSF	LPYQGHNSF
YPYPYPHTLY	YPYPYPHTL
YPNKYESVI	YPNKYESVI
KPVELRTKW	KPVELRTKW
APTAQATEW	APTAQATEW
FPTGNIHMF	FPTGNIHMF
MPLHTIIPLL	MPLHTIPLL
LPFDKETGF	LPFDKETGF
IPDLSEYKW	IPDLSEYKW
FPFYGKPMRI	FPFYGKMRI
QPSTLTDKW	QPSTLTDKW
MAIVGTHKF	MAIVGTHKF
TAYEKINKW	TAYEKINKW
SVIDSDEKW	SVIDSDEKW
FPDFSEQRW	FPDFSEQRW
LPLFPEPLHVF	FPEPL-HVF
FPGDQDLRF	FPGDQDLRF
LPYNDYFEY	LPYNDYFEY
HPGSSALHY	HPGSSALHY
FPEPSRPPLF	FPEPSRPLF
EPQPGARRW	EPQPGARRW
FPRHIEPEL	FPRHIEPEL
SGANIDELITF	SGANIDELI
FPAELENRI	FPAELENRI
TPWPHIVEF	TPWPHIVEF
LPSNDSSKF	LPSNDSSKF
LPGNPNAVW	LPGNPNAVW
FPISEETIKL	FPISEEIKL
APADQSQSW	APADQSQSW
MPYNHQHKY	MPYNHQHKY
YPDPVSIIQKY	DPVSIIQKY
FPDPAGKLNQF	DPAGKLNQF
IPDTMAHLI	IPDTMAHLI
IPAGTELTF	IPAGTELTF
FPNVSSFEW	FPNVSSFEW
HPAGHLVLKW	HPAGHLLKW
EPMPTKETGW	EPMPTKTGW
SADRFVYVW	SADRFVYVW
MPDPKTFKQHF	MPDPKTQHF
FPFLSGDNQHY	FLSGDNQHY
VPLEIMIKF	VPLEIMIKF
LPGDTALLL	LPGDTALLL
LPVIIFTTF	LPVIIFTTF
HANSVDTSF	HANSVDTSF
AAPSAAREL	AAPSAAREL
EPYGQLNPKW	EPYGQLPKW
LPEDFYHFW	LPEDFYHFW
SPIPGFTKW	SPIPGFTKW
MPHAPIGLYF	MPHAPILYF
LPVLSTDKF	LPVLSTDKF
HPVKSGIHKW	HPVKSGHKW
EPNPESLEL	EPNPESLEL
SPSAYVLEI	SPSAYVLEI
VPEAGAHEEW	VPEAGAEEW
DLFQDYERW	DLFQDYERW
HANNTVSNF	HANNTVSNF
SIDFTQEEW	SIDFTQEEW
IPAEDVPLL	IPAEDVPLL
SPTSAHAFW	SPTSAHAFW
DANSKQLLY	DANSKQLLY
IPIALSGRDIL	IALSGRDIL
HPMPRVNEI	HPMPRVNEI
TPIQNSLKDLW	TPIQNSLKD
YPIVDGKLSI	YPIVDGLSI
YPNSHTHYF	YPNSHTHYF
SPVDIFAKI	SPVDIFAKI
LPSELIVHI	LPSELIVHI
FPFSQDINSHL	FSQDINSHL
VPSPPPGHKW	VPSPPPHKW
MPLAFSDKY	MPLAFSDKY
MPVEKNITL	MPVEKNITL
SADEVQRFF	SADEVQRFF
NAEKELTDRNW	NAEKELRNW
VPYPDDLVGF	VPYPDDVGF
SPDSAVGVQW	SPDSAVVQW
HASDVLETSGW	HASDVLSGW
SASEVLKEW	SASEVLKEW
LPDGTSLTQTF	LPDGTSQTF
YLPDGTASL	YLPDGTASL
FPAKVTAHW	FPAKVTAHW
HLSDVVLRF	HLSDVVLRF
HPTTLAVGI	HPTTLAVGI
HPALLSDGKW	HPALLSGKW
TAADVVKQW	TAADVVKQW
SPSSDSLLF	SPSSDSLLF
YPHAFNVKF	YPHAFNVKF
MPPMQAQEW	MPPMQAQEW
TPDEIDHVF	TPDEIDHVF
TPLYGNVHSW	TPLYGNHSW
LAEEGFYKF	LAEEGFYKF
AAPAYSRAL	AAPAYSRAL
LPSLDKPGW	LPSLDKPGW
HPDSHQLFI	HPDSHQLFI
FPYPDPSQW	FPYPDPSQW
LPQDVILKF	LPQDVILKF
FPATPFGAQW	FPATPFAQW
FPYKGYIW	FPYKG-YIW
VPAAVSGRW	VPAAVSGRW
LPDEVRERW	LPDEVRERW
AQYEDIAQKS	QYEDIAQKS
SAYNEGTLMKF	SAYNEGTLM
TASSVALDL	TASSVALDL
NPDEGVNYF	NPDEGVNYF
LPSEIEVKY	LPSEIEVKY
QAFPNTNRW	QAFPNTNRW
QPMPETPKW	QPMPETPKW
MPMLNERTW	MPMLNERTW
HPTDPLTSF	HPTDPLTSF
FPLIYSEMKY	FPLIYSMKY
LPADWAPLF	LPADWAPLF
MPTTSTTSTRF	TTSTTSTRF
NPPLESHVGW	PPLESHVGW
FPIDHFTHI	FPIDHFTHI
FPESDNLFKW	FPESDNFKW
LPPPAYGF	LPPPA-YGF
TAASSALGF	TAASSALGF
SPSSVTGNALW	SPSSVTNAL
YPDINFNRL	YPDINFNRL
MPHQLQDTF	MPHQLQDTF
TPSGRSLWT	TPSGRSLWT
FPSTAEHTLQW	FPSTAEHTL
IPANVVLKW	IPANVVLKW
HPSPVVLKV	HPSPVVLKV
FPHNFQETTY	FPHNFQTTY
LPLPVVQLL	LPLPVVQLL
PPHVLSSEF	PPHVLSSEF
NPYSGDLTKF	NPYSGDTKF
QPYSKDSPF	QPYSKDSPF
YAFNGTQRF	YAFNGTQRF
NPLPTNYTW	NPLPTNYTW
SIPGGYNAL	SIPGGYNAL
VPVALRTDDW	VPVALRDDW
SPITSSPPKW	SPITSSPKW
LPFLPDLEEL	LPFLPDEEL
LAHGADVNW	LAHGADVNW
LPSPLQPSW	LPSPLQPSW
IPAQHITLF	IPAQHITLF
NANAASPLI	NANAASPLI
FPIPLINRL	FPIPLINRL
IPLDGETWSY	IPLDG-ETW
LPFLPTPMGKG	LPFLPTPMG
HPQDGRSAW	HPQDGRSAW
FPVAGQKLIY	FPVAGQKLI
LPYTGAETRI	LPYTGATRI
IPFVDPDSW	IPFVDPDSW
HADDTQPARL	HADDTQARL
TADDKKLQF	TADDKKLQF
FLWKEPATM	FLWKEPATM
HPEQDAGKVF	HPEQDAKVF
LPSSFVEKL	LPSSFVEKL
VPFPDTYEI	VPFPDTYEI
LPTFQSPEF	LPTFQSPEF
TAFGGFLKY	TAFGGFLKY
FPVRDGKIKL	FPVRDGIKL
SPADVFVQW	SPADVFVQW
APAPSTVHF	APAPSTVHF
LPLHIAPRW	LPLHIAPRW
HPAPDQQGL	HPAPDQQGL
HPYTEKPRLW	HPYTEKPRL
SPDESHRMW	SPDESHRMW
YPAQGVQQF	YPAQGVQQF
LPEPVTLRW	LPEPVTLRW
HIWPDDITKW	WPDDI-TKW
AAVDLISDEW	AAVDLIDEW
TPTPFFHTF	TPTPFFHTF
RPNDIYVNM	RPNDIYVNM
QALEDHFSSF	QALEDHSSF
HPVSQESSW	HPVSQESSW
HPQTIIAGW	HPQTIIAGW
DAGIGYLF	DAGIG-YLF
HPQPGAVEL	HPQPGAVEL
APAPIHNQF	APAPIHNQF
IPSPPPRPKN	IPSPPPPKN
MPVIPMNTI	MPVIPMNTI
VPEPRPSEW	VPEPRPSEW
YADPGAEVKI	YADPGAVKI
MPQEKSPGY	MPQEKSPGY
TPEAAAQVVQW	EAAAQVVQW
YPDRELQSQW	YPDRELSQW
KPNKTRVIW	KPNKTRVIW
SASQDGKLIIW	SASQDGKLI
HPNGLQVMY	HPNGLQVMY
YPFKDVNNW	YPFKDVNNW
TALSNLITW	TALSNLITW
LPAPPTQNM	LPAPPTQNM
HPEHAFYEF	HPEHAFYEF
NPFQEPRTVVW	NPFQEPRTV
NADTLALVF	NADTLALVF
HPFLSGAETF	HPFLSGETF
MVDGTLLLL	MVDGTLLLL
SAAADSAVRLW	AAADSAVRL
IAQSLEHSW	IAQSLEHSW
TAEGTVFHF	TAEGTVFHF
IPYPTKNPFTW	YPTKNPFTW
FPEHIFPAL	FPEHIFPAL
FPMTHGNTGF	FPMTHGTGF
APAETPHEKW	APAETPEKW
VPDPNVIKL	VPDPNVIKL
MAPERVASL	MAPERVASL
YATQSHQW	YATQS-HQW
LPVEGGFW	LPVEG-GFW
LPSKTKVAW	LPSKTKVAW
HPVTTDIKHSI	HPVTTDIKH
RPNDVQLFY	RPNDVQLFY
LPSSVISAI	LPSSVISAI
TPIKDSHLI	TPIKDSHLI
LPSPVTAQKY	LPSPVTQKY
LPSQLAHRL	LPSQLAHRL
TAFEKEHLW	TAFEKEHLW
HPSINKQEW	HPSINKQEW
YPGPGGGGW	YPGPGGGGW
TANDRILKY	TANDRILKY
EANAIALKY	EANAIALKY
TPIMKTKKW	TPIMKTKKW
MPSGPSGKRW	MPSGPSKRW
HPVHPDIKL	HPVHPDIKL
DADPHFHHF	DADPHFHHF
PVVSGVLPE	PVVSGVLPE
LPLPHFDTI	LPLPHFDTI
FPEALARLL	FPEALARLL
LPALKDRKW	LPALKDRKW
LPQPDVFPLF	LPQPDVPLF
TAWLEIMTKY	TAWLEITKY
FPVSYNDKF	FPVSYNDKF
DAYALNHTL	DAYALNHTL
VPVKVTDRF	VPVKVTDRF
VSPEYFSMLL	SPEYFSMLL
HVSTVNPNY	HVSTVNPNY
HVEEKAVHSW	HVEEKAHSW
IAVPRNDEW	IAVPRNDEW
PFKPPKVTF	PFKPPKVTF
DPDKDVLGW	DPDKDVLGW
TAVTPQQTW	TAVTPQQTW
LPDPGFQKI	LPDPGFQKI
LPYKATENDIY	LPYKATNDI
HADVATVMW	HADVATVMW
NPNTVIILI	NPNTVIILI
HAARIINDLL	HAARIIDLL
HPHPVVPKM	HPHPVVPKM
DALEKNQQW	DALEKNQQW
WPEEGPATAW	WPEEGPTAW
LPAEARER	LPAEA-RER
SPEPGTAAAW	SPEPGTAAW
FPYYPSPGVLF	YPSPG-VLF
SPATSVPGMG	SPATSVPGM
IPIGAYEPRW	IPIGAYPRW
APVPLYNSF	APVPLYNSF
YMFVDENTF	YMFVDENTF
LPGPYIKW	LPGPY-IKW
APVEVTHNF	APVEVTHNF
FPHRQPLRY	FPHRQPLRY
FPYAFKEVI	FPYAFKEVI
HPNALNLQL	HPNALNLQL
QPGTFLLRF	QPGTFLLRF
FPHLPGSAPSW	LPGSA-PSW
HAVKNDFQIW	HAVKNDQIW
SPIDFHLQSW	SPIDFHQSW
VPASALGSW	VPASALGSW
QPEGPGGAASW	EGPGGAASW
NAFEESKDNTI	NAFEESNTI
HPLPEVAHV	HPLPEVAHV
RPFAGFEDF	RPFAGFEDF
SSPAPRTAL	SSPAPRTAL
TPIQDNVDQTY	TPIQDNQTY
TADITVLRW	TADITVLRW
NAPWAVTSL	NAPWAVTSL
LPHPYAIAVF	LPHPYAAVF
LPNTDVPIL	LPNTDVPIL
HPLHNDPNL	HPLHNDPNL
HPGSTTLRI	HPGSTTLRI
