Data	Data aligned
VAVPGGVDL	VAVPGGVDL
STPEFTIL	STPEF-TIL
IAIIPSKKL	IAIIPSKKL
ASSPGILVL	ASSPGILVL
IIEPSLRQL	IIEPSLRQL
YVIGPKGNSL	YVIGPKNSL
LALDDVAAL	LALDDVAAL
YAFEGSYL	YAFEG-SYL
FQSSAVMAL	FQSSAVMAL
LAIESANEL	LAIESANEL
ILNPHGIPL	ILNPHGIPL
LAQPQMMVV	LAQPQMMVV
WALDDHHAL	WALDDHHAL
VIIGKTVTL	VIIGKTVTL
YSDDKVQL	YSDDK-VQL
QAFPGGHSM	QAFPGGHSM
MATESILHF	MATESILHF
TAIPISMVL	TAIPISMVL
VANPVPASL	VANPVPASL
YAISPGLDITF	YAISPGLDI
LIQKPSHPL	LIQKPSHPL
FAYRGFKYL	FAYRGFKYL
YTSPYFYAL	YTSPYFYAL
RAIDNAADL	RAIDNAADL
FAQTIETVL	FAQTIETVL
YADRVKEL	YADRV-KEL
RVAPEEHPVL	VAPEEHPVL
FQYPVRPASM	FQYPVRASM
FAMKGKRKTL	FAMKGKKTL
YAFLHRTL	YAFLH-RTL
LIYGTPRAA	LIYGTPRAA
FSFLPTRAL	FSFLPTRAL
TAVPYFSNL	TAVPYFSNL
FICPVVGLEM	FICPVVLEM
NTMGHMMEM	NTMGHMMEM
FSFPEPEAL	FSFPEPEAL
VIIRDSPVL	VIIRDSPVL
FAALPNQL	FAALP-NQL
KTYEHFNAM	KTYEHFNAM
YISVPKENSTL	ISVPKESTL
IIYAGSRAL	IIYAGSRAL
FTIDGPLCL	FTIDGPLCL
FTIARYMEL	FTIARYMEL
FSYVTPRAF	FSYVTPRAF
FATEGLRTL	FATEGLRTL
KAFFTSKAL	KAFFTSKAL
VAYEAPSL	VAYEA-PSL
FAVPKNYKL	FAVPKNYKL
LAQEIVKAL	LAQEIVKAL
YSHGGGAWL	YSHGGGAWL
LAYLGAKPRSL	YLGAKPRSL
FAVEAENREM	FAVEAEREM
ITDFQFKEL	ITDFQFKEL
MIDPRTKAL	MIDPRTKAL
LAVAIALRF	LAVAIALRF
FAGWGRAL	FAGWG-RAL
FAFQESPPRFL	FQESPPRFL
YAMASRDVFL	YAMASRVFL
FAQEALTVL	FAQEALTVL
FAALHGPAL	FAALHGPAL
YAYDGKDYLAL	YAYDGKDYL
VTDVGVHL	VTDVG-VHL
FSTPLNPFL	FSTPLNPFL
LAIRGLQL	LAIRG-LQL
FANFGVLRL	FANFGVLRL
LAQAHIQQL	LAQAHIQQL
VSDEKRTEL	VSDEKRTEL
FAYGGHPYPF	FAYGGHYPF
YSQTGNYEL	YSQTGNYEL
MAAPRAEAL	MAAPRAEAL
WAQSECRTL	WAQSECRTL
IALEAAKAL	IALEAAKAL
SAAFPYGGVL	AAFPYGGVL
HIIAGAGEL	HIIAGAGEL
LALADDKKL	LALADDKKL
FSSPSFQTL	FSSPSFQTL
YVDPVNKVL	YVDPVNKVL
IVDKSGRTL	IVDKSGRTL
KALANVNIGSL	LANVNIGSL
SATQVYTIL	SATQVYTIL
FIKNPSTSL	FIKNPSTSL
FSGRILGL	FSGRI-LGL
ITDLPIKL	ITDLP-IKL
FTVPQIIEM	FTVPQIIEM
KAASVRPVL	KAASVRPVL
TASPFFRAL	TASPFFRAL
LADIGYKTF	LADIGYKTF
FLFDHLLTL	FLFDHLLTL
LSMVPITSL	LSMVPITSL
MANGAVIHL	MANGAVIHL
LTTDISLIF	LTTDISLIF
VSDKAHIL	VSDKA-HIL
LVIGRVLEL	LVIGRVLEL
GIIHVISRP	GIIHVISRP
IADLVSKEL	IADLVSKEL
SFLTQSYQL	SFLTQSYQL
IAIDSVHQL	IAIDSVHQL
VAYFGLTTL	VAYFGLTTL
SATELMNIL	SATELMNIL
YTIPAHQNL	YTIPAHQNL
HSHVALAL	HSHVA-LAL
AAAPVPTTTL	AAAPVPTTL
YIIIPKSSL	YIIIPKSSL
FLFSKFIEL	FLFSKFIEL
SAVWNSPPL	SAVWNSPPL
LSFWWPLAL	LSFWWPLAL
SATIVIAYL	SATIVIAYL
AAAPPSPPFSF	AAAPPSPPF
AAMEFLQEL	AAMEFLQEL
AAQNSRLSL	AAQNSRLSL
FTFPDPPPL	FTFPDPPPL
YAFLREAL	YAFLR-EAL
LSFNPLTSL	LSFNPLTSL
FNDPVAMVL	FNDPVAMVL
QMAFQILL	QMAFQ-ILL
LAVDPNGAFL	LAVDPNAFL
YADRHAEL	YADRH-AEL
FALPAYHTL	FALPAYHTL
QAFSPSSLSSL	FSPSSLSSL
FAHWGQEL	FAHWG-QEL
VAQFKFTVL	VAQFKFTVL
TAIKVTQHL	TAIKVTQHL
FASEYPLIL	FASEYPLIL
LAHVVITQL	LAHVVITQL
FASSPLRVL	FASSPLRVL
FSQPGLRSL	FSQPGLRSL
KAYERGISL	KAYERGISL
FTEMASRVL	FTEMASRVL
FSQEPPDAL	FSQEPPDAL
LAVEHDNISL	LAVEHDISL
IAFHPVHGTL	IAFHPVGTL
VANVSLLAL	VANVSLLAL
FTEDQTAEF	FTEDQTAEF
NIYAANPVI	NIYAANPVI
YSVPFYPTF	YSVPFYPTF
YVGPSLRM	YVGPS-LRM
LGSPWAVEL	LGSPWAVEL
YALTALMKL	YALTALMKL
SAIFNFQSL	SAIFNFQSL
YLFERIKEL	YLFERIKEL
LAHVAGCEL	LAHVAGCEL
SVIEISRAL	SVIEISRAL
FAGMPITL	FAGMP-ITL
YSYSKGTYL	YSYSKGTYL
FASTTQSHL	FASTTQSHL
YSYPTKQAAL	YSYPTKAAL
MSVQPTVSL	MSVQPTVSL
FSVPPTEETL	FSVPPTETL
ISIEGNKMPL	ISIEGNMPL
LAFPGEMLL	LAFPGEMLL
IAGPVLLILVH	IAGPVLLIL
HTDTTVKF	HTDTT-VKF
YTLVGSLPL	YTLVGSLPL
YSADGHSIL	YSADGHSIL
FVDNHVEL	FVDNH-VEL
YAHLTPREL	YAHLTPREL
FAYKQENEM	FAYKQENEM
LASKAAEL	LASKA-AEL
MADSGTKAL	MADSGTKAL
AAIKPGTPLY	AAIKPGTPL
AAIASLLYL	AAIASLLYL
FLYDTHQNL	FLYDTHQNL
VANPEHMEM	VANPEHMEM
VTVGECRPL	VTVGECRPL
VAKAVTQAL	VAKAVTQAL
SALGHLSFL	SALGHLSFL
FSFDGPEIM	FSFDGPEIM
FAMPPPHGM	FAMPPPHGM
FSYVSPEL	FSYVS-PEL
LFHPSNVEM	LFHPSNVEM
NTIDPSHPM	NTIDPSHPM
YVLDGSGHIL	YVLDGSHIL
INVEPLSSL	INVEPLSSL
LADQPHLL	LADQP-HLL
PEVKFNWYVD	EVKFN-WYV
YAIEKVREI	YAIEKVREI
STLRSLNNF	STLRSLNNF
FGVIPSTPL	FGVIPSTPL
MALGHVIVL	MALGHVIVL
YVQPFLNAL	YVQPFLNAL
YSLPPEQLSSL	YSLPP-EQL
QAIRAGLEL	QAIRAGLEL
LTQVGSIL	LTQVG-SIL
FVALPGVAV	FVALPGVAV
IITTVGPEL	IITTVGPEL
YIIPVVLFL	YIIPVVLFL
ASSPYFAAL	ASSPYFAAL
YSIYVYKVL	YSIYVYKVL
LLPEHFLFL	LLPEHFLFL
GSHSMRYF	GSHSM-RYF
FSHLGSRDL	FSHLGSRDL
FAQPSGLSL	FAQPSGLSL
SVISVVSYL	SVISVVSYL
LSAPSLHAL	LSAPSLHAL
YILGKFFAL	YILGKFFAL
AAVNHISQL	AAVNHISQL
YTDFHIDF	YTDFH-IDF
LATLIHQVL	LATLIHQVL
FSLAPITKL	FSLAPITKL
KADMNVHLL	KADMNVHLL
FAVIGSTEEL	FAVIGSEEL
FLFDGSPTYVL	FLFDGSPTY
AAVNSALAF	AAVNSALAF
MILIPGQTL	MILIPGQTL
TIYDRFVHL	TIYDRFVHL
YAKEAQQSL	YAKEAQQSL
YIITGGGFL	YIITGGGFL
IVAEPGAVL	IVAEPGAVL
YVIDPIKGL	YVIDPIKGL
VATKIFQEL	VATKIFQEL
YSIVGQKL	YSIVG-QKL
LANDFQNAL	LANDFQNAL
FIFSDTHEL	FIFSDTHEL
MAYPSLVAM	MAYPSLVAM
ISILQQIEL	ISILQQIEL
RATPHPSEL	RATPHPSEL
FSHEEIAM	FSHEE-IAM
TAAPTIGVL	TAAPTIGVL
VAFPSGDASSL	VAFPSGSSL
FADVAPLQL	FADVAPLQL
FASFPHMVL	FASFPHMVL
YAVAKSILTL	YAVAKSLTL
YANAVLQAL	YANAVLQAL
AASSVRSNL	AASSVRSNL
LASPLDPQAL	LASPLDQAL
LAVHIAHSL	LAVHIAHSL
LSRNGPAL	LSRNG-PAL
YVINVTTHL	YVINVTTHL
AALGTMTSL	AALGTMTSL
KANPALYVL	KANPALYVL
FSYPAGTEL	FSYPAGTEL
FIDGHFVEM	FIDGHFVEM
SAAPTFLLL	SAAPTFLLL
KAVDPSSVAL	AVDPSSVAL
FAAGLGRSL	FAAGLGRSL
FSIPILMQL	FSIPILMQL
YAVELVNDSL	YAVELVDSL
NAVWALSNL	NAVWALSNL
FAADVRLMF	FAADVRLMF
VVIGRSGEM	VVIGRSGEM
TANKIFMVL	TANKIFMVL
IAFPAAPLL	IAFPAAPLL
TAGRVLEL	TAGRV-LEL
AVNPKFVAL	AVNPKFVAL
SSVPRTAEL	SSVPRTAEL
HSDEYFRQL	HSDEYFRQL
VASRATVL	VASRA-TVL
LSIEVNPNRPL	LSIEVNRPL
MAYGASFLSF	MAYGASLSF
LTFNPSSAL	LTFNPSSAL
RIPSFVTEL	RIPSFVTEL
LAADCAHEL	LAADCAHEL
YAFPKAVSV	YAFPKAVSV
SVIPPRTEL	SVIPPRTEL
FQEADSPTL	FQEADSPTL
PSVWQNIL	PSVWQ-NIL
LAVQAFLQM	LAVQAFLQM
LALFPGVAL	LALFPGVAL
YAISAGVSL	YAISAGVSL
LTALGPEL	LTALG-PEL
FQTHTTPVL	FQTHTTPVL
FIVPPPPEKSL	FIVPPPKSL
VIIEKTYSL	VIIEKTYSL
IADNHTPKEL	IADNHTKEL
FAVISRHSL	FAVISRHSL
FQNPFRSEL	FQNPFRSEL
KAFPFHIIF	KAFPFHIIF
HSIGSYFTL	HSIGSYFTL
VALNAHTFL	VALNAHTFL
FSKFGTVL	FSKFG-TVL
LIMDAYNSL	LIMDAYNSL
TAAQVARVL	TAAQVARVL
FSHSGVHSL	FSHSGVHSL
YAFSPRNSL	YAFSPRNSL
QVVKPHTPL	QVVKPHTPL
MAAMVLTSL	MAAMVLTSL
FALLTGPGSEL	LLTGPGSEL
FVIDLQTRL	FVIDLQTRL
FAEDPPTSL	FAEDPPTSL
MTQQPRPVL	MTQQPRPVL
MAIDIPHIWL	MAIDIPIWL
EAVRPHSAL	EAVRPHSAL
YVYSGVETL	YVYSGVETL
RAIQFYLEF	RAIQFYLEF
FTAPATVSL	FTAPATVSL
YIDDVFHAL	YIDDVFHAL
LSSDKIAAL	LSSDKIAAL
LANGIKVLL	LANGIKVLL
SAQDAARIL	SAQDAARIL
VAMPGVPAFL	VAMPGVPAF
AASHPLLL	AASHP-LLL
IAIATGKML	IAIATGKML
YGSPGILEF	YGSPGILEF
YTFPFQQL	YTFPF-QQL
YSLPNAPTL	YSLPNAPTL
FAHFPGLASEL	FAHFPGSEL
IASISKSL	IASIS-KSL
FVIGNGKNL	FVIGNGKNL
NIFPPSATL	NIFPPSATL
VASFPRTVL	VASFPRTVL
SAAQPGVAF	SAAQPGVAF
YAIGKDVQAM	YAIGKDQAM
GAYVPSLAL	GAYVPSLAL
LAITGGVTL	LAITGGVTL
AATLLHLEL	AATLLHLEL
SVHDPAGAL	SVHDPAGAL
FALAVRKGGAL	LAVRKGGAL
YAFRSAEPNAL	RSAEP-NAL
VADPVYRTF	VADPVYRTF
FITDHVNSL	FITDHVNSL
HAMQFPAEL	HAMQFPAEL
VASEKESVM	VASEKESVM
LTDANIHEL	LTDANIHEL
FALSVTNPL	FALSVTNPL
IAVAITEAL	IAVAITEAL
YALTSPLQL	YALTSPLQL
GAVEKGVPL	GAVEKGVPL
IITPAFAEL	IITPAFAEL
FMEETERSL	FMEETERSL
FATFPSSAFL	FATFPSSAF
FAQTLHPSL	FAQTLHPSL
LASHILTAL	LASHILTAL
VISLEGKPL	VISLEGKPL
MAGPLRAPL	MAGPLRAPL
FIKESTATTFL	FIKESTTTF
FAIRGLAEAL	FAIRGLEAL
FAYYRDLVF	FAYYRDLVF
KAYTSQFVSL	KAYTSQVSL
AAVALAHAL	AAVALAHAL
LAFLGSQSL	LAFLGSQSL
YIVMPNILVL	IVMPNILVL
FTIEVERAL	FTIEVERAL
YAYPGVLLI	YAYPGVLLI
FAEPGRVPF	FAEPGRVPF
YSLDHISSL	YSLDHISSL
AAFGKSPEI	AAFGKSPEI
IAISRTPVLM	IAISRTPVL
LALGSQMTL	LALGSQMTL
YSNVSIHL	YSNVS-IHL
AAINPELLQL	AAINPELQL
FITDPVVL	FITDP-VVL
VASFVKLIL	VASFVKLIL
FGDVTAHLL	FGDVTAHLL
RAMEGELGEL	RAMEGEGEL
AAVSRIVAL	AAVSRIVAL
VAVPASLLGM	VAVPA-SLL
FAAENVQEM	FAAENVQEM
ISSSPTHSL	ISSSPTHSL
IANPTATLL	IANPTATLL
FTGPNIMAM	FTGPNIMAM
YSAEPLPEL	YSAEPLPEL
EIRDVSNLGIF	EIRDV-SNL
FSYTGRVAV	FSYTGRVAV
ISVQPSSSL	ISVQPSSSL
YIPNKVLIL	YIPNKVLIL
FTVNQQPFL	FTVNQQPFL
KAMEYMFGW	KAMEYMFGW
SIVAPGGAL	SIVAPGGAL
TAINHFFIW	TAINHFFIW
YIIGGSVINEL	IGGSVINEL
AAGSHVIIL	AAGSHVIIL
FSFVRITAL	FSFVRITAL
VAIIARTDL	VAIIARTDL
YTGLGKSL	YTGLG-KSL
IIITPGYGL	IIITPGYGL
YAFNGTQRFL	YAFNGTRFL
TSSPSILTL	TSSPSILTL
FINVPPQIAL	FINVPPIAL
LVVDKAMEL	LVVDKAMEL
VALPVVYSL	VALPVVYSL
LAAEGQLTL	LAAEGQLTL
VSAPVTHQL	VSAPVTHQL
AANPIQFTL	AANPIQFTL
TAISRYMEL	TAISRYMEL
SISGITMVL	SISGITMVL
FAINIDNKDL	FAINIDKDL
FIVVNTQSL	FIVVNTQSL
FTSAAFHEL	FTSAAFHEL
FINGDISSL	FINGDISSL
AANKVVLQL	AANKVVLQL
ISYPGAML	ISYPG-AML
FSDVEAHF	FSDVE-AHF
VVAPPGVVV	VVAPPGVVV
FAVLPRLLL	FAVLPRLLL
FVNPVQVVL	FVNPVQVVL
IASAIVNEL	IASAIVNEL
FSVNLFRTL	FSVNLFRTL
YITDFLARL	YITDFLARL
FASETNLDF	FASETNLDF
FTMGGPAISM	FTMGGPISM
LILAPTREL	LILAPTREL
FIVDARPAM	FIVDARPAM
YSVIGRSL	YSVIG-RSL
FGNGWIPTL	FGNGWIPTL
YACEVTHQGL	YACEVTQGL
YAVNSQFTM	YAVNSQFTM
AATSRIAEL	AATSRIAEL
LAVDKSASL	LAVDKSASL
LAVDGLMEM	LAVDGLMEM
AIAEIGNQL	AIAEIGNQL
NTIETFNEL	NTIETFNEL
QAIERYLVV	QAIERYLVV
TAIPVHDGYVL	TAIPVHYVL
LQGPILRL	LQGPI-LRL
YAANPGQLF	YAANPGQLF
FALGLPFLVL	FALGLPLVL
KAGPGSLEL	KAGPGSLEL
SANIGPFL	SANIG-PFL
SSVPGVRLL	SSVPGVRLL
FSINAQRNAL	FSINAQNAL
YAITTLHNL	YAITTLHNL
FTNEAREM	FTNEA-REM
FSYLNPQEL	FSYLNPQEL
YGLLPSHASYL	LLPSHASYL
LAEIFGKVL	LAEIFGKVL
FTQAGVRQL	FTQAGVRQL
FADKTLLEL	FADKTLLEL
FAIETVKNLL	FAIETVKNL
YVFPGVTRL	YVFPGVTRL
LGIPISNIL	LGIPISNIL
MVVDIVQEL	MVVDIVQEL
VTVRPGLAM	VTVRPGLAM
VAVDGINAL	VAVDGINAL
FAIPGSSFL	FAIPGSSFL
LAEGSPRSL	LAEGSPRSL
AAVVVSKSGSL	VVVSKSGSL
VIAPNPAQL	VIAPNPAQL
LAAPGHPPVL	LAAPGHPVL
FQNPSTVTL	FQNPSTVTL
VSTPQIVSL	VSTPQIVSL
VAISAGFLAL	VAISAGLAL
YSDDIPHAL	YSDDIPHAL
GIIDPGSTV	GIIDPGSTV
AAFPGASLYL	AAFPG-ASL
QAISAIQAL	QAISAIQAL
GAYKYIQEL	GAYKYIQEL
SIIGRLLEV	SIIGRLLEV
FAVDSLRQL	FAVDSLRQL
AAVPRAAFL	AAVPRAAFL
AGVPLFLLE	AGVPLFLLE
STIGNFTNL	STIGNFTNL
VAKGPSHSL	VAKGPSHSL
YITDLFQVL	YITDLFQVL
FAGHSGDVM	FAGHSGDVM
FASGAVEL	FASGA-VEL
YAASDMLQL	YAASDMLQL
TASPVAVSL	TASPVAVSL
ILGPTFTL	ILGPT-FTL
FIMEGGAMVL	FIMEGGMVL
FVYSSRLTL	FVYSSRLTL
VACGSHHSM	VACGSHHSM
YAFQTGGKLYL	YAFQTGGKL
SADSLEHVL	SADSLEHVL
YSFYNQQTL	YSFYNQQTL
FAGPHSTL	FAGPH-STL
VADAIRTSL	VADAIRTSL
LGIPHSFAL	LGIPHSFAL
YAEEFRTYL	YAEEFRTYL
VSVDRGSAL	VSVDRGSAL
YGVTVFKAL	YGVTVFKAL
RVAPEEHPVLL	VAPEEHPVL
VIYPARISL	VIYPARISL
YQEVGAKVL	YQEVGAKVL
YALLGKVEL	YALLGKVEL
FSVTGRVL	FSVTG-RVL
YIIVPPLTL	YIIVPPLTL
FTYDQDGESL	FTYDQDESL
FALGAGTAL	FALGAGTAL
FAVDNVGNRTL	FAVDNVRTL
SIFSGAASL	SIFSGAASL
LAAHLGSAL	LAAHLGSAL
FTMDPKLSA	FTMDPKLSA
FQMQTTYVL	FQMQTTYVL
LTIPASLDL	LTIPASLDL
FSYMSKISL	FSYMSKISL
HAVGPSTSL	HAVGPSTSL
ASVGKTSIL	ASVGKTSIL
VAKESIPL	VAKES-IPL
TIYHMFIAL	TIYHMFIAL
FSIADSIEL	FSIADSIEL
VVIEPSSVL	VVIEPSSVL
LGIPIITVL	LGIPIITVL
YNIDSHLLL	YNIDSHLLL
MAANVIPVL	MAANVIPVL
SAIGRAMEL	SAIGRAMEL
PPPPQQERSK	QQERS----
FAFSPDGRHL	FAFSPDRHL
YVHLQPGMSL	YVHLQPMSL
AAMMAVRVL	AAMMAVRVL
LFFVGNQL	LFFVG-NQL
LATRSFPQL	LATRSFPQL
LATASSPKF	LATASSPKF
VAPFMANIPLL	FMANI-PLL
LANPHELSL	LANPHELSL
SAAPLQPVL	SAAPLQPVL
FVNPSLRVL	FVNPSLRVL
WTPPEDYRL	WTPPEDYRL
IAIPDASKL	IAIPDASKL
FAESLRTSL	FAESLRTSL
GTAPPTLAL	GTAPPTLAL
IANAVVKEL	IANAVVKEL
VAQTGSGKTL	VAQTGSKTL
LAFPDVVSL	LAFPDVVSL
FTIFRTISV	FTIFRTISV
YVAIQAVLSL	VAIQAVLSL
GFYPAEITLTW	GFYPAEITL
DAQLQIYTL	DAQLQIYTL
FTHAKTKTL	FTHAKTKTL
WSQDLFRAL	WSQDLFRAL
LASPESLEL	LASPESLEL
MTIENMNHL	MTIENMNHL
YGIEHALAL	YGIEHALAL
YAYLYIRML	YAYLYIRML
FATDSGLEF	FATDSGLEF
VTQLGSQL	VTQLG-SQL
VADGIFKAEL	VADGIFAEL
FTMKTVLML	FTMKTVLML
VTVPPGPSL	VTVPPGPSL
FTFSKDKLVAL	FSKDKLVAL
VIDEPVRL	VIDEP-VRL
MVIAHTKSL	MVIAHTKSL
VACGLNHTL	VACGLNHTL
FASELSRSL	FASELSRSL
IAAVPATAM	IAAVPATAM
FTADPLSLL	FTADPLSLL
YTIPPGHQV	YTIPPGHQV
FAVGVQQVL	FAVGVQQVL
VAVPTLNAL	VAVPTLNAL
YVIEPHSMEF	YVIEP-HSM
VAYMNPIAM	VAYMNPIAM
VAPEEHPVLL	VAPEEHPVL
SAQDRQLTL	SAQDRQLTL
YLIARVMLL	YLIARVMLL
ISNSHPLSL	ISNSHPLSL
LAFSVTGTSL	LAFSVTTSL
AIIPYFITL	AIIPYFITL
YAIESQLQL	YAIESQLQL
FQFGVPQAL	FQFGVPQAL
FVHDLVLYL	FVHDLVLYL
LSSPPTESL	LSSPPTESL
YAMENHSL	YAMEN-HSL
LGGPPLLL	LGGPP-LLL
KAMPITLHL	KAMPITLHL
FTVMPGQTL	FTVMPGQTL
TSVPSRSSSAL	SVPSRSSAL
TSVPVSAVF	TSVPVSAVF
FAVIAHVGM	FAVIAHVGM
IISPLFAEL	IISPLFAEL
VSMSPRVY	VSMSP-RVY
LTMLPRLVL	LTMLPRLVL
VATQVGIEW	VATQVGIEW
TAIVGMAL	TAIVG-MAL
MAALPFTKSL	AALPFTKSL
VAVGSGLSW	VAVGSGLSW
FAFEGIGDEDL	FAFEGIEDL
FAAVEGIFF	FAAVEGIFF
FSAPRHGSL	FSAPRHGSL
LAAPMILSL	LAAPMILSL
RIDEARQEL	RIDEARQEL
WAEEGQRVL	WAEEGQRVL
ESEQFLTEL	ESEQFLTEL
YSKPGLSM	YSKPG-LSM
YAQEDPRML	YAQEDPRML
FTVPANQAF	FTVPANQAF
AALYHGMAL	AALYHGMAL
NSNPVIAEL	NSNPVIAEL
NAVGLFSRL	NAVGLFSRL
TATFAISIL	TATFAISIL
FAMAGHENL	FAMAGHENL
LIISPTREL	LIISPTREL
HVITKTMEL	HVITKTMEL
YISAKPLEM	YISAKPLEM
FLPEFAGTQL	FLPEFATQL
YALQFPEKPL	YALQFPKPL
YAAQAHLKL	YAAQAHLKL
QAIPVTSEL	QAIPVTSEL
YTINVWDVL	YTINVWDVL
LMMDPLTGL	LMMDPLTGL
FGWSHLEAL	FGWSHLEAL
FAEKLSREL	FAEKLSREL
LLGPTVML	LLGPT-VML
VATGVISTL	VATGVISTL
AAYHLIIEL	AAYHLIIEL
ITVGPRGPL	ITVGPRGPL
AACDPRHGRYL	AACDPRRYL
STLNRFSAL	STLNRFSAL
FSYQGRASSL	FSYQGRSSL
FAGFGIGL	FAGFG-IGL
LALPGKPPFL	LALPGKPFL
LAFSNDGTTL	FSNDG-TTL
FVAETHIVL	FVAETHIVL
ATPEQPVLDL	ATPEQ-PVL
LATDFIQSL	LATDFIQSL
FTVPKNRSL	FTVPKNRSL
SAVGKTSLL	SAVGKTSLL
KAHLGTAL	KAHLG-TAL
LALETTNSL	LALETTNSL
LATDFIQSLL	LATDFIQSL
LAVEAVLRL	LAVEAVLRL
IALLKAIIL	IALLKAIIL
AAIFHYLII	AAIFHYLII
YAEPAAGREL	YAEPAAREL
YAYTGRLEL	YAYTGRLEL
FTQPNIEL	FTQPN-IEL
HVFIGGTPL	HVFIGGTPL
YTEDEAKEL	YTEDEAKEL
NIHVGNFL	NIHVG-NFL
ITYPQGLAL	ITYPQGLAL
GASPIGPTL	GASPIGPTL
YIVKWPLSL	YIVKWPLSL
YSIAQFKYL	YSIAQFKYL
VAYPGIPKL	VAYPGIPKL
SVKSPNQSL	SVKSPNQSL
IAMENIHSEM	IAMENISEM
FAHPPLLVL	FAHPPLLVL
FAEGSTLKL	FAEGSTLKL
YTTDRVMTV	YTTDRVMTV
NADPIAKYL	NADPIAKYL
LSKDSILSL	LSKDSILSL
LAGPVLGL	LAGPV-LGL
TAIRSGLEL	TAIRSGLEL
YALGKDFVTL	YALGKDVTL
YAYPATAAAPM	YAYPATAAA
LALDASQHSSL	LALDASSSL
FTAGGAIEF	FTAGGAIEF
VVQAARAL	VVQAA-RAL
ASLHVMMTL	ASLHVMMTL
YIFPGVAL	YIFPG-VAL
MIIENFEAL	MIIENFEAL
YAYRDAVFL	YAYRDAVFL
YANAKIYKL	YANAKIYKL
YAQIRTIAI	YAQIRTIAI
VSQVGKEL	VSQVG-KEL
RAAPGAEF	RAAPG-AEF
LILPGYIDF	LILPGYIDF
HAMESTRESL	HAMESTESL
WASEVGPVL	WASEVGPVL
FAVGLGPRL	FAVGLGPRL
GAAAWARPL	GAAAWARPL
FTVRPGELL	FTVRPGELL
LLLPAGIAL	LLLPAGIAL
FSHSVGTSL	FSHSVGTSL
YSDDHVKFF	YSDDHVKFF
MSSPLSKEL	MSSPLSKEL
YAISPGLDI	YAISPGLDI
NAIANASTL	NAIANASTL
YITAAYVEM	YITAAYVEM
YTIENPRHF	YTIENPRHF
AAIAFLHAL	AAIAFLHAL
TALNLFFKL	TALNLFFKL
TAMDVVYAL	TAMDVVYAL
LAVVVTKEM	LAVVVTKEM
AAYGFRLQSL	AAYGFRQSL
FTADVRSVL	FTADVRSVL
FTIPHTQEAF	FTIPHTQEA
RALDAGLAL	RALDAGLAL
YAYLNVVGM	YAYLNVVGM
FSVPGGHNL	FSVPGGHNL
YAVEGRDLTL	YAVEGRLTL
FSKSGRLL	FSKSG-RLL
SAAMVFSAL	SAAMVFSAL
FANDGSFLEL	FANDGSLEL
MIIGNGGIAL	IIGNGGIAL
LTDPDIHVL	LTDPDIHVL
LALAIAQEL	LALAIAQEL
FALPFGRTA	FALPFGRTA
QAMPTLIEL	QAMPTLIEL
VINDWFKVL	VINDWFKVL
VSNDWLIL	VSNDW-LIL
NAFRGGGSL	NAFRGGGSL
LLPSHPLEL	LLPSHPLEL
YAKNGQDL	YAKNG-QDL
LTAEHFAAL	LTAEHFAAL
IAQEAGHDL	IAQEAGHDL
FYLPLDAIKQL	LPLDAIKQL
FSDEIRHNL	FSDEIRHNL
YAHPLETLIL	YAHPL-ETL
IIHEIAVLEL	IIHEIALEL
FSHPQAAQL	FSHPQAAQL
KITDAFSSL	KITDAFSSL
SAVSIFHEL	SAVSIFHEL
IAIEDPFSV	IAIEDPFSV
AATTVLQEL	AATTVLQEL
YLLEKSRVI	YLLEKSRVI
VVNGRVLEL	VVNGRVLEL
LAEAGVRLL	LAEAGVRLL
YVIQKFFEF	YVIQKFFEF
YVYSHFLQF	YVYSHFLQF
YAAYPLTEV	YAAYPLTEV
LADVKVHIL	LADVKVHIL
LVNGKSLEL	LVNGKSLEL
FATDAILAT	FATDAILAT
YFIPATGHSL	FIPATGHSL
MVVGTGTSL	MVVGTGTSL
TALSFFHML	TALSFFHML
FIVEQYKHL	FIVEQYKHL
LATPVDLKL	LATPVDLKL
FAYPNRPDVL	FAYPNRDVL
ISIDRFLAV	ISIDRFLAV
FALGAGTALL	FALGAGTAL
VSYYEKHSL	VSYYEKHSL
KTIPSWATL	KTIPSWATL
YSQSPALEL	YSQSPALEL
VAMNPTNTVF	VAMNPTNTV
VATKDTRAL	VATKDTRAL
KADGVPVYL	KADGVPVYL
AIVKPGVPM	AIVKPGVPM
YSKIGPAL	YSKIG-PAL
LAMRPLASL	LAMRPLASL
YAFPKAVTV	YAFPKAVTV
LAITTEHTL	LAITTEHTL
YLLDLHSYL	YLLDLHSYL
MAYFPAISL	MAYFPAISL
FTNRTVLEL	FTNRTVLEL
WAIENPAVF	WAIENPAVF
FAHSFIEL	FAHSF-IEL
YAWLVPLAL	YAWLVPLAL
VANTMRTSL	VANTMRTSL
RTFEAFMYL	RTFEAFMYL
SVIQHTNSL	SVIQHTNSL
IAVANAQEL	IAVANAQEL
YFFVDPDL	YFFVD-PDL
FAHTNVESL	FAHTNVESL
FTDGGPRTL	FTDGGPRTL
FSHEVGSEL	FSHEVGSEL
SIILPQTEL	SIILPQTEL
LAHLGRHM	LAHLG-RHM
LSVRPQTAL	LSVRPQTAL
FAEEPGLVL	FAEEPGLVL
FASRIIDSL	FASRIIDSL
VACGESHSL	VACGESHSL
SIVSVAAHL	SIVSVAAHL
FSHSRMEEL	FSHSRMEEL
FAMTGERVDL	FAMTGEVDL
YAFGRVFSGL	YAFGRVSGL
AVEEKFRAL	AVEEKFRAL
RLLDWFRSL	RLLDWFRSL
KAVDQPRQL	KAVDQPRQL
LGYTSGLSL	LGYTSGLSL
YASLRIEEL	YASLRIEEL
FLDEKTHEL	FLDEKTHEL
LAYLQRIAL	LAYLQRIAL
GAVDPLLAL	GAVDPLLAL
FAHGTAGLVFL	FAHGTALVF
FAIPMIHAV	FAIPMIHAV
YAKDDPLEF	YAKDDPLEF
NAAGVPKQSL	AAGVPKQSL
VAYPRTGGTL	VAYPRTGTL
LAAGVVSAM	LAAGVVSAM
YTNGSFGSNF	YTNGSFSNF
FSHNGRIL	FSHNG-RIL
VAPSRLDF	VAPSR-LDF
FAHHGRSL	FAHHG-RSL
FSITPLSEL	FSITPLSEL
FTHASPTL	FTHAS-PTL
IAYDVTYSL	IAYDVTYSL
YSKSSHPL	YSKSS-HPL
FSSANSPFL	FSSANSPFL
YAFSGVEEL	YAFSGVEEL
LSTPFGQAL	LSTPFGQAL
VILEPMQEL	VILEPMQEL
LIYEDSIVL	LIYEDSIVL
FAVATPEEL	FAVATPEEL
LAVHPSGVAL	LAVHPSVAL
VVTVPSSSL	VVTVPSSSL
LASPEGKTL	LASPEGKTL
FTNGQTVNL	FTNGQTVNL
SAVGHVFSL	SAVGHVFSL
FLQEHNTTL	FLQEHNTTL
AAISTSRVL	AAISTSRVL
VVFVGNFL	VVFVG-NFL
VILRKNPNYDL	VILRKNPNY
NILDRFLAL	NILDRFLAL
YSDSFPMEL	YSDSFPMEL
SAIGYIHSL	SAIGYIHSL
VAYSHDGAFL	YSHDG-AFL
FSHAQTVVL	FSHAQTVVL
FILEHIMVI	FILEHIMVI
VVVAVGRAL	VVVAVGRAL
FVDTEIRL	FVDTE-IRL
FVVPNQKEL	FVVPNQKEL
YALAARDVFL	YALAARVFL
LSVISSPQL	LSVISSPQL
SVNGFISTL	SVNGFISTL
VVTITIMPAF	VTITIMPAF
YTTDFIFNL	YTTDFIFNL
YIAEPSMHSM	IAEPSMHSM
FSAPTPIQAL	FSAPTPQAL
YIYPNIIAM	YIYPNIIAM
TAKPPKEIL	TAKPPKEIL
FLVNHDFSPL	LVNHDFSPL
AAVDAGMAM	AAVDAGMAM
STIDKVSVL	STIDKVSVL
LADPVSNMAM	LADPVSMAM
FQTIARNAL	FQTIARNAL
FGLETWVM	FGLET-WVM
TIIDKSKSV	TIIDKSKSV
KADPDHKEL	KADPDHKEL
YAKDYTKAL	YAKDYTKAL
SAVSHFFSL	SAVSHFFSL
FILGHLRTL	FILGHLRTL
FTLSHITQL	FTLSHITQL
FATQQFVAL	FATQQFVAL
AALPFTKSL	AALPFTKSL
LAYIAHPKL	LAYIAHPKL
FANGRSTGL	FANGRSTGL
FLINFIHTL	FLINFIHTL
VIIKPSEL	VIIKP-SEL
FSLLPLSHL	FSLLPLSHL
LAYPFQSLL	LAYPFQSLL
YAAGVHSVL	YAAGVHSVL
AAMKALQAL	AAMKALQAL
VSVDISHTL	VSVDISHTL
VSQDPRHMVL	VSQDPRMVL
AAAPSLLIL	AAAPSLLIL
AAASPLLLL	AAASPLLLL
FVNPHVSSF	FVNPHVSSF
HALPPSLIPL	HALPPSIPL
LSDDHVLIL	LSDDHVLIL
YSKLKKERPDF	YSKLK-KER
AAIVAKQVL	AAIVAKQVL
FAAASREVL	FAAASREVL
ATVHPGLEL	ATVHPGLEL
LANVSTVL	LANVS-TVL
LATAAALTY	LATAAALTY
AAYYPSDVSSL	AAYYPSSSL
FGVDPYNVL	FGVDPYNVL
FIEDAVHVL	FIEDAVHVL
AAADVLEAL	AAADVLEAL
YASDYFDQL	YASDYFDQL
FSHHRVTVL	FSHHRVTVL
YLGKVLEL	YLGKV-LEL
NAHFPQSEL	NAHFPQSEL
LSSPHGGAL	LSSPHGGAL
FAWPQPASL	FAWPQPASL
FALDGLKQVM	FALDGLKQV
FTEPGAGLRAL	FTEPGARAL
YMLEHVITL	YMLEHVITL
YASTGREF	YASTG-REF
LSNHVFNAL	LSNHVFNAL
FVSDPLSDL	FVSDPLSDL
AAAHFYFEL	AAAHFYFEL
YANFNRIIL	YANFNRIIL
TIQADTPAL	TIQADTPAL
VAMYGGLVL	VAMYGGLVL
IVVEGHEL	IVVEG-HEL
IAIPFLIKL	IAIPFLIKL
FATFPSSAF	FATFPSSAF
LASAIINTL	LASAIINTL
LAENRFTVL	LAENRFTVL
FTVKLPVAL	FTVKLPVAL
LALGNTKEL	LALGNTKEL
YALTAIMKL	YALTAIMKL
IADPRGNTL	IADPRGNTL
FSFHHVLSL	FSFHHVLSL
KAIGLFISF	KAIGLFISF
ATDDPAARF	ATDDPAARF
AALPKATIL	AALPKATIL
FALGAALQL	FALGAALQL
YVSPRILTA	YVSPRILTA
DALVFGHL	DALVF-GHL
FYVPFAKAL	FYVPFAKAL
WAFPSKAL	WAFPS-KAL
VANEPASHL	VANEPASHL
FAVLEDHTL	FAVLEDHTL
FAIRWGFIPL	FAIRWGIPL
FAVSSKVTSM	FAVSSKTSM
TSHPHAMEL	TSHPHAMEL
SAYLSKEL	SAYLS-KEL
LADEKMKQL	LADEKMKQL
VAFGPAFAL	VAFGPAFAL
AAAAPSPVL	AAAAPSPVL
YAINFIHAT	YAINFIHAT
VSMPVFQSL	VSMPVFQSL
TASPVIKAV	TASPVIKAV
FAKPVYPGQTL	FAKPVYQTL
VNNPHFLIM	VNNPHFLIM
FITPTGHSL	FITPTGHSL
LAIDSIHQL	LAIDSIHQL
SVVAVPLPL	SVVAVPLPL
YSMPISIEF	YSMPISIEF
LAAGHLVQL	LAAGHLVQL
LAVNLTRVL	LAVNLTRVL
YSIGVNGHL	YSIGVNGHL
SACHVSNTL	SACHVSNTL
SVAKESIPL	SVAKESIPL
FAEGKPLEL	FAEGKPLEL
FSMDIIDSL	FSMDIIDSL
FTDAGLKEL	FTDAGLKEL
FAFPGEILM	FAFPGEILM
YSKLPGVSL	YSKLPGVSL
FTMGGPAI	FTMGG-PAI
FAIHKKIVL	FAIHKKIVL
FTNANREL	FTNAN-REL
SIVKPYLTL	SIVKPYLTL
LVVEGQAVSL	VVEGQAVSL
VSIRTGLEL	VSIRTGLEL
AAANPTLAF	AAANPTLAF
FAIDSSHPWL	FAIDSSPWL
VSFPYVIAL	VSFPYVIAL
STFSPSLAL	STFSPSLAL
HTNPNFQTL	HTNPNFQTL
SSIDPGLSI	SSIDPGLSI
YAVGDVKCL	YAVGDVKCL
AAAPPSPAW	AAAPPSPAW
VVIGKMLIL	VVIGKMLIL
LAIPVFLTL	LAIPVFLTL
VLPEHVSVL	VLPEHVSVL
YGDLGGPII	YGDLGGPII
LIISNTKSL	LIISNTKSL
SAVSQSKEL	SAVSQSKEL
DASGPDPQL	DASGPDPQL
IAQGSYIAL	IAQGSYIAL
VVAPAGITL	VVAPAGITL
FAEGKPLAL	FAEGKPLAL
NIDEAYKIL	NIDEAYKIL
FAIGGSGSTF	FAIGGSSTF
AAVPDSVAL	AAVPDSVAL
IAASRSAVM	IAASRSAVM
FSYAFPKEF	FSYAFPKEF
MTILGSAVL	MTILGSAVL
FATIRTASL	FATIRTASL
FAEGQGRAL	FAEGQGRAL
FAVGSFHTL	FAVGSFHTL
FIPATGHSL	FIPATGHSL
IAIKYSRTL	IAIKYSRTL
YTLVTGLFA	YTLVTGLFA
AAGPRPMAL	AAGPRPMAL
FALIPTALDAL	FALIP-TAL
FTLDPLYREL	FTLDPLREL
FQMESQKFL	FQMESQKFL
KSVDPTLAL	KSVDPTLAL
VATAMARVL	VATAMARVL
FLPEAPAEL	FLPEAPAEL
SAIGPFSGL	SAIGPFSGL
LAIEGAQAF	LAIEGAQAF
FSVEQITAM	FSVEQITAM
SAQTTSHEL	SAQTTSHEL
TALPSFTSL	TALPSFTSL
VSDFGGRSL	VSDFGGRSL
ATIPPISSL	ATIPPISSL
FSVQETQTL	FSVQETQTL
FAATHSLEF	FAATHSLEF
YAATETPHL	YAATETPHL
AALPAELQREL	AALPAEREL
IANDRFINM	IANDRFINM
RAYAKFYTL	RAYAKFYTL
FSDDSDLQL	FSDDSDLQL
FLIPKFFEL	FLIPKFFEL
YVQDPFAAL	YVQDPFAAL
FIAPTGHSL	FIAPTGHSL
FAMDVYKNL	FAMDVYKNL
YTSPVNPAV	YTSPVNPAV
KADSRLKAL	KADSRLKAL
FIQAVRQTL	FIQAVRQTL
EATDIALLL	EATDIALLL
KASDPASSL	KASDPASSL
YGLDLHPTI	YGLDLHPTI
LAQKNGRVL	LAQKNGRVL
SVVDVFAQL	SVVDVFAQL
NAPWAVTSL	NAPWAVTSL
AADAALRVL	AADAALRVL
FSVENKWSL	FSVENKWSL
AAVKVIQSL	AAVKVIQSL
YAFDFARQS	YAFDFARQS
VIIPRYLTL	VIIPRYLTL
FAKPENIDL	FAKPENIDL
FSFGGKLVTF	FSFGGKVTF
RATPHFSGL	RATPHFSGL
FVDEGIKTL	FVDEGIKTL
LSRTGVEL	LSRTG-VEL
VIMGLSPIL	VIMGLSPIL
YAFSARPL	YAFSA-RPL
TAGDYSRPL	TAGDYSRPL
FAIRGVVL	FAIRG-VVL
FILEPRSFL	FILEPRSFL
FALSEAMGL	FALSEAMGL
IALSEPQL	IALSE-PQL
FTVTVPKDL	FTVTVPKDL
LATSTSNTL	LATSTSNTL
AATAVTQAL	AATAVTQAL
ALSHILTAL	ALSHILTAL
FAALGTMTSL	AALGTMTSL
FINTVITSL	FINTVITSL
YATLFAQAL	YATLFAQAL
GAINHVLQL	GAINHVLQL
VALPMVLVL	VALPMVLVL
VAEHHVATL	VAEHHVATL
AVLPFSPAL	AVLPFSPAL
YAIEPGTPPLL	YAIEPGPPL
SAINQVEAL	SAINQVEAL
FLLPVINEM	FLLPVINEM
ITLLREISL	ITLLREISL
FIVPTGKTGL	FIVPTGTGL
MSVEVRQTL	MSVEVRQTL
FAYEGPMYL	FAYEGPMYL
YASGINVNL	YASGINVNL
FTVGSNGKNVF	FTVGSNKNV
IVVPAGVEL	IVVPAGVEL
QALPWISIL	QALPWISIL
LSQVRFLVL	LSQVRFLVL
YAVHEGLGL	YAVHEGLGL
TAMKKGETL	TAMKKGETL
LAEVGRVL	LAEVG-RVL
VAYLQAHAL	VAYLQAHAL
IAVDPRHLSL	IAVDPRLSL
AAVAPGHPL	AAVAPGHPL
FAIKSLRKL	FAIKSLRKL
LALDHLHSL	LALDHLHSL
YTNLGPRL	YTNLG-PRL
VSVPPTRQSL	VSVPPTQSL
IAQGIGTEL	IAQGIGTEL
AAAPHLLL	AAAPH-LLL
AALDKATVL	AALDKATVL
ASAPDPPVL	ASAPDPPVL
FAVHVESVL	FAVHVESVL
WSIPWKWL	WSIPW-KWL
IIINPSSSL	IIINPSSSL
FTSHPQEL	FTSHP-QEL
YAIRGVPSL	YAIRGVPSL
SIIGSARSL	SIIGSARSL
IARLPSSTL	IARLPSSTL
VACGSAHTL	VACGSAHTL
SASGPHSSL	SASGPHSSL
LAARASLDL	LAARASLDL
YAKRPGIGL	YAKRPGIGL
IIHDPGRGAPL	IIHDPGRGA
EADPFLHRL	EADPFLHRL
SADGMRLAL	SADGMRLAL
FTFDQDPSVL	FTFDQDSVL
AAMKNVTEL	AAMKNVTEL
ISRVGQAM	ISRVG-QAM
FALVGSYTL	FALVGSYTL
FGISSVPTKGL	ISSVPTKGL
YAFPVSNNL	YAFPVSNNL
KASDLYITL	KASDLYITL
LAYPARPAQL	LAYPARAQL
FATIRFHDL	FATIRFHDL
FSVPHTKSL	FSVPHTKSL
YALPAGLSA	YALPAGLSA
HADDSFLVL	HADDSFLVL
YIHVGAQL	YIHVG-AQL
VAVDVNNML	VAVDVNNML
RAFEVSENGNL	FEVSENGNL
TALGTFLFL	TALGTFLFL
VAEEKMRLL	VAEEKMRLL
GAISKIFVL	GAISKIFVL
IAHNMQSTL	IAHNMQSTL
ITVKDGKTL	ITVKDGKTL
FANDDRHVM	FANDDRHVM
LIYQGRVL	LIYQG-RVL
VSIVGMAL	VSIVG-MAL
YVFDGKPPQL	YVFDGKPQL
QATMPHLSM	QATMPHLSM
HAVGPSTAM	HAVGPSTAM
LAYLRLNTL	LAYLRLNTL
YAQEHGLNF	YAQEHGLNF
LAFDPSGQRL	LAFDPSQRL
YSVYVYKVL	YSVYVYKVL
YLNETFSEL	YLNETFSEL
TSVPPGSAL	TSVPPGSAL
FANGRSTGLIL	FANGRSTGL
FIFDEAEKL	FIFDEAEKL
VAVRESPQL	VAVRESPQL
YAGLDHEL	YAGLD-HEL
VATHSTLVL	VATHSTLVL
FVSSFMSEL	FVSSFMSEL
YAISKPEVL	YAISKPEVL
FTWVGLEM	FTWVG-LEM
YLQDEFRIL	YLQDEFRIL
LANGQTKVL	LANGQTKVL
LKETRAFPI	LKETRAFPI
AAVPPGSLL	AAVPPGSLL
YAINQPDVL	YAINQPDVL
HVPEHAVVL	HVPEHAVVL
FTPAVHASL	FTPAVHASL
ITSDPGLSL	ITSDPGLSL
NADPNMKLF	NADPNMKLF
TAIAESPVI	TAIAESPVI
SAIGYLHSL	SAIGYLHSL
QAQEPLHSL	QAQEPLHSL
IAGGAGPGWVL	GGAGPGWVL
FLLDPYKYMTL	FLLDPYKYM
LAFSRALEL	LAFSRALEL
HLDEAIHVL	HLDEAIHVL
FSAESSRSL	FSAESSRSL
VAFDKFWNM	VAFDKFWNM
VGVPVGSAL	VGVPVGSAL
FSDFEARQL	FSDFEARQL
VAVHVFSEF	VAVHVFSEF
YSDLRKESM	YSDLRKESM
KAFNWFSTL	KAFNWFSTL
FAISILQQI	FAISILQQI
YFAERVTSL	YFAERVTSL
MVDGKPVNL	MVDGKPVNL
SAIASTKVM	SAIASTKVM
LAAESKTVL	LAAESKTVL
LVSSWDTSVRL	SSWDTSVRL
MIIEDPAAL	MIIEDPAAL
HADVGKEL	HADVG-KEL
IADSGLKIL	IADSGLKIL
TAVAKNQAL	TAVAKNQAL
FAPKMSEIIL	FAPKMSIIL
AALPVYQEL	AALPVYQEL
ASYLRLWAL	ASYLRLWAL
LSYTRFSL	LSYTR-FSL
LADVAHIL	LADVA-HIL
FSTVVIHFL	FSTVVIHFL
YVQDYEDFM	YVQDYEDFM
QAFPGLLQL	QAFPGLLQL
ITLHVFWEL	ITLHVFWEL
YAIFDEGHML	AIFDEGHML
NAIREVLEL	NAIREVLEL
MAFDPTSTL	MAFDPTSTL
FADLGYKQM	FADLGYKQM
LAFPGETL	LAFPG-ETL
FASPNGEQF	FASPNGEQF
YAGYIPQAF	YAGYIPQAF
SSTPIAPVF	SSTPIAPVF
SAAEAYQVL	SAAEAYQVL
SSVGKVSVL	SSVGKVSVL
SAIFPDVAL	SAIFPDVAL
KTIETSPSL	KTIETSPSL
KAFNYFSSL	KAFNYFSSL
FAFDSEGNYML	FAFDSENYM
NAFSGVMML	NAFSGVMML
LAYPGSATI	LAYPGSATI
TIIEFTREL	TIIEFTREL
FSNPRALYL	FSNPRALYL
IVVAPSQTL	IVVAPSQTL
TVIHHVHSL	TVIHHVHSL
MIHLGHIL	MIHLG-HIL
IANGDIRSL	IANGDIRSL
SIISPKVKMAL	IISPKVMAL
LAYEPFSTL	LAYEPFSTL
SAVDVHINM	SAVDVHINM
FATMVRPVA	FATMVRPVA
VARVWSLMRF	VARVW-SLM
IIVPIFLLL	IIVPIFLLL
ISVDSRSVSL	SVDSRSVSL
FAGGHPAQL	FAGGHPAQL
IALKAGKTL	IALKAGKTL
HADASSKVL	HADASSKVL
FAYPAIRYL	FAYPAIRYL
VASSRSSVL	VASSRSSVL
ASAAAALVL	ASAAAALVL
YASTAKCL	YASTA-KCL
SAVPVGFFL	SAVPVGFFL
YIVPRAAIF	YIVPRAAIF
YSMPSTHAM	YSMPSTHAM
FVYLSNVVL	FVYLSNVVL
HAHLSQTTL	HAHLSQTTL
LAAAMVRVL	LAAAMVRVL
FSDPIHPQL	FSDPIHPQL
SAHSHFISL	SAHSHFISL
FLFPPAESL	FLFPPAESL
VALPGVAVSM	VALPGVVSM
LSVPRSVPL	LSVPRSVPL
YGYSNPKIL	YGYSNPKIL
SATYSNRAL	SATYSNRAL
AAINRQINL	AAINRQINL
AAYNGHCEAL	AAYNGHEAL
IAWPPPTEL	IAWPPPTEL
FAAEGLKL	FAAEG-LKL
LAHPYFESL	LAHPYFESL
LAINGSNLPR	LAING-SNL
HATDRFRSL	HATDRFRSL
FSVPLPARL	FSVPLPARL
YAIGNAPEL	YAIGNAPEL
STDVAKTF	STDVA-KTF
VIIGSTHVL	VIIGSTHVL
LIVEPSREL	LIVEPSREL
FSSQRSGL	FSSQR-SGL
FIEPNVRFW	FIEPNVRFW
VAFSPVTEL	VAFSPVTEL
FADEVRLSF	FADEVRLSF
FAINNSKSF	FAINNSKSF
TIIEATHVL	TIIEATHVL
FANNPREL	FANNP-REL
FSEPFGRDL	FSEPFGRDL
LASPPWRVL	LASPPWRVL
FSVKAGEAL	FSVKAGEAL
VIVNNKGEM	VIVNNKGEM
YSNMGNTL	YSNMG-NTL
TIIRQNQAL	TIIRQNQAL
FSSEVTAAL	FSSEVTAAL
YAIPKFKHL	YAIPKFKHL
VVVQPYNSL	VVVQPYNSL
ISEEGFHYL	ISEEGFHYL
FAANVYEAF	FAANVYEAF
PELQPLAGSL	ELQPLAGSL
ISHLGTPL	ISHLG-TPL
AAYYHPSYL	AAYYHPSYL
IANENHSTL	IANENHSTL
FVHPKPVSL	FVHPKPVSL
FAAEAQKL	FAAEA-QKL
QVEDAFRYM	QVEDAFRYM
FAGDIANQL	FAGDIANQL
VANPNSAIF	VANPNSAIF
IVYPGIAVF	IVYPGIAVF
FANTRIENF	FANTRIENF
FASLPDPVL	FASLPDPVL
FTYRGVDL	FTYRG-VDL
TVIRHGETL	TVIRHGETL
IALGEFSTL	IALGEFSTL
YTYIGPVL	YTYIG-PVL
FLQDTRLAL	FLQDTRLAL
SAITTLMHL	SAITTLMHL
LAVEYVDSL	LAVEYVDSL
YAFQTEGKLYL	FQTEGKLYL
AAAYPHTSL	AAAYPHTSL
YAISNAEAF	YAISNAEAF
YANIGKTL	YANIG-KTL
FAGLVQEI	FAGLV-QEI
YAEMGTRTF	YAEMGTRTF
IAAGIFNDL	IAAGIFNDL
YAYDGKDYIAL	YAYDGKIAL
FVAPPGNISL	FVAPPGISL
GAVETFMKL	GAVETFMKL
LSHSLLVTL	LSHSLLVTL
FVNVQKEL	FVNVQ-KEL
IIAPSLGF	IIAPS-LGF
YTVPAGMTV	YTVPAGMTV
IIEEAKRSL	IIEEAKRSL
LAEDKHKEL	LAEDKHKEL
ATNPISRVL	ATNPISRVL
VAQPNSRVL	VAQPNSRVL
LMEAVAVLV	LMEAVAVLV
FSHVGWLL	FSHVG-WLL
IAAMPLISL	IAAMPLISL
FASGGGREL	FASGGGREL
SAVSRAGSL	SAVSRAGSL
VAVQHFSLL	VAVQHFSLL
VIAQGIGKL	VIAQGIGKL
FAIPMIHAVL	FAIPMIAVL
YADPSILYI	YADPSILYI
VAAPPPKNSF	VAAPPPNSF
FTHLGLDL	FTHLG-LDL
FAYSDSRVGF	FAYSDSRVG
FADGFVKAL	FADGFVKAL
YTNPSGIVL	YTNPSGIVL
KAADVGISL	KAADVGISL
IAQPVRSFL	IAQPVRSFL
VAFSPTGKYL	VAFSPTKYL
LSDVNVERVL	LSDVNVRVL
SAILRSPAF	SAILRSPAF
TAHSRPVTL	TAHSRPVTL
YTLINHRVL	YTLINHRVL
AAFLAKDFNFL	FLAKDFNFL
LAAKSGQSF	LAAKSGQSF
PSLSHNLL	PSLSH-NLL
KINEAFIEM	KINEAFIEM
LAVLGHEL	LAVLG-HEL
ISNPNSIIL	ISNPNSIIL
RSNEHIREL	RSNEHIREL
SAMDLPDVTL	SAMDLPVTL
IVMEHVVFL	IVMEHVVFL
YSWLGETL	YSWLG-ETL
ISLEGKPL	ISLEG-KPL
KAGPILEL	KAGPI-LEL
KAIEVLLTL	KAIEVLLTL
FANLKYVSL	FANLKYVSL
FTMPLHMTF	FTMPLHMTF
MAYNAPSL	MAYNA-PSL
FAVGPGHGI	FAVGPGHGI
TIDPIPHQL	TIDPIPHQL
AAVDRTTEL	AAVDRTTEL
FIVEETLPL	FIVEETLPL
FAIDPHLL	FAIDP-HLL
TAVMPKVSL	TAVMPKVSL
LAAKEGLLL	LAAKEGLLL
YASGRTTGIVM	YASGRTTGI
FAINSNNPWL	FAINSNPWL
FAQEAISVL	FAQEAISVL
IVINPKTTL	IVINPKTTL
ASVDKVLEL	ASVDKVLEL
NIGWSTVNL	NIGWSTVNL
GAVLPSGNTL	AVLPSGNTL
LAYDTQLVL	LAYDTQLVL
FGHYQQAEL	FGHYQQAEL
YTCPVITNL	YTCPVITNL
LSLEGKPL	LSLEG-KPL
NAINITSAL	NAINITSAL
AAVRHVLAL	AAVRHVLAL
MAEPFTKAL	MAEPFTKAL
FAVGTRKAL	FAVGTRKAL
FALPTTVWL	FALPTTVWL
FADPHSKRVF	FADPHSRVF
FIYTSELEL	FIYTSELEL
YQEKGVRVL	YQEKGVRVL
AALWRFAEL	AALWRFAEL
FVAPPTAAV	FVAPPTAAV
LIIVPLSTL	LIIVPLSTL
VVGPSSVL	VVGPS-SVL
FADSTVRVW	FADSTVRVW
FTQPSRLLSL	FTQPSRLSL
FSIPFAPHI	FSIPFAPHI
YADPTKRLEL	YADPTKLEL
VAFVGGIDL	VAFVGGIDL
TADPEKRKL	TADPEKRKL
YAVFNEDGSL	YAVFNEGSL
SAAGPGFSL	SAAGPGFSL
LILTPTREL	LILTPTREL
RSMYLMIKAF	SMYLMIKAF
LAIIPHVTI	LAIIPHVTI
YILTSKEL	YILTS-KEL
FADPHGKVF	FADPHGKVF
YSYDLSHSL	YSYDLSHSL
YTMVYWHAL	YTMVYWHAL
SAQTGARAL	SAQTGARAL
YAYLKAIVL	YAYLKAIVL
AAAIKALEL	AAAIKALEL
FVVPRAALL	FVVPRAALL
SVIGHHETL	SVIGHHETL
FAQMYQKTL	FAQMYQKTL
SSMYPPHPL	SSMYPPHPL
SALERLTTL	SALERLTTL
VADPIIYVL	VADPIIYVL
YALPHAIL	YALPH-AIL
FSFEGPEI	FSFEG-PEI
FSQPVFPYL	FSQPVFPYL
SINDKIIEL	SINDKIIEL
YAGRQTEAL	YAGRQTEAL
FAFESVVAI	FAFESVVAI
FAAGIIAHL	FAAGIIAHL
YLGYLEQLLR	LGYLE-QLL
FIGYPITL	FIGYP-ITL
IAYSPDGKYL	IAYSPDKYL
KASPVSSSL	KASPVSSSL
FVPPQGSPTM	FVPPQGPTM
FSQPSLTTL	FSQPSLTTL
YAIGVSHPL	YAIGVSHPL
FSEGGERLL	FSEGGERLL
MTKLGHEL	MTKLG-HEL
YLLESVNKL	YLLESVNKL
FLEGRHAEL	FLEGRHAEL
FASIPGLEF	FASIPGLEF
TAITRAQSL	TAITRAQSL
IAFHSAVSL	IAFHSAVSL
VAILRHPTL	VAILRHPTL
LSKTSRAL	LSKTS-RAL
TAASEPRPL	TAASEPRPL
VSQEVTRSL	VSQEVTRSL
FLFKVRESGSL	FKVRESGSL
VTAKATIL	VTAKA-TIL
YAYGQYNMP	YAYGQYNMP
KAHAKAIEM	KAHAKAIEM
HAMHQTGHL	HAMHQTGHL
GAWSIPWKWL	WSIPW-KWL
VADPYVVIM	VADPYVVIM
FLVDPNLDL	FLVDPNLDL
FAVESEHDQAM	FAVESEQAM
VAVRKSAIM	VAVRKSAIM
LSVGMHCSL	LSVGMHCSL
FADGVYLVL	FADGVYLVL
AALFKAWAL	AALFKAWAL
YTNGKCVIL	YTNGKCVIL
LADPVFRTL	LADPVFRTL
FAGFPSAAA	FAGFPSAAA
ITSPHGIPL	ITSPHGIPL
FIYHLPQEF	FIYHLPQEF
FSEGLIKAL	FSEGLIKAL
LAPALLPAL	LAPALLPAL
IAVDMTQHL	IAVDMTQHL
FALGSPIAM	FALGSPIAM
VAHHSKVTL	VAHHSKVTL
RIIPRHLQL	RIIPRHLQL
HAIKSGMDM	HAIKSGMDM
FTSEKFLVM	FTSEKFLVM
AAMPVAQHL	AAMPVAQHL
TVTAMDVVY	TVTAMDVVY
YAFPLAHSL	YAFPLAHSL
LSTVVSPVI	LSTVVSPVI
LAASQGHSL	LAASQGHSL
YAFTALDAL	YAFTALDAL
VAHENNRAL	VAHENNRAL
FSEEMNRVL	FSEEMNRVL
FAFDEIVAL	FAFDEIVAL
FSFEAQGGL	FSFEAQGGL
NAYTGIVLL	NAYTGIVLL
FTVDSPVQQAL	TVDSPVQAL
VASEYPVIL	VASEYPVIL
HTIFASNTSSL	FASNT-SSL
MADPNIRFL	MADPNIRFL
ISDNAAKIL	ISDNAAKIL
GAVSPRQTL	GAVSPRQTL
LANPTTSAL	LANPTTSAL
FSLEYPTISL	FSLEYPISL
CAATPKHAL	CAATPKHAL
LIDVARTSL	LIDVARTSL
TADGRVVKL	TADGRVVKL
YAYETKDALCL	YAYETKDAL
FVNSKNMTL	FVNSKNMTL
VAAAVVRAL	VAAAVVRAL
YGSFVTRAL	YGSFVTRAL
FILEHIMVV	FILEHIMVV
VALLRVTPF	VALLRVTPF
FADSHELSEL	FADSHESEL
FSNAVVQIL	FSNAVVQIL
IAFDPRSAYYL	IAFDPRSAY
FSVPFHQAL	FSVPFHQAL
ASTKSLQELF	ASTKSLQEL
FALKNPFYSL	FALKNPYSL
YAVGGYTRL	YAVGGYTRL
FAVPENSSV	FAVPENSSV
KAFPASAAL	KAFPASAAL
YAFGQETNVPL	FGQETNVPL
VAVFPKDHSSL	AVFPKDSSL
AAIYNTTEL	AAIYNTTEL
YVIAYIRDL	YVIAYIRDL
FSNAHINEL	FSNAHINEL
FAGQPLTI	FAGQP-LTI
AAAGRSPHL	AAAGRSPHL
GAHFSVSSL	GAHFSVSSL
FATPVDPLFL	FATPVDLFL
SAIPTLQQL	SAIPTLQQL
FAYTVKYVL	FAYTVKYVL
YVNLPTIAL	YVNLPTIAL
YANSKAVTL	YANSKAVTL
QAHLTLMAL	QAHLTLMAL
LSILSSLTL	LSILSSLTL
FGINHGIEL	FGINHGIEL
LAYTGFVKL	LAYTGFVKL
FSGPAITL	FSGPA-ITL
FAIPLIEKL	FAIPLIEKL
FWIPYIHNL	FWIPYIHNL
SSMLPVMAL	SSMLPVMAL
ISDPIHMVL	ISDPIHMVL
HAFDSLSGISL	HAFDSLISL
STKEPGRTL	STKEPGRTL
FAQDGQHQVL	FAQDGQQVL
TAAPVPTTL	TAAPVPTTL
HAVKYSKAL	HAVKYSKAL
FAAVKDTILQL	FAAVKDTIL
LQKIGPIL	LQKIG-PIL
FTEKGGLSF	FTEKGGLSF
STLPALTAL	STLPALTAL
MGMVAGTTM	MGMVAGTTM
YAKEASRHSL	YAKEASHSL
STPDHSFSL	STPDHSFSL
LSWPGLAV	LSWPG-LAV
FISNVKTAL	FISNVKTAL
FAYTARISV	FAYTARISV
AAIWFRTYL	AAIWFRTYL
KSDPSIVRL	KSDPSIVRL
YIQQKVRVL	YIQQKVRVL
VIGPPVVL	VIGPP-VVL
FALEGPFVYL	FALEGPVYL
FAGGTRHAL	FAGGTRHAL
FAYGQNKTAF	FAYGQNTAF
YSINMNVFL	YSINMNVFL
GATPVSLAL	GATPVSLAL
YSEDGLLKL	YSEDGLLKL
TIVDTGIGM	TIVDTGIGM
IAIPVTVAF	IAIPVTVAF
YVIPHPVHAF	YVIPHPHAF
YAVTGDVKM	YAVTGDVKM
TALDPDMIQAL	ALDPDMQAL
RTNRPPLSL	RTNRPPLSL
IALVGKAM	IALVG-KAM
GIIEPLMNL	GIIEPLMNL
YIMDWMDEM	YIMDWMDEM
AVFGHPFSL	AVFGHPFSL
SSAKPGPAL	SSAKPGPAL
LAQQAILSL	LAQQAILSL
FSYESELFPTF	FSYES--EL
FTIDIKSFL	FTIDIKSFL
GVVDPRAISVL	VVDPRASVL
LSDLALHFL	LSDLALHFL
KTPDFESTGL	TPDFESTGL
FSVDQLMEL	FSVDQLMEL
AAEEGLREL	AAEEGLREL
SAVGQFVSL	SAVGQFVSL
FASKALEL	FASKA-LEL
FALPGNSQL	FALPGNSQL
YAHHAVSTL	YAHHAVSTL
YSISQERF	YSISQ-ERF
ISHSSLTSL	ISHSSLTSL
AALVPRQAL	AALVPRQAL
SAPVGVTAL	SAPVGVTAL
VAVDRFKSL	VAVDRFKSL
FSIMESPKEAL	SIMESPEAL
FIISRTQAL	FIISRTQAL
MASGHFAFL	MASGHFAFL
SAAENFLVL	SAAENFLVL
QADPTGRLL	QADPTGRLL
FSLPHPEAL	FSLPHPEAL
LAVPDMSSL	LAVPDMSSL
FAEVTENFAF	FAEVTEFAF
SSAPPLSEL	SSAPPLSEL
QALDYFLKM	QALDYFLKM
FANNVQLSL	FANNVQLSL
LAVDSFIYF	LAVDSFIYF
FAIGVQQL	FAIGV-QQL
FSIPEGQKL	FSIPEGQKL
TIDPNTRTL	TIDPNTRTL
FASGAFLHI	FASGAFLHI
FAVEYFTRL	FAVEYFTRL
FLIPFVITV	FLIPFVITV
LARPASAAL	LARPASAAL
LAAEGRVL	LAAEG-RVL
AALPLALVL	AALPLALVL
SAVDPVAVL	SAVDPVAVL
SASPLFQSL	SASPLFQSL
HIIENIVAV	HIIENIVAV
PVQAPQWTDF	VQAPQWTDF
LSVGSPSVL	LSVGSPSVL
FAEGFVRAL	FAEGFVRAL
LAVGSMKTL	LAVGSMKTL
FIKDSSVEL	FIKDSSVEL
FAASPSELHL	FAASP-SEL
LAKDHSPDL	LAKDHSPDL
VSGPAMTL	VSGPA-MTL
FVYPFGATL	FVYPFGATL
LAVDTQLLL	LAVDTQLLL
TAAPPAQPL	TAAPPAQPL
IAQDFKTDL	IAQDFKTDL
MANPTALLL	MANPTALLL
FSQKTKASL	FSQKTKASL
LAVSQGGEL	LAVSQGGEL
IIITPTREL	IIITPTREL
TAAPDLKL	TAAPD-LKL
FALNLFKHL	FALNLFKHL
FAGLVFLHL	FAGLVFLHL
YYVDFFKTL	YYVDFFKTL
TAFHSSMAL	TAFHSSMAL
YISGPHEL	YISGP-HEL
FANTGGGYL	FANTGGGYL
VARPLSTAL	VARPLSTAL
IASPPSLIL	IASPPSLIL
VAVKAAQEL	VAVKAAQEL
TAAHGLEL	TAAHG-LEL
LATRALPEL	LATRALPEL
YFIAPTGHSL	FIAPTGHSL
LSQPTPATL	LSQPTPATL
AAIKALEL	AAIKA-LEL
TATTSQPVL	TATTSQPVL
FVMEGEPPKL	FVMEGEPKL
SATDKCRSL	SATDKCRSL
YAVPWQGTMTL	YAVPWQGTM
LSQDPVLEL	LSQDPVLEL
FSTGNFNVL	FSTGNFNVL
FVTSSHLQL	FVTSSHLQL
MPMMPGPPM	MPMMPGPPM
LAHLRAAVL	LAHLRAAVL
FAILRQAEL	FAILRQAEL
AAIDPRVQYL	AAIDPRQYL
WIETQQAF	WIETQ-QAF
IADPNIAKL	IADPNIAKL
FVNSQEWTL	FVNSQEWTL
FAVPPALGSNL	FAVPPASNL
YAHPGLAL	YAHPG-LAL
LAEKHQKTL	LAEKHQKTL
YAGPGLSL	YAGPG-LSL
LVLVPTREL	LVLVPTREL
YGINNIREL	YGINNIREL
FVNDDRHVM	FVNDDRHVM
YSAPGRDL	YSAPG-RDL
LSSPVTKSF	LSSPVTKSF
FSINPLENL	FSINPLENL
YASFIEDNEL	YASFIENEL
FSTLYGRVL	FSTLYGRVL
SSSPVSVVL	SSSPVSVVL
TATPRDLVL	TATPRDLVL
FASEVSNVL	FASEVSNVL
KAIDLMNAL	KAIDLMNAL
SASALAVAL	SASALAVAL
YAEVGRVL	YAEVG-RVL
YSIGPNSKL	YSIGPNSKL
FTAMPPLTL	FTAMPPLTL
VAVSPSLDL	VAVSPSLDL
FAMEIDPSL	FAMEIDPSL
FIMDRAQAL	FIMDRAQAL
YAHRAKNIL	YAHRAKNIL
RSIFPQQSL	RSIFPQQSL
FSNGHIKVL	FSNGHIKVL
IAEQAHEL	IAEQA-HEL
LSTVGPRL	LSTVG-PRL
FSEENHEPL	FSEENHEPL
NAEPEPRSL	NAEPEPRSL
FTLHGRAIL	FTLHGRAIL
VATAADLEL	VATAADLEL
LAADQSRAL	LAADQSRAL
FSDLTMHEL	FSDLTMHEL
VALPASGWL	VALPASGWL
FAVPESDHL	FAVPESDHL
NAAQPYSNL	NAAQPYSNL
RALDHYLTL	RALDHYLTL
FVIFGATSL	FVIFGATSL
LAAPQRHAL	LAAPQRHAL
VAVHPSTVNPL	VAVHP-STV
ITIVKSTEL	ITIVKSTEL
FAHLRLEVL	FAHLRLEVL
LAGPPLEI	LAGPP-LEI
AATHHHPPL	AATHHHPPL
KAALAGLSL	KAALAGLSL
ITVTSSKAL	ITVTSSKAL
VSHGGTVSL	VSHGGTVSL
YAVRDTIAL	YAVRDTIAL
FNFVGKIL	FNFVG-KIL
ATVPSSPTL	ATVPSSPTL
FVYGESVEL	FVYGESVEL
KAFGSGSNL	KAFGSGSNL
VSDIGKEL	VSDIG-KEL
RPPGFSPFR	RPPGFSPFR
AVVGDPIAL	AVVGDPIAL
FITESYQTL	FITESYQTL
YIIDPQNGL	YIIDPQNGL
FAKETTSHNSL	FAKETTNSL
VVKPPGSSL	VVKPPGSSL
YSLQPPSAL	YSLQPPSAL
YSDDTLKQL	YSDDTLKQL
FAAISGMIL	FAAISGMIL
FIIYDTHSL	FIIYDTHSL
YTYESKMAFL	YTYESKMAF
MAIAPNVTV	MAIAPNVTV
AADKRSKAL	AADKRSKAL
FATTNQISL	FATTNQISL
MANPQMQQL	MANPQMQQL
AAINPNHPL	AAINPNHPL
YADQPHIF	YADQP-HIF
AAEERVRTL	AAEERVRTL
FALNHPEL	FALNH-PEL
FSDDPNVTKTL	FSDDPNKTL
NARNGVAL	NARNG-VAL
FSQPKVTEL	FSQPKVTEL
FTNDQYQEL	FTNDQYQEL
TAQSPGMNL	TAQSPGMNL
SAMAVVSRL	SAMAVVSRL
VNLPINGNGKQ	VNLPINGNG
MALLFLLPL	MALLFLLPL
VGDPSVHLL	VGDPSVHLL
IAAGIFKHL	IAAGIFKHL
VGIKPSLEL	VGIKPSLEL
FSIGVGSRL	FSIGVGSRL
FISGHTSEL	FISGHTSEL
FSKNGKDL	FSKNG-KDL
YAAQIVLTF	YAAQIVLTF
FADVNGWHL	FADVNGWHL
YGITSPISL	YGITSPISL
AAIRGTKEL	AAIRGTKEL
FSNPETLDL	FSNPETLDL
GIIRPGTAF	GIIRPGTAF
VAAKKNVSI	VAAKKNVSI
VTAYPNRPM	VTAYPNRPM
SAEQHQRTL	SAEQHQRTL
YINLGNVL	YINLG-NVL
VSIEPNFHSL	SIEPNFHSL
TAYDNFVEL	TAYDNFVEL
KAYHNSPAYL	KAYHNSAYL
AVVLPHQPL	AVVLPHQPL
YAFPKSITV	YAFPKSITV
IAVYHLQEL	IAVYHLQEL
FTEEKFRYM	FTEEKFRYM
AAIETYNLL	AAIETYNLL
KADDSRMSL	KADDSRMSL
FAHDSTRVI	FAHDSTRVI
LSIPSFQAL	LSIPSFQAL
YAVPFIQPDL	YAVPFIPDL
AAVRIGSVL	AAVRIGSVL
FAEQKFRKL	FAEQKFRKL
IAMPLHMIF	IAMPLHMIF
YSWVGRPLL	YSWVGRPLL
GAVDADKHHSL	AVDADKHSL
NIISTFQNL	NIISTFQNL
AALPDASPGNL	AALPDASPG
FIMDESNVL	FIMDESNVL
NVIESFTEL	NVIESFTEL
VATNRGSSL	VATNRGSSL
KAVNPGRSL	KAVNPGRSL
KAIRPYHAL	KAIRPYHAL
AIEPLPNVVEL	AIEPLPNVV
ISNPPGSNL	ISNPPGSNL
FAVDREARL	FAVDREARL
YAGKISQM	YAGKI-SQM
VAVTPFSL	VAVTP-FSL
FTHEALTL	FTHEA-LTL
FTAEQRQEL	FTAEQRQEL
GATKLFLIL	GATKLFLIL
LTEPLRDFSAM	LTEPL-RDF
VTIHPSSSL	VTIHPSSSL
AAAVPRAAF	AAAVPRAAF
FYAPELLFFAK	YAPEL-LFF
YANKYNIML	YANKYNIML
FLHPHLLVL	FLHPHLLVL
YVYPHSLNF	YVYPHSLNF
FNYPGGVAM	FNYPGGVAM
YSHPVVSSVPL	YSHPVVSSV
IAGPVVEI	IAGPV-VEI
FTDLGNKDL	FTDLGNKDL
AAQAHTREL	AAQAHTREL
YAYEKPHVV	YAYEKPHVV
VTAVSGKAL	VTAVSGKAL
ISIGPGASF	ISIGPGASF
FSIPEKNRPL	FSIPEKRPL
FSSDVTHEM	FSSDVTHEM
FADFERHFL	FADFERHFL
TAVENMPSL	TAVENMPSL
VATWQQSSL	VATWQQSSL
FAAKQREL	FAAKQ-REL
AAFPYGGVL	AAFPYGGVL
FQTEVGKQL	FQTEVGKQL
PALPAFLL	PALPA-FLL
HASTTRISL	HASTTRISL
LAHSGSDL	LAHSG-SDL
FSVESGTKM	FSVESGTKM
AGSAVFWVL	AGSAVFWVL
SSYVGRGL	SSYVG-RGL
NVLDHFSEL	NVLDHFSEL
LATHPGISF	LATHPGISF
TALPRIFSL	TALPRIFSL
FVIETARQL	FVIETARQL
HIYDNQGIEL	HIYDNQIEL
YAGDVSMFL	YAGDVSMFL
KAINVFVSA	KAINVFVSA
SAHLGWEL	SAHLG-WEL
FTLVGKVLL	FTLVGKVLL
QAIGAIRTL	QAIGAIRTL
VIIGTKTIL	VIIGTKTIL
IAISRTPVL	IAISRTPVL
AASPAGLDL	AASPAGLDL
FSSAIGLVL	FSSAIGLVL
FALESGGGSIL	FALESGSIL
LAQDIFKEL	LAQDIFKEL
AATDIFSYL	AATDIFSYL
LAIHGMETL	LAIHGMETL
FAVTLETVL	FAVTLETVL
FAMQLVKIL	FAMQLVKIL
LTDDRFKVM	LTDDRFKVM
FFQVGSDL	FFQVG-SDL
YAYDGKDYI	YAYDGKDYI
FVTKPNSAL	FVTKPNSAL
IADAAYKAM	IADAAYKAM
FASIATIQM	FASIATIQM
QAMPPLFSL	QAMPPLFSL
FVYENPISL	FVYENPISL
FAQKSGYFL	FAQKSGYFL
WATDWRLIL	WATDWRLIL
SAFLKTIAL	SAFLKTIAL
IAVPASNSGL	IAVPASSGL
SADDGIRNL	SADDGIRNL
MAVSHMKSL	MAVSHMKSL
FTTQGQSEL	FTTQGQSEL
FIAPSGHGL	FIAPSGHGL
VATEGSREL	VATEGSREL
NASPVISSV	NASPVISSV
YAQDRASHL	YAQDRASHL
QVTQPTVGMNF	VTQPTVMNF
AFVTGYDI	AFVTG-YDI
YAIPHPDQL	YAIPHPDQL
LASPVSPEL	LASPVSPEL
FLLEGIRSL	FLLEGIRSL
VVAPAGVTL	VVAPAGVTL
FIQDTSLIL	FIQDTSLIL
YAMPTKTIEVL	YAMPT-KTI
LAFNSAISL	LAFNSAISL
VTDPRVVDL	VTDPRVVDL
RAFQPSVSL	RAFQPSVSL
YAIENVETNL	YAIENVTNL
YIKDPKKAL	YIKDPKKAL
VADEQNRAL	VADEQNRAL
SAAFPGASL	SAAFPGASL
VAIQAVLTL	VAIQAVLTL
LAIDRVKLL	LAIDRVKLL
FADGHVLEL	FADGHVLEL
SGIERMGPL	SGIERMGPL
LATDQGSKL	LATDQGSKL
VADQRSRML	VADQRSRML
LVLAPTREL	LVLAPTREL
LASSEWPEL	LASSEWPEL
SAIDRIFTL	SAIDRIFTL
FAADAVKL	FAADA-VKL
FALPILNAL	FALPILNAL
IAHDTGTSL	IAHDTGTSL
SIPGGYNAL	SIPGGYNAL
LANERLMTL	LANERLMTL
FTDASFLTL	FTDASFLTL
FQAPTAKEM	FQAPTAKEM
VTDGGHLEL	VTDGGHLEL
SAISPKSSL	SAISPKSSL
IGIDHIKEL	IGIDHIKEL
TIIDTKGVTAL	IIDTKGTAL
TAIESTPTL	TAIESTPTL
VAVGSAVGHVM	VGSAVGHVM
VATDFFTVL	VATDFFTVL
YAAEGQRL	YAAEG-QRL
IVFSGSSL	IVFSG-SSL
SSSAVFLII	SSSAVFLII
VAIFAVDSL	VAIFAVDSL
YLLEKSRAI	YLLEKSRAI
LATPPFSRL	LATPPFSRL
YAWESSAGGSF	YAWESSGSF
HLPETKFSEL	LPETKFSEL
KAMELIREL	KAMELIREL
AANRLTLEL	AANRLTLEL
FSQKSFLVL	FSQKSFLVL
IATDPLNPL	IATDPLNPL
LLWPGAAL	LLWPG-AAL
VAVDPSILARL	VAVDP-SIL
FAHPSLWQL	FAHPSLWQL
FIIDGKGVL	FIIDGKGVL
YAANLKNVM	YAANLKNVM
AAMASLGALAL	MASLGALAL
FSDPVYKEI	FSDPVYKEI
WAQDKKLIL	WAQDKKLIL
AVEQNTLQEF	AVEQNTQEF
IAIPVTQEL	IAIPVTQEL
YAFVRPVIL	YAFVRPVIL
SVIIPGMTL	SVIIPGMTL
RAHIGPVL	RAHIG-PVL
YVSFPLEL	YVSFP-LEL
FIADHCPTL	FIADHCPTL
FAITEPLVTF	FAITEPVTF
FADDGVKYL	FADDGVKYL
MALLGHSL	MALLG-HSL
LAALSWQYL	LAALSWQYL
FTEMPTDNF	FTEMPTDNF
LIYDGKVEM	LIYDGKVEM
IAMDLILKM	IAMDLILKM
VAIGPCRML	VAIGPCRML
YSLPTSFSGSF	YSLPTSFSG
SAVTTFEAL	SAVTTFEAL
VTIARAIEL	VTIARAIEL
FALVGHLL	FALVG-HLL
TAYTRQQVL	TAYTRQQVL
YSWVGRPLLD	YSWVGRPLL
YAEGVRVL	YAEGV-RVL
NAATSFQVL	NAATSFQVL
FALRPTFDL	FALRPTFDL
LAVDPNRAVPL	LAVDPNRAV
SAQGKPLAL	SAQGKPLAL
TAAPVVPEL	TAAPVVPEL
VAYPHDGKIFF	VAYPHDKIF
YASPDVFKSL	YASPDVKSL
KTEDKVRVM	KTEDKVRVM
FAAEAIAL	FAAEA-IAL
YSYPAAVPQAL	YSYPAAQAL
TPEVDDEALEK	TPEVDDEAL
LSHGGKEL	LSHGG-KEL
SADPGILVL	SADPGILVL
LGIVGPVL	LGIVG-PVL
AASSAHVAL	AASSAHVAL
VAVNMYKQL	VAVNMYKQL
FSHGKGNMFL	FSHGKGMFL
NAYQRAILL	NAYQRAILL
VSIFPDSGHF	SIFPDSGHF
FIAEHYMFL	FIAEHYMFL
FQIQTSTSL	FQIQTSTSL
YVIPDWKVV	YVIPDWKVV
SAFPFPVTV	SAFPFPVTV
YAEARKRIL	YAEARKRIL
EIVPNGITLTM	EIVPNGITL
VAVTVRAAL	VAVTVRAAL
FASDVQFVL	FASDVQFVL
YLNEWLQIL	YLNEWLQIL
SIYSRFVQL	SIYSRFVQL
YAVDRAITHL	YAVDRATHL
NASIGKTL	NASIG-KTL
FSHGQVVSL	FSHGQVVSL
RAIDFSPYL	RAIDFSPYL
VADSPRDTASL	VADSPRASL
ASSPEHPEL	ASSPEHPEL
AAMSHLLEM	AAMSHLLEM
YALLGRTLL	YALLGRTLL
NSDPNLHLL	NSDPNLHLL
VTMTASRML	VTMTASRML
GAIGGTPPAF	GAIGGTPAF
FAVVARGTTIL	VVARGTTIL
TAISLFYEL	TAISLFYEL
YSYFSPRTM	YSYFSPRTM
IAVPDPSVL	IAVPDPSVL
FTSSTSLTL	FTSSTSLTL
FARSPGADL	FARSPGADL
IAAVTDIPL	IAAVTDIPL
FVVTGPAL	FVVTG-PAL
FAAGANVAL	FAAGANVAL
YFNPHTVTL	YFNPHTVTL
AAFQPNQYQML	AAFQPNYQM
YSTPHAFTF	YSTPHAFTF
HYMPPPYASL	YMPPPYASL
SASTVFIAL	SASTVFIAL
YSLPGVAL	YSLPG-VAL
SAQPWIAAL	SAQPWIAAL
RVIDYILDL	RVIDYILDL
WAAVPGKTF	WAAVPGKTF
FALGVYRTL	FALGVYRTL
MAINSISKL	MAINSISKL
LSIPPSLNL	LSIPPSLNL
YTIHFIEEM	YTIHFIEEM
FLLQHVQEL	FLLQHVQEL
SAIIFETPL	SAIIFETPL
YAHWKGQVL	YAHWKGQVL
VADEQQRLM	VADEQQRLM
FATHAAAL	FATHA-AAL
HAAHIISEL	HAAHIISEL
VSHAPGEAL	VSHAPGEAL
YAFPKAVSVF	YAFPKAVSV
IAFPTSISV	IAFPTSISV
YVNPNHQTSL	YVNPNHTSL
NGIFPGTPL	NGIFPGTPL
QADYHRKAL	QADYHRKAL
QAMGSFLSV	QAMGSFLSV
VALLGSAFQL	VALLGSFQL
SALAKLSVL	SALAKLSVL
FVDQGGHVL	FVDQGGHVL
FSHVNIVKF	FSHVNIVKF
SAYGAAAHL	SAYGAAAHL
LALRGLQL	LALRG-LQL
LAVDGRLSL	LAVDGRLSL
ISEENFRVM	ISEENFRVM
GAIPVFFSF	GAIPVFFSF
YAAGAKLVL	YAAGAKLVL
LTYMPSVSL	LTYMPSVSL
NAFMKAVEL	NAFMKAVEL
FVCRPNAAL	FVCRPNAAL
FTEAGLKEL	FTEAGLKEL
LSDPFYRTL	LSDPFYRTL
VVIEPISEL	VVIEPISEL
SIEGVTHAL	SIEGVTHAL
GAADPGFTM	GAADPGFTM
FADPEVLRRL	FADPEVRRL
YAQLHSFTL	YAQLHSFTL
FIIQGLRSV	FIIQGLRSV
YQQELEREL	YQQELEREL
SAAPEGVPL	SAAPEGVPL
LSKAAGPEL	LSKAAGPEL
YQNPQITQL	YQNPQITQL
YALERLKVM	YALERLKVM
TSDIPHML	TSDIP-HML
SASSPRLSSSL	ASSPRLSSL
YSHSSSSL	YSHSS-SSL
IANPTAMLL	IANPTAMLL
IATNGTPEL	IATNGTPEL
SAAEIMAVL	SAAEIMAVL
LTGPVLEL	LTGPV-LEL
GAVPIFIEL	GAVPIFIEL
LSSPVAQML	LSSPVAQML
FVMETFVHL	FVMETFVHL
FVTSNTQEL	FVTSNTQEL
VVVDPIQSV	VVVDPIQSV
ISHLHRTEL	ISHLHRTEL
LAAHIPLFL	LAAHIPLFL
FLYPFPLAL	FLYPFPLAL
QSLPPGLAV	QSLPPGLAV
AAFDGRHSQTL	AAFDGRQTL
FVFPGELLL	FVFPGELLL
VAYVSSVAL	VAYVSSVAL
FVDPNGKISL	FVDPNGISL
LADQKVHML	LADQKVHML
IAAPNMKAM	IAAPNMKAM
FTQKGNLL	FTQKG-NLL
FASPTSPPVL	FASPTSPVL
NAVPLFLRL	NAVPLFLRL
VAVPVAVTF	VAVPVAVTF
AAGRPLEL	AAGRP-LEL
FASHVSPEV	FASHVSPEV
VAAAHSVVL	VAAAHSVVL
LLDPNIYRTM	LLDPNIRTM
TSYVGLVL	TSYVG-LVL
LALKTGPTSGL	LALKTGPTS
SILSHFQSL	SILSHFQSL
SAMYSRKAM	SAMYSRKAM
YQMEMMRSL	YQMEMMRSL
IAPTGHSL	IAPTG-HSL
LSYPQTDVFL	LSYPQTVFL
VVDAIPVFL	VVDAIPVFL
FSAQPSREGAL	SAQPSRGAL
SSTTVIPTL	SSTTVIPTL
SAFGYFITA	SAFGYFITA
YAVGIQQVL	YAVGIQQVL
FAIYESLKKYL	AIYESLKYL
GANEATKTL	GANEATKTL
LAHPNIIAL	LAHPNIIAL
FAESGWRSAL	FAESGWSAL
VVYAHSKEL	VVYAHSKEL
FGDIFLHLL	FGDIFLHLL
FAHLNSPQL	FAHLNSPQL
LTVPFEKHSTL	VPFEKHSTL
LAAEPRLL	LAAEP-RLL
RVYIHPFHL	RVYIHPFHL
VAIQAVLSL	VAIQAVLSL
FVVERQPCM	FVVERQPCM
MAEPNAKFI	MAEPNAKFI
KAIGNAFAVL	KAIGNAAVL
FAEEQTLVL	FAEEQTLVL
FADKHIQVL	FADKHIQVL
FADGKVYAL	FADGKVYAL
YAMDIVKGL	YAMDIVKGL
YASNITSVL	YASNITSVL
FALSQPRAM	FALSQPRAM
LSIDLFHVL	LSIDLFHVL
HAMDGASHL	HAMDGASHL
VAQELPTTL	VAQELPTTL
RAIPNNQVL	RAIPNNQVL
LTFPPATAL	LTFPPATAL
AIVGQAQEI	AIVGQAQEI
AAAGSPLSL	AAAGSPLSL
VSDSGAHVL	VSDSGAHVL
NAIGPLVAL	NAIGPLVAL
RAHSEPLAL	RAHSEPLAL
LAMLRSLDL	LAMLRSLDL
NAPLVHATL	NAPLVHATL
FGLARAFSL	FGLARAFSL
TAIPVTQEL	TAIPVTQEL
IATSPQSPL	IATSPQSPL
IVMPNILVL	IVMPNILVL
STKPPGTFL	STKPPGTFL
VAQNSGLTL	VAQNSGLTL
YAYETKDAL	YAYETKDAL
FIFLPGNTL	FIFLPGNTL
HAAAYRNAL	HAAAYRNAL
YADVIVHRL	YADVIVHRL
HAIANSGKL	HAIANSGKL
SAAPLFFSW	SAAPLFFSW
IAVEPGNQW	IAVEPGNQW
FAMIVSSAL	FAMIVSSAL
LAQPTLLYL	LAQPTLLYL
FTNPWTKEL	FTNPWTKEL
YISEETRVL	YISEETRVL
AAEKGVRTL	AAEKGVRTL
FAVSDGLEL	FAVSDGLEL
LIEDHQKEL	LIEDHQKEL
WALESDNNTAL	LESDNNTAL
VSDPVTVHF	VSDPVTVHF
IAVPEARFL	IAVPEARFL
LANSRMAEL	LANSRMAEL
YIPDGHTKEM	YIPDGHKEM
ATTHLSPEL	ATTHLSPEL
SIVEQQLPL	SIVEQQLPL
LPSHPLEL	LPSHP-LEL
IADATVRSL	IADATVRSL
ISAGTSHSL	ISAGTSHSL
FLIENPKTSL	LIENPKTSL
VVASPRGPL	VVASPRGPL
WARGWKSL	WARGW-KSL
YVAQAGLEL	YVAQAGLEL
YAARPFAL	YAARP-FAL
FSVDARAL	FSVDA-RAL
ASIYTGITL	ASIYTGITL
FSHPREPAL	FSHPREPAL
FSYAGFEM	FSYAG-FEM
FADPVDVNPF	FADPVDNPF
QSISPGSRL	QSISPGSRL
KAFSQSSSL	KAFSQSSSL
IALPSLRIL	IALPSLRIL
FLPTSLPPEL	FLPTSLPEL
YVQIPGMEI	YVQIPGMEI
HAYDGKDYISL	HAYDGKISL
GSIAPGLSV	GSIAPGLSV
HASDRIIAL	HASDRIIAL
FASTILHLV	FASTILHLV
AAAALHPAL	AAAALHPAL
FSYAFPKAV	FSYAFPKAV
AAEDAIRNL	AAEDAIRNL
FSSPHLQML	FSSPHLQML
LSQQPFLSL	LSQQPFLSL
LASFKILAL	LASFKILAL
FFWPGIDL	FFWPG-IDL
LSHTSEEDF	LSHTSEEDF
YLTAEILEL	YLTAEILEL
RALEHFTDL	RALEHFTDL
FMNPHLISV	FMNPHLISV
TVTGKTVRLL	VTGKTVRLL
AIAAVFHTL	AIAAVFHTL
GIHETTFNSIM	GIHETTNSI
FATGVWHQM	FATGVWHQM
VIAPPDFVL	VIAPPDFVL
AIIPSKKL	AIIPS-KKL
FVDQFVEL	FVDQF-VEL
NVTDIMLIL	NVTDIMLIL
SAVVAQHSL	SAVVAQHSL
FQLEHIMDL	FQLEHIMDL
VATLYGLSL	VATLYGLSL
GAAVPIYVI	GAAVPIYVI
LQYSAILT	LQYSA-ILT
YAAPHFFHL	YAAPHFFHL
LAQKPGAPL	LAQKPGAPL
YAAAQKTSL	YAAAQKTSL
YALGALNHL	YALGALNHL
FAFESDLHSLL	FAFESDHSL
YTTDFIYQL	YTTDFIYQL
YQVGVHYEL	YQVGVHYEL
LILPGFIDF	LILPGFIDF
AAGPGFSL	AAGPG-FSL
FLSEHPNVTL	LSEHPNVTL
KADKKFHVL	KADKKFHVL
ASSPPVLSL	ASSPPVLSL
ISILGKSL	ISILG-KSL
FGSEFSPEL	FGSEFSPEL
LAIDAIHQL	LAIDAIHQL
QAADSILVL	QAADSILVL
FSKIGGIL	FSKIG-GIL
YAHITHKAL	YAHITHKAL
FGIDKSKSI	FGIDKSKSI
FIDGGGSVL	FIDGGGSVL
MVADKFTEL	MVADKFTEL
IADPKTDHRL	IADPKTHRL
FSKVGREL	FSKVG-REL
FANEPFADF	FANEPFADF
YMYQLFRSL	YMYQLFRSL
AAIAPPTSL	AAIAPPTSL
IAVGVGAQL	IAVGVGAQL
FIVGEMKNL	FIVGEMKNL
HLTPVTLEL	HLTPVTLEL
VTDGKEVLL	VTDGKEVLL
FSHSGRYM	FSHSG-RYM
FAFLTGVGL	FAFLTGVGL
LAVNVVTTL	LAVNVVTTL
TASEPLTL	TASEP-LTL
HTIFPSEYL	HTIFPSEYL
FSSPGGLSL	FSSPGGLSL
IAWSPDDNYL	IAWSPDNYL
FADSDSHSSF	FADSDSSSF
NAMMPGAPL	NAMMPGAPL
RASGQAFEL	RASGQAFEL
YVHPFIFAL	YVHPFIFAL
SALGKSPWL	SALGKSPWL
SAVYVLSSM	SAVYVLSSM
VAMGYSHSL	VAMGYSHSL
RALLGPAL	RALLG-PAL
VSHGRPLAL	VSHGRPLAL
WQNPHMLFL	WQNPHMLFL
LAFVSPSL	LAFVS-PSL
YTSEVQAIL	YTSEVQAIL
FALSSTKTL	FALSSTKTL
GAIARPACL	GAIARPACL
LNAAPRIAL	LNAAPRIAL
VVNGAFMVL	VVNGAFMVL
FAVVPSTAT	FAVVPSTAT
YADYHTHFL	YADYHTHFL
LAEFKVRAL	LAEFKVRAL
AAVPKTFQL	AAVPKTFQL
VAKAPSQAL	VAKAPSQAL
YALPHAILRL	YALPHALRL
IIDDVMKEL	IIDDVMKEL
YADVGGKQF	YADVGGKQF
SNVYPSKPL	SNVYPSKPL
YAIFKSQDF	YAIFKSQDF
LAAPVISVL	LAAPVISVL
TAEERARAL	TAEERARAL
MAIAPNVTVM	AIAPNVTVM
SAMEVVPAL	SAMEVVPAL
FGSQPGLYL	FGSQPGLYL
RIVPRFSEL	RIVPRFSEL
VAGRAMTL	VAGRA-MTL
GAFQPGRPL	GAFQPGRPL
NAVRTVQSL	NAVRTVQSL
FAAAKLLAL	FAAAKLLAL
FLIDNGVSL	FLIDNGVSL
FVEVGRLG	FVEVG-RLG
YSDIGHLL	YSDIG-HLL
YVQSMDVAAF	QSMDV-AAF
LAVERGSSL	LAVERGSSL
VAVNGVHSL	VAVNGVHSL
SATQVFPRL	SATQVFPRL
YVKRPGAAL	YVKRPGAAL
AAGPSFRL	AAGPS-FRL
FAFSSQEL	FAFSS-QEL
FVGPSRYL	FVGPS-RYL
HSALPNQSL	HSALPNQSL
YTSEAHQIL	YTSEAHQIL
FGGPEVLKL	FGGPEVLKL
IAIKFGSAL	IAIKFGSAL
VADLAHVL	VADLA-HVL
FLANVSTVL	FLANVSTVL
MSDTTFKAL	MSDTTFKAL
FVLDKVPFL	FVLDKVPFL
FVLPATPPQL	FVLPATPQL
LAEDTRTEL	LAEDTRTEL
KSQDVRQAL	KSQDVRQAL
AASEAGRAM	AASEAGRAM
FLYPFFGVL	FLYPFFGVL
AAYLRALSL	AAYLRALSL
AFAEALLL	AFAEA-LLL
FALPYVDHFL	FALPYVHFL
FSQEEFRNL	FSQEEFRNL
VVKEGRTL	VVKEG-RTL
RIFEKMFAM	RIFEKMFAM
FLNPAQRAL	FLNPAQRAL
MGHLGVVL	MGHLG-VVL
YSQAQRKEL	YSQAQRKEL
EVGGEALGRL	VGGEALGRL
AAIAAVNAL	AAIAAVNAL
VAYWRQAGL	VAYWRQAGL
GAQDPVRTL	GAQDPVRTL
AAIEGNLQL	AAIEGNLQL
VTDHNLHEL	VTDHNLHEL
IANARAKKL	IANARAKKL
VSVPYPSSL	VSVPYPSSL
MVIVPTREL	MVIVPTREL
GVIEPNKEL	GVIEPNKEL
YAEDRERFF	YAEDRERFF
AAAPAGRAM	AAAPAGRAM
IAVEPGNQWF	IAVEPGNQW
FVAPWNSLSL	VAPWNSLSL
YGFVNHAL	YGFVN-HAL
FAGNTPLHL	FAGNTPLHL
LASPVFARL	LASPVFARL
LAHRYFSYL	LAHRYFSYL
ISSPVVTSL	ISSPVVTSL
FANDASKVL	FANDASKVL
WANNKVSAL	WANNKVSAL
IASQRLTPL	IASQRLTPL
FSDGIRHVM	FSDGIRHVM
VIVTPLTEL	VIVTPLTEL
YILPFSEVL	YILPFSEVL
TIIPKVLAM	TIIPKVLAM
YTFSEPFHL	YTFSEPFHL
FIMSATPTM	FIMSATPTM
YLHDQNPDAAL	YLHDQNAAL
FLVEHNLVL	FLVEHNLVL
SSIEHLTTL	SSIEHLTTL
FIISDAANL	FIISDAANL
TAISISDHTAL	ISISDHTAL
KAAHFFSTL	KAAHFFSTL
HAIPPTLAM	HAIPPTLAM
YAEVGRVLL	YAEVGRVLL
SSVMPGMMM	SSVMPGMMM
KSIPSFSSL	KSIPSFSSL
LATSHMLEL	LATSHMLEL
LAAETAATL	LAAETAATL
VVYPWTQRF	VVYPWTQRF
SASESILEL	SASESILEL
FVQFPPSEL	FVQFPPSEL
FLYSGHLAL	FLYSGHLAL
FNFVGRIL	FNFVG-RIL
TAVPTIFSL	TAVPTIFSL
SSAPPITSL	SSAPPITSL
ISTNSHPIL	ISTNSHPIL
IAFPDEQAEAL	FPDEQAEAL
RAAGVVLEM	RAAGVVLEM
ITISPLQEL	ITISPLQEL
ISFSGMSL	ISFSG-MSL
LAKASGNTL	LAKASGNTL
FSVAVSPSL	FSVAVSPSL
FSVNGKVL	FSVNG-KVL
LALTRSSSL	LALTRSSSL
FSAGEPRVL	FSAGEPRVL
FSAPPGSEL	FSAPPGSEL
YANDVTRVL	YANDVTRVL
LVISDGSSL	LVISDGSSL
SAMKAVTEL	SAMKAVTEL
HAVHVALVL	HAVHVALVL
FAADLAEEL	FAADLAEEL
TVIGAFWHL	TVIGAFWHL
LTIEKISAL	LTIEKISAL
YIDPRMRIF	YIDPRMRIF
YLIPFSSKL	YLIPFSSKL
QAMPNSPQL	QAMPNSPQL
YLDPRITVAW	YLDPRITVA
TANGTLQTL	TANGTLQTL
FVTEEIIPL	FVTEEIIPL
AAAPEYKTL	AAAPEYKTL
AANPFFKLL	AANPFFKLL
NTDEPPMVF	NTDEPPMVF
ASYVSPVL	ASYVS-PVL
FSIPVVSDV	FSIPVVSDV
FALDMKYAL	FALDMKYAL
YAFNHSADF	YAFNHSADF
SLHTLFGDK	SLHTLFGDK
LAHNSTATL	LAHNSTATL
AALLHSPQL	AALLHSPQL
VAYAPKKEL	VAYAPKKEL
LAVRDVSEL	LAVRDVSEL
SAVVQHMSL	SAVVQHMSL
SAFDHFASV	SAFDHFASV
LADHTVHVL	LADHTVHVL
VTRLIYALFL	RLIYA-LFL
IAYIRDLAL	IAYIRDLAL
AANKTIIYL	AANKTIIYL
FVEEEEHFL	FVEEEEHFL
YTAFARLSL	YTAFARLSL
FLENHVRHL	FLENHVRHL
YINPRAVQL	YINPRAVQL
LSFETTEESL	LSFETTESL
YAVWFGGSML	YAVWFGSML
AADPQIRQF	AADPQIRQF
CAEAVSRVL	CAEAVSRVL
YVVEDSKQL	YVVEDSKQL
YAVKKHFAL	YAVKKHFAL
VTIKSMQLLF	VTIKSMQLL
LSQVPMSAL	LSQVPMSAL
FAFIQHPSL	FAFIQHPSL
LAQKVHSSL	LAQKVHSSL
YAFQDDRYL	YAFQDDRYL
FAVAFGSFF	FAVAFGSFF
AADPGLHETL	AADPGLETL
AAASHFFNL	AAASHFFNL
FAHFKKNNL	FAHFKKNNL
FACPSKATF	FACPSKATF
AADWHNLIL	AADWHNLIL
FNHINVEL	FNHIN-VEL
HTSEHFSFL	HTSEHFSFL
AALGRALAM	AALGRALAM
VAEENTRVL	VAEENTRVL
YAASAIGYL	YAASAIGYL
VATTALEL	VATTA-LEL
HAIMRSPQM	HAIMRSPQM
FSDPFLKYL	FSDPFLKYL
YTIPLAIKL	YTIPLAIKL
FADREVQL	FADRE-VQL
LSKGPGLEV	LSKGPGLEV
TAFPQRTEL	TAFPQRTEL
VTVQPSPYL	VTVQPSPYL
VAVVPRGSTL	AVVPRGSTL
AAHMPAAAL	AAHMPAAAL
FSQIPNNGL	FSQIPNNGL
FAYPAPLEV	FAYPAPLEV
KAISRWSSL	KAISRWSSL
LLLAHIIAL	LLLAHIIAL
IIQSIRMGM	IIQSIRMGM
FAMPYFIQV	FAMPYFIQV
AFGEGLAQR	AFGEGLAQR
FATNVTENVL	FATNVTNVL
YLADVTNAL	YLADVTNAL
FAVAGQEL	FAVAG-QEL
SSSPAVLAL	SSSPAVLAL
MVPPVQVSPL	MVPPVQSPL
LVVDNGSGM	LVVDNGSGM
FATDRVEEL	FATDRVEEL
FADVLVHRL	FADVLVHRL
SAMMYIQEL	SAMMYIQEL
FTQAARTSL	FTQAARTSL
VAYRPISASVL	VAYRPIASV
FVMEGVKNL	FVMEGVKNL
IIVGNPKAL	IIVGNPKAL
FGMQARYSL	FGMQARYSL
FAMFSGTHV	FAMFSGTHV
LAMEVGLVL	LAMEVGLVL
FAIDPHLLL	FAIDPHLLL
YIAHHLLTL	YIAHHLLTL
SANSHNIAL	SANSHNIAL
KTAENFRAL	KTAENFRAL
SASASSPKL	SASASSPKL
IIVDPAREL	IIVDPAREL
ISTEVNPKL	ISTEVNPKL
LLSLPATPL	LLSLPATPL
FAILIHDVL	FAILIHDVL
YADERLRINSL	YADERLNSL
HAIGTVKCL	HAIGTVKCL
LAAVPVQDL	LAAVPVQDL
YTYIGEVL	YTYIG-EVL
TAVAPNVAL	TAVAPNVAL
FLQTPLTEL	FLQTPLTEL
FTDESYLEL	FTDESYLEL
FIIISSQHL	FIIISSQHL
YSDFVVHEI	YSDFVVHEI
FILDPNQENVL	ILDPNQNVL
YTYTSKAL	YTYTS-KAL
GIVFSGSSL	GIVFSGSSL
ITNVQILIL	ITNVQILIL
DIFQPLLF	DIFQP-LLF
FAVNMFRTL	FAVNMFRTL
FATIKSASL	FATIKSASL
RAAEPLLTL	RAAEPLLTL
HIPVFSPAL	HIPVFSPAL
FVADVRLIF	FVADVRLIF
NAILVDTPL	NAILVDTPL
YIDEGRLVL	YIDEGRLVL
MAYVSGLSF	MAYVSGLSF
FSSEACREL	FSSEACREL
ATPFLVVRHQL	FLVVR-HQL
FAQQNSGHFL	FAQQNSHFL
LAHVGPRL	LAHVG-PRL
VAVMTVREL	VAVMTVREL
FVVGFQKIL	FVVGFQKIL
MAMAYGSSL	MAMAYGSSL
LPINGNGKQ	LPINGNGKQ
YAENAMRYI	YAENAMRYI
NASEHIVYL	NASEHIVYL
ETEDYLNSLL	ETEDYLNSL
ISFPSPDAL	ISFPSPDAL
YALPHAIMRL	YALPHAMRL
RAAERSSAL	RAAERSSAL
FAIVASDTRL	FAIVASTRL
IAAVSQEL	IAAVS-QEL
FVEDTECRTL	FVEDTERTL
FALSGPLFL	FALSGPLFL
VSIGDSHCL	VSIGDSHCL
GSAPWAPVL	GSAPWAPVL
VAIDRGLAF	VAIDRGLAF
FSTPLNPLL	FSTPLNPLL
FTNKSTSSL	FTNKSTSSL
LAAVAHSPL	LAAVAHSPL
FSQRDALSL	FSQRDALSL
FAQQMQLML	FAQQMQLML
VADGYPVRL	VADGYPVRL
YGYEHILTL	YGYEHILTL
FAYTRLQLL	FAYTRLQLL
LVHPNPPSVL	LVHPNPSVL
YLAPHVRTL	YLAPHVRTL
NAEKGAKFL	NAEKGAKFL
VVVQAISAL	VVVQAISAL
FSIDSPDSL	FSIDSPDSL
YVVPYTIHL	YVVPYTIHL
VSYPLSLEL	VSYPLSLEL
FTDEESRVFL	FTDEESRVF
FSYEVSRSL	FSYEVSRSL
SACGHTAVL	SACGHTAVL
FSYSCPKFL	FSYSCPKFL
SALEKSLAV	SALEKSLAV
MAAAMPLAL	MAAAMPLAL
LADDSVRSL	LADDSVRSL
SAFPHLRVL	SAFPHLRVL
SAAPRTVAL	SAAPRTVAL
LANLHITAL	LANLHITAL
VAFQHFQEL	VAFQHFQEL
QSYGNVVEL	QSYGNVVEL
FSYHQFIHL	FSYHQFIHL
IAIAPNGAL	IAIAPNGAL
LSQPILLEL	LSQPILLEL
FAFGENKMGQL	FAFGE-NKM
ISQGSDRTL	ISQGSDRTL
LQPPKPLSSL	LQPPKPSSL
QAIEPYITNF	AIEPYITNF
FGEMGGKFM	FGEMGGKFM
YAVEGRDL	YAVEG-RDL
YTAFSERPL	YTAFSERPL
VAYGKGTYF	VAYGKGTYF
LANSSTTTL	LANSSTTTL
FVYDEVRKL	FVYDEVRKL
ITYGQFAQL	ITYGQFAQL
TAAFPFAAL	TAAFPFAAL
FQDAVNKVL	FQDAVNKVL
FTEQGVRLL	FTEQGVRLL
ASFIITKAI	ASFIITKAI
FTAHPRVL	FTAHP-RVL
ITAPSYVL	ITAPS-YVL
YSTGHVSRL	YSTGHVSRL
YAAPWFLTL	YAAPWFLTL
YAVTPLLEDAL	YAVTPLLED
TATATNHVL	TATATNHVL
YVEDGKNQL	YVEDGKNQL
MAYHGLTVPL	MAYHGLVPL
HASESRVAL	HASESRVAL
SAVTGARHL	SAVTGARHL
AIIESGKTL	AIIESGKTL
FAMYPPSMI	FAMYPPSMI
YAIEVDPVL	YAIEVDPVL
FSEEDYRTL	FSEEDYRTL
FIPEHTNLSL	FIPEHTLSL
FAKETTQNAL	FAKETTNAL
QAINRQTAL	QAINRQTAL
YALLGRTL	YALLG-RTL
FTMVGKTF	FTMVG-KTF
LAAPLNIAM	LAAPLNIAM
LVEPHGRIM	LVEPHGRIM
FTYKGLRAL	FTYKGLRAL
VSDQANHVL	VSDQANHVL
YSVRVSPQM	YSVRVSPQM
HAGPTAHEL	HAGPTAHEL
VALPVFLVI	VALPVFLVI
FSHPSLCL	FSHPS-LCL
RAIDSIHQL	RAIDSIHQL
NAMGFHVIL	NAMGFHVIL
IASPVIAAV	IASPVIAAV
GSYDKSVAL	GSYDKSVAL
YVLGYKQTL	YVLGYKQTL
IAIEALTQL	IAIEALTQL
FAYDGKDYI	FAYDGKDYI
STDENFRYL	STDENFRYL
FAINQEQKEAL	FAINQEEAL
TVYVSMIAL	TVYVSMIAL
FANDANKVL	FANDANKVL
FASDIAPFL	FASDIAPFL
AAQDRVLSL	AAQDRVLSL
YALDLSTFL	YALDLSTFL
AAIDARIFHEL	AIDARIHEL
VSIHSATSL	VSIHSATSL
VVPEPGQPL	VVPEPGQPL
WAVSPETEL	WAVSPETEL
SIFFPSEGSNL	FFPSEGSNL
FLFDHQMVL	FLFDHQMVL
QATPAALVL	QATPAALVL
ATIDPDTISAL	TIDPDTSAL
YLQIHPQEL	YLQIHPQEL
LSYLRESSL	LSYLRESSL
YFISPTGHSL	FISPTGHSL
FAYMPNNSL	FAYMPNNSL
YAIRQSISKAL	YAIRQSKAL
FAADIISVL	FAADIISVL
VVGPNITL	VVGPN-ITL
YAIEAIKL	YAIEA-IKL
SIIAMGNTL	SIIAMGNTL
FADHPRAPF	FADHPRAPF
PPYTVVYFPVR	YTVVYFPVR
FAAETLVL	FAAET-LVL
VAQEPVNTL	VAQEPVNTL
FAFQAEIAQL	FAFQAEAQL
IAIEGIMNL	IAIEGIMNL
YLVPQARAL	YLVPQARAL
GIVGSGAAL	GIVGSGAAL
LAALPGVSL	LAALPGVSL
NVIETISSL	NVIETISSL
IAEDHRRLL	IAEDHRRLL
FTTHVMNLL	FTTHVMNLL
HAVEWPVVM	HAVEWPVVM
FSRPASLSL	FSRPASLSL
ATLPEAEALL	ATLPEAEAL
IVIDPKNPL	IVIDPKNPL
YAHLTYVTL	YAHLTYVTL
AAMYKSLEL	AAMYKSLEL
FSYHPSGLSL	FSYHPSLSL
VAVYPHNGM	VAVYPHNGM
FTNDKIINL	FTNDKIINL
YSLFLPLHEL	SLFLPLHEL
FSVPGSMKL	FSVPGSMKL
FAVVNHQGTL	FAVVNHGTL
FTIHLGAQL	FTIHLGAQL
SAIPWGISA	SAIPWGISA
FIHRGIEL	FIHRG-IEL
VAAPLGPLL	VAAPLGPLL
FTQQGPRL	FTQQG-PRL
IALDPDTMQAL	ALDPDTQAL
LAATPGLQL	LAATPGLQL
AAIVPGSQL	AAIVPGSQL
LSDHHVYL	LSDHH-VYL
SLINPSSSL	SLINPSSSL
FVKNAGRHL	FVKNAGRHL
FADQEVRSL	FADQEVRSL
FAAEAIAM	FAAEA-IAM
AVIQGLSTL	AVIQGLSTL
MTYVGAVF	MTYVG-AVF
YYINSPEL	YYINS-PEL
VALVVGHEL	VALVVGHEL
TAHERAKEL	TAHERAKEL
KAVPSFDSL	KAVPSFDSL
VANVPNTSL	VANVPNTSL
LLYPFAPLIL	LLYPFALIL
IAIPFGTAL	IAIPFGTAL
SSKTGIPL	SSKTG-IPL
YLNLGPAL	YLNLG-PAL
AATKILTEL	AATKILTEL
IAMGMAQAL	IAMGMAQAL
YAYFNFPEL	YAYFNFPEL
KAEDSARTL	KAEDSARTL
YVTSVILHI	YVTSVILHI
FGLNIFHQL	FGLNIFHQL
ISSPVILQF	ISSPVILQF
YVENQFREF	YVENQFREF
YTDFHVDF	YTDFH-VDF
NAQFNREEL	NAQFNREEL
VAHVDDMPNAL	HVDDMPNAL
LSDHHIYL	LSDHH-IYL
FAIADAAYKAM	IADAAYKAM
FISPTGHSL	FISPTGHSL
LAVEPGSNL	LAVEPGSNL
TSDPAAHAL	TSDPAAHAL
RAEERTRQL	RAEERTRQL
TIMPRGPTL	TIMPRGPTL
YAMEQSIKSVL	YAMEQSKSV
YMIAHITGL	YMIAHITGL
FAYDPSNYEYL	FAYDPSEYL
FAAKGEGQL	FAAKGEGQL
SAASLYPVL	SAASLYPVL
SVNSHVTTL	SVNSHVTTL
QTQHPRMPL	QTQHPRMPL
SALEKFVEL	SALEKFVEL
HSIIPRGSL	HSIIPRGSL
QAAPPIEL	QAAPP-IEL
SIFEENLF	SIFEE-NLF
YSLDMWRL	YSLDM-WRL
SSAEPHRPL	SSAEPHRPL
TAAYVRIL	TAAYV-RIL
IAFQYSTVL	IAFQYSTVL
VAAPPTAVGSL	VAAPP-TAV
FALGGNKQAL	FALGGNQAL
YSFDYPSDM	YSFDYPSDM
CAIAQAESL	CAIAQAESL
FAHHASCHF	FAHHASCHF
YSSPFDPVL	YSSPFDPVL
FSDQFPLPL	FSDQFPLPL
YITTSKQSL	YITTSKQSL
DVKFGADARAL	FGADA-RAL
YATYPREL	YATYP-REL
FAEALATHIL	FAEALAHIL
QIIAFFAHL	QIIAFFAHL
YADSNFHDF	YADSNFHDF
FIEKRYVEL	FIEKRYVEL
VVIRGNSIIML	VVIRGNSII
AAYAGGLVL	AAYAGGLVL
IAIGSQPVL	IAIGSQPVL
VANTHHVSL	VANTHHVSL
LAAIATEL	LAAIA-TEL
LTDEGLKQL	LTDEGLKQL
YAGPLFIYL	YAGPLFIYL
FAHYRRKQM	FAHYRRKQM
FGFSHLEAL	FGFSHLEAL
SALNRMKEL	SALNRMKEL
AQVPFEQIL	AQVPFEQIL
FYILTSKEL	FYILTSKEL
SAPYGRITL	SAPYGRITL
LALELHQEL	LALELHQEL
HAAPYFQQL	HAAPYFQQL
VALPPGLAV	VALPPGLAV
LVPALTDDS	LVPALTDDS
YLADIFTKL	YLADIFTKL
FTLGTTVFL	FTLGTTVFL
FAVALPQLL	FAVALPQLL
WAQPGGAAF	WAQPGGAAF
YAMDELRSL	YAMDELRSL
FAYDGKDYL	FAYDGKDYL
ITHNGETL	ITHNG-ETL
KAIDFAASL	KAIDFAASL
FVSPLVKYL	FVSPLVKYL
LADHAARQL	LADHAARQL
YAIMPPLEQF	AIMPPLEQF
FVVDRLIAL	FVVDRLIAL
IATWGIVVM	IATWGIVVM
FIDTAQHML	FIDTAQHML
IASPVQPVL	IASPVQPVL
LTGAVGSLL	LTGAVGSLL
HAFAQPFAV	HAFAQPFAV
MSKSLGNVL	MSKSLGNVL
GALAVFPSL	GALAVFPSL
FSADGHTML	FSADGHTML
ITAPPSRVL	ITAPPSRVL
LAAPSNLSM	LAAPSNLSM
YVPDTTISL	YVPDTTISL
FSTRLFAVL	FSTRLFAVL
LAVPFCVNF	LAVPFCVNF
VAQGGWRSL	VAQGGWRSL
VAVTRAKAL	VAVTRAKAL
LVTDIQPVL	LVTDIQPVL
YVTESQPDL	YVTESQPDL
FSQGGALSL	FSQGGALSL
YANNVQRVM	YANNVQRVM
YAKIDPSL	YAKID-PSL
SANIRLTAM	SANIRLTAM
NAIEGGTQL	NAIEGGTQL
LSFTHPTSF	LSFTHPTSF
YALDVRVNSL	YALDVRNSL
VAIFPSPMM	VAIFPSPMM
YASDFHNVL	YASDFHNVL
LAIGPCKSL	LAIGPCKSL
FTTGAIKDL	FTTGAIKDL
AAFWGQMQM	AAFWGQMQM
FAFESDLHSL	FAFESDHSL
FLESGGFRSL	FLESGGRSL
VATEKAVEL	VATEKAVEL
YVYERMTGL	YVYERMTGL
LSEEQCREL	LSEEQCREL
FAVEPQGPAL	FAVEPQPAL
LSIEKALDL	LSIEKALDL
LAMGVNLTSM	LAMGVNTSM
YSLAAALTL	YSLAAALTL
VSVAAMHCL	VSVAAMHCL
IAEMVRHAL	IAEMVRHAL
FLEEANRVL	FLEEANRVL
LLIENVASL	LLIENVASL
DAFSKDHQL	DAFSKDHQL
FTIVAESL	FTIVA-ESL
AIVLGNFL	AIVLG-NFL
LSDPQVHTV	LSDPQVHTV
RAIESSRDL	RAIESSRDL
TAIIPNSQL	TAIIPNSQL
YGSPNALVL	YGSPNALVL
FSSDNIAVL	FSSDNIAVL
ALVLLRPVI	ALVLLRPVI
AAVKATQTL	AAVKATQTL
FADHVVPLL	FADHVVPLL
NAMDGYRTL	NAMDGYRTL
IVIADPPYL	IVIADPPYL
LTLRPGVSL	LTLRPGVSL
SVVFHSTVI	SVVFHSTVI
SILTTHTTL	SILTTHTTL
AAISHGRVF	AAISHGRVF
AAMPRIYEL	AAMPRIYEL
SAVSSFVFL	SAVSSFVFL
HAAKGLMTL	HAAKGLMTL
LSSLPLNSL	LSSLPLNSL
YILDPKQAL	YILDPKQAL
YAITRVLRL	YAITRVLRL
AAIKPGTPL	AAIKPGTPL
FSHRGAHTL	FSHRGAHTL
VALDFEQEM	VALDFEQEM
LAGPDHLSL	LAGPDHLSL
FAQSILQSL	FAQSILQSL
FSVVSPSSF	FSVVSPSSF
YVADPGGSL	YVADPGGSL
IIYTAKISL	IIYTAKISL
PTTKTYFPHF	TTKTYFPHF
GAIPAFISL	GAIPAFISL
IASQGREL	IASQG-REL
FANTPKYSQVL	NTPKYSQVL
IADGVFRFL	IADGVFRFL
TTIKPGLAL	TTIKPGLAL
FSGKSTEL	FSGKS-TEL
WAVEGTAVAL	AVEGTAVAL
IADPFFRSA	IADPFFRSA
GVISKVSTL	GVISKVSTL
SGIGVSQVL	SGIGVSQVL
LSDPTYREL	LSDPTYREL
LATRAIPEL	LATRAIPEL
FSMEEGDVL	FSMEEGDVL
FIYNDPTL	FIYND-PTL
VALGNMYEL	VALGNMYEL
YTDYRPTPL	YTDYRPTPL
WASPPGRWL	WASPPGRWL
FIGDSGIPL	FIGDSGIPL
FTVNPKGEL	FTVNPKGEL
LLAMPVMVL	LLAMPVMVL
FALPYVIVL	FALPYVIVL
YAEIVHLTL	YAEIVHLTL
SADDRCKVL	SADDRCKVL
FVGYGVTL	FVGYG-VTL
VGAPFTGSSL	VGAPFTSSL
FSSLTNLPL	FSSLTNLPL
LTDYLMKIL	LTDYLMKIL
KAYNRFYLL	KAYNRFYLL
FAMMSHHEM	FAMMSHHEM
FLYAGHIFL	FLYAGHIFL
HAASVFLTL	HAASVFLTL
MSMEISIHRSL	MEISIHRSL
IAFGQSMDL	IAFGQSMDL
GAMDLLREL	GAMDLLREL
FADHVSSSL	FADHVSSSL
FGIDRPAEL	FGIDRPAEL
FSSPHLVQV	FSSPHLVQV
AAASAFTSL	AAASAFTSL
AAFEALGTAL	AAFEALTAL
VSHPRYLEL	VSHPRYLEL
FAFRNFLYL	FAFRNFLYL
FAEMLTGKTL	FAEMLTKTL
AYIAHPKL	AYIAH-PKL
YSYPSRQM	YSYPS-RQM
FAFGSPIGM	FAFGSPIGM
RADDGFHLL	RADDGFHLL
TAINASRAL	TAINASRAL
AAAATVREL	AAAATVREL
SALAWQQSL	SALAWQQSL
TSCNPSRAL	TSCNPSRAL
FIYPSNMQTM	FIYPSNQTM
FAHPYQYEL	FAHPYQYEL
NAYTGIVL	NAYTG-IVL
TITDIISAL	TITDIISAL
SVDLLLLEL	SVDLLLLEL
FGYPDPTYL	FGYPDPTYL
NATHQHCVL	NATHQHCVL
AAVGSVATL	AAVGSVATL
WAQTKNAEL	WAQTKNAEL
FSTLGRVL	FSTLG-RVL
YVVPYMIHL	YVVPYMIHL
LAQAMETAL	LAQAMETAL
HAVFPTSSM	HAVFPTSSM
AVAPVASAL	AVAPVASAL
KIVKWDRDM	KIVKWDRDM
GAQEPSRPL	GAQEPSRPL
VIVDPETGKEM	IVDPETKEM
AVMNYLPTL	AVMNYLPTL
VIADPRGNTL	IADPRGNTL
IITAFIRAL	IITAFIRAL
YLLDHFLSM	YLLDHFLSM
TVIPHLMAL	TVIPHLMAL
LANPNYLNFL	LANPNYLNF
SANDGFVRL	SANDGFVRL
AAQIPTAAL	AAQIPTAAL
ISNVKKVSL	ISNVKKVSL
YVVPGETAL	YVVPGETAL
YTSPNVRSL	YTSPNVRSL
ISIGVTQIL	ISIGVTQIL
LTKEGRSL	LTKEG-RSL
IAEENGLEVL	IAEENGEVL
LSEPMVHEL	LSEPMVHEL
VSSPTMPHL	VSSPTMPHL
NADSATRLL	NADSATRLL
ASIPYFHAM	ASIPYFHAM
QASDHRPVL	QASDHRPVL
RVIDVGSEW	RVIDVGSEW
TAVSHTTIL	TAVSHTTIL
FADELSHLL	FADELSHLL
MVNPTVFF	MVNPT-VFF
FAYDGKDYIAL	FAYDGKIAL
AAIHPSLEI	AAIHPSLEI
QAFPRITQL	QAFPRITQL
NSSRESPSL	NSSRESPSL
IAEEQQRIL	IAEEQQRIL
HAHGRHFNL	HAHGRHFNL
LTTEVHPEL	LTTEVHPEL
YAMDYSNKAL	YAMDYSKAL
MVGPILEM	MVGPI-LEM
LSKCGEEL	LSKCG-EEL
FVEERRKQL	FVEERRKQL
LAWTSSAL	LAWTS-SAL
VSYGEGKAL	VSYGEGKAL
VAIKAGTTL	VAIKAGTTL
FAENNFTEL	FAENNFTEL
FALKGLRTL	FALKGLRTL
SIDERMKKL	SIDERMKKL
EVQSLPLPL	EVQSLPLPL
SIAGIFKEV	SIAGIFKEV
AAVAAKINAM	AVAAKINAM
IAVSTGASL	IAVSTGASL
YIPEITSVL	YIPEITSVL
FTQDTRSL	FTQDT-RSL
TAYPNRPMVL	TAYPNRMVL
FAEAGRSTL	FAEAGRSTL
FGLPRWVTL	FGLPRWVTL
IAQDQPKIL	IAQDQPKIL
FAVYIHALL	FAVYIHALL
VAVVGDPIAL	VAVVGDIAL
ISVASFQEL	ISVASFQEL
AAVHIILVI	AAVHIILVI
TTISSFPQL	TTISSFPQL
IASIHSFEL	IASIHSFEL
VASEIMAVL	VASEIMAVL
FASTMVHAL	FASTMVHAL
FAWKPQLL	FAWKP-QLL
KAFGQSSAL	KAFGQSSAL
LAYHLAVVL	LAYHLAVVL
GIIRPGCAL	GIIRPGCAL
FQHVGKAF	FQHVG-KAF
FANERCLQL	FANERCLQL
FVRIGAML	FVRIG-AML
YALPKSLSV	YALPKSLSV
VANGKLMIL	VANGKLMIL
KALSIFNEL	KALSIFNEL
YATIILSKM	YATIILSKM
FASGPREL	FASGP-REL
LTDGHPLTL	LTDGHPLTL
RAVAPTMSL	RAVAPTMSL
HISRVGQAM	HISRVGQAM
EAARVAEQL	EAARVAEQL
FINSIILFL	FINSIILFL
VANGQYSHL	VANGQYSHL
FLWDVPSNWTL	FLWDVPSNW
AAYDRYLKL	AAYDRYLKL
YALNHTLSV	YALNHTLSV
HVDGQTHML	HVDGQTHML
FADLNLAEF	FADLNLAEF
IAINISRNL	IAINISRNL
YSIYPKSEL	YSIYPKSEL
STIGQKIAL	STIGQKIAL
VADHIQKVM	VADHIQKVM
LAEAGGRAL	LAEAGGRAL
AATESAAEL	AATESAAEL
IATGKMLSL	IATGKMLSL
YTAEPVTL	YTAEP-VTL
NTDEMVEL	NTDEM-VEL
WAYPRQVFI	WAYPRQVFI
FAGVERLAL	FAGVERLAL
SSVGALHAL	SSVGALHAL
YIALPLTL	YIALP-LTL
YAMISSPFM	YAMISSPFM
LIVDRPVTL	LIVDRPVTL
ASDPNVSKKL	ASDPNVKKL
YIQTGDRLL	YIQTGDRLL
LSAPIHTQM	LSAPIHTQM
SALHYAVEL	SALHYAVEL
VSILPGQTL	VSILPGQTL
FSGSGNRL	FSGSG-NRL
FADPHGKRVF	FADPHGRVF
VALRGSHSL	VALRGSHSL
FATTSPLVL	FATTSPLVL
ITIKPVLSL	ITIKPVLSL
IAKSDPPTL	IAKSDPPTL
LAQVSGLEM	LAQVSGLEM
AAYAFAPATL	YAFAP-ATL
FTVPDTREL	FTVPDTREL
FADRSLLEM	FADRSLLEM
FSEEKRRQL	FSEEKRRQL
FAIQYGEDL	FAIQYGEDL
LAQRSARAL	LAQRSARAL
MALLGQAL	MALLG-QAL
RAVPVGSGL	RAVPVGSGL
FANMLGVSL	FANMLGVSL
TSDPGRHVM	TSDPGRHVM
YTVLTRIGL	YTVLTRIGL
YTHHTGSSL	YTHHTGSSL
KAYEIMREL	KAYEIMREL
FAYDGKDYLTL	FAYDGKDYL
FSIGADTAL	FSIGADTAL
FVVPNQKRL	FVVPNQKRL
VTDNPREL	VTDNP-REL
LVGPGVEL	LVGPG-VEL
RAIGIGAYL	RAIGIGAYL
GTIPWFMEI	GTIPWFMEI
FTSDIALRL	FTSDIALRL
GALFISPAL	GALFISPAL
YSFHKFHYL	YSFHKFHYL
LANSVMQTL	LANSVMQTL
CIWMSALF	CIWMS-ALF
TAEGHPKSL	TAEGHPKSL
LADCNDHQM	LADCNDHQM
FSLRGKEL	FSLRG-KEL
MAAAALTSL	MAAAALTSL
LAYHRLHQL	LAYHRLHQL
FLIIPLHSL	FLIIPLHSL
LTVEPGASL	LTVEPGASL
SAVDFIRTL	SAVDFIRTL
YAVHGNML	YAVHG-NML
AILPFYITL	AILPFYITL
FSKAKPSVL	FSKAKPSVL
HAVAEGAKNVL	VAEGAKNVL
FSTKGKSL	FSTKG-KSL
MATRTSPRL	MATRTSPRL
YTQQEVREL	YTQQEVREL
LSVAPQQSL	LSVAPQQSL
FVAEGGPEL	FVAEGGPEL
FATLTRPLAL	FATLTRLAL
RAAPLDSIHSL	APLDSIHSL
FAQAPQLSV	FAQAPQLSV
LVNEGSLAL	LVNEGSLAL
FALADWKEL	FALADWKEL
YAYGFEKPSAI	YGFEKPSAI
YTLEHMHAF	YTLEHMHAF
YSHNQRSVL	YSHNQRSVL
VAYDNAVNL	VAYDNAVNL
FGIDPIWSL	FGIDPIWSL
FVIPVVQAL	FVIPVVQAL
FSDIQTGRVL	FSDIQTRVL
VALPVYLLI	VALPVYLLI
FAVWGGLFSM	FAVWGGFSM
YAYDGKDYL	YAYDGKDYL
VAFPSPAEL	VAFPSPAEL
ITFVNKHL	ITFVN-KHL
FVDPAQITM	FVDPAQITM
IAAPTSSAL	IAAPTSSAL
AAVDTNLTL	AAVDTNLTL
YTLSPENLQSL	LSPENLQSL
YAETIAHIL	YAETIAHIL
YSYSEKEL	YSYSE-KEL
KATFHYRTL	KATFHYRTL
AADDSKLVL	AADDSKLVL
LAFPSPEKL	LAFPSPEKL
FALLTTPEM	FALLTTPEM
FVDSDRDDL	FVDSDRDDL
AAAVGLEL	AAAVG-LEL
YSLVSREL	YSLVS-REL
SSHKTFRIKRF	SSHKTFRIK
MAWRALHPL	MAWRALHPL
VAEERGAVL	VAEERGAVL
FSIDVGYERFL	FSIDVGYER
YIIDPQNGLSF	YIIDPQNGL
FMVEKGPTL	FMVEKGPTL
FASFPSINL	FASFPSINL
FAHEVGHNF	FAHEVGHNF
ISNGELFQVL	ISNGELQVL
LTFVDPVL	LTFVD-PVL
TVVDRPQQPM	VVDRPQQPM
FFLIGPPL	FFLIG-PPL
YANYYTREV	YANYYTREV
FTLDVMKEL	FTLDVMKEL
YMDAPKAAL	YMDAPKAAL
YAMMKKMQL	YAMMKKMQL
FAGNSREL	FAGNS-REL
FSHQGVQL	FSHQG-VQL
HAYLSKNSL	HAYLSKNSL
ITDEQIQEM	ITDEQIQEM
YFITPTGHSL	FITPTGHSL
IAENLPKQL	IAENLPKQL
FSHVAMIL	FSHVA-MIL
SAYAGFLAL	SAYAGFLAL
SAAGLHRAL	SAAGLHRAL
VAQTWFRFL	VAQTWFRFL
FAFSPDGKFL	FAFSPDKFL
LAEAESRVL	LAEAESRVL
LAVLGRAL	LAVLG-RAL
FAADAMARL	FAADAMARL
FVLGRLLTL	FVLGRLLTL
VANGRIQSL	VANGRIQSL
KSKNPGEAL	KSKNPGEAL
SAAPLGTTL	SAAPLGTTL
IAHELGHSL	IAHELGHSL
AAIDHQIEV	AAIDHQIEV
LAAKPQSKL	LAAKPQSKL
LAQQKKAL	LAQQK-KAL
VVNPWGEVL	VVNPWGEVL
VAFLAMLLVL	VAFLAMLVL
FAGKVLRL	FAGKV-LRL
AALWPIMTAL	AALWPITAL
FGVFSGHTL	FGVFSGHTL
FTFPSHSL	FTFPS-HSL
NAITAFSTL	NAITAFSTL
YAIGLVMRL	YAIGLVMRL
YTDLPNRQL	YTDLPNRQL
SSIQHTQEL	SSIQHTQEL
IAIDGGKVL	IAIDGGKVL
AAIPYWLLL	AAIPYWLLL
YACAQSSKL	YACAQSSKL
YQIPTENSM	YQIPTENSM
AAFAHFPEL	AAFAHFPEL
QAVKIGQSL	QAVKIGQSL
WITDPKTAL	WITDPKTAL
FVTAVNLVL	FVTAVNLVL
TGIPVHLEL	TGIPVHLEL
SITSKPATL	SITSKPATL
FAIQKGLQA	FAIQKGLQA
AATKVTTVL	AATKVTTVL
NALKPGFFSHL	ALKPGFSHL
FSVGPDALMAL	FSVGP-DAL
HTIVPGQVL	HTIVPGQVL
QIPELPDPSL	IPELPDPSL
LATWATKEL	LATWATKEL
AAIWQYESL	AAIWQYESL
FAVVATGETAL	VVATGETAL
LILSPTREL	LILSPTREL
YVIGPKNNL	YVIGPKNNL
LIGPPLLI	LIGPP-LLI
YGAEALERMFL	YGAEALERM
HFSAYSSLI	HFSAYSSLI
MVNPVIYAL	MVNPVIYAL
FATSTEPVL	FATSTEPVL
VAHSPPSTL	VAHSPPSTL
FTYEAVEL	FTYEA-VEL
FQVNHTVAL	FQVNHTVAL
IADEEQKAL	IADEEQKAL
LSFKGKSL	LSFKG-KSL
FLAEAARSL	FLAEAARSL
LVINIIHSL	LVINIIHSL
FLAPSLVL	FLAPS-LVL
LSMERMVPA	LSMERMVPA
NAFKEITTM	NAFKEITTM
HALGGSSAL	HALGGSSAL
YIDSIPKTL	YIDSIPKTL
RTISVILFL	RTISVILFL
GVIDAYMTL	GVIDAYMTL
FAQGDVITL	FAQGDVITL
LATDAVQIL	LATDAVQIL
FAMKSVTQM	FAMKSVTQM
LAITTVLSL	LAITTVLSL
PISLDLTFHLL	ISLDLTFHL
YTSPVIPAL	YTSPVIPAL
IAFGPALAL	IAFGPALAL
AADPVSPLL	AADPVSPLL
YSAPVIHVL	YSAPVIHVL
ALHLLALLF	ALHLLALLF
FSANPKEL	FSANP-KEL
HAAEALLL	HAAEA-LLL
RAINIALQL	RAINIALQL
VTIKEGSQL	VTIKEGSQL
LLVDHFMEL	LLVDHFMEL
LAQGDMKQL	LAQGDMKQL
YQDPSFHLSL	YQDPSFLSL
GAAAPLLPM	GAAAPLLPM
YAREGEVM	YAREG-EVM
FAEASGLEL	FAEASGLEL
FAYTGRTAQEL	YTGRTAQEL
FVAPPLVM	FVAPP-LVM
FTTDAIAL	FTTDA-IAL
FSSNPISL	FSSNP-ISL
LSLPSTQSL	LSLPSTQSL
YSHVNKKAL	YSHVNKKAL
LASVPSPAL	LASVPSPAL
KATPQVPVL	KATPQVPVL
FAEDSLRVI	FAEDSLRVI
FSYPPHVGL	FSYPPHVGL
VVIGNIGAL	VVIGNIGAL
HAVAAAREL	HAVAAAREL
LAFGDRIAL	LAFGDRIAL
SIREAGGAF	SIREAGGAF
IAFPKAEEL	IAFPKAEEL
AAIANHQVL	AAIANHQVL
FTNEGRAL	FTNEG-RAL
GIKPVQRM	GIKPV-QRM
FTVPFYKQL	FTVPFYKQL
RVAPEEHPTL	VAPEEHPTL
YTSEMRSEL	YTSEMRSEL
LANEHNVAL	LANEHNVAL
IAWKGDTLVL	IAWKGDLVL
AVVDVRIGM	AVVDVRIGM
YSKPTLSAL	YSKPTLSAL
YAAQASQAL	YAAQASQAL
KAFQKIVVL	KAFQKIVVL
FVSEQLTSL	FVSEQLTSL
FTVPHTHVF	FTVPHTHVF
LAVQGKRTL	LAVQGKRTL
AATAATLAL	AATAATLAL
KIDEKTAEL	KIDEKTAEL
IAVNPSIL	IAVNP-SIL
AAAGTFKVL	AAAGTFKVL
FQLPYNGVVL	FQLPYNVVL
FGFSSGAFL	FGFSSGAFL
WAMDLRPEL	WAMDLRPEL
YSHDGAFL	YSHDG-AFL
TGWTGIAL	TGWTG-IAL
LAIYHVIMSVL	AIYHVISVL
FIVAEGDSL	FIVAEGDSL
FAAQRGLAV	FAAQRGLAV
FIYVNQSF	FIYVN-QSF
YSCDHNTSL	YSCDHNTSL
SAAPAIYL	SAAPA-IYL
AALDIYETL	AALDIYETL
HSHVGYTL	HSHVG-YTL
SAIGLSIAL	SAIGLSIAL
AAIKAFIAV	AAIKAFIAV
YSIVGLSSL	YSIVGLSSL
LAIPFAITI	LAIPFAITI
QAGPINREM	QAGPINREM
FSVGLQPTL	FSVGLQPTL
HADHSSLTL	HADHSSLTL
SAAMPGASL	SAAMPGASL
VIAPVGESL	VIAPVGESL
SASSFFKEL	SASSFFKEL
LLAQPGEAL	LLAQPGEAL
IVMPLHYSL	IVMPLHYSL
FIIQYQESL	FIIQYQESL
YTIPLSPVL	YTIPLSPVL
FSFDGPEI	FSFDG-PEI
YIDQRIHEL	YIDQRIHEL
FAEDTEAKNPF	FAEDT-EAK
FLIRESETL	FLIRESETL
YAVDPAQLQAL	YAVDP-AQL
NAGPAIVI	NAGPA-IVI
QAIKNGQAL	QAIKNGQAL
FSMLESPAL	FSMLESPAL
SAYPLSVEW	SAYPLSVEW
TADGMVHLL	TADGMVHLL
SAVDLPVTL	SAVDLPVTL
KSVTPASTL	KSVTPASTL
LAVDPNGIYL	LAVDPNIYL
IAVGIFQLL	IAVGIFQLL
FGSDISPEI	FGSDISPEI
TAISFAPYL	TAISFAPYL
ITRVGLAL	ITRVG-LAL
FSYEHFYVI	FSYEHFYVI
LAALLHAIA	LAALLHAIA
HIIATSKSL	HIIATSKSL
FASVVDIKL	FASVVDIKL
FSYQVASTL	FSYQVASTL
LAKKPHTSL	LAKKPHTSL
VAEEVTREL	VAEEVTREL
SAMSNPRAM	SAMSNPRAM
LSTPYIHSL	LSTPYIHSL
HVINTGNSM	HVINTGNSM
GSFDVADRMF	GSFDVADRM
YAKLGLSL	YAKLG-LSL
AAAWPLLL	AAAWP-LLL
FAISKNIQL	FAISKNIQL
FAAPTTGNQI	FAAPTTNQI
WADAMAKVL	WADAMAKVL
ISAIPTRSL	ISAIPTRSL
IADLAHLL	IADLA-HLL
AIVKVFLAL	AIVKVFLAL
LAVEKAAEL	LAVEKAAEL
SAVEPKTAL	SAVEPKTAL
SAHEPGGSL	SAHEPGGSL
MAISKPRNL	MAISKPRNL
YILPWESEL	YILPWESEL
SAVPGDLLTL	SAVPGDLTL
LACLHIATL	LACLHIATL
WAEWGHREL	WAEWGHREL
FADDTYPRWV	FADDTYPRW
IAFNDMNPF	IAFNDMNPF
DALELGLVI	DALELGLVI
GANHISPFL	GANHISPFL
FLMPTSSEL	FLMPTSSEL
EAYTGGLEL	EAYTGGLEL
HAMVILLTL	HAMVILLTL
VAHTKIQAL	VAHTKIQAL
YAEQLHVQL	YAEQLHVQL
IALNEKLVNL	ALNEKLVNL
AAVGEPAFL	AAVGEPAFL
FAHHKNQTL	FAHHKNQTL
FSFVMPSL	FSFVM-PSL
ITHLGHSL	ITHLG-HSL
QLLDIKIRL	QLLDIKIRL
ASVTSRTSM	ASVTSRTSM
LSIEQLTTL	LSIEQLTTL
NSDDRVLL	NSDDR-VLL
YAAEGQKL	YAAEG-QKL
YAYDGKDYIA	YAYDGKDYI
FAIDPHLLLSV	FAIDPHLLL
IGYSSPLTL	IGYSSPLTL
FQYSKSPSL	FQYSKSPSL
TIDTSRVSL	TIDTSRVSL
FVVSFSQVL	FVVSFSQVL
FSVTGTSL	FSVTG-TSL
HILDFSPSL	HILDFSPSL
SAIPHPLIM	SAIPHPLIM
LAVPIFVAL	LAVPIFVAL
FVHQGETEL	FVHQGETEL
FSTSVVRPF	FSTSVVRPF
YAVDAYFREAL	YAVDAYREA
FQEPDIHFL	FQEPDIHFL
YSQEQRQAF	YSQEQRQAF
AAATSALLL	AAATSALLL
FACEKNENL	FACEKNENL
FAEGFVKAL	FAEGFVKAL
FSIEPWLKV	FSIEPWLKV
FALLAGTAV	FALLAGTAV
FAVEEGDHL	FAVEEGDHL
FTSLPGSTM	FTSLPGSTM
FAYKNVKF	FAYKN-VKF
VTKSSPRAL	VTKSSPRAL
KAVETVHNL	KAVETVHNL
LSVEIVHEL	LSVEIVHEL
LTYLQRAL	LTYLQ-RAL
FSYITAVTL	FSYITAVTL
FSLPENIQLSL	FSLPENIQL
NASEDRLEL	NASEDRLEL
IILAPTREL	IILAPTREL
SAYQNHLIL	SAYQNHLIL
AAAPPLTL	AAAPP-LTL
MIDETRNSL	MIDETRNSL
AAFPGASL	AAFPG-ASL
IVIDGSGAL	IVIDGSGAL
AAAPQSLEF	AAAPQSLEF
LATAVIPQW	LATAVIPQW
IVNGHTLLV	IVNGHTLLV
LAYSGKLEEL	LAYSGKEEL
LAHGERAEL	LAHGERAEL
SAATASPQL	SAATASPQL
ISDLGQHTL	ISDLGQHTL
YATDVVEAFL	YATDVVEAF
VGAEPLLPW	VGAEPLLPW
LVFPGFFEL	LVFPGFFEL
HATQAIFEI	HATQAIFEI
FSVEGQLEF	FSVEGQLEF
YAIREEIVL	YAIREEIVL
HVMKAMQSL	HVMKAMQSL
VAMTGEITL	VAMTGEITL
FMSDLMKAL	FMSDLMKAL
FQYSSHVSL	FQYSSHVSL
VAHLGSQL	VAHLG-SQL
YLLEKSRIV	YLLEKSRIV
YASEIKEL	YASEI-KEL
FQNALIVR	FQNAL-IVR
SAVTPDIPL	SAVTPDIPL
FAHVGQLTGM	FAHVGQTGM
LSFTSQEL	LSFTS-QEL
VMAPRTLIL	VMAPRTLIL
IANVGSREM	IANVGSREM
LAYIHLIEF	LAYIHLIEF
DVAPSRLDF	DVAPSRLDF
FLLEKPFSV	FLLEKPFSV
VAAPASLSL	VAAPASLSL
FVVPDTVDM	FVVPDTVDM
FLYDKALTF	FLYDKALTF
FSLDLVHTL	FSLDLVHTL
FSDPHTAGL	FSDPHTAGL
GAVSPFGML	GAVSPFGML
SVVTVPSSSL	VVTVPSSSL
SSGLPRNTVVL	SGLPRNVVL
VADVRLYSL	VADVRLYSL
YSISGPHVL	YSISGPHVL
KVGLALEL	KVGLA-LEL
FGNPRKPVL	FGNPRKPVL
FTDSGIHII	FTDSGIHII
FSHDQYREL	FSHDQYREL
SSDSTFLVL	SSDSTFLVL
YAQLHSLTL	YAQLHSLTL
LTVDPQGAL	LTVDPQGAL
RAIEIYTDM	RAIEIYTDM
YVLEGKEL	YVLEG-KEL
VAVKGRQAL	VAVKGRQAL
SAANIQPIF	SAANIQPIF
YTSGTFRTV	YTSGTFRTV
FSADPRHIL	FSADPRHIL
AALPPVSPL	AALPPVSPL
VASAVCLRL	VASAVCLRL
LGIPYAQPPL	LGIPYAPPL
LSRNGKSL	LSRNG-KSL
FAVDPQITSL	FAVDPQTSL
FQYPDTRYL	FQYPDTRYL
VADTVYRAL	VADTVYRAL
FSDPTSKMRHL	FSDPT-SKM
NALFHASTL	NALFHASTL
AAEEESRVL	AAEEESRVL
YQYPRPLLI	YQYPRPLLI
FAHGNAEL	FAHGN-AEL
YADPNFVRTF	YADPNFRTF
LTLKHVKAL	LTLKHVKAL
NVVSSGHAL	NVVSSGHAL
YIDEQFERYL	YIDEQFRYL
ATISYILTL	ATISYILTL
FAAIGSAVF	FAAIGSAVF
TATDIRVTL	TATDIRVTL
RAIELATTL	RAIELATTL
MAFNKFNVL	MAFNKFNVL
TVMDKTRAL	TVMDKTRAL
WTKNGVEL	WTKNG-VEL
NAESGRGQVM	NAESGRQVM
LVIGLSREL	LVIGLSREL
VALGQVLSL	VALGQVLSL
YVLEHNLHL	YVLEHNLHL
SISTALLLL	SISTALLLL
YGFQYPLAM	YGFQYPLAM
LINANMMVL	LINANMMVL
FAIGVNFLI	FAIGVNFLI
KSFPGIPL	KSFPG-IPL
LAYMNHIMV	LAYMNHIMV
LSKVGQAL	LSKVG-QAL
ISIHVGQAG	ISIHVGQAG
YSLSSTLTL	YSLSSTLTL
QANIRLTSL	QANIRLTSL
YAYAAQNLL	YAYAAQNLL
SIIDPFGMPM	IIDPFGMPM
YQIAVTKVL	YQIAVTKVL
FSVPDVPKSM	FSVPDVKSM
FTYGLHMIL	FTYGLHMIL
AIMDLLLRL	AIMDLLLRL
KVIDQQNGL	KVIDQQNGL
YGNPNTLRL	YGNPNTLRL
FASTILHLVV	FASTI-LHL
FTVTVPKEL	FTVTVPKEL
FAIYKMSFF	FAIYKMSFF
LSDEHAREM	LSDEHAREM
TALGVIRSL	TALGVIRSL
LSSPFPSSSF	LSSPFPSSF
YAPYPSPVL	YAPYPSPVL
FSYGFDGRGL	FSYGFDRGL
YFNEGTVL	YFNEG-TVL
LATVLGRF	LATVL-GRF
FAMIPAKEA	FAMIPAKEA
MSSDVFPLL	MSSDVFPLL
GALPYFSEM	GALPYFSEM
SALPFITYL	SALPFITYL
MAHADPTEL	MAHADPTEL
FAVPIESDKTL	FAVPIEKTL
SADNVRQQL	SADNVRQQL
FAETGRTFL	FAETGRTFL
YVGPAKVI	YVGPA-KVI
ISDHAKVL	ISDHA-KVL
IAVPAVLPSF	IAVPAVPSF
LITQLKML	LITQL-KML
LTCLVPAAL	LTCLVPAAL
SAAPHTQSM	SAAPHTQSM
SAYRSVNSL	SAYRSVNSL
RAQRPRLQL	RAQRPRLQL
YSNPAVKTAL	YSNPAVTAL
FLLEHIRIL	FLLEHIRIL
AANVHHPVL	AANVHHPVL
YTIMSPAVL	YTIMSPAVL
YTLLGHEF	YTLLG-HEF
SAASITPLL	SAASITPLL
FISLDEINL	FISLDEINL
YSIGNGSVF	YSIGNGSVF
ASEGKYRAL	ASEGKYRAL
VACGASHVL	VACGASHVL
FVENHERTF	FVENHERTF
VVLGQFLVL	VVLGQFLVL
YAIDNPLHY	YAIDNPLHY
TIAPTLIA	TIAPT-LIA
VSIFSSASL	VSIFSSASL
YAHSGEHHL	YAHSGEHHL
SAIHVLASL	SAIHVLASL
SIQSHQESL	SIQSHQESL
YVISQKESL	YVISQKESL
IIIPNPAAL	IIIPNPAAL
IAQGQMTVL	IAQGQMTVL
FTIPHTQEA	FTIPHTQEA
FIIDDKGIL	FIIDDKGIL
FSQTHLKEL	FSQTHLKEL
LAAAVHKEM	LAAAVHKEM
FAIRPMYL	FAIRP-MYL
FAWEPFRGLEL	FAWEPFRGL
FIEEAYKKL	FIEEAYKKL
FIHKEQNSL	FIHKEQNSL
YLYVGPSL	YLYVG-PSL
KAMEAASSL	KAMEAASSL
YLIEPDVEL	YLIEPDVEL
FSAGDNPPVL	SAGDNPPVL
ATDPSARTL	ATDPSARTL
GADGSVRMF	GADGSVRMF
ASLPSGLPI	ASLPSGLPI
LATKTTPAL	LATKTTPAL
KTVYALPTIAF	YALPT-IAF
AVGPASIL	AVGPA-SIL
FSELSNPESL	FSELSNESL
IAVDKANL	IAVDK-ANL
YSFDGPSL	YSFDG-PSL
MSIYPSPTGVL	SIYPSPGVL
HAIEESVVL	HAIEESVVL
SSAHPGLEF	SSAHPGLEF
FANSRDTSF	FANSRDTSF
FSEPFHLIV	FSEPFHLIV
AAMQDPEVM	AAMQDPEVM
LATGAAMVL	LATGAAMVL
TGIPGLEQL	TGIPGLEQL
HANPILLLV	HANPILLLV
VSIAPLLEL	VSIAPLLEL
IVDGAVVKF	IVDGAVVKF
FIKESTATTF	FIKESTTTF
LVIDNGSGM	LVIDNGSGM
FLADPVSNM	FLADPVSNM
YAACQSHAF	YAACQSHAF
FAIPGSIFL	FAIPGSIFL
SASPASLLL	SASPASLLL
QVKSGTIFDNF	QVKSG-TIF
FSIDPARTL	FSIDPARTL
SALDTGFSL	SALDTGFSL
YVDPRGSPAL	YVDPRGPAL
VAVNKPAEF	VAVNKPAEF
FAEEVGAAL	FAEEVGAAL
FISHLFMQL	FISHLFMQL
SADFPRVGM	SADFPRVGM
AASMRALVL	AASMRALVL
LAVAGATSL	LAVAGATSL
FAYLRDLLI	FAYLRDLLI
YLIGVHASL	YLIGVHASL
YSLDTRSEL	YSLDTRSEL
AAMKLMTAL	AAMKLMTAL
TAIERSQTL	TAIERSQTL
VAVISGEAL	VAVISGEAL
YAMRAFADAL	YAMRAFDAL
YVVDDAAVL	YVVDDAAVL
SAYGKFRKL	SAYGKFRKL
FSHSFSAL	FSHSF-SAL
AAAAPPLTL	AAAAPPLTL
VVYPKPEQL	VVYPKPEQL
AAQGKTRTL	AAQGKTRTL
TTMVPTAAL	TTMVPTAAL
ISDTQRISL	ISDTQRISL
ASGPPVSEL	ASGPPVSEL
LAAQGKEL	LAAQG-KEL
ASLSTFQQM	ASLSTFQQM
SAFPEVRSL	SAFPEVRSL
VADPPRDSKGL	VADPPRKGL
FAVADTVYRAL	VADTVYRAL
FIVGDQISF	FIVGDQISF
MAIAMALTGGI	IAMALTGGI
TAFIGPAL	TAFIG-PAL
FTLPMMSTL	FTLPMMSTL
FTDEESRVF	FTDEESRVF
FGNNKLTTF	FGNNKLTTF
LSFDAISTL	LSFDAISTL
LANIRSPVF	LANIRSPVF
IAAPFTSKL	IAAPFTSKL
NAVSVHSNL	NAVSVHSNL
MAEKKTRAL	MAEKKTRAL
FAYNFREEL	FAYNFREEL
SALRPSTSRSL	SALRPSRSL
FTLGDIAQL	FTLGDIAQL
YTLLHNPTL	YTLLHNPTL
GAMGAFRAL	GAMGAFRAL
TAVNNPKSL	TAVNNPKSL
