Data	Data aligned
IYQDVTLKW	IYQDVTLKW
IYMFNMTGL	IYMFNMTGL
SYLEPGSIRHI	SYLE-PGSI
IFIDPGYQTF	IFIDGYQTF
YYPVAPHPTQI	PVAPHPTQI
TFLVGERVTL	TFLVERVTL
RYIPDAMNL	RYIPDAMNL
VITPVLLHF	VITPVLLHF
FSPVGSVL	FSPV-GSVL
KYSTIEFDFL	KYSTEFDFL
MYTDIQEPM	MYTDIQEPM
IYPATIASIDF	IYPATIASI
VLPGFTFIQHL	VLPG-FTFI
IYTWIEDHF	IYTWIEDHF
RYFISHVLAFF	YFISHVLAF
LYAEVPSSFHW	LYAEVPSSF
SYMVRELLIQF	SYMVRELLI
PYHPHPHVF	PYHPHPHVF
IYKAPSENW	IYKAPSENW
QWPPDPPLHF	QWPPPPLHF
AYTLIAPNI	AYTLIAPNI
IYEQVFAKL	IYEQVFAKL
WYMDNPQNL	WYMDNPQNL
QYSNNIRQLL	QYSNIRQLL
FYQPKIQQF	FYQPKIQQF
VYSPKSPSL	VYSPKSPSL
VFPHLPLIAI	VFPHPLIAI
QYADMLNKKF	QYADLNKKF
VYVTSPLVNNF	VTSPLVNNF
VVLDDKDYFLF	VLDDDYFLF
VYISNGQVL	VYISNGQVL
KWFNVRNGYGF	KWFNVRNGY
YYTKVYQEI	YYTKVYQEI
RYLEQLHQL	RYLEQLHQL
EYLAGHYML	EYLAGHYML
VYEYVVERF	VYEYVVERF
KFMPVSSLI	KFMPVSSLI
VYSPHVLNLTL	VYSPHVLNL
VTPERIAENF	VTPEIAENF
VYKTHIDVI	VYKTHIDVI
PYYLNLIELF	YYLNLIELF
RYVMTTTTL	RYVMTTTTL
AYSSILSSL	AYSSILSSL
YYVNGTYRL	YYVNGTYRL
FYFDESFFHF	FYFDSFFHF
AYVTVLEGF	AYVTVLEGF
ITPEVLPGW	ITPEVLPGW
HYLNHWNHF	HYLNHWNHF
VYNNIMRHYL	VYNNMRHYL
EYISTVKTL	EYISTVKTL
SYTALFPQL	SYTALFPQL
VFNDVRLLL	VFNDVRLLL
TFTFSHATF	TFTFSHATF
TYEAQFFGF	TYEAQFFGF
RMLPPPPMW	RMLPPPPMW
YYFEVVQKL	YYFEVVQKL
RYDNVTILF	RYDNVTILF
IYPLHELALW	IYPLELALW
RYVEIVSQF	RYVEIVSQF
EEDMNNGSF	EEDMNNGSF
FYLPSSPNL	FYLPSSPNL
SYIPIFPQLYF	SYIPIFPQL
RYTDIDYQVF	RYTDDYQVF
RYNPENNTW	RYNPENNTW
ILPGSLFRF	ILPGSLFRF
RYSVFFQSL	RYSVFFQSL
KYITDVVKL	KYITDVVKL
EYLSKQDLLFL	EYLSKQDLL
AFLKVSSVF	AFLKVSSVF
KYNLVTHIL	KYNLVTHIL
RYVASYLLAAL	RYVA-SYLL
NAPWAVTSL	NAPWAVTSL
RYFKGPELL	RYFKGPELL
KYVPAIAHL	KYVPAIAHL
YFISPTGHSL	YFISTGHSL
PYNAPTVKF	PYNAPTVKF
VYIVPVIVL	VYIVPVIVL
PYDPNFYDETY	PYDPNFYDE
QSVAYLAALL	SVAYLAALL
GWLPPELLGLW	GWLPELLGL
LRPLLAAAA	LRPLLAAAA
HFSVEGQLEF	HFSVGQLEF
RYALLPHLY	RYALLPHLY
DYSSILQKF	DYSSILQKF
RYTPVGRSF	RYTPVGRSF
IYHDLEQSI	IYHDLEQSI
EYLTKVDKL	EYLTKVDKL
DYLEWPEYF	DYLEWPEYF
KYIESPVLFL	KYIESPVLF
AYVHMVTHF	AYVHMVTHF
AYGSLFNTI	AYGSLFNTI
NYMVYMFQYD	NYMVYMFQY
KFFQSTKLDW	KFFQ-STKL
KYVERIHYI	KYVERIHYI
IYLNSSLVQF	IYLNSLVQF
YFLPITPQF	YFLPITPQF
YYQTDLVNI	YYQTDLVNI
IYREFREEESL	IYREFREEE
IYNGDMEKILL	IYNGDMEKI
IQVRYLKII	IQVRYLKII
KFLEHTNFEF	KFLETNFEF
RYPTSIASLAF	RYPTSIASL
PYAVLLEAL	PYAVLLEAL
RYQETFNVI	RYQETFNVI
YISDPTILW	YISDPTILW
VYMLAASLL	VYMLAASLL
VLPNSDFLVHF	VLPNSDFLV
EQPETYYKW	EQPETYYKW
RYYGNISRF	RYYGNISRF
RYNGLSFVYL	RYNGSFVYL
IFTDLSSRF	IFTDLSSRF
VLPSRFLNW	VLPSRFLNW
RYTPFSNGL	RYTPFSNGL
KYLSVQGQLF	KYLSQGQLF
RYNVPFLTF	RYNVPFLTF
VVVPAEWIKNW	VPAEWIKNW
LYLKLWNLI	LYLKLWNLI
IYGSVWEKL	IYGSVWEKL
EYLMQLNTI	EYLMQLNTI
VYIHHFDRI	VYIHHFDRI
VYNIHLAVNFL	VYNILAVNF
SYTHIQYLF	SYTHIQYLF
AYAENIALL	AYAENIALL
HFFGDFGFM	HFFGDFGFM
SYDPLRIYL	SYDPLRIYL
TYAALNSKATF	AALNSKATF
KYLEESNFV	KYLEESNFV
NYIPYLTKL	NYIPYLTKL
IYYVDVQKF	IYYVDVQKF
VMAPRTLVL	VMAPRTLVL
TYNLLSERW	TYNLLSERW
IYMVHIQVTL	IYMVIQVTL
RYTFYVLEF	RYTFYVLEF
DYSRIIQSW	DYSRIIQSW
KYLNWDAVFRF	KYLNWDAVF
RYLEKPMEI	RYLEKPMEI
SYPLNSYEL	SYPLNSYEL
VYHILKVLF	VYHILKVLF
QYLTFKPQTF	QYLTKPQTF
KYKNSEINFSF	KYKNSEINF
NWNEIVDSF	NWNEIVDSF
RYMDAWNTV	RYMDAWNTV
IYSPLLFKYF	IYSPLFKYF
YLMHNYPAF	YLMHNYPAF
VYSPHVLNL	VYSPHVLNL
SYPDSNGMPVW	SYPD-SNGM
TYTYEKLLW	TYTYEKLLW
VYAPPVGGFSF	VYAPPVGGF
YLPAINGIVF	YLPANGIVF
TYSQLITLVNF	TYSQLITLV
IYFASVSETF	IYFAVSETF
IYNGKLFDLL	IYNGLFDLL
SMTRYFYLF	SMTRYFYLF
RYTPEQDTMTF	RYTPEQDTM
RYAAQLPAL	RYAAQLPAL
KLPDVYGVFQF	KLPDVYGVF
FWNDVKDPVSI	NDVKDPVSI
GYLPLAHVL	GYLPLAHVL
NWFDLWSDGHL	FDLWSDGHL
VYLPGSRQTL	VYLPSRQTL
RYPDNLKHLYL	RYPDNLKHL
VYPEKLATKF	VYPELATKF
TYTTVPRVAF	TYTTPRVAF
VFIRGGEEF	VFIRGGEEF
AYQHLFYLL	AYQHLFYLL
PYLISGSKF	PYLISGSKF
RYQFLEEAF	RYQFLEEAF
IWDTAGQESF	IWDTGQESF
NYIDKVRFL	NYIDKVRFL
AYLPKMMTL	AYLPKMMTL
YYQNYFEKL	YYQNYFEKL
KYGIVLKEF	KYGIVLKEF
AYAELIKQMW	AYAELIKQM
VLPDADTLLHF	VLPDADTLL
SYPDLLPTF	SYPDLLPTF
KYLKAVEEL	KYLKAVEEL
VYAQVARLF	VYAQVARLF
LFKNDPLFF	LFKNDPLFF
QFIGYPITLF	QFIGYPITL
EYSKYLQQAF	EYSKLQQAF
IYSIDFTRF	IYSIDFTRF
RYQDAIRVF	RYQDAIRVF
SYIRPEDIVNF	IRPEDIVNF
FYNKKVENF	FYNKKVENF
NYAWVYYHL	NYAWVYYHL
VFLKNEKGQYI	FLKNKGQYI
VYQQVYRPVYF	VYQQYRPVY
IYLEKLKTI	IYLEKLKTI
GWLYYEAGQRF	LYYEAGQRF
TYGDAGLTYTF	TYGDAGLTY
FYPPHPDYTW	FYPPPDYTW
GFLDKNNDLLF	GFLDNNDLL
RYFDPANGKF	RYFDANGKF
QYSDALEHLL	QYSDALEHL
VYNEQIHDLL	VYNEIHDLL
YYVWLQHTL	YYVWLQHTL
KWFFQKLRF	KWFFQKLRF
KYLEDRGEVTF	KYLEDRGEV
SYLPISPTF	SYLPISPTF
YYSPHGHILVL	YYSPHGHIL
EYNQWFTKL	EYNQWFTKL
YYTWTDGYRF	YYTWDGYRF
RYQEVIQEL	RYQEVIQEL
IYQKPFQTL	IYQKPFQTL
YYKATEPVIAF	YYKATEPVI
PYPQYFTQL	PYPQYFTQL
VQPKQDAFANF	PKQDAFANF
TYMDRVFKQF	TYMDVFKQF
VVYPWTQRF	VVYPWTQRF
VFTAFTEEF	VFTAFTEEF
SFLFVHPEW	SFLFVHPEW
AYPPAPFMHIL	AYPPPFMHI
VYGNERFIQYL	VYGNRFIQY
QIFRPDNFVF	IFRPDNFVF
YYGEKIGIYF	YYGEIGIYF
VYFQYVGTDF	VYFQVGTDF
RYPNKLDTI	RYPNKLDTI
YYMKDLPTSF	YYMKLPTSF
VFPLLVAETF	VFPLVAETF
VYQLRFQFL	VYQLRFQFL
LYTEVTRYL	LYTEVTRYL
NISGIEEVNMF	SGIEEVNMF
YFIPATGHSL	YFIPTGHSL
TYLEKFQNL	TYLEKFQNL
GYPEVALHF	GYPEVALHF
IYSWFTRTF	IYSWFTRTF
VFGYHGYTF	VFGYHGYTF
MYKTTPDVIF	MYKTTPDVI
KYNILGTNTI	KYNIGTNTI
EYPDVAWPLRF	EYPDVAWPL
EFTSPPSLF	EFTSPPSLF
FYPEEVSSMVL	FYPEEVSSM
DYMNLLGMIF	DYMNLGMIF
RYQDGVYWAEF	RYQD-GVYW
VFSTVVIHF	VFSTVVIHF
AYAPQGWIAFF	AYAPGWIAF
LYFRELNHF	LYFRELNHF
YYSPHGHIL	YYSPHGHIL
SYSEWLQRL	SYSEWLQRL
LYMAALGATLF	LYMALGATL
FLNDPGHLLW	FLNDPGHLL
HYINMPVQF	HYINMPVQF
IFYSSDKYWYF	FYSSKYWYF
YYFDVSHEHL	YYFDSHEHL
TFQMKFFYI	TFQMKFFYI
VYNPVRAEW	VYNPVRAEW
IMPTIFNLI	IMPTIFNLI
TYLIQHQRI	TYLIQHQRI
VYAHIYHQHF	VYAHYHQHF
IFPTVNGLF	IFPTVNGLF
EYLKVDAQF	EYLKVDAQF
SYFSGSHMF	SYFSGSHMF
LFFYPLDFTF	FFYPLDFTF
LYHDIAQQAF	LYHDAQQAF
YYLPDGSTIEI	YYLPDGSTI
IYIPDGHTKEM	IYIPGHTKE
SYPGSSYIF	SYPGSSYIF
NYLLDMPLW	NYLLDMPLW
NYQANIWAL	NYQANIWAL
TYTNLNRLI	TYTNLNRLI
SYDPLRIYLF	SYDPRIYLF
IYPVDLGDKF	IYPVLGDKF
SYGSVFKAI	SYGSVFKAI
KYLDEDTIYHL	KYLD-EDTI
YGFQWRHF	YGFQ-WRHF
VWLEEELKTF	VWLEELKTF
AFHPTAQLL	AFHPTAQLL
GYYNGKWEFL	YYNGKWEFL
KYWEMMPPTI	KYWEMPPTI
YYGNISHFV	YYGNISHFV
RYGLITSLL	RYGLITSLL
KLISWYDNEF	KLISYDNEF
RYASINAHL	RYASINAHL
VYVKDLSSF	VYVKDLSSF
AYINKVEEL	AYINKVEEL
HYIYIENQF	HYIYIENQF
SYMPPSTVL	SYMPPSTVL
VYAILTHGI	VYAILTHGI
KYSVATQLF	KYSVATQLF
YYLQGGFNKF	YYLQGFNKF
NYQTMSDTTF	NYQTSDTTF
VYQEIWIGM	VYQEIWIGM
NYGQYFTLW	NYGQYFTLW
AYLDKKHTIF	AYLDKKHTI
EYATPLQTLF	EYATPLQTL
MYNLFWRHF	MYNLFWRHF
PFAKPLPTF	PFAKPLPTF
VWDKVIYLF	VWDKVIYLF
LLPSHPLEL	LLPSHPLEL
YYLEQFQYW	YYLEQFQYW
VYTGDALRI	VYTGDALRI
RLPEPLPSW	RLPEPLPSW
QFEEFGQTF	QFEEFGQTF
LYTPKPQVI	LYTPKPQVI
FYQGHITAF	FYQGHITAF
MHSPQTSAMLF	SPQTSAMLF
FYINVEREEW	FYINEREEW
YFYRDPEEI	YFYRDPEEI
VYLKTALGL	VYLKTALGL
PYSEAWGYFHL	PYSEAWGYF
PYIKEQFLL	PYIKEQFLL
KYLREEVKTF	KYLREVKTF
AYPILYMHF	AYPILYMHF
PWLFDAPKF	PWLFDAPKF
KYFSDGSSNTF	YFSDSSNTF
NYVGEELWSYF	VGEELWSYF
FYVDSIADL	FYVDSIADL
VMADIRELI	VMADIRELI
IYIINVHSM	IYIINVHSM
GYQRRWFVL	GYQRRWFVL
FYTAIAQAF	FYTAIAQAF
RLPLRLFLI	RLPLRLFLI
TYISWKEEL	TYISWKEEL
VYVGFQVQL	VYVGFQVQL
TYQRWQFTL	TYQRWQFTL
VFLPREDHLF	VFLPEDHLF
SWKTTPYQI	SWKTTPYQI
RYLEKNVKL	RYLEKNVKL
VYQIFDTFF	VYQIFDTFF
RYLEKSGVL	RYLEKSGVL
RYFNPKDYSW	RYFNKDYSW
PYMRSMMQTL	PYMRMMQTL
TYLEKAIKI	TYLEKAIKI
AYLPLRLLERL	AYLP-LRLL
KYSVINEINKI	KYSV-INEI
KYLLHSLVF	KYLLHSLVF
KYQIINEEF	KYQIINEEF
IYLDGIITI	IYLDGIITI
FTNQGTVIHF	TNQGTVIHF
SYIDRLISVF	SYIDLISVF
VYMPASSYQSL	VYMPSYQSL
KYSVGIHNL	KYSVGIHNL
LYVVDLKKF	LYVVDLKKF
KYLGQLTSI	KYLGQLTSI
SYDPTIENTF	SYDPIENTF
QVPNESFFNF	VPNESFFNF
EYMRSGLYSTF	YMRSLYSTF
IYPEVVHMF	IYPEVVHMF
SYPDNFLHI	SYPDNFLHI
NYGPMKGGSF	NYGPKGGSF
LFPEPLTW	LFPE-PLTW
RYISDQLFTNF	RYIS-DQLF
IWGAYDGKF	IWGAYDGKF
YYLNLIELF	YYLNLIELF
FYADHPFIF	FYADHPFIF
IYIPVLPPHL	IYIPLPPHL
RYSVFVNEL	RYSVFVNEL
RYLGKVLEL	RYLGKVLEL
MAYQLCHAL	MAYQLCHAL
SFNPYSEFI	SFNPYSEFI
LWYYGEHLF	LWYYGEHLF
YYDKHFTEF	YYDKHFTEF
YLDKFIRL	YLDK-FIRL
YYSSPFAFF	YYSSPFAFF
FWIPYIHNL	FWIPYIHNL
KYIFKERESF	KYIFERESF
SWFSKEEPVTI	FSKEEPVTI
IIGNSTVI	IIGN-STVI
RYQQWMERF	RYQQWMERF
QYVDFHNQL	QYVDFHNQL
FYTFPFQQL	FYTFPFQQL
IYLRLLVKL	IYLRLLVKL
VYISYLDSVHF	SYLD-SVHF
LQPFIYYRF	LQPFIYYRF
KYAPRPIFI	KYAPRPIFI
YYPEYKLLF	YYPEYKLLF
TWNPSSVQLL	TWNPSVQLL
NFIESSFWNF	NFIESFWNF
IYISKIVVEF	IYISIVVEF
KYLEDFITNI	KYLEFITNI
RYMDQWVPVI	RYMDWVPVI
AFPEIFYTF	AFPEIFYTF
SYMEVPTYLNF	SYMEVPTYL
VYVSRPSHF	VYVSRPSHF
SYANYFIRL	SYANYFIRL
VLTPNHVEF	VLTPNHVEF
KFYPPKVELFF	FYPPKVELF
LWMRLLPLL	LWMRLLPLL
RYLEVMRKL	RYLEVMRKL
LYAPDPGMLF	LYAPPGMLF
AYALLLQHL	AYALLLQHL
IYVLPMLTI	IYVLPMLTI
YFGTGFPHMLF	YFGTFPHML
VWFPDMMPTW	VWFPMMPTW
AYGEFLSRL	AYGEFLSRL
KYMDVVKERI	KYMDVKERI
YYKDIVENI	YYKDIVENI
VLPIRVHTI	VLPIRVHTI
IYPEAVTMF	IYPEAVTMF
KYLEESDEDDL	KYLEESDED
KFEELNMDLF	KFEENMDLF
VYIPVLPPHL	VYIPLPPHL
LYIPPTHTF	LYIPPTHTF
PFNPLLGETF	PFNPLGETF
HYTYILEVF	HYTYILEVF
TYHEVVDEIYF	TYHEVVDEI
VYPAGFVYI	VYPAGFVYI
TYPSQDVFLVI	TYPSQDVFL
LYLEHKGWYSW	LYLE-HKGW
YIAGHPAF	YIAG-HPAF
NYLAPYQFL	NYLAPYQFL
IYSVHVPAGLY	IYSVVPAGL
VFSPDGHLF	VFSPDGHLF
KWFTETSIILF	KWFTETSII
IYDPNLAFLRF	IYDPNLAFL
PVSSYPNTFEW	PVSSYPNTF
NYGGKWPFW	NYGGKWPFW
RWPKKSAEF	RWPKKSAEF
RYFISHVLAF	YFISHVLAF
SFSPSGTGFNF	SFSPSGTGF
IMYTVFEHTF	MYTVFEHTF
SYELRYFQI	SYELRYFQI
VFRLQFDEF	VFRLQFDEF
VYVAALKTL	VYVAALKTL
RFFPYTSSQMF	PYTS-SQMF
SYISRTNQL	SYISRTNQL
KYIDFDHVF	KYIDFDHVF
FYIPPPATHTL	YIPPATHTL
YYSKNLNSSF	YYSKLNSSF
VYDVTDQESF	VYDVDQESF
LYINKANIW	LYINKANIW
VYGVVPISL	VYGVVPISL
VFPFRTFYL	VFPFRTFYL
VYDTVFKHF	VYDTVFKHF
TYTQLVRLI	TYTQLVRLI
VYYPELFVW	VYYPELFVW
VYNEQIRDLL	VYNEIRDLL
SYLDMSKVIIF	SYLDMSKVI
VYPLKFFFL	VYPLKFFFL
FWTDIINEAIF	FWTDINEAI
YYRAIQFYL	YYRAIQFYL
VYPLYTIVFI	VYPLYTIVF
TYNKHINISF	TYNKINISF
LYSHINQTL	LYSHINQTL
LYEPVWHVW	LYEPVWHVW
LYPFAISLI	LYPFAISLI
IYDSVKVYF	IYDSVKVYF
IYTNQNVVW	IYTNQNVVW
PYVEDLSKL	PYVEDLSKL
KYPASTVQI	KYPASTVQI
KYERISWSF	KYERISWSF
SYGSGVVW	SYGS-GVVW
AYARIGNSYF	AYARGNSYF
MFPLVKSAL	MFPLVKSAL
VYPWTQRFFES	VYPWTQRFF
VLPQRFPQF	VLPQRFPQF
QYGSALAHFF	QYGSALAHF
VYPANERFWYF	VYPA-NERF
FYQPDLKYLSF	FYQPDLKYL
YVHMVTHF	YVHM-VTHF
VYLEKFMTF	VYLEKFMTF
HYILHNSFF	HYILHNSFF
VYVVGTAHF	VYVVGTAHF
AYKYIQELW	AYKYIQELW
VYSEAARVLQF	VYSEAARVL
KMVSVLPIF	KMVSVLPIF
IFNPRTGQLFL	IFNPTGQLF
AYGGAFYAF	AYGGAFYAF
RWYQVEGMEW	WYQVEGMEW
TYLDNGVVF	TYLDNGVVF
HYSLFPLLF	HYSLFPLLF
EYLERAPELF	EYLEAPELF
SWMELPGLKF	SWMEPGLKF
KYLLSSIQW	KYLLSSIQW
AYLKWISQI	AYLKWISQI
FYFDPKQTDVL	YFDPQTDVL
KYQPRFHIV	KYQPRFHIV
LYGNIIDNL	LYGNIIDNL
KYNKILNKY	KYNKILNKY
SYIPSTVFF	SYIPSTVFF
FYSGSPTSYF	FYSGPTSYF
NYIEFTRIL	NYIEFTRIL
RYVPRASY	RYVP-RASY
IYPSLIYII	IYPSLIYII
NYMPGQLTI	NYMPGQLTI
FYHKYFNYL	FYHKYFNYL
TYFNGDLKNF	TYFNDLKNF
AFIEEGTFL	AFIEEGTFL
VYILPAAYFW	VYILPAAYF
KYFDKVVTL	KYFDKVVTL
KYQEVTNNLEF	KYQEVTNNL
MYPFQIHSI	MYPFQIHSI
MYPASPWSHI	MYPAPWSHI
VYFMTGPMGF	VYFMGPMGF
TYPELNSSI	TYPELNSSI
TYNQKHSLF	TYNQKHSLF
RYMDLAENARF	RYMDLAENA
VLPESLPVL	VLPESLPVL
IYYSYGDFLL	YYSYGDFLL
VFLNLHTLKF	VFLNHTLKF
IYFKNSENL	IYFKNSENL
RYSGNQVLF	RYSGNQVLF
FYTVIPHNF	FYTVIPHNF
PWFVGDKITF	PWFVDKITF
YYEEQHPEL	YYEEQHPEL
VYSPHVLNLT	VYSPHVLNL
KYLGVPKYW	KYLGVPKYW
IITPIHEQW	IITPIHEQW
VFIEGADAETF	VFIEDAETF
QLPPAFDLF	QLPPAFDLF
AYPDFAPQKF	AYPDAPQKF
VYSAAILEYL	VYSAILEYL
AYTTEHWLV	AYTTEHWLV
PMMRPLIEKF	PMMRLIEKF
VYAEVSRLL	VYAEVSRLL
TWSADSKVLLF	SADSKVLLF
IYADYIAPLF	IYADIAPLF
QLPQPDVFPLF	PQPDVFPLF
VYFLPITPQFV	VYFLITPQF
SYLNSVQRL	SYLNSVQRL
YYSAVTPHL	YYSAVTPHL
VYPPHSHSI	VYPPHSHSI
RYIDRIHIF	RYIDRIHIF
AYKPGALTF	AYKPGALTF
TYMPHVHIL	TYMPHVHIL
AYLDKSPQF	AYLDKSPQF
RFLDDLGLKF	RFLDLGLKF
IYNGKVTSI	IYNGKVTSI
VYAHFPINVVI	VYAHFPINV
LYGIKDDVF	LYGIKDDVF
SYARHFLDF	SYARHFLDF
RYEIPESLL	RYEIPESLL
EYSLFPGQVVI	SLFPGQVVI
YYLWPAVQL	YYLWPAVQL
IDLINIESF	IDLINIESF
AYLDALQTL	AYLDALQTL
LYEQAFQLL	LYEQAFQLL
SYIHYVFRL	SYIHYVFRL
RFRPVPLGQTF	RPVPLGQTF
LYDPVISKL	LYDPVISKL
SYNPAENAVLL	SYNPENAVL
PIRVHTIVI	PIRVHTIVI
SYLSRLQYF	SYLSRLQYF
YYILRPEVI	YYILRPEVI
VYTRHMTWI	VYTRHMTWI
RYPDNLKHL	RYPDNLKHL
VYLKPSYAF	VYLKPSYAF
IYFDQVLVNI	IYFDVLVNI
RFLNDPGHLLW	RFLNPGHLL
GFIMPIEVHF	FIMPIEVHF
TLPFQQFEI	TLPFQQFEI
AYINRASLL	AYINRASLL
SYSEIKDFL	SYSEIKDFL
VYPERTPLL	VYPERTPLL
FYINGQYQF	FYINGQYQF
KYLSVQGQL	KYLSVQGQL
IYLLNPDGLF	IYLLNPDGL
EYAVLTSTI	EYAVLTSTI
EYIQFVPLL	EYIQFVPLL
NYPDEFTKL	NYPDEFTKL
VWGNVVTVEW	VWGNVTVEW
RYDGQVAVF	RYDGQVAVF
VYITNYRLYL	VYITYRLYL
TYENLIHVW	TYENLIHVW
VYPAVMVLL	VYPAVMVLL
AFMKGVFTF	AFMKGVFTF
LYSAVKTLL	LYSAVKTLL
VYVPHIHVWW	VYVPHIHVW
TYNEPGSQVF	TYNEGSQVF
LYGDNLDQHF	LYGDLDQHF
NYLGAIESW	NYLGAIESW
NAPLVNVTL	NAPLVNVTL
VYNDHSIYVW	VYNDSIYVW
IYFRSYKLLL	IYFRSYKLL
RYNERLDRLFI	RYNERLDRL
EYTDVYPEI	EYTDVYPEI
IWDPDSVKTI	IWDPSVKTI
EYPRSLFPSL	EYPRLFPSL
RFLESHWFVW	RFLEHWFVW
KYLPEWTAW	KYLPEWTAW
DYKNTFPKW	DYKNTFPKW
VYTEGERLYLF	VYTEERLYL
VFPSMPIKLQL	VFPSMPIKL
YAPAFTML	YAPA-FTML
IYTDWANHYL	IYTDANHYL
SYTDVWEKW	SYTDVWEKW
LYQDQILEKF	LYQDILEKF
LYSPKIEVHF	LYSPIEVHF
GYFSEEMNRVL	YFSEMNRVL
GWKENHATF	GWKENHATF
QWPQPDKPMFF	PQPDKPMFF
VYAEVSRLLL	VYAEVSRLL
RYSNLILNLF	RYSNILNLF
KYAHMINGF	KYAHMINGF
PYVGGLEEF	PYVGGLEEF
YYPSTPGRYSI	YYPSTPGRY
AYKDAIYVF	AYKDAIYVF
RYQFTPAFL	RYQFTPAFL
KAPEPLSSL	KAPEPLSSL
AYHNSPAYL	AYHNSPAYL
VYIQEMFRF	VYIQEMFRF
HYNSDLNNLLF	HYNSDLNNL
KYETVIMPVF	KYETIMPVF
VYTWPSGNTF	VYTWSGNTF
IYVHLTDGIW	IYVHLTDGI
IYTPIFNEY	IYTPIFNEY
FFEVSPVSF	FFEVSPVSF
IYFPKKEAVTF	YFPKEAVTF
VWIYDPVHF	VWIYDPVHF
TYFDKNYNL	TYFDKNYNL
GYIESVQHI	GYIESVQHI
YYIFIPSKF	YYIFIPSKF
QYMPEWLWV	QYMPEWLWV
VLPLPSENW	VLPLPSENW
EYKPPKFNLF	EYKPKFNLF
IYVVGGYSW	IYVVGGYSW
SYQRAFNEF	SYQRAFNEF
NYTEWLQDL	NYTEWLQDL
VFFFGSKDYYW	FFGSKDYYW
KYISKPENLKL	KYISKPENL
YYGPLNLLTF	YYGPNLLTF
LYRDVMRETF	LYRDMRETF
MYAKETVGF	MYAKETVGF
AGIALNDHF	AGIALNDHF
AYYEEQHPEL	YYEEQHPEL
EYDLIVHQL	EYDLIVHQL
IFAPKVPTL	IFAPKVPTL
EYGFYHDFF	EYGFYHDFF
YYTPITPHL	YYTPITPHL
EALERMFLSF	ALERMFLSF
TLPSPDKLPGF	PSPDKLPGF
VYLTPESKSSF	YLTPSKSSF
YYEKQFPEI	YYEKQFPEI
AFLDKQNQVKF	AFLDKQNQV
LYTPHSWLL	LYTPHSWLL
VTALIKDKI	VTALIKDKI
VYVWIYDPVHF	VWIYDPVHF
LYEEEMREL	LYEEEMREL
KWFTGPQLI	KWFTGPQLI
VYTQHQPFL	VYTQHQPFL
VYRNKDALSHF	RNKDALSHF
RYLDLFTNY	RYLDLFTNY
RYLNEFEEL	RYLNEFEEL
TTGIPIHVF	TTGIPIHVF
EYIPDLYNHF	EYIPLYNHF
GYVPTENLRF	GYVPENLRF
SYYGPLNLLTF	YYGPNLLTF
TYTSYLDKFF	TYTSYLDKF
LYGMQVLLF	LYGMQVLLF
TYGNPNYHW	TYGNPNYHW
VWNPRSHEKL	VWNPSHEKL
IYLPIANVARI	IYLPIANVA
TYAKGFGML	TYAKGFGML
KYPDLFQVNL	KYPDFQVNL
IYGEKTYAF	IYGEKTYAF
YHSEAFTVNF	YHSEFTVNF
KWFDFKLFF	KWFDFKLFF
LYAQYLERL	LYAQYLERL
LYLTGVVVL	LYLTGVVVL
KYQKGFSLW	KYQKGFSLW
SWADLRDVLF	SWADRDVLF
FYIESISYL	FYIESISYL
RYNESLTNF	RYNESLTNF
TYQDIHSIQAF	TYQD-IHSI
AYADYKYFVSL	AYAD-YKYF
QYFDSRGMFI	QYFDSRGMF
NYNEKIYEL	NYNEKIYEL
AFLPVEDLYW	AFLPVEDLY
RYIPLIVDI	RYIPLIVDI
DYKPSFPKW	DYKPSFPKW
IFKDKPIKL	IFKDKPIKL
RYQESLGNTVF	RYQELGNTV
IYVGIESNHLL	IYVGESNHL
TFAVTDELVF	TFAVDELVF
EYPEWLFEM	EYPEWLFEM
KWNPTAGVAF	KWNPAGVAF
AYDDKIYYF	AYDDKIYYF
EYQEWVIKL	EYQEWVIKL
VYVLESWHL	VYVLESWHL
RLFDPINLVF	LFDPINLVF
RYLMDPDTF	RYLMDPDTF
KYTPPPHHI	KYTPPPHHI
AYIERMNSI	AYIERMNSI
AYNKLNVFHW	AYNK-LNVF
YYIDKLEYL	YYIDKLEYL
TYLGDWYSVNW	TYLGDWYSV
TYDKGYQF	TYDK-GYQF
AFYPPHPDYTW	FYPPPDYTW
KYVSSVLSF	KYVSSVLSF
TYPPFVNFF	TYPPFVNFF
QYPVYWDHLEF	QYPVYWDHL
AYLSEAMKL	AYLSEAMKL
FYLPGLAPVNF	YLPGAPVNF
AYRSPNTEEIF	AYRSNTEEI
QYDPYTDSRF	QYDPTDSRF
KYFEVPSVL	KYFEVPSVL
KFFDHSGTLVM	KFFDHSGTL
LYNKIREDF	LYNKIREDF
KYIDQKFVL	KYIDQKFVL
YYIDADLLREI	YYID-ADLL
KYMVYPQTF	KYMVYPQTF
IISSVIQKF	IISSVIQKF
VYKENLVDGF	VYKELVDGF
SYDTRVYIW	SYDTRVYIW
DYSTTPGGTLF	STTPGGTLF
IYMNLASHI	IYMNLASHI
ELPVDVLYPYF	LPVDLYPYF
KYITEPEMVF	KYITPEMVF
SYNPLWLRI	SYNPLWLRI
YYLIMLPFRF	YYLILPFRF
VYITNFHVRM	VYITFHVRM
VYTSGVYHI	VYTSGVYHI
KYLDEFLLNKI	KYLD-EFLL
MYLLDQPVL	MYLLDQPVL
LYMPAVGFL	LYMPAVGFL
SYQKVIEL	SYQK-VIEL
LYHDIFSRL	LYHDIFSRL
LYFHENQLI	LYFHENQLI
AYSRVQYQF	AYSRVQYQF
SFKRVRINF	SFKRVRINF
KYIKDDFRF	KYIKDDFRF
IYATEAHVF	IYATEAHVF
YYINKISSTL	YYINISSTL
AWYDRFWLF	AWYDRFWLF
VYLQNWSHV	VYLQNWSHV
NYPQSVPRL	NYPQSVPRL
QYNTYPIKL	QYNTYPIKL
LYAEIRDKNF	LYAERDKNF
EWPPFVVTL	EWPPFVVTL
NYPETLGRLLI	NYPELGRLL
IYSEMIHNL	IYSEMIHNL
SYLKQLPHF	SYLKQLPHF
AYLPKILQI	AYLPKILQI
TFTDHVMLF	TFTDHVMLF
RYLVEVEEL	RYLVEVEEL
KYLMELTML	KYLMELTML
HYAYSFKYL	HYAYSFKYL
AFSPDSYFL	AFSPDSYFL
IFPKPPLYTF	IFPKPLYTF
RFIAPAASLGF	RFIAPAASL
IYSRIDRLEAF	IYSR-IDRL
SYQPIVDYI	SYQPIVDYI
RYISQPPLL	RYISQPPLL
IYWSDLSQRMI	YWSDLSQRM
VLPILPLLF	VLPILPLLF
VFSDAGLTF	VFSDAGLTF
IYTMIYRNL	IYTMIYRNL
DYLEHITSI	DYLEHITSI
NYISDPTILW	NYISDPTIL
MYIIPVVLF	MYIIPVVLF
KYNANFVTF	KYNANFVTF
VVHPHGHIF	VVHPHGHIF
IYTIINSI	IYTI-INSI
VYHNMPLIW	VYHNMPLIW
EYTKKIENL	EYTKKIENL
IFLDPHTTQTF	FLDPTTQTF
LYIVEPLKF	LYIVEPLKF
TYGPHVPEL	TYGPHVPEL
KLPDVYGVF	KLPDVYGVF
RFESVSHLI	RFESVSHLI
AFTMPLHMTF	AFTMLHMTF
TLSDIFLLF	TLSDIFLLF
RYFLPPYTF	RYFLPPYTF
PYNPIIGETF	PYNPIGETF
IYSTAFDYF	IYSTAFDYF
VYTGIDHHW	VYTGIDHHW
TYIRLYGRKF	TYIRYGRKF
LYSEVSHLL	LYSEVSHLL
FYARAKLF	FYAR-AKLF
KYLSGIAHF	KYLSGIAHF
LFLDSNGLFLF	LFLDSNGLF
RYAPPPSFSEF	RYAP-PPSF
KYMGIPQIRQL	KYMG-IPQI
VYNPNQVRM	VYNPNQVRM
SWNSNLSGHLL	NSNLSGHLL
SYPEETYPI	SYPEETYPI
MWYAPVGILF	WYAPVGILF
EYVANLTNL	EYVANLTNL
VYQNYRQFI	VYQNYRQFI
RYIDRIHIFF	RYIDRIHIF
SYLDEGFLL	SYLDEGFLL
EYLIKVNEI	EYLIKVNEI
SYIEHIFEI	SYIEHIFEI
ILPEIIPIL	ILPEIIPIL
AYVSTSRLF	AYVSTSRLF
TYDYNFHSF	TYDYNFHSF
PYSPRWDGNEM	PYSPRWDGN
IYLPYLHEW	IYLPYLHEW
FHISRLFYF	FHISRLFYF
FYPHFPEFF	FYPHFPEFF
YYLHQNNIVHL	YYLH-QNNI
FYLNQSTAYHF	FYLNQSTAY
MFPPSPLFF	MFPPSPLFF
AYFKRYQVKF	AYFKYQVKF
QFRLPDGSSF	RLPD-GSSF
DYPRYLFEI	DYPRYLFEI
SYLPGEDLMSL	SYLPGEDLM
NYSTVPQKQTL	STVPQKQTL
SYLERHGLINF	SYLERHGLI
FYHEAVVLF	FYHEAVVLF
PYKADILYF	PYKADILYF
VYADKLLNI	VYADKLLNI
LFIGGLPNYL	LFIGLPNYL
IYTNLNQKI	IYTNLNQKI
PYSDKLFEMVL	PYSDKLFEM
LYSGVFVAF	LYSGVFVAF
LYTELFTGF	LYTELFTGF
KYLPEWSAW	KYLPEWSAW
TYCLDEELVW	TYCLEELVW
AYLTIQMVRF	AYLTQMVRF
RYLDLILNDF	RYLDILNDF
DYGIVADLF	DYGIVADLF
TYITSVSRL	TYITSVSRL
VVFHPSQDLVF	VFHPQDLVF
ALPSKLPTF	ALPSKLPTF
VYWTQLNMF	VYWTQLNMF
IYTEMTGKLI	IYTEMTGKL
PWGVTPISF	PWGVTPISF
VMAPRTLLL	VMAPRTLLL
EYLENALKL	EYLENALKL
KYSDITIMF	KYSDITIMF
AFYMDTSHLF	FYMDTSHLF
SYVTVGELWAF	SYVTVGELW
KYLVIGDLLF	KYLVIGDLL
VYFISPQGL	VYFISPQGL
DYSDIVTTL	DYSDIVTTL
THVGKVNIF	THVGKVNIF
PYTDVNIVTI	PYTDNIVTI
VFLGNVETF	VFLGNVETF
FIEKHWTF	FIEK-HWTF
KLPNFGFVV	KLPNFGFVV
IFIIPGNPGF	IFIIGNPGF
YYLLADYHF	YYLLADYHF
KYPHYFPLL	KYPHYFPLL
DYGIVADL	DYGI-VADL
ISLKQAPLVH	ISLKQAPLV
KYLEHPLLL	KYLEHPLLL
RYSPVLSRF	RYSPVLSRF
TYSYSFFHF	TYSYSFFHF
HFLDRHLVF	HFLDRHLVF
YFSDGSSNTF	YFSDSSNTF
PYKYQVLAEMF	KYQVLAEMF
TYTMILNLL	TYTMILNLL
AYGKDFHLI	AYGKDFHLI
TYLNDFFSY	TYLNDFFSY
KYFAQEALTVL	YFAQALTVL
SYGDILHVI	SYGDILHVI
RYVQQLQRL	RYVQQLQRL
VTFLPTGITF	TFLPTGITF
KYADAVKNF	KYADAVKNF
RYTLQASTF	RYTLQASTF
LYIISVKGI	LYIISVKGI
KYIERIITRF	KYIEIITRF
TYGGSWKFLTF	TYGGSWKFL
AYSVEHNQL	AYSVEHNQL
RYTTEFHEL	RYTTEFHEL
SYGKVEGFW	SYGKVEGFW
TYAPLFSLPSF	TYAP-LFSL
LYHSEAFTVNF	LYHSEAFTV
SYLDRTEQL	SYLDRTEQL
AYLPDFLDYF	AYLPFLDYF
SYLAVIEGAKF	YLAVEGAKF
QYLDNLLVRF	QYLDLLVRF
FYGKYTAEI	FYGKYTAEI
VYPPIQVHVTL	VYPPIQVHV
VYLDEPIKI	VYLDEPIKI
VYGDVISNI	VYGDVISNI
RYGDGGSTF	RYGDGGSTF
LYSLKQYFL	LYSLKQYFL
SYLTSASSL	SYLTSASSL
FYYDPKHVIF	YYDPKHVIF
IYAPPLPSL	IYAPPLPSL
RYVLYPNNFQF	RYVLYPNNF
KYVHLFPKL	KYVHLFPKL
LYRDVTLETF	LYRDTLETF
SYMPVIDVF	SYMPVIDVF
EYDNFFQHL	EYDNFFQHL
LYYTWTDGYRF	YYTWDGYRF
TYPDVNNSI	TYPDVNNSI
SYKPAPFFVL	SYKPPFFVL
TWFNQPARKI	TWFNPARKI
FYIDKDMIHI	FYIDDMIHI
PLPESVPVF	PLPESVPVF
KYGPVFSF	KYGP-VFSF
MILPVGAANF	ILPVGAANF
VYVEKISFL	VYVEKISFL
SFMPNSPRF	SFMPNSPRF
KFMPVEGMVF	KFMPEGMVF
TYLEKAVEV	TYLEKAVEV
QYASLMHSF	QYASLMHSF
AYVVFVSTL	AYVVFVSTL
EYGQIESVRF	EYGQESVRF
VYPLMKEYF	VYPLMKEYF
TYPEGLEVLHF	TYPEGLEVL
LYPLVGTITI	LYPLGTITI
EMNEPVQLTF	EMNEVQLTF
YYGTGETF	YYGT-GETF
VAMNPTNTVF	AMNPTNTVF
IYHGLATLL	IYHGLATLL
HYMPPPYASL	HYMPPYASL
YWKIYNSIYI	YWKINSIYI
VFHDALKGW	VFHDALKGW
YAPGARLAL	YAPGARLAL
SFHNIHNTF	SFHNIHNTF
FYVPAEPKLAF	FYVPAEPKL
PYQEFTDHL	PYQEFTDHL
VYQVGGVTAYF	VYQVGGVTA
IYNLKNPTLF	IYNLNPTLF
KYQEYTNEL	KYQEYTNEL
IYQEVWNLF	IYQEVWNLF
SYSHIMALI	SYSHIMALI
VYTLDIPVLF	VYTLIPVLF
RYQEMIQKL	RYQEMIQKL
SLPKFYLLF	SLPKFYLLF
NYPDNVVFKF	NYPDVVFKF
RYSEAITQSVL	RYSEITQSV
VYLSNVVLF	VYLSNVVLF
SYADNILSF	SYADNILSF
IYSEVMEALKL	IYSEVMEAL
IYAGAIKSSF	IYAGIKSSF
TYFEKNFNL	TYFEKNFNL
LYTEKFEEF	LYTEKFEEF
TYLTIFDLF	TYLTIFDLF
AYAPQGWIAF	AYAPGWIAF
LYAFIGVKF	LYAFIGVKF
AYIQESATF	AYIQESATF
ILTERGYSF	ILTERGYSF
IYELAVASF	IYELAVASF
SYKLVTVKF	SYKLVTVKF
NYFFDAAKLMF	NYFFDAAKL
FYTKDLIVM	FYTKDLIVM
EFLGKEMKLYF	EFLGKEMKL
VYPKKELPFF	VYPKELPFF
IFSKIVSLF	IFSKIVSLF
AYSLNFPLL	AYSLNFPLL
VYERELQTF	VYERELQTF
IYANLSDEKAF	IYANSDEKA
TYIRWQELL	TYIRWQELL
KYATLSLFNTY	KYAT-LSLF
IYIKQIKTF	IYIKQIKTF
PYSEKMTVLF	PYSEMTVLF
AWIHPDLPLF	AWIHDLPLF
TYVRWYTQL	TYVRWYTQL
KYPGFLLNNF	KYPGLLNNF
RYIIKKDFF	RYIIKKDFF
QVYMDWYEKF	VYMDWYEKF
VYPPPHQVFTW	VYPPPHQVF
VYELSAVLI	VYELSAVLI
SYYGPLRTVWI	YYGPLRTVW
SYSTSLIGLTF	SYSTSLIGL
EYTGYSFKF	EYTGYSFKF
IYYFKANVF	IYYFKANVF
KYVENFGLI	KYVENFGLI
IYADNQVMHF	IYADQVMHF
TISPHVPEF	TISPHVPEF
VQGNITQKF	VQGNITQKF
TYIPGTQITF	TYIPTQITF
QLADLYKSF	QLADLYKSF
NYLVRINEI	NYLVRINEI
IYHPNVDKL	IYHPNVDKL
VYLAKLGNFF	VYLAKLGNF
SYNGKLYVF	SYNGKLYVF
KWNLDELPKF	KWNLELPKF
VYIPPQAEL	VYIPPQAEL
NYKDLNGNVF	NYKDNGNVF
VMWSPTHPALF	MWSPHPALF
KFSNVTMLF	KFSNVTMLF
ISQPASGNTF	SQPASGNTF
VWIARNPPGF	VWIANPPGF
IYLTFPVAM	IYLTFPVAM
PYISNIYLI	PYISNIYLI
AFIETPIPLF	AFIEPIPLF
LYQILQGIVF	LYQIQGIVF
IYSVGAFENF	IYSVAFENF
KYISGPHEL	KYISGPHEL
VYHEQHFFYI	VYHEHFFYI
SFSTVTNTF	SFSTVTNTF
VYHSDIPKW	VYHSDIPKW
LYDIILKNF	LYDIILKNF
EYIQKNVQL	EYIQKNVQL
KYLDYMQKI	KYLDYMQKI
YYFDSYAHF	YYFDSYAHF
KYGPIRQI	KYGP-IRQI
QLPVVVFTF	QLPVVVFTF
PYTGPFNLL	PYTGPFNLL
DYREFPIPEQF	REFPIPEQF
VFTPVVQRI	VFTPVVQRI
LYVPVMITW	LYVPVMITW
SYQKVIELF	SYQKVIELF
IYGPPQYNI	IYGPPQYNI
SYPGLQFEII	SYPGLQFEI
VFPDKGYSF	VFPDKGYSF
IYVGDGYVVHL	IYVGDGYVV
RYPAIIYNI	RYPAIIYNI
RYMPQNPHII	RYMPQNPHI
KFVETHPEF	KFVETHPEF
MYLGWTPYM	MYLGWTPYM
TYLEAHRIVKM	TYLE-AHRI
QYGEVANLL	QYGEVANLL
EYTNPEQIKQW	EYTN-PEQI
MYLPEAKESF	MYLPAKESF
SYLTGAAIW	SYLTGAAIW
RYLNKAFHIW	RYLNKAFHI
KYITDWQNVF	KYITWQNVF
SWPPPLTAI	SWPPPLTAI
RFEEAHFTF	RFEEAHFTF
HYLLPAIEYF	HYLLAIEYF
NYFAYVQMF	NYFAYVQMF
QYNPKFQTL	QYNPKFQTL
VFVDSVPEF	VFVDSVPEF
VYPWTQRFF	VYPWTQRFF
YYLGNPAEF	YYLGNPAEF
NYLSHHLTI	NYLSHHLTI
FYPPKVELF	FYPPKVELF
IYIDRFEDL	IYIDRFEDL
PYIMAPGLL	PYIMAPGLL
KYFHPPAHL	KYFHPPAHL
SYSGTFHSL	SYSGTFHSL
KYGIQMPAF	KYGIQMPAF
DYAELLQHF	DYAELLQHF
TYTDVTPRQF	TYTDTPRQF
VYTYIQSRF	VYTYIQSRF
DYKGKYVVFF	DYKGKYVVF
VYLHDFQRF	VYLHDFQRF
GYVVWQEVF	GYVVWQEVF
NYPLLLLTL	NYPLLLLTL
VYAFNLDTF	VYAFNLDTF
YPDVFAHF	YPDV-FAHF
KYMTAVVKL	KYMTAVVKL
AYFKTFVPQF	AYFKFVPQF
VFDTAIAHLF	VFDTIAHLF
EYSKQMQRF	EYSKQMQRF
FYSISQERF	FYSISQERF
IYGNDFMDL	IYGNDFMDL
KYIDYLMTW	KYIDYLMTW
KYMEDYHQF	KYMEDYHQF
QWADLSSQFYL	QWADLSSQF
RFIGATANF	RFIGATANF
WYPFFRGVTI	WYPFRGVTI
VFTAETHNF	VFTAETHNF
GYIPIYTPFF	GYIPYTPFF
SYALLTYMI	SYALLTYMI
YWIDIQLRW	YWIDIQLRW
NYVQAVEEF	NYVQAVEEF
KYMAEALLL	KYMAEALLL
YFNPHTVTL	YFNPHTVTL
PFIEPPESFEF	PFIEPPESF
VYVDFEGINF	VYVDEGINF
SYLGAFFSF	SYLGAFFSF
EYLERAPEL	EYLERAPEL
VYTIDFNSM	VYTIDFNSM
TYPTLFQGW	TYPTLFQGW
AYNPMARDLF	AYNPARDLF
FYPLIDVNW	FYPLIDVNW
SYYMIGEQKF	YYMIGEQKF
QYVTQINRL	QYVTQINRL
AYIKGGWIL	AYIKGGWIL
VYALPTIAF	VYALPTIAF
PYMDSPQSIGF	PYMDSPQSI
VYALKVRTI	VYALKVRTI
RFPEELTQTF	RFPELTQTF
IYGSVDRVI	IYGSVDRVI
KYGMVTYLL	KYGMVTYLL
LLPGKTYSF	LLPGKTYSF
QYAIISEAWRL	QYAIISEAW
VFDPVTKLW	VFDPVTKLW
VYPPGFMGL	VYPPGFMGL
RYAEAVQLL	RYAEAVQLL
TYPNTYIFDLF	TYPNYIFDL
NYMVYMFQY	NYMVYMFQY
PFFPPPEEFVF	PFFPPPEEF
GWWDGQGAFDF	GWWDGQGAF
IYQDWHSFL	IYQDWHSFL
NYIEKVVAI	NYIEKVVAI
GHKDQTRTYF	GHKDTRTYF
SYFIEPVQW	SYFIEPVQW
SYLHEPAVL	SYLHEPAVL
VYGFQWRHF	VYGFQWRHF
ILPQFLYQF	ILPQFLYQF
IYPTAPPRF	IYPTAPPRF
KFYPPKVELF	FYPPKVELF
LYKFSADEF	LYKFSADEF
YYIKYNTIETF	KYNT-IETF
HYSENMFSF	HYSENMFSF
IYYTGKYQSL	YYTGKYQSL
NYIPQGSIDSL	YIPQSIDSL
IFTDVALKF	IFTDVALKF
EYGAEALERMF	EYGAALERM
EFLWQEGHSAF	LWQEGHSAF
LYFTGSAHF	LYFTGSAHF
RFSLNTVEL	RFSLNTVEL
EYGRILTRL	EYGRILTRL
VYVAIQAVL	VYVAIQAVL
YYLNDLERI	YYLNDLERI
NYVKKFQSF	NYVKKFQSF
LYGSVPVLL	LYGSVPVLL
KWFTDTSIILF	KWFTDTSII
KYSFLPYQL	KYSFLPYQL
TYHPGVPVF	TYHPGVPVF
NYYPGSLFLTW	YYPGLFLTW
YPFPLPVF	YPFP-LPVF
RYSDSTFTF	RYSDSTFTF
MWKEGNRIHF	MWKENRIHF
VYFIGAHNI	VYFIGAHNI
GYTSWAIGL	GYTSWAIGL
FYTINRYTL	FYTINRYTL
SYAQYVHNL	SYAQYVHNL
PMFDGKVPHW	MFDGKVPHW
KYAQLYSNL	KYAQLYSNL
YKPPGLKW	YKPP-GLKW
AYGELRAMVL	AYGERAMVL
PFTNKPTTF	PFTNKPTTF
RYLDLFTSF	RYLDLFTSF
NYKSIFLQI	NYKSIFLQI
DYPSKMEYF	DYPSKMEYF
SYMPTVSHL	SYMPTVSHL
LVLYGDVEEL	LYGD-VEEL
VYPVPSLLTF	VYPVSLLTF
IYAKVDRLEAF	IYAK-VDRL
IYVTGGHLF	IYVTGGHLF
RYLDWRALM	RYLDWRALM
YYPELAFQF	YYPELAFQF
YIKHPHLF	YIKH-PHLF
TFLRNGGHF	TFLRNGGHF
KYFGGVLEYF	KYFGVLEYF
QYASRFVQL	QYASRFVQL
LYSTIRPYL	LYSTIRPYL
VYSKTQQSF	VYSKTQQSF
TFMDRGFVF	TFMDRGFVF
RYFPTQALNF	RYFPQALNF
VYKKTFLEF	VYKKTFLEF
VYLDHAGATLF	VYLDAGATL
PYRLIFEKF	PYRLIFEKF
ELFSPLHALNF	LFSPHALNF
IYPVKYTQTF	IYPVYTQTF
NYGTIKWFF	NYGTIKWFF
HYKPTPLYF	HYKPTPLYF
KYTFPAEHRF	KYTFAEHRF
EYLKLLHSF	EYLKLLHSF
RLPEEWSQW	RLPEEWSQW
RISLPLPNF	RISLPLPNF
RYAPDPVLV	RYAPDPVLV
ILGPPPPSF	ILGPPPPSF
VWDTAGQEKF	VWDTGQEKF
VFSSSGTSF	VFSSSGTSF
NYVNILATI	NYVNILATI
PYYSKFILI	PYYSKFILI
AYLQLFTKL	AYLQLFTKL
KIIAATFLF	KIIAATFLF
VYSIVPQSW	VYSIVPQSW
MYPGANPTF	MYPGANPTF
VYIPNKVLI	VYIPNKVLI
NYSNIRFQF	NYSNIRFQF
PLPAHDYFEFF	PAHDYFEFF
LLPPVVWLL	LLPPVVWLL
SYPKIIEEF	SYPKIIEEF
AYLLNLNHL	AYLLNLNHL
VYIKHPVSLEQ	VYIKHPVSL
EYMEHTYLI	EYMEHTYLI
SYLKGDNFFRF	SYLKGDNFF
QFLTELTRLF	QFLTELTRL
IYKPVTDFF	IYKPVTDFF
YYFPVKNVI	YYFPVKNVI
TYKVISNEF	TYKVISNEF
FFRSGKYDLDF	FFRSGKYDL
KYLTVKDYL	KYLTVKDYL
AYSAAKSWVF	AYSAKSWVF
FYNQVSTPLL	FYNQSTPLL
SYMGHFDLLNY	SYMGHFDLL
IYGYVAEQF	IYGYVAEQF
NWPSRPYLF	NWPSRPYLF
PYTFVQQHL	PYTFVQQHL
IYGPNVISI	IYGPNVISI
YFIPEFNLF	YFIPEFNLF
AYGIRFDVM	AYGIRFDVM
RYILEPFFI	RYILEPFFI
YYLNEIQSF	YYLNEIQSF
NYITAALKL	NYITAALKL
TYLPGIVGL	TYLPGIVGL
SWSPNPTPYF	SWSPPTPYF
KYIHSANVL	KYIHSANVL
NYLDWLTSI	NYLDWLTSI
NYAGRWDVLI	NYAGRWDVL
YYTTTPALVF	YYTTPALVF
VWPAAQFVNF	VWPAQFVNF
TMLGKFYHF	TMLGKFYHF
NYPDRNLPTI	NYPDNLPTI
YYYINYTTI	YYYINYTTI
YYDKAFDRI	YYDKAFDRI
SYFPPKGYAF	SYFPKGYAF
KYLYEEYLQAF	LYEEYLQAF
YTVLGPWFF	YTVLGPWFF
ELPLYIPPPIF	LYIP-PPIF
VLSGSAMNVVF	SGSAMNVVF
KMISNPTNF	KMISNPTNF
RYPSTGMLVLF	RYPSGMLVL
IYDTSTDRLLW	IYDTSTDRL
IGISNFNHL	IGISNFNHL
PWGVYPANL	PWGVYPANL
AWHPHTNKF	AWHPHTNKF
QYPVIIHLIW	QYPVIIHLI
YYLTFVQEL	YYLTFVQEL
MYINDKLPYF	MYINKLPYF
AYSPRFLYI	AYSPRFLYI
SFIPSSVPATF	IPSSVPATF
TYLKIQSFI	TYLKIQSFI
AFTNKPNVF	AFTNKPNVF
YYRPRFFLL	YYRPRFFLL
ELPKHYFSF	ELPKHYFSF
IYTSSVNRL	IYTSSVNRL
IFWAPESAPL	FWAPESAPL
FFKDRHWLF	FFKDRHWLF
HYAALAHYF	HYAALAHYF
RYEGFFSLW	RYEGFFSLW
AYTPEPLSSF	AYTPPLSSF
NYARGHYTI	NYARGHYTI
TYIRDFQKI	TYIRDFQKI
PYPKEEVGQYL	PYPKVGQYL
YYQSSVQYL	YYQSSVQYL
RFLAEEGFYKF	FLAEGFYKF
AFLEINRQLLF	AFLENRQLL
YYWQTSAKW	YYWQTSAKW
YFFDAAKLMF	YFFDAKLMF
KYLKPSGNMF	KYLKSGNMF
VLDDKDYFLF	VLDDDYFLF
PYEGGFFLF	PYEGGFFLF
GYLPNQLFRTF	GYLP-NQLF
IYGRMWYF	IYGR-MWYF
YYNPHLLLNTL	YYNP-HLLL
IYQRDPLKL	IYQRDPLKL
VWNDMNEPSVF	NDMNEPSVF
AYIAVGSISF	AYIAGSISF
SYIDMDKELEF	SYIDMDKEL
VYIAPLKAL	VYIAPLKAL
VYLDRKLLTL	VYLDKLLTL
VYAFSIENF	VYAFSIENF
FFIAGRYEF	FFIAGRYEF
KFYTDPSYF	KFYTDPSYF
ALPAAFHTW	ALPAAFHTW
AYIPLNNYLVF	AYIPLNNYL
VYSMDMFHTRF	YSMDFHTRF
DYVPPELITLF	DYVPELITL
VFFENFVTI	VFFENFVTI
EFPDKVFAEKW	EFPDKVFAE
KYMDVQFD	KYMD-VQFD
KWLLYPTEI	KWLLYPTEI
TYTDVTPRQFF	TYTDTPRQF
VYISEHEHF	VYISEHEHF
TYKFNFNKL	TYKFNFNKL
GYLTLVPLL	GYLTLVPLL
TYAPVAFRY	TYAPVAFRY
LYNRTMVQL	LYNRTMVQL
AYISGLDVF	AYISGLDVF
AYILDTLVF	AYILDTLVF
PLPSNTPTF	PLPSNTPTF
KYYEDNKQFF	YYEDNKQFF
IYVLPMLT	IYVL-PMLT
EYVAPLVLW	EYVAPLVLW
RYQTQPVTL	RYQTQPVTL
TYLDLLGTWVF	TYLDLLGTW
AYADLVKQAW	AYADVKQAW
VYADGPLNL	VYADGPLNL
IYGEKFEDENF	IYGEKFEDE
KYNSEWWVL	KYNSEWWVL
VSPYTEIHL	VSPYTEIHL
TYLDIFRDF	TYLDIFRDF
IYLPYLQNW	IYLPYLQNW
SYVAGIAWF	SYVAGIAWF
IYLTFPVAMF	IYLTPVAMF
IYTVLFERL	IYTVLFERL
LYQEVFGRL	LYQEVFGRL
LYDKDHYKL	LYDKDHYKL
TYTSYLDKF	TYTSYLDKF
HAPPGEFNEVF	PPGEFNEVF
IYADLNQNDF	IYADNQNDF
KYPDRVPVI	KYPDRVPVI
RYLNSQQQYF	RYLNQQQYF
YYGQGFPTF	YYGQGFPTF
MTQIMFETF	MTQIMFETF
LFHTIGVEF	LFHTIGVEF
ELPDYYLTI	ELPDYYLTI
HYTIVFNTF	HYTIVFNTF
NFPEFSFDF	NFPEFSFDF
AYTLLLHTW	AYTLLLHTW
TYQDIFRDF	TYQDIFRDF
RYLTVAAVF	RYLTVAAVF
LYGRLLVTF	LYGRLLVTF
YYEDNKQFF	YYEDNKQFF
RYPDNLKHLY	RYPDNLKHL
RYVALTSLL	RYVALTSLL
VYNPELDKW	VYNPELDKW
EFSKTPYTI	EFSKTPYTI
YYIDDVFHAL	YYIDVFHAL
QYYFNQHIF	QYYFNQHIF
YWFDAQQNTWF	YWFDQQNTW
KYEELFPAF	KYEELFPAF
AYSTVPGYYSW	AYSTVPGYY
GYLRSVFAL	GYLRSVFAL
AYLESFYKF	AYLESFYKF
IWISKLPHF	IWISKLPHF
TYSPALNKMF	TYSPALNKM
SYNHFAAIYF	SYNHAAIYF
AYFLKPKEL	AYFLKPKEL
VYPWPLPVY	VYPWPLPVY
ILNPDTLSL	ILNPDTLSL
FLPTHAQPNL	FLPTAQPNL
KFIDTTSKF	KFIDTTSKF
YYNGKWEFL	YYNGKWEFL
VYKDSIYYI	VYKDSIYYI
SYVDKNLELF	SYVDNLELF
SYLENVDHF	SYLENVDHF
YYQHIVTTL	YYQHIVTTL
KYPEKLYFEGL	KYPE-KLYF
KYGIVQEFF	KYGIVQEFF
TWYPVSIPAF	TWYPSIPAF
MYSDVWKQL	MYSDVWKQL
SYEYRFLEF	SYEYRFLEF
VYQHLFTRI	VYQHLFTRI
RYYFEGIKQTF	YYFEIKQTF
GYSEHFVEF	GYSEHFVEF
LYPGQLVQL	LYPGQLVQL
LYPDHFHLL	LYPDHFHLL
VSPVVRVAV	VSPVVRVAV
IYQDSFEQRF	IYQDFEQRF
YSHCVDVYI	YSHCVDVYI
RYPSNLQLF	RYPSNLQLF
PLPAENVTI	PLPAENVTI
RWFQPAIPSW	RWFQAIPSW
RFQAIITTF	RFQAIITTF
NYGDYFNVFF	NYGDYFNVF
IFNGFSVTL	IFNGFSVTL
LFIATSQKF	LFIATSQKF
GYMDDTQFVRF	YMDDQFVRF
LYTGTVSSF	LYTGTVSSF
AYYPAQGVQQF	YYPAGVQQF
KYITQGQLL	KYITQGQLL
SYRNIFPIW	SYRNIFPIW
TYNIFAITF	TYNIFAITF
PYFPIPEEYTF	YFPIEEYTF
LYIPPTHTFL	LYIPPTHTF
KYFEKQFEL	KYFEKQFEL
KYISKPENL	KYISKPENL
LYPEVFEKF	LYPEVFEKF
TYAPAIHQI	TYAPAIHQI
TYVKRLHLL	TYVKRLHLL
NFLPEIITL	NFLPEIITL
EYIPKWEQF	EYIPKWEQF
VYYPVRHHL	VYYPVRHHL
RYFENPQVI	RYFENPQVI
IYAPTLLVF	IYAPTLLVF
RYIDFLYQV	RYIDFLYQV
VFLPSTPGL	VFLPSTPGL
QYAVLLNRF	QYAVLLNRF
HYPQFSGQSF	HYPQSGQSF
NYRDTFFNL	NYRDTFFNL
TWSGESKTLVL	TWSGESKTL
VYEEILHQI	VYEEILHQI
NYLSIFRKF	NYLSIFRKF
NYLPAINGI	NYLPAINGI
AYLSKAMEI	AYLSKAMEI
RYSTPHAFTF	RYSTHAFTF
YYVDFFKTL	YYVDFFKTL
VYKVVGNLL	VYKVVGNLL
DRVYIHPF	DRVY-IHPF
IYKIDFVRF	IYKIDFVRF
SYLPTKPGEYF	YLPTPGEYF
EYFRVPDSATF	YFRVDSATF
YYLNRTHML	YYLNRTHML
IYFKNSENLW	IYFKNSENL
EYLIVFPKL	EYLIVFPKL
EYNSDLHQF	EYNSDLHQF
TTKTYFPHF	TTKTYFPHF
VFYPYPQYF	VFYPYPQYF
RYLDVSILGKF	RYLD-VSIL
LYPPGIELI	LYPPGIELI
IYDIVRNSW	IYDIVRNSW
LQPVTPLQLF	LQPVPLQLF
DYQEMFVQF	DYQEMFVQF
SFISPSIPITF	ISPSIPITF
YLPVNESF	YLPV-NESF
RWLAQPYYL	RWLAQPYYL
YIKSPPFF	YIKS-PPFF
DAASGGLLAAF	ASGGLLAAF
YAWVLDKL	YAWV-LDKL
RQPAELHLF	RQPAELHLF
MFLDRPQQW	MFLDRPQQW
IFFENHPYF	IFFENHPYF
YFISPFGHGL	YFISFGHGL
VYIKNFGEEVD	VYIKFGEEV
TYIQNFRFF	TYIQNFRFF
IFRPDNFVF	IFRPDNFVF
KYLSSENPLFF	KYLSENPLF
MYMTVSIIDRF	YMTVIIDRF
FYADHPFIFL	FYADHPFIF
KYHGYPYSF	KYHGYPYSF
PYQSQIAVF	PYQSQIAVF
GYIHVTQTF	GYIHVTQTF
KYFPYLVVI	KYFPYLVVI
NYLKDGPYI	NYLKDGPYI
SSGCFQEQQE	EQQE-----
NYLLESPHRF	NYLLSPHRF
TWFTAGAKLLF	TWFTAGAKL
LYPFPLALF	LYPFPLALF
RFQEKFFIF	RFQEKFFIF
SFSPKTYSF	SFSPKTYSF
TYSPFGDSPLF	PFGD-SPLF
SYFGSFSSL	SYFGSFSSL
RYPQDYQFYI	RYPQYQFYI
LYGKIAEAF	LYGKIAEAF
RYSSAFTNRI	RYSSFTNRI
LAVLSHIF	LAVL-SHIF
DYGNGFGGF	DYGNGFGGF
FYTKRFQEL	FYTKRFQEL
YYEYNHDLF	YYEYNHDLF
PYSPPTFRF	PYSPPTFRF
IYKDLPFETL	IYKDPFETL
MLGKFYHF	MLGK-FYHF
VYSRTFTWL	VYSRTFTWL
SYGTAPVNL	SYGTAPVNL
IGSGLSDLF	IGSGLSDLF
IFVDFAPFL	IFVDFAPFL
SQEGMVFTRF	SQEGVFTRF
SYLSSILRF	SYLSSILRF
KYLEEFPDGF	KYLEFPDGF
LFLPFPLPLF	LFLPPLPLF
LIPEEFFQF	LIPEEFFQF
PYLGQAPFL	PYLGQAPFL
EYVEKFYRI	EYVEKFYRI
EYVKQTWNL	EYVKQTWNL
RYLNDLYIL	RYLNDLYIL
FWVRGEGPIF	FWVREGPIF
YYDANQSMYVF	YYDANQSMY
TYAELMQTL	TYAELMQTL
YEVSQLKD	YEVS-QLKD
HYYGTGETF	HYYGTGETF
LYIKNGQGF	LYIKNGQGF
QWPELIPTL	QWPELIPTL
PYAPSGEIPKF	YAPSEIPKF
KYILVVPLI	KYILVVPLI
IYDHINEGKLW	IYDHNEGKL
KYTDWTEFL	KYTDWTEFL
IYKPVTDFFL	IYKPVTDFF
KYMPSVKVSVF	YMPSKVSVF
QYVSAFSKL	QYVSAFSKL
LFVKDLPQI	LFVKDLPQI
EYLTPEEMVTF	YLTPEMVTF
VYAVPILIF	VYAVPILIF
LYISEAEGLKF	LYISEAEGL
YGHFGRDSF	YGHFGRDSF
AYLQLLNLF	AYLQLLNLF
LYLTEKYVW	LYLTEKYVW
EYFESPFTI	EYFESPFTI
PYTEFKEF	PYTE-FKEF
QYFTKTVFL	QYFTKTVFL
VYLDKFIRL	VYLDKFIRL
QYQFLHHTL	QYQFLHHTL
SYASLQQNKW	SYASQQNKW
NYATGQWTRF	NYATQWTRF
AYFYGPIFI	AYFYGPIFI
AYGNVFSAF	AYGNVFSAF
SYQDFFEAI	SYQDFFEAI
PQPDVFPLF	PQPDVFPLF
PWVIEPVYI	PWVIEPVYI
IYIPTLAVL	IYIPTLAVL
VDLGGSHVF	VDLGGSHVF
IFSRFNALF	IFSRFNALF
NYKSEEEFIHI	NYKSEEEFI
KYVKIFDNF	KYVKIFDNF
TYRPLNDVHI	TYRPNDVHI
KYMTAVVKLF	KYMTVVKLF
EYALRSHSL	EYALRSHSL
QYNTYPIKLF	QYNTYPIKL
YFQQTGVRGF	YFQQGVRGF
EYDYLFKLL	EYDYLFKLL
PFHPPLQLFF	PFHPPLQLF
LYADVGGKQF	LYADGGKQF
AYAGARFVF	AYAGARFVF
NYLPITFGDKF	YLPIFGDKF
QYISPFHDI	QYISPFHDI
LYWSHPRKF	LYWSHPRKF
AYVGNLPRI	AYVGNLPRI
YFKAVSPELF	YFKASPELF
NYTEFTQFL	NYTEFTQFL
RYQDELTALL	RYQDLTALL
LGSGFPHLQLL	SGFPHLQLL
EYIRSLNQF	EYIRSLNQF
IWMKDPFAF	IWMKDPFAF
VYHLHIHVL	VYHLHIHVL
IYPALPQPNF	IYPAPQPNF
KFLEQVHQL	KFLEQVHQL
VYTLFSNKI	VYTLFSNKI
TMNIGSDKLLF	NIGSDKLLF
KYTKIFNDF	KYTKIFNDF
TYLDLLGTW	TYLDLLGTW
HFGPINSVAF	HFGPNSVAF
SYLSSLSHL	SYLSSLSHL
KYQDILNEI	KYQDILNEI
QQAQAFYTF	QQAQAFYTF
SFYPLIDVNW	FYPLIDVNW
KYLHPPPHL	KYLHPPPHL
VFFKELIQEF	VFFKLIQEF
NYSPGWKFNHW	NYSP-GWKF
SYMPARVVVF	SYMPRVVVF
TYFSAPGVMNF	YFSAGVMNF
VYSFGFERL	VYSFGFERL
VYFGDPVSL	VYFGDPVSL
TFPNIASATKF	PNIASATKF
SYLQSLLLF	SYLQSLLLF
RWFTHASPTLF	RWFTASPTL
RYISPDQLADL	RYIS-PDQL
KYVTSAYQW	KYVTSAYQW
LFLPRTDYSF	LFLPTDYSF
TIAEIKNLF	TIAEIKNLF
IYLEYLQAI	IYLEYLQAI
HYVDLKDRPFF	HYVDKDRPF
TYINPFVSF	TYINPFVSF
RYSTGLAGNLL	RYSTLAGNL
AYLSGMLRF	AYLSGMLRF
NYPPQYLILKL	NYPPQYLIL
GGLPERSVSL	GLPERSVSL
DYIDGILIKTF	DYID-GILI
LPEYSGITSL	EYSG-ITSL
QWPELLLRF	QWPELLLRF
RYIPDAMNLIL	RYIPAMNLI
AYTTVLQEW	AYTTVLQEW
EFLNWHALF	EFLNWHALF
AYLVNTYAL	AYLVNTYAL
VYMFQYDSTH	VYMFQYDST
QYPPVNWAALL	QYPPNWAAL
VYSPAIKDSTM	VYSPIKDST
NYIKDLNIL	NYIKDLNIL
RWTDNIFAI	RWTDNIFAI
NFQIEHHLF	NFQIEHHLF
RYQQPFEDF	RYQQPFEDF
LYQVVSQRF	LYQVVSQRF
SYMWTINNFSF	SYMWTINNF
VYFEGSDFKF	VYFESDFKF
DYSPYFKTI	DYSPYFKTI
EFLPFHFLL	EFLPFHFLL
AWAPKPYHKF	AWAPPYHKF
EWIPLAWKW	EWIPLAWKW
LFEWFHPLF	LFEWFHPLF
SYTRLFSNF	SYTRLFSNF
AYLQQVQDLVI	AYLQQVQDL
LYTLIEKTM	LYTLIEKTM
TYKDYVDLF	TYKDYVDLF
VYGGGAAEI	VYGGGAAEI
AYVGDLQTL	AYVGDLQTL
FYGDKMNLF	FYGDKMNLF
VWESSGQWMF	VWESGQWMF
RYGLPAAWSTF	YGLPAWSTF
EYVANLTEL	EYVANLTEL
GYYGPLRSVW	YYGPLRSVW
TYLGKYWAI	TYLGKYWAI
GYLADPAKF	GYLADPAKF
GRLYVEAAF	GRLYVEAAF
IYELMQTEF	IYELMQTEF
VITVPAYF	VITV-PAYF
KYIPELAYY	KYIPELAYY
KYSVWIGGSIL	KYSVIGGSI
EYNNNFHVL	EYNNNFHVL
IYQKAFEHL	IYQKAFEHL
VLFVVPLII	VLFVVPLII
VQPRNWLLF	VQPRNWLLF
KYQEVTNNL	KYQEVTNNL
QYTDLLRLF	QYTDLLRLF
QYIKFISETL	QYIKISETL
SYYDVKFNFL	SYYDVKFNF
KYPDIISRI	KYPDIISRI
KYWDVPPPGF	KYWDPPPGF
RYLSPKYIKMF	RYLSKYIKM
PYMDEIFHL	PYMDEIFHL
VYNTVSEGTHF	VYNTEGTHF
YLPEMFVNF	YLPEMFVNF
NYLPQISHL	NYLPQISHL
AAMYPDVFAHF	MYPDVFAHF
KTNHVFFLL	KTNHVFFLL
RYIMGSGESF	RYIMSGESF
AYATFIVTNYW	AYATIVTNY
RLYGPSSVSF	LYGPSSVSF
IYPSNMQTMLL	IYPSNMQTM
IYQYLGEPETF	QYLGEPETF
VYIDSMGYAF	VYIDMGYAF
FYLPLDAIKQL	FYLP-LDAI
VYMSSIESL	VYMSSIESL
VYIDKVRSL	VYIDKVRSL
VYANGIRNI	VYANGIRNI
RFFTSSTSLTL	RFFTSSTSL
LYAANPGQLF	LYAAPGQLF
KYLGQLHYL	KYLGQLHYL
RYTNGHLFTTI	RYTN-GHLF
PYVNNVPHL	PYVNNVPHL
VYKKYPNVF	VYKKYPNVF
TLPNYEDVATF	NYED-VATF
TYVPWPLML	TYVPWPLML
HYLNVAFDL	HYLNVAFDL
KYSTTFFMV	KYSTTFFMV
DYLTRYEHF	DYLTRYEHF
NYTLVSHLI	NYTLVSHLI
QLPELFHKI	QLPELFHKI
RYSGVNQSML	RYSGNQSML
GYIERPQLI	GYIERPQLI
RYQNIWNINL	RYQNWNINL
VYPPPHQVF	VYPPPHQVF
VYAILTHGIF	VYAILTHGI
VMPNGPPSFF	VMPNGPPSF
IYTLIHYI	IYTL-IHYI
NYKLTSITF	NYKLTSITF
GYAFIEFASF	GYAFEFASF
KYPYVAVML	KYPYVAVML
EYASLIGWKF	EYASIGWKF
VGTYIIDLLTF	TYIIDLLTF
QYASAFHFL	QYASAFHFL
EWLNKFNTF	EWLNKFNTF
VYSFVTPTF	VYSFVTPTF
AYLMDSDKF	AYLMDSDKF
KYMPNVKVAVF	YMPNKVAVF
LYYNTITNF	LYYNTITNF
QYLERLKQF	QYLERLKQF
LYIPIFSTF	LYIPIFSTF
LLPLIYHHL	LLPLIYHHL
PVTVRSIIS	PVTVRSIIS
KLPNFGFVVF	KLPNGFVVF
VYPGYYLTF	VYPGYYLTF
YYFPVKNVID	YYFPVKNVI
SYLKEFIHI	SYLKEFIHI
VFSTDAGFHF	VFSTAGFHF
VYTDFAFRI	VYTDFAFRI
IYPSKWIARL	IYPSWIARL
EYGIFNQKI	EYGIFNQKI
VYAVIPAEKF	VYAVPAEKF
LYSEVDVHF	LYSEVDVHF
LYEEAFTVF	LYEEAFTVF
YYNKVSTVFW	YYNKVSTVF
KYPENFFLL	KYPENFFLL
AFPPHHPLI	AFPPHHPLI
KYQEEFEHF	KYQEEFEHF
MYPPEIGDFAF	MYPPEIGDF
SYPNVFLVF	SYPNVFLVF
AYLIDIKTI	AYLIDIKTI
KFISNSNKITF	KFISNSNKI
LLPSRQFGF	LLPSRQFGF
VYSPFVLLNTL	VYSP-FVLL
LIPIIVLLL	LIPIIVLLL
FYLFDLKAF	FYLFDLKAF
DDMEKIWHHTF	DMEKWHHTF
RYAVIGADL	RYAVIGADL
VYSHLPDLL	VYSHLPDLL
IFSHFFGDFGF	IFSHFFGDF
DYMGMSSGF	DYMGMSSGF
IYNPAFFKY	IYNPAFFKY
VLYPQVMEFW	LYPQVMEFW
TYIQKIFRM	TYIQKIFRM
KYGLGFQII	KYGLGFQII
FYIPDGSFTNI	YIPDSFTNI
VYITRAQLM	VYITRAQLM
EYHTPWYLF	EYHTPWYLF
TYMDAQLFKKV	TYMD-AQLF
PYVDNSYKW	PYVDNSYKW
KYPVLFQRI	KYPVLFQRI
FSPQMVGFYI	FSPQVGFYI
SFFGSLPGF	SFFGSLPGF
RYLPQCSYF	RYLPQCSYF
VFMFPVGLYY	VFMFVGLYY
YLPHLFPSF	YLPHLFPSF
EYLDRIGQLFF	EYLDIGQLF
LYKELGEYF	LYKELGEYF
LFYADHPFIF	FYADHPFIF
VLIKDTTALSF	VLIKDTTAL
SYIFDINTI	SYIFDINTI
VFLPIVVLI	VFLPIVVLI
IYQDRDQFAKL	IYQD-RDQF
NYIFRLSQF	NYIFRLSQF
YYISPRITF	YYISPRITF
MYTPKAEVW	MYTPKAEVW
IIGDTFVKI	IIGDTFVKI
EYWDTVRPLL	EYWDVRPLL
HYIYIENQFF	IYIE-NQFF
VYFGGFFI	VYFG-GFFI
IFIKDSNSL	IFIKDSNSL
AFLDSQTATF	AFLDQTATF
NYFTVTKPW	NYFTVTKPW
GYTPDWIFLL	GYTPWIFLL
PYQPQYPDSHF	QYPD--SHF
PYYNGPHLNL	YYNGPHLNL
AYMELQQKAEF	AYMELQQKA
KYPDVASPTL	KYPDASPTL
GYRDPYSGSTI	RDPYSGSTI
KYVKGLISI	KYVKGLISI
IWDTLGNKQF	IWDTGNKQF
NYIPVKNGKQF	NYIPNGKQF
PYYQPPYTL	PYYQPPYTL
KYVPLVTGL	KYVPLVTGL
VYIRGSKIRF	VYIRSKIRF
TGPTRFFLF	TGPTRFFLF
NYPVWDTQF	NYPVWDTQF
VYDTVHEEW	VYDTVHEEW
TYKNFFYLI	TYKNFFYLI
IFHPTQPWVF	IFHPQPWVF
KWDLSELPKF	KWDLELPKF
DYFVPLHHF	DYFVPLHHF
PYNPILGETF	PYNPLGETF
SFSNSFPQIF	SFSNSFPQI
VYPSRAVITTM	VYPS-RAVI
LYTEAIKFF	LYTEAIKFF
SYVRWEGVF	SYVRWEGVF
LYHEKPLVF	LYHEKPLVF
VYKPPGLKW	VYKPPGLKW
TYMDVMREQHL	TYMDREQHL
VWLEEAGQKL	VWLEAGQKL
KQPEDYFYL	KQPEDYFYL
GYTTIVPDF	GYTTIVPDF
IYPKLLDNF	IYPKLLDNF
VYAEIMAVL	VYAEIMAVL
IYNFPIHAF	IYNFPIHAF
YIPRKPFPDF	YIPRPFPDF
EYAPDYQSFW	EYAPDYQSF
IWYTPIKEEW	WYTPIKEEW
SWLTSSWNF	SWLTSSWNF
KYFGPDFLEQI	YFGPFLEQI
IYLRDPVQV	IYLRDPVQV
RYYGYTGAF	RYYGYTGAF
SYFEDFSNI	SYFEDFSNI
KYGVAFYNY	KYGVAFYNY
VYDGKFAIF	VYDGKFAIF
RFLDKALEL	RFLDKALEL
HYLPDLHHL	HYLPDLHHL
SYATLLHVL	SYATLLHVL
KYPHYFPVM	KYPHYFPVM
LYRLQFNEF	LYRLQFNEF
FYQRFPLSF	FYQRFPLSF
AYTRAVMHF	AYTRAVMHF
QYIDKLNEL	QYIDKLNEL
KMLDNFYNF	KMLDNFYNF
VYMGLLAVF	VYMGLLAVF
IYFEYSHAF	IYFEYSHAF
YYDPKHVIF	YYDPKHVIF
GYSVIIEKL	GYSVIIEKL
KYTEGVQSL	KYTEGVQSL
IYPTGLFTPEL	IYPTFTPEL
VYTDLTPLSKF	VYTDPLSKF
VYLPTAFLL	VYLPTAFLL
SFPHPLPSL	SFPHPLPSL
RYLEYFEKI	RYLEYFEKI
SEKVYTIMY	SEKVYTIMY
AYNEGIINLL	AYNEIINLL
EYVSQHLVF	EYVSQHLVF
LFIDDKGILF	LFIDKGILF
VYGSFASKL	VYGSFASKL
QYSNAFDVF	QYSNAFDVF
QYLQDAYSF	QYLQDAYSF
RYPPHSVQYTF	RYPPHSVQY
RYVFQSENTF	RYVFSENTF
RYRPRAPII	RYRPRAPII
VYSEVAAYEF	VYSEAAYEF
FWAPESAPL	FWAPESAPL
QYPEVEIFRTL	QYPE-VEIF
VYKKSIFVF	VYKKSIFVF
IFLSQPILL	IFLSQPILL
RYVPSTPWF	RYVPSTPWF
QYVAQANSW	QYVAQANSW
SYKNGFLNL	SYKNGFLNL
YYNGMVVFW	YYNGMVVFW
SYSSTFHSL	SYSSTFHSL
LYGPKYTFF	LYGPKYTFF
YYTNSLEKL	YYTNSLEKL
FYQHKFPEV	FYQHKFPEV
AFAPIQEMMTF	AFAPIQEMM
IYVQALIFRL	IYVQLIFRL
IFLTKANLI	IFLTKANLI
YGIRLEHF	YGIR-LEHF
YYITTRAQF	YYITTRAQF
YFIADLPHL	YFIADLPHL
EWSPYTKIF	EWSPYTKIF
VYDPSLKTLL	VYDPSLKTL
LYIGWDKHYGF	LYIGWDKHY
LFLDDGHTF	LFLDDGHTF
TYSIGFLRF	TYSIGFLRF
SYLVQYMQF	SYLVQYMQF
VTVAVVDTF	VTVAVVDTF
EMMDLQHGSLF	MDLQHGSLF
LYVDFPQHL	LYVDFPQHL
IYTEAKKVPW	IYTEKKVPW
IYGGATKWTF	IYGGTKWTF
TYLPTSPLL	TYLPTSPLL
KYFQLDVTL	KYFQLDVTL
LYPSKSIIL	LYPSKSIIL
IFTTEAHLL	IFTTEAHLL
KYMDIEFDF	KYMDIEFDF
NYIHVGAQL	NYIHVGAQL
KFIEGGDGHLF	KFIEGDGHL
RYQEFINTLQF	RYQEFINTL
DYGNSPLHRF	DYGNPLHRF
IYNYPEQLF	IYNYPEQLF
YMGHFDLLNYF	GHFDLLNYF
YYQDTPKQI	YYQDTPKQI
NYLPFIMEL	NYLPFIMEL
LLPAGGAPTVF	PAGGAPTVF
KYLATLETL	KYLATLETL
IWLPFPVLL	IWLPFPVLL
YYLNKSVSI	YYLNKSVSI
DYRPLFENF	DYRPLFENF
KYPSPFFVF	KYPSPFFVF
AYSAKIALF	AYSAKIALF
RYKPGEPITF	RYKPEPITF
NYEGSPIKVTL	EGSPIKVTL
AYPTVKFYF	AYPTVKFYF
KYPNLLNQL	KYPNLLNQL
KYQELQVLF	KYQELQVLF
KYQPRIAVF	KYQPRIAVF
KYLMIEEYL	KYLMIEEYL
RYINNPLLI	RYINNPLLI
GYGFTTDLF	GYGFTTDLF
RYPDSHQLF	RYPDSHQLF
ILPKELQTW	ILPKELQTW
PWGVYPANLF	PWGVPANLF
EYGKFFVTI	EYGKFFVTI
VYITGKEVFSF	VYITGKEVF
VYPGIAENI	VYPGIAENI
VYPFPTFQPAF	PFPTFQPAF
LYAKIAEAF	LYAKIAEAF
NYISGIQTI	NYISGIQTI
RYQHGIAVI	RYQHGIAVI
NYISFYDHL	NYISFYDHL
IYNQVNVVL	IYNQVNVVL
YFISHVLAF	YFISHVLAF
PYISTTPAKL	PYISTPAKL
TFNPSSMAVSF	NPSSMAVSF
VLPPDTDPAFF	VLPPTDPAF
AFFGDVVLRF	FFGDVVLRF
LFIDQPQFLKF	LFIDQPQFL
SYAQGFMLL	SYAQGFMLL
QWSPTRPAVF	QWSPRPAVF
QYIFEGLGHLI	IFEGLGHLI
QYPVIIHLI	QYPVIIHLI
PYNPILGEIF	PYNPLGEIF
FYQPKIQQFL	FYQPKIQQF
YYLQHPPISF	YYLQPPISF
YYIIYRNVF	YYIIYRNVF
ILPVGAANF	ILPVGAANF
GYADIVQLL	GYADIVQLL
PWFAGNKITF	PWFANKITF
NYIPYLTKLKF	NYIPYLTKL
HYPEYGYTI	HYPEYGYTI
VYPASKMFPFI	VYPAKMFPF
SIPGGYNAL	SIPGGYNAL
VYWHSSAHI	VYWHSSAHI
LYIPSVDLL	LYIPSVDLL
IGAEVYHNL	IGAEVYHNL
SFPTTKTYF	SFPTTKTYF
GYPETLVNLI	GYPETLVNL
TLKYPHYFPLL	KYPHYFPLL
NYFPGGVALIW	NYFPGVALI
NYKNPDQVYL	NYKNDQVYL
RYFPDRNVALF	YFPDNVALF
VFIHPAASYYF	IHPAASYYF
SYLIIHQRI	SYLIIHQRI
LYQDKFPFF	LYQDKFPFF
YYLNDLDRI	YYLNDLDRI
IYGLIVALL	IYGLIVALL
VYPTAVHVL	VYPTAVHVL
NWGNLNITKI	NWGNNITKI
GYGPPPPHY	GYGPPPPHY
VYTEAIADI	VYTEAIADI
RYMSPMEAQEF	YMSPEAQEF
ALPSMDKYAVF	PSMDKYAVF
VYWEGYVRF	VYWEGYVRF
RYNPGSESITF	RYNPGSESI
LLPAEYAEF	LLPAEYAEF
AYVVKVFSL	AYVVKVFSL
KYMDVQFDF	KYMDVQFDF
LQNHVFPLF	LQNHVFPLF
IFGPVQPLF	IFGPVQPLF
VLPPSSIGFTF	VLPPSSIGF
RMPEFYNRF	RMPEFYNRF
TYQVLAVTF	TYQVLAVTF
SFISGLFNF	SFISGLFNF
KMPKMKMPTF	KMPKKMPTF
FYALVQYTL	FYALVQYTL
VYLQNWSHVL	VYLQWSHVL
VFLVPTGEVF	VFLVTGEVF
VYVPHIHVW	VYVPHIHVW
SYISKVDVL	SYISKVDVL
TYVENLRLL	TYVENLRLL
NYFTVTKPWF	NYFTTKPWF
MYPDVFAHF	MYPDVFAHF
KFVEQLITF	KFVEQLITF
LYPFLGIRF	LYPFLGIRF
IWDKIKNLF	IWDKIKNLF
TYAELMQTLRF	TYAELMQTL
SYMFVDENTF	SYMFDENTF
YWPVIPLKF	YWPVIPLKF
SYIDVAVKL	SYIDVAVKL
TTPPSVFFPVF	TPPSFFPVF
SYVTEELPQL	SYVTELPQL
LFYADHPFIFL	FYADHPFIF
SYIGFPVEL	SYIGFPVEL
SYSSKPPLW	SYSSKPPLW
IQPGKVVVF	IQPGKVVVF
KWPETPLLL	KWPETPLLL
DYAYLREHF	DYAYLREHF
YLPDGTASL	YLPDGTASL
PYYDSFVRW	PYYDSFVRW
IYGLDFYVV	IYGLDFYVV
RWLSENIAHF	RWLSNIAHF
NYITIKDFL	NYITIKDFL
FFPLESWQI	FFPLESWQI
KMPKFSMPGF	KMPKSMPGF
SHGFAAEF	SHGF-AAEF
KYLEDMKTYF	KYLEMKTYF
VYPPGGQPLL	VYPPGQPLL
FYTPAPPGF	FYTPAPPGF
AYYHQEWTVF	YYHQEWTVF
TYLIVTSLL	TYLIVTSLL
TYLLSVYRL	TYLLSVYRL
IFKPPDPDNTF	KPPDPDNTF
VYGTLSDLL	VYGTLSDLL
TYIIPRSVLF	TYIIRSVLF
NYQKRFQNL	NYQKRFQNL
IYQQIIQTY	IYQQIIQTY
AYGEVGRVFF	AYGEVGRVF
GWAGQPPPTW	GWAGPPPTW
KYLLTPVNFF	KYLLTPVNF
KYTGVLTEL	KYTGVLTEL
YYGYDYHNY	YYGYDYHNY
NMTSVTNHF	NMTSVTNHF
VYSQIPAAVKL	VYSQIPAAV
YYSKFFDLI	YYSKFFDLI
VWGVPIPVF	VWGVPIPVF
MYPDLSELLM	MYPDLSELL
VYIKHPVSL	VYIKHPVSL
VVPSGGFFPTI	PSGGFFPTI
AYGHFSYEF	AYGHFSYEF
LLPHILPLL	LLPHILPLL
TLPAGWKPLF	TLPAWKPLF
VYIPAHGRL	VYIPAHGRL
VYISQWGSMW	VYISWGSMW
VMKSLTQTF	VMKSLTQTF
VYKSPASDTY	VYKSASDTY
RYYDVPIATL	RYYDPIATL
SFMDVSNPF	SFMDVSNPF
VWWEIVGPTL	VWWEVGPTL
LYAQLVQQRF	LYAQVQQRF
RYKLYQEMF	RYKLYQEMF
MYTLGITNF	MYTLGITNF
IYIAGHPAF	IYIAGHPAF
VQQTVQDLF	VQQTVQDLF
KYNFPLVTL	KYNFPLVTL
QFVPKSHLF	QFVPKSHLF
FIANVAHTF	FIANVAHTF
IYPEYILPGI	IYPEILPGI
YYFSTISSSF	YYFSISSSF
RYIANTVEL	RYIANTVEL
YYTEAGSMFF	YYTEAGSMF
IDLTSASYTMI	DLTSASYTM
AYMRSLFDYF	AYMRLFDYF
DYITYLSIF	DYITYLSIF
YFPTWEGLFW	YFPTWEGLF
ARLQQLLFVIF	RLQQLFVIF
YYVRAVLHL	YYVRAVLHL
YYTGWMQKW	YYTGWMQKW
QYEQVKQLF	QYEQVKQLF
TYFSTPLLL	TYFSTPLLL
SFSDYPPLGRF	DYPP-LGRF
VYSPALTDF	VYSPALTDF
EYLRFLQTI	EYLRFLQTI
VYKAFVMETF	VYKAVMETF
SYVHYVFRL	SYVHYVFRL
IYSTKLYRF	IYSTKLYRF
IGYPKPALL	IGYPKPALL
KYWDTFYKI	KYWDTFYKI
IYLVSIPELLF	IYLVIPELL
SYTSGLETL	SYTSGLETL
RYPPDIRATF	RYPPIRATF
VYTPVASRQSL	VYTPSRQSL
IYPDSFTVL	IYPDSFTVL
NYPSAFHSV	NYPSAFHSV
TYINHVVSV	TYINHVVSV
KYMRDPTFV	KYMRDPTFV
RYPEETLSLM	RYPEETLSL
VWLPASVLF	VWLPASVLF
HYIDDLVVI	HYIDDLVVI
DYNFVFTSF	DYNFVFTSF
IYSWILDHF	IYSWILDHF
AYIERMNYI	AYIERMNYI
TYPNTYIF	TYPN-TYIF
RYAEQISVL	RYAEQISVL
MFTNQGTVIHF	MFTNQGTVI
TWYHTPNVVF	WYHTPNVVF
EYKIAFPYL	EYKIAFPYL
YYDDLKYRYF	YYDDKYRYF
TYLSIFDQL	TYLSIFDQL
SYLDSIHFF	SYLDSIHFF
SFYFFFSSF	SFYFFFSSF
IYPYVIQEL	IYPYVIQEL
LYIYPQSLNF	LYIYQSLNF
KFLDPITGTF	KFLDITGTF
SYADQMFLL	SYADQMFLL
KYSPFVVSF	KYSPFVVSF
VYIGKLNMI	VYIGKLNMI
LYNKDAVIEF	LYNKAVIEF
TYLPAGQSVL	TYLPGQSVL
NYAQWYPIVVF	QWYP-IVVF
YYDVKFNFL	YYDVKFNFL
KYLDVKFEYL	KYLDKFEYL
NYHLGVMSW	NYHLGVMSW
FYVDTVRAF	FYVDTVRAF
KYIQEAEML	KYIQEAEML
MYSIEPADRF	MYSIPADRF
VYPSAGVLF	VYPSAGVLF
VYVAAVREF	VYVAAVREF
IYKGIPLQL	IYKGIPLQL
VYVQELQKL	VYVQELQKL
EYTRYLFAL	EYTRYLFAL
AYLEAYKEF	AYLEAYKEF
AYDVLFHQW	AYDVLFHQW
VHIPEVYLI	VHIPEVYLI
AYMPHTFFI	AYMPHTFFI
IFPLETPAF	IFPLETPAF
NSTAIQELF	NSTAIQELF
YLDHAGATL	YLDHAGATL
SYLELVKSL	SYLELVKSL
RYKYIFINI	RYKYIFINI
IYGEKLQFIF	IYGEKLQFI
EYLQEVARI	EYLQEVARI
PYMDEIVTL	PYMDEIVTL
HYVAGLVGI	HYVAGLVGI
VYFEKSPDF	VYFEKSPDF
NYNPAQQAF	NYNPAQQAF
VMPSSFFLL	VMPSSFFLL
NYMEPAQLL	NYMEPAQLL
VFPEKGYSF	VFPEKGYSF
ALTEVLFHF	ALTEVLFHF
VYTTTVHWL	VYTTTVHWL
VLGTPVETI	VLGTPVETI
GWMEISHTF	GWMEISHTF
VYSPNMRWII	VYSPNMRWI
AYTPVVVTL	AYTPVVVTL
SFVILVAL	SFVI-LVAL
MGHTGAVW	MGHT-GAVW
KFAELVYTGF	KFAEVYTGF
NYNFEKPFL	NYNFEKPFL
VYLTDPQGLVL	VYLTDPQGL
VFINVPTVSF	VFINPTVSF
PYMRSMMQSL	PYMRMMQSL
KYVSGEFRF	KYVSGEFRF
KYGALVNNF	KYGALVNNF
KYIDKTIRV	KYIDKTIRV
EYTIDSDWRF	EYTISDWRF
AYLITLGKF	AYLITLGKF
SYIQSIPVV	SYIQSIPVV
VANAIIHLF	VANAIIHLF
GFYPAEITLTW	FYPAITLTW
VLPPSSIGF	VLPPSSIGF
VYVDAVGQF	VYVDAVGQF
VYVDLGGSHVF	VYVDGGSHV
KYMSVIAEL	KYMSVIAEL
EYMPGGDLVNL	EYMPGGDLV
GYAGELGFRAF	YAGEGFRAF
AYTPFHAVL	AYTPFHAVL
RYEAAFPFL	RYEAAFPFL
VFHPSQDLVF	VFHPQDLVF
RFSPLTTNLI	RFSPLTTNL
EYGRPFLII	EYGRPFLII
TYPAELNNI	TYPAELNNI
QQQLIDDHFLF	QLIDDHFLF
NYNPYIGGLGI	NYNPYIGGL
SQPLGPRII	SQPLGPRII
NGYTTIVPDF	GYTTIVPDF
EWILNPTNYAF	ILNPTNYAF
NYMLNNYTKF	NYMLNYTKF
RWFDKSFTF	RWFDKSFTF
EYLQLLNLL	EYLQLLNLL
YFINRSWEW	YFINRSWEW
VYENKYVKF	VYENKYVKF
NYMMDWKNQF	NYMMWKNQF
EYLRQIFRL	EYLRQIFRL
AYTSQFVSL	AYTSQFVSL
KYLILLQEM	KYLILLQEM
KFAEEFYSF	KFAEEFYSF
NYIHGSSQAQF	IHGSSQAQF
IYTEVRELV	IYTEVRELV
YGLEKFWAF	YGLEKFWAF
SYLITSVEL	SYLITSVEL
AYPYNFSNL	AYPYNFSNL
RYGNTPFLF	RYGNTPFLF
DYYPEYKLLF	YYPEYKLLF
VLKADEGISF	VLKAEGISF
VYKDSFELKF	VYKDFELKF
IYTPIFNEYIS	IYTPIFNEY
TYIKFINLF	TYIKFINLF
IKYPENFFLL	KYPENFFLL
RYLVISEKL	RYLVISEKL
MWLPWALLL	MWLPWALLL
NYIMQSHSL	NYIMQSHSL
PYSEPMPLSF	PYSEMPLSF
VFEAPTVAF	VFEAPTVAF
YYNQEWTLW	YYNQEWTLW
AFFGDSLATRF	FFGDLATRF
EYLTAEILEL	EYLTEILEL
VYLAKLGNF	VYLAKLGNF
IFIRNVLLF	IFIRNVLLF
YYTEFPTVL	YYTEFPTVL
FLPVTPILEGF	PVTPILEGF
EYIIEYPHF	EYIIEYPHF
QYQPPAPAL	QYQPPAPAL
AYSIVIRQI	AYSIVIRQI
YYKPDSPEY	YYKPDSPEY
SYVTEELPQLI	SYVTELPQL
KYFEVPSVLL	KYFEVPSVL
SYMWTINNF	SYMWTINNF
PYFYAPELL	PYFYAPELL
SYFEHNLETW	SYFENLETW
IYTDIIYIF	IYTDIIYIF
MYQNLKVLI	MYQNLKVLI
HYFVGANYL	HYFVGANYL
PNSHTHYF	PNSH-THYF
QYLEDERIALF	QYLEERIAL
RFGYCRRLL	RFGYCRRLL
IYLERFPIF	IYLERFPIF
VYQEMPAQL	VYQEMPAQL
IYPDLLGLQW	IYPDLGLQW
VYQYTSPDF	VYQYTSPDF
NYGRVFSEW	NYGRVFSEW
EYLENMVIKL	EYLEMVIKL
MYGTIFTAW	MYGTIFTAW
AFFEGPPFKF	AFFEPPFKF
AFKELQSTF	AFKELQSTF
KYLSGLVQW	KYLSGLVQW
VYSFLDKMSF	VYSFDKMSF
IFEDISIEHF	IFEDSIEHF
RWFTHASPTL	RWFTASPTL
SYAAPDRKAF	SYAADRKAF
NYLDPRITVAW	NYLDPRITV
HAPLTNIPL	HAPLTNIPL
TYISTIGIDF	TYISIGIDF
KYLQSTISF	KYLQSTISF
RYLDSLKAI	RYLDSLKAI
SFLPGLHLLTF	SFLPGLHLL
VYILKGGYERF	ILKGGYERF
TYMKDLYQL	TYMKDLYQL
YYEAGQRFL	YYEAGQRFL
VWFNIGSVDTF	FNIGSVDTF
YYTSVTPVL	YYTSVTPVL
PYFQRPLAL	PYFQRPLAL
QYSSVFKSL	QYSSVFKSL
ITPHALPMF	ITPHALPMF
VYIDRVRSL	VYIDRVRSL
IYEPNFIFF	IYEPNFIFF
PYFPIPEEY	PYFPIPEEY
FYGHFFRF	FYGH-FFRF
WYGWHFPEL	WYGWHFPEL
PWPEQHVPVLF	PWPEHVPVL
YYVGFAYLM	YYVGFAYLM
RYLRELPLLF	RYLRELPLL
IQERAFFLF	IQERAFFLF
QFPPALLSF	QFPPALLSF
ALPEIFTEL	ALPEIFTEL
IYIKHPHLF	IYIKHPHLF
PLPNFSSLNL	PLPNSSLNL
PWGIKQAGF	PWGIKQAGF
AFQAEIAQL	AFQAEIAQL
EFGYSNRVVDL	GYSNRVVDL
IYPWVHVVI	IYPWVHVVI
KFSPNTSQF	KFSPNTSQF
KYERIFTLL	KYERIFTLL
FYVRGLFSF	FYVRGLFSF
KYLVIGDLL	KYLVIGDLL
TYTEFVPQI	TYTEFVPQI
NYLDQIAKF	NYLDQIAKF
SYIQQINNL	SYIQQINNL
HYITPMMEL	HYITPMMEL
KYINTDAKF	KYINTDAKF
ISYLDSVHFF	SYLDSVHFF
LFYGNKTSVQF	FYGNTSVQF
RYSTPVDIW	RYSTPVDIW
RYTVGGLETF	RYTVGLETF
TYLVDMQRF	TYLVDMQRF
IYQEIILANHF	IYQELANHF
TFLNHPALI	TFLNHPALI
VYADQPHIF	VYADQPHIF
VYTVHHVVW	VYTVHHVVW
SWPGLAVGNL	SWPGAVGNL
QYGKIEVI	QYGK-IEVI
SISVPIFKQF	ISVPIFKQF
RYLPTGSFPF	RYLPGSFPF
LYEDELVPLF	LYEDLVPLF
YYFSKLIEF	YYFSKLIEF
SYILRLEEI	SYILRLEEI
RLPVSIPLF	RLPVSIPLF
NYKPPNAEEF	NYKPNAEEF
FYQKEHWNYF	FYQKHWNYF
VYPLYTIVF	VYPLYTIVF
TGTAVTPFVF	TGTATPFVF
FYDNNTGKLI	FYDNNTGKL
VFIHDQKLF	VFIHDQKLF
YLPSSFPVL	YLPSSFPVL
NYPDYMPSNIF	NYPDMPSNI
IYSPDHTNNSF	YSPDTNNSF
LEKSFYQF	LEKS-FYQF
AYGASFLSF	AYGASFLSF
YQTPRLWLF	YQTPRLWLF
VYPNWAIGL	VYPNWAIGL
YDIVFKHF	YDIV-FKHF
RYPDTIALTF	RYPDIALTF
FYLLISKTF	FYLLISKTF
KYDAFLASESL	AFLA-SESL
YFTTKSYIF	YFTTKSYIF
VLPKQGPLF	VLPKQGPLF
VGAYILYFF	VGAYILYFF
SYLPWFEVF	SYLPWFEVF
MLLGFGIMLL	LLGFGIMLL
VMPSMPPGQW	VMPSPPGQW
IYPHGLVLL	IYPHGLVLL
VYIHGGGWAL	VYIHGGWAL
YYLGKILEM	YYLGKILEM
RYLLTQELL	RYLLTQELL
VTLEGVPA	VTLE-GVPA
LFLEHAHNL	LFLEHAHNL
IYNPTTGEFL	IYNPTTGEF
IYIPSYFDF	IYIPSYFDF
YYGYTGAF	YYGY-TGAF
VYMNRVKEI	VYMNRVKEI
AYNPVTHQL	AYNPVTHQL
VLPGHFNTF	VLPGHFNTF
RYQKSTELL	RYQKSTELL
PYLLYSVHM	PYLLYSVHM
VYIHPSSALF	VYIHSSALF
FYPFPVPPL	FYPFPVPPL
VYAHFPINVV	VYAHFPINV
SFLVPSLLQF	SFLVSLLQF
AYFPPGATL	AYFPPGATL
LYPGSVYLL	LYPGSVYLL
MYDSFWRQF	MYDSFWRQF
LYSVDPATF	LYSVDPATF
MYLKTVDKF	MYLKTVDKF
YYKQFFDRV	YYKQFFDRV
IYKEDFNEL	IYKEDFNEL
VYTASIPAL	VYTASIPAL
FYVGHIDAF	FYVGHIDAF
SFMHVNTNANF	MHVNTNANF
QHPSNVLHFF	QHPSNVLHF
QYISYIPQIHM	QYISYIPQI
IYSPHTGIQEY	IYSP-HTGI
RYAVVLNATW	RYAVLNATW
IYTRLEMYNI	IYTREMYNI
PYYTGMPSAF	YYTGMPSAF
VYPSSLSKI	VYPSSLSKI
VFIGNLNTLVV	VFIGNLNTL
VFAPTNEAF	VFAPTNEAF
RYNPNLNTW	RYNPNLNTW
NYNAVFNLL	NYNAVFNLL
QYYGYLWSEVF	YYGYWSEVF
YVIQKFFEF	YVIQKFFEF
IFQDVLLQF	IFQDVLLQF
AYMKSLLSL	AYMKSLLSL
IYELRTYKL	IYELRTYKL
VYINLANLI	VYINLANLI
KYPNVFKKI	KYPNVFKKI
TVTPVSPSF	TVTPVSPSF
SYLFQQDKF	SYLFQQDKF
AYLKEVEQL	AYLKEVEQL
RYTVQFTTM	RYTVQFTTM
KYFSFPGELLM	KYFSPGELL
VYQNIFTAM	VYQNIFTAM
TYNYPVHYF	TYNYPVHYF
VYVIEPHSMEF	VYVIEPHSM
GYLTNPRSL	GYLTNPRSL
RYVEQKAGITF	RYVEQKAGI
SWSPDSTHLL	SWSPSTHLL
VYKEHFQDDVF	VYKEHFQDD
NFISPNITVHL	ISPNITVHL
IYSYGFATI	IYSYGFATI
YIDFPGGILSF	DFPGGILSF
FHNDLALVQLW	FHNDALVQL
PYGPPLPSL	PYGPPLPSL
KFSPNTSQFLL	KFSPNTSQF
TYVKEIEVW	TYVKEIEVW
VYVPVPKQTI	VYVPPKQTI
SYISDGKEYLF	SYISGKEYL
EYQIFKAIF	EYQIFKAIF
SYPTFFPRFEF	SYPTFFPRF
RYLDLLTTW	RYLDLLTTW
LWPAVQLANF	LWPAQLANF
AYPPAPFMHI	AYPPPFMHI
NYVDLVSSL	NYVDLVSSL
QYLGQIQHI	QYLGQIQHI
TFQDFSHIF	TFQDFSHIF
FSEDDYTALI	FSEDYTALI
QYAHLEWLL	QYAHLEWLL
SFFENPILSF	SFFEPILSF
AYIDYLSHL	AYIDYLSHL
RFMDGHITF	RFMDGHITF
SYEEVLHLL	SYEEVLHLL
NYLGGTSTI	NYLGGTSTI
LYFHINQTL	LYFHINQTL
VYAHFPINV	VYAHFPINV
FYQILIYDF	FYQILIYDF
FYMHAGSLLL	FYMHAGSLL
LYQDGVFKF	LYQDGVFKF
IYFPEGSGVKI	YFPESGVKI
TQMPDPKTF	TQMPDPKTF
EYIAAFLSHF	EYIAFLSHF
YFFSDGIRL	YFFSDGIRL
DLYPLVLGF	DLYPLVLGF
VYLPTNVGL	VYLPTNVGL
PWAFPAREF	PWAFPAREF
QYLTTKEQF	QYLTTKEQF
LYPHIDKQYL	LYPHDKQYL
SYNDYVREF	SYNDYVREF
VLPFEPVPVI	VLPFPVPVI
TYLERHMSEF	TYLEHMSEF
AYARIGNSY	AYARIGNSY
LYSTAMESI	LYSTAMESI
VYQQTSHMM	VYQQTSHMM
AMTDIITLF	AMTDIITLF
AYKIKYPENFF	AYKIYPENF
KYFLWEEKF	KYFLWEEKF
LYPDGVFYDL	LYPDVFYDL
IYLRDSTEFF	IYLRDSTEF
VYSETVDLIKF	VYSETVDLI
DYSKDYNHW	DYSKDYNHW
VSAAGLVQGL	SAAGLVQGL
ILDRVADGMVF	RVAD-GMVF
RFIPYTEEF	RFIPYTEEF
SYYGPLNLL	SYYGPLNLL
VMPFISAGF	VMPFISAGF
KYLTQVDILL	KYLTQVDIL
YFSQFGTVTRF	SQFGTVTRF
SYMWTINNFS	SYMWTINNF
KQVPNESFFNF	VPNESFFNF
IMPEKFEFW	IMPEKFEFW
VYLPKIPSW	VYLPKIPSW
SYMEVPTYL	SYMEVPTYL
NYLHLDYNF	NYLHLDYNF
QYFSSGKYYW	YFSSGKYYW
TYGDLNHLV	TYGDLNHLV
AYIPKLLQL	AYIPKLLQL
YYQTPRLWLF	YYQTRLWLF
RYLESGVVL	RYLESGVVL
SYIPLFPQL	SYIPLFPQL
SYLEKVVTL	SYLEKVVTL
AYVPGFAHI	AYVPGFAHI
LSPRELTAL	LSPRELTAL
RATHVTDFF	RATHVTDFF
TYEEVFYFV	TYEEVFYFV
EYMKVQTEI	EYMKVQTEI
TTYPNTYIF	TTYPNTYIF
AYAQEIQKL	AYAQEIQKL
RGNPTVEVDLF	NPTVEVDLF
YYNTETKQSTW	YYNTETKQS
RYVELAWGF	RYVELAWGF
RWLEAEWIF	RWLEAEWIF
YLPPLFWRF	YLPPLFWRF
GYKPDFVGF	GYKPDFVGF
IYSTLLQNNI	IYSTLQNNI
EYPDRIINTF	EYPDIINTF
NYNFDFRSW	NYNFDFRSW
RYVLYPNNF	RYVLYPNNF
KYISPETMVAL	KYIS-PETM
SYYSPSIGF	SYYSPSIGF
NYTDRIQVL	NYTDRIQVL
NYTDQWERW	NYTDQWERW
IYTDQAGQWRI	IYTDQAGQW
TVSGVYPLF	TVSGVYPLF
AYLALFLKL	AYLALFLKL
SYVDSALKPLF	SYVDALKPL
IYADKDVFHMV	IYAD-KDVF
SYTPVGLIQNL	SYTP-VGLI
YYMTPRDFLF	YYMTRDFLF
SYIPIFPQL	SYIPIFPQL
IYIDRGVVF	IYIDRGVVF
RYPNLDFGW	RYPNLDFGW
LYDIVFKHF	LYDIVFKHF
RYLSKVLEL	RYLSKVLEL
DYLHMVHRL	DYLHMVHRL
AYPEYLITF	AYPEYLITF
RPPGFSPFR	RPPGFSPFR
IYPLLGATL	IYPLLGATL
RYGSDFYSM	RYGSDFYSM
EFEKLSDFF	EFEKLSDFF
LYQDQLQKW	LYQDQLQKW
AYNRIVDAL	AYNRIVDAL
AYGRSPMVSF	AYGRPMVSF
LMASLSDFKF	LMASSDFKF
TYPLIFASI	TYPLIFASI
LYPNIDKDHAF	LYPNKDHAF
LYPPETGLF	LYPPETGLF
IFFGGLVFKF	IFFGLVFKF
GYTPDWIFL	GYTPDWIFL
VYPGIAVFF	VYPGIAVFF
SYSPPQSFGFF	SYSPQSFGF
TYAKQYEEF	TYAKQYEEF
FYNPFQFEI	FYNPFQFEI
IFLPILRTGF	IFLPLRTGF
MYTAVGSEW	MYTAVGSEW
PWVEQEGPEYW	VEQEGPEYW
QYISYIPQI	QYISYIPQI
SYLDQVKLQF	SYLDVKLQF
VYLDGHLITTV	VYLD-GHLI
AYLEAIHNF	AYLEAIHNF
FYPEEISSMVL	FYPEEISSM
SFNPLTSLLQW	SFNPLTSLL
FYVVAESFKF	FYVVESFKF
RFGQDFSTF	RFGQDFSTF
QYFPKAPEF	QYFPKAPEF
LPYFWEHF	LPYF-WEHF
EYQDLLNVKM	EYQDLNVKM
YYNTAVKL	YYNT-AVKL
FYQDTFGQQW	FYQDFGQQW
AYPHNLMTF	AYPHNLMTF
YYGQGFPSF	YYGQGFPSF
RFLEQQNKILL	RFLEQQNKI
RYKATGLHF	RYKATGLHF
TYAEKLHRL	TYAEKLHRL
RREYIAAF	RREY-IAAF
AFSQKSHLI	AFSQKSHLI
PYLVVIHTL	PYLVVIHTL
YYQETLQQL	YYQETLQQL
AYSEAIFEL	AYSEAIFEL
IYVHDLLTF	IYVHDLLTF
RYTPLKENW	RYTPLKENW
VYAVVRGLF	VYAVVRGLF
AYVELVHHI	AYVELVHHI
HFIEIHHHL	HFIEIHHHL
PYQCPECGKSF	QCPECGKSF
VYFGHWVVM	VYFGHWVVM
AYGHFGRDSF	AYGHGRDSF
AYMPHTFFIG	AYMPHTFFI
TYRNVMEQF	TYRNVMEQF
VFLFNTENKLL	LFNTENKLL
FFSEVERRF	FFSEVERRF
VYSIRLAYL	VYSIRLAYL
AFIQKSNLI	AFIQKSNLI
IYLLIHNNF	IYLLIHNNF
YLDLYLIHW	YLDLYLIHW
VYTDRFHLIL	VYTDRFHLI
VYYGHTNYI	VYYGHTNYI
LYLPKSWTI	LYLPKSWTI
LYSILDEVIF	LYSILDEVI
ILQKEVYLF	ILQKEVYLF
VWEITGAEF	VWEITGAEF
LYPKIIQDI	LYPKIIQDI
EYFDQHFGPFF	EYFDHFGPF
RLPAWQPIL	RLPAWQPIL
YYLSKIEEL	YYLSKIEEL
YFIAPTGHSL	YFIATGHSL
RYGGSFAEL	RYGGSFAEL
IYWDGPLAL	IYWDGPLAL
VGVTITDPF	VGVTITDPF
ILSPLLLLF	ILSPLLLLF
SYADQMFL	SYAD-QMFL
QYTPHSHQF	QYTPHSHQF
VAPVTHVSV	VAPVTHVSV
PYEKGFALL	PYEKGFALL
PYSPRFLEVF	PYSPFLEVF
TYIGNIGRF	TYIGNIGRF
MYIVGQYPRF	MYIVQYPRF
TYTNAFAFTQF	TYTN-AFAF
PFFNPIQTQVF	FFNPQTQVF
RYAEEVGIFF	RYAEVGIFF
GLSPPVAIFF	LSPPVAIFF
VFNPYTEFKEF	PYTE-FKEF
FLFNTENKLLL	LFNTNKLLL
EFMPQGAVF	EFMPQGAVF
FYGNKTSVQF	FYGNTSVQF
KWSSTFHNF	KWSSTFHNF
SYIALPLTL	SYIALPLTL
VVADVLAKF	VVADVLAKF
VYPAGSQVMMI	VYPAGSQVM
FYPAEITLTCS	FYPA-EITL
LYITLPLAL	LYITLPLAL
DYIPQLAKF	DYIPQLAKF
VAAGSYQRF	VAAGSYQRF
FYPYGLQTF	FYPYGLQTF
TFSDVTFKL	TFSDVTFKL
FYPPHPNYTW	FYPPPNYTW
QMPVILTPLHF	PVILTPLHF
TMSALILT	TMSA-LILT
SAPYGRITL	SAPYGRITL
IYEETRGVL	IYEETRGVL
KYAVLYQPLF	KYAVYQPLF
EYIAKQFGF	EYIAKQFGF
NYIPRFWTF	NYIPRFWTF
ELPLTGSTF	ELPLTGSTF
YYPPSQIAQL	YYPPQIAQL
IYHNPTANSF	IYHNTANSF
YYTDFLITL	YYTDFLITL
SFFTGGPLW	SFFTGGPLW
KYDVLFALF	KYDVLFALF
MYTVFEHTF	MYTVFEHTF
EYQIKTNQL	EYQIKTNQL
GPGSAGWQQEF	GSAGWQQEF
KYIETTPLTI	KYIETPLTI
RYTERVDYL	RYTERVDYL
RYFDVGLHNFL	RYFDGLHNF
LPISTPHPIGF	ISTPHPIGF
SYHPFENMVAF	SYHP-FENM
FYPYPQYFTQL	PYPQYFTQL
RYSAGWDAKFF	RYSAWDAKF
VLPPPAGYVPI	VLPPPAGYV
IYMDTLNIFM	IYMDTLNIF
KYGDFKLLEF	KYGDKLLEF
NYQRLFDFF	NYQRLFDFF
IYPSIFHVL	IYPSIFHVL
KYNDFGNSF	KYNDFGNSF
SFVNKQPTL	SFVNKQPTL
SYLLIHQRI	SYLLIHQRI
TFGYGARLF	TFGYGARLF
AQGPTPRYF	AQGPTPRYF
VYNENLVHM	VYNENLVHM
TFLTAFCLPSF	FLTACLPSF
SYVWRTYHL	SYVWRTYHL
QYMEEIYHRI	QYMEIYHRI
IIHEIAVLEL	IIHEAVLEL
IYPSPTGVLI	IYPSTGVLI
TFLDDSGSLNW	TFLDDSGSL
RYMNHMQSL	RYMNHMQSL
RYPHLLEQL	RYPHLLEQL
QLPDWRLVF	QLPDWRLVF
GYYGQGFPTF	YYGQGFPTF
VTLSSIPVF	VTLSSIPVF
RYYPSGDAF	RYYPSGDAF
PYQPNVPVGI	PYQPVPVGI
YYSLIKMVF	YYSLIKMVF
VYPSGMPAL	VYPSGMPAL
LFLPYSHFL	LFLPYSHFL
AYLPVNESF	AYLPVNESF
FYSQPDHLF	FYSQPDHLF
VVPEPGQPL	VVPEPGQPL
RYYEDSRLIW	RYYEDSRLI
SYFEKGPLTF	SYFEGPLTF
NYPDVLTRPSL	NYPDTRPSL
IYQLPDWRLVF	IYQLPDWRL
RYNLSPSIFF	RYNLSPSIF
FYLDPQTASRF	YLDPTASRF
LYKDVRDLL	LYKDVRDLL
VYTDILIGL	VYTDILIGL
QYSPLLAAF	QYSPLLAAF
TYERGTYYF	TYERGTYYF
SYVAGLPRF	SYVAGLPRF
SGLAMWFHF	SGLAMWFHF
VLPPSVPFF	VLPPSVPFF
MSNKYPQAVF	KYPQ--AVF
SFTPAMGSIF	SFTPMGSIF
RFEELNADLF	RFEENADLF
LYIADWMVHW	LYIAWMVHW
SYNNFFRMF	SYNNFFRMF
VFKNDQDTW	VFKNDQDTW
TYSPFGDSPL	TYSPGDSPL
KYTEITATYF	KYTETATYF
PYQATIDGVRF	YQATDGVRF
KYLEESTIRHF	KYLE-ESTI
QYQFPPPLI	QYQFPPPLI
SFYVNGLTL	SFYVNGLTL
AKADGIVSKNF	KADGVSKNF
EYQKVGQSF	EYQKVGQSF
RYVKKLGDF	RYVKKLGDF
TFESSHYLL	TFESSHYLL
AYIDRLLHL	AYIDRLLHL
NLPIGFLEL	NLPIGFLEL
TYAPVKSFL	TYAPVKSFL
AYLLPAIVHI	AYLLAIVHI
VYTSGIYNI	VYTSGIYNI
NYSGAAEYLYF	NYSGAAEYL
PFWMAPEVI	PFWMAPEVI
IYPHGLVLLDL	IYPHGLVLL
VFTTQELVQAF	TTQELVQAF
VYIDFPGGI	VYIDFPGGI
AYSPAIQMF	AYSPAIQMF
TYVHSSATI	TYVHSSATI
LLPPFPPGMF	LLPPPPGMF
PYKAYPSQL	PYKAYPSQL
HYVGSAAAF	HYVGSAAAF
QYMERLQLL	QYMERLQLL
TFIVGDQISF	TFIVDQISF
AYMEDAPLL	AYMEDAPLL
FYGWTPVHW	FYGWTPVHW
RYALIMHKL	RYALIMHKL
KYIENLDNITF	KYIENLDNI
VYLTIKPLNL	VYLTKPLNL
SYTSVLSRL	SYTSVLSRL
SYIDLLQRF	SYIDLLQRF
ALSSVYLLL	ALSSVYLLL
AYQKQPTIF	AYQKQPTIF
NTANGFPVF	NTANGFPVF
SYIELPAYL	SYIELPAYL
YFLREGNQI	YFLREGNQI
TYLEVINTV	TYLEVINTV
NYITPNPIFF	NYITNPIFF
PYLWWKKYI	PYLWWKKYI
GYLPLGFEF	GYLPLGFEF
KYVPYSESF	KYVPYSESF
VFMPHGLGHFL	VFMPGLGHF
TYGGSWKF	TYGG-SWKF
ITSPYLITL	ITSPYLITL
VYQAAALSKAF	VYQAALSKA
LSTYLVTII	LSTYLVTII
IYSDTQFPSL	IYSDQFPSL
LYPAAQLQHLW	LYPAQLQHL
LYIQTDHLFF	LYIQTDHLF
KYPLNLYLL	KYPLNLYLL
LYTYPENWRAF	TYPENWRAF
KYEGHQQFF	KYEGHQQFF
FPGEAERVAF	FPGEERVAF
KYSEIQQLL	KYSEIQQLL
SYLEPTSVTNF	SYLESVTNF
GWYDEEHPLVF	WYDEHPLVF
TYPENWRAF	TYPENWRAF
AYADYIGFIL	AYADIGFIL
LYKPTFSQL	LYKPTFSQL
IYVNPANTHQF	IYVNNTHQF
IFTDGSRIVF	IFTDSRIVF
LYLKVKGNVF	LYLKKGNVF
VFTSRSAAF	VFTSRSAAF
TYQHVPVESF	TYQHPVESF
VYTLLTTHL	VYTLLTTHL
PYLDSFYEY	PYLDSFYEY
LYMRIAPEL	LYMRIAPEL
VPFVKYEFI	VPFVKYEFI
FFKELIQEF	FFKELIQEF
TYEELLNRVF	TYEELNRVF
PYEPAVDFF	PYEPAVDFF
KYIEGVSDF	KYIEGVSDF
KFLESTDSF	KFLESTDSF
TYTDRVFFL	TYTDRVFFL
YYVGGDLLTLL	YYVGDLLTL
SYVRSLPFF	SYVRSLPFF
AWGPPSPEL	AWGPPSPEL
VYALVVVSY	VYALVVVSY
SYGIVLYEL	SYGIVLYEL
KYAALYQPLF	KYAAYQPLF
KYPEIKSLM	KYPEIKSLM
YFPPKGYAF	YFPPKGYAF
KFILALKVLF	KFILLKVLF
IYPPINVLPSL	IYPP-INVL
AYDTVRWEF	AYDTVRWEF
RYQTLYARF	RYQTLYARF
EFPPGTPRF	EFPPGTPRF
VFPRLHNVLF	VFPRLHNVL
VYAALQRQLL	VYAAQRQLL
VISEKPLLF	VISEKPLLF
IYLPEADSILF	IYLPEADSI
SWNPNEPWVI	SWNPEPWVI
KYLTEGLLQF	KYLTGLLQF
RYIPSLPDRI	RYIPLPDRI
RYRDRLQYF	RYRDRLQYF
VYTHEVVTL	VYTHEVVTL
VILPVPAFNVI	ILPVAFNVI
RYIHPQQEAF	RYIHQQEAF
NYTDIKDYL	NYTDIKDYL
RYMSINTHL	RYMSINTHL
VYVNKMTGL	VYVNKMTGL
SQFIGYPITLF	QFIGYPITL
EYAKIHDLL	EYAKIHDLL
IYITGSSII	IYITGSSII
KFVDSTFYL	KFVDSTFYL
AYLPPLQQVF	AYLPLQQVF
AFGTGTGLF	AFGTGTGLF
FYSQEVRDLF	FYSQVRDLF
FYADHPFIFLV	FYADHPFIF
YYLKKFIME	YYLKKFIME
LYMKNGQGF	LYMKNGQGF
NYISDPTIL	NYISDPTIL
VWYSPKVFI	VWYSPKVFI
LYMKGGLMNSW	YMKGLMNSW
SYLQRLEVL	SYLQRLEVL
TYLNEGFLSLW	TYLNGFLSL
NWTHLQSLF	NWTHLQSLF
SWASHWVTF	SWASHWVTF
LYQDHMQYI	LYQDHMQYI
VYKVPPFTF	VYKVPPFTF
QYQKVPVLF	QYQKVPVLF
HYSQELSLLYL	HYSQELSLL
RNPPGFAFVEF	NPPGAFVEF
HYATLYFVF	HYATLYFVF
RYFIDSTNL	RYFIDSTNL
IMPPVFTSF	IMPPVFTSF
SYLESFYHM	SYLESFYHM
IYFDLDPTGQF	YFDLPTGQF
IFFPGVSEF	IFFPGVSEF
RYGHLDMVEF	RYGHDMVEF
GYAPKSFHV	GYAPKSFHV
KYLADPSNLF	KYLAPSNLF
VFLRAINKF	VFLRAINKF
FYAHIIPFL	FYAHIIPFL
AYLKFLDQF	AYLKFLDQF
SYMGHFDLL	SYMGHFDLL
PYGPPPTGL	PYGPPPTGL
QYNGNLQDLKV	QYNGNLQDL
SLAEKLYLF	SLAEKLYLF
YYIRFFITY	YYIRFFITY
IYNLKNPTL	IYNLKNPTL
IFSTITSKMNL	IFSTITSKM
TMPTSLPNL	TMPTSLPNL
DYLHLPPEI	DYLHLPPEI
LFPLSELVEF	LFPLELVEF
LYLEPQGTLF	LYLEQGTLF
YYFEEVQRL	YYFEEVQRL
HYVEKPSTF	HYVEKPSTF
LYVIGGNHF	LYVIGGNHF
VFTEVANLF	VFTEVANLF
VFVQGPAWQF	VFVQPAWQF
AYKPPGFSL	AYKPPGFSL
IYMDTLNIF	IYMDTLNIF
RFKEANNFL	RFKEANNFL
VYFRIQDLEMF	VYFR-IQDL
LWGPGLPNF	LWGPGLPNF
DYDKLIVRF	DYDKLIVRF
RWLAQPYYLL	RWLAQPYYL
RYYAFPQMI	RYYAFPQMI
PFYRGERITF	FYRGERITF
EYIDIGALNGI	EYIDIGALN
IYVISAETF	IYVISAETF
YNQKHSLF	YNQK-HSLF
EVLQSTQRF	EVLQSTQRF
IYLDLPQNF	IYLDLPQNF
HYSPIYLSF	HYSPIYLSF
KYLYVDKNF	KYLYVDKNF
RYAKIVEIPF	RYAKVEIPF
FYPLDFTF	FYPL-DFTF
FMILPVGAANF	ILPVGAANF
LYTVVVYDF	LYTVVVYDF
RLPPTPLLL	RLPPTPLLL
AYLTINQLL	AYLTINQLL
SYLEKQVVTF	SYLEQVVTF
KMPKISMPGF	KMPKSMPGF
TYIHALDNGLF	TYIHLDNGL
LYTPEHHLI	LYTPEHHLI
EYLPIGGLAEF	YLPIGLAEF
SWTPFPPDLW	SWTPFPPDL
PFYGVPGVLLF	FYGVGVLLF
KYALELQKL	KYALELQKL
RVAPEEHPVL	VAPEEHPVL
VYVPSHLFHML	VYVP-SHLF
HFIAEHYMF	HFIAEHYMF
KLPEIWETLF	KLPEIWETL
MYLGITPSI	MYLGITPSI
VYTPVDSLVF	VYTPDSLVF
VYDDMAFRYL	VYDDAFRYL
TYIKPISKL	TYIKPISKL
SYLLPGMASF	SYLLGMASF
DYAVVLNQL	DYAVVLNQL
TYWVSKGSAF	YWVSKGSAF
RFLDPRNKISF	RFLDPRNKI
LLPQGRPPVF	LLPQRPPVF
VYGFPVNQLF	VYGFVNQLF
IYQGSSGSYF	IYQGSGSYF
QFAWRHFYW	QFAWRHFYW
IYWTKYYDF	IYWTKYYDF
VYTVVDEMFL	VYTVVDEMF
TYMGHTGAVW	TYMGTGAVW
RYQFIEEAF	RYQFIEEAF
RYIEFHSQSGF	RYIEFHSQS
RQPSLFYHL	RQPSLFYHL
DYVEGLRVF	DYVEGLRVF
KYPGHLAAITL	KYPGHLAAI
VYNEKIHDLL	VYNEKIHDL
YYSKSVGFMQW	YYSK-SVGF
IYPRAPDLF	IYPRAPDLF
YYDDQTRQNI	YYDDTRQNI
KYMEDVTQI	KYMEDVTQI
VYSPLGSAYKL	VYSPLGSAY
SLPEDFYHF	SLPEDFYHF
EFYQDTFGQQW	FYQDFGQQW
DWYDVKAPAMF	WYDVAPAMF
PVIDGPRYTF	VIDGPRYTF
AWYPWWEQQGF	WYPWEQQGF
SYAELIMKL	SYAELIMKL
FYWFDAQQNTW	YWFDQQNTW
SYMGLDQIKPL	SYMG-LDQI
VLDPKDAHVQF	VLDPKDAHV
HYHPIVQRF	HYHPIVQRF
KTYQDIQNTI	TYQDIQNTI
VQPPHLFLW	VQPPHLFLW
VYSIINGIVF	VYSINGIVF
RFLPSPVVI	RFLPSPVVI
VYPTLMEPVLL	VYPTMEPVL
VYNIHLAVNF	VYNILAVNF
MAPERVASL	MAPERVASL
AISGPFNVQF	ISGPFNVQF
EYPRETFSF	EYPRETFSF
AYQDRLAYL	AYQDRLAYL
PYTFVSKEGF	PYTFSKEGF
RYLERLIKL	RYLERLIKL
VYEKFHPSI	VYEKFHPSI
YLPPSTPDF	YLPPSTPDF
SLADAINTEF	SLADINTEF
VLPNTALHL	VLPNTALHL
PLVLFGFINF	LVLFGFINF
ILPVPAFNVI	ILPVAFNVI
KWMPGITQW	KWMPGITQW
YVRDLRSIV	YVRDLRSIV
VYPWTQRFFE	VYPWTQRFF
LYVEKVLEF	LYVEKVLEF
HFHPSVALF	HFHPSVALF
RYNSQLLSF	RYNSQLLSF
PYFEVLEKW	PYFEVLEKW
PYKPGQTVF	PYKPGQTVF
KYNDTFWKEF	KYNDFWKEF
MYMGEEHLF	MYMGEEHLF
TWLVNSAAHLF	LVNSAAHLF
YYNKVSTVF	YYNKVSTVF
PSAQEHLASL	SAQEHLASL
VYVQNVVKL	VYVQNVVKL
IYEIIDNSQGF	EIIDNSQGF
VMAPRTLIL	VMAPRTLIL
RYEGILYTI	RYEGILYTI
TYQVVQFNRL	TYQVQFNRL
RYMTDGMLL	RYMTDGMLL
EYISGKVFF	EYISGKVFF
TYKDYVDL	TYKD-YVDL
KYFLWVVKF	KYFLWVVKF
LYDTIFQIF	LYDTIFQIF
QYLDVLHAL	QYLDVLHAL
AFMVNGQKF	AFMVNGQKF
VYMALGKYTM	VYMAGKYTM
KYIPGTKMI	KYIPGTKMI
SYVAFTDTERL	VAFTDTERL
VYKTIMEQF	VYKTIMEQF
KYPENDLFRKL	KYPE-NDLF
KLFIGGLSF	KLFIGGLSF
LYPLTNYTF	LYPLTNYTF
AFSPHSQAYF	AFSPSQAYF
SYGPDWKDF	SYGPDWKDF
NYMEVVSLL	NYMEVVSLL
VYSAGVYRL	VYSAGVYRL
SYKPIFSTL	SYKPIFSTL
NYATRIVTL	NYATRIVTL
DYLDSIYFNRF	DYLD-SIYF
RFTDEESRVF	RFTDESRVF
VYFLPITPHYV	VYFLITPHY
SVANSIHSLF	VANSIHSLF
KFKTPELAEEF	KTPELAEEF
LYIDFGGKF	LYIDFGGKF
SYIAHLRQI	SYIAHLRQI
YYDSFVRWQF	YYDSVRWQF
KYLPALDEF	KYLPALDEF
TYLDQVKIRF	TYLDVKIRF
ILRPGMVVTF	ILRPMVVTF
MYGNIIRGW	MYGNIIRGW
IYDKFIAQL	IYDKFIAQL
YFIQDDGSRF	YFIQDGSRF
EYMKHTRLF	EYMKHTRLF
RYAVFNEDGSL	VFNE-DGSL
IPEPEAAVLF	PEPEAAVLF
TWYHTPNVVFI	YHTPNVVFI
TYLRDQHFL	TYLRDQHFL
KYVTDVGVL	KYVTDVGVL
AFIEKHWTF	AFIEKHWTF
SWPPAPPLTL	SWPPPPLTL
VYGSGSSGF	VYGSGSSGF
KYHTHLLQF	KYHTHLLQF
VFVFPTELIF	VFVFPTELI
VMPNYPFINI	VMPNPFINI
IYMPYAQWL	IYMPYAQWL
GMDVAASEFF	GMDVAASEF
GYFDEEMNRVL	YFDEMNRVL
YYLTPDGQRF	YYLTDGQRF
PYFQQTGVRGF	YFQQGVRGF
IYGLLKNPF	IYGLLKNPF
KYQILNNEVF	KYQINNEVF
KYIATDFTL	KYIATDFTL
VYPASPSSWLI	VYPASPSSW
YYLTHGLYL	YYLTHGLYL
KYNETFQFI	KYNETFQFI
NYYEVHKELF	YYEVHKELF
AWFPKITEDF	AWFPITEDF
IFHEVPLKF	IFHEVPLKF
PFIKSQHELLF	PFIKSQHEL
VYNSWKNNKF	VYNSKNNKF
AYLQNLFSL	AYLQNLFSL
IYNALIEFI	IYNALIEFI
VYIIDYAREF	VYIIYAREF
SYVNLPTIAL	SYVNPTIAL
RYNHITATYF	RYNHTATYF
LLIENVASL	LLIENVASL
SYISKEHFGTF	SYIS-KEHF
RYGLVTNEI	RYGLVTNEI
RYLIKLLLL	RYLIKLLLL
DWPQENIAGVF	PQENIAGVF
QYGIFPDNFTF	QYGIFPDNF
AYSEALAAF	AYSEALAAF
PFLKPDDIQYF	FLKPDIQYF
KYLNENQLSQL	YLNEQLSQL
VYPGDPLRF	VYPGDPLRF
IHPSLLPSF	IHPSLLPSF
YSTTPGGTLF	STTPGGTLF
VYQPVRYYYV	VYQPVRYYY
EFLTKTAKF	EFLTKTAKF
LYTPSNEHF	LYTPSNEHF
RYPNSHTHYF	RYPNHTHYF
KYMTPMQQKL	KYMTMQQKL
EYIGRSVHYW	EYIGSVHYW
IFTDLYYLTF	IFTDYYLTF
ERSSFSSFDF	RSSFSSFDF
VNPTVFFDI	VNPTVFFDI
FFDPNTHENL	FFDPTHENL
TLPEEVGHLSF	TLPEEVGHL
KFMGVQMETF	KFMGQMETF
RYFILPYVI	RYFILPYVI
MYEPGSALKPF	MYEP-GSAL
RLADPVFIGF	RLADVFIGF
VYNPTPNSL	VYNPTPNSL
EYSIVIQQL	EYSIVIQQL
AYNDKIVAF	AYNDKIVAF
EYLTAEVLEL	EYLTEVLEL
QIGTVSPLF	QIGTVSPLF
IFSQKLGYLLF	IFSQLGYLL
TYGEIFEKF	TYGEIFEKF
IYDEVVKLL	IYDEVVKLL
QYLMDNPTF	QYLMDNPTF
FYPIYFRPL	FYPIYFRPL
TYLPREILNLI	TYLPEILNL
EYLRMSGIYW	EYLRSGIYW
VYQYGSALAHF	QYGSALAHF
SYIPLFPQLY	SYIPLFPQL
PYLGPVSPSL	PYLGVSPSL
MYSPIPPSL	MYSPIPPSL
IIMPPVFTSF	IMPPVFTSF
SWLPTTPPTI	SWLPTPPTI
VVPPISLSTTF	VPPILSTTF
SYYGPLNLLT	SYYGPLNLL
KYDDNVKAYF	KYDDVKAYF
YWPDVIHSF	YWPDVIHSF
KYIDYIFNV	KYIDYIFNV
TYNSSGAYRF	TYNSGAYRF
TYITSKPIVF	TYITKPIVF
IYDPNLAFLR	IYDPNLAFL
YYASIAKAF	YYASIAKAF
QYDGIFYEF	QYDGIFYEF
RYNGGLLEF	RYNGGLLEF
KYVPVSAAAIF	KYVPSAAAI
KYVAVMPPHI	KYVAMPPHI
SYDTITVHW	SYDTITVHW
MLPSILNQL	MLPSILNQL
IYTRLLPAL	IYTRLLPAL
LFHSGGKFIL	LFHSGGKFI
RYGINTTDIF	RYGITTDIF
VYSDLHAFYY	VYSD-LHAF
PYVDAEQKNLF	PYVDEQKNL
IIMNDYPKF	IIMNDYPKF
LYSDLADLML	LYSDLADLM
YLTPEEMVTF	YLTPEMVTF
FYYLPEMFVNF	YYLPMFVNF
RFLNAENAQKF	FLNANAQKF
VMSATFAKF	VMSATFAKF
AYAQKIFKIL	AYAQKIFKI
IYSVLGARETF	SVLGARETF
IYPVNAISF	IYPVNAISF
EYFAPDFTL	EYFAPDFTL
NYADQISRL	NYADQISRL
VYSADREDLY	VYSADREDL
LYYLQHPPISF	YYLQPPISF
VYFQARLYHTL	YFQALYHTL
EYMPIKLKI	EYMPIKLKI
LFPPPTPIF	LFPPPTPIF
RYGSAIGVLAF	RYGSAIGVL
LYIGSSKTF	LYIGSSKTF
HYPPVQVLF	HYPPVQVLF
IYQRWKDLL	IYQRWKDLL
IFITEKHGNYF	FITEHGNYF
FYLENLEQM	FYLENLEQM
SYAPPTDSFL	SYAPPTDSF
AYTPVLNQF	AYTPVLNQF
IYDHNPKVF	IYDHNPKVF
KYTNLVTGW	KYTNLVTGW
IIYAGEKAQF	IYAGEKAQF
SLPESVPLF	SLPESVPLF
GYIKGIFGF	GYIKGIFGF
RFAHGTAGLVF	RFAHGTAGL
TYTDLLSVI	TYTDLLSVI
AYMQEPLFVEF	YMQELFVEF
GFPVSDWLF	GFPVSDWLF
FYVPDMKPSMF	FYVPMKPSM
QYLKVEQLF	QYLKVEQLF
VYFEYEEKI	VYFEYEEKI
AYTPQTHTSF	AYTPTHTSF
RYLENGKETL	RYLEGKETL
AWARLDHKF	AWARLDHKF
RWLKDSSLLTL	RWLKDSSLL
VYPQKAYYY	VYPQKAYYY
SYYSSPFAFF	YYSSPFAFF
VYSPALTDFTF	VYSPALTDF
TYQTIIELF	TYQTIIELF
TYVIYAHLL	TYVIYAHLL
PIRLLAAAA	PIRLLAAAA
QFIGYPITL	QFIGYPITL
AYIGFIQSL	AYIGFIQSL
DWGAWQKF	DWGA-WQKF
TYGVSFFLV	TYGVSFFLV
QYSQHFAFI	QYSQHFAFI
IYPGAFVDL	IYPGAFVDL
IYSEVATLI	IYSEVATLI
EYNSALPLL	EYNSALPLL
KYLGLLENL	KYLGLLENL
NYPTKFQYL	NYPTKFQYL
VWDTAGQERF	VWDTGQERF
VYIKHPVSLE	VYIKHPVSL
SYQEMIANL	SYQEMIANL
RFVNVVPTF	RFVNVVPTF
QFMVESFKF	QFMVESFKF
VYNAVANLW	VYNAVANLW
RYPPKSGNYF	RYPPSGNYF
PFKSPSIGF	PFKSPSIGF
PYEAGTYSL	PYEAGTYSL
PYRPIPVTW	PYRPIPVTW
IFSPTSNLL	IFSPTSNLL
LYANMFERL	LYANMFERL
SFISNAVAPFF	SFISAVAPF
IYVADTENHLI	IYVATENHL
SYPELVKMVW	SYPEVKMVW
YYLEVGKTLI	YYLEVGKTL
SYRIIYNLF	SYRIIYNLF
IFLTDTAKQI	IFLTTAKQI
YILEPFFI	YILE-PFFI
TYGKIDLGF	TYGKIDLGF
IYNGKLFDL	IYNGKLFDL
TYKQVVDLI	TYKQVVDLI
RYLLKFEQI	RYLLKFEQI
FFLIGPPLLI	FFLIGPPLL
DYLQEVPIL	DYLQEVPIL
FYLGGPTSI	FYLGGPTSI
LYVMVNAKF	LYVMVNAKF
LQPERYELW	LQPERYELW
SYKPPGNFPFI	SYKPGNFPF
EYLFDSFFSLI	EYLFSFFSL
SFISVGNKF	SFISVGNKF
HYIDAGYLGF	HYIDGYLGF
RFIDAVYKL	RFIDAVYKL
FYPEEISSMV	FYPEEISSM
LYPAAIVTI	LYPAAIVTI
FYLEFKPLL	FYLEFKPLL
VVPDQLMAF	VVPDQLMAF
VMPNGPPSF	VMPNGPPSF
IYRGPFADENF	RGPFADENF
VYKGLDTETW	VYKGDTETW
FPIEACVTML	FPIECVTML
DYILNVMKF	DYILNVMKF
NYSPVSRIGLF	NYSPSRIGL
QFHPDGLIF	QFHPDGLIF
EYTSILHLF	EYTSILHLF
PWGVDSLITL	PWGVSLITL
QYSRFSLENNF	RFSL-ENNF
YFHEEDESSF	YFHEDESSF
VYAAQPHVI	VYAAQPHVI
KWLEPLKNLRF	KWLEPLKNL
YSKQMQRF	YSKQ-MQRF
KYGRIVEVL	KYGRIVEVL
PFVPHIPFDF	PFVPIPFDF
VFIADFPGL	VFIADFPGL
KYPLLLREI	KYPLLLREI
EYMLQNHVF	EYMLQNHVF
IFTPKPTLF	IFTPKPTLF
KYIDQKFVLQL	KYIDQKFVL
KYKKTTPEYVF	KYKKTTPEY
LYQHAVEYF	LYQHAVEYF
LYIVHPTMF	LYIVHPTMF
KYLHPPTHL	KYLHPPTHL
VFPDDMPTL	VFPDDMPTL
TFLPFIHTI	TFLPFIHTI
AYYPPSQIAQL	YYPPQIAQL
SYSVYVYKVL	SYSVVYKVL
KYHPRVLYI	KYHPRVLYI
IYQRHVYNL	IYQRHVYNL
SIPAFLSSL	SIPAFLSSL
RYIQWVEENF	RYIQVEENF
HFIDENKELF	HFIDNKELF
LYVYPQRLNF	LYVYQRLNF
GWNWGTVKF	GWNWGTVKF
YLWPFWLF	YLWP-FWLF
QYASLMHSFIL	QYASLMHSF
LYSNNITKLL	LYSNNITKL
YYTDIMHTL	YYTDIMHTL
IGVIAYILL	IGVIAYILL
HYAENVSMWIF	HYAENVSMW
YYLSLPPEM	YYLSLPPEM
LYPDRELQSQW	LYPDRELQS
YYGILQEKI	YYGILQEKI
QYSYIDFKF	QYSYIDFKF
YWGTTHDLTF	YWGTHDLTF
YACLKFSEDL	ACLKFSEDL
EWASRFWLW	EWASRFWLW
RVYIHPFHL	RVYIHPFHL
YYVRILSTI	YYVRILSTI
RYPNKLDTITW	RYPNKLDTI
HYFNTPFQL	HYFNTPFQL
FFIDQANYF	FFIDQANYF
YFPELIANF	YFPELIANF
AFMPVLKVVL	AFMPLKVVL
SYSDPPLKF	SYSDPPLKF
PWMQPPPPPM	PWMQPPPPM
IYAGGIKSI	IYAGGIKSI
PLPSSYLIF	PLPSSYLIF
KYLAILGSVTF	YLAIGSVTF
SFLELLKHLV	SFLELLKHL
IYISTLKTEF	IYISLKTEF
VYTSVQAQY	VYTSVQAQY
VYMLYTELF	VYMLYTELF
KYPVPVFSTF	KYPVVFSTF
TLPSRVFHPAF	LPSRFHPAF
IYTHGLALL	IYTHGLALL
PYITEHTGF	PYITEHTGF
ILDPIFKVF	ILDPIFKVF
LYLDKATLIW	LYLDKATLI
PLAHSGWLF	PLAHSGWLF
PYSEYFEYF	PYSEYFEYF
VYLPPEAFTF	VYLPEAFTF
VLPALTINPTI	PALTINPTI
MYKLFNGTF	MYKLFNGTF
IYTRLEMYNIL	IYTREMYNI
VFQKVTEVF	VFQKVTEVF
AYMEEEGVFHF	AYMEEEGVF
IYAVATSGMRL	IYAVATSGM
LQPKQFPFL	LQPKQFPFL
IFIQNSKLYF	IFIQSKLYF
IYNGDMEKI	IYNGDMEKI
FYLFPNRLEW	FYLFNRLEW
KYSTLSLF	KYST-LSLF
EYMLEKSFYQF	YMLESFYQF
GFININSLRL	GFINNSLRL
IFLNKTFQW	IFLNKTFQW
AYAKFYTLL	AYAKFYTLL
FYIPKIQDL	FYIPKIQDL
AYAQIDWHDF	AYAQDWHDF
EYHTDTTVKF	EYHTTTVKF
SYPSAFSKL	SYPSAFSKL
VFMDSNGIRQF	VFMD-SNGI
QFGVPQALF	QFGVPQALF
EYRPEFSNF	EYRPEFSNF
RYLDELMKL	RYLDELMKL
TYIPVPAKI	TYIPVPAKI
RYTPAIDVW	RYTPAIDVW
KYIQRQETI	KYIQRQETI
VYPSLPTPLL	VYPSPTPLL
AYQLMTDVF	AYQLMTDVF
QYEPLFHML	QYEPLFHML
SFIESVPLL	SFIESVPLL
YTYPENWRAF	TYPENWRAF
KYADAVKNFL	KYADAVKNF
VFHPRQELI	VFHPRQELI
YYMDYLAAL	YYMDYLAAL
AYTQRILEI	AYTQRILEI
AYKDKDISFF	AYKDKDISF
THAVVTVPAYF	AVVTVPAYF
AYEDFSFPIF	AYEDSFPIF
VLPEHVSVL	VLPEHVSVL
VYISEENFRVM	VYIS-EENF
RWLDETTYEW	RWLDTTYEW
VFMKPGLPTTF	FMKPLPTTF
YPEINFVGLLI	EINFVGLLI
PYQEIKNVI	PYQEIKNVI
LYAVLVHTGF	LYAVVHTGF
YYGLYRDLF	YYGLYRDLF
RYKGPGFEYF	RYKGGFEYF
RYQSGLSTEF	RYQSLSTEF
VGQGDFHLL	VGQGDFHLL
KYPSVKVSVFV	KYPSKVSVF
IYTKMSANGW	IYTKSANGW
IWPPFQPPAW	IWPPQPPAW
IYYDDQTRQNI	YYDDTRQNI
LWGPEEEPHLL	LWGPEEPHL
YFFKPPINQF	FFKPPINQF
KYKPAVNQI	KYKPAVNQI
SYPQEVIPTF	SYPQVIPTF
KYVKILYDF	KYVKILYDF
TFLDMDHTF	TFLDMDHTF
TYLPDFLDYF	TYLPFLDYF
YYIEGIENSVF	YYIEIENSV
KFSPRPLKF	KFSPRPLKF
KYGNFIDKL	KYGNFIDKL
VYVPKEEQLF	VYVPEEQLF
KIIHDFPQF	KIIHDFPQF
ALPQSLPAW	ALPQSLPAW
AYSYPIATL	AYSYPIATL
PYYPSPGVLF	YYPSPGVLF
VFAGVFNTF	VFAGVFNTF
RYVPSTPWFL	RYVPSTPWF
VPMSLSYEEL	PMSLSYEEL
LYIDRPLPYL	LYIDPLPYL
YYMELTKLL	YYMELTKLL
IYLNHIEPLKI	IYLNHIEPL
MFQPILPYVF	MFQPLPYVF
EYIKFLRSI	EYIKFLRSI
YVVESTGVF	YVVESTGVF
YWKEKTSQDNF	KEKTSQDNF
RWTDGLYYL	RWTDGLYYL
QYLLAHSMF	QYLLAHSMF
FWRGGQYENF	FWRGQYENF
VYPDTVALTF	VYPDVALTF
IYLEPWHLDIF	IYLEWHLDI
VYGQPQLM	VYGQ-PQLM
KYPLLISRI	KYPLLISRI
IFNPVSKNF	IFNPVSKNF
RYTPSQQGVAF	RYTPSQQGV
NYGVLHVTF	NYGVLHVTF
RYMLTAGLTAF	YMLTGLTAF
KYFDSGDYNM	KYFDGDYNM
IYIWDLNNF	IYIWDLNNF
VYMAAVLEYL	VYMAVLEYL
LFPGKAFSW	LFPGKAFSW
YYLPNKNQMVF	YYLPNKNQM
SYGEWLHGF	SYGEWLHGF
PYIIHTVLY	PYIIHTVLY
LYPRDSWNF	LYPRDSWNF
EYALWNYLF	EYALWNYLF
SWNPNLSGHLL	SWNPLSGHL
VLPIEGPPSF	VLPIGPPSF
FYMDTSHLFNT	FYMDTSHLF
NYHLNIQRF	NYHLNIQRF
HYNSDLNNLL	HYNSDLNNL
KYGSVAFPNF	KYGSAFPNF
VGLGLHPLF	VGLGLHPLF
VYDPLFSQL	VYDPLFSQL
LMSLIINTF	LMSLIINTF
TYVSGTLRF	TYVSGTLRF
IYRWFNISF	IYRWFNISF
VYSKKVEYL	VYSKKVEYL
VYTRPAISSF	VYTRAISSF
KYLEEIATQM	KYLEIATQM
RYKAPFHQL	RYKAPFHQL
IYNNMKQFI	IYNNMKQFI
TFPSLLLVF	TFPSLLLVF
SHSAHFFEF	SHSAHFFEF
LYVPALSALW	LYVPALSAL
EYLTKWPKF	EYLTKWPKF
MFLTDSNNI	MFLTDSNNI
HAPFTATSL	HAPFTATSL
RYSDIGTLAW	RYSDGTLAW
YQCLFSAHVL	QCLFSAHVL
KYVKVFHKF	KYVKVFHKF
MYPGLQVYTF	MYPGQVYTF
FYISPVNKL	FYISPVNKL
FYQRVGQQL	FYQRVGQQL
MYPRLGGFVM	MYPRGGFVM
RYPDRITLI	RYPDRITLI
FIEEGTFLF	FIEEGTFLF
AYAIIKEEL	AYAIIKEEL
VFVSPGATYF	VFVSGATYF
VYIIGSSGF	VYIIGSSGF
YYFRPGHLL	YYFRPGHLL
TYNPNMPFKW	TYNPMPFKW
QWMSKVVTF	QWMSKVVTF
VDVEPKVKS	VDVEPKVKS
ATAPVVALF	ATAPVVALF
IFSEVGPVVSF	IFSEVGPVV
KYGSVIQLL	KYGSVIQLL
LYLDTMQVMKW	LYLDTMQVM
HYSHYISTF	HYSHYISTF
GWNEGRPYLF	GWNERPYLF
NYSPYVNYF	NYSPYVNYF
VYFSAAHAL	VYFSAAHAL
VYKPAQNSW	VYKPAQNSW
KYDPSIGIYGL	KYDPSIGIY
SWLEYESSF	SWLEYESSF
SYIPIFPQLY	SYIPIFPQL
PYSSIDQLL	PYSSIDQLL
KYQPRVHII	KYQPRVHII
KYNIYSPLLF	KYNIYSPLL
VYVPTGFSAF	VYVPGFSAF
DYIDTIWKI	DYIDTIWKI
TYGWTANM	TYGW-TANM
EYTAKIALL	EYTAKIALL
KYMYGVNAW	KYMYGVNAW
GYNVKFDMF	GYNVKFDMF
VFLPRVTELAL	VFLPRVTEL
MYGPPALRF	MYGPPALRF
TYTNAFAF	TYTN-AFAF
TYLSQFPKA	TYLSQFPKA
VWLPYLYTL	VWLPYLYTL
KYQAVTATL	KYQAVTATL
PYQNGFTFHTW	PYQN-GFTF
SYLPHAPPF	SYLPHAPPF
KYAPGSLHYF	KYAPSLHYF
PYQPAPPSGYF	PYQPPPSGY
NYIKSLSSF	NYIKSLSSF
IYSPDHSSNNF	YSPDSSNNF
IYSTDLHKL	IYSTDLHKL
KFLDKYMPQF	KFLDYMPQF
KIKYPENFFLL	KYPENFFLL
NFGGGGGNF	NFGGGGGNF
IYIKDYVTL	IYIKDYVTL
ITAKEYWMF	ITAKEYWMF
RYIQPWESEF	RYIQWESEF
PFWNEEIVPQI	FWNEIVPQI
ALGEPITLF	ALGEPITLF
TYFPTWEGLFW	TYFPTWEGL
YPSPFFVF	YPSP-FFVF
GWDPNEMFKF	GWDPEMFKF
FSQFGPIERA	SQFGPIERA
RYLPTGSFPFL	RYLPGSFPF
VYGQITVRM	VYGQITVRM
ELAKVINDGLF	ELAKINDGL
YYKNIGLGF	YYKNIGLGF
SYPQIQNNL	SYPQIQNNL
TYFPTWEGLF	TYFPTWEGL
IYTTSNHI	IYTT-SNHI
IFSEVGSVVSF	IFSEVGSVV
SYQFILNLF	SYQFILNLF
AYNNQSNRL	AYNNQSNRL
DRVYIHPFHL	VYIH-PFHL
VYHNLKNVI	VYHNLKNVI
AYNPLAGGLL	AYNPAGGLL
RYPVGRFPSL	RYPVRFPSL
SYIQRLVQI	SYIQRLVQI
AWRPPPFDTL	AWRPPFDTL
YYPAQGVQQF	YYPAGVQQF
YYRIFTWRF	YYRIFTWRF
LYGAPGVEF	LYGAPGVEF
PYSPAAGVDF	PYSPAGVDF
LYIQSHYQL	LYIQSHYQL
AYIADHLGF	AYIADHLGF
VFKEINTQI	VFKEINTQI
VYFPALTSLL	VYFPALTSL
IYTPIFNEYI	IYTPIFNEY
IYDPVHFKTF	IYDPHFKTF
IYTPYEYPYTL	IYTPYPYTL
AYNDNWFITF	AYNDWFITF
QYPFPLPVFDM	QYPFPLPVF
FHETLYQKADD	LYQK-----
PLPTSFPTL	PLPTSFPTL
RWSPVRPLVF	RWSPRPLVF
AYTSELQKL	AYTSELQKL
IWWEPTGHTFF	IWWETGHTF
EYLGSMAKI	EYLGSMAKI
DYADSIHAIF	DYADSIHAI
AYLPVNESFGF	AYLPVNESF
KYMDINFDF	KYMDINFDF
IYTDITYSF	IYTDITYSF
RYVDQVLQL	RYVDQVLQL
AWPLSTLPVF	AWPLTLPVF
YFQNTQGLIF	YFQNQGLIF
VYKSPASDTYI	VYKSASDTY
LYRQYFEEI	LYRQYFEEI
NVPTEGFQF	NVPTEGFQF
EYYDKAFDRI	YYDKAFDRI
NFLHPINTIF	NFLHPINTI
WSFVPSTRIL	SFVPSTRIL
AMYPDVFAHF	MYPDVFAHF
IYAGVGEFSF	IYAGGEFSF
YYSHLEGARF	YYSHEGARF
KLPESENLQEF	KLPE-SENL
FIDLNYMVYMF	DLNYMVYMF
EYLKNVLLQF	EYLKVLLQF
TFAEIVTPF	TFAEIVTPF
RYAEALEQHW	RYAELEQHW
RYAAQLPALF	RYAALPALF
QYEEQFVTL	QYEEQFVTL
TVLDPDLRMTF	VLDPLRMTF
AYVTLAAHF	AYVTLAAHF
IYLTADNLVL	IYLTDNLVL
LFQRTAWVF	LFQRTAWVF
MPQYPFPLPVF	QYPFPLPVF
SYPVMGFEF	SYPVMGFEF
IYTFPHASF	IYTFPHASF
AYPNSSLFMFF	AYPNSLFMF
AYVVFVTTL	AYVVFVTTL
RYSGVNQSMLF	RYSGNQSML
KYITQGQLLQF	KYITQGQLL
PWAPTDMLDL	PWAPDMLDL
KYSPSMKSL	KYSPSMKSL
VYSGGVYLF	VYSGGVYLF
VQPRNWLLFA	VQPRNWLLF
VMLGTQLLYKF	LGTQLLYKF
VSSYPNTFEW	SYPN-TFEW
SFIKDYPVVSI	SFIKDYPVV
CCPVFACIQEF	VFAC-IQEF
FYLRDPIDL	FYLRDPIDL
LYIGHLTTL	LYIGHLTTL
VYNVHGDQVF	VYNVGDQVF
LYFGSAFATPF	YFGSFATPF
SYINPDHLKYF	SYIN-PDHL
SWFAGEKLTF	SWFAEKLTF
PNLAFLRF	PNLA-FLRF
HFFQPTNQQF	FFQPTNQQF
SYVYPPVQEF	VYPP-VQEF
RYLMDPDTFTF	RYLMDPDTF
IYTDMGRFTI	IYTDGRFTI
KYMKNTPYV	KYMKNTPYV
IYPAVPPHF	IYPAVPPHF
IYLPAAQTM	IYLPAAQTM
SYTGIIHAF	SYTGIIHAF
VFTPLILLI	VFTPLILLI
YYPSIVANRW	YYPSVANRW
AYFNFPELL	AYFNFPELL
HLPETKFSEL	HLPEKFSEL
IFSPNVVNLTL	IFSPNVVNL
LYPEGKLPHW	LYPEKLPHW
YNFEKPFLW	YNFEKPFLW
SYGIIRGLQF	SYGIRGLQF
SYQVGINQRF	SYQVINQRF
NYGWIIRYL	NYGWIIRYL
VYTTNIQEL	VYTTNIQEL
TYYWGFAAW	TYYWGFAAW
LYPEGLAQL	LYPEGLAQL
EMAAQDFFQRW	AAQDFFQRW
AFNPEPLVL	AFNPEPLVL
TVPVRLSSL	TVPVRLSSL
NYSDVMSKLGF	NYSDVMSKL
VYLFPGIPEL	VYLFGIPEL
NYLDVATFL	NYLDVATFL
IYPPEVAEF	IYPPEVAEF
TVTRPTGVSF	VTRPTGVSF
VYNENLVHMI	VYNELVHMI
VFFEVSPVSF	VFFESPVSF
VLELAGNASKD	ELAGNASKD
MYMENFIEHL	MYMEFIEHL
LYSSKLYRF	LYSSKLYRF
IFMENRNEF	IFMENRNEF
MYQEHINEI	MYQEHINEI
AYPHRLNLF	AYPHRLNLF
LYLPSFFTY	LYLPSFFTY
SFPSFLPSF	SFPSFLPSF
RYLDKTEQW	RYLDKTEQW
SFKLSGFSF	SFKLSGFSF
LFMPRSTEF	LFMPRSTEF
VLPKLYVKL	VLPKLYVKL
KYNDNFFGL	KYNDNFFGL
LYIPAMAFI	LYIPAMAFI
AYGWVSATF	AYGWVSATF
DYKQALKYF	DYKQALKYF
VYYRGGALL	VYYRGGALL
LFAVFQTTF	LFAVFQTTF
YYVRAWVVF	YYVRAWVVF
DYGGFTMMF	DYGGFTMMF
KYPQLLPGI	KYPQLLPGI
PFIISSESYSF	IISSESYSF
YYSPILDQW	YYSPILDQW
FYQGEKNFYF	FYQGKNFYF
SFAPKPAVF	SFAPKPAVF
YYNAAGFNKL	YYNAGFNKL
VFFIIEHLF	VFFIIEHLF
TYIGQGYII	TYIGQGYII
AFHSPKALF	AFHSPKALF
VYTVVDEMF	VYTVVDEMF
HVVPDQLMAF	VVPDQLMAF
RYVDRVTEF	RYVDRVTEF
TIIDTKGVTAL	IIDTGVTAL
AYLEALSHL	AYLEALSHL
VMPLIIQGF	VMPLIIQGF
IYNHPPHPTM	IYNHPHPTM
YYDSFVRWQFL	YYDSVRWQF
LYYDAIWHF	LYYDAIWHF
YFEVPSVLL	YFEVPSVLL
RYLELISSI	RYLELISSI
AFIPAIDSFGF	AFIPAIDSF
LYQHEINLF	LYQHEINLF
RYPHAAVNGLF	RYPHAVNGL
IYFDRIEVVNF	IYFDRIEVV
VGADLSHVF	VGADLSHVF
IAPTGHSL	IAPT-GHSL
FWEIRYMYF	FWEIRYMYF
TKGECHVPIL	KGECHVPIL
YNILRGIGKL	NILRGIGKL
TFSPHFKVF	TFSPHFKVF
AYTLGVKQLI	AYTLGVKQL
VWVARNPPGF	VWVANPPGF
RYLWATVTI	RYLWATVTI
SYFPKILTF	SYFPKILTF
FYNLLTRTF	FYNLLTRTF
NYAIFDEGHML	AIFDEGHML
DLAGFKELF	DLAGFKELF
IAPWRMPEF	IAPWRMPEF
VYPADVVLF	VYPADVVLF
PYPPPPPEF	PYPPPPPEF
KYGFYTHVF	KYGFYTHVF
VFFKGFKW	VFFK-GFKW
FAHGTAGLVF	AHGTAGLVF
VYQYMHETI	VYQYMHETI
YYGEHLFML	YYGEHLFML
SWPGLAVGNLF	PGLAVGNLF
MMYSGELKF	MMYSGELKF
KYLPEWTAWL	KYLPEWTAW
EYLPKVTGL	EYLPKVTGL
NYAENILTL	NYAENILTL
PYFLPEHIF	PYFLPEHIF
FFEGPPFKF	FFEGPPFKF
SYNNHAWSF	SYNNHAWSF
FYHDFFTNI	FYHDFFTNI
SVWAAVPGKTF	VWAAPGKTF
VYLPNINKI	VYLPNINKI
EWPKHWPTF	EWPKHWPTF
AYLEAHETF	AYLEAHETF
RYFFLFLL	RYFF-LFLL
VYRDGTGVVEF	VYRDGTGVV
LYQGVYSQI	LYQGVYSQI
VYMVGKANSVF	VYMVKANSV
YYRAPELIF	YYRAPELIF
VYPFGIVGM	VYPFGIVGM
RYLSKATTL	RYLSKATTL
HYIRKYNRF	HYIRKYNRF
QYLNKNALTTL	YLNKALTTL
VYTLDIPVL	VYTLDIPVL
YFLPDHPEL	YFLPDHPEL
EYYDKHFTEF	YYDKHFTEF
TYIAPWQITW	TYIAWQITW
YYMIGEQKF	YYMIGEQKF
RFKEANNFLW	RFKEANNFL
DFAPVIVEAF	DFAPIVEAF
VYLDPLVFREF	VYLD-PLVF
KYDPNVYSI	KYDPNVYSI
TYIPPLLVAF	TYIPLLVAF
LFIPSSKLLFL	LFIPSKLLF
VLPQAFDRF	VLPQAFDRF
IYFSNTHFF	IYFSNTHFF
EWFYAHIIPF	FYAH-IIPF
VLNNVAHTF	VLNNVAHTF
LYQEHMAYI	LYQEHMAYI
EALCKYGFVF	ALCKYGFVF
FLPFPLPLF	FLPFPLPLF
PYQEIKNVIL	PYQEIKNVI
VSISSDAFFPF	VSISSDAFF
PYTPFLTEL	PYTPFLTEL
QYQVQFWKM	QYQVQFWKM
KWLTKSFHF	KWLTKSFHF
QYPVFPWVI	QYPVFPWVI
TYEGIFKTL	TYEGIFKTL
TYTSNLVRL	TYTSNLVRL
LYPEIFEKF	LYPEIFEKF
MYIARQLSF	MYIARQLSF
ALERMFLSF	ALERMFLSF
SYLPVGSVSF	SYLPGSVSF
AYTLLGHEF	AYTLLGHEF
AYVGDVPIL	AYVGDVPIL
QYTKTGIFF	QYTKTGIFF
KYGEPGEVFI	KYGEPGEVF
SYSIYVYKV	SYSIYVYKV
TFASPTQVFF	TFASPTQVF
IFNEYAAKKM	IFNEAAKKM
HYAKIAADF	HYAKIAADF
SYNPITHQL	SYNPITHQL
SQALRYPYF	SQALRYPYF
VYFEGSIYEI	VYFESIYEI
SLPLAYPPPQF	PLAYPPPQF
VYAPPVGGF	VYAPPVGGF
VYINTAQEF	VYINTAQEF
MYSEVLDVL	MYSEVLDVL
EWTVDTSKLVF	EWTVDTSKL
DYAAIRDNYF	DYAARDNYF
TYGVSFFL	TYGV-SFFL
KYAALYQPLFD	KYAAYQPLF
IQNDAGVRIQF	IQNDAGVRI
PFSNSHNALKL	PFSNSHNAL
FYPPKVELFF	FYPPKVELF
VYVLTVTEI	VYVLTVTEI
YVVDLKKF	YVVD-LKKF
AFTTHPSQF	AFTTHPSQF
FYVEWTDVL	FYVEWTDVL
AYLKYIEGL	AYLKYIEGL
FYNPTTRLSMW	FYNP-TTRL
RWPKKSAEFLL	RWPKKSAEF
NYNEAVYLVRF	NYNEAVYLV
KYMQKSLEL	KYMQKSLEL
KYFSFPGEL	KYFSFPGEL
VFFFYPLDF	VFFFYPLDF
KYIESPVLF	KYIESPVLF
QYLDDVSLHHL	YLDDSLHHL
VFSPDGPSRF	VFSPGPSRF
IFTDIFHYL	IFTDIFHYL
VYASDRATF	VYASDRATF
NYVEEKLIPTW	NYVE-EKLI
KWFESGPLLF	KWFEGPLLF
KYSEVFEAI	KYSEVFEAI
IFNPRTGQLF	IFNPTGQLF
IAGYVTHLM	IAGYVTHLM
VYPEESLVI	VYPEESLVI
VYAGNFVEV	VYAGNFVEV
AYSPRHYVI	AYSPRHYVI
TWFPKQMVLEL	TWFPKQMVL
VFYPPNGVIPF	FYPPGVIPF
KFPEVIINF	KFPEVIINF
SYSISVPIF	SYSISVPIF
RYITEALIKKL	RYIT-EALI
HYLPYYYSI	HYLPYYYSI
YYLGNPAEFHD	YYLGNPAEF
SYAETPLQL	SYAETPLQL
IYFFLEDVF	IYFFLEDVF
SYGKINILL	SYGKINILL
VYYLPDAEGAF	YYLPAEGAF
NYIVPDKQIF	NYIVDKQIF
QLMSLIINTF	LMSLIINTF
AYSIVAGVF	AYSIVAGVF
LYPHLSTYW	LYPHLSTYW
YPPVQVLF	YPPV-QVLF
RFFQGSQEF	RFFQGSQEF
VLKPGMVVTF	VLKPMVVTF
TYTTVSEYHW	TYTTSEYHW
RYLTGAWRL	RYLTGAWRL
KYGDILHVI	KYGDILHVI
SYVETELIF	SYVETELIF
KLPSNLPQL	KLPSNLPQL
GYTEVLKLL	GYTEVLKLL
IYGGTYML	IYGG-TYML
MYGDYKYTYW	MYGDYKYTY
LYSPEEPKILF	LYSPEEPKI
VYNASLENREW	VYNASLENR
IISSLPQLL	IISSLPQLL
VYYKDDTHYF	YYKDDTHYF
KYTAQMYEL	KYTAQMYEL
VYNVEVKNAEF	VYNVKNAEF
GHNGWVTQI	GHNGWVTQI
YFMEAIAPPLL	YFMEIAPPL
VQQTIHWLF	VQQTIHWLF
NYFIPEFNLF	YFIPEFNLF
VIAPWRMPEF	VIAPRMPEF
VHILQVPVW	VHILQVPVW
HYIPRAVLL	HYIPRAVLL
KYPLLLKEL	KYPLLLKEL
QYNPHVHQL	QYNPHVHQL
IYMPMIPEL	IYMPMIPEL
QYFAEPMM	QYFA-EPMM
DYQKLHDAFF	DYQKLHDAF
YYLPEMFVNF	YYLPMFVNF
YSKILPSLI	YSKILPSLI
SYLEKVVAI	SYLEKVVAI
KYPLNLYLLF	KYPLNLYLL
LYPEVPPEEF	LYPEPPEEF
VYSQFITQL	VYSQFITQL
IYAIVKEKY	IYAIVKEKY
IFASFNDTF	IFASFNDTF
YYPSPGVLF	YYPSPGVLF
LYIPKDAYF	LYIPKDAYF
VYIDFPGGILS	VYIDFPGGI
KWFNVRMGFGF	KWFNVRMGF
SYMGHFDL	SYMG-HFDL
IGAEVYHHL	IGAEVYHHL
IYAPKLQEF	IYAPKLQEF
TFLEDLKSF	TFLEDLKSF
IYFGKDIPNMF	YFGKIPNMF
IYHTGTFAQI	IYHTTFAQI
PFPPPGGLTF	PFPPGGLTF
DFNSDTHSSTF	NSDTHSSTF
AYFGTGFPHML	AYFGGFPHM
LYAGNIKTL	LYAGNIKTL
ELTGFRELF	ELTGFRELF
VYSLQEQHF	VYSLQEQHF
TYVSSFYHAF	TYVSFYHAF
IYTVKVEDLTF	IYTVKVEDL
PYVTFPVAF	PYVTFPVAF
FFFYPLDFTF	FFYPLDFTF
VYIGELPQDF	VYIGLPQDF
VSEPRYFQL	VSEPRYFQL
VLFPEPLTW	VLFPEPLTW
SYVMWKAGF	SYVMWKAGF
GYASRFIVI	GYASRFIVI
EFAPDNRHIF	EFAPNRHIF
IYNKNPPLGF	IYNKPPLGF
SYHPALNAIL	SYHPALNAI
LYQRAFQHL	LYQRAFQHL
KYPAVINDI	KYPAVINDI
GWLLDGTKF	GWLLDGTKF
AHYDLRHTF	AHYDLRHTF
LYQFNPAFF	LYQFNPAFF
YYMTQTEEL	YYMTQTEEL
IYVPELGMSF	IYVPLGMSF
TYIDKWFLYKM	TYIDKWFLY
AYYPPSQI	AYYP-PSQI
KYPNLLNQLL	KYPNLLNQL
VYTSVVEEL	VYTSVVEEL
TYAPETMMF	TYAPETMMF
VYAPFIEKL	VYAPFIEKL
TFASPTQVF	TFASPTQVF
GYPWTQRFFES	GYPWTQRFF
LYILDNETNF	LYILNETNF
EPSVSIPFL	EPSVSIPFL
VYGSGQRAF	VYGSGQRAF
FYITSRTQF	FYITSRTQF
KFIWTNHKF	KFIWTNHKF
KYSEEVLAVF	KYSEVLAVF
IYKDDISNSSF	IYKDSNSSF
VYGFVREAL	VYGFVREAL
QHIGNIFMF	QHIGNIFMF
IYFQAPVKI	IYFQAPVKI
NYFLWTEKF	NYFLWTEKF
FLYAPTILL	FLYAPTILL
TYVTEVREL	TYVTEVREL
VYKDMPETSF	VYKDPETSF
VFKPSDVML	VFKPSDVML
ACELHVAGFDF	ELHVAGFDF
AGLDIFAKF	AGLDIFAKF
VYFTRPMTM	VYFTRPMTM
VYNTFTTEERW	VYNTFTTEE
LYGQVQVF	LYGQ-VQVF
PSFYAERFFKF	FYAERFFKF
IYPRTQLPTW	IYPRQLPTW
MFPPTSIYHVF	PPTSIYHVF
MVNPTVFF	MVNP-TVFF
IYAPATLPVM	IYAPTLPVM
IYAGMPITEVF	AGMPITEVF
LWGIQKELQF	LWGIKELQF
QYLDRAEKL	QYLDRAEKL
NYKSHHLQL	NYKSHHLQL
LYQPNFNTNF	LYQPFNTNF
VYVKHSISF	VYVKHSISF
NFTNVAATF	NFTNVAATF
FFQPTNQQF	FFQPTNQQF
QYLEQSSKL	QYLEQSSKL
YYGPLNLL	YYGP-LNLL
RFPPYHVGQTF	PYHV-GQTF
LYQEILAQL	LYQEILAQL
TDAEGDDFELL	AEGDDFELL
LFQHITALF	LFQHITALF
IYQEGWRTVF	IYQEWRTVF
QFPQAFEF	QFPQ-AFEF
MGIYVGAKVF	IYVG-AKVF
QYILFPLRF	QYILFPLRF
VFDTSIAQLF	VFDTIAQLF
EFPDRIMNTF	EFPDIMNTF
QYLPHVARL	QYLPHVARL
LYFAPPEFL	LYFAPPEFL
RYAVEILTW	RYAVEILTW
VFTYVGALF	VFTYVGALF
YTLGVKQLI	YTLGVKQLI
QWPWQASLQF	QWPWASLQF
VVTVPAYF	VVTV-PAYF
MYTDIQEPMF	MYTDQEPMF
TYNMVLNLL	TYNMVLNLL
FYVNGLTL	FYVN-GLTL
AYMDENRNITF	AYMDENRNI
AWKPESPLW	AWKPESPLW
VYIMDTVGNIW	VYIMTVGNI
YLPPEAFTF	YLPPEAFTF
PWFDPAIF	PWFD-PAIF
YMDENRNITF	YMDERNITF
RYIPTAAAF	RYIPTAAAF
EYQELLDIKL	EYQELDIKL
IMTGSYNNF	IMTGSYNNF
VWNFPIDVTF	VWNFIDVTF
KYLEMIYSM	KYLEMIYSM
YYDMNAANVGW	YYDMNAANV
EFRSKQAEEEF	RSKQAEEEF
NYNDRYDEI	NYNDRYDEI
YWNEYGGGLLW	EYGG-GLLW
TYIPSTQNPAF	YIPSQNPAF
NYMSPFAQF	NYMSPFAQF
NYAQVFNKL	NYAQVFNKL
RFDAMPFTL	RFDAMPFTL
KYLESVKPF	KYLESVKPF
EYPENGERFSF	EYPENGERF
YYAEVETRI	YYAEVETRI
KYFSGPAITL	KYFSPAITL
VYLRDSFGL	VYLRDSFGL
IYILDPELL	IYILDPELL
SFLQDPSFF	SFLQDPSFF
YASQKKTF	YASQ-KKTF
NWLHKEAHQLF	LHKEAHQLF
KYNPQFGDAFW	KYNPFGDAF
EYKFQYAYF	EYKFQYAYF
VLPEGGETPIF	VLPEGETPI
AYKRPQELETF	KRPQELETF
VFFKGFKWGF	VFFKFKWGF
HYYTGTQGLIF	YYTGQGLIF
HYSSRLGSAIF	HYSSLGSAI
AFYPPHPNYTW	FYPPPNYTW
RYKQDVERF	RYKQDVERF
VGGVTAYF	VGGV-TAYF
HRLTWSFLW	HRLTWSFLW
IYQYIQSRF	IYQYIQSRF
LYIGWDKHYG	LYIGWDKHY
LYSNNITKL	LYSNNITKL
DYALHWLVL	DYALHWLVL
AYSDIVKMI	AYSDIVKMI
QYPFPLPVF	QYPFPLPVF
SFYQGEKNFYF	FYQGKNFYF
IYSDDLGVTW	IYSDLGVTW
IWHHTFYNEL	IWHHFYNEL
HYNWLIYHL	HYNWLIYHL
LYVLQVLTF	LYVLQVLTF
TYDFLFKFL	TYDFLFKFL
ASCWNSQEFI	ASCWNSQEF
EYGGVMVSF	EYGGVMVSF
RISPDRVY	RISP-DRVY
NYLLYVSNF	NYLLYVSNF
YYGDVIWVI	YYGDVIWVI
LYELHVFTF	LYELHVFTF
FYMDTSHLF	FYMDTSHLF
DYIKRVPSI	DYIKRVPSI
EYGQDLLHTVF	EYGQLLHTV
TYLDLLGTWV	TYLDLLGTW
FWKSGNALF	FWKSGNALF
YYLRPVSQQEF	YYLRSQQEF
SFFKDPIVNF	FFKDPIVNF
TYFEEIKQF	TYFEEIKQF
IYGGRIDNYF	IYGGIDNYF
IYLARHVGL	IYLARHVGL
PYNHQHEYF	PYNHQHEYF
KYLSGLVDKF	KYLSLVDKF
LFETALLSSGF	ETALLSSGF
DYGDRFWDI	DYGDRFWDI
RYPTSIASL	RYPTSIASL
AYYDGVAKI	AYYDGVAKI
PYFSGSSTF	PYFSGSSTF
YYAGEFHKM	YYAGEFHKM
EIFGQLRDFYF	IFGQRDFYF
LYPRLYPEL	LYPRLYPEL
LFTSKGLF	LFTS-KGLF
NYDKVEKLF	NYDKVEKLF
LYKPPTPEML	LYKPTPEML
VYTTTVHW	VYTT-TVHW
LYLEFLQKF	LYLEFLQKF
QYSGSLLNSL	QYSGLLNSL
VYNNSRMLHFL	VYNNRMLHF
SYANVKQWL	SYANVKQWL
IYEDVERQW	IYEDVERQW
KQLTWFYTF	KQLTWFYTF
QYIKFLQTI	QYIKFLQTI
EYTDVLQKI	EYTDVLQKI
SYHSEWNLF	SYHSEWNLF
EYLDDRNTF	EYLDDRNTF
TYDSSLSSYTV	TYDSSLSSY
SFFPNGYAF	SFFPNGYAF
VLPNRPFGLF	VLPNPFGLF
AYMDAPKAAL	AYMDPKAAL
KLPQLPITNF	KLPQPITNF
IAQWPALTF	IAQWPALTF
KFFGAENSVNL	FFGANSVNL
RYVPRASYF	RYVPRASYF
RFQEQSQLL	RFQEQSQLL
NYGAIPQTW	NYGAIPQTW
FGGRNPFDTF	FGGRPFDTF
TYARNLPAF	TYARNLPAF
KYLSLSNSF	KYLSLSNSF
VAQQVTQQF	VAQQVTQQF
DYGGFTMM	DYGG-FTMM
SYVVAMETF	SYVVAMETF
PYLDQINVI	PYLDQINVI
VYDTNPAKF	VYDTNPAKF
EYLYFFRVL	EYLYFFRVL
VYAGMITVF	VYAGMITVF
QYTGGIAKL	QYTGGIAKL
LYYPQQAIVF	YYPQQAIVF
IYDDEIPSLKI	IYDDEIPSL
RYLPYNQQHL	RYLPNQQHL
TWMGSPSIF	TWMGSPSIF
RYPQSIFSTF	RYPQIFSTF
YMDRVFKQF	YMDRVFKQF
DFNWRFIF	DFNW-RFIF
RYPSLWRRL	RYPSLWRRL
VFKQYNQTF	VFKQYNQTF
IPPSLNPII	IPPSLNPII
VYLNFTRADLI	VYLNTRADL
RYFKTPRKF	RYFKTPRKF
IYMQKVIYYL	IYMQVIYYL
YFPTWEGLF	YFPTWEGLF
FYPAIADLF	FYPAIADLF
RYFVSEDSIFL	RYFVSEDSI
FYPEEISSM	FYPEEISSM
GIPEFWFTI	GIPEFWFTI
KYAWVLDKL	KYAWVLDKL
NYIMKIHNF	NYIMKIHNF
VWNSSSTEF	VWNSSSTEF
VYKEEISRF	VYKEEISRF
KLPANHPLL	KLPANHPLL
RYMEVSGNL	RYMEVSGNL
LYLDTMQVM	LYLDTMQVM
FHEVPLKF	FHEV-PLKF
TQLGKYPVI	TQLGKYPVI
SLPEDIPVF	SLPEDIPVF
VYAKDWMVM	VYAKDWMVM
QYWEAQGWTF	QYWEQGWTF
IYNFVESKL	IYNFVESKL
PWGDGNHTLF	PWGDGNHTL
VYLPLTSHI	VYLPLTSHI
TYLPAGQSVLL	TYLPGQSVL
VYVATRPTI	VYVATRPTI
VYVPLKELL	VYVPLKELL
VYPNIEETHW	VYPNEETHW
HYLREVQAF	HYLREVQAF
TYVPWPLM	TYVP-WPLM
IYHNGVLEF	IYHNGVLEF
FYLLQTNPTYL	LLQTNPTYL
IFDNVAKVW	IFDNVAKVW
IFAEILNYI	IFAEILNYI
SYGPITVYF	SYGPITVYF
DYRLGAIHSL	DYRLAIHSL
FLSELTQQL	FLSELTQQL
VFPGHPVQF	VFPGHPVQF
ALPYFWEHF	ALPYFWEHF
VYMDWYEKFQ	VYMDWYEKF
PYPDDLVGF	PYPDDLVGF
TYQAMVHEL	TYQAMVHEL
TYLDIPLVI	TYLDIPLVI
SFYPAEITLTW	FYPAITLTW
LYQGLLPSL	LYQGLLPSL
KFGDILHVI	KFGDILHVI
EYSDVLAKL	EYSDVLAKL
KYLMELTLI	KYLMELTLI
KYQEIPFYHI	KYQEPFYHI
VGAMMYHTI	VGAMMYHTI
IYAAVTPEL	IYAAVTPEL
KYKETDLLILF	KYKETDLLI
VYKYPFELI	VYKYPFELI
VYSTGVHNI	VYSTGVHNI
VYMGEMGRL	VYMGEMGRL
LYQLQAERI	LYQLQAERI
TYQSVKQQLF	TYQSKQQLF
QYEIWRELF	QYEIWRELF
LFFGPVGFNF	FFGPVGFNF
IMPSSSHLF	IMPSSSHLF
VFVVVPFMEF	VFVVPFMEF
GWYDEEHPL	GWYDEEHPL
NYQDTIGRL	NYQDTIGRL
IYFDGDFGQI	IYFDDFGQI
EYQKVWNLF	EYQKVWNLF
SYALLTYM	SYAL-LTYM
VLRPPGGGSNF	RPPGGGSNF
PYHSLPSEAVF	HSLPSEAVF
IYAPQGLLL	IYAPQGLLL
SYQYPPVNW	SYQYPPVNW
AYFTETEKF	AYFTETEKF
KYSGVLSSI	KYSGVLSSI
PWPEYIYTRL	PWPEIYTRL
QYNFDFSKL	QYNFDFSKL
TYLEDRPMF	TYLEDRPMF
PFAPAIQTF	PFAPAIQTF
IYTHGLALLGF	IYTHGLALL
TYPQLEGFKF	TYPQEGFKF
VLPSVLNKF	VLPSVLNKF
DYIKFLRSI	DYIKFLRSI
TYIDKWFLY	TYIDKWFLY
RYIFAKNLF	RYIFAKNLF
KSDIYTLFF	KSDIYTLFF
VQPGIGTEVF	VQPGGTEVF
RYVWWKKSL	RYVWWKKSL
QYYNQEWTLW	YYNQEWTLW
PYNPLIMRL	PYNPLIMRL
AYYGNISHF	AYYGNISHF
PYSGDLTKF	PYSGDLTKF
KYSIVNPRL	KYSIVNPRL
YNKVHITL	YNKV-HITL
VYFLPITPHY	VYFLITPHY
VYADHLDWHY	VYAD-HLDW
TYGSIALI	TYGS-IALI
IFIDEIDSF	IFIDEIDSF
GLNDTMRYILI	GLNDTMRYI
YWTDWGTPAKI	DWGT-PAKI
SYSPAHARL	SYSPAHARL
NYGTGMERW	NYGTGMERW
LYLTIARQL	LYLTIARQL
VYFISPQGLKF	VYFISPQGL
IYNQVKQII	IYNQVKQII
GMELQSWYPVI	ELQSWYPVI
VYQEPIPTAQL	VYQEPIPTA
EWPKHWPTFI	EWPKHWPTF
PYLDNLPNF	PYLDNLPNF
SYSIGIANF	SYSIGIANF
LYGRNFNYL	LYGRNFNYL
YGLVIYAGF	YGLVIYAGF
VYDVVELKF	VYDVVELKF
YYTRLGNDF	YYTRLGNDF
AYLGLPAFL	AYLGLPAFL
ALPKELPLI	ALPKELPLI
LYTSKWTVTF	LYTSWTVTF
YYGYLWSEVY	YYGYLWSEV
AYLPHTFWI	AYLPHTFWI
EFPDKGFFFAF	EFPDKGFFF
SFTFASPTQVF	TFASPTQVF
TYYSKSVGF	TYYSKSVGF
YFISPQGLKF	YFISQGLKF
IWPSSIPNL	IWPSSIPNL
PYDQYLHRF	PYDQYLHRF
ILELAGNAARD	ILELAGNAA
IFSIKPLQF	IFSIKPLQF
PFTPPEPYRF	PFTPEPYRF
VLSEPNPRPVF	LSEPPRPVF
SYLSHSEQLVF	SYLSHSEQL
PLRPQNYLF	PLRPQNYLF
RYMWINQEL	RYMWINQEL
FYLPKDAVKHL	YLPKAVKHL
AYSGVPMTI	AYSGVPMTI
YYPAAPLPGF	YYPAPLPGF
EYMEHVYLI	EYMEHVYLI
AYQHAFLYI	AYQHAFLYI
YHVHLHVL	YHVH-LHVL
PYSVYLFSF	PYSVYLFSF
TYGITVAEL	TYGITVAEL
IFQGNVHNF	IFQGNVHNF
RYIDQKFVQQL	RYIDFVQQL
PYTSWREMFL	PYTSWREMF
ILPPAPSSYF	ILPPPSSYF
KWVDYSNKF	KWVDYSNKF
YLGQIQHI	YLGQ-IQHI
TYLTYNDFI	TYLTYNDFI
YFITPTGHSL	YFITTGHSL
RYFVSEGFEFF	RYFVEGFEF
NYNFEKPFLW	NYNFEKPFL
YFVPAEPKLAF	YFVPAEPKL
IWDTAGQERF	IWDTGQERF
SYFIAMHLF	SYFIAMHLF
AYEIIDQFF	AYEIIDQFF
RYLEDGKETL	RYLEGKETL
DYHTKLFLI	DYHTKLFLI
RWLPQKNAAQF	LPQKNAAQF
HYFDPQYFEF	HYFDQYFEF
QYQNVLTLW	QYQNVLTLW
PYFYAPEL	PYFY-APEL
RYTNRVVTL	RYTNRVVTL
KYLSSSGEVF	KYLSSGEVF
EYYEKQFPEI	YYEKQFPEI
TFSDVEAHF	TFSDVEAHF
LWPDSVPSALF	LWPDVPSAL
LYNPVSFAF	LYNPVSFAF
DFMKPVISI	DFMKPVISI
YYHARVYEF	YYHARVYEF
LYFLKPSYW	LYFLKPSYW
IYNFFSPL	IYNF-FSPL
IYSPEGHVL	IYSPEGHVL
KYIPLPQRV	KYIPLPQRV
TYEKFFGLL	TYEKFFGLL
VFKTDVHEL	VFKTDVHEL
FIHDQKLF	FIHD-QKLF
SLTYTLVII	SLTYTLVII
AYSMSFKNL	AYSMSFKNL
SYPAVPPIW	SYPAVPPIW
IYNEVLRDLL	IYNELRDLL
IYGKDVFEAF	IYGKVFEAF
SYIPYNPQQF	SYIPNPQQF
VFTLKPLEF	VFTLKPLEF
VIPVRIHTI	VIPVRIHTI
IYPVLQALDF	IYPVQALDF
FFKPHWDEKF	FFKPWDEKF
AYLIQVHKW	AYLIQVHKW
PFTDQIFHF	PFTDQIFHF
SSAFLGYVLY	SSAFLGYVL
ELPLTNPELF	ELPLNPELF
VQPSKYHFL	VQPSKYHFL
FLPITPQF	FLPI-TPQF
IFIDITEVRW	IFIDTEVRW
PYNDYFEYF	PYNDYFEYF
EYAAINSML	EYAAINSML
IMGIIIDHF	IMGIIIDHF
SYSMIVNNL	SYSMIVNNL
VFLGQAFTI	VFLGQAFTI
DYARLVNEL	DYARLVNEL
MYPPEIGDFA	MYPPEIGDF
PYNPLWAQL	PYNPLWAQL
SMWEKGNVF	SMWEKGNVF
RMPPPANLPSL	PPPANLPSL
PYMDAVVSL	PYMDAVVSL
EYAQVIKML	EYAQVIKML
AYTDTGMIYF	AYTDGMIYF
VYPTLSQQL	VYPTLSQQL
RTLLWTELF	RTLLWTELF
IYAAFKEVL	IYAAFKEVL
RYGPVVKVVF	RYGPVKVVF
TYVWVQYVW	TYVWVQYVW
VFFDEANKQVF	FFDENKQVF
RYTRWINQL	RYTRWINQL
VYVPTVFENY	VYVPVFENY
SYYSSPFAF	SYYSSPFAF
VFLTTSPQGHF	LTTSPQGHF
RYVQPMASF	RYVQPMASF
GYKDSPSVW	GYKDSPSVW
IFHDISLRF	IFHDISLRF
MYADPNFVRTF	MYADFVRTF
QVPNESFFNFF	VPNESFFNF
KYNLINEYF	KYNLINEYF
LYETPTGWKFF	LYETTGWKF
RYLDEINLL	RYLDEINLL
AYATHPFKF	AYATHPFKF
VLPVPPIEF	VLPVPPIEF
VFIKYLPEW	VFIKYLPEW
KLFYADHPFIF	FYADHPFIF
YSSILQKF	YSSI-LQKF
RYTIVQQQI	RYTIVQQQI
AYIDRLLHLW	AYIDRLLHL
VYLPTHTSL	VYLPTHTSL
VYSKDNPNLLF	VYSKNPNLL
KYYFYDNYF	KYYFYDNYF
EYTRALFLL	EYTRALFLL
IYMGRPTYG	IYMGRPTYG
VQAGVTYLF	VQAGVTYLF
MYTDIQEPML	MYTDQEPML
IYVGRVKSF	IYVGRVKSF
YVPPPVATPF	VPPPVATPF
LYQEWEREF	LYQEWEREF
FYRSYFSQF	FYRSYFSQF
VYIDQTMVL	VYIDQTMVL
IFFFGTHETAF	FFGTHETAF
PWTQRFFESF	PWTQFFESF
VYVPALIFGQL	VYVP-ALIF
MFQYDSTHGKF	QYDSTHGKF
AYGNVFSAFA	AYGNVFSAF
RYIYTTKTL	RYIYTTKTL
GYGPATQVRW	GYGPTQVRW
VYEGQFKDNMF	VYEGFKDNM
QLPEPLISF	QLPEPLISF
VYLSTKKPPSH	VYLSKKPPS
PMPSRPSTTPF	PSRPSTTPF
NWTTAAPLLL	NWTTAAPLL
GYSNRVVDLM	GYSNRVVDL
PYLLISTQI	PYLLISTQI
EYIHHLEVI	EYIHHLEVI
IYTHLVKSL	IYTHLVKSL
VYAKYWIYV	VYAKYWIYV
SYADIQSWL	SYADIQSWL
YYASDVWSF	YYASDVWSF
KYLEEFITNI	KYLEFITNI
IYIESPITM	IYIESPITM
KYKGIFNGF	KYKGIFNGF
SLPGNFFYL	SLPGNFFYL
VYLDHAGATL	VYLDAGATL
TYGAFLQKF	TYGAFLQKF
GYGEGFRW	GYGE-GFRW
VYGIRLEHF	VYGIRLEHF
QYYHPPNLL	QYYHPPNLL
LYMDKFEEF	LYMDKFEEF
LYPQFMFHL	LYPQFMFHL
AYALLSHFL	AYALLSHFL
KYAPSGFYI	KYAPSGFYI
IYEMILHEF	IYEMILHEF
KFSNIVDKF	KFSNIVDKF
GYARLIETL	GYARLIETL
FFGPVGFNF	FFGPVGFNF
AYVPALQMAF	AYVPLQMAF
NPIHYNITSI	PIHYNITSI
VYIDFPGGIL	VYIDFPGGI
AYATMLRSI	AYATMLRSI
YYLTDVDRI	YYLTDVDRI
AYQKQPTIFQN	AYQKQPTIF
KLLGPAGLTW	LLGPAGLTW
TYIKSPPFF	TYIKSPPFF
KYIMDLERL	KYIMDLERL
NYSIIPYLL	NYSIIPYLL
LYMDTGEEIRF	LYMDTGEEI
TYSSGHNRLYF	TYSSGHNRL
TYVSGMLRF	TYVSGMLRF
MELPGLKF	MELP-GLKF
GYADIVQLLL	GYADIVQLL
IYWPNGLTI	IYWPNGLTI
SYYKDALRF	SYYKDALRF
DYIRVIEML	DYIRVIEML
VYHVHLHVL	VYHVHLHVL
YYGPLRTVWI	YYGPLRTVW
IFQPQQSVVL	IFQPQSVVL
KYMLKANLI	KYMLKANLI
LYSDATTSKI	LYSDTTSKI
YFLDKIDVI	YFLDKIDVI
FYIPPLATHTI	YIPPATHTI
FYSEILDKKF	FYSELDKKF
RFHPTPLLL	RFHPTPLLL
EYPIVDGKL	EYPIVDGKL
PFLPTHAQPNL	FLPTAQPNL
TYGNLLDYL	TYGNLLDYL
IFGVIIDTF	IFGVIIDTF
RFLAATFLL	RFLAATFLL
KTEFDKLF	KTEF-DKLF
GFFEQGGWSF	FFEQGGWSF
EWSPYTKIFQF	PYTK-IFQF
VFTDSGIHII	VFTDSGIHI
IWEIINSEYF	IWEINSEYF
FYTDPSYFF	FYTDPSYFF
ATPLSTLSL	ATPLSTLSL
PWEVMPDLYF	PWEVPDLYF
MYPHLMEGF	MYPHLMEGF
TYHGVFVNI	TYHGVFVNI
IYITDMSDTNW	IYITDMSDT
RYKEEYAVLI	RYKEEYAVL
VFVGTGDLF	VFVGTGDLF
EYASVLQLL	EYASVLQLL
HYSFYIETF	HYSFYIETF
FYAELYHII	FYAELYHII
LYGNVEKVKF	LYGNEKVKF
VFVEATHVL	VFVEATHVL
AYPTDLYTI	AYPTDLYTI
HFKDFTATF	HFKDFTATF
YYASQKKTF	YYASQKKTF
VYADLGTLSRL	VYAD-LGTL
IYVIPQPHF	IYVIPQPHF
YFLKGVLVF	YFLKGVLVF
SLPPSPLLF	SLPPSPLLF
LYGEFADPF	LYGEFADPF
LSLPEDFYHFW	SLPEDFYHF
LYTMNPNKF	LYTMNPNKF
RFGESTTGF	RFGESTTGF
FYISDLWKM	FYISDLWKM
KFYNQVSTPLL	FYNQSTPLL
EFNPTKPLL	EFNPTKPLL
LYERGFENI	LYERGFENI
YYEVHKELF	YYEVHKELF
KLSEPKPIFF	KLSEKPIFF
MFQTAVGHSF	MFQTVGHSF
VYNDIGKEMLL	VYNDGKEML
RYFKGYFL	RYFK-GYFL
KYSNMEQSLF	KYSNEQSLF
LYNAIMNIL	LYNAIMNIL
SYTYLSLGF	SYTYLSLGF
VFKTTLNEF	VFKTTLNEF
KYSMDTYVF	KYSMDTYVF
QYFAEPMML	QYFAEPMML
AYLPTGKQF	AYLPTGKQF
VYQFGSALAHF	QFGSALAHF
SYLTELIDRF	SYLTLIDRF
TYIDKWFL	TYID-KWFL
KSFCVKSNLI	SFCVKSNLI
KYPDYEVTW	KYPDYEVTW
FYAHIIPFLG	FYAHIIPFL
VYVLCYSLIL	VYVLYSLIL
TYQSITERI	TYQSITERI
EWFYAHIIPFL	FYAHIIPFL
YLAKTGETF	YLAKTGETF
NYVEVTRKW	NYVEVTRKW
VYIYRYFFL	VYIYRYFFL
RYIYNREEF	RYIYNREEF
KYFPETWIWDL	KYFPETWIW
VYLSDALLSGF	VYLS-DALL
SYDPDFNQL	SYDPDFNQL
IYIWDLNN	IYIW-DLNN
AYGLDFYIL	AYGLDFYIL
VWTPIPVLTW	VWTPPVLTW
RYLLVPEKV	RYLLVPEKV
VYPQPGMQRF	VYPQGMQRF
NYYAFFKLL	NYYAFFKLL
VYVGTLKLI	VYVGTLKLI
SSQGFLPHF	SSQGFLPHF
VFISSSLNTF	VFISSLNTF
QYGFPATPF	QYGFPATPF
IYGMIERL	IYGM-IERL
AYVLNIVRF	AYVLNIVRF
AFLYNDQLIW	AFLYNDQLI
GYTSRWYHL	GYTSRWYHL
EYVEAVSFQHF	EYVE-AVSF
HYADVLGLLL	HYADLGLLL
PTTKTYFPHF	TTKTYFPHF
GYADKNLIAKW	GYAD-KNLI
VYWKIYNSI	VYWKIYNSI
ELPTAFDYVEF	PTAFDYVEF
VWDEVSGQW	VWDEVSGQW
YFAKFEEKF	YFAKFEEKF
HYAIIKFPL	HYAIIKFPL
VFFPPEAQNDF	FFPPAQNDF
EFMPVETFSEF	EFMP-VETF
LFACLLGAAF	LFACLGAAF
TYLSHQEKL	TYLSHQEKL
RYVENPNIM	RYVENPNIM
RYFVSEGFEF	RYFVEGFEF
LYAEVPSSF	LYAEVPSSF
PYGNVAFPHL	PYGNAFPHL
VWSPDIEQSF	VWSPIEQSF
SYLPHAPPFA	SYLPHAPPF
STYIKSPPFF	TYIKSPPFF
VYEGPELNHAF	EGPELNHAF
YFKDGKAINVF	KDGKAINVF
LFEKAGPIW	LFEKAGPIW
VMSQALKATF	VMSQLKATF
KYGPVVSLL	KYGPVVSLL
KYQTPPHQNF	KYQTPHQNF
NYIHWVEDL	NYIHWVEDL
VYLHPGAVVF	VYLHGAVVF
AYTFPTFKF	AYTFPTFKF
IFSPYNEVLSF	IFSPYNEVL
EYKIVISKF	EYKIVISKF
SYVWDIKSI	SYVWDIKSI
NYPMPIGHF	NYPMPIGHF
YYDPNIENKNL	YYDPNIENK
GYSIHTYLW	GYSIHTYLW
QWPGKEPQVTF	PGKEPQVTF
QYASALKHI	QYASALKHI
RYIPDAMNLI	RYIPAMNLI
PYKVTQDEL	PYKVTQDEL
IYSKNVVLW	IYSKNVVLW
QQNLVYYRF	QQNLVYYRF
QYLPAIRALW	QYLPAIRAL
YTFPHASF	YTFP-HASF
RYLSPKWIKMF	RYLSKWIKM
AYLNITKHL	AYLNITKHL
KYGNLDIFSTL	KYGN-LDIF
FYQDTYGQQW	FYQDYGQQW
VFIDKQTNL	VFIDKQTNL
VHAGPFANI	VHAGPFANI
VYVGSFSWW	VYVGSFSWW
RYQDIIHSI	RYQDIIHSI
VLPTPTEKDVF	PTPTEKDVF
KYGIVQEF	KYGI-VQEF
FVDHVFTF	FVDH-VFTF
SYYTSLPRF	SYYTSLPRF
RYHPTFFNDVF	RYHPTFFND
IYQSIEFSRL	IYQSEFSRL
RYFQPPGTW	RYFQPPGTW
VYQEVQAMF	VYQEVQAMF
VYPSKQFDVL	VYPSQFDVL
IGMDVAASEFF	IGMDAASEF
KYIENLDNIT	KYIENLDNI
HWLDYFPPLAI	HWLDYFPPL
IFHYLEVLF	IFHYLEVLF
PFVDHVFTF	PFVDHVFTF
RYQEKISAL	RYQEKISAL
PWIPPSSPTTF	IPPSSPTTF
YFLHPPMPAL	YFLHPMPAL
YATHPFKF	YATH-PFKF
RYQTFLQLL	RYQTFLQLL
IFIDKIYSI	IFIDKIYSI
KFFGKELSTTL	FFGKLSTTL
RYLDSLKAIVF	RYLDSLKAI
IYSVFRNAASF	SVFRNAASF
LYSDRHYDL	LYSDRHYDL
LYGTIPQIF	LYGTIPQIF
VFEDLSVTL	VFEDLSVTL
YYFEGIKQTF	YYFEIKQTF
AYIPTPIYF	AYIPTPIYF
AYMDTLQTQW	AYMDLQTQW
FINKELILF	FINKELILF
DYWIVKNSW	DYWIVKNSW
RTAITTPNF	RTAITTPNF
IYQFIMDRF	IYQFIMDRF
YFLGSIVNF	YFLGSIVNF
IYPSPWPEKF	IYPSWPEKF
PYLFHVVTF	PYLFHVVTF
LYTEVTRYLDF	LYTEVTRYL
FYSNIQTVI	FYSNIQTVI
GYLGYTSGF	GYLGYTSGF
VYPLALYGF	VYPLALYGF
SYVTSPQGF	SYVTSPQGF
IFPPSMHFF	IFPPSMHFF
SFGLLDLPF	SFGLLDLPF
AFPSEHFGKLF	AFPSHFGKL
KYLTAEAFGF	KYLTEAFGF
VLPGVDALSNI	PGVDALSNI
YYNVLWEKL	YYNVLWEKL
VYVFDGKPPQL	VFDGKPPQL
VYPQRLNFV	VYPQRLNFV
VYLDYIRVI	VYLDYIRVI
QYLVRASYL	QYLVRASYL
PAFYMDTSHLF	FYMDTSHLF
VFIEDVSREF	VFIEVSREF
SYLSKWWDI	SYLSKWWDI
LYQEIIHYF	LYQEIIHYF
QYPNPLPVL	QYPNPLPVL
YYYVGFAYL	YYYVGFAYL
EYATKISRF	EYATKISRF
EYGEFYKSL	EYGEFYKSL
RWPDVARPPF	RWPDARPPF
VYQHGLTGF	VYQHGLTGF
LYLENIDEF	LYLENIDEF
PYMAPEIFHSF	YMAPIFHSF
ALPDQSFLW	ALPDQSFLW
AYLDKISEL	AYLDKISEL
VWKEAKPDEL	VWKEKPDEL
EFVPSPGNHF	EFVPPGNHF
AYVQLAHGQTF	VQLAHGQTF
KYFQGDLQLF	KYFQDLQLF
TYIKSPPFFE	TYIKSPPFF
GYFGNPQKF	GYFGNPQKF
VFLPSEGFNF	VFLPEGFNF
IYNPVKASI	IYNPVKASI
YLPSAWNSF	YLPSAWNSF
YYTSRPALF	YYTSRPALF
VYHKPPNAF	VYHKPPNAF
VYAAGKAERTL	VYAAKAERT
AYNPNTQTFM	AYNPNTQTF
KYGNQLVRL	KYGNQLVRL
LRQYFEEAF	LRQYFEEAF
IFSTITSKM	IFSTITSKM
YFDPANGKF	YFDPANGKF
RYVTTVTSW	RYVTTVTSW
KWYDRRDYVF	KWYDRDYVF
LYDIILQNL	LYDIILQNL
DYLDLYLIHW	DYLDYLIHW
PYMPTVSATI	PYMPVSATI
KYQGVTQGF	KYQGVTQGF
NYAAALETF	NYAAALETF
PPYTVVYFPVR	PYTVVYFPV
IYAIHVEGL	IYAIHVEGL
AYQLMVDVF	AYQLMVDVF
FDLDYGFQR	FDLDYGFQR
VWAAVPGKTFV	VWAAPGKTF
KQTELFAHF	KQTELFAHF
ILMNDYPKF	ILMNDYPKF
KYFLKPEVL	KYFLKPEVL
DMKHWPFQVI	DMKHPFQVI
YWGTPIPLW	YWGTPIPLW
GYPVPPYAFF	GYPVPPYAF
VWEEAFRFF	VWEEAFRFF
PYSGSPANF	PYSGSPANF
PYTSWREMF	PYTSWREMF
QYKGMFDTL	QYKGMFDTL
YLPTLWVKL	YLPTLWVKL
LYMEQFTKANF	LYMEQFTKA
TYVGYGVLTLF	TYVGGVLTL
DYVEINIDHKF	VEINIDHKF
LYWSHEALF	LYWSHEALF
YLPEVSYQF	YLPEVSYQF
LYVGKIPGF	LYVGKIPGF
LYPPPPHTL	LYPPPPHTL
RFMAEMVDFF	RFMAEMVDF
NRIAIYELLF	RIAIYELLF
AYKDFLWFF	AYKDFLWFF
LMTTVHAI	LMTT-VHAI
TYQEVAQKF	TYQEVAQKF
RMPRWYFLL	RMPRWYFLL
VYMFQYDSTHG	VYMFQYDST
NYASTFTWW	NYASTFTWW
FFNDVFSTLF	FFNDVFSTL
PYGEKQDEF	PYGEKQDEF
IYLPEVRKI	IYLPEVRKI
VYWEGYVRFL	VYWEGYVRF
AMNPTNTVF	AMNPTNTVF
IYFGSNIPNMF	YFGSIPNMF
FYGNVSRF	FYGN-VSRF
IYQELLGLAF	IYQELGLAF
YYPNPPLVL	YYPNPPLVL
LYAEPAVLQW	LYAEAVLQW
VYHVHLHV	VYHV-HLHV
ILPEYLSNW	ILPEYLSNW
SYVKVLHHM	SYVKVLHHM
VYTPTDTLV	VYTPTDTLV
SYINELRTF	SYINELRTF
VYPWTQRF	VYPW-TQRF
YWRDQAQETL	YWRDAQETL
YSLEMKMSFF	YSLEKMSFF
AYAQQLTEW	AYAQQLTEW
PGALLKYIGP	PGAL-LKYI
VYITGKEVF	VYITGKEVF
EFISTGSKLLF	EFISTGSKL
QYAKDIGFI	QYAKDIGFI
IYSAERFLI	IYSAERFLI
KYVGAIEKL	KYVGAIEKL
KYLMALKNL	KYLMALKNL
IFEGLGHLI	IFEGLGHLI
SFSTVHEKF	SFSTVHEKF
SFLHGNASLLF	SFLHNASLL
KYDAAHFLI	KYDAAHFLI
EYPEINFVGLL	EYPENFVGL
RYTDVSTRY	RYTDVSTRY
VLSAEGFLF	VLSAEGFLF
QYPGRSLVF	QYPGRSLVF
LYLPQEQLTHW	LYLP-QEQL
VYITPMEAL	VYITPMEAL
AYAEAVQRL	AYAEAVQRL
VWFEYPVQI	VWFEYPVQI
VYESIYNRI	VYESIYNRI
PWFQNSSVILF	FQNSSVILF
IYGGSDSRF	IYGGSDSRF
EELIEKMQE	EELIEKMQE
SYAGNSPLI	SYAGNSPLI
TYGQQGHPNTW	YGQQHPNTW
LYMGPEYIKYF	LYMG-PEYI
QFGPINNHF	QFGPINNHF
YLPISHPRF	YLPISHPRF
AYPRISVNNVL	AYPRSVNNV
LLPTPDEFPRF	PTPDEFPRF
KLYSPSQIGAF	LYSPQIGAF
KFIDPIYQV	KFIDPIYQV
PYLPPLEKL	PYLPPLEKL
PYLSEVLTF	PYLSEVLTF
RYPDSMLGAMF	RYPDMLGAM
IFSPTSNLLLL	IFSPTSNLL
VANSIHSLF	VANSIHSLF
VFLLESPYI	VFLLESPYI
SYLDNFIKI	SYLDNFIKI
VYGVFSIAEF	VYGVSIAEF
PLPPGSFHGDF	PLPPGSFHG
QYQDTKGFSTW	QYQD-TKGF
FFYEGSRVLF	FYEGSRVLF
IYAGQMAVL	IYAGQMAVL
EWPREPQVPL	EWPRPQVPL
VYLPEAMPASF	YLPEMPASF
VFLPDQGAFF	VFLPQGAFF
FYNEHTNDF	FYNEHTNDF
IYPGAFVDLF	IYPGFVDLF
DMEKIWHHTF	DMEKWHHTF
DYVTGLQTL	DYVTGLQTL
LYNPKITSEL	LYNPITSEL
VYSVFGFSF	VYSVFGFSF
RYFDVGLHNF	RYFDGLHNF
IYLGQLECFS	IYLGQLECF
RYSNVIQPSSF	RYSNQPSSF
VYHHTFFEM	VYHHTFFEM
YYQEVLQQL	YYQEVLQQL
LYVGGMKEI	LYVGGMKEI
PTLFNPFLL	PTLFNPFLL
VWFRIPNQF	VWFRIPNQF
LFTSISEIF	LFTSISEIF
KYAEENFKTF	KYAENFKTF
AISQPASGNTF	SQPASGNTF
DYILDLQKYW	DYILDLQKY
DYDSVFHHL	DYDSVFHHL
VFNGYFVHF	VFNGYFVHF
VFQGAVESI	VFQGAVESI
EYKVPDGMVGF	KVPDGMVGF
QWGGMPMSF	QWGGMPMSF
IYNPTTGEF	IYNPTTGEF
VYSPIRSGL	VYSPIRSGL
LCPALPGW	LCPA-LPGW
PYNDYFEY	PYND-YFEY
IYTWGTEEF	IYTWGTEEF
VYTKALSSL	VYTKALSSL
EYFFSDGIRL	YFFSDGIRL
GYGGGFGNF	GYGGGFGNF
KYGSVTVW	KYGS-VTVW
FYGDFFGDI	FYGDFFGDI
FYGDVQTHI	FYGDVQTHI
YYQPLVHLL	YYQPLVHLL
LYQTCQQNQF	LYQTQQNQF
SYRSVQEFL	SYRSVQEFL
TYIVFGEAKI	TYIVGEAKI
KYMETIEKL	KYMETIEKL
RYQDEVFGGF	RYQDVFGGF
SYSQSSNLF	SYSQSSNLF
RYALQMEQL	RYALQMEQL
KYRQQFEEL	KYRQQFEEL
QYAQQWNQY	QYAQQWNQY
IMRDPQTEEF	IMRDQTEEF
SYMLVNENRF	SYMLNENRF
AYLKGEDLF	AYLKGEDLF
VYIGVHVPF	VYIGVHVPF
NMGWLTFTF	NMGWLTFTF
LFPEEVIATIF	LFPEVIATI
RLPKSPPYTAF	LPKSPYTAF
YYAYLPAKL	YYAYLPAKL
VYFLPITPQF	VYFLITPQF
SYEVFKDLF	SYEVFKDLF
VNLPINGNGKQ	VNLPINGNG
YYNTYQVVQF	YYNTQVVQF
SYYGGNWASF	YYGGNWASF
SWPDWALPRL	SWPDALPRL
TYQETPEIDMF	TYQE-TPEI
YLPNQLFRTF	YLPNLFRTF
GWYDEEHPLV	WYDEEHPLV
YAEKLHRL	YAEK-LHRL
LYYTEAGSMFF	YYTEAGSMF
SYPTFFPRF	SYPTFFPRF
TFDAGAGIAL	TFDAAGIAL
QYPFPLPVFD	QYPFPLPVF
VFTPVTTEI	VFTPVTTEI
EYGFISQTL	EYGFISQTL
AYNDQGQVRL	AYNDGQVRL
VYGHQFMNL	VYGHQFMNL
EYLQNLNHI	EYLQNLNHI
SYGMVGALQF	SYGMGALQF
QFPEVYVPTVF	QFPEYVPTV
KYSSLNLF	KYSS-LNLF
VLMNQPPQI	VLMNQPPQI
VYNPLLFDKL	VYNPLFDKL
VLPEIDPVLF	VLPEDPVLF
LYPNTPYAYTF	LYPNTPYAY
AYYFHLQTF	AYYFHLQTF
VFSEFNRYLF	VFSENRYLF
PLTNPELF	PLTN-PELF
IFISKVGDTSF	ISKVGDTSF
FYSNKEIFL	FYSNKEIFL
TFVPQFQEAAF	TFVPQFQEA
IYATIMDFF	IYATIMDFF
FLGDSWGILF	FLGDWGILF
ELPEPLMTF	ELPEPLMTF
LFHEHPDLI	LFHEHPDLI
IWDTTQKEHL	IWDTQKEHL
SVPVSLQTL	SVPVSLQTL
VYATMPINSF	VYATPINSF
RWLPAGDALL	RWLPGDALL
RYFKGDYSI	RYFKGDYSI
NFIPTIVNF	NFIPTIVNF
YYFDHNSNW	YYFDHNSNW
YYRKYAAIF	YYRKYAAIF
MYIDPDLLAEL	MYID-PDLL
SLRPQNSTTW	SLRPNSTTW
IYLRDSTEF	IYLRDSTEF
LYRDVMLETF	LYRDMLETF
VYKDHQTITI	VYKDQTITI
LYNPENIYL	LYNPENIYL
VYDVFWLRF	VYDVFWLRF
AYIHQYTKF	AYIHQYTKF
NYLNHWNHF	NYLNHWNHF
FVNDIFERI	FVNDIFERI
DYAIWNTKF	DYAIWNTKF
FYSRLLQKF	FYSRLLQKF
YFHPPAHL	YFHP-PAHL
EYPSVTNYL	EYPSVTNYL
NYIEKNMERF	NYIENMERF
IYLVSIPEL	IYLVSIPEL
YFAERVTSL	YFAERVTSL
SYMVRGGHF	SYMVRGGHF
MYMQQQQPLL	MYMQQQPLL
YYHPPNLLELF	YYHPNLLEL
TYAYLFKYI	TYAYLFKYI
SYYGPLRTVW	YYGPLRTVW
LYPRLKVLAF	LYPRKVLAF
KMTQIMFETF	KMTQMFETF
GYISNGELF	GYISNGELF
LYLPPMRKID	LYLPPMRKI
ITPYGYFLI	ITPYGYFLI
VYENVSHFL	VYENVSHFL
VFTEVGEGVTF	VFTEVGEGV
SFTPVGDVF	SFTPVGDVF
VYGFPVNQL	VYGFPVNQL
YWNADTDLVSW	YWNADTDLV
MMGHRPVL	MMGH-RPVL
VYLTDPQGL	VYLTDPQGL
YQSRDYYNF	YQSRDYYNF
VWAAVPGKTF	VWAAPGKTF
SWSEAGGILF	SWSEGGILF
YYQIRSSQL	YYQIRSSQL
YFKDTSPVF	YFKDTSPVF
TLASNPATF	TLASNPATF
TYSDEFGNLDF	TYSDEFGNL
VYFPDQHINF	VYFPQHINF
IGMEKFFNI	IGMEKFFNI
NYDPNQRPFF	NYDPQRPFF
NFGQHPFVF	NFGQHPFVF
QYLRVETQF	QYLRVETQF
VWNGPVGVFEW	VWNGPVGVF
IISPEVSASF	ISPEVSASF
PFADALDLF	PFADALDLF
LYAQRPAGF	LYAQRPAGF
RTMEWVQTI	RTMEWVQTI
LFLSSSSLGLF	LFLSSSLGL
YYRGNYMTF	YYRGNYMTF
YAMKSLSLL	YAMKSLSLL
QYASYEFVQRL	ASYEFVQRL
MWPTRRLVTI	MWPTRLVTI
RKQGLDRLF	RKQGLDRLF
RGAEAYHFF	RGAEAYHFF
IYTPGSTVLY	IYTPGSTVL
SGPYGGGGQYF	PYGGGGQYF
HSPQTSAMLF	SPQTSAMLF
VYNSPRGYF	VYNSPRGYF
LYVDKSLNL	LYVDKSLNL
FLDAGHKLNF	FLDAHKLNF
LYLLNTTKL	LYLLNTTKL
KYRPLFDYF	KYRPLFDYF
TYQLGFHSI	TYQLGFHSI
AYGDMNHEW	AYGDMNHEW
AYSIFFDEKF	AYSIFDEKF
EYVVESTGVF	EYVVSTGVF
QYGNILHLY	QYGNILHLY
LYQKELATL	LYQKELATL
PWFDPAIFTI	PWFDAIFTI
EYGAILSFF	EYGAILSFF
IYLNHIEPL	IYLNHIEPL
LYGIHDIFF	LYGIHDIFF
NYIGLINRI	NYIGLINRI
RYLQTLTTI	RYLQTLTTI
VIGMPPPVF	VIGMPPPVF
AYLVYTDRL	AYLVYTDRL
SYSPQAFKF	SYSPQAFKF
DQSFLWNVF	DQSFLWNVF
TTPDVIFVF	TTPDVIFVF
AWKTISNGF	AWKTISNGF
VFKPISSTW	VFKPISSTW
KPGMVVTF	KPGM-VVTF
IYGELWKTGMF	IYGEWKTGM
TYTVRVPTI	TYTVRVPTI
TYTVKIVAI	TYTVKIVAI
LWVGATPHL	LWVGATPHL
PFLSGAETF	PFLSGAETF
VFTKYGQGF	VFTKYGQGF
NYTKAMRLF	NYTKAMRLF
AAVLEYLTAE	AVLEYLTAE
SYITKPEKW	SYITKPEKW
VHVVPDQLMAF	VVPDQLMAF
GIMDAANFEQF	IMDANFEQF
FIDTTSKF	FIDT-TSKF
AYEHKFYEI	AYEHKFYEI
IWWEPTGHTF	IWWETGHTF
EYVKFLHKF	EYVKFLHKF
RWKPASQPTI	RWKPSQPTI
YYQPNAGKAF	YYQPAGKAF
HYFQNTQGLIF	HYFQNTQGL
EFPDKGFFF	EFPDKGFFF
QYQIIMTMI	QYQIIMTMI
YLKTVDKF	YLKT-VDKF
AYGDIILTF	AYGDIILTF
KYPKVWEGF	KYPKVWEGF
QYLSSIQHL	QYLSSIQHL
GYMDYAQARF	GYMDAQARF
TYIQILESF	TYIQILESF
VYLEDSGHTL	VYLESGHTL
LYNEAVKII	LYNEAVKII
KYSFPHTYI	KYSFPHTYI
TWDLQPEKL	TWDLQPEKL
VYKPPKVSL	VYKPPKVSL
GFQVKAYTF	GFQVKAYTF
AYPTAYPSF	AYPTAYPSF
KYGNLGHVNI	KYGNGHVNI
IYPSNMQTM	IYPSNMQTM
DWAPKAFIISF	DWAPKAFII
LYPSIIQEF	LYPSIIQEF
QYQSQAKQLF	QYQSAKQLF
SYRPIVDYI	SYRPIVDYI
EYLPFLNTL	EYLPFLNTL
SMGLSYPVF	SMGLSYPVF
YYGYLWSEVF	YYGYWSEVF
KWKPPPSPLL	KWKPPSPLL
VQFSIRDYFTF	QFSIDYFTF
SIMATEDRQLF	IMATDRQLF
SYLIQHQRF	SYLIQHQRF
YFNHITNASQW	NHITNASQW
FSPFHASVL	FSPFHASVL
QYLPYISYL	QYLPYISYL
SYTDQAFFSF	SYTDAFFSF
KYPSPFFV	KYPS-PFFV
TWQKIHEPIML	TWQKIHEPI
KYFSSMAEF	KYFSSMAEF
AYMPHTFFIGD	AYMPHTFFI
PYRGWFPVI	PYRGWFPVI
YYTEAGSMF	YYTEAGSMF
QYASLMHSFI	QYASLMHSF
VYNKVHITL	VYNKVHITL
VYLQNEYKF	VYLQNEYKF
FVITPILLI	FVITPILLI
PYGNIQSRL	PYGNIQSRL
PQYPFPLPVF	QYPFPLPVF
LYKAYLESF	LYKAYLESF
FYADRFLKF	FYADRFLKF
SYIPLFPQLYF	SYIPLFPQL
VWSDIAPLNF	VWSDAPLNF
VYLSGYGVEL	VYLSYGVEL
RWLPQQNAAHF	LPQQNAAHF
RYISQTQGL	RYISQTQGL
VFDPALNLF	VFDPALNLF
LFKRISEQF	LFKRISEQF
VISAPDSQVRF	SAPDSQVRF
LYQKEVSHL	LYQKEVSHL
GYTTALKSF	GYTTALKSF
KYIDQGIAEL	KYIDGIAEL
IMPLEDMNEF	IMPLDMNEF
VYKDLLVLF	VYKDLLVLF
FYMDTSHLFN	FYMDTSHLF
WSPVRPLVF	WSPVRPLVF
NYVPEVSAL	NYVPEVSAL
NYQNVVHKL	NYQNVVHKL
NYVATTHMI	NYVATTHMI
NYAPAFTML	NYAPAFTML
SYIPTLSSF	SYIPTLSSF
IYNGFSSVLQF	IYNGFSSVL
FVTEITDDLHF	FVTEITDDL
MYLKQILYL	MYLKQILYL
LYPRDLWNF	LYPRDLWNF
SYIDVLPEF	SYIDVLPEF
KFFEEVLLF	KFFEEVLLF
VTGRFNGQF	VTGRFNGQF
RYNPRILFQL	RYNPILFQL
QYNPKLDVKL	QYNPLDVKL
GYSYNIRHSF	GYSYIRHSF
DYLSRVQGF	DYLSRVQGF
KFLDAGHKLNF	KFLDAGHKL
YWDSAGAAHF	YWDSGAAHF
NYSPGWKF	NYSP-GWKF
EYTPRSWNF	EYTPRSWNF
YISGIQTI	YISG-IQTI
EFLRDQPQF	EFLRDQPQF
YYSPTKNEI	YYSPTKNEI
TMMFTFHKF	TMMFTFHKF
AYLHTTTTF	AYLHTTTTF
RYSSESDVWSF	RYSSESDVW
YYGPLRSVW	YYGPLRSVW
IYAGEKAQF	IYAGEKAQF
NIVEAMERF	NIVEAMERF
