Data	Data aligned
KKPLSTPSM	KKPLSTPSM
AQAGWLQHDY	AQAGLQHDY
AKDPRYARY	AKDPRYARY
KKYLMIEEY	KKYLMIEEY
AKIVPKISY	AKIVPKISY
TQVIHSIEY	TQVIHSIEY
AKLPTGTTL	AKLPTGTTL
LKLGYVSRY	LKLGYVSRY
KQGVVLKY	KQG-VVLKY
TKISTHVSF	TKISTHVSF
GKYENNYNAVF	GKYENYNAV
YLFEPHSGEEY	FEPHSGEEY
HQLEFIQKF	HQLEFIQKF
RKLDEQQEF	RKLDEQQEF
LQRLVNLY	LQR-LVNLY
GKYEAVERYY	GKYEAVERY
AQLGLGHSY	AQLGLGHSY
KHFGTILNY	KHFGTILNY
KKFNEPGSQYF	KKFNPGSQY
KEYERFSKY	KEYERFSKY
RKENLTRLF	RKENLTRLF
LQKPGETVF	LQKPGETVF
RVYPERSTSY	RVYPRSTSY
RQIGSRSY	RQI-GSRSY
LQRLVEGY	LQR-LVEGY
AGAPPGTAY	AGAPPGTAY
AKIFRGQVY	AKIFRGQVY
FKINQKEGISY	NQK-EGISY
KQIDRQLTAY	KQIDQLTAY
KKIYDREQTRY	KIYDEQTRY
KKIEEFLSSF	KKIEFLSSF
KKNLVTISY	KKNLVTISY
GKSKGIAY	GKS-KGIAY
AKASPTQNLF	AKASTQNLF
RKGEFETGF	RKGEFETGF
LQHDFGHLSVF	LQHDHLSVF
KHLDKFSSY	KHLDKFSSY
RKLDRSVFTAY	RKL-DRSVF
VQYQDPAAVSF	YQDPAAVSF
GKGFTRTSY	GKGFTRTSY
SKLSFSQVF	SKLSFSQVF
TQRMFEIDY	TQRMFEIDY
RQVYLPMSY	RQVYLPMSY
YKYEDLVRM	YKYEDLVRM
NKYMGLTQF	NKYMGLTQF
VKVLITSQGY	VKVLTSQGY
VKPQSGSPY	VKPQSGSPY
LLAVFVTPL	LLAVFVTPL
KKVDGSVNAY	KKVDSVNAY
GKAFFLSSY	GKAFFLSSY
GKKKYETEF	GKKKYETEF
AKPLAALVTY	AKPLALVTY
GKMGKGVSF	GKMGKGVSF
AKMVVDAVM	AKMVVDAVM
VKFSPSSRY	VKFSPSSRY
GKFDQIYDVGY	GKFDQIYDV
ARFKERVGY	ARFKERVGY
AKVFGATTNY	AKVFATTNY
RQAPPHIEL	RQAPPHIEL
RKAIDYIKY	RKAIDYIKY
GKFDHADRTF	GKFDADRTF
YKHFEETQHTY	KHFETQHTY
GQYPTQPTY	GQYPTQPTY
SQLVAGVAF	SQLVAGVAF
RKKPTTEGF	RKKPTTEGF
AKRLREERL	AKRLREERL
FKVDAGKLHY	FKVDGKLHY
KKWATKTRL	KKWATKTRL
YKRVTGTSL	YKRVTGTSL
RKIHTGENL	RKIHTGENL
TQRSQQLEF	TQRSQQLEF
KKFLEPYIY	KKFLEPYIY
GKIPSPLSSSY	GKIPLSSSY
YKMRNGYEL	YKMRNGYEL
GQKQYNVDY	GQKQYNVDY
SSQFGGGSQY	SQFGGGSQY
RHREHLINY	RHREHLINY
YKKSGKLVF	YKKSGKLVF
AKMATGNYF	AKMATGNYF
VKNKDIRKF	VKNKDIRKF
RKVDPMAIVVF	RKVDAIVVF
RKPDEDMKLY	RKPDDMKLY
SQFINFPIY	SQFINFPIY
GKFYPELKLAY	GKFYPELKL
GQVAAGGAF	GQVAAGGAF
TKPGLYTAY	TKPGLYTAY
RQLPEPLISF	RQLPPLISF
AQKTSLRY	AQK-TSLRY
AQYKARVAL	AQYKARVAL
AKFLDPITGTF	AKFLITGTF
AKLPEIEEY	AKLPEIEEY
KHKTFVEKY	KHKTFVEKY
AQAPPTAQL	AQAPPTAQL
QQFLIQQQY	QQFLIQQQY
KKIDASQTEF	KKIDSQTEF
IKYKERFLVY	IKYKRFLVY
LKPEGVLVY	LKPEGVLVY
SQRLGSQKF	SQRLGSQKF
RLLDTTITF	RLLDTTITF
YKSAPARSY	YKSAPARSY
RKIFPSVIKY	RKIFSVIKY
KQFEGSTSF	KQFEGSTSF
AGLQFPVGR	AGLQFPVGR
HKVDLPFQEY	HKVDPFQEY
KKVGIVGKY	KKVGIVGKY
YQQIFLHEF	YQQIFLHEF
AKVKQRIDY	AKVKQRIDY
RQKLVRNIY	RQKLVRNIY
SQARLLTSF	SQARLLTSF
TQMDVKLVF	TQMDVKLVF
AKYPEIKSL	AKYPEIKSL
GKVFFTEKF	GKVFFTEKF
RKYDEVLHM	RKYDEVLHM
AHQGNPAVY	AHQGNPAVY
KKVEKSKIF	KKVEKSKIF
GKITDFIKF	GKITDFIKF
GKFHYKKEGTY	FHYKKEGTY
HQYKVRAY	HQY-KVRAY
GQLGFHVKY	GQLGFHVKY
SARAGETRF	SARAGETRF
KQMLSALNY	KQMLSALNY
REVAPRLAF	REVAPRLAF
AQYREVAAF	AQYREVAAF
SQHIGTGNLY	SQHITGNLY
RKTGQAPGYSY	RKTGQAPGY
RKTFSQSTY	RKTFSQSTY
AKSVGPLQY	AKSVGPLQY
RKKLYYDTDY	KKLYYDTDY
RKFDAIYKY	RKFDAIYKY
KKMELLQKY	KKMELLQKY
AKVLKTVTF	AKVLKTVTF
VQKEGKISY	VQKEGKISY
YKAQPVIEF	YKAQPVIEF
TKLQAQHVSY	TKLQQHVSY
GKSFGTSSY	GKSFGTSSY
SKSQALAVY	SKSQALAVY
SQGSFPEHY	SQGSFPEHY
AKAIATTVTY	AKAITTVTY
GKTSFGMSVF	GKTSGMSVF
GKFTEGNITY	GKFTGNITY
GKFHQESKF	GKFHQESKF
GKYLGINKELY	GKYLINKEL
YQEKGVRVL	YQEKGVRVL
GKFTKTHKF	GKFTKTHKF
TKDSTRLKY	TKDSTRLKY
GKVRAVIGSTY	GKVRIGSTY
KQVMEGRVTF	KQVMGRVTF
AQAASQHVF	AQAASQHVF
RQISREVTY	RQISREVTY
SKYFERHGY	SKYFERHGY
GKLGNESVTF	GKLGESVTF
YQPIQSPTF	YQPIQSPTF
KKIENLEAL	KKIENLEAL
AKFQPPPEY	AKFQPPPEY
GKLLRTILF	GKLLRTILF
YKALESIEY	YKALESIEY
KQPDNSPEY	KQPDNSPEY
LQQPRSLTY	LQQPRSLTY
LKPVVGEVY	LKPVVGEVY
HQMTPSSSY	HQMTPSSSY
IKPEQTTEY	IKPEQTTEY
RKMVGSRMF	RKMVGSRMF
YKKTKEAVL	YKKTKEAVL
GKYEEVEYYY	GKYEEVEYY
QQIGKVVQVY	QQIGVVQVY
AQRPTEQEL	AQRPTEQEL
GQHIQLVQY	GQHIQLVQY
AKNNGIVSY	AKNNGIVSY
TKLEGGVAY	TKLEGGVAY
GQSKDKVIY	GQSKDKVIY
RKYNWSAKA	RKYNWSAKA
YKITAEEMY	YKITAEEMY
RQFPVTVHF	RQFPVTVHF
IKYDLKGSTY	IKYDKGSTY
IKPGEHGSTY	IKPGHGSTY
KKVTNIISF	KKVTNIISF
GKLQKTVSY	GKLQKTVSY
SQRFKSSVY	SQRFKSSVY
TKKVTSVVF	TKKVTSVVF
KKVQPNSSY	KKVQPNSSY
KKRFTEEATKY	KKRFEATKY
KQREFESRL	KQREFESRL
KQRLFIINF	KQRLFIINF
FQYLSKTY	FQY-LSKTY
SQYGSQVGY	SQYGSQVGY
KKFSAMHEF	KKFSAMHEF
FQYDDSGNTF	FQYDSGNTF
RQFPFHEMF	RQFPFHEMF
KQSQELSQY	KQSQELSQY
VKVVPTVY	VKV-VPTVY
VKFPSKSAL	VKFPSKSAL
HERTFLLEY	HERTFLLEY
VKIINDNATY	VKIIDNATY
KQFFGIVGF	KQFFGIVGF
GKFHSIVRL	GKFHSIVRL
RMNPNSPSITY	RMNPPSITY
KKAVGGVAL	KKAVGGVAL
AQVKLLEF	AQV-KLLEF
AMIDGQSAF	AMIDGQSAF
VKYERQPEY	VKYERQPEY
VKHIHVKAF	VKHIHVKAF
AQYPSQPQRF	AQYPQPQRF
YSLDGRLLSTY	SLDGLLSTY
ILGPPGSVY	ILGPPGSVY
TMFVQRQVF	TMFVQRQVF
IKFSEEQRF	IKFSEEQRF
AQNPANMSKY	AQNPNMSKY
LQSLPTRAY	LQSLPTRAY
VKPQTSPEY	VKPQTSPEY
GQMIFAQAL	GQMIFAQAL
VQRVASVMQEY	RVASVMQEY
SKQASTVVF	SKQASTVVF
KALSRLISF	KALSRLISF
RQLLYITAF	RQLLYITAF
AKYVQGDAIGY	AKYVDAIGY
KKANITFEY	KKANITFEY
RKAIDYIRF	RKAIDYIRF
RKWFEPSQF	RKWFEPSQF
RKLTPKEAF	RKLTPKEAF
AGFAAIVAY	AGFAAIVAY
FKSQANQNY	FKSQANQNY
NQYISQQEY	NQYISQQEY
YQHDDGRVSY	YQHDGRVSY
VKWKGSLFF	VKWKGSLFF
GAYVSLLEY	GAYVSLLEY
AKLDVFQSY	AKLDVFQSY
GQVQLPSPH	GQVQLPSPH
YKYPSDISY	YKYPSDISY
RKIEVEHIF	RKIEVEHIF
AQYQREYSEF	AQYQEYSEF
AQYQSVPVY	AQYQSVPVY
AKVINDGLFY	AKVIDGLFY
RKKQSDVMRF	RKKQDVMRF
TKLKNTLIQY	TKLKTLIQY
KSYSVGVAY	KSYSVGVAY
AQHSYFGSF	AQHSYFGSF
RKFPAGKVPAF	RKFPKVPAF
VKYIQTDGY	VKYIQTDGY
FQFIMKQSY	FQFIMKQSY
RKLEAAEDIAY	RKLEEDIAY
VKEGVSAAF	VKEGVSAAF
YLPDGTASL	YLPDGTASL
MKYNARDTVFY	MKYNRDTVF
TKFSQDFSTF	TKFSDFSTF
KKFGDFITL	KKFGDFITL
ILKPDGSLY	ILKPDGSLY
EYTINIHKR	EYTINIHKR
RKDGSFIVRY	RKDGFIVRY
AQIKFLNTY	AQIKFLNTY
SQYPNQPTRF	SQYPQPTRF
AQWKHAVKF	AQWKHAVKF
VAPVASAL	VAP-VASAL
TKIKTIGSTY	TKIKIGSTY
TQMPDPKTF	TQMPDPKTF
RKPQSSLLRY	RKPQSLLRY
GKLLIGTLY	GKLLIGTLY
TYDDATKTF	TYDDATKTF
AKVKATTSL	AKVKATTSL
RQATVNVSY	RQATVNVSY
RKIETFLNHY	RKIEFLNHY
LKAMLSTGF	LKAMLSTGF
AQSDFISAF	AQSDFISAF
KKLQKAALL	KKLQKAALL
GKYGFVIAV	GKYGFVIAV
GKVFRHNSY	GKVFRHNSY
TKYHGPKAL	TKYHGPKAL
ALMPPFTAF	ALMPPFTAF
AKFPLPMEVF	AKFPPMEVF
RKFTQLREY	RKFTQLREY
GKPEPKVVY	GKPEPKVVY
GQYPVFNQY	GQYPVFNQY
SHRAFVVKY	SHRAFVVKY
SKVLLPLTY	SKVLLPLTY
AKIVRLTEY	AKIVRLTEY
AKLFFHTEY	AKLFFHTEY
LKRQGRTLY	LKRQGRTLY
YKFYPPKVELF	YKFYPKVEL
RQVVRSSKF	RQVVRSSKF
KKNELIEAF	KKNELIEAF
RQQPPSTTTF	RQQPSTTTF
EQYESFVKF	EQYESFVKF
RHSLPLQSF	RHSLPLQSF
GKVYSSSSY	GKVYSSSSY
GKFFSQSSH	GKFFSQSSH
RKNPAERMSY	RKNPERMSY
RKIQEESLRTY	IQEESLRTY
GKANIIFSY	GKANIIFSY
GKFFSQKSY	GKFFSQKSY
AKRYEKLDF	AKRYEKLDF
GKLIIWDSY	GKLIIWDSY
TKAGVLARY	TKAGVLARY
RKFKEAERLF	RKFKAERLF
GKAFTHSRF	GKAFTHSRF
GKYEAVERY	GKYEAVERY
RKVLPLEEAY	RKVLLEEAY
GKIEFISTM	GKIEFISTM
AKFAYKDEY	AKFAYKDEY
RPVPKGATY	RPVPKGATY
AKVANASYY	AKVANASYY
RQFVKRIGY	RQFVKRIGY
KKIEISQHAKY	KKIEISQHA
FKIPSNTTL	FKIPSNTTL
HKVANTSSF	HKVANTSSF
HKVETFSGVY	HKVEFSGVY
RKADALKAM	RKADALKAM
AKIYPDPEL	AKIYPDPEL
ALAPAGFSY	ALAPAGFSY
YQYLEQSKY	YQYLEQSKY
YKASSEMALY	YKASSEMAL
RMWKTLTFF	RMWKTLTFF
AKINETDTF	AKINETDTF
SQYPFPVTL	SQYPFPVTL
HKKQDPDVPF	KKQDPDVPF
SKRISKLAY	SKRISKLAY
VQFIGRESKY	VQFIRESKY
RQQQSQTAY	RQQQSQTAY
SKTQVTVQY	SKTQVTVQY
VKNWVPTAY	VKNWVPTAY
SKPKEKLVY	SKPKEKLVY
RKFPYPLQW	RKFPYPLQW
RKIPVPANRY	RKIPPANRY
GQRVIGHY	GQR-VIGHY
AQVIVFQTY	AQVIVFQTY
GQTKPVVVY	GQTKPVVVY
AQWEETVTY	AQWEETVTY
AKDQSVRIW	AKDQSVRIW
RKFYKGKKY	RKFYKGKKY
TQFPSTVSTVY	TQFPVSTVY
AKKGFTAVGY	AKKGTAVGY
SQLPEKVEY	SQLPEKVEY
GKRPEEENVY	GKRPEENVY
AKVYLTTGY	AKVYLTTGY
KKLQQTQEY	KKLQQTQEY
GKRKEIYKY	GKRKEIYKY
AQVLSVVAH	AQVLSVVAH
RQFMAETQF	RQFMAETQF
IHFISPNIY	IHFISPNIY
GKAFNSRSY	GKAFNSRSY
AKIPSVIEY	AKIPSVIEY
SKYAADRNHY	SKYADRNHY
MKARVVLKY	MKARVVLKY
AEWSSKTSY	AEWSSKTSY
KKPTVTLTY	KKPTVTLTY
FKALIAAQY	FKALIAAQY
AKVGKAHVY	AKVGKAHVY
AQARWWATF	AQARWWATF
RAAPFSLEY	RAAPFSLEY
AKFIEGVVL	AKFIEGVVL
MKIWTSEHVF	MKIWSEHVF
RKFPGRPEEEY	RKFPPEEEY
GQTKPVYVY	GQTKPVYVY
VKYNGPESQY	VKYNPESQY
AKVGTRLMF	AKVGTRLMF
SKQLFMTAY	SKQLFMTAY
AHWVTHTSY	AHWVTHTSY
IKLPSVTSF	IKLPSVTSF
GKAFSYRSA	GKAFSYRSA
KLYQSIIGY	KLYQSIIGY
GKPVVNVSY	GKPVVNVSY
SKAPAPTF	SKA-PAPTF
GMWKGGRSH	GMWKGGRSH
GQILMPNIGY	GQILPNIGY
KKPKNENPVDY	PKNENPVDY
GKFNPHVHVEY	GKFNVHVEY
AQYLPKEQY	AQYLPKEQY
HQASHQPLY	HQASHQPLY
AQYDGAYKV	AQYDGAYKV
AQLRNLEAY	AQLRNLEAY
SQRAVTNHSVY	RAVTNHSVY
TTAPTHVLAM	TAPTHVLAM
KKYYPTAEEVY	KKYYTAEEV
RKAISRELY	RKAISRELY
AKLDHVNIVHY	AKLDHVNIV
AQLIASAKY	AQLIASAKY
NQWEALTEY	NQWEALTEY
AKVMNLIVF	AKVMNLIVF
LKTYGQSTY	LKTYGQSTY
GQRQVGVGY	GQRQVGVGY
QKTIVKETY	QKTIVKETY
AHSLVGTPY	AHSLVGTPY
FKPNQTRTY	FKPNQTRTY
GKLFTQNSH	GKLFTQNSH
RQRFRQFGY	RQRFRQFGY
GKYASIILF	GKYASIILF
LKNPNAPML	LKNPNAPML
RKSIARVL	RKS-IARVL
RQYPTPFQL	RQYPTPFQL
RQALLTQHY	RQALLTQHY
LKEGHKKIY	LKEGHKKIY
SKVRALKTAY	SKVRLKTAY
HQRQNINKF	HQRQNINKF
GKLGKGFGAF	GKLGGFGAF
RQSPPRAAL	RQSPPRAAL
SQHQETPVY	SQHQETPVY
AKYMAEVKKY	AKYMEVKKY
TKVDIKETY	TKVDIKETY
KKIEDNNTLVF	KKIEDNNTL
VQYVHTQRF	VQYVHTQRF
YKWSNKLQY	YKWSNKLQY
LKEEKPKMY	LKEEKPKMY
KKYPEKLYF	KKYPEKLYF
GKMEIFTLF	GKMEIFTLF
SKFPTQISL	SKFPTQISL
RQIQESVTF	RQIQESVTF
RKIGELVRY	RKIGELVRY
AQRIQKLSF	AQRIQKLSF
RKIPTGAEA	RKIPTGAEA
YKVFKEEKY	YKVFKEEKY
GKVITSSSSF	GKVISSSSF
RKDPNKLVL	RKDPNKLVL
RKNLSIQRY	RKNLSIQRY
AQAAPSSSF	AQAAPSSSF
GKFAGNPWYY	GKFAGNPWY
LQYLSQGNVVF	YLSQGNVVF
AKYNKILNKY	AKYNILNKY
YHGKTGRVY	YHGKTGRVY
GKMNPQSAF	GKMNPQSAF
AKASKIEVY	AKASKIEVY
GKAIVSRQF	GKAIVSRQF
LKHQMETHY	LKHQMETHY
AQFETKKLY	AQFETKKLY
RLIPHVQVF	RLIPHVQVF
AKILPIMF	AKI-LPIMF
GKFDGDSAY	GKFDGDSAY
AKFSATPRY	AKFSATPRY
GRSKGYGFITF	SKGYGFITF
KQFPEVIKY	KQFPEVIKY
VKATTKIKY	VKATTKIKY
SKHRAQVIY	SKHRAQVIY
SKNDLAVAY	SKNDLAVAY
HQNSNIRTY	HQNSNIRTY
RKFGEAIGMGF	RKFGEAIGM
KKIEDLIKY	KKIEDLIKY
FKLLPQLTY	FKLLPQLTY
HQKLGIAY	HQK-LGIAY
KKWNLPVYF	KKWNLPVYF
GKAEIARAY	GKAEIARAY
YLRKEDMEY	YLRKEDMEY
IKKPDYKVAY	KKPDYKVAY
IQEEFYRVY	IQEEFYRVY
RKLDFPSASF	RKLDPSASF
RKYSSVHTI	RKYSSVHTI
LQREGVSHY	LQREGVSHY
RKHEHVGSF	RKHEHVGSF
GKAPLNVQF	GKAPLNVQF
KKFPQMTSY	KKFPQMTSY
GKLKPTMAF	GKLKPTMAF
AKIPVTIITGY	AKIPIITGY
AQPETRVSY	AQPETRVSY
GKVQENSAY	GKVQENSAY
GKWNLKQQY	GKWNLKQQY
AKILLDPYY	AKILLDPYY
IQYDKTNVL	IQYDKTNVL
MMDQARSAF	MMDQARSAF
AQFKGTQSL	AQFKGTQSL
ILNTLQGVF	ILNTLQGVF
KKWISLTNF	KKWISLTNF
KKGPSGYGF	KKGPSGYGF
FKFGKELTF	FKFGKELTF
YQHGHINSY	YQHGHINSY
AHYPSQPVF	AHYPSQPVF
YHLGVVEAY	YHLGVVEAY
AKAGILTTL	AKAGILTTL
KKPGHVAEVY	KKPGVAEVY
AKPNGLILQY	AKPNLILQY
KKNVSVQY	KKN-VSVQY
KKYPKALVKY	KKYPALVKY
RHYVGSAAAF	RHYVSAAAF
AQIAGYLY	AQI-AGYLY
LQTVHAEY	LQT-VHAEY
RKFGSDKGVF	RKFGDKGVF
AKVTFTYTEF	AKVTTYTEF
KAVLDSYEY	KAVLDSYEY
TQIPRKVVY	TQIPRKVVY
RKVQPPQQNY	RKVQPQQNY
KKYAEDRERF	KKYADRERF
AQERSRLTY	AQERSRLTY
YKAYLESFY	YKAYLESFY
SKRLESGVQF	SKRLSGVQF
VKYYQSHHY	VKYYQSHHY
KQRKPRILF	KQRKPRILF
WQTVVGKTY	WQTVVGKTY
RAYQQSEAY	RAYQQSEAY
SKEEAMRWF	SKEEAMRWF
RLVELLVSY	RLVELLVSY
AKAPPPVFY	AKAPPPVFY
SKVIEDVAF	SKVIEDVAF
FKIKITSEL	FKIKITSEL
EEQLQQIR	EEQ-LQQIR
MQHIFLNNY	MQHIFLNNY
GKYFSLIPTGF	GKYFIPTGF
SQYLTRITI	SQYLTRITI
ASYEVKELY	ASYEVKELY
IQRQETISL	IQRQETISL
TQYESKVFY	TQYESKVFY
AKGNIPAESY	AKGNPAESY
SKYPASSSVF	SKYPSSSVF
GQTGTKSVF	GQTGTKSVF
FLFDGSPTY	FLFDGSPTY
GKNDPSSTF	GKNDPSSTF
SQIEEHKVF	SQIEEHKVF
RQIPYTMMKF	RQIPTMMKF
LLYESPERY	LLYESPERY
GQRVISMY	GQR-VISMY
RKFVADGIF	RKFVADGIF
SKMGKQLTY	SKMGKQLTY
LQKAQTQEF	LQKAQTQEF
FQMEQIVY	FQM-EQIVY
AKGIRNVPY	AKGIRNVPY
HHLVARVY	HHL-VARVY
GQFGTINNF	GQFGTINNF
FQYESKVFY	FQYESKVFY
RKVDPEALQVF	RKVDALQVF
SQTEVSSEY	SQTEVSSEY
FKVSDEVGF	FKVSDEVGF
RHSDIVVLY	RHSDIVVLY
FKFVEQQSY	FKFVEQQSY
GKYKDNEAIEF	YKDNEAIEF
PAYHSSLMD	PAYHSSLMD
GKAFSSKSY	GKAFSSKSY
KKIEKLEEY	KKIEKLEEY
FKSNVTKTM	FKSNVTKTM
GKVIGIAIM	GKVIGIAIM
AKIPGTGAL	AKIPGTGAL
SQFSVPSSY	SQFSVPSSY
GKVFSQNAY	GKVFSQNAY
KQIEPSLY	KQI-EPSLY
HQAIHTIEF	HQAIHTIEF
KQRPIFIITEY	RPIFIITEY
QKYPTKVSF	QKYPTKVSF
QKRPQGLSF	QKRPQGLSF
AQQVVLSSY	AQQVVLSSY
AKFLGFVAF	AKFLGFVAF
RGHLAKIY	RGH-LAKIY
GADVNRVTY	GADVNRVTY
RKIGARIY	RKI-GARIY
GEKGKLGQY	GEKGKLGQY
KQTQIFTTY	KQTQIFTTY
GKLYLEREEY	KLYLEREEY
VQRPQVVEY	VQRPQVVEY
RQIVSAVAY	RQIVSAVAY
YQADIERMY	YQADIERMY
VKNIKQAEF	VKNIKQAEF
FKFMPPPTY	FKFMPPPTY
AKFVTKAY	AKF-VTKAY
VKYTPRGAGSY	VKYTGAGSY
SKVQTAVTM	SKVQTAVTM
RKIPGVPIMY	RKIPVPIMY
GKIIKPLQY	GKIIKPLQY
RKYIGYARQY	RKYIYARQY
AKVFITKQGY	AKVFTKQGY
KQIFETIYY	KQIFETIYY
YKIMPLEL	YKI-MPLEL
AHIVSRLFY	AHIVSRLFY
THLKPGTLY	THLKPGTLY
KKFKDIIHY	KKFKDIIHY
GKASPSPSL	GKASPSPSL
KSFPGGKEY	KSFPGGKEY
VKAELRQYF	VKAELRQYF
GKVLTDEQY	GKVLTDEQY
RKFPAGKVPA	RKFPAGKVP
RKLDPPGGQFY	RKLDPGGQF
AMYSRKAMY	AMYSRKAMY
KGYLVSVDGY	KGYLSVDGY
KAYGASKTF	KAYGASKTF
SQFGGGSQY	SQFGGGSQY
TKLGKPFKY	TKLGKPFKY
GQEGKYRVY	GQEGKYRVY
GKGKFGNVY	GKGKFGNVY
FKFSSKNQL	FKFSSKNQL
RQREQEIAL	RQREQEIAL
GKHFSGESY	GKHFSGESY
SKEDDVRQY	SKEDDVRQY
AQYLPKEQYLY	AQYLPKEQY
QQVPVNQVF	QQVPVNQVF
SQVLLLKSF	SQVLLLKSF
HQHLSKESM	HQHLSKESM
MAPLKMLAL	MAPLKMLAL
RQYNRDWQSY	RQYNDWQSY
AKLASYVKF	AKLASYVKF
SKASQFTGY	SKASQFTGY
AKVDENHSEF	AKVDNHSEF
TKVVQNDAY	TKVVQNDAY
VKNKIASKY	VKNKIASKY
GKYFGGVLEY	GKYFGVLEY
SGFENKISY	SGFENKISY
RKVKNSQSFF	RKVKNSQSF
SQRVLYIRY	SQRVLYIRY
AKYPAPERL	AKYPAPERL
LKYDAQDKALY	LKYDQDKAL
VKHPPSVKY	VKHPPSVKY
KGLKVREY	KGL-KVREY
GKISETTARTY	GKISTARTY
RLFATDERF	RLFATDERF
SQARTLITF	SQARTLITF
GQFLAPNSH	GQFLAPNSH
GKFFRYSSY	GKFFRYSSY
GKGSFGEVF	GKGSFGEVF
RKEQETALRVY	RKE-QETAL
AKNPQEQKSF	AKNPEQKSF
GKISKEKSF	GKISKEKSF
GKYFEPEAY	GKYFEPEAY
AQPPVGAAY	AQPPVGAAY
IKKSDPVVSY	KKSDPVVSY
QQFPAFNSY	QQFPAFNSY
RQRLQSNAL	RQRLQSNAL
RKFMTNRLL	RKFMTNRLL
QQYNSFVSL	QQYNSFVSL
LKRLEEHRY	LKRLEEHRY
GKLKDLSRF	GKLKDLSRF
LKFPHSAHQKY	LKFPAHQKY
AKFSRPAQL	AKFSRPAQL
VKAPPQTRL	VKAPPQTRL
GKAFNSSSY	GKAFNSSSY
YKVDLESKL	YKVDLESKL
GGPGGVGGL	GGPGGVGGL
KKIYLQDEF	KKIYLQDEF
YKVETVGDKY	YKVEVGDKY
GKIGTVMTF	GKIGTVMTF
FQFLPHAY	FQF-LPHAY
SKFILIAAY	SKFILIAAY
HQLAVTAY	HQL-AVTAY
HLPETKFSEL	HLPEKFSEL
KKYEQLKAM	KKYEQLKAM
GQAPPGKAL	GQAPPGKAL
FKVNKKITF	FKVNKKITF
RKFVNKSY	RKF-VNKSY
SKMHTSQDF	SKMHTSQDF
KQHYGFVLY	KQHYGFVLY
AMMHGGTGF	AMMHGGTGF
IKAIQLEY	IKA-IQLEY
IKMDASLGNL	IKMDSLGNL
GKIEGLTAEF	GKIELTAEF
KQLPDQISF	KQLPDQISF
ISPSRTEAL	ISPSRTEAL
VKFGGQLLSF	VKFGQLLSF
IILPFLILL	IILPFLILL
RQESSVRLW	RQESSVRLW
YKVEYPIMY	YKVEYPIMY
RLSLNGVRF	RLSLNGVRF
VQRGGTPSAF	VQRGTPSAF
AQVKKATVF	AQVKKATVF
TQYTKPNQY	TQYTKPNQY
HQVSLLARF	HQVSLLARF
KKGFTAVGY	KKGFTAVGY
TEKPEVID	TEK-PEVID
AQRPDNPREF	AQRPNPREF
AKYIPELAYY	AKYIPELAY
KKPPGAQLGF	KKPPAQLGF
AKAPGAIGPY	AKAPAIGPY
GKKGHVLSY	GKKGHVLSY
SKDKRALKF	SKDKRALKF
HKMVVESAY	HKMVVESAY
IQNNPHASY	IQNNPHASY
RKDPHGFFAF	RKDPGFFAF
AIYGGSASY	AIYGGSASY
AKPEYISKTY	AKPEISKTY
KQIVDRVSY	KQIVDRVSY
SIPGGYNAL	SIPGGYNAL
KQLPGFTTL	KQLPGFTTL
QQYQQQAGY	QQYQQQAGY
FQAILDHTY	FQAILDHTY
GQLGTHAEY	GQLGTHAEY
LQRATGISF	LQRATGISF
AKWSVESIF	AKWSVESIF
SQLPPLTAF	SQLPPLTAF
AQAELESRY	AQAELESRY
KKFSFKKPF	KKFSFKKPF
RQYPWGTVQV	RQYPGTVQV
QQLQLFTEY	QQLQLFTEY
GKYYFYDNY	GKYYFYDNY
VQPSKFNSY	VQPSKFNSY
AKVKNSTEF	AKVKNSTEF
IKFFTGDVF	IKFFTGDVF
GQLMFMNKY	GQLMFMNKY
RKPSEEFNGY	RKPSEFNGY
SKVVPFSHY	SKVVPFSHY
SLFVSNHAY	SLFVSNHAY
KQRQLTSY	KQR-QLTSY
GKAFSRSSY	GKAFSRSSY
AKVILLTGY	AKVILLTGY
HQALPSVSH	HQALPSVSH
GKVFSNNSY	GKVFSNNSY
LKHIFKTSL	LKHIFKTSL
AKLNPGIAY	AKLNPGIAY
RKGEFVNEY	RKGEFVNEY
KKADIGVAM	KKADIGVAM
SQIDNNEPY	SQIDNNEPY
SQDTFKVHY	SQDTFKVHY
GKSTVINAM	GKSTVINAM
AAANPTLAF	AAANPTLAF
RKILATGENY	RKILTGENY
MQWRALVL	MQW-RALVL
GKTSLVQRY	GKTSLVQRY
GQNPFELAF	GQNPFELAF
GKLKDPANFQY	GKLKDPANF
SQFASSYVF	SQFASSYVF
SKYATGIRY	SKYATGIRY
TKWPGDILAY	TKWPDILAY
GKIAVMELF	GKIAVMELF
SHAISMSAY	SHAISMSAY
RKMDKIKTF	RKMDKIKTF
AQVPKSSAL	AQVPKSSAL
SMSDPGVSY	SMSDPGVSY
KQTQTFTTY	KQTQTFTTY
KKMPKIPVL	KKMPKIPVL
FVEIKGSV	FVE-IKGSV
AKVDLVSAY	AKVDLVSAY
LQIDNARLA	LQIDNARLA
FQLGSKLVY	FQLGSKLVY
RKALERELY	RKALERELY
GKFGGDFLVY	GKFGDFLVY
YKEEGSKVTTY	YKEEKVTTY
SSPQPGSAL	SSPQPGSAL
KQADPFASL	KQADPFASL
RKFKHFQEF	RKFKHFQEF
MKILTERGY	MKILTERGY
RKNPSDPKL	RKNPSDPKL
QQSPDVLVY	QQSPDVLVY
KKYPFILEVYY	KKYPILEVY
GKFFSQMSY	GKFFSQMSY
SKFIIHNVY	SKFIIHNVY
LKDEVRTLTY	LKDERTLTY
GKYFSLEGY	GKYFSLEGY
KKPESFFTQF	KKPEFFTQF
SKITMPIAF	SKITMPIAF
AKLQDPFSLY	AKLQPFSLY
GKVFTGGALY	GKVFGGALY
IILMILLLI	IILMILLLI
RKVDVEEEFF	RKVDVEEEF
AKYYTRITM	AKYYTRITM
GKINILLQTY	GKINLLQTY
SKFSQQQSF	SKFSQQQSF
AKFVDGEWY	AKFVDGEWY
LKLDSKNAL	LKLDSKNAL
AKYLPHSAGRY	AKYLPHSAG
LKPNTSVQF	LKPNTSVQF
SKAKPSVL	SKA-KPSVL
RKFSLKTVL	RKFSLKTVL
AQSPELRTY	AQSPELRTY
RHQYHIRAY	RHQYHIRAY
GQVTFLHVF	GQVTFLHVF
TKHIGLVY	TKH-IGLVY
KQYKVVVY	KQY-KVVVY
SQQPASGVAY	SQQPSGVAY
GKSGHILSY	GKSGHILSY
GKFKGVGRSY	GKFKVGRSY
GKPQNAPEGY	GKPQAPEGY
KLYRPGSVAY	KLYRGSVAY
KKKPVVTIY	KKKPVVTIY
AQRSTETALY	AQRSTETAL
LQNLFEEKY	LQNLFEEKY
RQKQGVVLKY	RQKQVVLKY
SQKVSGPQY	SQKVSGPQY
NKIFLPTIY	NKIFLPTIY
VKFDAVSGDYY	VKFDVSGDY
SKYNFENKY	SKYNFENKY
SKYQTVEKL	SKYQTVEKL
RKMEIYRPH	RKMEIYRPH
LKPGMVVTF	LKPGMVVTF
AQSRFLSTY	AQSRFLSTY
RKWSSEKRF	RKWSSEKRF
KQYPISLVL	KQYPISLVL
GKYGGMQMF	GKYGGMQMF
GKSHIGLVY	GKSHIGLVY
MMIPSQISY	MMIPSQISY
GQNASVLAY	GQNASVLAY
FQSLPKSAF	FQSLPKSAF
AQDAGYRMY	AQDAGYRMY
AGFAFRQTY	AGFAFRQTY
AKLPIEPRF	AKLPIEPRF
SKMLQHIDY	SKMLQHIDY
QKYQPRIAVF	QKYQRIAVF
SKIHFISPNIY	IHFISPNIY
FQLGESVKY	FQLGESVKY
SKLPKDTAL	SKLPKDTAL
TKVYTQVEF	TKVYTQVEF
KLPDIFSVY	KLPDIFSVY
RKLENKNAF	RKLENKNAF
SKLQWVSVF	SKLQWVSVF
QMWISKQEY	QMWISKQEY
SQLKGVSTF	SQLKGVSTF
SKFDGTRLY	SKFDGTRLY
YQYLLVTAL	YQYLLVTAL
YKHFNRHGKF	KHFNRHGKF
HKIDKSHEF	HKIDKSHEF
YKVSEYARRF	YKVSYARRF
KQKNTVVRY	KQKNTVVRY
AKIAEQVASF	AKIAQVASF
EKAPTNIVY	EKAPTNIVY
SKMNSIVY	SKM-NSIVY
RKVATEFESF	RKVAEFESF
YMIDPSGVSY	YMIDSGVSY
TKADHMGSY	TKADHMGSY
KKAPAQKVPA	KKAPAQKVP
KKHSQFIGY	KKHSQFIGY
FKKGDRVF	FKK-GDRVF
GKAFNRNSY	GKAFNRNSY
SHLGESSSY	SHLGESSSY
RQVEDLQATF	RQVELQATF
PIRLLAAAA	PIRLLAAAA
TKFQAGVRF	TKFQAGVRF
KKAMPGAEY	KKAMPGAEY
GKFKPNSVTY	GKFKNSVTY
KKSKENVLY	KKSKENVLY
GQLGFHVNY	GQLGFHVNY
HHIPDVITY	HHIPDVITY
IQFKLHESY	IQFKLHESY
YKFEEHGKAF	YKFEHGKAF
SKKPESTSF	SKKPESTSF
TKISTQLDF	TKISTQLDF
SKRIWGELY	SKRIWGELY
QKFGERVAY	QKFGERVAY
SKSPDLLMY	SKSPDLLMY
TQRDFMLSF	TQRDFMLSF
LKWIIKSNY	LKWIIKSNY
RKEPAALQY	RKEPAALQY
VHFVQTNSF	VHFVQTNSF
YKKDVGKTL	YKKDVGKTL
VKSKIASKY	VKSKIASKY
GKGFTRISY	GKGFTRISY
AKYMKDLISY	AKYMDLISY
SAAQPGVAF	SAAQPGVAF
GHYLGEFSITY	YLGEFSITY
YQRDLEVAL	YQRDLEVAL
IMKIDIEKF	IMKIDIEKF
MQHRYVELF	MQHRYVELF
SIVNRTVTF	SIVNRTVTF
YLYGQTTTY	YLYGQTTTY
KKITNNIVY	KKITNNIVY
RHRPELIEY	RHRPELIEY
FQKPSGVSA	FQKPSGVSA
HKLWDPNEF	HKLWDPNEF
SQIYQSIEF	SQIYQSIEF
YKAKQGYVIY	YKAKGYVIY
SKKHLETKF	SKKHLETKF
GKSFASKEY	GKSFASKEY
AQQEARTEF	AQQEARTEF
KKIEQQGGF	KKIEQQGGF
GKKLFGEGY	GKKLFGEGY
AKRLWGDIY	AKRLWGDIY
SQFKGYFIF	SQFKGYFIF
GKIQFGYVY	GKIQFGYVY
AKKDYNEAY	AKKDYNEAY
YKLPDNVTF	YKLPDNVTF
GKAFSRISY	GKAFSRISY
GKFLGLRAY	GKFLGLRAY
KQYADVEGF	KQYADVEGF
GKFFSRVSY	GKFFSRVSY
AAAPAGTTF	AAAPAGTTF
RKAASLKSNY	RKAALKSNY
RKRPVPKGATY	RKRPKGATY
GKWFTPTEF	GKWFTPTEF
SKMDLIEHY	SKMDLIEHY
PQAPSGPSY	PQAPSGPSY
GKVFKHRSY	GKVFKHRSY
SQTNPGSQF	SQTNPGSQF
AKFKDFYQF	AKFKDFYQF
GKFNVLLTTY	GKFNLLTTY
AMIDTGKAF	AMIDTGKAF
QQIEPLFQF	QQIEPLFQF
KQKDIVSIHY	KQKDVSIHY
LKALLLSSY	LKALLLSSY
GKTAVDTVF	GKTAVDTVF
RQATSTASTF	RQATTASTF
SKLPGSIQHVY	SKLPGSIQH
GKAFIRSSY	GKAFIRSSY
AKLRLLSSF	AKLRLLSSF
KAKEELIF	KAK-EELIF
AQVVLYRSY	AQVVLYRSY
LKYLTKKY	LKY-LTKKY
SKDKRDVYY	SKDKRDVYY
HQFLQNEY	HQF-LQNEY
RQGTPLIAF	RQGTPLIAF
SKAPGMNSL	SKAPGMNSL
RQRPQMKVNEY	RQRPKVNEY
AKLKGIGEY	AKLKGIGEY
KKISELDAF	KKISELDAF
VHNPDVITY	VHNPDVITY
GQLVKMLLY	GQLVKMLLY
AQLERQLQF	AQLERQLQF
QKAFNSSSF	QKAFNSSSF
AMRIGAEVY	AMRIGAEVY
RKITLRQVF	RKITLRQVF
KKRERDLEL	KKRERDLEL
AKNLFPNTY	AKNLFPNTY
AKNPKIAVS	AKNPKIAVS
AQHLFLQAF	AQHLFLQAF
RKIFTSSSNF	RKIFSSSNF
KQIDPVLQVY	KQIDVLQVY
AQDEHLITF	AQDEHLITF
RHSLPKVSY	RHSLPKVSY
AQRASSNVF	AQRASSNVF
RISQFSGVTF	SQF-SGVTF
KKSDVEAIF	KKSDVEAIF
VKAELRQY	VKA-ELRQY
AQAPIAAVL	AQAPIAAVL
KQAKLVEQY	KQAKLVEQY
LQRFPNKPY	LQRFPNKPY
VKLQDAGVY	VKLQDAGVY
MKHGQRITF	MKHGQRITF
GQIPQILYY	GQIPQILYY
AKAGGFVVGY	AKAGFVVGY
KKLGQSIESSY	GQS-IESSY
QSQFIFEHSY	SQFIFEHSY
VQFDGTNSAF	VQFDTNSAF
RKPDFRNPLY	RKPDRNPLY
AQFGHTSIVAY	AQFGSIVAY
RKVWAEAVHY	RKVWEAVHY
IQYLFLEY	IQY-LFLEY
KQYISAVQMY	KQYISAVQM
AKAGITTTL	AKAGITTTL
AKRLLINLY	AKRLLINLY
GQAGMHATY	GQAGMHATY
VAYDSKQYY	VAYDSKQYY
AQKIDLPEY	AQKIDLPEY
GMAAMPQTVY	GMAAPQTVY
AQLPKPTSTY	AQLPPTSTY
VQVDDIKRVY	VQVDIKRVY
MKKEFTLEF	MKKEFTLEF
GKPLKLMVY	GKPLKLMVY
GKMNPQSAFF	GKMNPQSAF
AKEEHLRQY	AKEEHLRQY
QQVVLSSY	QQV-VLSSY
GQYGNPLNKY	GQYGPLNKY
AQRQFVVAA	AQRQFVVAA
RKYEAFLQRY	RKYEFLQRY
AQAPAQSQF	AQAPAQSQF
KKSDVETIF	KKSDVETIF
SMWIERTSF	SMWIERTSF
RKHGGEKGVPF	RKHGKGVPF
AHSGVLLQY	AHSGVLLQY
SKVMNIVSY	SKVMNIVSY
KKVENFTVSF	KKVEFTVSF
RKYGSVTVWRY	RKYGSVTVW
RQREIEIRF	RQREIEIRF
KKFKNLKY	KKF-KNLKY
AKKISQLGY	AKKISQLGY
HKVISGTTL	HKVISGTTL
TKDGVREVF	TKDGVREVF
RKDKSLRVM	RKDKSLRVM
RKQPVKVVY	RKQPVKVVY
SKFSNPRAL	SKFSNPRAL
SKFLAPYTTF	SKFLPYTTF
SKIYKPLLF	SKIYKPLLF
GKYKNSEINF	GKYKSEINF
SAPVGVTAL	SAPVGVTAL
RKSFYSSHY	RKSFYSSHY
KQYPYNNLY	KQYPYNNLY
KQYEKSSRF	KQYEKSSRF
LLADPTGAF	LLADPTGAF
RKFEPGTQRF	RKFEGTQRF
FKKYLQETY	FKKYLQETY
AKWNPTAGVAF	AKWNAGVAF
AHFAKSISL	AHFAKSISL
FKVKSHVY	FKV-KSHVY
GQFYDNKGITY	GQFYKGITY
GKFQGLIEKF	GKFQLIEKF
KGYPSEFSTY	KGYPEFSTY
QKIDVQESF	QKIDVQESF
LLDDSVRVY	LLDDSVRVY
AQLSKQSSF	AQLSKQSSF
RQYPWGVVQV	RQYPGVVQV
VKRKQFEKY	VKRKQFEKY
TKLPFIVVM	TKLPFIVVM
RLWEQLVHF	RLWEQLVHF
KKALAAGGY	KKALAAGGY
RQIDFVLSY	RQIDFVLSY
KQYYALEVSY	KQYYLEVSY
RKYDAKFTDF	RKYDKFTDF
SKPGVSLVY	SKPGVSLVY
RKLNNFNSY	RKLNNFNSY
GKLQYELQY	GKLQYELQY
LQRVLQSEF	LQRVLQSEF
RKMDVSKITRY	RKMDKITRY
GKMKIFVKY	GKMKIFVKY
SKKFGDMSY	SKKFGDMSY
SKFSSASKY	SKFSSASKY
AQHVFKVSL	AQHVFKVSL
KGFAFVEY	KGF-AFVEY
AMYPHIFYF	AMYPHIFYF
LKIEPEEPITF	LKIEEPITF
RKAAITMQRY	RKAATMQRY
GQRYIQFY	GQR-YIQFY
SQGPVKHVY	SQGPVKHVY
HQYFSYNQM	HQYFSYNQM
AKLIAVEIY	AKLIAVEIY
STINPDHLSY	TINPDHLSY
GKYKSVSAF	GKYKSVSAF
KQIDNTGSSTY	KQIDGSSTY
KQIESKTAF	KQIESKTAF
VVGEHKDKVI	VGEHKDKVI
RKNPVQEQTY	RKNPQEQTY
TQFGGKRPF	TQFGGKRPF
VQRVETISL	VQRVETISL
GKIRKDLKY	GKIRKDLKY
AQYAQRASVAF	AQR-ASVAF
KKLANKVVY	KKLANKVVY
RKEERRITY	RKEERRITY
SKAPHLAY	SKA-PHLAY
KKYGVDLIRY	KKYGDLIRY
KKWVELPITF	KKWVLPITF
GKLKALKTY	GKLKALKTY
HQVAPSPAGY	HQVASPAGY
VKFDAVIGY	VKFDAVIGY
KKAPDFVFY	KKAPDFVFY
GKNPDEVSY	GKNPDEVSY
GKMGTLVSL	GKMGTLVSL
RKMPLPLKL	RKMPLPLKL
RKTIPIKY	RKT-IPIKY
ALWKQFQSF	ALWKQFQSF
SKMSELQTY	SKMSELQTY
VMINKATPY	VMINKATPY
SQFGTVTRF	SQFGTVTRF
KKVTSVVF	KKV-TSVVF
IKLDPHNHVLY	IKLDHNHVL
GQRKPATSY	GQRKPATSY
KKMETNYQRF	KKMENYQRF
AKIENVQKTGF	AKIEQKTGF
GKAFIFPSF	GKAFIFPSF
GQTAYATSY	GQTAYATSY
GKSDPFLEF	GKSDPFLEF
RKKSTTIRF	RKKSTTIRF
KKLEDIRTRY	KKLEIRTRY
GKARHRLSF	GKARHRLSF
GKLISVEY	GKL-ISVEY
KKFASFNAY	KKFASFNAY
IQHSTIIGF	IQHSTIIGF
AKLNNQARF	AKLNNQARF
GKFQEEANIY	GKFQEANIY
GKADGQQSSF	GKADQQSSF
AQPALKTQF	AQPALKTQF
AQVDPLSAL	AQVDPLSAL
LKYGKPLQL	LKYGKPLQL
GKPEKPSVTY	GKPEPSVTY
MQLPNGVTY	MQLPNGVTY
KQNPLLAEAY	KQNPLAEAY
LQREEEEAF	LQREEEEAF
LQHPDVAAY	LQHPDVAAY
KKQPSVLVTF	KQPSVLVTF
GKLGGQDSF	GKLGGQDSF
VPNLFSLQL	VPNLFSLQL
KLTEPHQVY	KLTEPHQVY
RSAVFSVTY	RSAVFSVTY
RKYLGQLHY	RKYLGQLHY
VQRLPVGAAF	VQRLVGAAF
AQVVQWVSF	AQVVQWVSF
RKSTSFRVY	RKSTSFRVY
IHYQMVYSY	IHYQMVYSY
KKLELSHEY	KKLELSHEY
RQIDLVDNYF	RQIDLVDNY
SKWLKHQAF	SKWLKHQAF
KKLSSPSNY	KKLSSPSNY
GKLFNRIAY	GKLFNRIAY
AKIPLGFYY	AKIPLGFYY
AKFKSSIY	AKF-KSSIY
RQSPHSNLF	RQSPHSNLF
QKIQDAQDKLY	IQDAQDKLY
VKVNIIQEEY	VKVNIQEEY
IKKDSGKEF	IKKDSGKEF
AKAPYLAKF	AKAPYLAKF
KKRLETVAL	KKRLETVAL
KLFIGGLSF	KLFIGGLSF
GQVQKIVLY	GQVQKIVLY
IGHYTLKIEI	GHYTLKIEI
AQKSISQHY	AQKSISQHY
AKFFTESRL	AKFFTESRL
SHYPFFSTF	SHYPFFSTF
HKIEAGNEF	HKIEAGNEF
RKQEEERGRVY	KQEERGRVY
GQNAQTMAY	GQNAQTMAY
RLQEFLTAY	RLQEFLTAY
HAAEYGAEALE	AAEYGAEAL
VKFNPIETF	VKFNPIETF
FKGPELLVDY	FKGPLLVDY
GKLVALHTF	GKLVALHTF
RQLSSSSSY	RQLSSSSSY
HGHLSAVY	HGH-LSAVY
KKYFETEQM	KKYFETEQM
AKRADLQSTF	AKRALQSTF
GKKLEERGF	GKKLEERGF
RKMEPSTAA	RKMEPSTAA
AKVVDKSEY	AKVVDKSEY
GKTFSKSTY	GKTFSKSTY
SKAFPFYSSY	SKAFFYSSY
RMYPGLQVY	RMYPGLQVY
GKVQDAFISY	GKVQAFISY
RQFGKKHLF	RQFGKKHLF
VKTGTITTF	VKTGTITTF
WHAPPVTTY	WHAPPVTTY
QAYHSPATA	QAYHSPATA
RQLPSSHAL	RQLPSSHAL
SQFHGLITHY	SQFHLITHY
AKDPANGRQF	AKDPNGRQF
RHWGGQADF	RHWGGQADF
AKFRSNLPA	AKFRSNLPA
AKSVPSHTY	AKSVPSHTY
RKVEDLFLTF	RKVELFLTF
KKFVTQQQY	KKFVTQQQY
AQPEPSTGF	AQPEPSTGF
AKINSGSSL	AKINSGSSL
SKKWGFTKF	SKKWGFTKF
YKKGENPVSY	KKGENPVSY
GKLKGEATV	GKLKGEATV
RQAMGMLAF	RQAMGMLAF
TKIQHILTY	TKIQHILTY
KKQKPSRVLY	KQKPSRVLY
RQFEGLMRF	RQFEGLMRF
GNYATVISH	GNYATVISH
RQEGVPRTF	RQEGVPRTF
AEYQFTGTY	AEYQFTGTY
AKQDVVLNY	AKQDVVLNY
AKIQKAVEY	AKIQKAVEY
VKYTNNEAY	VKYTNNEAY
KQYGEGLSY	KQYGEGLSY
GKLFPLPGY	GKLFPLPGY
RHLHPIQTSF	RHLHIQTSF
KKKPKDLDF	KKKPKDLDF
TKIDVSYEY	TKIDVSYEY
KKWVNEVRY	KKWVNEVRY
SQYPFPVTLY	SQYPPVTLY
LMIDVTKSYY	LMIDVTKSY
GKLLRDLEY	GKLLRDLEY
GKYIPKQSF	GKYIPKQSF
GKVGNVGQTNY	GKVGGQTNY
GQKIFYVNY	GQKIFYVNY
TQKEHLLKY	TQKEHLLKY
GKVPVVVSY	GKVPVVVSY
GKYEEVEYY	GKYEEVEYY
SQVKPLFQF	SQVKPLFQF
AKTNTVSY	AKT-NTVSY
RKIGDTSVSY	RKIGTSVSY
KKNPNIKSL	KKNPNIKSL
TKQPIPAAY	TKQPIPAAY
RKINLNISY	RKINLNISY
RKDDPRLSF	RKDDPRLSF
RKSGVGNIF	RKSGVGNIF
RPIVWGLAF	RPIVWGLAF
GKKLTELSM	GKKLTELSM
RHMSLLTAF	RHMSLLTAF
RKISAIRSY	RKISAIRSY
TQHPTLRLY	TQHPTLRLY
VMLPTGAAF	VMLPTGAAF
FLEETNRLY	FLEETNRLY
VKAEMLHMY	VKAEMLHMY
AQEQDSPAF	AQEQDSPAF
SKPAYGNSPY	SKPAGNSPY
YKVFVVGESY	YKVFVGESY
AKPHGPRTLY	AKPHPRTLY
KKKTVIEIEF	KKTVIEIEF
YKKGKDSLY	YKKGKDSLY
GKAFSHSSY	GKAFSHSSY
AKWLQDEMF	AKWLQDEMF
RKHNQRPTF	RKHNQRPTF
SKNPHIVSF	SKNPHIVSF
AKYEDLYAF	AKYEDLYAF
NQKPPSAEY	NQKPPSAEY
YKSPASDTY	YKSPASDTY
YKYTDKIMTY	YKYTKIMTY
GKAEVAVTLY	GKAEVAVTL
GKFPSLLTH	GKFPSLLTH
AQAISRFAY	AQAISRFAY
RKVDKQTAL	RKVDKQTAL
KKFSDSVKSTF	KKFSVKSTF
VQGPVGTDF	VQGPVGTDF
HQKKEFVKY	HQKKEFVKY
QQHDFTSQIF	QQHDTSQIF
GKYAERDIVQF	GKYADIVQF
RKILEAQETF	RKILAQETF
YKRDPSKQY	YKRDPSKQY
GKLDERHRLF	GKLDRHRLF
GQRAKSMKF	GQRAKSMKF
GKVPQPAIL	GKVPQPAIL
GKLPAGGVLY	GKLPGGVLY
LKMPSVAQF	LKMPSVAQF
AQMAQVLQF	AQMAQVLQF
RKFRHDKRVY	RKFRDKRVY
GQSRLIFTY	GQSRLIFTY
KIRGGKQFI	KIRGGKQFI
KQLVAEQVTY	KQLVEQVTY
RKVDTKALY	RKVDTKALY
RKFLEKEVF	RKFLEKEVF
FKVSASPLLY	FKVSSPLLY
DSYVGDEAQSK	SYVGEAQSK
AHNMRVMKF	AHNMRVMKF
SGSQRISSIY	SQR-ISSIY
SQRAGLQF	SQR-AGLQF
RQKQSLEY	RQK-QSLEY
RKPSIVTKY	RKPSIVTKY
KKLQGEVEKY	KKLQEVEKY
SKLTQILSY	SKLTQILSY
SKTETNVYF	SKTETNVYF
GKPRFQQTSF	GKPRQQTSF
GKPTHFTVY	GKPTHFTVY
FKIHPMAY	FKI-HPMAY
GRIKAIQLEY	IKA-IQLEY
AKAKPEASF	AKAKPEASF
FKPETISAF	FKPETISAF
LKRPLEATF	LKRPLEATF
HKYLTVKDY	HKYLTVKDY
VKVIQQESY	VKVIQQESY
QMYRTEIRM	QMYRTEIRM
SKRPPSVGDVF	SKRPPSVGD
HGIDPTGTY	HGIDPTGTY
RKKNEELEQLY	KKNELEQLY
AKYSTPATL	AKYSTPATL
LQAPPLTSL	LQAPPLTSL
MQYPGRSLVF	MQYPRSLVF
AQLWTDLQY	AQLWTDLQY
MKAAFQSQY	MKAAFQSQY
AMNPTNTVF	AMNPTNTVF
VNLPINGNGKQ	NLPINGNGK
GKYRDAVSRY	GKYRAVSRY
AQGVILVY	AQG-VILVY
IQVDPNYAY	IQVDPNYAY
GQHRSTIITLY	GQHRTIITL
KHLPASNVSF	KHLPSNVSF
RKLTQETTY	RKLTQETTY
AKKGIDYDF	AKKGIDYDF
RKKTERLAF	RKKTERLAF
KKVNVQVSF	KKVNVQVSF
RQVKGDLAF	RQVKGDLAF
GKSYSVALY	GKSYSVALY
AKYIVSVGY	AKYIVSVGY
LLEGEESR	LLE-GEESR
RKDPRQIFF	RKDPRQIFF
YKIAFPYLY	YKIAFPYLY
RKLDKLTVL	RKLDKLTVL
VKVKDSTEY	VKVKDSTEY
LKAPALPLL	LKAPALPLL
IKISNPTEF	IKISNPTEF
NQRLAYVTY	NQRLAYVTY
RKAVSYAKF	RKAVSYAKF
SKYVSLITSY	SKYVLITSY
KQMTFEAQAF	KQMTEAQAF
TKKGIGPVY	TKKGIGPVY
YQIKVHRKY	YQIKVHRKY
KKELTGRTL	KKELTGRTL
GKSFTSNSY	GKSFTSNSY
YKVPHPLEH	YKVPHPLEH
AKKGEEALF	AKKGEEALF
RQEQTKRML	RQEQTKRML
AAESPAGRA	AAESPAGRA
VKVPTTLAEY	VKVPTLAEY
AKVINDGLFYY	AKVIDGLFY
RKQLHKLRY	RKQLHKLRY
SKPASNPKF	SKPASNPKF
RKAALKNAF	RKAALKNAF
AKAPVGPVT	AKAPVGPVT
AQYSQDYQQF	AQYSDYQQF
GKNITQLSY	GKNITQLSY
KKYQLTNAF	KKYQLTNAF
RKLDQVSQF	RKLDQVSQF
SKAPAPVTY	SKAPAPVTY
KKVAVATPA	KKVAVATPA
FHLEAREVY	FHLEAREVY
KKLDSQISL	KKLDSQISL
AQRKTLSGF	AQRKTLSGF
GKAPNILLY	GKAPNILLY
TQAPIFISF	TQAPIFISF
AKASLNGADIY	AKASLNGAD
AKIGGIITVF	AKIGIITVF
AQAFIHNSLY	AQAFIHNSL
MKLSLVAAM	MKLSLVAAM
QQKYPTKVSF	QKYPTKVSF
RKELESRAL	RKELESRAL
RQYDKFLTH	RQYDKFLTH
VKIGALEGY	VKIGALEGY
RLRDENGRPY	RLRDNGRPY
IKDPKEREF	IKDPKEREF
YQKQPKIGY	YQKQPKIGY
RQAVFTAKY	RQAVFTAKY
KQWLSKKSTY	KQWLKKSTY
VKADGHKVY	VKADGHKVY
GKSTSIQSF	GKSTSIQSF
RHYYSITINY	RHYYITINY
THYQLGLAY	THYQLGLAY
KQFQKVITEY	KQFQVITEY
AKILNHPRVY	AKILHPRVY
LKYEPTNVRY	LKYETNVRY
KKYNMRVEDY	KKYNRVEDY
AQRSTETAL	AQRSTETAL
SKVPSAPHF	SKVPSAPHF
KLFLTGESY	KLFLTGESY
VGEFSGANK	VGEFSGANK
IKNQLIEQF	IKNQLIEQF
AKPDSTLHTY	AKPDTLHTY
RVYIHPFHL	RVYIHPFHL
VQADVQKERY	VQADQKERY
VQIPPSTTY	VQIPPSTTY
GKAFSLRSY	GKAFSLRSY
GKYQEALSY	GKYQEALSY
LKKDDSVGY	LKKDDSVGY
KKAIQDPAF	KKAIQDPAF
AQAHFNNGEY	AQAHNNGEY
GKNLYTNEY	GKNLYTNEY
AMHPQVNIY	AMHPQVNIY
GKYKFLQKY	GKYKFLQKY
RGFYSVETF	RGFYSVETF
AKKYIDQKF	AKKYIDQKF
SKLKETSPL	SKLKETSPL
SKLLLPITY	SKLLLPITY
TMKPSETSF	TMKPSETSF
RKPPAPKSTY	RKPPPKSTY
VQRGIGTAY	VQRGIGTAY
KQYLPNIAY	KQYLPNIAY
HKVSPMLY	HKV-SPMLY
SKYEKLAKI	SKYEKLAKI
KKKIPSLSF	KKKIPSLSF
NKFYSGTGY	NKFYSGTGY
GKVFATTGY	GKVFATTGY
AQSHVKISF	AQSHVKISF
RKAPQHTAVGF	RKAPQHTAV
GKVFSRITY	GKVFSRITY
RQLAHIYHY	RQLAHIYHY
HHYLISIY	HHY-LISIY
GKYGFSDPLTF	GKYGFSDPL
SHIPQSSSY	SHIPQSSSY
GKNPFLGIAY	GKNPLGIAY
YAKLNPGIAY	AKLNPGIAY
AQVQYPLQTF	AQVQPLQTF
IMVKPHEEY	IMVKPHEEY
PQRATSNVF	PQRATSNVF
GKFFSRLSY	GKFFSRLSY
GKYPSWTFY	GKYPSWTFY
GKAFNRSSY	GKAFNRSSY
THAANTVVY	THAANTVVY
KQFDAGTVNY	KQFDGTVNY
GKYAVIGTY	GKYAVIGTY
WKHAGKQDY	WKHAGKQDY
GKTTQVTQF	GKTTQVTQF
IQKPGSNAF	IQKPGSNAF
GKAFSRSSF	GKAFSRSSF
YKVTTQTSL	YKVTTQTSL
QQRVVRVY	QQR-VVRVY
GQYPYPSGF	GQYPYPSGF
AKFRENVEDVF	AKFRENVED
VQLILHEY	VQL-ILHEY
AKYLDEDTIY	AKYLEDTIY
GKAPHGPSF	GKAPHGPSF
KQAPPQKVSF	KQAPQKVSF
RKVDVEEEF	RKVDVEEEF
GQVQVRTLY	GQVQVRTLY
LKFIPHKDY	LKFIPHKDY
VKLPSGEDY	VKLPSGEDY
AQNPSGETAF	AQNPGETAF
GKALEVAEY	GKALEVAEY
GKLEDIPAFF	GKLEDIPAF
RKFLESTDSF	RKFLSTDSF
SIPEKNRPL	SIPEKNRPL
GKYGSSLEF	GKYGSSLEF
MKFMTQSAF	MKFMTQSAF
THYIQHLSF	THYIQHLSF
KKHYAPLQAY	KHYAPLQAY
KHFEVLISY	KHFEVLISY
RKILSRLF	RKI-LSRLF
AKSVPTKTY	AKSVPTKTY
KQISVGFIGY	KQISGFIGY
AKHIFPVTF	AKHIFPVTF
KKALAAAGY	KKALAAAGY
GKVFSRNSY	GKVFSRNSY
GKPGHLQFY	GKPGHLQFY
RHVDAMNEY	RHVDAMNEY
AMIARELLY	AMIARELLY
AKPLKLYVY	AKPLKLYVY
RKDLFIATY	RKDLFIATY
HQYSIQVAF	HQYSIQVAF
TQVILREY	TQV-ILREY
RKTEYISTEF	RKTEISTEF
GKFASVFVY	GKFASVFVY
LSVKEKNISI	VKE-KNISI
RQFPTAFEF	RQFPTAFEF
RQVSTLNSY	RQVSTLNSY
AKAAEAAASAY	KAAEAASAY
AKVKFEERY	AKVKFEERY
GQYSPPPYSEY	GQYSPYSEY
AKRGAFGHERY	RGAFGHERY
AAFTLRTQY	AAFTLRTQY
RKIASRNEF	RKIASRNEF
KKQDPDVPF	KKQDPDVPF
AHYNLQNAF	AHYNLQNAF
GKAFSYRSY	GKAFSYRSY
KKIPSTVEF	KKIPSTVEF
SKIETRGTRY	SKIERGTRY
KQFEKQVELY	KQFEKQVEL
GKYASPDVF	GKYASPDVF
RKFQPYKPFYY	RKFQPYKPF
IKYDPSIGIY	IKYDSIGIY
KKIEMVRAY	KKIEMVRAY
RKLPEKTQTF	RKLPKTQTF
AKVSGGPSL	AKVSGGPSL
GAYEQVIKY	GAYEQVIKY
GKRPPGVLH	GKRPPGVLH
FQFLPHAYY	FQFLPHAYY
LKYEHKEIEY	LKYEKEIEY
RKPLTTSGF	RKPLTTSGF
RKHQINIEKY	RKHQNIEKY
FKYNKPAFL	FKYNKPAFL
SKYEALQTF	SKYEALQTF
AKLVSEKLASY	KLVSKLASY
GARPVELGF	GARPVELGF
GQRKEVEVF	GQRKEVEVF
KKAVPKEDIY	KKAVKEDIY
NQVIFPVSY	NQVIFPVSY
GKYMQAVIQY	GKYMAVIQY
RLYGKDYNVY	RLYGDYNVY
GKISDARVV	GKISDARVV
KKFSIEKRF	KKFSIEKRF
YGQTGAGKTYT	GQTGAGKTY
KKFSNPYSIEY	KKFSYSIEY
GKTVQIPVY	GKTVQIPVY
SLVNLGGSK	SLVNLGGSK
KKLPKGTVSF	KKLPGTVSF
KNHEFIATF	KNHEFIATF
AKINEIRQM	AKINEIRQM
GKVGGLLAF	GKVGGLLAF
KKAEIGIAM	KKAEIGIAM
KKFFGEFTGF	KKFFEFTGF
RKEPGQRLL	RKEPGQRLL
AKIAVVEKY	AKIAVVEKY
KKPAFNLSAF	KKPANLSAF
KQVKYFIHY	KQVKYFIHY
AMVGHQVSF	AMVGHQVSF
KKYGAAMVVM	KKYGAMVVM
LSDIKGLIKY	SDIKGLIKY
GKWMGIAF	GKW-MGIAF
FQYSKSPSL	FQYSKSPSL
RKYAFELKM	RKYAFELKM
RHMEQHVSF	RHMEQHVSF
RKILPRSDY	RKILPRSDY
DPFNPFELTNH	FNPFELTNH
GKEKLPRYY	GKEKLPRYY
IQVVSKNLY	IQVVSKNLY
AKQLSAQSY	AKQLSAQSY
KKYLTEGLLQF	KKYLTEGLL
RMVLVNAVY	RMVLVNAVY
IQLLQKLTY	IQLLQKLTY
AQYDQASTKY	AQYDASTKY
GHYPRHIVF	GHYPRHIVF
RQAPVLLQTY	RQAPLLQTY
KMYDAAKLLY	KMYDAKLLY
MQHRYIELF	MQHRYIELF
GKVAVVAGY	GKVAVVAGY
QKIQGEGNPY	QKIQEGNPY
GKINETINY	GKINETINY
GKSKGFGFVSF	SKGFGFVSF
RKFAYLGRLA	RKFAYLGRL
GQHGYSTGY	GQHGYSTGY
GQIKTVYPASY	IKTVYPASY
SKINHEPTTF	SKINEPTTF
VQYRYFKGY	VQYRYFKGY
GKQQWQQLY	GKQQWQQLY
VKDAKIAVY	VKDAKIAVY
AKINFDSNSAY	AKINSNSAY
AKIFGIQSF	AKIFGIQSF
GQGFALVY	GQG-FALVY
VKDDIFRIY	VKDDIFRIY
AQAMFNLGY	AQAMFNLGY
SKNPSKESF	SKNPSKESF
YKPVANHQY	YKPVANHQY
GKIGYYLVL	GKIGYYLVL
RKKPGLAITF	RKKPLAITF
YKVPAGVSL	YKVPAGVSL
TKYQVTWY	TKY-QVTWY
RQYPEVIKY	RQYPEVIKY
AGYTARVY	AGY-TARVY
HQQPPSQQY	HQQPPSQQY
LQIATHTAF	LQIATHTAF
AKYIETSEL	AKYIETSEL
RKAVSKLY	RKA-VSKLY
SQFPQPQHF	SQFPQPQHF
GKLGFLASY	GKLGFLASY
YQSPVRVY	YQS-PVRVY
AKSTLRVLY	AKSTLRVLY
GQDPHSSQAF	GQDPSSQAF
RKIEDNEFHY	RKI-EDNEF
TQREFMLSF	TQREFMLSF
GKWKQISKY	GKWKQISKY
IKADHVSTY	IKADHVSTY
KKNPFHLEL	KKNPFHLEL
HQLRAQILAY	HQLRQILAY
YKNRTILGY	YKNRTILGY
GKVMGKVFF	GKVMGKVFF
KKMTLQTGF	KKMTLQTGF
SAYAQIVQF	SAYAQIVQF
KKAMTVGEY	KKAMTVGEY
RKIEARVSA	RKIEARVSA
AQIPPHAVM	AQIPPHAVM
RKIDAAKNTF	RKIDAKNTF
GKAFTHYSTY	GKAFHYSTY
GKTFSNSSY	GKTFSNSSY
RKVPFGKTY	RKVPFGKTY
TKFQEAVTF	TKFQEAVTF
AQYEDIAQK	AQYEDIAQK
KKLSEPSSLQY	KKLSEPSSL
LKVKGNVF	LKV-KGNVF
LQAMPRTEF	LQAMPRTEF
SKAAPSRLF	SKAAPSRLF
KMKEIAEAY	KMKEIAEAY
YKIYPGHGRRY	KIYPHGRRY
AKVDATADY	AKVDATADY
KKPDQHFKPY	KKPDHFKPY
IQAGIFQEF	IQAGIFQEF
VHRATGHEF	VHRATGHEF
HQYNPKFQTLF	HQYNKFQTL
KKKVERLTM	KKKVERLTM
AKISTLPQL	AKISTLPQL
KQYGFFSYL	KQYGFFSYL
GQTLFAGY	GQT-LFAGY
FQNNTTNRY	FQNNTTNRY
SKFSQKIRY	SKFSQKIRY
GKSSVINAM	GKSSVINAM
KKYAEALDY	KKYAEALDY
RKKAYADFY	RKKAYADFY
MMYSGELKF	MMYSGELKF
AQNLSIIQY	AQNLSIIQY
YQFTGIKKY	YQFTGIKKY
RKLTDDELFQY	RKLTDDELF
GQYTGHEY	GQY-TGHEY
LQYSGKTTF	LQYSGKTTF
FQKVITEY	FQK-VITEY
AQRIQNGSY	AQRIQNGSY
RKAQSVYSSY	RKAQVYSSY
AKVDRLEAF	AKVDRLEAF
QKVKLFTAH	QKVKLFTAH
KKTFSYAGF	KKTFSYAGF
FKIDDQRRTH	FKIDQRRTH
SKTGSVTTTY	SKTGVTTTY
IQVKVRDTY	IQVKVRDTY
AKILADQQDKY	AKILQQDKY
TLYETIIGY	TLYETIIGY
SQVPQQSHF	SQVPQQSHF
GKLFSQLSY	GKLFSQLSY
AKYDWEQKY	AKYDWEQKY
RQYEGHVNEY	RQYEHVNEY
SKIRVPVRY	SKIRVPVRY
GQRTFGENY	GQRTFGENY
AKLPSETIF	AKLPSETIF
GKLPNFGFVVF	GKLPGFVVF
RGYYSLETF	RGYYSLETF
AKFAEEFYSF	AKFAEFYSF
HVGKTPIVG	HVGKTPIVG
GKLGNESVTFY	GKLGESVTF
AKVATGRVL	AKVATGRVL
AKAQSGLAF	AKAQSGLAF
SKLPSSIEY	SKLPSSIEY
KQRLQQLF	KQR-LQQLF
AQYEHDLEV	AQYEHDLEV
AKTDNVVQAK	AKTDNVVQA
YMRDPDDQY	YMRDPDDQY
GKRTDEAAF	GKRTDEAAF
GQLPGLHEY	GQLPGLHEY
RKNPQHKIEY	RKNPHKIEY
GQNKKVMIY	GQNKKVMIY
KKHLVSAGY	KKHLVSAGY
ILAARSPVF	ILAARSPVF
YKQLGYSVY	YKQLGYSVY
QKLPVANEY	QKLPVANEY
AKRFDVSGY	AKRFDVSGY
RKTEPATGF	RKTEPATGF
YQTAPKAGY	YQTAPKAGY
RKYESVLQL	RKYESVLQL
AKYESQTSF	AKYESQTSF
YKFYSVNVDY	YKFYVNVDY
RKNPEFRVQF	RKNPFRVQF
FKAPITSEF	FKAPITSEF
AKRPKFLTTY	AKRPFLTTY
AQNAVRLHY	AQNAVRLHY
GKIADRFLLY	GKIARFLLY
RQLQQLISF	RQLQQLISF
AQFPSSGRF	AQFPSSGRF
GQTKQVTVY	GQTKQVTVY
LQHDNIIAY	LQHDNIIAY
TKAVSSVKF	TKAVSSVKF
YKVFREEKY	YKVFREEKY
AKLGKEIEEY	AKLGEIEEY
LKHKFITRY	LKHKFITRY
IKPDGLLEF	IKPDGLLEF
GKHQPHKVTQY	HQPHKVTQY
GKPLGPRTLY	GKPLPRTLY
RQQEERKRLY	RQQERKRLY
AAAPVIKAY	AAAPVIKAY
IQYKTLRTF	IQYKTLRTF
GKLVQIEY	GKL-VQIEY
YKYSGRDSL	YKYSGRDSL
AKPTRLNVF	AKPTRLNVF
RLFKDQLVY	RLFKDQLVY
ILYNIKQEY	ILYNIKQEY
MPYLEHESF	MPYLEHESF
RAYFELSEY	RAYFELSEY
RKNPVTSTY	RKNPVTSTY
KKVAPAPAV	KKVAPAPAV
AKAAEEAKKF	AKAAEAKKF
ILTVGGTAY	ILTVGGTAY
IQRTEAYEY	IQRTEAYEY
AKAQALVQY	AKAQALVQY
GQVKAAVKY	GQVKAAVKY
GQEVSPKVY	GQEVSPKVY
AQHLFIQTF	AQHLFIQTF
QQNLNTITY	QQNLNTITY
YKRISRVEF	YKRISRVEF
YKIDGSLEV	YKIDGSLEV
GKTSLITRF	GKTSLITRF
FQYDSTHGKF	FQYDTHGKF
GKAFSQSAY	GKAFSQSAY
VKLDPRPEY	VKLDPRPEY
AQRPTATY	AQR-PTATY
IKAIFPNGQF	IKAIPNGQF
SKYSNSDVIIY	SKYSNSDVI
IKHSTPSPTRY	KHSTSPTRY
GKAITFVTQY	GKAIFVTQY
KKYNMKLVY	KKYNMKLVY
YKAKYPIVGY	AKY-PIVGY
GKVRPYSVY	GKVRPYSVY
KKWFSDHRY	KKWFSDHRY
AKPQHVTETF	AKPQVTETF
AKLDELKLKY	AKLDLKLKY
RMIYLVTEY	RMIYLVTEY
LQLDRISVY	LQLDRISVY
FQAMGKTSF	FQAMGKTSF
RKAEAAVVA	RKAEAAVVA
AGGYFTSPGGY	GGYFSPGGY
RKKINSTTLY	KKINSTTLY
GKFKQAETLY	GKFKQAETL
SKAPAGSSL	SKAPAGSSL
YKYEGVRGLY	YKYEVRGLY
SQDPGTHVV	SQDPGTHVV
IKHPNLVRY	IKHPNLVRY
RSAIFSITY	RSAIFSITY
RKYGNANVWKY	RKYGNANVW
KKIRTSPTF	KKIRTSPTF
AQRASVAF	AQR-ASVAF
AMLRQLAQY	AMLRQLAQY
FKRDLEWVERL	FKRDWVERL
RQYSRNEPLTF	RQYSRNEPL
AQRAFILTV	AQRAFILTV
AKFIASTGM	AKFIASTGM
RKANILTNRY	RKANLTNRY
NARLAADD	NAR-LAADD
RLWISVARY	RLWISVARY
NKVISSVSY	NKVISSVSY
KGFAFVQY	KGF-AFVQY
AKMKGFDVF	AKMKGFDVF
KKYDGRTKPIP	KKYDGRTKP
VQQVAAEY	VQQ-VAAEY
AKLQQTTQL	AKLQQTTQL
AKRPELRNY	AKRPELRNY
RKFQEQNETF	RKFQQNETF
RQLSFTGVTF	RQLSTGVTF
AKIALMNSVF	AKIAMNSVF
GKVGPMIGQY	GKVGMIGQY
KKGILLQLF	KKGILLQLF
GKGGFGTVF	GKGGFGTVF
SKIDYFLEY	SKIDYFLEY
RSFPGFQAF	RSFPGFQAF
AQIEGVVPF	AQIEGVVPF
KQQQPPTVY	KQQQPPTVY
RHLEPALAF	RHLEPALAF
KQYLAVVF	KQY-LAVVF
FKKPGSKNF	FKKPGSKNF
GKSFSRSSF	GKSFSRSSF
RKFSENPHVY	RKFSNPHVY
LHYMGTSTF	LHYMGTSTF
LQFNPKFMTF	LQFNKFMTF
LAGDKSRPF	LAGDKSRPF
KKPELVISY	KKPELVISY
GKLIWKVTDY	GKLIKVTDY
IKDPGPTRTF	IKDPPTRTF
EQYEQILAF	EQYEQILAF
YKLDKQHTF	YKLDKQHTF
IQNDRQLQY	IQNDRQLQY
RKLFGFTERY	RKLFFTERY
GKSSVIQVF	GKSSVIQVF
VEWEGTTPY	VEWEGTTPY
KKISSKINY	KKISSKINY
AEQRGENALKD	AEQRGENAL
AKPTLQLVY	AKPTLQLVY
LKIGDTVSF	LKIGDTVSF
VHAPPMQLGF	VHAPMQLGF
KLFPGSPAIY	KLFPSPAIY
VQKEDIEVY	VQKEDIEVY
KKKAEGTVF	KKKAEGTVF
FKYDDAERRFY	FKYDAERRF
AQLKDYITY	AQLKDYITY
AKLPFTPLSY	AKLPTPLSY
REIESSPQY	REIESSPQY
AQAPAGTSF	AQAPAGTSF
TKVGPNATY	TKVGPNATY
FKLEPLQAY	FKLEPLQAY
RKVQPPQNY	RKVQPPQNY
RTAPSGSEY	RTAPSGSEY
YQYSDQGIDY	YQYSQGIDY
TQRLVQVM	TQR-LVQVM
YKYEAPWTVY	YKYEPWTVY
RKIAVAKQNY	RKIAAKQNY
RQIKHMIKY	RQIKHMIKY
VSGSQRISSIY	SQR-ISSIY
RKAVTVVKF	RKAVTVVKF
RKWDDDYVRY	RKWDDYVRY
GKAFTRVNY	GKAFTRVNY
VKALMRFAF	VKALMRFAF
AQRQEIRTAY	AQRQIRTAY
GKLDQPDRFSF	GKLDQPDRF
LQHDYGHLSVY	LQHDHLSVY
GKYGTLQEF	GKYGTLQEF
SQRSTATMY	SQRSTATMY
FKEGKERMY	FKEGKERMY
SVPEAQSAL	SVPEAQSAL
KAFDFPSSF	KAFDFPSSF
AHNPQQIYF	AHNPQQIYF
LQIGVIRVY	LQIGVIRVY
HYLKGLKIEKM	LKGLKIEKM
AAVGTGSSY	AAVGTGSSY
IKADHVST	IKA-DHVST
AQVSRRISF	AQVSRRISF
MKVLLAAAL	MKVLLAAAL
KKIADFLNSF	KKIAFLNSF
LKFDSKYMNF	LKFDKYMNF
KKIEDNNTL	KKIEDNNTL
SKLEHTAQTY	SKLETAQTY
YKIPYTTVL	YKIPYTTVL
GQFSKPFSF	GQFSKPFSF
YKPDVKIEY	YKPDVKIEY
GKYVSVGAF	GKYVSVGAF
LKMIPRIDY	LKMIPRIDY
IQFNLRNLY	IQFNLRNLY
RQFWFQGNRY	RQFWQGNRY
KKWFSDTRY	KKWFSDTRY
SQVDSKSTF	SQVDSKSTF
GKAPGAEEY	GKAPGAEEY
SKYLHVGY	SKY-LHVGY
FQAPTAKEM	FQAPTAKEM
LKEGGHRVL	LKEGGHRVL
RQWKPQLGF	RQWKPQLGF
AQRQEISAAF	AQRQISAAF
GKAFSQSSY	GKAFSQSSY
GKRLDVTGF	GKRLDVTGF
KKYAEVLRY	KKYAEVLRY
AQILLKAL	AQI-LLKAL
IKKEFDKKY	IKKEFDKKY
GQYSTGKTTF	GQYSGKTTF
GQIEHKLAF	GQIEHKLAF
KQILLENTF	KQILLENTF
TQFINPETPGY	TQFINPETP
RKYHKLGTGF	RKYHLGTGF
KKVSKAAIL	KKVSKAAIL
LQRVGAGTY	LQRVGAGTY
GKAFSRSTY	GKAFSRSTY
HQITVLHVY	HQITVLHVY
AKTPQKSVSF	AKTPKSVSF
GKVVKVTIM	GKVVKVTIM
NSKLPSSIEY	SKLPSSIEY
AKQRLQQLF	AKQRLQQLF
LMYVGRVVF	LMYVGRVVF
SKLLANMVY	SKLLANMVY
SQVPTQMSF	SQVPTQMSF
NKADVILKY	NKADVILKY
LQAVFVQSY	LQAVFVQSY
RQIDQFLVV	RQIDQFLVV
GKVGSQSSF	GKVGSQSSF
GQLVRSILY	GQLVRSILY
AKHIFKTY	AKH-IFKTY
KHQEHILRF	KHQEHILRF
KMRPGEATL	KMRPGEATL
KKLLSLLTF	KKLLSLLTF
RKSEVSPRI	RKSEVSPRI
AKIKGKNSF	AKIKGKNSF
KKSEPEPVY	KKSEPEPVY
AQIFRPLKF	AQIFRPLKF
GKFQDNFEF	GKFQDNFEF
LQHPNIVGY	LQHPNIVGY
KKFVETPGQKY	KKFVPGQKY
VKVDLSEKY	VKVDLSEKY
AQRRDPSIHY	AQRRPSIHY
AQRKFRPY	AQR-KFRPY
FKRKYGKSL	FKRKYGKSL
RMIDLLEEY	RMIDLLEEY
KKYPFILEV	KKYPFILEV
KKFNSSVLSF	KKFNSVLSF
AKKLFGSTF	AKKLFGSTF
YQTAISENY	YQTAISENY
RQAKEERTF	RQAKEERTF
AQHYTETAL	AQHYTETAL
RKWAPPKFLPH	RKWAPPKFL
GKAFGDSSY	GKAFGDSSY
AKLPGGVQNF	AKLPGVQNF
YHIGIPLTY	YHIGIPLTY
AKLHAALYER	AKL-HAALY
AHSVPSPAF	AHSVPSPAF
KKPITTGGVTY	KKPIGGVTY
GQVYSELKY	GQVYSELKY
YKLELEQTY	YKLELEQTY
PPHPPPPPP	PPHPPPPPP
YKTPHRVAF	YKTPHRVAF
KMHQSRISY	KMHQSRISY
RQYHLQQLFY	RQYHLQQLF
VKYIQQENF	VKYIQQENF
RKAAITIQSSY	AAITIQSSY
KKYTEITATY	KKYTITATY
AKAPFAAHGY	AKAPAAHGY
SKFQPQSPDFL	SKFQQSPDF
SHHLVARVY	SHHLVARVY
IGQSKSVKIY	GQSKSVKIY
GQKPGGSDF	GQKPGGSDF
AKYRKIHLF	AKYRKIHLF
AKANPQVL	AKA-NPQVL
PLRNPIIY	PLR-NPIIY
KQIHFLYQY	KQIHFLYQY
AKYFIRDEF	AKYFIRDEF
AKFSPVATASY	AKFSPVATA
RQREMEEQM	RQREMEEQM
AKHPGLGEY	AKHPGLGEY
GQKLAEQMF	GQKLAEQMF
SQHQAIERF	SQHQAIERF
YKVDNLEEF	YKVDNLEEF
IKYNTIETF	IKYNTIETF
PHVSPRHSF	PHVSPRHSF
VQVKRIHEY	VQVKRIHEY
LQAPAFTGY	LQAPAFTGY
YKAPILLAL	YKAPILLAL
GKTFSQTSY	GKTFSQTSY
RQVLTSSF	RQV-LTSSF
VHRQFAIVF	VHRQFAIVF
AKVDQNRVRY	AKVDNRVRY
RKRLEAQGY	RKRLEAQGY
RQYEQQTY	RQY-EQQTY
YKVETKKY	YKV-ETKKY
KKLEKETTMY	KKLEETTMY
KKIESSGVTY	KKIESGVTY
GKIFTFGSY	GKIFTFGSY
RMKTGNKIRY	MKTGNKIRY
AKRMVEHKF	AKRMVEHKF
YKYLNQTSRSF	YLNQTSRSF
AQYSQDYQQFY	AQYSDYQQF
GKSEVTSSF	GKSEVTSSF
VQGLLSETY	VQGLLSETY
RKFKWGKGF	RKFKWGKGF
GQTGTGKTF	GQTGTGKTF
SHYVAFVKY	SHYVAFVKY
LKTGISDVF	LKTGISDVF
RKNLPSTAL	RKNLPSTAL
KKADVDAIHEY	KKADAIHEY
RQPDSPTALY	RQPDSPTAL
KRFEPGTQRF	KRFEGTQRF
KQSQILLVY	KQSQILLVY
RQLDRNLTF	RQLDRNLTF
KKMVSKYKY	KKMVSKYKY
MKFKPNQTRTY	FKPNQTRTY
IAPTGHSL	IAP-TGHSL
KQVASSTGF	KQVASSTGF
SKWNTRESY	SKWNTRESY
AKKFEASGF	AKKFEASGF
GQRPTQPVY	GQRPTQPVY
VKRSAAEMY	VKRSAAEMY
GKREGIDQSY	GKREIDQSY
YGSKPLNIAY	GSKPLNIAY
KKMPSKTSL	KKMPSKTSL
YKIDEDGKKF	YKIDDGKKF
VKAEIRQQF	VKAEIRQQF
YKILGGSVL	YKILGGSVL
RQYDGIFYEF	RQYDIFYEF
GKTDPGTVF	GKTDPGTVF
AKYPASTVQIL	AKYPSTVQI
QQFRNAPPF	QQFRNAPPF
TAYPGQTQY	TAYPGQTQY
GHFGPINSVAF	FGPINSVAF
KQFHRIVTY	KQFHRIVTY
AKKRDIYDKY	KKRDIYDKY
GKYFDKASY	GKYFDKASY
KKRPETVATQF	KKRPVATQF
YKIKYPENF	YKIKYPENF
IQNPDPAVY	IQNPDPAVY
GKAFTQSAY	GKAFTQSAY
YKMDPTKQY	YKMDPTKQY
AHRNPKIGY	AHRNPKIGY
KKASIGYTY	KKASIGYTY
RHFGTILNY	RHFGTILNY
TQTLVREY	TQT-LVREY
TQIPTETTY	TQIPTETTY
AKLFPGSPAIY	KLFPSPAIY
AKVDLNSNGF	AKVDNSNGF
RQYLDQQQY	RQYLDQQQY
RKSQVSIRY	RKSQVSIRY
AKVDTDGNGY	AKVDDGNGY
RKIEAEIVRI	RKIEAEIVR
GKVKLVVRY	GKVKLVVRY
RQLEDILSTY	RQLEILSTY
VKAPGKSSF	VKAPGKSSF
AKGWAPTF	AKG-WAPTF
KKIEFGVVY	KKIEFGVVY
KKLSSAVVF	KKLSSAVVF
SNYHFGVTY	SNYHFGVTY
KKYPFILEVY	KKYPILEVY
KGRVFEVSL	KGRVFEVSL
RKVKIDKRF	RKVKIDKRF
GKHFGTILNY	GKHFTILNY
IQKQFEELY	IQKQFEELY
PQVSLSKLF	PQVSLSKLF
KKPDYKVAY	KKPDYKVAY
LKFNGALTM	LKFNGALTM
TQRLKIMEY	TQRLKIMEY
RKTVTAMDVVY	RKTVMDVVY
YMIERPEPEF	YMIEPEPEF
KKWEQDPETF	KKWEDPETF
KKKDFDTAL	KKKDFDTAL
KKAQNIMESF	KKAQIMESF
TKYMRDPTF	TKYMRDPTF
AHIKVGETY	AHIKVGETY
RKFHGYNSL	RKFHGYNSL
RQKELESNY	RQKELESNY
FKLGGVTASF	FKLGVTASF
IKENPSSQY	IKENPSSQY
IMEHRFKTY	IMEHRFKTY
KKFQSFQDH	KKFQSFQDH
QQMWISKQEY	QMWISKQEY
LRPLLAAAA	LRPLLAAAA
SKFDEQRTATY	SKFDEQRTA
KHADPRIQGY	KHADRIQGY
RKGQAVTL	RKG-QAVTL
TQFVSGSKY	TQFVSGSKY
RHSGPLRVAM	RHSGLRVAM
GQFLVRIIY	GQFLVRIIY
GQFPGHNEFF	GQFPGHNEF
IKHSTPSPTKY	KHSTSPTKY
SKLFSSVTF	SKLFSSVTF
FKEAEVRVY	FKEAEVRVY
KQFRPPMGGY	KQFRPMGGY
KKYAGGVAEY	KKYAGVAEY
RQFEGLQGY	RQFEGLQGY
FKGELIHVF	FKGELIHVF
AKRIGEVQV	AKRIGEVQV
VQISPMSAF	VQISPMSAF
QQEERKRLY	QQEERKRLY
YQYTIRAH	YQY-TIRAH
AKEFNPRSF	AKEFNPRSF
AQYDRQIRL	AQYDRQIRL
TKYLENQAF	TKYLENQAF
SKFGTGNKY	SKFGTGNKY
KGYPSEFATY	KGYPEFATY
KKFENTEMF	KKFENTEMF
RKFPSLRAV	RKFPSLRAV
RQVGATVEF	RQVGATVEF
AKITAQEAV	AKITAQEAV
FQFDVQRKY	FQFDVQRKY
SKYAPEEGNRY	SKYAEGNRY
KKIEVLDVSY	KKIELDVSY
RQYGQTVATY	RQYGTVATY
IQEESLRTY	IQEESLRTY
AQRAPGGLSY	AQRAGGLSY
AKAFLSTLF	AKAFLSTLF
RANPFNTPH	RANPFNTPH
KQYEVEIQTY	KQYEEIQTY
RLYTQGYISY	RLYTGYISY
SQMKSYQSF	SQMKSYQSF
YKRDFEAKL	YKRDFEAKL
SQYNIRGVTY	SQYNRGVTY
GQVKTGISM	GQVKTGISM
RQMAHVQIF	RQMAHVQIF
RQINWTVLY	RQINWTVLY
AKYGIPLAY	AKYGIPLAY
YKLLGGLAV	YKLLGGLAV
AQIVHAISY	AQIVHAISY
RKQPMSATL	RKQPMSATL
AKKDFEKKF	AKKDFEKKF
AKAGTEEAIVY	AKAGTEEAI
RKPFGSKMY	RKPFGSKMY
AQFKTSNSY	AQFKTSNSY
KKKEPEPNF	KKKEPEPNF
AKANPQYTVY	AKANQYTVY
IKVIPTLAL	IKVIPTLAL
GKHFSHAGALF	GKHFHAGAL
GKEETRRFY	GKEETRRFY
FKSGSPVATF	FKSGPVATF
RKYPENDLF	RKYPENDLF
AKLKKFIAY	AKLKKFIAY
SQRDYTQYY	SQRDYTQYY
SKIAGILHY	SKIAGILHY
RQAHLTNQY	RQAHLTNQY
RKYEKPQEL	RKYEKPQEL
VSYKGSISY	VSYKGSISY
AKAAGPLQVY	AKAAPLQVY
RKMEHDGSLF	RKMEDGSLF
YKLRAAEQY	YKLRAAEQY
RKWQQLQAKRY	RKWQQLQAK
LKVKDLRQY	LKVKDLRQY
SKLQNNNVY	SKLQNNNVY
LQIVHETGY	LQIVHETGY
GKRPFGVSL	GKRPFGVSL
SKVANTILF	SKVANTILF
KKVEQTIQY	KKVEQTIQY
RLYQHAVEY	RLYQHAVEY
RQPLITLQY	RQPLITLQY
VKYTQRVDY	VKYTQRVDY
SHLFVTSSF	SHLFVTSSF
SQRLESVSF	SQRLESVSF
RQYRAVVY	RQY-RAVVY
SKVGSRLGY	SKVGSRLGY
SKNVSGISF	SKNVSGISF
SQATPHSSY	SQATPHSSY
KKVFLGRDTY	KKVFGRDTY
AHAHPQEVY	AHAHPQEVY
GQHVFLVY	GQH-VFLVY
RQLEEEGITF	RQLEEGITF
VKEKATGRYY	VKEKATGRY
SQYQGVVVY	SQYQGVVVY
RGWKLQVSY	RGWKLQVSY
RQAGLSYIRY	RQAGSYIRY
SKLWIIMEY	SKLWIIMEY
MKSPFGSSF	MKSPFGSSF
RQALLIERY	RQALLIERY
YMYRHKGTY	YMYRHKGTY
HQLGNNSVF	HQLGNNSVF
HKRIHGVGF	HKRIHGVGF
YKIDPSTL	YKI-DPSTL
VLFEHAVGY	VLFEHAVGY
RQIGVEHVVVY	IGVEHVVVY
KQFDRKHHTY	KQFDKHHTY
GKAAAAVAF	GKAAAAVAF
AKYITEPEM	AKYITEPEM
RQYLQEVGY	RQYLQEVGY
AQHLTVSGF	AQHLTVSGF
GKPPFEANTY	GKPPEANTY
RKMNVSPDVNY	KMNVPDVNY
LQHASAVL	LQH-ASAVL
SGSQFEFTQF	SQF-EFTQF
VQRITQETF	VQRITQETF
VLSAADKGNV	LSAADKGNV
NKAEVHESY	NKAEVHESY
AKRPELRNYF	AKRPELRNY
SKIPHRVF	SKI-PHRVF
GKVTGDTVY	GKVTGDTVY
AQFLFGHY	AQF-LFGHY
SKIPAVTY	SKI-PAVTY
GKIQGIIAEY	GKIQIIAEY
IQASTVVTY	IQASTVVTY
HQLATDSTF	HQLATDSTF
GQYYKPEQF	GQYYKPEQF
IKPETILYY	IKPETILYY
RQYGSEGRFTF	RQYGSEGRF
AKVGTRLVF	AKVGTRLVF
TKRPGLMTKY	TKRPLMTKY
GKIGGAQNRSY	GKIGQNRSY
KQRTHVMRF	KQRTHVMRF
GQHSHVVRY	GQHSHVVRY
KMYSTDDGVQF	YSTDDGVQF
KKSDPVVSY	KKSDPVVSY
SKGIVVTAY	SKGIVVTAY
KQLKEAQVQY	KQLKAQVQY
RQLPRFSMY	RQLPRFSMY
FQRGYYRYY	FQRGYYRYY
KKFNEPGSQY	KKFNPGSQY
YKFKVIAY	YKF-KVIAY
GQITHIQY	GQI-THIQY
GQHNQSVNY	GQHNQSVNY
AKPAGGPKPP	AKPAGGPKP
KAPSAARSL	KAPSAARSL
VLYPHLSTY	VLYPHLSTY
FKSPAASSF	FKSPAASSF
IQHPSNVL	IQH-PSNVL
YHSFVSSVF	YHSFVSSVF
RKAVLTEY	RKA-VLTEY
SQRIFITY	SQR-IFITY
KKAPAGPSL	KKAPAGPSL
KKVERQTEL	KKVERQTEL
FKYPNFDVEY	FKYPFDVEY
AKPKIEHTY	AKPKIEHTY
FQLPGGHLEF	FQLPGHLEF
GKAFSSHAY	GKAFSSHAY
YKIKYPENFF	YKIKYPENF
RKEETVTVY	RKEETVTVY
RKKDWKTLY	RKKDWKTLY
AKAPSRMY	AKA-PSRMY
TQYIIHNY	TQY-IIHNY
VKKIDKYLY	VKKIDKYLY
GKDIGRGIGY	GKDIRGIGY
RAFDQGADAIY	RAFDQGADA
KGYAFVQY	KGY-AFVQY
IQTRGGTF	IQT-RGGTF
RAYLVRWEY	RAYLVRWEY
AKLEERTGY	AKLEERTGY
RKIKVSNTL	RKIKVSNTL
KKVAPQNDSF	KKVAQNDSF
GKHVPRAVF	GKHVPRAVF
RGYLARKAF	RGYLARKAF
MKIPTGQEY	MKIPTGQEY
LQLPARNLTY	LQLPRNLTY
AKQRLTPKL	AKQRLTPKL
FQTTISKY	FQT-TISKY
IKPGTSVEY	IKPGTSVEY
LKPYFLEAY	LKPYFLEAY
AQVWMITRY	AQVWMITRY
AGSKQLFMTAY	SKQLFMTAY
RKSDITSEL	RKSDITSEL
YKNIPQMSF	YKNIPQMSF
NQIPFIIQY	NQIPFIIQY
RKPEGGPSF	RKPEGGPSF
HQREIQVM	HQR-EIQVM
PQYQTWEEF	PQYQTWEEF
VKAVLAESY	VKAVLAESY
AGHLSTAQY	AGHLSTAQY
VKIKTKLFY	VKIKTKLFY
VVSEVDIAKAD	SEVDIAKAD
AQFPNGPQF	AQFPNGPQF
RAFPYGNVAF	RAFPGNVAF
AKFSLPVSL	AKFSLPVSL
RQYAKDIGF	RQYAKDIGF
AKTVLAIRY	AKTVLAIRY
RQFPFSSAL	RQFPFSSAL
RLYGPSSVSF	RLYGSSVSF
KKKQIEQKF	KKKQIEQKF
HHFLQVLTY	HHFLQVLTY
AQRQDIAF	AQR-QDIAF
GKRLNTREF	GKRLNTREF
RKQANRMSF	RKQANRMSF
AKNPSWASITY	AKNPASITY
ARIYHTIAY	ARIYHTIAY
SKAPVLTY	SKA-PVLTY
AKIERFEFY	AKIERFEFY
SKKIDRHMY	SKKIDRHMY
RKIIGGVDY	RKIIGGVDY
KKRPPLQEY	KKRPPLQEY
RKLSTFRESF	RKLSFRESF
HQAIHTIEY	HQAIHTIEY
ISRETGEPY	ISRETGEPY
AKYPIKQSL	AKYPIKQSL
HKLDISDEF	HKLDISDEF
REYEAQQQY	REYEAQQQY
SQRDPPHNNF	SQRDPHNNF
KQEEERGRVY	KQEERGRVY
SQALAIRSY	SQALAIRSY
GKAWGILTF	GKAWGILTF
KKAPLLLHY	KKAPLLLHY
KKDPVKKIF	KKDPVKKIF
KKYLDAEQSY	KKYLAEQSY
KKFAFVHISF	KKFAVHISF
GKVISSSSSF	GKVISSSSF
VQQVHVATY	VQQVHVATY
RQHRMMILY	RQHRMMILY
SKQAGQSVF	SKQAGQSVF
RQALLLLAL	RQALLLLAL
GKVTSIMQF	GKVTSIMQF
FKVLHIVNF	FKVLHIVNF
RKTFLKLAF	RKTFLKLAF
KQQNPRLVY	KQQNPRLVY
TKAEPSISY	TKAEPSISY
GQFASDVQF	GQFASDVQF
HQAPRQLFY	HQAPRQLFY
KKAPGSGAVF	KKAPSGAVF
IKLLETESF	IKLLETESF
AKIYQQNPEAY	YQQ-NPEAY
SKRIAQETF	SKRIAQETF
KKADLILSY	KKADLILSY
YKKELEKTY	YKKELEKTY
SKVDGKLSF	SKVDGKLSF
VMFPGNSPSY	VMFPNSPSY
RQLPSFQTF	RQLPSFQTF
KKFSGKHVVF	KKFSKHVVF
SQFIFEHSY	SQFIFEHSY
TVTEKPEVIDA	TEKPEVIDA
AKFNKKAERF	AKFNKAERF
RKPTVTHVHY	RKPTTHVHY
GQLGLLARY	GQLGLLARY
AKYPAESPDY	AKYPESPDY
RKREEIPLDF	RKREIPLDF
IKDNVVIVY	IKDNVVIVY
FSYGTKILY	FSYGTKILY
AQLPEKVEY	AQLPEKVEY
RKLFIGGLSF	RKLFGGLSF
RGFAHGSVY	RGFAHGSVY
RHGPPMHSY	RHGPPMHSY
AGYLGFKAY	AGYLGFKAY
AQRLVRVL	AQR-LVRVL
SKMFHPNVY	SKMFHPNVY
SGYEAAVY	SGY-EAAVY
RKQDYEQAVF	RKQDEQAVF
RKVYSILSL	RKVYSILSL
YKLLPHSEY	YKLLPHSEY
RKRYDAATTY	RKRYAATTY
RQWLIDTLY	RQWLIDTLY
QKYQSPVRVY	QKYQPVRVY
IKKIADDKY	IKKIADDKY
AKTGLTPLM	AKTGLTPLM
QQNPQPLIF	QQNPQPLIF
KKLDEQYQKY	KKLDQYQKY
KQLEDGRTL	KQLEDGRTL
RAYAKALHY	RAYAKALHY
YQYPRPLLI	YQYPRPLLI
VKVIDRILY	VKVIDRILY
RARELLVSY	RARELLVSY
AKHIFKTYL	AKHIFKTYL
KKHILVMSF	KKHILVMSF
IHNPTGRSY	IHNPTGRSY
HKKPFLAKY	HKKPFLAKY
AKYFIRDEFL	AKYFIRDEF
RMHQAIERF	RMHQAIERF
HKYSGKEGDKF	HKYSGKEGD
AKNNVVINY	AKNNVVINY
RQLGSLSKY	RQLGSLSKY
YKYKDFGQMGF	YKDFGQMGF
GQHVTAALY	GQHVTAALY
AQHKFLVAV	AQHKFLVAV
VKIQKHVTF	VKIQKHVTF
AKIKSLTEY	AKIKSLTEY
GKTIQTISF	GKTIQTISF
VQQVQRLPF	VQQVQRLPF
RQHNYTEAF	RQHNYTEAF
KGYAFIEY	KGY-AFIEY
RKFSTKVTL	RKFSTKVTL
AQVKPDGTY	AQVKPDGTY
RQLGLEHTRY	RQLGEHTRY
ALWIGTTSF	ALWIGTTSF
RAQPRGAVY	RAQPRGAVY
YKIGLVEAL	YKIGLVEAL
GKAFSQKQY	GKAFSQKQY
SQRSVRLY	SQR-SVRLY
LKNGALVVY	LKNGALVVY
KMYTDGSTF	KMYTDGSTF
YKRPQELETF	YKRPELETF
RKYWKNLTF	RKYWKNLTF
TVTEKPEVID	TVTEKPEVI
RQYLEEVGY	RQYLEEVGY
AKNPRINQL	AKNPRINQL
NKYLTAEAF	NKYLTAEAF
AKVLHGEQY	AKVLHGEQY
KLYEKFLEF	KLYEKFLEF
AQHEGESVSY	AQHEESVSY
AKFREIAEAY	AKFRIAEAY
ALLKTGAAY	ALLKTGAAY
AAAAAAPPDP	AAAAAPPDP
LKPGGVLTY	LKPGGVLTY
AKLDSLQTL	AKLDSLQTL
RMKETQKSIYY	RMKEQKSIY
SKIYPSREEY	SKIYSREEY
GQRKGAGSVF	GQRKAGSVF
IMKNPEVEF	IMKNPEVEF
GKGNFGEVY	GKGNFGEVY
AQEDAQRLY	AQEDAQRLY
RKLTSNLRIGF	RKLTSNLRI
AKRSDELSF	AKRSDELSF
IKAAFKTSY	IKAAFKTSY
SQYRIKEY	SQY-RIKEY
GYSFTTTAER	YSFTTTAER
GKFDWRQQY	GKFDWRQQY
RKAKQKLGF	RKAKQKLGF
LKKTEVSRY	LKKTEVSRY
VQENGQRKY	VQENGQRKY
GKFGHEFLEF	GKFGEFLEF
AAAAAQSVY	AAAAAQSVY
GKINVVPQF	GKINVVPQF
FKPEEIQTVY	FKPEIQTVY
LKPQVSSIF	LKPQVSSIF
AKAYPPTSM	AKAYPPTSM
AQIYQLIEY	AQIYQLIEY
HKFPDEDSY	HKFPDEDSY
TKFPAEQYY	TKFPAEQYY
FQHVGKAF	FQH-VGKAF
AKLPDFESRY	AKLPFESRY
RLINTQAIF	RLINTQAIF
VQFGANKSQY	VQFGNKSQY
KQFQFGHAL	KQFQFGHAL
RQVAPASGY	RQVAPASGY
RKVKFTQQNY	RKVKTQQNY
AKRDVPALDRY	AKR-DVPAL
RQAHMQARF	RQAHMQARF
KQFKSEAY	KQF-KSEAY
RKVLVKVDEY	RKVLKVDEY
SQVPVKHVY	SQVPVKHVY
LMVGTSIHY	LMVGTSIHY
RGFLAREQY	RGFLAREQY
LAPLKYLAL	LAPLKYLAL
YKAPITNEF	YKAPITNEF
RKKPPMNSM	RKKPPMNSM
GKAFNGKAY	GKAFNGKAY
RKIEEIKDF	RKIEEIKDF
AQFHPDGLIF	AQFHDGLIF
AKLPSRPADNY	AKLPSRPAD
RKHGVVPLATY	HGVVPLATY
AQAQLQKRY	AQAQLQKRY
GKLWNLNNY	GKLWNLNNY
YLLPDTKAY	YLLPDTKAY
TKNISAISY	TKNISAISY
GQRGSGSSF	GQRGSGSSF
RKQIFILLF	RKQIFILLF
AKSGVGTAL	AKSGVGTAL
KQMEQISQF	KQMEQISQF
AKVSSNKTGF	AKVSNKTGF
ALFRTIITY	ALFRTIITY
KKPTGLVTF	KKPTGLVTF
THRPVNVVNVY	RPVNVVNVY
KKRPGIETLF	KKRPGIETL
NVKVDPEIQ	NVKVDPEIQ
RMVEMFLEY	RMVEMFLEY
RKFPVPKPIDY	RKFPKPIDY
HKFAKDFMTY	HKFADFMTY
KQFGNILIL	KQFGNILIL
HQRSFTETM	HQRSFTETM
KKFSLPLYF	KKFSLPLYF
AKSNELFTTF	AKSNLFTTF
SKHPGHYAVY	SKHPHYAVY
GQRSYLVQY	GQRSYLVQY
RQSTPRVSF	RQSTPRVSF
VQRNHETAF	VQRNHETAF
KKFQRPHDY	KKFQRPHDY
SKQETGTEF	SKQETGTEF
RQLEAARY	RQL-EAARY
AQYEDIAQKS	AQYEDIAQK
RKHGLEVIY	RKHGLEVIY
KQIVEILTAY	KQIVILTAY
AKSSVGETVY	AKSSGETVY
QQYVGKVKF	QQYVGKVKF
AKYPHVEDY	AKYPHVEDY
SKEPSARLL	SKEPSARLL
SQRPAARAF	SQRPAARAF
GKFLQGDSF	GKFLQGDSF
RKLKIQQSY	RKLKIQQSY
RKFKQVAEAY	RKFKVAEAY
RQYMFSSL	RQY-MFSSL
AKQPHVGDY	AKQPHVGDY
AKQIHAVRY	AKQIHAVRY
GQWGGGSHY	GQWGGGSHY
YKFDFPVSY	YKFDFPVSY
VQQLQRLSF	VQQLQRLSF
SQRPPTRETF	SQRPTRETF
KQIENARMF	KQIENARMF
KKVLQSEF	KKV-LQSEF
GKYREFHRMY	GKYRFHRMY
YKALLPQQSY	YKALPQQSY
FAFEHSEEY	FAFEHSEEY
SKMDPTDAKY	SKMDTDAKY
YKAWSSIVY	YKAWSSIVY
KKAHLGTAL	KKAHLGTAL
RLYFSQQTY	RLYFSQQTY
SKLGKHAHF	SKLGKHAHF
RKYEAIQLTF	RKYEIQLTF
KQAEWSSKTSY	AEWSSKTSY
YKAFVMETF	YKAFVMETF
KKFVIDVGY	KKFVIDVGY
MKKLWGDRY	MKKLWGDRY
RKYHQRPTF	RKYHQRPTF
AAPEGKRSL	AAPEGKRSL
SQADIKKAY	SQADIKKAY
RKITTYVSF	RKITTYVSF
AKMKTPVQY	AKMKTPVQY
GKIPVSRGF	GKIPVSRGF
YKLDPDRQY	YKLDPDRQY
SQRSPSELF	SQRSPSELF
AQLDPSLVAF	AQLDSLVAF
TQILQSPAF	TQILQSPAF
RKFINLNEF	RKFINLNEF
AAIRENPVY	AAIRENPVY
YKRQGAARF	YKRQGAARF
AQHPSALRF	AQHPSALRF
FKPKGGVIF	FKPKGGVIF
GKTFSQTYY	GKTFSQTYY
KKFKGDLAY	KKFKGDLAY
AKYATGENTVF	AKYAENTVF
RKAHLTNQY	RKAHLTNQY
AKTEVSLTL	AKTEVSLTL
TEELAYLK	TEE-LAYLK
VQVTPLSSGY	VQVTLSSGY
SAYGSVKAY	SAYGSVKAY
GQHPALSY	GQH-PALSY
IKMGLLSSF	IKMGLLSSF
KKILQKGQTAY	LQK-GQTAY
LKYHQRVLY	LKYHQRVLY
RAFPNKQGY	RAFPNKQGY
RQAPVAAVF	RQAPVAAVF
KKLEELEQKY	KKLELEQKY
SKPRNVPAAY	SKPRVPAAY
GKGSFGEVY	GKGSFGEVY
GAEAKPAE	GAE-AKPAE
KKFQSFQEH	KKFQSFQEH
SQHPQQTSF	SQHPQQTSF
RKLVTTSETY	RKLVTSETY
RKKLPVDSVF	KKLPVDSVF
GQFPGHNEF	GQFPGHNEF
RKPDQVFQSY	RKPDVFQSY
YKIGDLTGY	YKIGDLTGY
KQLQKDKQVY	KQLQDKQVY
GQKLGGQSF	GQKLGGQSF
SKALPASSF	SKALPASSF
RHLLFLLEY	RHLLFLLEY
AKLTISPDY	AKLTISPDY
RQTIFNISL	RQTIFNISL
KKKEEMLKKF	KKKEMLKKF
AANLFAQTY	AANLFAQTY
AKPRSLQTGF	AKPRLQTGF
GQREGSRGF	GQREGSRGF
AQRYNELSY	AQRYNELSY
RQREEQLVSF	RQREQLVSF
YKVPDGMVGF	YKVPGMVGF
SGRMQKVSY	SGRMQKVSY
RNMQLPNGVTY	MQLPNGVTY
HQVVVAKY	HQV-VVAKY
LQRLENTQY	LQRLENTQY
FKPDFGAESIY	FKPDGAESI
AKIKPNIF	AKI-KPNIF
VKAKSIVF	VKA-KSIVF
RQPPSTTTF	RQPPSTTTF
HQLRAQIMAY	HQLRQIMAY
GKVRDINRTY	GKVRINRTY
YVPPLAPHP	YVPPLAPHP
SKKPLILVY	SKKPLILVY
YKIKTLIKKY	YKIKLIKKY
SQVPRSSSM	SQVPRSSSM
LKSPGSVVF	LKSPGSVVF
LKYHPRVLY	LKYHPRVLY
KSQVGTLLF	KSQVGTLLF
IQFEIAHAY	IQFEIAHAY
AQPHHGVPY	AQPHHGVPY
RKVEQLQQEY	RKVELQQEY
GKKENDIDY	GKKENDIDY
SKLGPGEKY	SKLGPGEKY
RKLQDVFEFRY	RKLQDVFEF
MQREPNQAF	MQREPNQAF
ISPTGHSL	ISP-TGHSL
SKINPNTAY	SKINPNTAY
SKVPLKHEY	SKVPLKHEY
GQKPWSQHY	GQKPWSQHY
AKRPSDIKF	AKRPSDIKF
TQAQTTATY	TQAQTTATY
AQRHVLTY	AQR-HVLTY
FKKLHEAHF	FKKLHEAHF
AQREDELTF	AQREDELTF
YKLSLEFPSGY	KLSLFPSGY
GAYGQAVRY	GAYGQAVRY
GKYKQALLQY	GKYKALLQY
KKPDLPQTNF	KKPDPQTNF
RKRDFELAQAY	RKRDLAQAY
AQKDQEIAF	AQKDQEIAF
RQRIVQQY	RQR-IVQQY
GKLKQFDAY	GKLKQFDAY
HKPDFISLF	HKPDFISLF
KKWQKSLQY	KKWQKSLQY
VQGIFVEKY	VQGIFVEKY
RKFLDTSHY	RKFLDTSHY
AKSSTTVSSF	AKSSTVSSF
KKLDLISEL	KKLDLISEL
KKMKLQGQF	KKMKLQGQF
RKYVNGSTY	RKYVNGSTY
RKAYSTTSI	RKAYSTTSI
GKVVVGHAL	GKVVVGHAL
FKIEPPGLF	FKIEPPGLF
HHVIARHEY	HHVIARHEY
