Data	Data aligned
RSYWKEVLL	RSYWKEVLL
AAARDVTL	AA-ARDVTL
GAILVVTKL	GAILVVTKL
FLTGPLNL	FL-TGPLNL
VAPVASAL	VA-PVASAL
FGSKIILL	FG-SKIILL
YAASFINL	YA-ASFINL
ALDVANKIGII	VA-NKIGII
VAYKFPELL	VAYKFPELL
GAHQGVAVL	GAHQGVAVL
FVLQRLVFL	FVLQRLVFL
VAYFGLTTL	VAYFGLTTL
NVKVDPEIQ	NVKVDPEIQ
FIESSFWNF	FIESSFWNF
FAGMPITL	FA-GMPITL
IAVGHIYYF	IAVGHIYYF
RSHYSPIYL	RSHYSPIYL
FADDGVKYL	FADDGVKYL
SSIEHLTTL	SSIEHLTTL
SAAMGGILL	SAAMGGILL
KQYGNEVFL	KQYGNEVFL
SLAHRPVRL	SLAHRPVRL
FAHSFIEL	FA-HSFIEL
LAFSRALEL	LAFSRALEL
AAIYLVTSL	AAIYLVTSL
SITDVYLLNL	SI-TDVYLL
FSLPHVGYL	FSLPHVGYL
SAAGVLIKL	SAAGVLIKL
FVYGESVEL	FVYGESVEL
FAFPGEILM	FAFPGEILM
FASPTQVFF	FASPTQVFF
SSLKLLKYVLF	KL-LKYVLF
VALSQIVRL	VALSQIVRL
TKAVDAETAE	KAVDAETAE
GSISSVLYL	GSISSVLYL
LAAFVPLLL	LAAFVPLLL
HAAEALLL	HA-AEALLL
FIGKLRSNL	FIGKLRSNL
RITNQVIYL	RITNQVIYL
WVRGEGPIFF	RG-EGPIFF
FTAQVIIL	FT-AQVIIL
KASKEILL	KA-SKEILL
LLIENVASL	LLIENVASL
QTIALITYL	QTIALITYL
FLDWPQGTF	FLDWPQGTF
AVRLLLPGEL	RL-LLPGEL
AAIPPDYLL	AAIPPDYLL
GAIIGPILL	GAIIGPILL
KALGILTYL	KALGILTYL
FAFEGIGDEDL	FAFEGIGDE
GADPSTVEM	GADPSTVEM
VADNLAIQL	VADNLAIQL
SAPAGVQL	SA-PAGVQL
GVIATIAFL	GVIATIAFL
HAYDREVHL	HAYDREVHL
FLGPIVNL	FL-GPIVNL
ASIGSTIFL	ASIGSTIFL
FLGGVVHL	FL-GGVVHL
GALGGRALLL	GALGRALLL
SAAQPLNL	SA-AQPLNL
IAVGSISFL	IAVGSISFL
DAFKTQMELL	DAFKTQMEL
FASGVVKL	FA-SGVVKL
YSNKEIFL	YS-NKEIFL
AALAANSNGIA	ALAANSNGI
SAIDSILNL	SAIDSILNL
YLGKVLEL	YL-GKVLEL
IIHEIAVLEL	II-HEIAVL
GATPTPLLL	GATPTPLLL
SNYSHVIFL	SNYSHVIFL
TASQRFIEL	TASQRFIEL
FVHDLVLYL	FVHDLVLYL
AAVGFPTHL	AAVGFPTHL
ISTNSHPIL	ISTNSHPIL
YISKEQLL	YI-SKEQLL
SAFGGAARL	SAFGGAARL
NAYQRAILLL	NAYQRAILL
TASEPLTL	TA-SEPLTL
KLGPAIKL	KL-GPAIKL
AATHRVVEL	AATHRVVEL
SAIDRIFTL	SAIDRIFTL
HVYSGVVNL	HVYSGVVNL
HSLSFETQL	HSLSFETQL
KAFQHPSHL	KAFQHPSHL
IGVGAVTML	IGVGAVTML
SAATATWL	SA-ATATWL
LALLHLLYL	LALLHLLYL
GAVPIFIKL	GAVPIFIKL
VATGPLSL	VA-TGPLSL
WAVPQPTRL	WAVPQPTRL
SATIVIAYL	SATIVIAYL
TTPDHPLFL	TTPDHPLFL
MADPNIRFL	MADPNIRFL
IVDGAVVKF	IVDGAVVKF
SATEALLWL	SATEALLWL
RAVHILTKL	RAVHILTKL
GVSPEPIHL	GVSPEPIHL
AAYLRALSL	AAYLRALSL
AAIGQLAFL	AAIGQLAFL
FAYDGKDYL	FAYDGKDYL
YAYFNFPEL	YAYFNFPEL
AASPSELHL	AASPSELHL
WSMTSDIF	WS-MTSDIF
FALTNIAVL	FALTNIAVL
GQTSVVSFL	GQTSVVSFL
KSDPSIVRL	KSDPSIVRL
SATPRPLHL	SATPRPLHL
FAHHLPVWL	FAHHLPVWL
VAATVVYL	VA-ATVVYL
RALDHYLTL	RALDHYLTL
ILQKNVPIL	ILQKNVPIL
GAGAPVYL	GA-GAPVYL
TAGPAVHL	TA-GPAVHL
LVTHLVTKL	LVTHLVTKL
GTVEQIVYL	GTVEQIVYL
DRVYIHPF	DR-VYIHPF
AAVLPFGGTF	AVLPFGGTF
VAAKEVVL	VA-AKEVVL
ISYFGYPSF	ISYFGYPSF
SLYQSKYEEL	SLYSKYEEL
VSGPRLFL	VS-GPRLFL
FSVPLPARL	FSVPLPARL
FLPQKIIYL	FLPQKIIYL
FAVEYFTRL	FAVEYFTRL
AAVRETVML	AAVRETVML
FAAQSLVQL	FAAQSLVQL
RSGPLTGWRVF	RS-GPLTGW
FAGNTPLHL	FAGNTPLHL
FAIPLIERL	FAIPLIERL
AIEPLPNVVEL	PL-PNVVEL
TVARPLFL	TV-ARPLFL
VAITRVANL	VAITRVANL
SALGSQAHL	SALGSQAHL
SASDQVLYL	SASDQVLYL
RVAPEEHPTL	VAPEEHPTL
ASVGKTSIL	ASVGKTSIL
YLDIARYL	YL-DIARYL
FIGKIPIML	FIGKIPIML
FADQAEILL	FADQAEILL
MAVRLVTEL	MAVRLVTEL
VIISVITQL	VIISVITQL
TATEQWIFL	TATEQWIFL
VLDMHGFL	VL-DMHGFL
VADGYPVRL	VADGYPVRL
AAIQGATLL	AAIQGATLL
VAADIAVQL	VAADIAVQL
TALGKLLYL	TALGKLLYL
YGYEHILTL	YGYEHILTL
RIPSFVTEL	RIPSFVTEL
GAFFGPIRL	GAFFGPIRL
GQVGHILEL	GQVGHILEL
SALSAPTLL	SALSAPTLL
LAFPSPEKL	LAFPSPEKL
STTRELYL	ST-TRELYL
VAYGLHELL	VAYGLHELL
AAIQQRTLL	AAIQQRTLL
LAYTGFVKL	LAYTGFVKL
SAMAVVSRL	SAMAVVSRL
AAIASLLYL	AAIASLLYL
RALEHFTDL	RALEHFTDL
SADKFQVLL	SADKFQVLL
NADPIAKYL	NADPIAKYL
GAIGSPVRL	GAIGSPVRL
FVAGGTVLL	FVAGGTVLL
TAPQGNVDL	TAPQGNVDL
VAQKKASFL	VAQKKASFL
AQFEHTILL	AQFEHTILL
FAIRNQIKL	FAIRNQIKL
RAAEKLYL	RA-AEKLYL
TSYPDPILL	TSYPDPILL
FSSPHGKDLL	SSPHGKDLL
LGTAFMLWL	LGTAFMLWL
FAIDPHLLL	FAIDPHLLL
VADKGGMLL	VADKGGMLL
GSYFRVTLL	GSYFRVTLL
SSYKEVTEL	SSYKEVTEL
YAYAAQNLL	YAYAAQNLL
YSHPGVVFL	YSHPGVVFL
SIADRPLYL	SIADRPLYL
DASGPDPQL	DASGPDPQL
FATKTVIYL	FATKTVIYL
TIPVSPLHL	TIPVSPLHL
FSSPPLSL	FS-SPPLSL
LAVGAPLLL	LAVGAPLLL
VAPGKDLTK	VAPGKDLTK
DLAGRDLTDYL	LAGDLTDYL
KLSKPVYL	KL-SKPVYL
YFAERVTSL	YFAERVTSL
YIYHGTVKL	YIYHGTVKL
KALANVNIGSL	LANVNIGSL
FADAHRPKL	FADAHRPKL
LAAHIPLFL	LAAHIPLFL
VLLESEQF	VL-LESEQF
AATKILTEL	AATKILTEL
DSYVGDEAQSK	YVGDEAQSK
VALPGVAVSML	VALGVAVSM
GASKPNAL	GA-SKPNAL
RAVNDYPSL	RAVNDYPSL
VSIDTVTVL	VSIDTVTVL
IVAINDPFI	IVAINDPFI
FAYDGKDYLTL	FAYDGKDYL
YSKLKKERPDF	YS-----KL
KAYVRVLDL	KAYVRVLDL
AANKTIIYL	AANKTIIYL
YVYKNVSQL	YVYKNVSQL
EAVDLITRL	EAVDLITRL
SATQVYTIL	SATQVYTIL
GAYHAVVLL	GAYHAVVLL
YGYGHESEL	YGYGHESEL
AAASHPLLL	AAASHPLLL
FVMETFVHL	FVMETFVHL
RAYDGTTYL	RAYDGTTYL
VAIGNPVHL	VAIGNPVHL
FTIGKAIWL	FTIGKAIWL
GAYTQVIFL	GAYTQVIFL
GADARALML	GADARALML
SADPEARRL	SADPEARRL
DSYQKFIPFI	DSYQKFIPF
VSYVRSVYL	VSYVRSVYL
SIYRVPLLL	SIYRVPLLL
AALSQVTLL	AALSQVTLL
FAYEGPMYL	FAYEGPMYL
HLPETKFSEL	HLPTKFSEL
FAFRNFLYL	FAFRNFLYL
RATPHPSEL	RATPHPSEL
SSVATITRL	SSVATITRL
SIYSRFVQL	SIYSRFVQL
FAVALPQLL	FAVALPQLL
YLYGQTTTYL	YLYQTTTYL
VAGGAVYL	VA-GGAVYL
YAIREEIVL	YAIREEIVL
YAIPHPDQL	YAIPHPDQL
YSLSSTLTL	YSLSSTLTL
VTIGHIALL	VTIGHIALL
FLASVSTVL	FLASVSTVL
FAIVASDTRL	AIVASDTRL
AQYDRQIRL	AQYDRQIRL
FAAETLVL	FA-AETLVL
YLGWTPYM	YL-GWTPYM
FIYKHGLKL	FIYKHGLKL
VAYPGIPKL	VAYPGIPKL
LIRKLPFQRL	LIRLPFQRL
VAAKETLL	VA-AKETLL
SATGEIYL	SA-TGEIYL
AFLIPLLVW	AFLIPLLVW
SAVGKTSFL	SAVGKTSFL
AASFGKSINF	ASFGKSINF
YSSDTTPLL	YSSDTTPLL
GLIDHQTYL	GLIDHQTYL
TVTEKPEVIDA	TVTEKPEVI
GSDPRVTQL	GSDPRVTQL
QSIAFISRL	QSIAFISRL
SAFSNVAWL	SAFSNVAWL
RVDPVNFKL	RVDPVNFKL
TVALPVFL	TV-ALPVFL
KAFSYPSKL	KAFSYPSKL
STGPIVDL	ST-GPIVDL
FALGAGTALL	FALGAGTAL
VGYHKHITL	VGYHKHITL
FAYTRLQLL	FAYTRLQLL
AGVNTVTTL	AGVNTVTTL
WAVALPVYL	WAVALPVYL
FGYKHVLTL	FGYKHVLTL
SAYKELTDL	SAYKELTDL
SGAPHAILL	SGAPHAILL
AIMDLLLRL	AIMDLLLRL
FVYGSMSFL	FVYGSMSFL
FITEFPLFL	FITEFPLFL
GVGPLLYL	GV-GPLLYL
TVTEKPEVID	TVTEKPEVI
SAKSWPIFL	SAKSWPIFL
LLDPVPPVL	LLDPVPPVL
YLLPSVVLL	YLLPSVVLL
DVYLYKQSF	DVYLYKQSF
YGYGSTVRL	YGYGSTVRL
IADRPLYL	IA-DRPLYL
YAYPGVLLI	YAYPGVLLI
YAYRDAVFL	YAYRDAVFL
GSHSMRYF	GS-HSMRYF
TAIAGLTFL	TAIAGLTFL
KAPGSTSNL	KAPGSTSNL
FVGGGIGGTIL	GG-IGGTIL
YAITRVLRL	YAITRVLRL
PPAPPVFL	PP-APPVFL
KALGHPAML	KALGHPAML
FSAPRHGSL	FSAPRHGSL
GVVDHQTEL	GVVDHQTEL
FAADIISVL	FAADIISVL
GNFNYIEFTR	GN-FNYIEF
FAVYIHALL	FAVYIHALL
GAIFVPIHL	GAIFVPIHL
YIVDLLTHL	YIVDLLTHL
TAAVHIIL	TA-AVHIIL
VAAKSVKL	VA-AKSVKL
SAIGVLAFL	SAIGVLAFL
FSLKTVLLL	FSLKTVLLL
LVLTGFSHIDL	LVLTGFSHI
VAISSLTYL	VAISSLTYL
YTIPLAIKL	YTIPLAIKL
TAYRNITEL	TAYRNITEL
ISSHIPLIIQF	HI-PLIIQF
SSGLPRNTVVL	GLPRNTVVL
GASNSAPHL	GASNSAPHL
VSVLPTTADF	SVLPTTADF
YAVGGYTRL	YAVGGYTRL
YVINVTTHL	YVINVTTHL
SSGGVIRL	SS-GGVIRL
NAYTGIVLL	NAYTGIVLL
FVEIKGSV	FV-EIKGSV
FLDVAGLL	FL-DVAGLL
AAAHSVRL	AA-AHSVRL
WAYPRQVFI	WAYPRQVFI
LAAPVISVL	LAAPVISVL
YSAPRVWWM	YSAPRVWWM
EAARVAEQL	EAARVAEQL
IAGPVVEI	IA-GPVVEI
AAQTKATFL	AAQTKATFL
FLFELPSRL	FLFELPSRL
KADGVPVYL	KADGVPVYL
RLLLPGEL	RL-LLPGEL
NAAFKDVAL	NAAFKDVAL
ASLSTFQQM	ASLSTFQQM
FAYNFREEL	FAYNFREEL
FSLAPITKL	FSLAPITKL
IAPTGHSL	IA-PTGHSL
SSYYGVVRL	SSYYGVVRL
WLYPYSILL	WLYPYSILL
AATVTITHL	AATVTITHL
FVEPFVIL	FV-EPFVIL
SVISVVSYL	SVISVVSYL
VLQALKQLQL	LQALKQLQL
MAINSISKL	MAINSISKL
AVALPVYL	AV-ALPVYL
YLLPFISKL	YLLPFISKL
GAYGTMTYL	GAYGTMTYL
SVPLAATSM	SVPLAATSM
YAIGNAPEL	YAIGNAPEL
ASAVQLIL	AS-AVQLIL
LAIASGIYL	LAIASGIYL
VAANKAVHL	VAANKAVHL
AAAPTANLL	AAAPTANLL
LFHPSNVEM	LFHPSNVEM
AGFAGDDAPR	FA-GDDAPR
GAGAPVYM	GA-GAPVYM
RAASKTVRL	RAASKTVRL
VAIGFKTKL	VAIGFKTKL
LATRSFPQL	LATRSFPQL
VIAQGIGKL	VIAQGIGKL
YSVWIGGSIL	YSVIGGSIL
FAAPTTGNQI	AAPTTGNQI
YASPDLSKL	YASPDLSKL
LTGPVLEL	LT-GPVLEL
SAAPGTASL	SAAPGTASL
SAVENLLLL	SAVENLLLL
VVIRGNSIIML	RG-NSIIML
AAVPRAAFL	AAVPRAAFL
FAAKVLYL	FA-AKVLYL
TAMDVVYAL	TAMDVVYAL
MAGSPVFL	MA-GSPVFL
KAPVTKVAA	KAPVTKVAA
FAKAIYERL	FAKAIYERL
AASPQAPTL	AASPQAPTL
GAINHVLQL	GAINHVLQL
YGSDRILL	YG-SDRILL
YTAPTAIRL	YTAPTAIRL
FQYSKSPSL	FQYSKSPSL
LANEVKVLL	LANEVKVLL
VGPPGRSSL	VGPPGRSSL
AADPSVVNL	AADPSVVNL
YSVETVTLL	YSVETVTLL
SALGHLSFL	SALGHLSFL
FALLQQPLF	FALLQQPLF
MIIGGGMAFTF	MIIGGGMAF
YSLQVTTYL	YSLQVTTYL
RAMKHPLGL	RAMKHPLGL
FSSPPVIL	FS-SPPVIL
GGITSVIKL	GGITSVIKL
AIKFLEVIKPF	FL-EVIKPF
FVYENPISL	FVYENPISL
SASAAEVLL	SASAAEVLL
HASDRIIAL	HASDRIIAL
VLPERYSSL	VLPERYSSL
LVGPQIYL	LV-GPQIYL
AAASQFTLL	AAASQFTLL
FSDGLAHLDNL	FS-DGLAHL
AILMTVALL	AILMTVALL
GAVPRLLYL	GAVPRLLYL
KAYYKSSHL	KAYYKSSHL
SGISRLTWL	SGISRLTWL
ASVDKVTRL	ASVDKVTRL
SSVATVVYL	SSVATVVYL
FVDQFVEL	FV-DQFVEL
ATYHRAIKV	ATYHRAIKV
GISQPIWL	GI-SQPIWL
RIYGNKTEL	RIYGNKTEL
VVYPWTQRF	VVYPWTQRF
AASDFIFL	AA-SDFIFL
RAAPHRISL	RAAPHRISL
AAAKHLIL	AA-AKHLIL
GIVGVFVKL	GIVGVFVKL
KAFNTSSHL	KAFNTSSHL
SAVFMVTRL	SAVFMVTRL
SGVKKPIYL	SGVKKPIYL
HRGFSGLQ	HR-GFSGLQ
MSSLKLLKYVL	SSLKLLKYV
SAKERPIWL	SAKERPIWL
YAVPSAGLRL	YAVSAGLRL
LLGPTVML	LL-GPTVML
RAVGVQNYL	RAVGVQNYL
VATKIFQEL	VATKIFQEL
TINEPILL	TI-NEPILL
SSHARPVSL	SSHARPVSL
SATRVYIVL	SATRVYIVL
TAYWKELSL	TAYWKELSL
GISPVPINL	GISPVPINL
QAAPPIEL	QA-APPIEL
SAYEFVTWL	SAYEFVTWL
LAAPQLIML	LAAPQLIML
YIITGGGFL	YIITGGGFL
SAPTETHSL	SAPTETHSL
VLLSHLSYL	VLLSHLSYL
AAADSAVRL	AAADSAVRL
VARVWSLMRF	VA-RVWSLM
YIPDFLTLL	YIPDFLTLL
VATSVLTQM	VATSVLTQM
SAARLTMM	SA-ARLTMM
RVAPEEHPVLL	VAPEHPVLL
VAHGKQLFL	VAHGKQLFL
FLPSSVLWL	FLPSSVLWL
YGAGIVLRL	YGAGIVLRL
FAYTGQILL	FAYTGQILL
AALPKATIL	AALPKATIL
AAVRKPIVL	AAVRKPIVL
VLAPVIDL	VL-APVIDL
SAITQVLLL	SAITQVLLL
HIPDVITYL	HIPDVITYL
VAVGVYARL	VAVGVYARL
SAAAPQLL	SA-AAPQLL
YAISKPEVL	YAISKPEVL
YQYPVIIHL	YQYPVIIHL
LQYSFPLQL	LQYSFPLQL
YALTSPLQL	YALTSPLQL
TAIRGAIIL	TAIRGAIIL
AAALFVLL	AA-ALFVLL
VVTITIMPAF	VTITIMPAF
AAAPVPTTTL	AAPVPTTTL
AAAAPAFL	AA-AAPAFL
SAARFALL	SA-ARFALL
HAAHIISEL	HAAHIISEL
FAIRGVVLL	FAIRGVVLL
SVGKPLYL	SV-GKPLYL
HAMQFPAEL	HAMQFPAEL
YAIGLVMRL	YAIGLVMRL
WGYPHPFLI	WGYPHPFLI
SVKDLVILL	SVKDLVILL
QAITALAHL	QAITALAHL
GSSGGVIRL	GSSGGVIRL
IAVAATPIPKL	VAATPIPKL
LALSQISYL	LALSQISYL
YLADIFTKL	YLADIFTKL
AALDKATVL	AALDKATVL
VGAGAPVYM	VGAGAPVYM
SSYPGKTAL	SSYPGKTAL
FAHLINVEF	FAHLINVEF
FTSDIALRL	FTSDIALRL
LAAGHLVQL	LAAGHLVQL
VTAKATIL	VT-AKATIL
ILIPNGVQIF	ILIPNGVQI
GLIENPALL	GLIENPALL
YSLDHISSL	YSLDHISSL
FALPYVIVL	FALPYVIVL
SAAPAIQL	SA-APAIQL
AATHLTSKL	AATHLTSKL
GAYVHMVTH	GAYVHMVTH
YAATFLHL	YA-ATFLHL
LAVLHTVLL	LAVLHTVLL
ILENNPLVDF	ILENNPLVD
MANGAVIHL	MANGAVIHL
FAVNSLLYL	FAVNSLLYL
LAITDEILL	LAITDEILL
SAYEVIKL	SA-YEVIKL
SAAPTFLLL	SAAPTFLLL
FAAFLPEFL	FAAFLPEFL
FASTILHL	FA-STILHL
HATVPIRL	HA-TVPIRL
VVDGGLQLIL	VVDGLQLIL
YAFGRVFSGL	YAFRVFSGL
SAASRVFL	SA-ASRVFL
RAFDHVLHL	RAFDHVLHL
AGPLRKSSL	AGPLRKSSL
YSTEPNNL	YS-TEPNNL
FASNHIQL	FA-SNHIQL
YVAIQAVLSL	VAIQAVLSL
VAPRSGLAA	VAPRSGLAA
AAINRYSRL	AAINRYSRL
IAIGKVLKL	IAIGKVLKL
SQVPFPSRL	SQVPFPSRL
VVPEPGQPL	VVPEPGQPL
FAYDGKDYIAL	FAYDGKDYI
SAAHEVEL	SA-AHEVEL
AATAQVSHL	AATAQVSHL
QTYFFPIHL	QTYFFPIHL
KAGPILEL	KA-GPILEL
VAIGVKVYL	VAIGVKVYL
AIRNDEEL	AI-RNDEEL
HVAKEILL	HV-AKEILL
ALLATVLGRF	LLATVLGRF
FVVDIESRL	FVVDIESRL
FITDPVVL	FI-TDPVVL
GSFDVADRMF	GSFDVADRM
LAYEKIAYL	LAYEKIAYL
SSPQPGSAL	SSPQPGSAL
AAAVQAFYL	AAAVQAFYL
NSDDRVLL	NS-DDRVLL
TAAGKEVML	TAAGKEVML
YQYPRPLLI	YQYPRPLLI
YLYPDITRL	YLYPDITRL
SADSRIAEL	SADSRIAEL
LLPISPFML	LLPISPFML
VAFSPVTEL	VAFSPVTEL
VAVKRAVML	VAVKRAVML
FLDGIYVSEK	FLDGIYVSE
GATSLVTLL	GATSLVTLL
FAIPLIEKL	FAIPLIEKL
GASKAVFL	GA-SKAVFL
KVANVSLL	KV-ANVSLL
AAINRQINL	AAINRQINL
FAAEAQKL	FA-AEAQKL
EIRDVSNLGIF	EI-RDVSNL
ALDVFALWL	ALDVFALWL
FSSPPVILL	FSSPPVILL
FVIDLQTRL	FVIDLQTRL
FATKPELL	FA-TKPELL
WLPAGDALLQM	WLPAGDALL
FADQEVRSL	FADQEVRSL
FVTMTASRML	FVTMTASRM
VAASNIVQM	VAASNIVQM
YLITSVELL	YLITSVELL
GAFGKETDL	GAFGKETDL
ILNPDNSFEIL	NPDNSFEIL
IAFPDEQAEAL	IAFEQAEAL
SASPSVAQL	SASPSVAQL
SANDGFVRL	SANDGFVRL
KAYELALYL	KAYELALYL
FALSGPLFL	FALSGPLFL
FVAPSDIQL	FVAPSDIQL
FIGYPITL	FI-GYPITL
IAAPFTSKL	IAAPFTSKL
FGIDRPAEL	FGIDRPAEL
NAPWAVTSL	NAPWAVTSL
SLYPHFTLL	SLYPHFTLL
TAPTGHTL	TA-PTGHTL
VASEYPVIL	VASEYPVIL
FVDFEGISL	FVDFEGISL
ALAFEPLSQLL	LAFEPLSQL
TTAAPLLL	TT-AAPLLL
RAYTSETYL	RAYTSETYL
MVNPTVFF	MV-NPTVFF
FADGVILL	FA-DGVILL
ALAFEPLSQL	LAFEPLSQL
YSNRVVDL	YS-NRVVDL
SVATVVYL	SV-ATVVYL
AAAPHLLL	AA-APHLLL
YVFPGVTRL	YVFPGVTRL
AVKDLVVLLF	AVKDLVVLL
FSHSQITRL	FSHSQITRL
AAIWFRTYL	AAIWFRTYL
FSTEEFVLL	FSTEEFVLL
SAIGYIHSL	SAIGYIHSL
FAAGETFL	FA-AGETFL
TYDDATKTF	TYDDATKTF
FATQQFVAL	FATQQFVAL
RVVDLITNL	RVVDLITNL
FSADGHTML	FSADGHTML
SIAGPVLL	SI-AGPVLL
FADGHVLEL	FADGHVLEL
VAHGGVQKL	VAHGGVQKL
KSGPVVSL	KS-GPVVSL
IVYPKPTWL	IVYPKPTWL
AAMQDPEVM	AAMQDPEVM
HAIYWPAFL	HAIYWPAFL
AAYHLIIEL	AAYHLIIEL
YLPSFFTKL	YLPSFFTKL
WSMTSDIFF	WSMTSDIFF
MLDPLEVHL	MLDPLEVHL
SLDDGWIRF	SLDDGWIRF
QAFPRITQL	QAFPRITQL
LAYIHLIEF	LAYIHLIEF
FAYRGFKYL	FAYRGFKYL
AAAKALRI	AA-AKALRI
AAAAAIVFL	AAAAAIVFL
VADPYVVIM	VADPYVVIM
FLYQYSTRL	FLYQYSTRL
HAGPVINTL	HAGPVINTL
KITPLEIEVL	ITPLEIEVL
FLDLSIIRF	FLDLSIIRF
SVPEAQSAL	SVPEAQSAL
VATRALLL	VA-TRALLL
FADFERHFL	FADFERHFL
VIDEPVRL	VI-DEPVRL
FAVNSVLRL	FAVNSVLRL
FAVTLETVL	FAVTLETVL
GAISKIFVL	GAISKIFVL
GAVPIFIEL	GAVPIFIEL
KAYERGISL	KAYERGISL
AATSRIAEL	AATSRIAEL
FAAVKLFL	FA-AVKLFL
FVFPGELLL	FVFPGELLL
KSIKNVTEL	KSIKNVTEL
FLDLTEQEF	FLDLTEQEF
FAILSFLHI	FAILSFLHI
NFGIGQDIQPK	FGIGQDIQP
GAVGKTCLL	GAVGKTCLL
SSVGKVSVL	SSVGKVSVL
KAVGSIAYL	KAVGSIAYL
FLGKPLFL	FL-GKPLFL
GAARPVSL	GA-ARPVSL
TAAPVPTTL	TAAPVPTTL
YAFPLAHSL	YAFPLAHSL
VVIRGNSIIM	VVIRGNSII
RIAIEIYL	RI-AIEIYL
LAYPFQSLL	LAYPFQSLL
FAVLEDHTL	FAVLEDHTL
LAARLVTFL	LAARLVTFL
AAVNHISQL	AAVNHISQL
GADPNATTL	GADPNATTL
FSAPKINL	FS-APKINL
YSAPEILL	YS-APEILL
VAILPQLFM	VAILPQLFM
AASEPVVL	AA-SEPVVL
VLEYLTAEIL	LEYLTAEIL
HLDRPVFL	HL-DRPVFL
YLGQVAILL	YLGQVAILL
YAVDRAITHL	YAVRAITHL
LAGPALEL	LA-GPALEL
VATVVPTHL	VATVVPTHL
FAYPAPLEV	FAYPAPLEV
IAAKKVLRL	IAAKKVLRL
SAATFSVFL	SAATFSVFL
LIYGRPVYV	LIYGRPVYV
FLSKEIWL	FL-SKEIWL
YSYSKGTYL	YSYSKGTYL
FLPEAPAEL	FLPEAPAEL
ATPVDPLFL	ATPVDPLFL
SAPVGVTAL	SAPVGVTAL
AASTLVTWL	AASTLVTWL
FASEYPLIL	FASEYPLIL
KAGDVIFL	KA-GDVIFL
FSNPRALYL	FSNPRALYL
AVIESVTFL	AVIESVTFL
TVVTITIMPAF	TV-VTITIM
VVYGGISRL	VVYGGISRL
YAAGVHSVL	YAAGVHSVL
AASAQLLRL	AASAQLLRL
GYSFTTTAER	YSFTTTAER
LTPEEEEILNK	LTPEEEEIL
GATLRTSRL	GATLRTSRL
AAAGSPVFL	AAAGSPVFL
FIAGTIQL	FI-AGTIQL
FAIRSLAEL	FAIRSLAEL
SAVGKTSLL	SAVGKTSLL
FVDPAQITM	FVDPAQITM
FTDVNKIYL	FTDVNKIYL
FLFSKFIEL	FLFSKFIEL
TITQAVIFI	TITQAVIFI
VSIFPDSGHF	SIFPDSGHF
FLTRIISQL	FLTRIISQL
SAIPVTYVF	SAIPVTYVF
GAVERPLSL	GAVERPLSL
AVVPLVGKL	AVVPLVGKL
QASHQPLYL	QASHQPLYL
STARHLYL	ST-ARHLYL
YGAPTAVRL	YGAPTAVRL
FSYPLDLLL	FSYPLDLLL
FAWKPQLL	FA-WKPQLL
LLDGKLVLL	LLDGKLVLL
VAPVTHVSV	VAPVTHVSV
FLYAGHIFL	FLYAGHIFL
YAYTGRLEL	YAYTGRLEL
GAYGKVFLV	GAYGKVFLV
RVYIHPFHL	RVYIHPFHL
QSAPAPVML	QSAPAPVML
KADSVVVLL	KADSVVVLL
AAYPKIQML	AAYPKIQML
SVSKEVFL	SV-SKEVFL
YAADNQIYI	YAADNQIYI
LAYYGFTKL	LAYYGFTKL
ALPKLPISL	ALPKLPISL
FSGPAITL	FS-GPAITL
YANKYNIML	YANKYNIML
SATQVFPRL	SATQVFPRL
VALARALFI	VALARALFI
FAYLRDLLI	FAYLRDLLI
PPYTVVYFPVR	YT---VVYF
LAVNVVTTL	LAVNVVTTL
AAVFGVTRL	AAVFGVTRL
RISNPPILL	RISNPPILL
YVQSMDVAAF	VQSMDVAAF
AAYDRYLKL	AAYDRYLKL
TAFFGDVVL	TAFFGDVVL
VLDKYELL	VL-DKYELL
ISVGVINLL	ISVGVINLL
FAFRHVLKL	FAFRHVLKL
VAIQAVLSL	VAIQAVLSL
SAFRGVGLL	SAFRGVGLL
YQIDTVINL	YQIDTVINL
SAASVWGNL	SAASVWGNL
FLGPEIFF	FL-GPEIFF
TSLSALTQL	TSLSALTQL
FAISILQQL	FAISILQQL
SIPEKNRPL	SIPEKNRPL
GASLFLLL	GA-SLFLLL
VIPGHLIFL	VIPGHLIFL
QVTQPTVGMNF	QVTQPTVGM
GAAPAPTAV	GAAPAPTAV
GAYKYIQEL	GAYKYIQEL
VADPTPFHI	VADPTPFHI
IAYFHPQKL	IAYFHPQKL
AASHPLLL	AA-SHPLLL
DIVRANTF	DI-VRANTF
NANHPDFPM	NANHPDFPM
VGAGAPVYL	VGAGAPVYL
YAFVRPVIL	YAFVRPVIL
YQYGAVVTL	YQYGAVVTL
NAGKILLL	NA-GKILLL
AAINPELLQL	AAIPELLQL
IAVDKANL	IA-VDKANL
YGSVPVLL	YG-SVPVLL
FIAAGLYL	FI-AAGLYL
NAFKEITTM	NAFKEITTM
FAYPAIRYL	FAYPAIRYL
HAAIVIFL	HA-AIVIFL
YLAKVLWL	YL-AKVLWL
DALVFGHL	DA-LVFGHL
AAASKVLNL	AAASKVLNL
GAVPGITKF	GAVPGITKF
QIPEIKQTL	QIPEIKQTL
YSGLIYTYSGL	GLIYTYSGL
AAANPLAL	AA-ANPLAL
IAAGLYLLL	IAAGLYLLL
AAHIPLFL	AA-HIPLFL
LTAPEIIL	LT-APEIIL
VADKKARLI	VADKKARLI
KAAKELRL	KA-AKELRL
SQYPFPVTL	SQYPFPVTL
AAYRRALEL	AAYRRALEL
FLLPILSQI	FLLPILSQI
AVGGEALGRL	VGGEALGRL
VGSRPIKL	VG-SRPIKL
AAYYHPSYL	AAYYHPSYL
FAGASIKI	FA-GASIKI
DLTDYLMKI	DLTDYLMKI
DVNFPIDNL	DVNFPIDNL
NARLAADD	NA-RLAADD
AAGSPVFL	AA-GSPVFL
AAATSALLL	AAATSALLL
YADYRIIDL	YADYRIIDL
IAVGYVDDTQF	VGYVDDTQF
AAGPPLLL	AA-GPPLLL
RTIGVITKL	RTIGVITKL
FAADHNYL	FA-ADHNYL
KAVGTITKL	KAVGTITKL
HSISIPTKL	HSISIPTKL
LAPTDVKEL	LAPTDVKEL
FSDPFLKYL	FSDPFLKYL
VAVTSYTLL	VAVTSYTLL
VAFPLLTKL	VAFPLLTKL
VAVQHFSLL	VAVQHFSLL
YAYEAVEQL	YAYEAVEQL
AAYGNRQNL	AAYGNRQNL
YSFKVITKL	YSFKVITKL
ANSHQGQML	ANSHQGQML
KAPAPRPSL	KAPAPRPSL
FAAPSPFAEL	AAPSPFAEL
YVAPKAVWL	YVAPKAVWL
FSVGGLLKL	FSVGGLLKL
SALEFLTQL	SALEFLTQL
AAGKEVML	AA-GKEVML
FLKLLGAL	FL-KLLGAL
DRVYIHPFHL	RVYIHPFHL
FAVDREARL	FAVDREARL
ITSDQPILL	ITSDQPILL
FLDEPTNHL	FLDEPTNHL
MALLATVLGRF	MA-LLATVL
HAIFKLTYL	HAIFKLTYL
YLDSPLVRF	YLDSPLVRF
FADGVILLL	FADGVILLL
YTAEPVTL	YT-AEPVTL
SGFGGITML	SGFGGITML
YQYLLVTAL	YQYLLVTAL
VLPNDPVFL	VLPNDPVFL
SGPGPAAAL	SGPGPAAAL
FSGNPIKVSF	FS-GNPIKV
FAAGIIAHL	FAAGIIAHL
AAPATRAAL	AAPATRAAL
YSAPVIHVL	YSAPVIHVL
VAYGKGTYF	VAYGKGTYF
SGLTHVTSL	SGLTHVTSL
HVDDMPNAL	HVDDMPNAL
LITQLKML	LI-TQLKML
GAVGSRVTL	GAVGSRVTL
SAVSGAIRL	SAVSGAIRL
KTPNFSTLL	KTPNFSTLL
VSLGHISML	VSLGHISML
FADREVQL	FA-DREVQL
VAFTPEGERL	VAFPEGERL
EIGIVRQFPF	EI-GIVRQF
VLPEHVSVL	VLPEHVSVL
SAAPVAHLL	SAAPVAHLL
FLAHIYTEL	FLAHIYTEL
SAAPPLDL	SA-APPLDL
VAHSPPEKL	VAHSPPEKL
AAVDRTTEL	AAVDRTTEL
VASKFITL	VA-SKFITL
VASVIVTKL	VASVIVTKL
FTTDAIAL	FT-TDAIAL
SVDIAAFNKI	SVDAAFNKI
ILDPHVVLL	ILDPHVVLL
SIPDFPMHL	SIPDFPMHL
SALGYLHSI	SALGYLHSI
FVDTEIRL	FV-DTEIRL
DVANKIGII	DVANKIGII
PSLSHNLL	PS-LSHNLL
FVANAIIHL	FVANAIIHL
VISLEGKPL	VISLEGKPL
SSHGGEIFL	SSHGGEIFL
VAVAEVIKL	VAVAEVIKL
TSIHHATHL	TSIHHATHL
KAFQKIVVL	KAFQKIVVL
GAYGGGAKL	GAYGGGAKL
ILDPHVVL	IL-DPHVVL
NVPVRDIPA	NVPVRDIPA
FAIDSSHPWL	FAISSHPWL
LAFEGPILL	LAFEGPILL
FLANVSTVL	FLANVSTVL
IVAINDPFIDL	VAIDPFIDL
LEEALQQAKED	EALQQAKED
MAYFPAISL	MAYFPAISL
RVAPEEHPVL	VAPEEHPVL
HQAFSVVFL	HQAFSVVFL
NAFSGVMML	NAFSGVMML
TADGAHFEL	TADGAHFEL
LAVRVVTLL	LAVRVVTLL
FIPKFITHL	FIPKFITHL
FLDSQTATF	FLDSQTATF
VIGPPVVL	VI-GPPVVL
PLPVQVFNL	PLPVQVFNL
AAIGEATRL	AAIGEATRL
FAALMPTVL	FAALMPTVL
FAFESDLHSLL	FAFSDLHSL
KIHEPIML	KI-HEPIML
FAMPYFIQV	FAMPYFIQV
RAADVLVYL	RAADVLVYL
YAFSSVEKL	YAFSSVEKL
YIFSHILRL	YIFSHILRL
FALPTTVWL	FALPTTVWL
YAYLKAIVL	YAYLKAIVL
LVVLSGLHM	LVVLSGLHM
AAATLTSKL	AAATLTSKL
LVIGRVLEL	LVIGRVLEL
AAASPVTL	AA-ASPVTL
SAAPVAHL	SA-APVAHL
KATGKISKL	KATGKISKL
FASFPEYL	FA-SFPEYL
YAYNPLAGGLL	YAYPLAGGL
FADREVQLL	FADREVQLL
AAAPPALI	AA-APPALI
GAYSPIVLL	GAYSPIVLL
VILPVPAF	VI-LPVPAF
GAYRGGERL	GAYRGGERL
YASGRTTGIVM	YASGRTTGI
AVIKGLTYL	AVIKGLTYL
AIEALLHDL	AIEALLHDL
FAAEAIAM	FA-AEAIAM
SAAPRTVAL	SAAPRTVAL
SADPNVVDL	SADPNVVDL
LTPYRVIFL	LTPYRVIFL
LATVLGRF	LA-TVLGRF
AAAIFVII	AA-AIFVII
YADSSIAEL	YADSSIAEL
AAAGSPLSL	AAAGSPLSL
VGGPEIEL	VG-GPEIEL
KLDEEALL	KL-DEEALL
SATGTVSDL	SATGTVSDL
MLKPSLPFTSL	PS-LPFTSL
YLLDLHSYL	YLLDLHSYL
IAVHVVPDQL	AVHVVPDQL
IAILNNNL	IA-ILNNNL
SAITTLMHL	SAITTLMHL
RIAGEASRL	RIAGEASRL
ILATVLSIPEL	ATVLSIPEL
SAVTTTAHL	SAVTTTAHL
SAALHLLL	SA-ALHLLL
TAAPSPLRL	TAAPSPLRL
LSFPTTKTYF	LSFTTKTYF
VVAPFMANIPL	VVAPFMANI
IIDQVNPEL	IIDQVNPEL
LLQAYLLL	LL-QAYLLL
VAVPWAALL	VAVPWAALL
MAGKEVFL	MA-GKEVFL
LAAKKAVWL	LAAKKAVWL
KAAQEVKL	KA-AQEVKL
AAASPVHL	AA-ASPVHL
TALENPVLL	TALENPVLL
GATVEIHL	GA-TVEIHL
YLPDGTASL	YLPDGTASL
TADGRVVKL	TADGRVVKL
FAYDPSNYEYL	FAYSNYEYL
ILDLGQNIF	ILDLGQNIF
LSAVVASII	LSAVVASII
NATIRVTNL	NATIRVTNL
LILPGFIDF	LILPGFIDF
FTYKQVVDL	FTYKQVVDL
AAVGFLSSL	AAVGFLSSL
YLNPDQSGEF	YLNDQSGEF
YAVYSLLYL	YAVYSLLYL
TALERPSFL	TALERPSFL
AATKVTTVL	AATKVTTVL
FAVSDISFL	FAVSDISFL
FLSHIPITL	FLSHIPITL
GSDPSIISL	GSDPSIISL
FVFQEPSLL	FVFQEPSLL
YSYYGPLNL	YSYYGPLNL
FASKHAVKL	FASKHAVKL
AAAQEPLQL	AAAQEPLQL
FAYRFSNLL	FAYRFSNLL
FAIGGLCNL	FAIGGLCNL
SADPRHILL	SADPRHILL
FALRIASRL	FALRIASRL
FSTRLFAVL	FSTRLFAVL
FVAESHIIL	FVAESHIIL
FVSFPLYL	FV-SFPLYL
LAYHLAVVL	LAYHLAVVL
FAISILQQI	FAISILQQI
GATTTAPSL	GATTTAPSL
LVLEPRGL	LV-LEPRGL
IAYSRPVYF	IAYSRPVYF
YLYFSSTKL	YLYFSSTKL
YIDKVRFL	YI-DKVRFL
AVGPDLYL	AV-GPDLYL
YSVDIPLDK	YSVDIPLDK
QVKSGTIFDNF	QV-KSGTIF
MVDGTLLLL	MVDGTLLLL
LVGLFEDTNL	VGLFEDTNL
FVSPEVFL	FV-SPEVFL
EVQSLPLPL	EVQSLPLPL
TAAGAVFL	TA-AGAVFL
YAFSGVEEL	YAFSGVEEL
YALLGRTLL	YALLGRTLL
NAVSVHSNL	NAVSVHSNL
VSSHEVFL	VS-SHEVFL
YALGALNHL	YALGALNHL
FQSSAVMAL	FQSSAVMAL
SAATKIVFL	SAATKIVFL
GAVKKLTKL	GAVKKLTKL
YAIEAIKL	YA-IEAIKL
GADNSVVRF	GADNSVVRF
FAYAKRTLL	FAYAKRTLL
FSYPAGTEL	FSYPAGTEL
TAAPSASLL	TAAPSASLL
FQNIRPLFI	FQNIRPLFI
FSLKISLLL	FSLKISLLL
NLSLPIPI	NL-SLPIPI
LATASSPKF	LATASSPKF
SASNSFSRL	SASNSFSRL
SVYGRLIDL	SVYGRLIDL
VAHSPPSTL	VAHSPPSTL
YASKEVIL	YA-SKEVIL
GSTGTVAHL	GSTGTVAHL
FATKVVHLL	FATKVVHLL
LAVAHPLLL	LAVAHPLLL
SSLKLLKYVL	SSLKLLKYV
FAIPGSSFL	FAIPGSSFL
ASVDKVLEL	ASVDKVLEL
YALPHAIL	YA-LPHAIL
RIYQKKTQL	RIYQKKTQL
FAALPNQL	FA-ALPNQL
FADGKVYAL	FADGKVYAL
GLGPVEYL	GL-GPVEYL
YAAGENIR	YA-AGENIR
FAADLAEEL	FAADLAEEL
IALEATQLL	IALEATQLL
RAQGRVLRL	RAQGRVLRL
SAIIVASYL	SAIIVASYL
LILPGYIDF	LILPGYIDF
HAVRQPVFL	HAVRQPVFL
DVAAFNKI	DV-AAFNKI
AAAASYPAL	AAAASYPAL
LAAGAVFL	LA-AGAVFL
AGIAHPSAL	AGIAHPSAL
GQYPRALEL	GQYPRALEL
IVAKQVLL	IV-AKQVLL
TAAGGTVHL	TAAGGTVHL
FLLQHQTFL	FLLQHQTFL
AAAPAVSL	AA-APAVSL
AAVGEPAFL	AAVGEPAFL
GTVDDVPKL	GTVDDVPKL
YLLPAIVHI	YLLPAIVHI
YVAPRRILL	YVAPRRILL
FLSQPILL	FL-SQPILL
YVGSRPIKL	YVGSRPIKL
HSPGAVSSL	HSPGAVSSL
FAARPVLL	FA-ARPVLL
TAIREISLL	TAIREISLL
FIVGDQISF	FIVGDQISF
GSVSNPLFL	GSVSNPLFL
FLYGGELVL	FLYGGELVL
SALPFITYL	SALPFITYL
TLDELPAML	TLDELPAML
AATSLITTL	AATSLITTL
FKQYANDNGVD	YA-NDNGVD
LSDHHIYL	LS-DHHIYL
LIGPPLLI	LI-GPPLLI
SAYGAAAHL	SAYGAAAHL
LILADIHDF	LILADIHDF
GSTRIITRL	GSTRIITRL
YANSKAVTL	YANSKAVTL
FSTFTITRL	FSTFTITRL
KAVASVARL	KAVASVARL
SAAVQILL	SA-AVQILL
FIADLVVGL	FIADLVVGL
SVGQPVFL	SV-GQPVFL
LATVLSIPELL	TVLSIPELL
AAPEGKRSL	AAPEGKRSL
FSHAQTVVL	FSHAQTVVL
YLVPRAVLL	YLVPRAVLL
TGAAPIIDVVR	GA-APIIDV
VGYDGPIYM	VGYDGPIYM
FALDGLKQVM	FALDGLKQV
ILPEIIPIL	ILPEIIPIL
ALYSKGILL	ALYSKGILL
AAGSHVIIL	AAGSHVIIL
IADPNIAKL	IADPNIAKL
LAGPASNL	LA-GPASNL
YSLPNAPTL	YSLPNAPTL
LAFPGEMLL	LAFPGEMLL
FLDEEVKL	FL-DEEVKL
FASPTSPPVL	FASTSPPVL
AAFGRDLFL	AAFGRDLFL
YALTAIMKL	YALTAIMKL
TVWPTMITPML	PT-MITPML
FASPDLPLL	FASPDLPLL
VAMKESLLL	VAMKESLLL
LAGLHVLL	LA-GLHVLL
AAFSLTSHL	AAFSLTSHL
SIFEENLF	SI-FEENLF
LLDGRVALL	LLDGRVALL
AEQRGELAIKD	RG-ELAIKD
KAAEVYTRL	KAAEVYTRL
FTLSHITQL	FTLSHITQL
GTYTLIIRL	GTYTLIIRL
AAVAPVLSI	AAVAPVLSI
NAAEAMLL	NA-AEAMLL
GIFQFPLNL	GIFQFPLNL
PVQEELSVL	PVQEELSVL
LQGPILRL	LQ-GPILRL
YGLPVVVKL	YGLPVVVKL
TAVSRPLFL	TAVSRPLFL
YAAQAHLKL	YAAQAHLKL
AALPVYQEL	AALPVYQEL
LLPSHPLEL	LLPSHPLEL
AAAEAVKL	AA-AEAVKL
HVYHHASML	HVYHHASML
LAGPVLGL	LA-GPVLGL
DLREKLDSF	DLREKLDSF
YGYSKLIEL	YGYSKLIEL
FSIADSIEL	FSIADSIEL
QAGPVIKV	QA-GPVIKV
YIIPVVLFL	YIIPVVLFL
GLYEGLTWL	GLYEGLTWL
KLHVDPENF	KLHVDPENF
YIALPLTL	YI-ALPLTL
VIIERLLLL	VIIERLLLL
TATATNHVL	TATATNHVL
AQLELISRI	AQLELISRI
LAFSRPSQL	LAFSRPSQL
GAVSTASHL	GAVSTASHL
IVGPVVGL	IV-GPVVGL
FAHKPLLL	FA-HKPLLL
SAALHIDL	SA-ALHIDL
KLLPQLTYL	KLLPQLTYL
VAGQVVEL	VA-GQVVEL
TAISLFYEL	TAISLFYEL
FALPSPQHI	FALPSPQHI
SAFLSAIFL	SAFLSAIFL
HAAPQPQKL	HAAPQPQKL
GSYGRKTVL	GSYGRKTVL
FLDSTSPLL	FLDSTSPLL
YAISKPDIL	YAISKPDIL
WADDWLVHL	WADDWLVHL
VVPDHPVLL	VVPDHPVLL
GAAVPVEL	GA-AVPVEL
SLVNLGGSK	SLVNLGGSK
FLITQLKML	FLITQLKML
LATRAIPEL	LATRAIPEL
FASFKPTYL	FASFKPTYL
ITKSIPIL	IT-KSIPIL
VAPFMANIPLL	VAPANIPLL
FAYDGKDYI	FAYDGKDYI
HAVLLVTQL	HAVLLVTQL
YAFPKSITV	YAFPKSITV
ELERPGGNEI	LERPGGNEI
YIADPNIAKL	IADPNIAKL
FLYPFPLAL	FLYPFPLAL
FIISRPTKL	FIISRPTKL
TVFERPTFL	TVFERPTFL
DAQLQIYTL	DAQLQIYTL
YAVVGTVLL	YAVVGTVLL
ILDNSPAFL	ILDNSPAFL
LADKNVPNL	LADKNVPNL
VAAAVSYL	VA-AAVSYL
KATGPPVSEL	KATPPVSEL
SAFLHAIRL	SAFLHAIRL
VAHKEIKL	VA-HKEIKL
IVQPIISKL	IVQPIISKL
AAYPRPGML	AAYPRPGML
FTSTPVSL	FT-STPVSL
SAIHTIAHL	SAIHTIAHL
IAILNNNLNTL	ILNNNLNTL
ASTARHLYL	ASTARHLYL
LASSYIAHL	LASSYIAHL
FLGYPITL	FL-GYPITL
PLIGCVLLL	PLIGCVLLL
IVDSYLPVIL	IVDYLPVIL
WVNILKNPHF	VNILKNPHF
LAFKEMFL	LA-FKEMFL
FLPDHPIVL	FLPDHPIVL
YAAEGQKL	YA-AEGQKL
AAPEGVPL	AA-PEGVPL
LALLLPVFL	LALLLPVFL
NAVSQITRM	NAVSQITRM
YAVGYMLRL	YAVGYMLRL
FAAGSATRL	FAAGSATRL
DAFSKDHQL	DAFSKDHQL
YIPNKVLIL	YIPNKVLIL
KSTSNITKL	KSTSNITKL
FAADAVKL	FA-ADAVKL
AAAGAPALL	AAAGAPALL
GPVYPHPVLL	PVYPHPVLL
SAGPLLRL	SA-GPLLRL
YVVPYMIHL	YVVPYMIHL
HASSSIVSL	HASSSIVSL
YVVPYTIHL	YVVPYTIHL
ILYGKIIHL	ILYGKIIHL
FSDVEAHF	FS-DVEAHF
AIIDKYIKL	AIIDKYIKL
KIYEEPIIL	KIYEEPIIL
ILPEYADIF	ILPEYADIF
GAADGVIRL	GAADGVIRL
FAIPGSIFL	FAIPGSIFL
VSAAGLVQGL	SAAGLVQGL
SSSDAIYL	SS-SDAIYL
TAAKEIEV	TA-AKEIEV
IAVKDGILL	IAVKDGILL
FVYNGPHML	FVYNGPHML
FAIRPMYL	FA-IRPMYL
RPPGFSPFR	RPPGFSPFR
VAIVHAVLL	VAIVHAVLL
FTADPLSL	FT-ADPLSL
AATDIFSYL	AATDIFSYL
AAAPPLTL	AA-APPLTL
NLRTALIFGGF	NL-RTALIF
GLPRWVTLL	GLPRWVTLL
FADSHLWKL	FADSHLWKL
VAYWRQAGL	VAYWRQAGL
YAAPHFFHL	YAAPHFFHL
TAFPEASFL	TAFPEASFL
LTDQTLIYL	LTDQTLIYL
VAHVDDMPNAL	HVDDMPNAL
ALGPILRL	AL-GPILRL
EVGGEALGRLL	VGGEALGRL
FISLDEINL	FISLDEINL
RAAPPPLFL	RAAPPPLFL
ASINSTVRL	ASINSTVRL
STIRLLTSL	STIRLLTSL
AALRLLTYL	AALRLLTYL
NASEHIVYL	NASEHIVYL
SAFNEITKL	SAFNEITKL
VTYPGELLL	VTYPGELLL
ILLTQITNL	ILLTQITNL
STPQHPLLL	STPQHPLLL
KAFPYSSHL	KAFPYSSHL
IAAGIFNDL	IAAGIFNDL
VLDVVERSL	VLDVVERSL
IANPTATLL	IANPTATLL
LSDTRTRYL	LSDTRTRYL
TISPIIKL	TI-SPIIKL
KAFNHRSYL	KAFNHRSYL
VSAIPIWL	VS-AIPIWL
VIPESVILL	VIPESVILL
YAAQPELL	YA-AQPELL
GQYSHLVLL	GQYSHLVLL
FAGPHSTL	FA-GPHSTL
SATLPNYL	SA-TLPNYL
VAPSRLDF	VA-PSRLDF
AAVHGTTKL	AAVHGTTKL
MIPYQIGDVF	IPYQIGDVF
LSSDPIAL	LS-SDPIAL
FSIGVGSRL	FSIGVGSRL
GAYDHSYVEL	GAYHSYVEL
AVKDLVVLL	AVKDLVVLL
FLSSVIQNL	FLSSVIQNL
YADPSILYI	YADPSILYI
YALDLSTFL	YALDLSTFL
FLITQLKM	FL-ITQLKM
SASASSPKL	SASASSPKL
RVVDNPIYL	RVVDNPIYL
FASHVSPEV	FASHVSPEV
AEQRGENALKD	AEQRGENAL
AELNEFLTR	AELNEFLTR
YQVDSRTYL	YQVDSRTYL
FADLNLAEF	FADLNLAEF
FVLGHFILL	FVLGHFILL
AAGSPLSL	AA-GSPLSL
LLGPWLLL	LL-GPWLLL
AKNKLNDLED	AK-NKLNDL
SSGREIYL	SS-GREIYL
GAWSIPWKWL	GA-WSIPWK
GSVSDIIRL	GSVSDIIRL
SAAFAVKL	SA-AFAVKL
FAVATPEEL	FAVATPEEL
