Data	Data aligned
TQIGGERYNF	TQIGGRYNF
KLDSGKELKI	KLDSGELKI
GLSRELFESW	GLSREFESW
DLIGVVEAL	DLIGVVEAL
RVVDFDETW	RVVDFDETW
VQHNMVDVL	VQHNMVDVL
RLAEYFIGDVF	RLAEYGDVF
RQWLEASSQL	RQWLESSQL
RLIEQEEYL	RLIEQEEYL
RQYEEKNKEF	RQYEENKEF
GLVPRLLGDIL	LVPRLGDIL
RLIRDLHQHL	RLIRDHQHL
AQIKANYDVL	AQIKAYDVL
SLSRIGDEL	SLSRIGDEL
RLQLEKAAWRW	RLQLEKAAW
ALEALVPVTI	ALEALPVTI
HQSEVAQSF	HQSEVAQSF
RLMVPVTVVF	RLMVPTVVF
RVSQDGLDLL	RVSQDLDLL
ILAAVETRL	ILAAVETRL
RVAHFGYHW	RVAHFGYHW
LLIDDKGTIKL	LLIDDKGTI
QVSSEDVRW	QVSSEDVRW
HLDISRDRL	HLDISRDRL
KQPRQDYQL	KQPRQDYQL
KQFQFGHAL	KQFQFGHAL
RLEIEAENHYW	RLEIEENHY
RQAAEDKSW	RQAAEDKSW
YQLDLPKANLL	QLDLPANLL
RVDTTLLGF	RVDTTLLGF
ILDPRPTII	ILDPRPTII
SQIDDLYSTI	SQIDDYSTI
RLFKNQEDL	RLFKNQEDL
HLETGGQKI	HLETGGQKI
AQYEHDLEV	AQYEHDLEV
RQQEYKEKL	RQQEYKEKL
QQIQEKVATF	QQIQEVATF
RSIDMDNYML	SIDMDNYML
SQPERDWVL	SQPERDWVL
GQIQVNIQEW	GQIQVIQEW
TQDNGILTF	TQDNGILTF
KLYPWIHQF	KLYPWIHQF
GQAPPGKAL	GQAPPGKAL
FQALPHELF	FQALPHELF
YQFIEPFEEKF	FIEPFEEKF
RQDNSILKV	RQDNSILKV
RLAELQEQL	RLAELQEQL
KQLDPGQRDLF	QLDPGRDLF
RVAPEQQMI	RVAPEQQMI
RQSPHSNLF	RQSPHSNLF
RILDLIDDAW	RILDLDDAW
RIEENTGHTF	RIEENGHTF
RQFFNEPEENF	RQFFNEENF
QQIKDLEQKL	QQIKDEQKL
ALSPVPSHW	ALSPVPSHW
SSPAPRTAL	SSPAPRTAL
KQVTTAENL	KQVTTAENL
RQLEQELHKW	RQLEQLHKW
LQRANDDRW	LQRANDDRW
RLFGPVDSEQL	RLFGPSEQL
KQMPDVNVSW	KQMPDNVSW
RQEELRVYL	RQEELRVYL
KLADIQIEQL	KLADIIEQL
VQQDPKHMEAW	QQDPKMEAW
RLSSDTTLM	RLSSDTTLM
KLESIDKIARW	KLES-IDKI
ITHKGEIEI	ITHKGEIEI
GQMVIDEELL	GQMVIEELL
KLPNYEEKI	KLPNYEEKI
GLQTKEEVSI	LQTKEEVSI
RLYPLAIQI	RLYPLAIQI
LLDVTPLSL	LLDVTPLSL
AQAAREFIL	AQAAREFIL
GQSGAGNNW	GQSGAGNNW
HLDGNVLDHF	HLDGNLDHF
GQDEPLIHVF	GQDEPIHVF
KMIDSGDKL	KMIDSGDKL
RISEAYESL	RISEAYESL
AQIPVVFRL	AQIPVVFRL
LQINDKIAL	LQINDKIAL
GQDAVAIEL	GQDAVAIEL
RQSVYEEKL	RQSVYEEKL
RQLNEKLVQLI	RQLNELVQL
RVWQWDEKW	RVWQWDEKW
KLTELEQRI	KLTELEQRI
YQQQGRLDKL	QQQGRLDKL
KLKSNDGEERL	KSNDGEERL
YQNEDEKVTL	YQNEDKVTL
SQQERDWVL	SQQERDWVL
RVIDVGSEW	RVIDVGSEW
RQMSIHMEEL	RQMSIMEEL
RQLEEKKAEL	RQLEEKAEL
GQADVISKL	GQADVISKL
KQAHVDVKF	KQAHVDVKF
HQILTPFLL	HQILTPFLL
RLVKEYTVL	RLVKEYTVL
GQTSVIEQI	GQTSVIEQI
QQHQALQTNW	QQHQAQTNW
RILRDIETF	RILRDIETF
GQSAVASNI	GQSAVASNI
RQALVEFEDVL	ALVEFEDVL
RMNQEIVNL	RMNQEIVNL
KLLPGIEVLW	KLLPGIEVL
RQYAKDIGF	RQYAKDIGF
RLFNDPVAMV	RLFNDPVAM
KQMVEDYQWL	KQMVEDYQW
RISKDEHQDL	RISKDHQDL
RVSKILKEEW	RVSKIKEEW
QQDQVDRNI	QQDQVDRNI
KQAFGEKITM	KQAFGKITM
HIAQRDYSW	HIAQRDYSW
RQDLTQSLI	RQDLTQSLI
HIDNNILLI	HIDNNILLI
VVAPGQEKI	VVAPGQEKI
FQAWDDARM	FQAWDDARM
SQIDAEFEKM	SQIDAFEKM
SQANVVVKI	SQANVVVKI
KLISSDGHEF	KLISSGHEF
RLLGTPSQETW	LLGTPQETW
GQHADIYKL	GQHADIYKL
RLIPTLVSI	RLIPTLVSI
RIIDVIDKELI	RIIDVDKEL
HQFQNSADSL	HQFQNADSL
VQFPGDQDLRF	VQFPGDQDL
YLSLTPEQW	YLSLTPEQW
RLQHLAESW	RLQHLAESW
HQNVESHLL	HQNVESHLL
KQQEYEEQF	KQQEYEEQF
KQESIVLKL	KQESIVLKL
KLDSSETTM	KLDSSETTM
GQFSKPFSF	GQFSKPFSF
KLAPKDVKI	KLAPKDVKI
AQVVGVLKI	AQVVGVLKI
KLFQGQLVL	KLFQGQLVL
VQNEAKLDEI	VQNEALDEI
RQHEKTHWL	RQHEKTHWL
RQYHENIKI	RQYHENIKI
KQDFSPEVL	KQDFSPEVL
RLILIESRI	RLILIESRI
HQSNVFHHI	HQSNVFHHI
HQVDYILETW	HQVDYLETW
ALAVLEDRF	ALAVLEDRF
GQEKNSSNFI	GQEKNSSNF
KQSVHIVENEI	SVHIVENEI
RQVQDLHVKL	RQVQDHVKL
HLAWFGDSL	HLAWFGDSL
RIMEVIDAI	RIMEVIDAI
RIAHIPLYF	RIAHIPLYF
QVVEDGYEFF	QVVEDYEFF
RMFADDLHNL	RMFADLHNL
ISPTGHSL	ISPT-GHSL
KLLTEKDAQI	KLLTEDAQI
AEQRGENALKD	AEQRGENAL
SQINLSVENAW	QINLSENAW
RQPIPVKDLL	RQPIPKDLL
RLMQEVNRQL	RLMQENRQL
EGTVIIPNL	EGTVIIPNL
GQDPPSGDRL	GQDPPGDRL
YQQELEREL	YQQELEREL
ALDSPGTDHF	ALDSPTDHF
KIVEIINEELW	KIVEINEEL
VQYALPLQL	VQYALPLQL
AQARDEEQRL	AQARDEQRL
MAPLKMLAL	MAPLKMLAL
RLIEEENML	RLIEEENML
RQAWLGEEVL	RQAWLEEVL
RLNDGNEYL	RLNDGNEYL
VLLNEDGKQLL	LLNEDKQLL
HLVSEDVKW	HLVSEDVKW
RTVKVGDTL	RTVKVGDTL
RQFPGSHRV	RQFPGSHRV
RQPLEGSDLW	RQPLESDLW
KQFEGLADKL	KQFEGADKL
RLQIEKERL	RLQIEKERL
AQDKQFGTW	AQDKQFGTW
RQAQASFRDGL	AQASFRDGL
RLSVEKATI	RLSVEKATI
LQDNPASGEKF	LQDNPGEKF
YLAKHIENI	YLAKHIENI
QIHQGEERL	QIHQGEERL
RVHPETYEW	RVHPETYEW
RLAELTVDEFL	RLAELVDEF
KQIMENAEI	KQIMENAEI
ALNSREPHM	ALNSREPHM
YLVKREDYL	YLVKREDYL
EQNRQPLLL	EQNRQPLLL
KLSPEELLL	KLSPEELLL
RIEPPDRRW	RIEPPDRRW
RMNALFVQF	RMNALFVQF
KQDALDYITW	KQDALYITW
GQQQETETF	GQQQETETF
KMQELEAKL	KMQELEAKL
RQMKEDAEKF	RQMKEAEKF
LLSIVNPEW	LLSIVNPEW
RLDNEKEGF	RLDNEKEGF
HLAVNDFEL	HLAVNDFEL
QESNVQLKL	QESNVQLKL
KLSETFLHI	KLSETFLHI
KMWEEAISL	KMWEEAISL
ILGPTFTL	ILGP-TFTL
VLFEDAVAHI	VLFEDVAHI
RQADTKAIQHL	RQADTIQHL
KESEVVMKF	KESEVVMKF
RLWEDSAGEKW	RLWEDGEKW
HLSSIEVLI	HLSSIEVLI
LLQEEFVKW	LLQEEFVKW
RQYLDEEFVL	RQYLDEFVL
KQYEEFYVGL	KQYEEYVGL
RQVETTETL	RQVETTETL
HLDRIVALF	HLDRIVALF
KQLAEDVKL	KQLAEDVKL
GQMPSDKTI	GQMPSDKTI
YQTEIGQTL	YQTEIGQTL
KQYTGINAI	KQYTGINAI
LLTTMGDRF	LLTTMGDRF
RQMEHFLDSW	RQMEHLDSW
RQIEETLAHF	RQIEELAHF
RLFPGLAIKI	RLFPGAIKI
HMIRDIQTL	HMIRDIQTL
FQLIQKELI	FQLIQKELI
RLLEQEKSL	RLLEQEKSL
RQQEYDFKM	RQQEYDFKM
RLDQAVLDL	RLDQAVLDL
HLNALEERF	HLNALEERF
RQIDLVDNYF	RQIDLDNYF
RLLDYVVNI	RLLDYVVNI
KQMEDGHTLF	KQMEDGHTL
ALAPILDD	ALAP-ILDD
RLVGKETSI	RLVGKETSI
RMIMEGQYQF	RMIMEQYQF
HQFESSFEL	HQFESSFEL
RLLSLVKEEF	RLLSLKEEF
RLIVLFSHW	RLIVLFSHW
SLSQVFLHL	SLSQVFLHL
KMDRALLEL	KMDRALLEL
RLIHEQDLEWL	RLIHEDLEW
AQQPQKEAAL	AQQPQEAAL
ALTDDGRVFLW	ALTDDRVFL
HIQKEDVPSE	HIQKEVPSE
GQDPRINVVL	GQDPRNVVL
SLVALSEKL	SLVALSEKL
RLVVTADDF	RLVVTADDF
LLSLVKEEF	LLSLVKEEF
LLSEIEEHL	LLSEIEEHL
RVREEHQGENL	REEHQGENL
YLNDLHEVL	YLNDLHEVL
KLTPVPDSF	KLTPVPDSF
IQARLPLLL	IQARLPLLL
RQWEEQGEL	RQWEEQGEL
RLNEKNYELL	RLNEKYELL
AQAEAADSW	AQAEAADSW
RLEESRRLW	RLEESRRLW
YLTELIDRF	YLTELIDRF
RISPDRVYI	RISPDRVYI
AQDFLLKWSF	AQDFLKWSF
GQHPSQHLI	GQHPSQHLI
IVIGDEHISF	IVIGDHISF
RLDDSSFLGL	RLDDSFLGL
RLREVSEKL	RLREVSEKL
SQEEKAAYL	SQEEKAAYL
KLVWFDLDL	KLVWFDLDL
RLHSGEVKF	RLHSGEVKF
HQASHQPLYL	HQASHPLYL
RLDIDPETITW	RLDIDPETI
RQDRDALHM	RQDRDALHM
RQWDYTEKL	RQWDYTEKL
RLWNIQTDTL	RLWNITDTL
AQFEHTILL	AQFEHTILL
RLVRELEKKF	RLVREEKKF
KQIAEAVRL	KQIAEAVRL
RLFILDEADKL	FILDEADKL
GQRKEVEVF	GQRKEVEVF
RLDSDEQKI	RLDSDEQKI
GQTAEVPNL	GQTAEVPNL
RTDYSFHKF	RTDYSFHKF
RQDIDTQKI	RQDIDTQKI
KIMEEKIQI	KIMEEKIQI
RIASEASRL	RIASEASRL
GQGILSQDAW	GQGILQDAW
LLALVKPEVW	LLALVPEVW
RQFHEKTSAL	RQFHETSAL
AQTRLGNGW	AQTRLGNGW
RQPSVIYSWI	RQPSVIYSW
RQLEEKEKL	RQLEEKEKL
GQMAYILQL	GQMAYILQL
KQDETQTKI	KQDETQTKI
AQAIKGMHI	AQAIKGMHI
RLEQEEQQRL	RLEQEQQRL
QQDPVIYQRL	QQDPVYQRL
KLDPSPQTI	KLDPSPQTI
LLSDTKLEL	LLSDTKLEL
GQLALDPSL	GQLALDPSL
HVIDDFVQF	HVIDDFVQF
RLAEDKAEL	RLAEDKAEL
RLALLQEQW	RLALLQEQW
GLWRGEEVTL	GLWRGEVTL
RLSPIENFL	RLSPIENFL
AQLRFIQAW	AQLRFIQAW
SSYAHKASSI	SSYAHASSI
KLDSGKELHI	KLDSGELHI
ILRAILEVL	ILRAILEVL
KLIGLAVDYF	KLIGLVDYF
RVVKGQVEYL	RVVKGVEYL
SQISAGEEKW	SQISAEEKW
HQDEDKQLI	HQDEDKQLI
HMAVAREDL	HMAVAREDL
RMFNSIAETW	RMFNSAETW
KLDPKALEW	KLDPKALEW
RLSQVSDSV	RLSQVSDSV
SQVRDVIGF	SQVRDVIGF
RLLDKLVGEFL	LLDKLGEFL
VLSDLDQKW	VLSDLDQKW
KQLEAINDKL	KQLEANDKL
RQYKGMFDTL	RQYKGFDTL
KLANVFFDTF	KLANVFDTF
VQGHVEELW	VQGHVEELW
ALFDKSINEFW	ALFDKINEF
HQDDFNQLL	HQDDFNQLL
RLLAETHYQL	RLLAEHYQL
ALERRIEYI	ALERRIEYI
RLSEEEQRL	RLSEEEQRL
RLEKNVKEVL	RLEKNKEVL
KQTTKSELL	KQTTKSELL
GIDQSYQLL	GIDQSYQLL
RIIKNEVKKL	RIIKNVKKL
KLIKGVERL	KLIKGVERL
KLYGKPIRV	KLYGKPIRV
KQFFEEVGI	KQFFEEVGI
GQDIEYIEI	GQDIEYIEI
ALFNGAQKL	ALFNGAQKL
RQNLFQEAEEF	NLFQEAEEF
RMSYNEKSDIW	RMSYNKSDI
KLSEDGTYTGF	KLSEDYTGF
AMPLPGVGEEL	PLPGVGEEL
HLSSLIAQL	HLSSLIAQL
AQILQSDLL	AQILQSDLL
HLANIVERL	HLANIVERL
KLYENLGEYF	KLYENGEYF
YQYLGEPETF	YQYLGPETF
RQLDETNALL	RQLDENALL
KQAEEPRGSSL	KQAEEGSSL
RQQQPPPETF	RQQQPPETF
ILSGVVTKM	ILSGVVTKM
RLDQEHSDKF	RLDQESDKF
SQLPVDHIL	SQLPVDHIL
RIVAPGKGI	RIVAPGKGI
RLEETQALL	RLEETQALL
KLESIGQRI	KLESIGQRI
AQHKADMQRW	AQHKAMQRW
RQVEEAERL	RQVEEAERL
ANALGGKGAGF	ALGGKGAGF
RLYHELVGL	RLYHELVGL
RTVEDFNKF	RTVEDFNKF
LIIWGVLEL	LIIWGVLEL
RQFDVDILI	RQFDVDILI
LIVDRDEAW	LIVDRDEAW
RLIEPPHTDSL	LIEPPTDSL
HLDDQMTLL	HLDDQMTLL
RIMQDFESDTF	MQDFESDTF
RILGSDTESW	RILGSTESW
RQELTYQEL	RQELTYQEL
RLFPNSFNDKF	RLFPNNDKF
GVSHVFEYI	GVSHVFEYI
KLYEEKTGNAW	KLYEEGNAW
TQMPDPKTF	TQMPDPKTF
KQHIPDAKL	KQHIPDAKL
RQAAGKIFEIF	RQAAGIFEI
KQIQEKQGQL	KQIQEQGQL
RLHQEERMKL	RLHQERMKL
RMVNDAEKF	RMVNDAEKF
KAPGSTSNL	KAPGSTSNL
SIDKTEAGI	SIDKTEAGI
KQELIQAEI	KQELIQAEI
AQAADVLEL	AQAADVLEL
ALVALKDLL	ALVALKDLL
RLLDSEIKI	RLLDSEIKI
RLFTEKVNNTF	RLFTENNTF
KQMKSEVATL	KQMKSVATL
RQHFIQEEQI	RQHFIEEQI
AQAKAGNLM	AQAKAGNLM
RLLLPVAEYF	RLLLPAEYF
GQDMLYQSL	GQDMLYQSL
IMDSLFQSF	IMDSLFQSF
HQTRAEEGL	HQTRAEEGL
RIYNFAHRF	RIYNFAHRF
RLNSAPDMR	RLNSAPDMR
RVMDASAFEIF	RVMDAAFEI
RGDDTPLHL	RGDDTPLHL
RQIITDHRW	RQIITDHRW
YLDQVKLQF	YLDQVKLQF
RQLEIVGEKL	RQLEIGEKL
HMVSDEYEQL	HMVSDYEQL
ALAPSTMKI	ALAPSTMKI
RQDTVRSFL	RQDTVRSFL
AQSYIAHNF	AQSYIAHNF
SQSPMLLEL	SQSPMLLEL
HLIPDGEITSI	LIPDGITSI
KQSEDMHAF	KQSEDMHAF
LLIGQTEVDIM	LLIGQEVDI
AQMEVASFLL	AQMEVASFL
KLIETGERERL	KLIETRERL
SQYEALKEDW	SQYEAKEDW
RQHNYTEAF	RQHNYTEAF
YQLQTIKPENF	QLQTIPENF
GQYDGKVDVW	GQYDGVDVW
FQRLAALKL	FQRLAALKL
KESSAKLYI	KESSAKLYI
SQVIIREGELL	VIIREGELL
SQEMDAGLQAW	EMDAGLQAW
KQMAAEEAM	KQMAAEEAM
GLIEVKTDEF	GLIEVTDEF
HLEKSVEKI	HLEKSVEKI
RLKEAEEERL	RLKEAEERL
RQAFPNTNRW	RQAFPTNRW
RQAIHEPKL	RQAIHEPKL
AAPATRAAL	AAPATRAAL
RVINEEYKI	RVINEEYKI
AQSAVEILL	AQSAVEILL
KQVDDLASVW	KQVDDASVW
RQGKFEAAETL	RQGKFAETL
LLSEEEYHL	LLSEEEYHL
SQFLADTERF	SQFLATERF
RQIGVEHVV	RQIGVEHVV
AIDFTHEEW	AIDFTHEEW
RLQAEAQEL	RLQAEAQEL
KLDLERETI	KLDLERETI
KQFAEGSTL	KQFAEGSTL
SLIDADPYL	SLIDADPYL
RQVKGDLAFL	RQVKGDLAF
KIVEIDAHI	KIVEIDAHI
AIVKEIVNI	AIVKEIVNI
AIWKELISL	AIWKELISL
SLIELFESF	SLIELFESF
RLIALDAAEEF	LIALDAEEF
AQDFKTDLRF	AQDFKDLRF
RMESSINHI	RMESSINHI
RLAHVGPRL	RLAHVGPRL
RLLLDHEAL	RLLLDHEAL
HQDITEDSF	HQDITEDSF
SLAEDNLKL	SLAEDNLKL
RVEGMTELYF	RVEGMELYF
GLSKDITHF	GLSKDITHF
FQEDIISIW	FQEDIISIW
GQHAVSAYL	GQHAVSAYL
RTVYFSEQW	RTVYFSEQW
ALDEVVLKF	ALDEVVLKF
RQGKVEDKW	RQGKVEDKW
AQQELKLLL	AQQELKLLL
GQVKILEDSF	GQVKIEDSF
ALDKATVLL	ALDKATVLL
LLDSQSHHL	LLDSQSHHL
ALAVRGSDR	ALAVRGSDR
RVSHLIEHL	RVSHLIEHL
RQHTQIVRL	RQHTQIVRL
RMNEVISLW	RMNEVISLW
LQATEDAKL	LQATEDAKL
RLQAEAQQL	RLQAEAQQL
RQSKNEALL	RQSKNEALL
RLAQEAASKL	RLAQEASKL
RQQAAPDADL	RQQAADADL
FLYQPDWRF	FLYQPDWRF
GQTREHALL	GQTREHALL
RQFSGARNQL	RQFSGRNQL
LQSKLKDLF	LQSKLKDLF
RSLDDALKL	RSLDDALKL
KLDGLIHRF	KLDGLIHRF
LLDSSHSEL	LLDSSHSEL
RLHNVFNDFL	RLHNVNDFL
SLYQDQILEKF	YQDQILEKF
AQFHPEVGL	AQFHPEVGL
YLIEPDVEL	YLIEPDVEL
AQLNFTKDQL	AQLNFKDQL
KQFHSVEVHKW	KQFHSVHKW
IVQGPDPNL	IVQGPDPNL
LLDKKSLKI	LLDKKSLKI
RQTVADQVL	RQTVADQVL
FLYSDEVQI	FLYSDEVQI
KLIGDPNLEF	KLIGDNLEF
KQNHESVQW	KQNHESVQW
TLDTIQLAF	TLDTIQLAF
RQIASQLEQEW	QIASQEQEW
RLIKEKEEAF	RLIKEEEAF
RQLDTVNFF	RQLDTVNFF
RLLSELEYEAW	LLSELYEAW
RIADKEVTI	RIADKEVTI
GQFRDQIKF	GQFRDQIKF
QGLNEGVGQGI	GLNEGGQGI
GQDKIRPLW	GQDKIRPLW
KLEAEADKIGL	KLEAEADKI
KMDEVLYSI	KMDEVLYSI
IQDFMFHGI	IQDFMFHGI
RQRDADVEKI	RQRDAVEKI
AQHDDELTI	AQHDDELTI
RVIKGNIDKF	RVIKGIDKF
KQEGIATSDNF	KQEGIATSD
MQEPSAHTF	MQEPSAHTF
AQLPMSIRI	AQLPMSIRI
HIIHIDFGF	HIIHIDFGF
RLLHHDDPEVL	LLHHDPEVL
LLQGHERSI	LLQGHERSI
RLAQEGIYTL	RLAQEIYTL
RQDVATNLL	RQDVATNLL
GQALPEMEI	GQALPEMEI
IIDPGDSDII	IIDPGSDII
RLEKSGDLL	RLEKSGDLL
KMMDVTVTI	KMMDVTVTI
KQMEDGHTL	KQMEDGHTL
HIFKDKVVL	HIFKDKVVL
RVVKNFEHL	RVVKNFEHL
RLQTSEAAL	RLQTSEAAL
RQILEGVHFL	RQILEVHFL
KLLPETVTI	KLLPETVTI
KQLSLKVDEL	KQLSLVDEL
RLIQETEVI	RLIQETEVI
YLAYDIGNHF	YLAYDGNHF
ILQRVIDYI	ILQRVIDYI
RLENDGATAL	RLENDATAL
RIMEIVDAI	RIMEIVDAI
KLIDTIPDDKL	LIDTIDDKL
KQAEVVGYF	KQAEVVGYF
IAPTGHSL	IAPT-GHSL
ALVDVIEDKL	ALVDVEDKL
VQMQREWSF	VQMQREWSF
RQPRNPKTDKL	RQPRNTDKL
AQQAEEGSARL	QQAEESARL
KQLKEAQGKI	KQLKEQGKI
LQDLTPLKL	LQDLTPLKL
RLQIEREKL	RLQIEREKL
KLPSGEDYNL	KLPSGDYNL
LELARKIIL	LELARKIIL
RILIEFDTL	RILIEFDTL
RQDPDKQLM	RQDPDKQLM
LLTEISSSW	LLTEISSSW
KQTEIAKRL	KQTEIAKRL
RLPVGGFADLM	RLPVGFADL
GQVHLFEHI	GQVHLFEHI
YQARDLMLM	YQARDLMLM
GQDPKNFSEI	GQDPKFSEI
RLLPSELTLW	RLLPSELTL
SLVEVDREFW	SLVEVREFW
RQVKGDLAF	RQVKGDLAF
KKLQREKKI	KKLQREKKI
QQAEEGSARL	QQAEESARL
KQFLSETEKM	KQFLSTEKM
SLFSDKQMI	SLFSDKQMI
RQQEVETEL	RQQEVETEL
YQLTIEPLL	YQLTIEPLL
KQTEVETVM	KQTEVETVM
RLSQALKEHL	RLSQAKEHL
HLQQDSLKL	HLQQDSLKL
KQDAVDYLTW	KQDAVYLTW
YQHKEEYQL	YQHKEEYQL
RLESRTQLVTM	RLESRTQLV
ALAKTEVSL	ALAKTEVSL
RISNMIAKL	RISNMIAKL
SLAADAGLLQF	SLAADAGLL
MVDGTLLLL	MVDGTLLLL
RLDDSVFEGL	RLDDSFEGL
KLTEDKETL	KLTEDKETL
EPFGKIDNIVL	KIDN--IVL
MIINDPRYSAL	IINDPYSAL
AQVKEAGIAW	AQVKEGIAW
YLFPNRLEW	YLFPNRLEW
RLRQERESL	RLRQERESL
VLDQKEHRL	VLDQKEHRL
RIINDLLQSL	RIINDLQSL
RLYNKIREDF	RLYNKREDF
RQYGEVANL	RQYGEVANL
LQIDDVTIKI	LQIDDTIKI
RVAIEHLDKI	RVAIELDKI
AQHLFIQTFW	AQHLFIQTF
RLYKYDHNF	RLYKYDHNF
AQIKELEEL	AQIKELEEL
RVDITLLGF	RVDITLLGF
KLLDLENENM	KLLDLNENM
AQEALTVLSL	AQEALVLSL
GQSVLRSSW	GQSVLRSSW
RMYDERAQEW	RMYDEAQEW
RLFQENSVL	RLFQENSVL
KLSSHEEAL	KLSSHEEAL
RLDEAFDFV	RLDEAFDFV
KLSPEELLLRW	KLSPEELLL
RIINEPTAAAI	IINEPAAAI
AQFEPDSTEYI	AQFEPTEYI
RIIGAKDHASI	RIIGAHASI
RQQGKEVGETL	QQGKEGETL
RLFNEQNFF	RLFNEQNFF
IIDTPGHESF	IIDTPHESF
ALDPTARKI	ALDPTARKI
VLYVENERW	VLYVENERW
RMVQNLLDKL	RMVQNLDKL
ESQDQVFLRW	SQDQVFLRW
RVAPEEHPVLL	RVAPEHPVL
RLDELNLSW	RLDELNLSW
HLIHEQIPLSL	LIHEQPLSL
RLGPPEPMM	RLGPPEPMM
KLSEIPLTL	KLSEIPLTL
KLDAEVSKW	KLDAEVSKW
KLYANMFERL	KLYANFERL
RQISQDFSEL	RQISQFSEL
GQDYEHVTM	GQDYEHVTM
ALFPGDVDRL	ALFPGVDRL
GLVLDPKVGF	GLVLDKVGF
SLDAHEETI	SLDAHEETI
RQPMPDPGL	RQPMPDPGL
HQDQMVQKI	HQDQMVQKI
AQVADVVVSRW	QVADVVSRW
KLAEQYESF	KLAEQYESF
RMQGQEAVL	RMQGQEAVL
ALGPLVGDNF	ALGPLGDNF
RIIKETQRL	RIIKETQRL
QQIAKDMERW	QQIAKMERW
RQPLITLQYF	RQPLILQYF
YQQSMDSKL	YQQSMDSKL
RVDPNGSRYL	RVDPNSRYL
RLMKELNQKL	RLMKENQKL
SIASPDVKL	SIASPDVKL
RLSQIKEKM	RLSQIKEKM
VIDDAFALW	VIDDAFALW
LQNIGIDKI	LQNIGIDKI
SVPEAQSAL	SVPEAQSAL
RLEKPAKYDDI	RLEKPYDDI
TQAPVVPYW	TQAPVVPYW
RLVSWVNLI	RLVSWVNLI
RQLSEEERGRL	QLSEERGRL
RLLSVEHEDF	RLLSVHEDF
HLANEKNLKL	HLANENLKL
KIFPMGDRL	KIFPMGDRL
SQDPDFLTI	SQDPDFLTI
RLANIDEEML	RLANIEEML
KTDPTERLTI	KTDPTRLTI
RLAEISDVW	RLAEISDVW
KLEEKERAL	KLEEKERAL
RLYTEDEFEKF	RLYTEFEKF
SQIKQEVENF	SQIKQVENF
RQFYEEELI	RQFYEEELI
WLSSVVDHF	WLSSVVDHF
HLLAEQEKQQF	LLAEQKQQF
RLYHEADKTYM	RLYHEADKT
RMAPDYDHL	RMAPDYDHL
SIAHIGDVM	SIAHIGDVM
RQAQQERDEL	RQAQQRDEL
RLYPEGLAQL	RLYPELAQL
RQESSVRLW	RQESSVRLW
KLIKEGDIV	KLIKEGDIV
RQLDVSSNEL	RQLDVSNEL
GVIDDAFALW	GVIDDAFAL
RVSINGYDHF	RVSINYDHF
AQIKAGYQSL	AQIKAYQSL
RQLEEEGITF	RQLEEGITF
RLNVEFALI	RLNVEFALI
RITNVQILI	RITNVQILI
KIQQGALELL	IQQGALELL
RQWEEQGELLL	RQWEEGELL
KIAHVFLDLT	KIAHVFLDL
RQEKEITKL	RQEKEITKL
AQNGVSQLI	AQNGVSQLI
RQFPFHEMF	RQFPFHEMF
IQDKSVSFF	IQDKSVSFF
KLVSIEKEKI	KLVSIKEKI
GQIPLKEVTF	GQIPLEVTF
RQTFVIHKL	RQTFVIHKL
RLLEDSALSKY	RLLE-DSAL
RIYESHVGI	RIYESHVGI
LQHGAEPTI	LQHGAEPTI
RLAPYIIDL	RLAPYIIDL
RLSPNEEAF	RLSPNEEAF
RLIGHQEAF	RLIGHQEAF
FQLRDKYMF	FQLRDKYMF
HLPASGLDIF	HLPASLDIF
HQSGIVQLLW	HQSGIVQLL
HQTSAESW	HQTS-AESW
VMVDDRLVTM	VMVDDLVTM
RLIFQPIEESF	LIFQPEESF
GVVQSGDHI	GVVQSGDHI
HLIGSGSEKM	HLIGSSEKM
DRPHEGTRPVR	RPHEGRPVR
ALREENEQL	ALREENEQL
RQFEDEKANW	RQFEDKANW
AQHPSALRF	AQHPSALRF
SQIADVARF	SQIADVARF
RLFVGEPVW	RLFVGEPVW
GQASGELLQQI	GQAS-GELL
YLESKDNQKL	YLESKNQKL
FQAEIAQLM	FQAEIAQLM
RQEAIDWLL	RQEAIDWLL
RIAQGLSSESW	AQGLSSESW
RQLQDPLVIM	RQLQDPLVI
TQANPGKGEGL	QANPGGEGL
HQAKAGSDKL	HQAKASDKL
RQEDGIKNFF	RQEDGKNFF
RILDMGFADTM	ILDMGADTM
KLLEGEEERL	KLLEGEERL
RQHLGKGHLL	RQHLGGHLL
RLEDELGGQFL	RLEDEGGQF
RLPGGPTLTF	RLPGGTLTF
KLAEAERVGL	KLAEARVGL
IMDVTEEVW	IMDVTEEVW
AQDVFNHSW	AQDVFNHSW
HLSSGHLKW	HLSSGHLKW
QQWQDLMSI	QQWQDLMSI
QQFSKVIDEL	QQFSKIDEL
RAANILVSDTL	AANILSDTL
QEARNIYQEF	QEARNYQEF
KQIQEDWEL	KQIQEDWEL
YLINMHVDEF	YLINMVDEF
HLVPPEIIQSL	LVPPEIQSL
RIIDEVVNKF	RIIDEVNKF
ALVRDILYV	ALVRDILYV
RIMDPEIAL	RIMDPEIAL
KMTQIMFETF	KMTQIFETF
SQIEADFRL	SQIEADFRL
KQEFLEQKI	KQEFLEQKI
RQDKLKVHM	RQDKLKVHM
KLTEENTTL	KLTEENTTL
SQAPEAWRL	SQAPEAWRL
RIATDRLHI	RIATDRLHI
RQADFEAHNI	RQADFAHNI
ATDGKVLLW	ATDGKVLLW
AQSRIALAL	AQSRIALAL
RIHSGEKSESI	RIHSGSESI
SQVALADKELL	QVALAKELL
GLSFVRLLL	GLSFVRLLL
LQDGHEREYI	LQDGHREYI
RSMGLPLQF	RSMGLPLQF
QIDDVTIKI	QIDDVTIKI
RLVHTTAIEHF	LVHTTIEHF
YQDMPEYENF	YQDMPYENF
AQSKKITKEEF	AQSKKKEEF
RVESLEMERW	RVESLMERW
KQIFEDHVF	KQIFEDHVF
RQADFVQVL	RQADFVQVL
KQENTQTEQKL	KQENTEQKL
HLNPSDTEEW	HLNPSTEEW
RILDILEYI	RILDILEYI
RQLAEEILM	RQLAEEILM
SQHDGSITASL	SQHDGTASL
FQEDSRSTL	FQEDSRSTL
RLDHLAEKF	RLDHLAEKF
RLQLEKAAW	RLQLEKAAW
KMVNSGMLETI	MVNSGLETI
RQAVQILDEL	RQAVQLDEL
KLRETEEKL	KLRETEEKL
RLYYIGGEVF	RLYYIGEVF
AQHFLPAGDSV	AQHFLPAGD
RMNGFIDQI	RMNGFIDQI
AQHVEVESI	AQHVEVESI
KLVDDQMNW	KLVDDQMNW
RIMDEKTASEL	IMDEKASEL
AQIPQKVLW	AQIPQKVLW
ILNMEDDQNW	ILNMEDQNW
RMEDRLDRL	RMEDRLDRL
RQMNIDVATW	RQMNIVATW
ALINDELVEW	ALINDLVEW
RLIKDTLAL	RLIKDTLAL
RIWGTEGDSW	RIWGTGDSW
RQNKESILEKF	RQNKELEKF
RLARQDPQL	RLARQDPQL
RLYQVEYAF	RLYQVEYAF
GQFPGHNEF	GQFPGHNEF
RLFAVLEQL	RLFAVLEQL
GQAGSSIPSTW	AGSSIPSTW
KQVSDLISVL	KQVSDISVL
TLHRYEHAL	TLHRYEHAL
RQHSALTRL	RQHSALTRL
RQWQDVESL	RQWQDVESL
AVTMDDFRW	AVTMDDFRW
GQSKAVGQDTL	GQSKAQDTL
VSDGNINSDRI	SDGNISDRI
QVDRIILQL	QVDRIILQL
AQDSAAVQI	AQDSAAVQI
IQDQGGWVRL	IQDQGWVRL
LQDRPIPEW	LQDRPIPEW
FLSSVIQNL	FLSSVIQNL
VIAPPDFVL	VIAPPDFVL
ALAKLVEAI	ALAKLVEAI
RVFVDDVTI	RVFVDDVTI
RLQQEETQL	RLQQEETQL
ALAKTGAESI	ALAKTAESI
GLVDGGDHI	GLVDGGDHI
RQAKEERTF	RQAKEERTF
RLAQEAVTL	RLAQEAVTL
RLDQAEKKL	RLDQAEKKL
RTIDEHDAII	RTIDEHDAI
HLTTVLDKL	HLTTVLDKL
IQDAQDKLYL	IQDAQKLYL
AIIDPGDSDII	IIDPGSDII
RQVYDGFSFI	RQVYDGFSF
SLDNIVKLW	SLDNIVKLW
KQSKTVDVL	KQSKTVDVL
LLIDFAHSW	LLIDFAHSW
RIEDPQIQAHW	IEDPQQAHW
RISPDQGQQF	RISPDGQQF
RMDEEFTKI	RMDEEFTKI
RVIEDRDSQL	RVIEDDSQL
SQDQFSDMRI	SQDQFDMRI
RLPAAGVGDMV	RLPAAVGDM
HLLSDELLL	HLLSDELLL
RLIDGREAVTF	RLIDGREAV
RLLAEIGAVTL	LLAEIAVTL
HLSKIETRI	HLSKIETRI
RLIEVTEEEL	RLIEVEEEL
KLSHETVTI	KLSHETVTI
HLYRDGEGRI	HLYRDEGRI
YLPDGSYEDW	YLPDGYEDW
RQLQEDAARL	RQLQEAARL
KLDETGNSL	KLDETGNSL
RSSTPLPTI	RSSTPLPTI
RLPEEEFGHF	RLPEEFGHF
RLQIEDFEARI	LQIEDEARI
RQQTDMAVNW	RQQTDAVNW
GQFFPDIVEF	GQFFPIVEF
RMSDDVHSL	RMSDDVHSL
KQFAEILHF	KQFAEILHF
RQDAVMQQVF	RQDAVQQVF
AQAVTTSKW	AQAVTTSKW
NQMVEISAW	NQMVEISAW
GQSKITFLL	GQSKITFLL
KQQENVTLLL	KQQENVTLL
SIYSGLEAF	SIYSGLEAF
HQTIVMQFI	HQTIVMQFI
KMFFLIEKI	KMFFLIEKI
QLYPLQDIL	QLYPLQDIL
RVAQLLERW	RVAQLLERW
RQLEAIVRI	RQLEAIVRI
KMPSGEFARI	KMPSGFARI
IQDGKGDVTI	IQDGKDVTI
HQAGISDTL	HQAGISDTL
HIIEDTEEARL	IIEDTEARL
VATVSLPR	VATV-SLPR
FSAAHEEQW	FSAAHEEQW
RLYSVSYLL	RLYSVSYLL
RLQNIEAHL	RLQNIEAHL
HVSNLEFPF	HVSNLEFPF
RVIEFAAKF	RVIEFAAKF
KQEKPERLL	KQEKPERLL
ALAQATPDHF	ALAQAPDHF
RQISNIKKEKL	QISNIKEKL
GLIHGDFNEF	GLIHGFNEF
ILIDENDNKI	ILIDEDNKI
KQLEIAHEKL	KQLEIHEKL
RQDIDQAKI	RQDIDQAKI
KISPEDTHL	KISPEDTHL
GMSNDGRFLKF	GMSNDGRFL
RLKAAEADSKL	KAAEADSKL
TQTTHELTI	TQTTHELTI
FLDGNEMTL	FLDGNEMTL
SLDGYFHLW	SLDGYFHLW
RLPKILEDGL	RLPKIEDGL
RLHQEGKFVEL	HQEGKFVEL
AAPSAAREL	AAPSAAREL
SQSHAYQQF	SQSHAYQQF
GQAEALDKI	GQAEALDKI
KVFNGEGEQI	KVFNGGEQI
AQDVPSAQQW	AQDVPAQQW
AQVAKESVL	AQVAKESVL
HTVFLFALL	HTVFLFALL
HMISDGFLTI	HMISDFLTI
RLLEEEGVSL	RLLEEGVSL
RQQKEVLSW	RQQKEVLSW
AQMVTQAMW	AQMVTQAMW
RMFLENETW	RMFLENETW
RLESFLHDSW	RLESFHDSW
RLIELDESF	RLIELDESF
GQHLGALDYL	GQHLGLDYL
KLIDDVHRL	KLIDDVHRL
QLAFIEELF	QLAFIEELF
QQFPAPLGW	QQFPAPLGW
AVEAESEQKW	AVEAEEQKW
AQVEDFLQF	AQVEDFLQF
GQAEPESVLL	GQAEPSVLL
RLLELIEGF	RLLELIEGF
KIVIDFDSI	KIVIDFDSI
SQYPQSDDKL	SQYPQDDKL
IQDKGSIQKF	IQDKGIQKF
KQNELLEPNSF	KQNELPNSF
SQENLVVHI	SQENLVVHI
HLAKDLLVL	HLAKDLLVL
VLSHVVLEF	VLSHVVLEF
RQYKDYKI	RQYK-DYKI
QLAGFSHQI	QLAGFSHQI
ELYMEQKNERL	YMEQKNERL
HLEASAEKW	HLEASAEKW
SVMKTEPSI	SVMKTEPSI
YQQELERELF	YQQELRELF
KQSSVMQRL	KQSSVMQRL
RLYFDEISF	RLYFDEISF
AQMDYQLRL	AQMDYQLRL
RQVEKVVDKF	RQVEKVDKF
KQAEEKGVVL	KQAEEGVVL
KLFSEKRVEL	KLFSERVEL
RLDPTAVNI	RLDPTAVNI
RQISTSGELSF	RQISTSGEL
KQVVEISSL	KQVVEISSL
KQAPPLEDI	KQAPPLEDI
KLYEEINQVF	KLYEENQVF
FEAPIKLVF	FEAPIKLVF
DIQSRSKEQL	IQSRSKEQL
RIYNDDKNTYI	RIYNDKNTY
AQEEGTSQAL	AQEEGSQAL
KQLFTLVEW	KQLFTLVEW
RQLKKLDEDSL	RQLKKEDSL
RMIEVQDEL	RMIEVQDEL
ALDPNSKGNSL	ALDPNGNSL
ALMAQEQKL	ALMAQEQKL
ALLERLSELAL	ALLERLSEL
SLSDTVEKL	SLSDTVEKL
RLATLNEKL	RLATLNEKL
LQINQTFEEL	LQINQFEEL
RVINEEYKIW	RVINEEYKI
AQTHVDLSF	AQTHVDLSF
KQFYYRDEF	KQFYYRDEF
KLSEYEMSI	KLSEYEMSI
IQVEPVLDYL	IQVEPLDYL
LQDPGNHLI	LQDPGNHLI
RLAEVVHEL	RLAEVVHEL
SQDPTKEIRF	SQDPTEIRF
KQNAEELQDF	KQNAELQDF
IQQRGGEERL	IQQRGEERL
AQEVHSTGI	AQEVHSTGI
YQDPDGTRKL	YQDPDTRKL
AAPAKKPYRKA	AAPAKKPYR
RQVVESVGNQM	RQVVESVGN
TQALEKYNI	TQALEKYNI
KQILEGVYYL	KQILEVYYL
RQNESYLNF	RQNESYLNF
GQSIYGDKF	GQSIYGDKF
KASGFEESMKW	KASGFEESM
RLQEPKKDLI	RLQEPKDLI
KLISEEDLL	KLISEEDLL
AQLEEEWGL	AQLEEEWGL
RLYAGPEVDIW	RLYAGEVDI
RQLQPASELW	RQLQPASEL
KQADEEFQIL	KQADEEFQI
AQSDIEHLF	AQSDIEHLF
RLLPEKLTI	RLLPEKLTI
GQSALPQRL	GQSALPQRL
GQAAGVLIHSI	GQAA-GVLI
KQSPPIVKI	KQSPPIVKI
VADLVGFLL	VADLVGFLL
RISDDKYGRI	RISDDYGRI
KVVGKDYLL	KVVGKDYLL
HIDAVSLLL	HIDAVSLLL
RQLLLYEAEAL	LLLYEAEAL
KLLDEKTSKL	KLLDETSKL
KQDQSNVQI	KQDQSNVQI
RQTWDQLLL	RQTWDQLLL
RLLDKESSKW	RLLDKSSKW
SQDWRDSEW	SQDWRDSEW
KLIGDTPIDTF	KLIGDIDTF
YVHKSVMEEL	YVHKSMEEL
KQAHVELAERM	KQAHVLAER
RLQDLGMELL	RLQDLMELL
AQAPPTAQL	AQAPPTAQL
RQAQVAEKL	RQAQVAEKL
ALDKSNTHI	ALDKSNTHI
GQNSADISI	GQNSADISI
KQVEDEKNSF	KQVEDKNSF
KIDGLLIDQI	KIDGLIDQI
RTLDFDPLL	RTLDFDPLL
LQSGADPTL	LQSGADPTL
RIAPPDRRF	RIAPPDRRF
SQDPFPAAI	SQDPFPAAI
HLAWVQEEW	HLAWVQEEW
QQVKDVQKL	QQVKDVQKL
RLYEDSGYSSF	RLYEDYSSF
GQNRIHLEI	GQNRIHLEI
HQSASEHGL	HQSASEHGL
VLQNGGDKL	VLQNGGDKL
AQVGPEIEQF	AQVGPIEQF
KQYGNEVFL	KQYGNEVFL
KLDEDVKMI	KLDEDVKMI
GLHSVLEEW	GLHSVLEEW
LLFNSKNEDL	LLFNSNEDL
IQSISLLDQL	IQSISLDQL
RQDDPSYRSF	RQDDPYRSF
RLPGGNEIGM	RLPGGEIGM
RIAIYELLF	RIAIYELLF
RLLDDRHDSGL	LLDDRDSGL
IMVAPDKDYF	IMVAPKDYF
VAPVTHVSV	VAPVTHVSV
AQEDVTLEHL	AQEDVLEHL
KQDDSQSSNQF	KQDDSQSSN
HQISSGLEAM	HQISSLEAM
RLAVDTDTF	RLAVDTDTF
AQTIHEENI	AQTIHEENI
YLEDTDRNL	YLEDTDRNL
RLDNITQVM	RLDNITQVM
AQAADVLELL	AQAADLELL
VQENIGPLRI	VQENIPLRI
RQLEEYQGILL	RQLEEYQGI
RLQKEQEKL	RLQKEQEKL
AQNRAEIKL	AQNRAEIKL
YLIKDGKLI	YLIKDGKLI
KLWNEVTTSF	KLWNETTSF
RVLDLVEVL	RVLDLVEVL
SQHSVDQSW	SQHSVDQSW
RSIDDVVRL	RSIDDVVRL
RIDPSSLSF	RIDPSSLSF
RLINLVGESL	RLINLGESL
RQITQVYGF	RQITQVYGF
LQDVIDLRL	LQDVIDLRL
RAGDLVELLL	RAGDLVELL
RLNPLVLLL	RLNPLVLLL
RQVFEGQNRI	RQVFEQNRI
AQGPALDLI	AQGPALDLI
TLDPNTREW	TLDPNTREW
HIIDDALVRL	HIIDDLVRL
RLISQIVSSI	RLISQVSSI
YQFGEIRTI	YQFGEIRTI
KQVDLENVW	KQVDLENVW
AIESGQHYW	AIESGQHYW
RTFQDEPLI	RTFQDEPLI
ALPEFGEVEI	ALPEFEVEI
LLYDDKGVGL	LLYDDGVGL
QIGPPEVHL	QIGPPEVHL
GQHTSSTTSAW	HTSSTTSAW
KLVAIVDVI	KLVAIVDVI
SIPEKNRPL	SIPEKNRPL
RQPDKEFSF	RQPDKEFSF
ALNQLFEKI	ALNQLFEKI
RMLDSGADYL	RMLDSADYL
SQFGTEHVL	SQFGTEHVL
LLPADGILI	LLPADGILI
RLDDAIHVL	RLDDAIHVL
RQHEIVLKV	RQHEIVLKV
HLLLEVEVI	HLLLEVEVI
HQVVEDGYEF	HQVVEGYEF
FQSSAVMAL	FQSSAVMAL
ALDVSFNKF	ALDVSFNKF
RIIFVDEVF	RIIFVDEVF
TLDPVEKAL	TLDPVEKAL
AIDFSHEEW	AIDFSHEEW
RLALKEDKF	RLALKEDKF
QLFQEYDNHI	QLFQEDNHI
TLSVSGDRL	TLSVSGDRL
QQHSGQHLI	QQHSGQHLI
RLLGEASSNW	RLLGESSNW
RVFAAESII	RVFAAESII
RQVKVILNI	RQVKVILNI
RVLPSIVNEVL	VLPSINEVL
QLSPVLLYL	QLSPVLLYL
LLHQDVNTAW	LLHQDNTAW
RESERQLRL	RESERQLRL
RIVETEAYL	RIVETEAYL
HLHFPDPSL	HLHFPDPSL
RQQQDLVAF	RQQQDLVAF
RQVKEMNPAL	RQVKENPAL
RQLKDEAIVYL	RQLKDEAIV
VQEGQNLKITI	VQEGQNLKI
RQVLHGEAL	RQVLHGEAL
ALLNLAERL	ALLNLAERL
AVSRILEEW	AVSRILEEW
AGFAGDDAPR	AGFAGDDAP
RLILYNDGDSL	ILYNDGDSL
RLEDQHRLL	RLEDQHRLL
RLDASENRL	RLDASENRL
RLMQKKETNL	RLMQKETNL
RLTKLQDNL	RLTKLQDNL
RLSRTPGNRI	RLSRTGNRI
HLNPETITI	HLNPETITI
AQAPSSFQL	AQAPSSFQL
RQLKIKEVTL	RQLKIEVTL
ISMGDHLW	ISMG-DHLW
RQLESMIRL	RQLESMIRL
KQFKYGNQL	KQFKYGNQL
KQPEEVFDVL	KQPEEFDVL
QQMEAEHNTL	QQMEAHNTL
TNSAILPLL	TNSAILPLL
RLSVGTNEKI	RLSVGNEKI
ILDDGGDLTHW	ILDDGGDLT
RINEDQKVAL	RINEDKVAL
AQLNIAEQNW	AQLNIEQNW
QLVDREHKL	QLVDREHKL
RIKELEERI	RIKELEERI
SQLDDQYSRF	SQLDDYSRF
IQIMKVEEI	IQIMKVEEI
RQGEVVQRL	RQGEVVQRL
FQDQVLDLL	FQDQVLDLL
RMPEEDNKI	RMPEEDNKI
RQDAQQEDF	RQDAQQEDF
RLLSIKEAF	RLLSIKEAF
RQTAEYSAF	RQTAEYSAF
AISSVRLYI	AISSVRLYI
GVVKEGDQI	GVVKEGDQI
MLDPHQTLF	MLDPHQTLF
RLVRDLVTGF	RLVRDVTGF
RQADFEAHNIL	RQADFAHNI
LIYSGKLLL	LIYSGKLLL
GQSREELDKF	GQSRELDKF
ALSDLALHF	ALSDLALHF
AQGPAGAEKL	AQGPAAEKL
IVAPDADARW	IVAPDDARW
ALERVLQDW	ALERVLQDW
RLGGTKQDYL	RLGGTQDYL
RVLKGDVEKL	RVLKGVEKL
GQFPGHNEFF	GQFPGHNEF
VLDITRLLL	VLDITRLLL
RLEKGVDVKF	RLEKGDVKF
HLLVEHETQKL	LLVEHTQKL
GQSTVNHSL	GQSTVNHSL
RLQEESEVL	RLQEESEVL
VIHQSVYELI	VIHQSYELI
TQDNITVRW	TQDNITVRW
TQQNWDYRW	TQQNWDYRW
ILSEDKLTI	ILSEDKLTI
KTIGGGDDSF	KTIGGDDSF
KLIQESPTVEL	IQESPTVEL
RQSDLLVKL	RQSDLLVKL
ILDESDHITM	ILDESHITM
IRHTGEKPF	IRHTGEKPF
VQLKDLEKW	VQLKDLEKW
AQAASQHVF	AQAASQHVF
RLQIEIGKL	RLQIEIGKL
RIISHFDIF	RIISHFDIF
ALAPAEVQVL	ALAPAVQVL
HLDKQQVQL	HLDKQQVQL
HQVEEDYLF	HQVEEDYLF
FQDEINWRL	FQDEINWRL
GQDPHSSQAF	GQDPHSQAF
SAPSRATAL	SAPSRATAL
RLQSTSERL	RLQSTSERL
KQLEDGRTL	KQLEDGRTL
TYDDATKTF	TYDDATKTF
ILWSPHYKELI	ILWSPYKEL
KLFADAVQELL	KLFADVQEL
RQMTDPNVAL	RQMTDNVAL
KQLKLDPSI	KQLKLDPSI
RLLQEDSSPLL	LLQEDSPLL
AQDQTQDTQLI	AQDQTDTQL
KQFIDGRLDLL	KQFIDRLDL
HQTGGEVTI	HQTGGEVTI
RIDQVNQLL	RIDQVNQLL
GQAQPIIDQL	GQAQPIDQL
RVHAFLEQW	RVHAFLEQW
HLWTGEEQL	HLWTGEEQL
RIFEKMFAM	RIFEKMFAM
RLQEETGAKI	RLQEEGAKI
RLWGDHGQEAL	RLWGDQEAL
HLASGGNDNL	HLASGNDNL
HLENSGWQKI	HLENSWQKI
YIAEEYSRL	YIAEEYSRL
KLQEEKVRAVF	LQEEKRAVF
GQVPDTNYI	GQVPDTNYI
YQDLIDRGW	YQDLIDRGW
RQIPLYIDDTL	RQIPLDDTL
RQIQESVTF	RQIQESVTF
GQIYGDVLYF	GQIYGVLYF
LMTWVQDQL	LMTWVQDQL
HLSIINEYL	HLSIINEYL
RLMQVGEEF	RLMQVGEEF
VMDQKEHKL	VMDQKEHKL
HQEKPERPL	HQEKPERPL
AAPEGKRSL	AAPEGKRSL
RLQQDKVLI	RLQQDKVLI
RQLPSSHAL	RQLPSSHAL
KLFADAVQEL	KLFADVQEL
RLSGKILHI	RLSGKILHI
YLIVDRDEAW	YLIVDDEAW
SQVIPMEEF	SQVIPMEEF
LQSLLVEERL	LQSLLEERL
ILEKESALF	ILEKESALF
KLFTSEEEHL	KLFTSEEHL
RLFDANKAELF	RLFDAKAEL
QQASMEEKF	QQASMEEKF
LQAPLGYDKF	LQAPLYDKF
RIHNEDNSQF	RIHNENSQF
RLEEMNINI	RLEEMNINI
AVSNLALQF	AVSNLALQF
RSIEEVYYLW	RSIEEVYYL
FLDLTEQEF	FLDLTEQEF
KLTKTNERL	KLTKTNERL
AQLSPLDSETL	QLSPLSETL
RQHVIDVQI	RQHVIDVQI
KLMELLEEI	KLMELLEEI
RLENRYEAL	RLENRYEAL
RVIVAEFDSF	RVIVAFDSF
RIIEAEESRM	RIIEAESRM
YVDKSRGDKL	YVDKSGDKL
KITDVIIGF	KITDVIIGF
ALFPKDVDRL	ALFPKVDRL
RQLWDSAVSHF	QLWDSVSHF
VLLEEGEAQRL	LLEEGAQRL
FQIGDYLDI	FQIGDYLDI
RLLFLKDVL	RLLFLKDVL
LIDENDNKI	LIDENDNKI
GLYRDEHQDF	GLYRDHQDF
RIHNELSPLKL	RIHNELSPL
RLMGSVKDHL	RLMGSKDHL
ALSEDHAWVVF	ALSE-DHAW
QQIKQVEEF	QQIKQVEEF
RMQKEITAL	RMQKEITAL
RQWADDWLVHL	RQWADDWLV
KVSSVMDRF	KVSSVMDRF
LEQNQLYGEVI	EQNQLGEVI
RQGSPKILEHL	GSPKILEHL
RLFQKTLKL	RLFQKTLKL
RLFGDVEASL	RLFGDEASL
RQAQENATLLF	RQAQENATL
VQAPANDSW	VQAPANDSW
RVLQQEHRL	RVLQQEHRL
SQMGPDAHM	SQMGPDAHM
KLFPYEEHL	KLFPYEEHL
KLLSQDFVQI	LLSQDFVQI
AVHAEVFTI	AVHAEVFTI
RLDPNVQKW	RLDPNVQKW
HQDLSQKI	HQDL-SQKI
ALHQDVQAMW	ALHQDVQAM
RLQQELMTL	RLQQELMTL
ILSDDKHDW	ILSDDKHDW
VLDPHTSHSW	VLDPHSHSW
KMDRKDKLF	KMDRKDKLF
LLAEPVPGI	LLAEPVPGI
TQTAVITRI	TQTAVITRI
KQFAAIQKEQL	KQFAAKEQL
IPSQPFLTAL	SQPF-LTAL
KLLNLISKL	KLLNLISKL
RIIEETLALKF	RIIEETLAL
ALESGRYELL	ALESGYELL
AQQHREALI	AQQHREALI
RLIVDVIRF	RLIVDVIRF
RQHALLQEEL	RQHALQEEL
SVINDTVVRF	SVINDVVRF
LLLDDSLVSI	LLDDSLVSI
RQTQALADQF	RQTQAADQF
RIQELEDLL	RIQELEDLL
GQFKTYAI	GQFK-TYAI
RILELDQELI	RILELDQEL
VLIGNLGDKL	VLIGNGDKL
RQFQELNEL	RQFQELNEL
RMDFEDLGL	RMDFEDLGL
ELAPYDENW	ELAPYDENW
LLGRGQEAHL	LLGRGEAHL
RIFPDKFVL	RIFPDKFVL
AQAAEFREAW	AQAAEREAW
AQQASEKIDRF	QQASEIDRF
SQDGRVFIW	SQDGRVFIW
KLMSELESF	KLMSELESF
KVASALEKW	KVASALEKW
LQYSFPLQL	LQYSFPLQL
IPAAIIFDIL	IPAAIFDIL
RLLDLENSLL	RLLDLENSL
YLDRKSDERL	YLDRKDERL
AQREDALEL	AQREDALEL
FLSPDKLSL	FLSPDKLSL
RMQLSDDEGHF	QLSDDEGHF
LLYLLEHTW	LLYLLEHTW
RQSEDFNSL	RQSEDFNSL
RQLIIRDIL	RQLIIRDIL
AQLRQYHRL	AQLRQYHRL
SLGPNGLDKM	SLGPNLDKM
RAVDDGVNTF	AVDDGVNTF
RLYEAYLPETF	RLYEAPETF
KQTQPERYI	KQTQPERYI
AVDPAILLI	AVDPAILLI
ALSDYDLVL	ALSDYDLVL
VQVQPGVDII	VQVQPVDII
KQFAPEYEKI	KQFAPYEKI
KIIDETMAQL	KIIDEMAQL
KLENGEIETI	KLENGIETI
RIDEARQEL	RIDEARQEL
WQVDTKEEVW	WQVDTEEVW
YLVEDIQHI	YLVEDIQHI
RQDLERVMI	RQDLERVMI
LQNKLPELW	LQNKLPELW
GQSWHPEHF	GQSWHPEHF
VLDVSGADML	VLDVSADML
LEQRFLELL	LEQRFLELL
ILDSSPEKL	ILDSSPEKL
KLIDDQDISI	KLIDDDISI
ILIKQDQTL	ILIKQDQTL
RQMQLEDGGQL	MQLEDGGQL
AVDNILLKL	AVDNILLKL
RLRYPVTPELL	RLRYPTPEL
YEFDEQGHSTW	FDEQGHSTW
RLQEASQTI	RLQEASQTI
RINNEDNSQF	RINNENSQF
KLTPIHDRI	KLTPIHDRI
RVVEEPYTV	RVVEEPYTV
RLVAVEENVW	RLVAVENVW
KVIDVDHGI	KVIDVDHGI
RLEFPSGETI	RLEFPGETI
GQFIGPHRI	GQFIGPHRI
GQARPLEFL	GQARPLEFL
RVDNMIIQSI	RVDNMIQSI
ILNDVQDRF	ILNDVQDRF
HQHNVSLQL	HQHNVSLQL
RLGKNGADEI	RLGKNADEI
RQDQSIILL	RQDQSIILL
GQQKPHPGERL	QQKPHGERL
AQHSVPLQL	AQHSVPLQL
RLTNHQELW	RLTNHQELW
ALQERDVAI	ALQERDVAI
GQTSVVSFL	GQTSVVSFL
RLHVTALDYL	RLHVTLDYL
KLNEAKEEF	KLNEAKEEF
SQTTVYEKL	SQTTVYEKL
SLGTGYTEEF	SLGTGTEEF
RQSIVVSFL	RQSIVVSFL
GQASLIDLL	GQASLIDLL
HQVRSMDEL	HQVRSMDEL
RVVDEKTKDLI	VVDEKKDLI
MQVKVGNEV	MQVKVGNEV
KLDHVVTII	KLDHVVTII
RQQALQHAQTL	QQALQAQTL
ILDQREASI	ILDQREASI
RLFEMGFAEQL	RLFEMAEQL
RQQNDELTTL	RQQNDLTTL
GQSFSEQHI	GQSFSEQHI
SVMPAGVDKI	SVMPAVDKI
KIDGQQTII	KIDGQQTII
RQKAIEEFF	RQKAIEEFF
RLDPHPELL	RLDPHPELL
AQAWIKKDQF	AQAWIKDQF
HLISIIKDDL	HLISIKDDL
ENRGPTELL	ENRGPTELL
RQNAEQHVTQL	RQNAEQHVT
RLMKELEEI	RLMKELEEI
KLHWQKNGDYL	HWQKNGDYL
HIYHSEYFL	HIYHSEYFL
RLQALDTGW	RLQALDTGW
KLSGEYEKF	KLSGEYEKF
RQDFSPEEL	RQDFSPEEL
LMDPDTKLI	LMDPDTKLI
RIEEGLDQI	RIEEGLDQI
RLFGEDEVEVL	RLFGEEVEV
RLLEEEIIAF	RLLEEIIAF
ILYSKTEHL	ILYSKTEHL
ALDDSIGDVW	ALDDSGDVW
HITKVEERL	HITKVEERL
RLDVTVQSF	RLDVTVQSF
HLIDGDVVLF	HLIDGDVVL
RMHDEKVDLW	RMHDEVDLW
HLDATKLLL	HLDATKLLL
RLQYAIISEAW	LQYAISEAW
RIKENKGEERL	KENKGEERL
RIAEYAFKL	RIAEYAFKL
GLFHGNEML	GLFHGNEML
LQIEDFEARI	LQIEDEARI
HLESGSGKVTF	HLESGSGKV
KQFGIDGESF	KQFGIGESF
AQVRKENQW	AQVRKENQW
RQADKVWRL	RQADKVWRL
RLESIISGAAL	RLESIGAAL
AQAFIHNSL	AQAFIHNSL
QQDRIQQEI	QQDRIQQEI
KLPPKDLRI	KLPPKDLRI
RLFKDQLVY	RLFKDQLVY
KMGGKDFSF	KMGGKDFSF
ISSFKDPKI	ISSFKDPKI
RISLPLPNF	RISLPLPNF
VLPGFPDADSF	VLPGFADSF
ALDAHQQSI	ALDAHQQSI
RQMSGAQIKI	RQMSGQIKI
HLFKEGIKPMW	HLFKEGIKP
RVFREVEML	RVFREVEML
YQNMTVDIL	YQNMTVDIL
ILDPSNTEI	ILDPSNTEI
RVSSDEDLKL	RVSSDDLKL
RMVKTYEKL	RMVKTYEKL
AQSHPEMGL	AQSHPEMGL
RQSFALEQL	RQSFALEQL
ALPDQSFLW	ALPDQSFLW
RLIEESVTV	RLIEESVTV
KQAVGHEAI	KQAVGHEAI
RQESGNNEVI	RQESGNEVI
RISKEEAMRW	RISKEAMRW
IQDSTEDHTW	IQDSTDHTW
ALPGPSLDQW	ALPGPLDQW
LLNNAFEEL	LLNNAFEEL
YQDVGSLNI	YQDVGSLNI
RQEMIATQKL	RQEMITQKL
RIVEPYIAW	RIVEPYIAW
RLFQTEEKI	RLFQTEEKI
QLFVGTERI	QLFVGTERI
ILANDGVLL	ILANDGVLL
RLDQVEQEL	RLDQVEQEL
KLFNESHGIFL	KLFNESHGI
AQDIERASF	AQDIERASF
WLDPNETNEI	WLDPNTNEI
RVSQLQIQF	RVSQLQIQF
LQVGKGDEV	LQVGKGDEV
TQTLVREYF	TQTLVREYF
TVARGEPESL	TVARGPESL
RQGEAEFNRI	RQGEAFNRI
HLIEEINDEM	HLIEENDEM
LSSDDANVLVW	LSSDDANVL
FQIEDVIHKF	FQIEDIHKF
AQYFEPLTL	AQYFEPLTL
RTNGKEPEL	RTNGKEPEL
AQSQLIKSDEM	SQLIKSDEM
ILATDDPNF	ILATDDPNF
KLHGKPIRI	KLHGKPIRI
RQANEEYQIL	RQANEEYQI
KIIEDLGVHF	KIIEDGVHF
RLEAVPLEF	RLEAVPLEF
KAPSAARSL	KAPSAARSL
GQVPPGTNHI	GQVPPTNHI
LLSPVSVEW	LLSPVSVEW
GQWKKGFVL	GQWKKGFVL
YLYESGETEKL	YESGETEKL
RQAADFAEQF	RQAADAEQF
RQLAKIHAI	RQLAKIHAI
RIQEFEAAL	RIQEFEAAL
AQAREFGNL	AQAREFGNL
RMENGVLGNAL	RMENGGNAL
HQAQIDHYL	HQAQIDHYL
RQSGEAFVEL	RQSGEFVEL
RQFEEQKQKL	RQFEEKQKL
RESPNITDRW	RESPNTDRW
HQNLKEFAL	HQNLKEFAL
RLFEGNALL	RLFEGNALL
AQFTTALRL	AQFTTALRL
ILEGRTISVQF	ILEGRTISV
ALHIPFSVDEI	HIPFSVDEI
SQSAVKTKF	SQSAVKTKF
RQGQIEVSI	RQGQIEVSI
RVINKEHVL	RVINKEHVL
RVQLDVFTL	RVQLDVFTL
ALASSLLDRF	ALASSLDRF
RQMLEALNFL	RQMLEALNF
GQLKGEVAQM	GQLKGVAQM
YQLEIPENF	YQLEIPENF
HQLPSEHQTI	HQLPSHQTI
RLSKEYDQL	RLSKEYDQL
HLVKIGDLF	HLVKIGDLF
ELQRVLQSL	ELQRVLQSL
RQHWTMTKI	RQHWTMTKI
RLLKGKKGEQM	RLLKGGEQM
RLVGSQEEL	RLVGSQEEL
VQHSNVVINLI	VQHSNVINL
AMITDLEERL	AMITDEERL
RQIQLIREML	RQIQLREML
YVDPSGGDRF	YVDPSGDRF
RIAQEVQRF	RIAQEVQRF
RVIGQDHDF	RVIGQDHDF
QLLGLHEQL	QLLGLHEQL
SLYDQAEKL	SLYDQAEKL
KLNDMIDAI	KLNDMIDAI
GQPGFHSDTL	GQPGFSDTL
KQDRLNQTL	KQDRLNQTL
AQAGEFGDRL	AQAGEGDRL
ILDPHVVLL	ILDPHVVLL
LTRHYDPSKI	TRHYDPSKI
HLIAQHSAI	HLIAQHSAI
RQQLEMYSI	RQQLEMYSI
RQHEEPESF	RQHEEPESF
RISEESTKI	RISEESTKI
RLLTEISSSW	RLLTESSSW
HQAGISDTLW	HQAGISDTL
SQIALNEKL	SQIALNEKL
RLMFEYQTL	RLMFEYQTL
KLLQEQDQEL	KLLQEDQEL
HLLLPSQEESF	LLLPSEESF
KQWKHFSGDHL	KQWKHGDHL
RMTEDALRL	RMTEDALRL
LLVPALGESW	LLVPAGESW
LFDHAVSKF	LFDHAVSKF
IQDAGRTQI	IQDAGRTQI
RIIKVGGERF	RIIKVGERF
RLGYFDDAL	RLGYFDDAL
RQAHLTNQYM	RQAHLNQYM
KLEEIIHQI	KLEEIIHQI
HLSSAHLAF	HLSSAHLAF
RLHLSERRDSF	HLSERRDSF
HLVKPFADTL	HLVKPADTL
KQMEQISQFL	KQMEQISQF
ITPTGTHPL	ITPTGTHPL
HQVQHEARL	HQVQHEARL
RQPKVVERL	RQPKVVERL
RLNVLREYL	RLNVLREYL
KLATGQEEF	KLATGQEEF
AQSKDFAVGI	AQSKDAVGI
AQLEEKNQEL	AQLEENQEL
SQDPNRVEL	SQDPNRVEL
GQWKEEQKL	GQWKEEQKL
RQAPPHIEL	RQAPPHIEL
RLFTSAEETF	RLFTSEETF
TQQQHDFTL	TQQQHDFTL
GQDKLVHLW	GQDKLVHLW
RLAEERHNRL	RLAEEHNRL
KLLEVYEQL	KLLEVYEQL
KLAPITYPQGL	KLAPIPQGL
KQFDDVLIYL	KQFDDLIYL
RQDQLILQII	RQDQLILQI
YQLFDNDRTQL	QLFDNRTQL
ALLAGSEYL	ALLAGSEYL
LLAPSDVAGW	LLAPSVAGW
RQIDQFLVV	RQIDQFLVV
QLEKHTRYW	QLEKHTRYW
IIDEQPLIF	IIDEQPLIF
KEAADIIQKL	KEAADIQKL
RQNHSILKI	RQNHSILKI
RLVNQEIEKF	RLVNQIEKF
SLAREVYTEW	SLAREYTEW
ALDKIRYESL	ALDKIYESL
GQALELPLRI	GQALEPLRI
RINRQLEAL	RINRQLEAL
KISEVVELL	KISEVVELL
YQSIEFSRL	YQSIEFSRL
FQGRAEVVSL	FQGRAVVSL
RIKEDVGDNW	RIKEDGDNW
IQTAVRLLL	IQTAVRLLL
HQQNALFQYF	HQQNAFQYF
RVAEERGAVL	RVAEEGAVL
RAQEGDWRW	RAQEGDWRW
ILQHLSEAW	ILQHLSEAW
SQDPGTHVV	SQDPGTHVV
QIVTAGLGDHL	IVTAGGDHL
LLFWDKETQI	LLFWDETQI
RVHNLITDFL	RVHNLTDFL
RMADSGESL	RMADSGESL
RLMDEFKIGEL	LMDEFIGEL
RLPQYDFVF	RLPQYDFVF
KLFSLQDLL	KLFSLQDLL
ILEPLNPLL	ILEPLNPLL
RSFDSEFKL	RSFDSEFKL
YQAEIPDRL	YQAEIPDRL
AQDGKIKVW	AQDGKIKVW
KLREDLERL	KLREDLERL
VQIGEKEGW	VQIGEKEGW
RQILEGVHF	RQILEGVHF
YQQKEIEFL	YQQKEIEFL
RVVNGKVEYF	RVVNGVEYF
RLFKNDPLF	RLFKNDPLF
RQGRTLYGF	RQGRTLYGF
YLENGKETL	YLENGKETL
RQFSTPFQL	RQFSTPFQL
GQWREYFSAL	GQWREFSAL
RVDEEPTTL	RVDEEPTTL
HQHVSTHSDIL	HVSTHSDIL
AQDSTDLVAKL	AQDSTVAKL
RMQVANIDKF	RMQVAIDKF
SMGFFTKEEW	SMGFFKEEW
AVVDLIDAI	AVVDLIDAI
RLENTKQQL	RLENTKQQL
GQSKENNYL	GQSKENNYL
HQIDLIVQL	HQIDLIVQL
GQEGSIHNL	GQEGSIHNL
RLFSEIQTTL	RLFSEQTTL
HQDGIHILV	HQDGIHILV
RLEGREFEFL	RLEGRFEFL
KIEDIDNEDW	KIEDINEDW
HQIAEEHGL	HQIAEEHGL
YLTAEILEL	YLTAEILEL
RQAQADRVNL	RQAQARVNL
RQDINKEHLW	RQDINKEHL
AQVPFEQIL	AQVPFEQIL
FIDVDDERW	FIDVDDERW
RQSFGTNSDVL	RQSFGSDVL
RLLNNAFEEL	RLLNNFEEL
VLVKVFEKF	VLVKVFEKF
RVDGAVSSW	RVDGAVSSW
AQYFLDKIDVI	FLDK-IDVI
KVSDYEMKL	KVSDYEMKL
RQLEESASHL	RQLEEASHL
RQYAKDIGFI	RQYAKDIGF
RLFNDPVAMVL	RLFNDPVAM
LLDKAQDLF	LLDKAQDLF
RAAVIGDVI	RAAVIGDVI
ALIRLLESF	ALIRLLESF
RQVLENFKL	RQVLENFKL
KLIDETQDMLL	KLIDEQDML
YLHESTQDEL	YLHESQDEL
FLSSFEEKI	FLSSFEEKI
RLEASSSQSF	RLEASSQSF
RIAPSGDQW	RIAPSGDQW
RQHPFEDGAKL	RQHPFGAKL
AQDYGGLLLL	AQDYGGLLL
RVDKSAVGF	RVDKSAVGF
YQHKLAEKL	YQHKLAEKL
KQWTEILHF	KQWTEILHF
YQMKEEEVQL	YQMKEEVQL
RQTSGEVGL	RQTSGEVGL
HQSSHGDIF	HQSSHGDIF
ALIKDKILF	ALIKDKILF
RLEQIKKTEL	RLEQIKTEL
ILMKDLADEL	ILMKDADEL
AESHIILVL	AESHIILVL
SQFREEEITL	SQFREEITL
KQEGAVHVL	KQEGAVHVL
ALDPNAYEAF	ALDPNYEAF
VLFAIKEVGF	VLFAIEVGF
HLFEDAYLL	HLFEDAYLL
RMDYEDDRL	RMDYEDDRL
RQILEGVHYL	RQILEVHYL
RQVGKTLRI	RQVGKTLRI
VQEGHTAVVSF	VQEGHTAVV
QQSVIGDYL	QQSVIGDYL
KVYEYDTVI	KVYEYDTVI
RVSELQVLL	RVSELQVLL
REAGNINQSL	REAGNNQSL
GQDVGRYQV	GQDVGRYQV
RLAPDYDAL	RLAPDYDAL
RLPDNYTQDTW	RLPDNYTQD
VLADVMDDQL	VLADVDDQL
CGSVFDPSFPW	SVFDPSFPW
ALDNSVYLW	ALDNSVYLW
RQETVAQAALL	RQETVQAAL
KQSKDGAGFLI	KQSKDGAGF
RLHGLPEQF	RLHGLPEQF
KLYHNEVEI	KLYHNEVEI
RQFEFSVDSF	RQFEFVDSF
RLWNETVELF	RLWNEVELF
HQPSVLLEL	HQPSVLLEL
RQHLQEVGL	RQHLQEVGL
KQDSLGQLVDW	KQDSLGQLV
LLDPDVVARF	LLDPDVARF
AQVADAFLSKF	QVADALSKF
HIIGQESAI	HIIGQESAI
SQAAVSARF	SQAAVSARF
RLDIDPETI	RLDIDPETI
AMWPEQSDKW	AMWPESDKW
RVQKEVAGF	RVQKEVAGF
HLHRDKALL	HLHRDKALL
IQALDSEGNTF	ALDSEGNTF
QLVMEGYKW	QLVMEGYKW
RVIDYAVKI	RVIDYAVKI
KQVEDDIQQL	KQVEDIQQL
ALTSIAQKI	ALTSIAQKI
IQVDLADKL	IQVDLADKL
AVVKIVEEW	AVVKIVEEW
VLPEHVSVL	VLPEHVSVL
RLFGDEAAEQW	RLFGDAEQW
GQDSSEIHF	GQDSSEIHF
RIIDNMGQEVI	IIDNMQEVI
ALNIVGDLL	ALNIVGDLL
AVAPPDAGL	AVAPPDAGL
RVIEGKVDQI	RVIEGVDQI
YQHGIFQSI	YQHGIFQSI
SQGFLPHFQHF	GFLPHFQHF
RQPNIFEIL	RQPNIFEIL
SQEGASVKI	SQEGASVKI
RLSYVGNNF	RLSYVGNNF
GLIADAKTLI	GLIADKTLI
ALIPETTTL	ALIPETTTL
RLKSDERPVHI	KSDERPVHI
RLAPTLSQL	RLAPTLSQL
LAPTDVKEL	LAPTDVKEL
VVPEPGQPL	VVPEPGQPL
AQEQGQHLI	AQEQGQHLI
KLEEKRAEL	KLEEKRAEL
HLIEDVLNQL	HLIEDLNQL
KQHSWHESDSF	HSWHESDSF
QRVEEELLAL	RVEEELLAL
YQWDDPDPRL	YQWDDDPRL
GQAGAARDAL	GQAGARDAL
VLFRFSDDAF	VLFRFDDAF
KLFGEKSASF	KLFGESASF
RIADFQDVL	RIADFQDVL
GQDPGAPQL	GQDPGAPQL
RVLQNGGDKL	RVLQNGDKL
AQAAQQLWL	AQAAQQLWL
RLYFAETVL	RLYFAETVL
RMSLVEPQI	RMSLVEPQI
RQQSHFAMM	RQQSHFAMM
AQITEEEAKL	AQITEEAKL
AQAKADKIKL	AQAKAKIKL
RIDDLEKNI	RIDDLEKNI
GIYPHKLVF	GIYPHKLVF
RQEDAEYQAF	RQEDAYQAF
RLLEENDQL	RLLEENDQL
NQDLTFQHI	NQDLTFQHI
LLFEADTITL	LLFEATITL
RMESVFNQAI	RMESVNQAI
VQILQEVNDF	VQILQVNDF
HLQRIIQQETL	RIIQ-QETL
RLTEIGPRM	RLTEIGPRM
RVDRIILLF	RVDRIILLF
GQKEGEPRI	GQKEGEPRI
KQFAEENGL	KQFAEENGL
RLEEGHRQYL	RLEEGRQYL
AQARINARL	AQARINARL
HQHEYFFLI	HQHEYFFLI
KLAPPSSTL	KLAPPSSTL
HLAVEHDNI	HLAVEHDNI
RISLEYSEL	RISLEYSEL
RQLEEARQI	RQLEEARQI
RQQLPTFLQQM	QQLPTLQQM
AQDPQMLDQL	AQDPQLDQL
AQSKLALVL	AQSKLALVL
LLAHPDAPM	LLAHPDAPM
KHLDVVTLL	KHLDVVTLL
RLLQEQHQL	RLLQEQHQL
REWSGKEKW	REWSGKEKW
HQDQLQVLL	HQDQLQVLL
KLYGSGDQEAW	KLYGSQEAW
GQYYDLLRL	GQYYDLLRL
SQDQVFLRW	SQDQVFLRW
LQTSIREEI	LQTSIREEI
RMEEEQHHW	RMEEEQHHW
GQMSFDHQQL	GQMSFHQQL
HQSIIIERM	HQSIIIERM
QLIDKVWQL	QLIDKVWQL
GLAPTDPVL	GLAPTDPVL
RQIEKDITSF	RQIEKITSF
ALQSPFYGDKM	LQSPFGDKM
SLSRGEEGF	SLSRGEEGF
RVNPVEYSI	RVNPVEYSI
HVSLVQLTL	HVSLVQLTL
YLTELLSTMV	YLTELLSTM
RLANPDQSL	RLANPDQSL
RLFLDGDQL	RLFLDGDQL
RVQLGGSDQL	VQLGGSDQL
RLFDEGTISKW	RLFDEISKW
SQHNPVPDFI	SQHNPPDFI
AQDLVYSFF	AQDLVYSFF
RQVIAAVKW	RQVIAAVKW
FQAKLEHEYI	FQAKLHEYI
FQSGRDDTW	FQSGRDDTW
RMIDIQTRM	RMIDIQTRM
RSINQGLDRL	SINQGLDRL
SQLKEHFAQF	SQLKEFAQF
RLFEVPHEL	RLFEVPHEL
RLEDSSQQL	RLEDSSQQL
EARRLNPGAI	RLNP--GAI
AQEARNIYQEF	QEARNYQEF
RQNGDDPLL	RQNGDDPLL
KQDKKEMAI	KQDKKEMAI
RQLQESEQQL	RQLQEEQQL
ILSSIPEAEKF	SSIPEAEKF
YTSESGDRL	YTSESGDRL
KLIDDVHRLF	KLIDDVHRL
RMLIALDKW	RMLIALDKW
GQAEDHLKL	GQAEDHLKL
KQDKDAIAI	KQDKDAIAI
KLFEGENEHL	KLFEGNEHL
KLVHPTDKF	KLVHPTDKF
RQISALEDDL	RQISAEDDL
SQFKYALVW	SQFKYALVW
RVVDTFQDYF	RVVDTQDYF
KLSEELLDKW	KLSEELDKW
RVVKLNEVI	RVVKLNEVI
GQLAEHESI	GQLAEHESI
YMFQHIEESF	YMFQHEESF
GQSRAIERL	GQSRAIERL
RLHEKGVLL	RLHEKGVLL
RLIGDAAKNQL	RLIGDKNQL
AQDLWSEQSI	AQDLWEQSI
HLVGVDSLI	HLVGVDSLI
RQMGYTEAI	RQMGYTEAI
LLAEEIEKF	LLAEEIEKF
RLPDEKVELF	RLPDEVELF
KLEGFHTQI	KLEGFHTQI
RQPRDFGDSL	RQPRDGDSL
RLDSIEAKL	RLDSIEAKL
RLIKEELIRL	RLIKELIRL
AQEGESSQQL	AQEGESQQL
RMHNEKVDLW	RMHNEVDLW
IQTVPNLDWL	IQTVPNLDW
GQFEEFGQTF	GQFEEGQTF
SIPGGYNAL	SIPGGYNAL
AQIKFLYEEL	AQIKFYEEL
KQAEIVKRL	KQAEIVKRL
RQIQVMEKL	RQIQVMEKL
RLYDLDKDEKI	RLYDLDEKI
RLDVGNFSW	RLDVGNFSW
RVFASPLRL	RVFASPLRL
KLSKFKIRI	KLSKFKIRI
QQLPDILKI	QQLPDILKI
RQEVDNTFW	RQEVDNTFW
KLIQEKKDNLL	KLIQEKDNL
GQYHGDAGDSL	GQYHGGDSL
YQALTVHDNL	YQALTHDNL
KQYPISLVL	KQYPISLVL
VLDDKDYFL	VLDDKDYFL
KQIDSVNHI	KQIDSVNHI
RQHEDFVWL	RQHEDFVWL
AQHQTKLYL	AQHQTKLYL
IQDDAVHTL	IQDDAVHTL
RLVDPHIEMI	RLVDPIEMI
ILDGNQLHI	ILDGNQLHI
RGAQVEEIW	RGAQVEEIW
NQFFISLPLKI	NQFFISLPL
KQDSLVILTI	KQDSLILTI
AQAALQSSW	AQAALQSSW
AVSDILEKL	AVSDILEKL
HVIDSIVGDGI	VIDSIGDGI
RIDPFVRTFL	RIDPFVRTF
GQLDVRELI	GQLDVRELI
SAPKGSVL	SAPK-GSVL
RIAPRPYRL	RIAPRPYRL
GQVTDPRGI	GQVTDPRGI
RQQKEITAL	RQQKEITAL
RQEISFGKL	RQEISFGKL
HQARIEIESF	HQARIIESF
LLQETAYERL	LLQETYERL
RTLPVDFHI	RTLPVDFHI
KIIHDFPQF	KIIHDFPQF
TQDGIKLMF	TQDGIKLMF
AGPLRKSSL	AGPLRKSSL
QQNPGKFDEL	QQNPGFDEL
QLIERILEAW	QLIERLEAW
RLENTQYLL	RLENTQYLL
LIMVAIPII	LIMVAIPII
KQIDDRKEW	KQIDDRKEW
RQGPEESGL	RQGPEESGL
RIMKIDIEKF	RIMKIIEKF
RQFVPIKVEQI	RQFVPVEQI
KLNTLETEEW	KLNTLTEEW
RLNEDFDHF	RLNEDFDHF
RVSPALGITW	RVSPAGITW
RLLPGLVETF	RLLPGVETF
ESLTANLLI	ESLTANLLI
RLQEGNESL	RLQEGNESL
QQDDGKMFI	QQDDGKMFI
RMYELVHRM	RMYELVHRM
KIDPSTLQMW	KIDPSTLQM
TLIPHTDGEKL	LIPHTGEKL
RQLTANTGHTI	QLTANGHTI
RADDTFEAL	RADDTFEAL
RMVEIGSRW	RMVEIGSRW
AQALAKLTI	AQALAKLTI
RILADLEDYL	RILADEDYL
KLFDLDEKLML	KLFDLDEKL
SLSQPKMDEL	SLSQPMDEL
LLEGEESR	LLEG-EESR
RQKEEEDLKL	RQKEEDLKL
RLDEARQML	RLDEARQML
RQLENLVQEL	RQLENVQEL
RLFRDLVSL	RLFRDLVSL
RVWDVNTGEVL	RVWDVGEVL
IQGPVGLDQRF	GPVGLDQRF
RLFATDERF	RLFATDERF
RIDGVLIRM	RIDGVLIRM
RILQDEQYL	RILQDEQYL
ILTTEGRNALI	ILTTERNAL
AQDFNTDLRF	AQDFNDLRF
ALLAEGITW	ALLAEGITW
AQEFFLHLI	AQEFFLHLI
GLIDDYSMVRF	LIDDYMVRF
KMVKDLVASL	KMVKDVASL
RQIKDRVTM	RQIKDRVTM
HQFGTDKDVF	HQFGTKDVF
RQDGSVNFF	RQDGSVNFF
KQFTVAELF	KQFTVAELF
VQAIKDHAF	VQAIKDHAF
KLVNIRNDDI	KLVNINDDI
ALIFEGTDTHW	LIFEGDTHW
RTFEKDHRL	RTFEKDHRL
RQSTLEKKI	RQSTLEKKI
GISMGDHLW	GISMGDHLW
AAPEGVPL	AAPE-GVPL
ALDRQTATQLL	ALDRQATQL
YQGEGAHHI	YQGEGAHHI
KLQDVADSF	KLQDVADSF
KQAPGEKGNIL	KQAPGKGNI
HQDSRAHLLL	HQDSRAHLL
VQDGATHSL	VQDGATHSL
YQEPIPTAQL	YQEPITAQL
RIDQKIYGELW	RIDQKYGEL
AEIKELFQYI	AEIKEFQYI
RQTPEPAGL	RQTPEPAGL
KLEDLKLLF	KLEDLKLLF
RQEGVPRTF	RQEGVPRTF
AQENRVVAFF	AQENRVVAF
KLGPEKRI	KLGP-EKRI
AQHKADIEERL	AQHKAEERL
FQNNEKFVQF	FQNNEFVQF
GQGHFWELW	GQGHFWELW
AQTVSPAEKW	AQTVSAEKW
HQMDNAQDLL	HQMDNQDLL
KLSPEEYVL	KLSPEEYVL
AMAKIQAKI	AMAKIQAKI
RQSVLRELF	RQSVLRELF
RQLFKDYEI	RQLFKDYEI
LQDPNNKSNW	LQDPNKSNW
RMHQAIERF	RMHQAIERF
QQHVIETLI	QQHVIETLI
RQLDTETNL	RQLDTETNL
RQVQSQAHGL	RQVQSAHGL
FQIIEEDAAL	FQIIEDAAL
RLDQPKLDEV	RLDQPLDEV
RSDPGLLTNTM	RSDPGLLTN
KLAPPLVTL	KLAPPLVTL
HQDPADPKM	HQDPADPKM
IQDRVLYVL	IQDRVLYVL
RLFSKYQYF	RLFSKYQYF
RQVDAEVAQQW	QVDAEAQQW
MQNPRQYKI	MQNPRQYKI
TLFKGFGDRL	TLFKGGDRL
KQYRGKELL	KQYRGKELL
RLEDTKNNNL	RLEDTNNNL
FQAHKEENW	FQAHKEENW
RLFDANKDRF	RLFDAKDRF
KLDDIVQHI	KLDDIVQHI
RIFSGGDQSF	RIFSGDQSF
HQAFVYDHL	HQAFVYDHL
IIDPVALEI	IIDPVALEI
RLEEASLLHQF	RLEE-ASLL
KMSSKKLKI	KMSSKKLKI
RLAPNFRW	RLAP-NFRW
GISFPDPKM	GISFPDPKM
GLIDDNDLYRW	GLIDDNDLY
YQDAAGPREAF	YQDAAREAF
KQAADMILL	KQAADMILL
LLIDDKGTI	LLIDDKGTI
RLNYEHDNISL	RLNYEHDNI
AQNKLFNKI	AQNKLFNKI
AVVNVADLW	AVVNVADLW
KVSELKEEL	KVSELKEEL
FQAVHVQGEDL	AVHVQGEDL
YQEKGVRVL	YQEKGVRVL
RLVKDQEALM	RLVKDQEAL
KAHPDVLTI	KAHPDVLTI
RMEKGEPYM	RMEKGEPYM
RTDVVELLL	RTDVVELLL
RLFLEQFSI	RLFLEQFSI
RLYKDDQLL	RLYKDDQLL
KQIDKEPKI	KQIDKEPKI
RQALGVSLF	RQALGVSLF
RLISEAQIQEF	LISEAIQEF
RLEPLVLFL	RLEPLVLFL
RLDNGQVGL	RLDNGQVGL
VQAGDVITI	VQAGDVITI
TAPTGHTL	TAPT-GHTL
RQAAEEIRI	RQAAEEIRI
KQSRDISTL	KQSRDISTL
RVIEEAKTAF	RVIEEKTAF
RLFGAVVRW	RLFGAVVRW
GQAGGKLHI	GQAGGKLHI
RMIHEDTRHLL	RMIHETRHL
RLIAEKRSLF	RLIAEKRSL
SQLIDTHLL	SQLIDTHLL
RLAHYIDRV	RLAHYIDRV
AQVNTKVSDSL	AQVNTSDSL
AVDGISLHL	AVDGISLHL
YQAKENDFDRL	YQAKEFDRL
KQLEDILVL	KQLEDILVL
ALSDGVHKI	ALSDGVHKI
AQNVLSKADVI	NVLSKADVI
KLLEENVSAF	KLLEEVSAF
KQTAVPTIF	KQTAVPTIF
ALAPILDDG	ALAPILDDG
SQQELEAKL	SQQELEAKL
RQPDLVLRL	RQPDLVLRL
AQFHPDGLIF	AQFHPGLIF
GQVQYLDLI	GQVQYLDLI
RMEKLNQLW	RMEKLNQLW
RQIIEQDKHAL	IIEQDKHAL
HLLDDRKLEL	LLDDRKLEL
RLDSIDPAL	RLDSIDPAL
AQITGTEHL	AQITGTEHL
HQDSRAHLL	HQDSRAHLL
KQIESLNDKL	KQIESNDKL
RQATSTASTF	RQATSASTF
LLWQENERL	LLWQENERL
HLLNVINENF	HLLNVNENF
RLVLDPYLL	RLVLDPYLL
LQHQEVKPYTL	HQEVKPYTL
HLHQTPLHL	HLHQTPLHL
VMIDEDMTARI	MIDEDTARI
SQVPNEKVGW	SQVPNKVGW
SQIREMETL	SQIREMETL
AQIAEGMAYI	AQIAEMAYI
HLQRNINENF	HLQRNNENF
RQMLEALNF	RQMLEALNF
QIAPPSHLI	QIAPPSHLI
VAPRSGLAA	VAPRSGLAA
KVSDILLRL	KVSDILLRL
RIAEIIKGELW	RIAEIKGEL
GQVEIHLGDSL	GQVEIGDSL
YQDPSNAQFL	YQDPSNAQF
AGPACVTVIL	AGPACVTVI
KLVEGQEKL	KLVEGQEKL
RQDGVLQDW	RQDGVLQDW
AVDGLSFQAF	AVDGLFQAF
SMSPTGDFL	SMSPTGDFL
KQLDDLKVEL	KQLDDKVEL
RQHLQEVGLF	RQHLQEVGL
HQAPDTQSI	HQAPDTQSI
AQSFITSSW	AQSFITSSW
KIIESEEEL	KIIESEEEL
RLEQGYELQF	RLEQGELQF
GQHAFYQLI	GQHAFYQLI
HQEGNKNVGL	HQEGNNVGL
HQIIRDEGI	HQIIRDEGI
GQFDVEFRL	GQFDVEFRL
HQLEDLEATF	HQLEDEATF
VMDAALLLI	VMDAALLLI
QQTDIAVNW	QQTDIAVNW
GQATTAYFL	GQATTAYFL
GQFALSGSW	GQFALSGSW
RQFEGLMRF	RQFEGLMRF
RLLQRDVQI	RLLQRDVQI
RQQFHDAKF	RQQFHDAKF
VQIGQVHEEF	VQIGQHEEF
HQLDSIDLW	HQLDSIDLW
KLLEEQGIFL	KLLEEGIFL
RQAEMLDDL	RQAEMLDDL
RLSKEDIERM	RLSKEIERM
RQQKQRQLL	RQQKQRQLL
RQINEDNERW	RQINENERW
RQGIPNESW	RQGIPNESW
RLMKEKQRL	RLMKEKQRL
RLAALEEQRM	RLAALEQRM
RAIMDKKANI	AIMDKKANI
KLDTITWTW	KLDTITWTW
FLDGELKSDVF	FLDGEKSDV
RLEATETQL	RLEATETQL
FQDPVPLTV	FQDPVPLTV
KQHAAELHL	KQHAAELHL
KLLDTMVDTF	KLLDTVDTF
RQDMLTLQMI	RQDMLTLQM
RLEALAAEF	RLEALAAEF
KLIEFMDTF	KLIEFMDTF
LLSDDSKFGF	LLSDDKFGF
RQMQQKMKETL	MQQKMKETL
LQANISPEFW	LQANISPEF
TQIEDAVSLW	TQIEDAVSL
TLASAGFDRL	TLASAFDRL
KQIQDMLGL	KQIQDMLGL
AQAGYEVVGL	AQAGYVVGL
ALSRLKLKL	ALSRLKLKL
KLAPKDIKI	KLAPKDIKI
FLSKIEEKLT	FLSKIEEKL
RLIRIFEKL	RLIRIFEKL
HEGDIILKI	HEGDIILKI
AMHAQDPQM	AMHAQDPQM
RQLEALENDNF	QLEALNDNF
ALSEMVEYI	ALSEMVEYI
QQIEELENHL	QQIEEENHL
SQVHIMDEHW	SQVHIDEHW
RIAEALSKMKL	RIAEALSKM
RMEAPKIDRI	RMEAPIDRI
RIIKDVVLQW	RIIKDVLQW
RQYGDESTL	RQYGDESTL
KMSEKILLL	KMSEKILLL
RIVEDDASI	RIVEDDASI
QISAGEEKW	QISAGEEKW
RLDPKGKSL	RLDPKGKSL
RLSESDYEKL	RLSESYEKL
RQIKNFHKL	RQIKNFHKL
RQDSIPAFL	RQDSIPAFL
QQADASKQLW	QQADAKQLW
KIVEIINEEL	KIVEINEEL
KLLEGEESRI	KLLEGESRI
KLLYLEDFF	KLLYLEDFF
QLDETSHRW	QLDETSHRW
ALMEQRLFW	ALMEQRLFW
HLDSNIENQEI	HLDSNNQEI
RIAGEASRL	RIAGEASRL
ILINDAGEVRL	LINDAEVRL
RMIKQLKEEL	RMIKQKEEL
RLFDDSTVTTV	RLFDDTVTT
SQTQPDLDHL	SQTQPLDHL
VLFPEPLTW	VLFPEPLTW
RLDDTVHVVI	RLDDTHVVI
HLYFETVTI	HLYFETVTI
RLWGLTEMF	RLWGLTEMF
RIAQPGDHV	RIAQPGDHV
KQEEQDRLL	KQEEQDRLL
ALQSFLKAEEL	LQSFLAEEL
RILVDQQVW	RILVDQQVW
ILDNDGDRLF	ILDNDGDRL
RVEGAQQRW	RVEGAQQRW
RLVRSDVAM	RLVRSDVAM
QQAQLAAAEKF	AQLAAAEKF
ALAPHLDDAL	ALAPHDDAL
RLSEVQASL	RLSEVQASL
RLIESLFTI	RLIESLFTI
FQDNFEFVQW	FQDNFFVQW
RSFQGKESI	RSFQGKESI
RQQQDEAYL	RQQQDEAYL
RQFLNRDDI	RQFLNRDDI
RISEDVEERL	RISEDEERL
RVVDIYSKF	RVVDIYSKF
KLASSELERL	KLASSLERL
AIHPDMVTI	AIHPDMVTI
IQDIYENSW	IQDIYENSW
RLLEEKDPVPL	RLLEEKDPV
KQMPEEPKL	KQMPEEPKL
MIHEPEPHI	MIHEPEPHI
VLHFKEWQL	VLHFKEWQL
ILARDILEI	ILARDILEI
RLAVYIDRV	RLAVYIDRV
RLFSKSIETL	RLFSKIETL
LLVENIERETF	LVENIRETF
GQAPPDQEAL	GQAPPQEAL
RLLAGPDTEVL	LLAGPTEVL
VQAPDWHL	VQAP-DWHL
RQDQIQQVV	RQDQIQQVV
RVDDGSQKI	RVDDGSQKI
RQVTKEEGL	RQVTKEEGL
RLLQEKVNQL	RLLQEVNQL
ILANIGDHF	ILANIGDHF
RLKEIKEELL	RLKEIEELL
SQDLTHLNL	SQDLTHLNL
RQQEEITHL	RQQEEITHL
ALAPPEVVM	ALAPPEVVM
RIADSFQVI	RIADSFQVI
RQVAEAPGL	RQVAEAPGL
RLPEEEHEF	RLPEEEHEF
RLQQMSERF	RLQQMSERF
RLNHEGKIVL	RLNHEKIVL
AQHGQPLNM	AQHGQPLNM
AVIEAEHTL	AVIEAEHTL
HQFEKIEQF	HQFEKIEQF
KLQDGVHII	KLQDGVHII
LLFEGEKITI	LLFEGKITI
KLEKNLSDRL	KLEKNSDRL
SQSATEVRL	SQSATEVRL
RLMIVKKEKL	RLMIVKEKL
RQTLSVVFDAF	TLSVVFDAF
HLVSEGVLLF	HLVSEGVLL
SQIIQKEDL	SQIIQKEDL
HLAVVELLL	HLAVVELLL
RVIEEAKTAFL	RVIEEKTAF
RVIPSQEHL	RVIPSQEHL
RQESESVLTL	RQESEVLTL
RLINQVLEL	RLINQVLEL
RQALATDEL	RQALATDEL
RQEGAKVSL	RQEGAKVSL
RLAELERKL	RLAELERKL
RQYFQEIGL	RQYFQEIGL
RLDTGPQSL	RLDTGPQSL
RQLALAEKF	RQLALAEKF
RQEATVNYL	RQEATVNYL
YLASEISTW	YLASEISTW
NIPEKTTAL	NIPEKTTAL
QQSNVILLL	QQSNVILLL
YQHIDRWLL	YQHIDRWLL
SQHQAIERF	SQHQAIERF
ERVQAQEQRI	RVQAQEQRI
HLDRTMYLL	HLDRTMYLL
LLIDPEPQI	LLIDPEPQI
AQMSKQLDMF	AQMSKLDMF
FQEADSPTL	FQEADSPTL
ALSKEIYVI	ALSKEIYVI
GQVFFVDHI	GQVFFVDHI
FMSEISDEF	FMSEISDEF
ALYASRLYL	ALYASRLYL
RLYHEDHPQL	RLYHEHPQL
RQEKMNEKI	RQEKMNEKI
KLTNIVEKF	KLTNIVEKF
KIAPNTPQL	KIAPNTPQL
GLINDMVRF	GLINDMVRF
IQFADDMQEF	IQFADMQEF
RLVESDPQGL	RLVESPQGL
RQDPGTELL	RQDPGTELL
SQHGYYEKL	SQHGYYEKL
AQIADLQQKL	AQIADQQKL
LLFVDEPKL	LLFVDEPKL
RQSQLVVDWL	RQSQLVVDW
KQSEEHNML	KQSEEHNML
ALLALKEVEEI	LLALKVEEI
RLDETIQAI	RLDETIQAI
GQWRFVDVL	GQWRFVDVL
SQEEPGKGSFW	SQEEPKGSF
RQIKDTVTM	RQIKDTVTM
ILSSFESRL	ILSSFESRL
RQSELEPVV	RQSELEPVV
KLAQTYMDKL	KLAQTMDKL
RTSPGSLDKI	RTSPGLDKI
YQDEVFGGF	YQDEVFGGF
LQDDIPTTF	LQDDIPTTF
RMLEESNLSF	RMLEENLSF
HLDEKSFRW	HLDEKSFRW
LQIGDVVRI	LQIGDVVRI
RQILEKKEGLF	RQILEKEGL
SMDQTILLW	SMDQTILLW
ALHNLDRKW	ALHNLDRKW
HLEDVFQLF	HLEDVFQLF
RQENGASVI	RQENGASVI
KQDKGGFGF	KQDKGGFGF
LISITKLEW	LISITKLEW
LQDKEGLSNQL	LQDKESNQL
AQAKEENVGL	AQAKENVGL
RLDPADLQL	RLDPADLQL
RVDPDVAQHW	RVDPDAQHW
RLVEDMENKI	RLVEDENKI
LLSDVRFVL	LLSDVRFVL
KQAEEYLSF	KQAEEYLSF
LQKKNHLI	LQKK-NHLI
RQALEEANAEL	ALEEANAEL
AQSKDFAV	AQSK-DFAV
HLDGHHVVF	HLDGHHVVF
RQIGSVDTF	RQIGSVDTF
IQDPASQRLTW	IQDPASQRL
VLQQKEHTI	VLQQKEHTI
RLDPAQRKL	RLDPAQRKL
AQYPSEHLI	AQYPSEHLI
RIQNSGAEAW	RIQNSAEAW
RQNKTEAEQQI	RQNKTEQQI
HVDKVIMKL	HVDKVIMKL
QQSSLSLRW	QQSSLSLRW
LQDTLIHLI	LQDTLIHLI
AQTVANFNI	AQTVANFNI
KQLRDELRL	KQLRDELRL
HILRGEPVI	HILRGEPVI
AQYREVAAF	AQYREVAAF
HQSKLTNEDF	HQSKLNEDF
RLQAEEKAHAF	LQAEEAHAF
SQAGITETEW	SQAGIETEW
GLDVEDVKF	GLDVEDVKF
YQSKVRELI	YQSKVRELI
GQLRAQEAGL	GQLRAEAGL
HLLEDAFNQI	HLLEDFNQI
YLEKSGVLDTL	YLEKSLDTL
RQIEEQKALAL	RQIEEQKAL
RQVLEDFPTI	RQVLEFPTI
RLIPERTVW	RLIPERTVW
RISVIQKEEF	RISVIKEEF
RQPDKENVTL	RQPDKNVTL
HILELVDNW	HILELVDNW
HVQDAEEAW	HVQDAEEAW
RLSNKVEAI	RLSNKVEAI
RLLEGEEQRL	RLLEGEQRL
AVVAAGDKW	AVVAAGDKW
RQERVMFDKI	RQERVFDKI
RQETKEAQL	RQETKEAQL
RQAEETVDF	RQAEETVDF
KLEDTITLI	KLEDTITLI
QQAAIPIQI	QQAAIPIQI
RQVEDLQATF	RQVEDQATF
RQHNTEIRM	RQHNTEIRM
VQDESHSEW	VQDESHSEW
RLLFSSDSDLL	LLFSSSDLL
AQATPDHVL	AQATPDHVL
TLIEDEIATI	TLIEDIATI
KLWADRISL	KLWADRISL
ILLDDTGLAYI	LLDDTLAYI
AVSSPDPLL	AVSSPDPLL
RQMREMEENF	RQMREEENF
RLDEAAQRL	RLDEAAQRL
RQIYIYNEKI	RQIYINEKI
RQDINKEHL	RQDINKEHL
RQQGNEPSQIL	RQQGNPSQI
RQENEQRRLF	RQENEQRRL
KLHEEIEHL	KLHEEIEHL
SSPQPGSAL	SSPQPGSAL
ILYHLGEEW	ILYHLGEEW
LLDEVIQEF	LLDEVIQEF
SQTVVEEYL	SQTVVEEYL
AVDEVVLKF	AVDEVVLKF
IIHEIAVLEL	IIHEIVLEL
RMKGGEKIGI	RMKGGKIGI
KAEENAQRL	KAEENAQRL
AQDEEIARL	AQDEEIARL
RLFIQKEEQL	RLFIQEEQL
AVIEDTWHYF	AVIEDWHYF
RIHKGDRVL	RIHKGDRVL
RADPLFLLI	RADPLFLLI
RQDIFQEQL	RQDIFQEQL
REAFLVNSDL	REAFLNSDL
SLLDDTTVTL	LLDDTTVTL
RLQEALDAEML	RLQEADAEM
HQLFLEPEVL	HQLFLPEVL
LLDSRSYETL	LLDSRYETL
NAPWAVTSL	NAPWAVTSL
AQFEGIVTDLI	AQFEGVTDL
KLIDVTNIYW	KLIDVNIYW
GQFYDLKELF	GQFYDKELF
RQLNEKLVQL	RQLNELVQL
RLFDTQSKEKL	RLFDTKEKL
RVQGPELISL	RVQGPLISL
LAPILDDGW	LAPILDDGW
SLHQVSFLF	SLHQVSFLF
AQTTMEPHL	AQTTMEPHL
GQDVSQAQRQI	GQDVSQAQR
KQIDELDILRL	KQIDELDIL
KAPVTKVAA	KAPVTKVAA
AQAEDMNVKL	AQAEDNVKL
YQAHYGEQL	YQAHYGEQL
RQEGHSQGF	RQEGHSQGF
FIFDSAGKELF	FIFDSGKEL
RLDRTEIITF	RLDRTIITF
RQIDEQQKL	RQIDEQQKL
ELQPSEEVTW	LQPSEEVTW
RISEAKEEL	RISEAKEEL
TQNLDVHFW	TQNLDVHFW
RLLEDKKITVL	RLLEDKITV
RLHEKVNII	RLHEKVNII
RQEPYTLPQGF	RQEPYPQGF
KMIEDLQNEL	KMIEDQNEL
HLWTGEEQLW	HLWTGEEQL
RLEERSSEF	RLEERSSEF
YQVEGMEWL	YQVEGMEWL
KLMKEDGTTL	KLMKEGTTL
HLNQFVDHEKI	NQFVDHEKI
HQIGPGMVQQI	QIGPGVQQI
VLFAEEPGL	VLFAEEPGL
AISDLQQLW	AISDLQQLW
RVYEFLDKL	RVYEFLDKL
LLAPDGHLQF	LLAPDHLQF
RTIEDFNKF	RTIEDFNKF
RQFMAETQF	RQFMAETQF
VLHPTPELW	VLHPTPELW
HQQLEGWKW	HQQLEGWKW
RQAEELFHNL	RQAEEFHNL
TVTGVGDVF	TVTGVGDVF
AQFKGTQSL	AQFKGTQSL
VQALVSGKL	VQALVSGKL
KVIELQEII	KVIELQEII
RLVSSDPEI	RLVSSDPEI
AQAGPGGDTW	AQAGPGDTW
SLSDTHDRL	SLSDTHDRL
RLQESFDTI	RLQESFDTI
FLDENVHFF	FLDENVHFF
YMVADRFSEL	YMVADFSEL
RSTSVTNDKL	RSTSVNDKL
RQYGDESTLAF	RQYGDESTL
RQLIQESKF	RQLIQESKF
RQAQAEDAL	RQAQAEDAL
RQALPQVRL	RQALPQVRL
AQATGIESL	AQATGIESL
AQAKPALKI	AQAKPALKI
AVIDIPGADTL	VIDIPADTL
ALNSKDAAL	ALNSKDAAL
RLFKEGKERM	RLFKEKERM
ALILGGDRM	ALILGGDRM
IQDPASQRL	IQDPASQRL
QESNVRLKL	QESNVRLKL
KVVDDTLEL	KVVDDTLEL
ALVPETIHDEL	LVPETHDEL
RLQQEVEEQL	RLQQEEEQL
FLYTGEGDTV	FLYTGGDTV
RLPKDFVDL	RLPKDFVDL
IQINQEEERL	IQINQEERL
KLAQDDLHI	KLAQDDLHI
KTAPFDSRF	KTAPFDSRF
RLVAGPRTDTL	LVAGPTDTL
LLSQDFVQI	LLSQDFVQI
RQSLEVKM	RQSL-EVKM
RLLKSKLYL	RLLKSKLYL
HLHNGDLDHF	HLHNGLDHF
KVAELFEKL	KVAELFEKL
KVLGNPKSDEM	VLGNPSDEM
HVDIVKLLL	HVDIVKLLL
HLDKEIEKL	HLDKEIEKL
GLSDLRLEL	GLSDLRLEL
KLSQLEEHL	KLSQLEEHL
VLIDIREYW	VLIDIREYW
IQQNNDIVQSL	QQNNDVQSL
RQIHANHETL	RQIHAHETL
ALYGQPLLL	ALYGQPLLL
SIAPEDPFV	SIAPEDPFV
RLPTEEEWEF	RLPTEEWEF
AQAQIVQSW	AQAQIVQSW
HQINDASRGTL	HQINDASRG
KVHDFDVKI	KVHDFDVKI
RMSSFGDFV	RMSSFGDFV
RQGKAKLVI	RQGKAKLVI
KQVFTSEKF	KQVFTSEKF
RQSLSLPSM	RQSLSLPSM
HQTQVSQRL	HQTQVSQRL
SIIADDFAAF	IIADDFAAF
TQGPIEVYL	TQGPIEVYL
RLNELMSQI	RLNELMSQI
RQEDLIMKV	RQEDLIMKV
KLQEVDSLW	KLQEVDSLW
GQTAIDAAL	GQTAIDAAL
AMDFTPEEW	AMDFTPEEW
HQAGSDSLL	HQAGSDSLL
KLEEGKYLI	KLEEGKYLI
KQDWLILHI	KQDWLILHI
GQSIDKSYL	GQSIDKSYL
RQMVVLEEEF	RQMVVEEEF
RQTIQVSLM	RQTIQVSLM
SQIREMETLI	SQIREMETL
RLIKHAVQERL	RLIKHQERL
RLEASETESF	RLEASTESF
RQVLEIESSW	RQVLEESSW
RQHAEHIFLSF	RQHAEHIFL
VQDRFEVNI	VQDRFEVNI
KLQYFMEQF	KLQYFMEQF
RQQEIEEKL	RQQEIEEKL
RLLEEIHAM	RLLEEIHAM
GQHSSNVQW	GQHSSNVQW
KLEDIFQQEF	KLEDIQQEF
RLAVDKSASL	RLAVDSASL
RLDYITAEI	RLDYITAEI
VVDRSQAGDRI	SQAG--DRI
KLYSEMEQL	KLYSEMEQL
RQDAVHAIL	RQDAVHAIL
FQLRSFDQL	FQLRSFDQL
KQISKILEEF	KQISKLEEF
AMIELVERL	AMIELVERL
FLPRTDYSF	FLPRTDYSF
IIDGNPETFW	IIDGNPETF
RQIEILELEDL	RQIEILEDL
RLFELAKDYM	RLFELKDYM
RLIQQVAQEIW	RLIQQAQEI
GMAAVVDRI	GMAAVVDRI
HQDESSSFHHL	HQDESFHHL
RLSVSTETL	RLSVSTETL
RQMVEHGGF	RQMVEHGGF
KISLISEKW	KISLISEKW
RQTTITSHF	RQTTITSHF
RVADTFQDYF	RVADTQDYF
KLIADVGLVGF	LIADVLVGF
QQARNVMQSW	QQARNMQSW
LSSPATLNSR	LSSPALNSR
LLDLKEPTW	LLDLKEPTW
HLSEVQAFF	HLSEVQAFF
LMAQHFDEVW	LMAQHDEVW
RQDPFTVHM	RQDPFTVHM
RLEKEERKM	RLEKEERKM
QQDSGRLYL	QQDSGRLYL
IQDEIRSVI	IQDEIRSVI
VQWDEAEITI	VQWDEEITI
SQSKDSDVYI	SQSKDDVYI
RLVAGSTDQL	RLVAGTDQL
RLAELTVDEF	RLAELVDEF
VLTSKGDAW	VLTSKGDAW
AQHQALVTLW	AQHQALVTL
RLINTQAIF	RLINTQAIF
KLAVGDNNSKW	AVGDNNSKW
RLTGVNDKM	RLTGVNDKM
HQLDVVIAEKL	QLDVVAEKL
RVIDDSLVVGV	RVIDDSLVV
AQNQGDIKL	AQNQGDIKL
RLWKNVYDEL	RLWKNYDEL
RTIADSLINSF	TIADSINSF
KIIEQEKEI	KIIEQEKEI
HQQLEGWRW	HQQLEGWRW
GQESAQNTKF	GQESANTKF
RQLKNIKDAF	RQLKNKDAF
GLFADGHLILW	GLFADGHLI
KLIKDGLII	KLIKDGLII
ERVSYALLF	ERVSYALLF
AQLAAAEKF	AQLAAAEKF
QLVMEGYNW	QLVMEGYNW
GVVSKGDKI	GVVSKGDKI
RQFLRGLDFL	RQFLRLDFL
SQANIAQVL	SQANIAQVL
AQAALAVNI	AQAALAVNI
SQEQSFSDKL	SQEQSSDKL
RLGPSVVGL	RLGPSVVGL
RQVGVGYVDSI	RQVGVVDSI
AQSSLDLFL	AQSSLDLFL
SQFGHVVDIV	SQFGHVVDI
RQFGKKHLF	RQFGKKHLF
FVDDQQTFF	FVDDQQTFF
KQFAEMYVAKF	KQFAEVAKF
RQDKRTVYVYL	RQDKRTVYV
WLYGEDHQI	WLYGEDHQI
RLFNAVVRW	RLFNAVVRW
NLVQVGDSL	NLVQVGDSL
HLVEMDTDQL	HLVEMTDQL
GQDPGPEPRL	GQDPGEPRL
RLLLLPLLL	RLLLLPLLL
TQIKQKVDSL	TQIKQVDSL
HLDDIRNDW	HLDDIRNDW
RIVDDFGTHL	RIVDDGTHL
RLLEEHAKL	RLLEEHAKL
RQMPGKELEW	RQMPGELEW
KVIGILQDGF	KVIGIQDGF
GQIRDNKIGI	GQIRDKIGI
EQDQAVHLW	EQDQAVHLW
KQVYDIAAKF	KQVYDAAKF
KMEDTDFVGW	KMEDTFVGW
NARLAADD	NARL-AADD
YLAQPLLREVL	AQPLLREVL
GQSPVKAEW	GQSPVKAEW
KLFGMIITI	KLFGMIITI
RSDYEDPAF	RSDYEDPAF
QISQAYEVL	QISQAYEVL
KLHRGEIKL	KLHRGEIKL
HLDEARTLL	HLDEARTLL
RIMSGESTF	RIMSGESTF
RQDLTTLDV	RQDLTTLDV
TMVEAFDRW	TMVEAFDRW
AGDGTFQKW	AGDGTFQKW
WLLDDSKTWW	LLDDSKTWW
ILQDGRIFI	ILQDGRIFI
SQFASVERI	SQFASVERI
RQALLLLAL	RQALLLLAL
KQFEGTVEI	KQFEGTVEI
YMVADKFTEL	YMVADFTEL
RLSTLIEFL	RLSTLIEFL
ILILDNDGDRL	ILDNDGDRL
KQVMEGRVTF	KQVMERVTF
KVMEYENRI	KVMEYENRI
KQFAGYSEEVL	KQFAGSEEV
GQDPDEIGI	GQDPDEIGI
LLDATQHTL	LLDATQHTL
VIQENEHAL	VIQENEHAL
HQSALELIM	HQSALELIM
RQAAEDKSWRV	RQAAEDKSW
RLSAQDPVV	RLSAQDPVV
KMVDERTDYL	KMVDETDYL
FQSFQDHKL	FQSFQDHKL
KLMPNFSDSF	KLMPNSDSF
RQISSAMEQL	RQISSMEQL
ALYTEKFEEF	ALYTEFEEF
RQLQESAAKL	RQLQEAAKL
RLEEEKRML	RLEEEKRML
RIEDRLERL	RIEDRLERL
RMEDIKILI	RMEDIKILI
RMVEEIGVEL	RMVEEGVEL
AQAQEVFFL	AQAQEVFFL
RMIQIQENM	RMIQIQENM
ILLDERGQIKL	LLDERQIKL
RQNLDALLNQL	NLDALLNQL
AQYSQDYQQF	AQYSQYQQF
HVSDLEYRI	HVSDLEYRI
FLIRESETL	FLIRESETL
KTDGGDPSGL	KTDGGPSGL
SQINRAYQF	SQINRAYQF
IVDGHSVEEL	IVDGHVEEL
HLYEEKFESI	HLYEEFESI
SQSPKDTSF	SQSPKDTSF
IQSNYDIAI	IQSNYDIAI
HVVHPPTGEEF	VVHPPGEEF
HVIDGEKTI	HVIDGEKTI
SIYEGDESF	SIYEGDESF
RTIQGLIDFI	RTIQGIDFI
RQIGDKDQKI	RQIGDDQKI
LQDPTNLDKF	LQDPTLDKF
KQADLYISEGL	KQADLSEGL
YQNLIDVGF	YQNLIDVGF
GLAPKDPAL	GLAPKDPAL
KLSLNMDNL	KLSLNMDNL
RVSPEEVTI	RVSPEEVTI
RQQPPDLVEF	RQQPPLVEF
RLMNETTAVAL	RLMNETTAV
QMFGEMEVW	QMFGEMEVW
ALDATHQQL	ALDATHQQL
RLDTTLIDF	RLDTTLIDF
ILDQTKTEL	ILDQTKTEL
KQFHDSKIKF	KQFHDKIKF
KQIESDRQNL	KQIESRQNL
KQINQEYLI	KQINQEYLI
KVLELFESF	KVLELFESF
KQAVTKAGW	KQAVTKAGW
ILEDLDLDKF	ILEDLLDKF
RLIEETISI	RLIEETISI
RLSAEERDQL	RLSAERDQL
TQDAVPLTL	TQDAVPLTL
IALLKIRSK	IALLKIRSK
AQVPNIDFEGL	QVPNIFEGL
GQSWPESLI	GQSWPESLI
RQHEIDGKALF	RQHEIGKAL
HQVNSDLLGW	HQVNSLLGW
VQDPSQFDVL	VQDPSFDVL
RSESRPDIL	RSESRPDIL
LMDESVLKF	LMDESVLKF
KLPSSYELDVL	KLPSSYELD
HLDDIRQDW	HLDDIRQDW
SMEKSFSDLF	SMEKSSDLF
RLVEGLDQF	RLVEGLDQF
RIFNDSDFTGF	RIFNDFTGF
RVLFIKDVI	RVLFIKDVI
AQWADQEQW	AQWADQEQW
KLQEVLDYL	KLQEVLDYL
RIESVIKELW	RIESVKELW
REHPLYLRL	REHPLYLRL
RMNVLADAL	RMNVLADAL
HQNDDAEVSL	HQNDDEVSL
HLDEVFLEL	HLDEVFLEL
ALDFNTKVFW	ALDFNKVFW
KVATAQDDI	KVATAQDDI
YLVSPITGEKI	LVSPIGEKI
KQITEDTVEF	KQITETVEF
RVLEELETL	RVLEELETL
RVVDDDGMTSL	VVDDDMTSL
GQVITIGNERF	QVITINERF
YLAQHYDKI	YLAQHYDKI
KMVRADPSL	KMVRADPSL
RLAKELLDSF	RLAKELDSF
KLVYQIFDTF	KLVYQFDTF
AQAQDAELVRL	AQDAELVRL
RVSEIRDAF	RVSEIRDAF
HQHRSGIESAL	HRSGIESAL
SQDGTLQSF	SQDGTLQSF
HLEEAFTSEHW	HLEEASEHW
RLIYDTKGRF	RLIYDKGRF
YIIEREPLI	YIIEREPLI
RQTIINDYI	RQTIINDYI
HQLLEKVRI	HQLLEKVRI
RQAQTDRVSL	RQAQTRVSL
RLAEVKDSL	RLAEVKDSL
RQIDQMVGLI	RQIDQMVGL
FDPNIRDSR	FDPNIRDSR
SQNAIDHKI	SQNAIDHKI
RLAEETGVHII	RLAEEGVHI
HVDGQTHMLF	HVDGQTHML
GQVEVTGDEY	GQVEVGDEY
RLQVEKERL	RLQVEKERL
HQAAQALHL	HQAAQALHL
RISELRLIL	RISELRLIL
RQEDDKLFL	RQEDDKLFL
KQFRTEMEDL	KQFRTMEDL
ALAPILDDGW	ALAPIDDGW
RIVPSEVEPFL	RIVPSVEPF
RLPGFSDSNVI	RLPGFDSNV
KLEDPHVDII	KLEDPHVDI
AQDANAAQQEL	AQDANQQEL
QSESELQKL	QSESELQKL
RQMHLMIDQL	RQMHLIDQL
KLIENNDTI	KLIENNDTI
SQSPGSSENQM	SQSPGSSEN
GQLLNDPFL	GQLLNDPFL
FLDDLGLKF	FLDDLGLKF
QLQDGHEREYI	LQDGHREYI
KLDEREAGI	KLDEREAGI
HIDPNVDYQF	HIDPNDYQF
YQHGHINSYL	YQHGHNSYL
GIDKPDVRF	GIDKPDVRF
RQIKEGAGVW	RQIKEAGVW
RQDVDNASL	RQDVDNASL
RQQISGPELL	RQQISPELL
RVFQVEYAM	RVFQVEYAM
KLHDVEHVL	KLHDVEHVL
AQLPEQVTL	AQLPEQVTL
AETAVQLFI	AETAVQLFI
RLDGGTDITF	RLDGGDITF
RLQSGVNTL	RLQSGVNTL
KLQNKEHVI	KLQNKEHVI
RVSAVQMDDW	RVSAVMDDW
RQLLDQVEQI	RQLLDVEQI
WQEGSVTRL	WQEGSVTRL
GQSELASRL	GQSELASRL
AQQLEEARL	AQQLEEARL
RVANPRLDTF	RVANPLDTF
RLFLDSNGL	RLFLDSNGL
HLYRDGHEEAL	HLYRDEEAL
SLWYGKEYW	SLWYGKEYW
FLPREDHLF	FLPREDHLF
RLSGIEERY	RLSGIEERY
RLSSIKTRF	RLSSIKTRF
RQQLGEMGL	RQQLGEMGL
TLGPKDPGL	TLGPKDPGL
GQDAASKAW	GQDAASKAW
HLYSSIEHL	HLYSSIEHL
YQYPRPLLI	YQYPRPLLI
SQFPTPEAVL	SQFPTEAVL
GQDRILIRF	GQDRILIRF
HLWDEDFVQW	HLWDEFVQW
FLVLDEQRF	FLVLDEQRF
RLKEEGNEQF	RLKEENEQF
KLLEYIEEI	KLLEYIEEI
SPMGSSDLLAP	SPMGSSDLL
KVDGSEPKL	KVDGSEPKL
HLDMEHERL	HLDMEHERL
AQAKAESITL	AQAKASITL
RQSLAESLFAW	RQSLAESLF
HVSAVPESL	HVSAVPESL
RQLAQHDEDL	RQLAQDEDL
KLSELQLRV	KLSELQLRV
RVDKNAPTV	RVDKNAPTV
ILADLHSADQL	LADLHADQL
AQYDRQIRL	AQYDRQIRL
GQVSIHSVW	GQVSIHSVW
ILSKIPDEI	ILSKIPDEI
AQLQELQVKF	AQLQEQVKF
RIYFGEVQL	RIYFGEVQL
RVIKDKQTQL	RVIKDQTQL
FQHWDPDIL	FQHWDPDIL
HQEQANNDFF	HQEQANDFF
GQIDDHQSSRL	QIDDHSSRL
RIIDEEGVESI	IIDEEVESI
GQIEDELNL	GQIEDELNL
KQEIGFGNW	KQEIGFGNW
LQLDKEFQL	LQLDKEFQL
KLLEDRIAEF	KLLEDIAEF
AVDKAYKL	AVDK-AYKL
HQDPQQNFL	HQDPQQNFL
QLSDVAEKL	QLSDVAEKL
RQNLAEMGL	RQNLAEMGL
RLFEAEAQDLF	RLFEAAQDL
VQDPSVFVTF	VQDPSFVTF
RLFDEPQLASL	RLFD-EPQL
RQILEKAIQL	RQILEAIQL
IMKDKDNFW	IMKDKDNFW
HLVDLRISW	HLVDLRISW
RALIEKVGI	RALIEKVGI
RQDSINLFL	RQDSINLFL
GQMQMAELL	GQMQMAELL
RQYKDYKIHW	RQYKDKIHW
AQSEAEKERI	AQSEAKERI
ALAGVLAILAT	ALAGVLAIL
SQGSVGFLW	SQGSVGFLW
RLYAESDYDAF	RLYAEYDAF
RQIRSDFVTL	RQIRSFVTL
KLFSEKRVELL	KLFSERVEL
RLDDLFLESF	RLDDLLESF
RVDDIFSDL	RVDDIFSDL
RLVEREAGL	RLVEREAGL
WSFDGIDRW	WSFDGIDRW
KLQEIENAI	KLQEIENAI
FLHELEEKM	FLHELEEKM
RLDSIVGPQL	RLDSIGPQL
RVNGQYIMEGL	GQYI-MEGL
FQENSTIGQKI	QENSTGQKI
SMDKTMILW	SMDKTMILW
QTLELKNSI	QTLELKNSI
AQDEHLITF	AQDEHLITF
RQYSDMPPLTL	RQYSDMPPL
GQLDDARVIL	GQLDDRVIL
KQMSISTGL	KQMSISTGL
AQQEAERARF	AQQEARARF
YMIHEPEPHI	YMIHEEPHI
SQDPPEKSI	SQDPPEKSI
KLDSSDIYNEL	KLDSSYNEL
GQHVATQHF	GQHVATQHF
RQVAKVEKF	RQVAKVEKF
GLFHGTELL	GLFHGTELL
QLSNGDHHF	QLSNGDHHF
HLIYLINDVL	HLIYLNDVL
KQNRPIPQW	KQNRPIPQW
AQALTDQQQF	AQALTQQQF
RIIHTGEKF	RIIHTGEKF
HQEVVELLI	HQEVVELLI
RLVAGSTDQLL	RLVAGTDQL
RLFRAQDPDQL	RLFRAPDQL
KVFELDLVTL	KVFELLVTL
HQDLHSEAW	HQDLHSEAW
GQSKGFAFI	GQSKGFAFI
KLIGRYFDEI	KLIGRFDEI
RVILDEGHAI	RVILDGHAI
KLMAIPLVF	KLMAIPLVF
GVTVVGDII	GVTVVGDII
SVIFGEALW	SVIFGEALW
GQYYKPEQF	GQYYKPEQF
MIDNVILLI	MIDNVILLI
SQVEGEHQLW	SQVEGEHQL
AQVRDLEEKL	AQVRDEEKL
QQDKLNTRW	QQDKLNTRW
AQVQVAGDML	AQVQVGDML
AMVSLEMEKL	AMVSLMEKL
KQVQADFITL	KQVQAFITL
KQAGLVVKL	KQAGLVVKL
RQDQIHSSI	RQDQIHSSI
RLLDLHQSW	RLLDLHQSW
RLLQDHPWLL	RLLQDPWLL
KQQDVIYELI	KQQDVYELI
KQESTVMVL	KQESTVMVL
RQQEQMKQQQW	QQEQMQQQW
VQHQDALQI	VQHQDALQI
RQHQAGSDSLL	RQHQASDSL
RQESVTKQQW	RQESVKQQW
AMAPERTGW	AMAPERTGW
AQIDDDVFDKI	QIDDDFDKI
KQVQTLQDEL	KQVQTQDEL
RLFKTALQEEI	RLFKTQEEI
RLERSIRDEI	RLERSRDEI
YQILDGIHYL	YQILDIHYL
SQFKGYFIF	SQFKGYFIF
MDYWKSPTL	MDYWKSPTL
RLGTFETQI	RLGTFETQI
YLMAEKLGI	YLMAEKLGI
KLVFIGDTL	KLVFIGDTL
RQTHTVDSL	RQTHTVDSL
KLEENNGTDLL	KLEENGTDL
RLSITNETF	RLSITNETF
SLFSAVREDF	SLFSAREDF
RQFPTAFEF	RQFPTAFEF
AQAEYIEKF	AQAEYIEKF
SQSTVKVLI	SQSTVKVLI
SLISSDYELL	SLISSYELL
AQFDNHNSQVW	AQFDNNSQV
AQNGIPLRI	AQNGIPLRI
HMDGKIRLW	HMDGKIRLW
AQYKEISKF	AQYKEISKF
AQDPEIASL	AQDPEIASL
KQVEEIFNL	KQVEEIFNL
AQIEDLQVKL	AQIEDQVKL
HLPSFDAHL	HLPSFDAHL
HLSTYSLVW	HLSTYSLVW
AMEEALFQHF	AMEEAFQHF
RLDHKFDLM	RLDHKFDLM
HQITEVGTM	HQITEVGTM
RQAAKTEIEKL	RQAAKIEKL
RTVELFYDVL	RTVELYDVL
IRLSLEKKL	IRLSLEKKL
RQTLQEDLL	RQTLQEDLL
QLQKPDVVGI	QLQKPVVGI
RQYPEVEIF	RQYPEVEIF
RLALPDYEYL	RLALPYEYL
KQITEENFQL	KQITENFQL
KQDPNYLATM	KQDPNLATM
SVYDGKLLI	SVYDGKLLI
KESTLHLVL	KESTLHLVL
RLVDTGDKFR	RLVDTGDKF
RLHWIDREKL	RLHWIREKL
RLAGKELRF	RLAGKELRF
LLNVINENF	LLNVINENF
IQGPDYVL	IQGP-DYVL
QLAQHDEDL	QLAQHDEDL
RQDAGGILHI	RQDAGILHI
KLHIPYAGETL	HIPYAGETL
YINVEREEW	YINVEREEW
VQSGLRILL	VQSGLRILL
RLIAQRYLL	RLIAQRYLL
RLAQTHRDAL	RLAQTRDAL
WQEGSVTRLW	WQEGSVTRL
KQFAEGSTLKL	KQFAEGSTL
KLFQSDTNAML	FQSDTNAML
HQDTQGTSHRW	HQDTQSHRW
KIIGINGDFF	KIIGIGDFF
RQLEEEQKL	RQLEEEQKL
ILNSLYNENL	ILNSLNENL
KLLQNIGIDKI	LLQNIIDKI
RIDGVSLLV	RIDGVSLLV
RLGSLVDEF	RLGSLVDEF
KQQRNEVSF	KQQRNEVSF
RQYGSEGRFTF	RQYGSEGRF
RQHFSPLSL	RQHFSPLSL
QQDAQEFFL	QQDAQEFFL
HQTQDSQVYW	HQTQDQVYW
RLYTEEAFDKL	RLYTEFDKL
RIHLRDYVI	RIHLRDYVI
RQLREQVNDLF	RQLREVNDL
GLSNTVMRL	GLSNTVMRL
KLYNNITFEEL	KLYNNFEEL
KLAEFIDFL	KLAEFIDFL
RLSFLVSYI	RLSFLVSYI
RQREMEEQM	RQREMEEQM
RLFYFSNEKY	RLFYFNEKY
QLEPEELYQTF	LEPEEYQTF
YQSPTGDRI	YQSPTGDRI
RLPSSSSGDQL	RLPSSGDQL
GQFLEVITL	GQFLEVITL
ILDTEAVAW	ILDTEAVAW
RLFKIDKEYL	RLFKIKEYL
LARESAEVHLI	RESAEVHLI
RILGIIDAI	RILGIIDAI
RLLSVGGEAF	RLLSVGEAF
RLPPEIFGDAL	RLPPEGDAL
TEKPEVID	TEKP-EVID
KLWEAESKL	KLWEAESKL
KQLEEQNARL	KQLEENARL
RLSTMQDSL	RLSTMQDSL
ALAPKDKKI	ALAPKDKKI
RAFQAHKEENW	FQAHKEENW
RIIEENIPELL	RIIEEIPEL
RQDWGPITSI	RQDWGITSI
SLVNLGGSK	SLVNLGGSK
ALAEKEHKL	ALAEKEHKL
AQIAELKMQL	AQIAEKMQL
RMFPGEVAL	RMFPGEVAL
YQAPDIDVQL	YQAPDDVQL
RLADEFGVAV	RLADEGVAV
RILDESHSI	RILDESHSI
SQDYGKHLL	SQDYGKHLL
RIVKIGDFGL	RIVKIDFGL
AQMGSEAHV	AQMGSEAHV
RQFPVTVHF	RQFPVTVHF
KQVEDDIQQLL	KQVEDIQQL
KPERSFEIL	KPERSFEIL
AQSDLKEVM	AQSDLKEVM
YQDTPKQI	YQDT-PKQI
RVISFEEQV	RVISFEEQV
RDIFKKQII	RDIFKKQII
KQMPEPEQL	KQMPEPEQL
ILDAGGHNVTI	ILDAGGHNV
GQNPFELAF	GQNPFELAF
RQQEGESRL	RQQEGESRL
KQYADVEGF	KQYADVEGF
RIDGKTYVI	RIDGKTYVI
VLAPILPDNF	VLAPIPDNF
AQFKGIEKL	AQFKGIEKL
FQLTQGDQL	FQLTQGDQL
KLLRDDEAHL	KLLRDEAHL
RLTTSTSTF	RLTTSTSTF
RVVKDITNAF	RVVKDTNAF
RVFEDESGKHW	RVFEDESGK
RMTLADDVTL	RMTLADVTL
RQPAEMAAEL	RQPAEAAEL
RLQSKVLKL	RLQSKVLKL
RLIKSFEKV	RLIKSFEKV
RLEEGIRFL	RLEEGIRFL
KQTALASRF	KQTALASRF
RIHQDGIHI	RIHQDGIHI
KLNENHSGELW	KLNENSGEL
RVSINKDEL	RVSINKDEL
FLDSLRDLI	FLDSLRDLI
ISTHIGNEL	ISTHIGNEL
ALAPHEEYI	ALAPHEEYI
YIIKDKHIL	YIIKDKHIL
RLSVLVDEF	RLSVLVDEF
KQISQAYEVL	KQISQYEVL
SQFLAKVESF	SQFLAVESF
GQDSIVLLI	GQDSIVLLI
ALIWDIQQM	ALIWDIQQM
QQAWPLEGF	QQAWPLEGF
RQELYVEDF	RQELYVEDF
KILAEGGGAKF	ILAEGGAKF
GLYGIKDDVF	GLYGIDDVF
RQLDEGEISTI	QLDEGISTI
RQTMEDLISLW	RQTMELISL
TQFFGFDTETF	TQFFGTETF
SLDSSTLLF	SLDSSTLLF
HQHEPFLDFL	HQHEPLDFL
RLADDLNEKI	RLADDNEKI
HLAGVKDQL	HLAGVKDQL
RQLVDTTVEL	RQLVDTVEL
RQIYEEANKTM	RQIYEANKT
HLTELQEFW	HLTELQEFW
AQHPATTEDI	AQHPATEDI
RQFKEIAAV	RQFKEIAAV
RQLESEREAL	RQLESREAL
IQAKVEPEI	IQAKVEPEI
KLDWVEVGL	KLDWVEVGL
FQDDPDIIAF	FQDDPIIAF
SQGQPAQDIF	SQGQPAQDI
RIQAGEEKL	RIQAGEEKL
RIKELPELW	RIKELPELW
RLVPKHEEEAF	RLVPKEEAF
KLDELYGTW	KLDELYGTW
KQYIEFVADRL	YIEFVADRL
GAGFSIRYEIF	AGFSIRYEI
YQGFDTDTW	YQGFDTDTW
HLSEMVMKL	HLSEMVMKL
KQIKDDNQEI	KQIKDNQEI
WLHGLESQI	WLHGLESQI
SQDPESLLL	SQDPESLLL
ALFQIEQGI	ALFQIEQGI
RLFPGSSFL	RLFPGSSFL
SAPVGVTAL	SAPVGVTAL
RQDQRVEQL	RQDQRVEQL
RLLKDYEDKI	RLLKDEDKI
VLFDDELLM	VLFDDELLM
RLLSSFDFF	RLLSSFDFF
RLEERSVLF	RLEERSVLF
RLPEEWSQW	RLPEEWSQW
QISKEYERF	QISKEYERF
KQIEDQMTRL	KQIEDMTRL
RQANNINML	RQANNINML
HLDEAIHVL	HLDEAIHVL
RQVGATVEF	RQVGATVEF
GIMKKAYEL	GIMKKAYEL
HQSKEENLI	HQSKEENLI
SLVASGKAELI	SLVASKAEL
RVFPHEVNW	RVFPHEVNW
AQPKGDPRI	AQPKGDPRI
RQENIELGEKL	RQENIGEKL
RQVASHVGL	RQVASHVGL
RQENMVLKL	RQENMVLKL
AQDPVFQKL	AQDPVFQKL
VLFPGTDHI	VLFPGTDHI
RLDDSLLYL	RLDDSLLYL
AQEIGEERI	AQEIGEERI
RVFVGGDDF	RVFVGGDDF
FLSKVEETF	FLSKVEETF
RLQDFKLDF	RLQDFKLDF
SVDETTQAM	SVDETTQAM
VQDVQGDGRW	VQDVQDGRW
KLPEFYDETL	KLPEFDETL
RVFSLSSEF	RVFSLSSEF
RLNSELQQQL	RLNSEQQQL
RLMEEKEKL	RLMEEKEKL
SLAEEHEGL	SLAEEHEGL
AETHIVLLF	AETHIVLLF
RVSELHLEV	RVSELHLEV
RQTNNQQNW	RQTNNQQNW
VLAQADHEL	VLAQADHEL
RLPHSGEAQL	RLPHSEAQL
GLPNNIVDVW	GLPNNVDVW
KLLPENNVL	KLLPENNVL
RQLGEANEEF	RQLGENEEF
RQASPNIVI	RQASPNIVI
KLVEEFMLL	KLVEEFMLL
RMIKEFRATL	RMIKERATL
YMIGSEVGNYL	IGSEVGNYL
SQAPEKVTL	SQAPEKVTL
KQDNETFGF	KQDNETFGF
FQDKRNLYL	FQDKRNLYL
RQQLPLPYEQL	QQLPLYEQL
SQFSYQHAI	SQFSYQHAI
GQEKIPVHKF	GQEKIVHKF
KIAKENLDVF	KIAKELDVF
AQRSGLNQI	AQRSGLNQI
REAELQMLL	REAELQMLL
RMDKLGRTI	RMDKLGRTI
GQALDGVSI	GQALDGVSI
RLVLEVAQHL	RLVLEAQHL
HLGKIEELL	HLGKIEELL
RQVTGVTRVTI	RQVTGVTRV
HQWLGPEFL	HQWLGPEFL
GVTKFGDNI	GVTKFGDNI
KLVQIEYAL	KLVQIEYAL
ALSKLREDF	ALSKLREDF
AIVDVPVGEEL	IVDVPGEEL
RTAGTLFGEGF	AGTLFGEGF
HTIGIGDSI	HTIGIGDSI
KLEEIDWVTF	KLEEIWVTF
EIVRESHSL	EIVRESHSL
HAAEYGAEALE	HAAEYAEAL
RLLAEEEQQLL	RLLAEEQQL
VMDPTKILI	VMDPTKILI
YQLSKEYTL	YQLSKEYTL
YIVFGEAKI	YIVFGEAKI
RLYSENDRLRI	RLYSENDRL
TQERGQESNRF	TQERGQESN
RMVVTGDNV	RMVVTGDNV
QQLRQETGL	QQLRQETGL
SLSRKDSRW	SLSRKDSRW
RQIKEQGKTI	RQIKEGKTI
RVFQTEAEL	RVFQTEAEL
GLIKLYENF	GLIKLYENF
RQSGDSVRL	RQSGDSVRL
VQGPDWHL	VQGP-DWHL
TLSTFKESW	TLSTFKESW
KQYIISEELI	KQYIIEELI
QLHAAESDEF	QLHAASDEF
RQHVEFDML	RQHVEFDML
RIMSEERSL	RIMSEERSL
RQVRPVTEKL	RQVRPTEKL
RMITETEKF	RMITETEKF
KQSNSYDMF	KQSNSYDMF
FQISKEYERF	FQISKYERF
GQQSAHLAELI	QQSAHAELI
RLSQETQQYF	RLSQEQQYF
AIDSIHQLW	AIDSIHQLW
VQISDKITI	VQISDKITI
RQTVAVGVI	RQTVAVGVI
IIDNSPQAF	IIDNSPQAF
TQGQVDEKW	TQGQVDEKW
SQVGVEPSI	SQVGVEPSI
AQIRETETF	AQIRETETF
HLTAITVDVW	HLTAIVDVW
KLYPLEIVF	KLYPLEIVF
LQNNTILRL	LQNNTILRL
FLEDGIRMW	FLEDGIRMW
RLIDDMVAQAM	RLIDDVAQA
RTDAGVHAL	RTDAGVHAL
RIIHLVHRF	RIIHLVHRF
AQIKEMVEL	AQIKEMVEL
LLFSHEEEL	LLFSHEEEL
RQEEGVFGF	RQEEGVFGF
RQQLELIRL	RQQLELIRL
GQIDPEPVM	GQIDPEPVM
RVIQKALESI	RVIQKLESI
RLAEAEKSQL	RLAEAKSQL
RIADEDRGNW	RIADERGNW
RLPDMEMVI	RLPDMEMVI
TQVPEGAAKW	TQVPEAAKW
RQQLQAHQL	RQQLQAHQL
RLLYPPETGL	LLYPPETGL
SVERSLSDLF	SVERSSDLF
RIIEREEKI	RIIEREEKI
AQMFSDMVL	AQMFSDMVL
RLFKNDPLFF	RLFKNDPLF
RLNKHEENL	RLNKHEENL
IQHAEEFLI	IQHAEEFLI
SQDKNLYHNL	SQDKNYHNL
RTFKTVFAEHI	RTFKTAEHI
RQVVHVETL	RQVVHVETL
KLIHPDEDI	KLIHPDEDI
RAQAGEFGDRL	AQAGEGDRL
RIYWDGPLAL	RIYWDPLAL
RQDNERVLF	RQDNERVLF
RLDVTSNKL	RLDVTSNKL
RQDNPKLDSM	RQDNPLDSM
RLVPDSDVRF	RLVPDDVRF
TQYISEPKL	TQYISEPKL
GQDVGRYQVSW	GQDVGRYQV
AQSQAVTKI	AQSQAVTKI
YQIPDVRDIF	YQIPDRDIF
ILNKVEERM	ILNKVEERM
ALLNLLSLR	ALLNLLSLR
FLDGNELTL	FLDGNELTL
RLAEVEEKL	RLAEVEEKL
AQETVKHSDLF	AQETVHSDL
KLTIHGDLY	KLTIHGDLY
KQDGSTIHI	KQDGSTIHI
RLVEEKVNQL	RLVEEVNQL
KQTDFEHRI	KQTDFEHRI
RLSPVSPAL	RLSPVSPAL
HLSDVVLRF	HLSDVVLRF
SLSDVLDAF	SLSDVLDAF
RQFVEHASEKL	FVEHASEKL
RLEQNQQHL	RLEQNQQHL
LQNPDLVSL	LQNPDLVSL
VLLDNQTVTF	LLDNQTVTF
RQYYTAEKL	RQYYTAEKL
HLDGNTEPGL	HLDGNEPGL
GQIKQIIRI	GQIKQIIRI
GQFQHALEEL	GQFQHLEEL
RLNKVISEL	RLNKVISEL
VQDKGSIHKF	VQDKGIHKF
RLHSLDRVYF	RLHSLRVYF
KLEEKEHLL	KLEEKEHLL
RMLDSVEKL	RMLDSVEKL
RQNKELKVKL	RQNKEKVKL
AQILLKGAERL	ILLKGAERL
RQETEEKILL	RQETEKILL
HIAKLQELW	HIAKLQELW
KLPVHTEISW	KLPVHEISW
ALQRANDDRW	ALQRADDRW
KQLAEEETKI	KQLAEETKI
ALDTKGPEI	ALDTKGPEI
RLIHEPSAALL	RLIHESAAL
RLDKTEQSL	RLDKTEQSL
TQEEPYSDII	TQEEPYSDI
AQAEPERHVW	AQAEPRHVW
RVFREVETL	RVFREVETL
GQASVSLRL	GQASVSLRL
AQHYQDTLI	AQHYQDTLI
RMDAGEVTL	RMDAGEVTL
ILDKTGDKL	ILDKTGDKL
KLFEDGKTGF	KLFEDKTGF
RQILEKAGGL	RQILEAGGL
SHEKLLLQI	SHEKLLLQI
RQGDLEPKF	RQGDLEPKF
KIIGDLLQF	KIIGDLLQF
YLDPNYQSI	YLDPNYQSI
RMDSGLDKF	RMDSGLDKF
RVLREERAYI	RVLRERAYI
RLESNKEGTRW	RLESNGTRW
TLQRGKEENI	TLQRGEENI
RLSPSGDSVF	RLSPSDSVF
RQALETAVNL	RQALEAVNL
REHTALLKI	REHTALLKI
QVGQLAAAGI	QVGQLAAGI
RTMDDKTVF	RTMDDKTVF
SVIDSDEKW	SVIDSDEKW
AVSLILEEW	AVSLILEEW
HIVSVDEHL	HIVSVDEHL
ALDTTRHEL	ALDTTRHEL
AQSHVKISF	AQSHVKISF
AQAPVMNTW	AQAPVMNTW
RVLDERLVRL	RVLDELVRL
RLVREIAQDF	RLVREAQDF
KQLEKDFSSM	KQLEKFSSM
KQAPPQKVSF	KQAPPKVSF
TLQVNGRHEYL	LQVNGHEYL
REDKVHLKL	REDKVHLKL
RQREELREKL	RQREEREKL
REASIYTGI	REASIYTGI
RVAEETIKDYF	RVAEETIKD
RQQPPSTTTF	RQQPPTTTF
GQIDLLERL	GQIDLLERL
AQVMWFEKL	AQVMWFEKL
YLFGSDVVAQF	YLFGSVAQF
MLYPLSHGF	MLYPLSHGF
ALVRFVNLI	ALVRFVNLI
RQGDQDVSL	RQGDQDVSL
RQALFGDHV	RQALFGDHV
VQHSDVLFL	VQHSDVLFL
RQAATEFGWTL	RQAATEFGW
RLVYLNEAW	RLVYLNEAW
STTKIGDAI	STTKIGDAI
HQEQGHQLL	HQEQGHQLL
RLPGYAEVLL	RLPGYEVLL
KLTTAFEEVW	KLTTAEEVW
RLVKDQEAL	RLVKDQEAL
AQALLEYHL	AQALLEYHL
IQDRGDQAF	IQDRGDQAF
KQYGDKIIEEL	KQYGDIEEL
LLDMSYEQL	LLDMSYEQL
STVGFGDQI	STVGFGDQI
AQSLVLDTL	AQSLVLDTL
RLREEQQRERL	REEQQRERL
AIYGNEPEI	AIYGNEPEI
RLPDLIKEVL	RLPDLKEVL
QQNNVEHKV	QQNNVEHKV
RTILQHLSEAW	ILQHLSEAW
RSYQDPSNAQF	YQDPSNAQF
AQDNADYRL	AQDNADYRL
QMSGAQIKI	QMSGAQIKI
QDLSDVLQI	QDLSDVLQI
AQDKEAAEAI	AQDKEAEAI
GVFHGIENF	GVFHGIENF
SQDIVNQVL	SQDIVNQVL
HLLEKDIITL	HLLEKIITL
ALMKEEGVKL	ALMKEGVKL
NIDDKDFKW	NIDDKDFKW
GQFHDLMELF	GQFHDMELF
AQDATKLDTW	AQDATLDTW
AQIIEADEVLL	AQIIEDEVL
RLQEEFEATL	RLQEEEATL
QQDWVVQRI	QQDWVVQRI
RLPAEDEVLL	RLPAEEVLL
ALVALTSERF	ALVALSERF
RQQFEVNGHFF	RQQFENGHF
RQAFHMEQL	RQAFHMEQL
RLPDHLIKDLF	RLPDHIKDL
GQYDGKVDIW	GQYDGVDIW
HLDQSDSDF	HLDQSDSDF
HQIEAVDGEEL	QIEAVGEEL
RILQDEQYLM	RILQDEQYL
RQSLREARI	RQSLREARI
AQDPENQAL	AQDPENQAL
RQFDEESLESF	RQFD-EESL
GQIYANNDKL	GQIYANDKL
KLIAEKSEAKI	LIAEKEAKI
IQDDMHLVI	IQDDMHLVI
RQVDIATQGW	RQVDITQGW
YVADLGDIL	YVADLGDIL
KLWEMDNMLI	KLWEMDNML
HAIEDKETI	HAIEDKETI
SMMDVDHQI	SMMDVDHQI
RLSKEETVL	RLSKEETVL
AQGKMKLLI	AQGKMKLLI
KQFEPNDFYL	KQFEPDFYL
RIVKESGGKL	RIVKEGGKL
RLVDTGDKF	RLVDTGDKF
KQALDKLKL	KQALDKLKL
RLNRIENAL	RLNRIENAL
RQAIEELYYF	RQAIELYYF
KIVPVEITI	KIVPVEITI
LQDKDTYSW	LQDKDTYSW
RIIWQEEDTF	RIIWQEDTF
RLVSSEQAL	RLVSSEQAL
HMESVNAEAKL	ESVNAEAKL
LLNSKEAAL	LLNSKEAAL
RQSKISLDNL	RQSKILDNL
SLDPSRPVTF	SLDPSPVTF
FQDSGLSRF	FQDSGLSRF
FQNIRPLFI	FQNIRPLFI
SIDVGYERF	SIDVGYERF
RLFEDTFVNF	RLFEDFVNF
RLAEDAPNF	RLAEDAPNF
KQFYEPKPDLL	KQFYEKPDL
YLFKGNNRW	YLFKGNNRW
AQIRTIAII	AQIRTIAII
RLVEVNGENV	RLVEVGENV
LDKLSSLNKI	KLSS-LNKI
RMVSEAGTGF	RMVSEGTGF
RIKNNDPKL	RIKNNDPKL
SQGFPDTYRL	SQGFPTYRL
FLLDPVKGERL	LLDPVGERL
LLSHVEQLL	LLSHVEQLL
GQNPEKIFQNL	GQNPEFQNL
RQFKEIAAVI	RQFKEAAVI
KQMQSDPHKL	KQMQSPHKL
RQEDVIATANL	RQEDVIATA
RLDAVLQRI	RLDAVLQRI
RLDGHTISDL	RLDGHISDL
RLAEDVSDQL	RLAEDSDQL
RILATLEDGW	RILATEDGW
ALPNVYEVI	ALPNVYEVI
RLNRQLEEKI	RLNRQEEKI
RMIEVEQKL	RMIEVEQKL
RTIAETEAAYL	TIAETAAYL
KQIGVSVDTW	KQIGVVDTW
REVDLKNGHNL	EVDLKGHNL
ALSQVGDLAF	ALSQVDLAF
KLAQENMDLF	KLAQEMDLF
AQVFVHGESL	AQVFVGESL
RLSMNVGDQF	RLSMNGDQF
RLNQSQREEL	RLNQSREEL
ALHVGFDNF	ALHVGFDNF
AQVQKDARI	AQVQKDARI
KQVHPDTGI	KQVHPDTGI
TQQWEDYRF	TQQWEDYRF
KLFNDAIRL	KLFNDAIRL
LLHSSHISEEL	HSSHISEEL
ALQLGELKI	ALQLGELKI
GQMHGVVFW	GQMHGVVFW
SQSPALELDKF	SQSPALDKF
RLTHLIDHL	RLTHLIDHL
YVSSPDPQL	YVSSPDPQL
YIFEEPFTI	YIFEEPFTI
RQEGWIHHL	RQEGWIHHL
KLDDHVKKF	KLDDHVKKF
RILAAETDRL	ILAAETDRL
KLLNTVGDLL	KLLNTGDLL
IIISTPEKW	IIISTPEKW
WQKADINTKW	WQKADNTKW
KLFDQANKL	KLFDQANKL
HLINFSETL	HLINFSETL
HLGSVILIF	HLGSVILIF
LQAPSVKDFL	LQAPSKDFL
YAPKGSSL	YAPK-GSSL
GLYPAPLKI	GLYPAPLKI
RQHAYEHSL	RQHAYEHSL
YLVKIFEEL	YLVKIFEEL
RIFGGLDML	RIFGGLDML
RLLAEEEQQL	RLLAEEQQL
RLQQLFKGSQF	QQLFKGSQF
EGEKHIYSPII	GEKHIYSPI
KQFAEENGLLF	KQFAEENGL
RVLEGHEEL	RVLEGHEEL
KQSDSLTRI	KQSDSLTRI
YQGNTALHL	YQGNTALHL
RLFGGDMEKF	RLFGGMEKF
HLVHLPEEL	HLVHLPEEL
ALFLDKMGSL	ALFLDMGSL
TQESTFQEL	TQESTFQEL
KIAEKEVRI	KIAEKEVRI
RQISQDVKL	RQISQDVKL
RLDRPVVGW	RLDRPVVGW
YQNQEIHNL	YQNQEIHNL
AMVAPDVQI	AMVAPDVQI
RLKEKEDAL	RLKEKEDAL
LSEDKTLLL	LSEDKTLLL
KLMELYERL	KLMELYERL
YLAADGKSTTW	AADGKSTTW
EIQRLEGQL	EIQRLEGQL
RQFMEIEPEML	RQFMEEPEM
KLTKDGNVL	KLTKDGNVL
KMHARDFTV	KMHARDFTV
RQAHMQARF	RQAHMQARF
VLYDRPLKI	VLYDRPLKI
LQSRIEDRL	LQSRIEDRL
RQFEIERDL	RQFEIERDL
AQNRFLLEL	AQNRFLLEL
KLLDLIEDL	KLLDLIEDL
RLAHEIEAL	RLAHEIEAL
RQIHKFEEL	RQIHKFEEL
ALILVDDRF	ALILVDDRF
RQHIQVFIDRF	HIQVFIDRF
KLYDDMIRL	KLYDDMIRL
AQALVLQVF	AQALVLQVF
RQVGPDGLM	RQVGPDGLM
AQSGHEVTL	AQSGHEVTL
ALTSAGDRF	ALTSAGDRF
RIATEFNQL	RIATEFNQL
RIGKFEARF	RIGKFEARF
HLINQNSDYL	HLINQSDYL
GQIVLVDDW	GQIVLVDDW
QVARPGGDTI	QVARPGDTI
RLAKSDPMV	RLAKSDPMV
FQGDIRLLM	FQGDIRLLM
RIVDVYENL	RIVDVYENL
KQFGNILIL	KQFGNILIL
FQHALEELM	FQHALEELM
RVVDLITNL	RVVDLITNL
AQALEELTGF	AQALELTGF
KMADIEYRL	KMADIEYRL
RQLQQELADTL	LQQELADTL
ALFRELISW	ALFRELISW
RLLPESWGF	RLLPESWGF
IQENTQTPTV	IQENTTPTV
IQAGIFQEF	IQAGIFQEF
RQQHEGAQGAL	QQHEGQGAL
RLLQETLYM	RLLQETLYM
GQDGSVVQF	GQDGSVVQF
YLVDDSFSQAL	LVDDSSQAL
ALTPLEPRL	ALTPLEPRL
RLALVISEL	RLALVISEL
LQLDKEFQLF	QLDKEFQLF
HLDTTQQMI	HLDTTQQMI
ALFNGISKW	ALFNGISKW
HQDPGQPLYI	HQDPGPLYI
ALALIYNEAL	ALALINEAL
SVQGGETRI	SVQGGETRI
RVQDLEQKM	RVQDLEQKM
RIIQDRVSL	RIIQDRVSL
RVANVADVV	RVANVADVV
AVAGEDARI	AVAGEDARI
KQYNVDYKL	KQYNVDYKL
LQWLESKEEVL	WLESKEEVL
KIDRLILEL	KIDRLILEL
RLLQDKEGL	RLLQDKEGL
ILDDTVQRF	ILDDTVQRF
RQNKLTYTM	RQNKLTYTM
KLMDLDVEQL	KLMDLVEQL
RTDGKVFQFL	RTDGKFQFL
RQDISVHKL	RQDISVHKL
AQAPSSFQLL	AQAPSFQLL
KLDDTSLEFL	KLDDTLEFL
RLSHSQERL	RLSHSQERL
RLTNAGYDYL	RLTNAYDYL
ALAAGEIGF	ALAAGEIGF
KLFKEVASL	KLFKEVASL
RLVRDKDTDKF	RLVRDTDKF
RTAPFHLDLW	RTAPFHLDL
KQLSGEEVSW	KQLSGEVSW
ALARLVLRL	ALARLVLRL
RLQDLKDRL	RLQDLKDRL
AILELDEHL	AILELDEHL
RQIGEGQVSL	RQIGEQVSL
KQAETIEKL	KQAETIEKL
GQLSEGAIAAI	QLSEGIAAI
KLDTAYDDL	KLDTAYDDL
HQQLEEAQI	HQQLEEAQI
GQIMDSETF	GQIMDSETF
RLSLPESTESF	SLPESTESF
RLLLAGYDDF	RLLLAYDDF
GQIQEAIALI	GQIQEAIAL
SQVEGEHQL	SQVEGEHQL
RQVGVTEML	RQVGVTEML
ALQKDALSI	ALQKDALSI
RQQLQTTRQEL	QQLQTRQEL
LLQFGPTEKF	LQFGPTEKF
RLASLKTDTF	RLASLTDTF
SQDRTAKLW	SQDRTAKLW
SQDPSGDSKL	SQDPSDSKL
RVSQTPESL	RVSQTPESL
QLAEVEEKI	QLAEVEEKI
REAPIHLDF	REAPIHLDF
LEARNKLLL	LEARNKLLL
YILANIGDHF	ILANIGDHF
RLIEAGEQLGF	RLIEAGEQL
RSMEDFVTW	RSMEDFVTW
SQAEIEQKI	SQAEIEQKI
LQSLNFERI	LQSLNFERI
AQMTPSPSEMF	AQMTPPSEM
RVMSEKDEYQF	VMSEKEYQF
SVTEIQEKW	SVTEIQEKW
HQVKDLLDLI	HQVKDLDLI
VLDSSLSELF	VLDSSSELF
KLEEHEESL	KLEEHEESL
YLSNADERL	YLSNADERL
HIVDEVNGLI	HIVDEVNGL
RQAEEQIEHL	RQAEEIEHL
KLEAGIRGI	KLEAGIRGI
KLKQFEERL	KLKQFEERL
RVTSVVTGF	RVTSVVTGF
FQDGTKATF	FQDGTKATF
RILEFDYEM	RILEFDYEM
AQSSKSVKEAW	AQSSKKEAW
RLMMDPLTGL	RLMMDLTGL
SQVKLQDFF	SQVKLQDFF
IQHVVEDSW	IQHVVEDSW
RLEEEMRKL	RLEEEMRKL
LLFEGEKKITI	LLFEGEKKI
TVTEKPEVID	TVTEKPEVI
RIQKELAEI	RIQKELAEI
VQQLEQWEF	VQQLEQWEF
SQYPFPVTL	SQYPFPVTL
KLEGPDVSL	KLEGPDVSL
ALSNLEVKL	ALSNLEVKL
AQQKEEAQL	AQQKEEAQL
RQEPVQPLL	RQEPVQPLL
TQDTQPHYI	TQDTQPHYI
RVINEPTAAAL	VINEPAAAL
RQLEEKDRVL	RQLEEDRVL
RLEQDEYAL	RLEQDEYAL
RLPEEVVDFL	RLPEEVDFL
RQIKEPVKF	RQIKEPVKF
RLPEEEHEFF	RLPEEEHEF
IVDIGRQDW	IVDIGRQDW
RQLQVLDLF	RQLQVLDLF
RISDAITHL	RISDAITHL
KLSAEKVEI	KLSAEKVEI
NQDHVHAVW	NQDHVHAVW
RSDIGEFEW	RSDIGEFEW
RINEDPKDALL	RINEDKDAL
RVHDVLFGDVW	RVHDVGDVW
QQTSEHALF	QQTSEHALF
IQDEEFYTL	IQDEEFYTL
FSAPTLEDHF	FSAPTEDHF
FQVKEVDVGL	FQVKEDVGL
RQHNWPLTM	RQHNWPLTM
RLLESFETM	RLLESFETM
RQLQDPLVI	RQLQDPLVI
RVLKEDKERW	RVLKEKERW
AMYPKYDRI	AMYPKYDRI
RLVSLIFNSF	RLVSLFNSF
VVEDGYEFF	VVEDGYEFF
LLNKAPEYL	LLNKAPEYL
LLFEGEKKI	LLFEGEKKI
RLLVFTSDDTF	LLVFTDDTF
LVQAERTVL	LVQAERTVL
RVVTEDQLL	RVVTEDQLL
QQHEIESRI	QQHEIESRI
RIPYKDTFW	RIPYKDTFW
KVPQLEIVPN	KVPQLEIVP
AQQNLALQL	AQQNLALQL
KLVAGEHGL	KLVAGEHGL
RQALPDSPERF	ALPDSPERF
TQIITKYLW	TQIITKYLW
RQLLDHMDSW	RQLLDMDSW
YGRPPDSHHSR	RPPDSHHSR
RQIDRENQRL	RQIDRNQRL
RQEAYLEAL	RQEAYLEAL
KMVTEKAGF	KMVTEKAGF
RLKQDYLRI	RLKQDYLRI
HLSGDSLFL	HLSGDSLFL
RLAEEVNDKL	RLAEENDKL
RQHSLPSSEHL	HSLPSSEHL
