Data	Data aligned
ILWSERPTKV	ILWSEPTKV
AAPKAGPGV	AAPKAGPGV
GVDDLDFFI	GVDDLDFFI
LLLSAEPVPA	LLLSAPVPA
RMYPFQIHSI	RMYPFIHSI
YLFDLPLKV	YLFDLPLKV
FLANIGTSV	FLANIGTSV
RLMEPIYLVEI	RLMEPIYLV
RLVEIQYEL	RLVEIQYEL
YLMQESPPHV	LMQESPPHV
LLWDKIHKL	LLWDKIHKL
SLFGDVKKL	SLFGDVKKL
FLYPFLHTV	FLYPFLHTV
NIIELVHQV	NIIELVHQV
FNEKSKEL	FN-EKSKEL
KMYEEFLSKV	KMYEELSKV
LLPHPGLQV	LLPHPGLQV
SVYHKPPSA	SVYHKPPSA
SLAELDEKISA	SLAELDEKI
HVLDVIHEV	HVLDVIHEV
TLLAAEFLKQV	LAAEFLKQV
AMFGKLMTI	AMFGKLMTI
AQLDPEALGNI	QLDPELGNI
YLDKTFYNL	YLDKTFYNL
LLSPVVPQI	LLSPVVPQI
EVFEVVERV	EVFEVVERV
KMNEKLYTV	KMNEKLYTV
VLDNPTPEM	VLDNPTPEM
LLLDVPTAAV	LLLDVTAAV
LLAETHYQL	LLAETHYQL
MQWQNVEHV	MQWQNVEHV
SLQEKLWAI	SLQEKLWAI
FLDDVVHSL	FLDDVVHSL
AMNARPHKV	AMNARPHKV
IAVVQPEKQ	IAVVQPEKQ
YLFTSPQRV	YLFTSPQRV
AVFKELVKL	AVFKELVKL
FTWEGLYNV	FTWEGLYNV
YENEVALRQ	YENEVALRQ
YLGNINPQM	YLGNINPQM
SLWEISKQIEG	SLWEISKQI
TVMGKIFAV	TVMGKIFAV
KTGRVYNV	KT-GRVYNV
YLYDRIRKA	YLYDRIRKA
TLYRLANQL	TLYRLANQL
KLLEGTIVNV	KLLEGIVNV
KAFSIGSNLNV	KAFSIGSNL
WLAEKLPTL	WLAEKLPTL
ALWKNEGFFL	ALWKNGFFL
YTFPLAEKV	YTFPLAEKV
KIWDVSVNSVV	KIWDVVNSV
VMGDIPAAV	VMGDIPAAV
FLHDLKETNI	FLHDLETNI
IQDEIRSVI	IQDEIRSVI
VLFGEITRL	VLFGEITRL
SLVENIERLKV	SLVENIERL
LMQTEVHHV	LMQTEVHHV
SPPAILVTV	SPPAILVTV
QLLDPASFEYL	LLDPAFEYL
LHLKLLDYL	LHLKLLDYL
YLSDNVHLV	YLSDNVHLV
FLLPSEVPAL	LLPSEVPAL
KIWDPVHRV	KIWDPVHRV
ALTELLAKI	ALTELLAKI
KVLDVLWEL	KVLDVLWEL
ALQEKVQAV	ALQEKVQAV
YAFNMKATV	YAFNMKATV
SLVEIRNFL	SLVEIRNFL
SLLRVGWSV	SLLRVGWSV
ATFIVKDLL	ATFIVKDLL
STWRIMTTL	STWRIMTTL
FQAGSGIYHV	FQAGSIYHV
ILSEIKEAV	ILSEIKEAV
AMLTVLHEI	AMLTVLHEI
SVAEGRALMSV	SVAEGRALM
KLLEPVPVSV	KLLEPPVSV
FLLDKKIGV	FLLDKKIGV
ALYPGQLVQL	ALYPGLVQL
KTALIHDGL	KTALIHDGL
IMLEALERV	IMLEALERV
FLLFINHRL	FLLFINHRL
TLPPPPSGL	TLPPPPSGL
LGPPPPLRV	LGPPPPLRV
ILDEPTNHL	ILDEPTNHL
AVPPPLAKA	AVPPPLAKA
FLADPSAFVAA	FLADPSAFV
KLLDVVHPA	KLLDVVHPA
RLGPVPPGL	RLGPVPPGL
SLWHNITVV	SLWHNITVV
TLGVIPESV	TLGVIPESV
FLDPNNIPKA	FLDPNIPKA
YMHFLENQV	YMHFLENQV
KLFSILSTV	KLFSILSTV
ATMPVVPSV	ATMPVVPSV
SLLDPVPEV	SLLDPVPEV
QLLEKVPTL	QLLEKVPTL
ILLNIEHRI	ILLNIEHRI
SLWEISKQI	SLWEISKQI
KLWVPDEEV	KLWVPDEEV
TTYKLVINGKT	TTYKLVING
FLWERPTLL	FLWERPTLL
MLWDLNEGKHL	MLWDLNEGK
ALMSRPAQV	ALMSRPAQV
KLMSDLQKL	KLMSDLQKL
AMFDHIPVGV	AMFDHPVGV
SVPEAQSAL	SVPEAQSAL
SIYPSPTGV	SIYPSPTGV
VLFDVTGQV	VLFDVTGQV
ALSDIFQAV	ALSDIFQAV
ISEGSVKFDI	SEGSVKFDI
STWEPEENI	STWEPEENI
LLWQVIKIGL	LLWQVKIGL
FLYSGGHRV	FLYSGGHRV
LISQIVSSI	LISQIVSSI
YIAKITEGV	YIAKITEGV
ILSDPSVFSPL	ILSDPVFSP
GLFHLGEFV	GLFHLGEFV
VLISKLPYI	VLISKLPYI
AMFPDTIPRV	AMFPDIPRV
KLQDLTDVQI	KLQDLDVQI
LTDITKGV	LT-DITKGV
YLAKHIENI	YLAKHIENI
VAPPRGPLP	VAPPRGPLP
RVLPPSALQSV	VLPPSLQSV
KLLEIMTRI	KLLEIMTRI
KFLLTSVFPQL	LLTSVFPQL
SLFNKLVEL	SLFNKLVEL
YLHNQGIGV	YLHNQGIGV
NLFDRVVTL	NLFDRVVTL
RLYEFWWSL	RLYEFWWSL
KLDSPRVTV	KLDSPRVTV
FLPEAPAEL	FLPEAPAEL
GIWSITAKV	GIWSITAKV
RTMEWVQTI	RTMEWVQTI
NIWRDVGLFGV	IWRDVLFGV
YLAHLAHHL	YLAHLAHHL
TLWVDPYEV	TLWVDPYEV
RVMELFFTV	RVMELFFTV
AQYEDIAQKS	AQYEDIAQK
SLIHGLWNL	SLIHGLWNL
KLFSLQDLL	KLFSLQDLL
LLWELVTREV	LLWELTREV
SLWKGLVGI	SLWKGLVGI
KLMGIVNKV	KLMGIVNKV
LLIGHLERV	LLIGHLERV
FLYAGHIFL	FLYAGHIFL
MVAEILHHL	MVAEILHHL
TLNEKLTAL	TLNEKLTAL
YQLEIPENFTT	YQLEIPENF
LLDRFLATV	LLDRFLATV
KLQDAEIARL	KLQDAIARL
VVMNVVHQL	VVMNVVHQL
LLQELTDIDTL	LLQELIDTL
KILDIGLAYI	KILDILAYI
SVFEGLERL	SVFEGLERL
FLIPIYHQV	FLIPIYHQV
KVWKLAEVL	KVWKLAEVL
TLMDAELFKKV	MDAELFKKV
TTLDVTKLTPL	TLDVTLTPL
YVADLGAMVV	YVADLGAMV
RLWDLTTGTTT	RLWDLTTGT
KLFDTQQFL	KLFDTQQFL
PKIVKWDRDM	KI------V
FVWEASHYL	FVWEASHYL
YLRSMIPHL	YLRSMIPHL
RTLPVDFHI	RTLPVDFHI
KLLEKAFSI	KLLEKAFSI
SLFKLIVKV	SLFKLIVKV
VLMEMSYRL	VLMEMSYRL
KLLDISELDM	KLLDISELD
MAPERVASL	MAPERVASL
SVLLITQHL	SVLLITQHL
AIAPIIAAV	AIAPIIAAV
WLIEDGKVVTV	LIEDGVVTV
VLWDLVDRIGI	VLWDLVDRI
SLLSHVEQL	SLLSHVEQL
TLSKIVPHI	TLSKIVPHI
AQLPRIFHV	AQLPRIFHV
ILDEVIFKL	ILDEVIFKL
VIYDVSHNI	VIYDVSHNI
ALQEKLWNV	ALQEKLWNV
YIFPLDDKAAV	YIFPLDDKA
NLFDLGGQYL	NLFDLGQYL
QLISKIPHI	QLISKIPHI
GLWHGMFANV	GLWHGFANV
FAPYNKPSL	FAPYNKPSL
FLWKEPATM	FLWKEPATM
VLLGHIFYV	VLLGHIFYV
AQIEVVPSA	AQIEVVPSA
FMSQVHSV	FM-SQVHSV
SLVEVNPAYSV	SLVEVNPAY
TLFNVIKSV	TLFNVIKSV
YMIAHITGL	YMIAHITGL
HLANIVERV	HLANIVERV
YVLDLAAKV	YVLDLAAKV
KMDDPTVNWSI	KMDDPTVNW
QMLEIHSQV	QMLEIHSQV
FTYATTEKV	FTYATTEKV
KQIDSVNHI	KQIDSVNHI
WAPERPLVGV	WAPERLVGV
KEHLTEQI	KE-HLTEQI
MTSEIHNTV	MTSEIHNTV
KLAKLQAQV	KLAKLQAQV
VLMNQPPQIAP	VLMNQPPQI
RLWDVHTSA	RLWDVHTSA
RLAELQEQL	RLAELQEQL
YLARIQGFQV	YLARIGFQV
FLWVPRKL	FL-WVPRKL
SLIGHLQTL	SLIGHLQTL
ILWAPDEESGV	ILWAPDEES
ALWDPGPEAA	ALWDPPEAA
ALDSQVPKV	ALDSQVPKV
SLLYNVPAV	SLLYNVPAV
RQLEKLKEV	RQLEKLKEV
NLLQIQRNV	NLLQIQRNV
RLSEFIPAVF	RLSEFIPAV
FLQPELVKL	FLQPELVKL
YLYPDITRL	YLYPDITRL
RIAELLTEL	RIAELLTEL
LLAEPVPGI	LLAEPVPGI
FLFQEPRSI	FLFQEPRSI
SLLNPPETLNL	SLLNPPETL
KIAWISETL	KIAWISETL
KLYTGLREV	KLYTGLREV
SLPAIVSIA	SLPAIVSIA
NTWEPEENI	NTWEPEENI
TVAQIKATV	TVAQIKATV
KMIEDGKIHTV	KMIEDIHTV
SAAEPTPAV	SAAEPTPAV
ALLKIEGVYA	ALLKIGVYA
ALPPVLTTV	ALPPVLTTV
YLDVVQSNV	YLDVVQSNV
KMAEIKVKL	KMAEIKVKL
KLYSISSQV	KLYSISSQV
GLDDIKDLKV	GLDDIDLKV
VLIGEGVLTKL	LIGEGLTKL
LMDSNLPRL	LMDSNLPRL
GLIDTKELEPL	LIDTKLEPL
ILPSYIPVRV	ILPSYPVRV
LLDSAPLNV	LLDSAPLNV
YLLDLHSYL	YLLDLHSYL
KLWDVREGM	KLWDVREGM
ALLELLHEL	ALLELLHEL
KLNPQQFEV	KLNPQQFEV
KMDASLGNLFA	KMDASLGNL
YMAPEVVEA	YMAPEVVEA
FLQPHLDAV	FLQPHLDAV
KLIELKAEI	KLIELKAEI
STLKNVPQV	STLKNVPQV
KLTEMRGIYA	KLTEMGIYA
ILNEIVNFV	ILNEIVNFV
ALYDNVEKL	ALYDNVEKL
KLYRPGSVAYV	KLYRPVAYV
LMAEMGVHSV	LMAEMVHSV
KLLPDTILEKL	LLPDTLEKL
FMLPDPQNI	FMLPDPQNI
SLLDPFAAV	SLLDPFAAV
TDTYKLILNGK	KL--ILNGK
YLGQIQHI	YL-GQIQHI
QIAELKMQL	QIAELKMQL
IQVSPEIFQFL	VSPEIFQFL
ISERYGPVFTI	ERYGPVFTI
ILDKKVEKV	ILDKKVEKV
GLVDEKALAQA	LVDEKLAQA
AVIEAEKIAQV	IEAEKIAQV
FLDTLKVLV	FLDTLKVLV
SVITQVFHV	SVITQVFHV
TLTSKLYSL	TLTSKLYSL
FIQEIEHAL	FIQEIEHAL
KLLDSMHEV	KLLDSMHEV
ALMAHAMEEV	LMAHAMEEV
QMMWLMDHI	QMMWLMDHI
LLSHVIVAL	LLSHVIVAL
YTFNVDQKL	YTFNVDQKL
YLLDPKIADLV	LLDPKIADL
KSYELPDGQVI	KSYELDGQV
RMGPPLHTV	RMGPPLHTV
KLFGHLTSA	KLFGHLTSA
KTLELPHVFV	KTLELHVFV
KVAELKQEL	KVAELKQEL
SAPKGSVL	SA-PKGSVL
SMFEFSEKL	SMFEFSEKL
ALLGILQHV	ALLGILQHV
YLAGLHANI	YLAGLHANI
KLVEIPTKMRV	KLVEIPTKM
KLLPQLTYL	KLLPQLTYL
KLAEIRHEV	KLAEIRHEV
SLAQYLINV	SLAQYLINV
RPPGFSPFR	RPPGFSPFR
FLADNHHQV	FLADNHHQV
SLIDMRGIETV	SLIDMIETV
RLWDLTTGT	RLWDLTTGT
LANSDPKLAL	LANSDKLAL
SLADDSVLERL	LADDSLERL
ALGKILSV	AL-GKILSV
ALMPWRYAL	ALMPWRYAL
AVWAKGIRNV	AVWAKIRNV
NIPEPVVIGI	NIPEPVIGI
VTIKKDVDG	VTIKKDVDG
YTPPPPPTA	YTPPPPPTA
SIIGRLLEV	SIIGRLLEV
KTAAEDAIRNL	AAEDAIRNL
RMWEDPMGA	RMWEDPMGA
KIYEHHIKV	KIYEHHIKV
DAVEDLESVGK	AV-EDLESV
FLFDGSPTYVL	FLFDGPTYV
KMADIGGHAI	KMADIGHAI
KMMDPRVLHHM	KMMDPRVLH
RVMELFFTVH	RVMELFFTV
AVMDWKDVL	AVMDWKDVL
ELMEQVPHI	ELMEQVPHI
VLFPWQARL	VLFPWQARL
TLADLVHHV	TLADLVHHV
VLHDRIVSV	VLHDRIVSV
TVAQIKAHV	TVAQIKAHV
RLPPEGILHNV	RLPPELHNV
AQYENPPHIY	AQYENPPHI
YVSEILEKV	YVSEILEKV
IAPPVPLKA	IAPPVPLKA
LLSAEPVPA	LLSAEPVPA
RLSDVQIYV	RLSDVQIYV
TVWIPEVGV	TVWIPEVGV
LRLLKTLET	LRLLKTLET
AGFAGDDAPR	AGFAGDDAP
RLQEVTHSV	RLQEVTHSV
QMISRIEYV	QMISRIEYV
KLWDINAHI	KLWDINAHI
FLNNQIKEL	FLNNQIKEL
SLFERLVKV	SLFERLVKV
FQWDIMERI	FQWDIMERI
LLTEIRAVV	LLTEIRAVV
TLTNIIHNL	TLTNIIHNL
SMSADVPLV	SMSADVPLV
LLREKVEFL	LLREKVEFL
YLFNSVVNV	YLFNSVVNV
YENEVALR	YE-NEVALR
RMFDGKFVVA	RMFDGKFVV
IMDRIYKNV	IMDRIYKNV
TLWDIQKDL	TLWDIQKDL
KLGEIVTTI	KLGEIVTTI
RMLPHAPGV	RMLPHAPGV
FQLPAPPHI	FQLPAPPHI
KIYEGQVEV	KIYEGQVEV
FLLKLIHIL	FLLKLIHIL
ALEEQLQQIR	ALEEQLQQI
LEEALQQAKED	LE-EALQQA
IIQDIDDTHVF	IIQDIDTHV
VTAEVKHNI	VTAEVKHNI
FLFEPVVKA	FLFEPVVKA
VLDPKPPPLTL	VLDPKPPPL
ASENRTDISL	SENRTDISL
ILFYVEHQA	ILFYVEHQA
VMWSPTHPA	VMWSPTHPA
YAPGARLAL	YAPGARLAL
YLMEGSYNKV	YLMEGYNKV
KVWAPVQGL	KVWAPVQGL
NLAEVVERV	NLAEVVERV
KLFEGLKFFL	KLFEGKFFL
KLLSHSLLVTL	KLLSHSLLV
KLWKGARSV	KLWKGARSV
FLQPGGYHV	FLQPGGYHV
AQVSKVEAL	AQVSKVEAL
YLYDLNHTL	YLYDLNHTL
KISVIVETV	KISVIVETV
LMYPYIFHVL	LMYPYIFHV
FLGAVKNV	FL-GAVKNV
ILYRVGDGV	ILYRVGDGV
AMASLGALALL	AMASLALAL
FAFLISERL	FAFLISERL
KMFFLIEKI	KMFFLIEKI
RLLEVQSQV	RLLEVQSQV
KLIDKLDSL	KLIDKLDSL
KIWDVSVNSV	KIWDVVNSV
NMVDIIHSV	NMVDIIHSV
VAWEVANKV	VAWEVANKV
FQDEINWRL	FQDEINWRL
FILEKIEYL	FILEKIEYL
RVWDISTVSSV	RVWDIVSSV
ALFQHITAL	ALFQHITAL
LLSEPSLLRTV	SEPSLLRTV
QAPGVITGV	QAPGVITGV
GLAKAVASV	GLAKAVASV
KLMELYERL	KLMELYERL
VVAEFVPLI	VVAEFVPLI
ALASLENHV	ALASLENHV
YLFALQSHL	YLFALQSHL
RMLHFLTAV	RMLHFLTAV
KLFVFDERYAL	FVFDERYAL
VLFTITKTV	VLFTITKTV
YLQEHAQEV	YLQEHAQEV
AIGKVYHA	AI-GKVYHA
YGPPVRTEY	YGPPVRTEY
RLWGIPDQARV	RLWGIPDQA
RLAQEGIYTL	RLAQEIYTL
RVQILKDYV	RVQILKDYV
YLNEIKDSV	YLNEIKDSV
KLMEEIREL	KLMEEIREL
KLFDTQHRV	KLFDTQHRV
YLLTHPPPIM	YLLTHPPPI
YLHEFRDKL	YLHEFRDKL
KLIGQVHEV	KLIGQVHEV
NIPEKTTAL	NIPEKTTAL
FLLPKVQSI	FLLPKVQSI
VLSELLWQV	VLSELLWQV
VLIPKLPQL	VLIPKLPQL
SMMDPNHFLMI	SMMDPNHFL
QLGPVPVTI	QLGPVPVTI
RLYPWGVVEV	RLYPWVVEV
LLPDQPPYHL	LLPDQPYHL
TLTNVIHNL	TLTNVIHNL
LMAITRHGV	LMAITRHGV
YLNQHIEHV	YLNQHIEHV
LLGPPPVGV	LLGPPPVGV
YMAELIERL	YMAELIERL
VLQNLKGQYV	VLQNLGQYV
YLFILKNQV	YLFILKNQV
KLLDFGSLSNL	KLLDFLSNL
YLSPKLWAL	YLSPKLWAL
TLWGIQKEL	TLWGIQKEL
VVLPAPPAV	VVLPAPPAV
KILDVASLEVL	KILDVSLEV
FMAPKAWTV	FMAPKAWTV
RIFILGPSHHV	FILGPSHHV
LLADLKTMV	LLADLKTMV
KLMALGPIRL	KLMALPIRL
KMAEMLVEL	KMAEMLVEL
KLPPPPPQA	KLPPPPPQA
QMMQNPQILAA	QMMQNPQIL
HLVSPEALDFL	VSPEALDFL
KVARLDNIFL	KVARLNIFL
RLQEDPPVGV	RLQEDPVGV
GLMTTVHAI	GLMTTVHAI
HVYDGKFLARV	HVYDGKFLA
KIADFGWSV	KIADFGWSV
KLMDLRNEYL	KLMDLNEYL
VQWKVVETL	VQWKVVETL
ALDRIVEYL	ALDRIVEYL
YLFTIINSL	YLFTIINSL
LLLDVPTAA	LLLDVPTAA
NMDELRHQV	NMDELRHQV
FVFPLDKDELL	FVFPLKDEL
YIYDKDMEII	YIYDKDMEI
TLDGSLHAV	TLDGSLHAV
ILYGKIIHL	ILYGKIIHL
FLASESLIKQI	LASESIKQI
ALLDVTPKAV	ALLDVPKAV
SIMQVVNYV	SIMQVVNYV
FLYQILRGL	FLYQILRGL
ALMQIQQGL	ALMQIQQGL
TLYDIAHTPGV	TLYDIAHTP
YLTNEGIQYL	LTNEGIQYL
ILLDDTGLAYI	LLDDTLAYI
VAPPPPTHL	VAPPPPTHL
FLWERPTLLV	FLWERPTLL
SLAPLFFKL	SLAPLFFKL
YLGPHIASV	YLGPHIASV
KVGSFKFIYV	KVGSFFIYV
KLWDIINVNI	KLWDINVNI
RLAALEQNV	RLAALEQNV
MLIEEGGLQHL	LIEEGLQHL
KVLDLRINL	KVLDLRINL
QVMQIIEHL	QVMQIIEHL
KAPEVPTEGV	KAPEVTEGV
KMAIITTHL	KMAIITTHL
RMAVLNEQV	RMAVLNEQV
LLGEIPDRL	LLGEIPDRL
FLAGAVTSV	FLAGAVTSV
ILDDIGHGV	ILDDIGHGV
YLLDRLPEM	YLLDRLPEM
QQWDTSKGEQV	QQWDTGEQV
VLDDKLVFV	VLDDKLVFV
SLMHVPPSL	SLMHVPPSL
KVSVIQDFV	KVSVIQDFV
KLWIIMEYL	KLWIIMEYL
ALWDKLFNL	ALWDKLFNL
FIFEKKLAQA	FIFEKLAQA
RQADTKAIQHL	QADTKIQHL
KMDEVLYSI	KMDEVLYSI
HLAEVSAEV	HLAEVSAEV
KLHDINAQL	KLHDINAQL
VLWDRTFSLF	VLWDRTFSL
VLMPMERQMSV	VLMPMERQM
LISLKDWL	LI-SLKDWL
QLNEQVHSL	QLNEQVHSL
GLWEIENNPTV	GLWEIENNP
FLDTIKSNL	FLDTIKSNL
APALTGLGPVT	ALTGLGPVT
QLLEKVIEL	QLLEKVIEL
RLLESFETM	RLLESFETM
KAAQIKEHL	KAAQIKEHL
YMLEHVITL	YMLEHVITL
RLDIVHENL	RLDIVHENL
SVAALSKIFAV	AALSKIFAV
IAPTGHSL	IA-PTGHSL
KVLERVNAV	KVLERVNAV
STGKVFSV	ST-GKVFSV
KLFDIFSQQV	KLFDISQQV
RAPPVRPQNSL	RAPPVQNSL
FVLDKVPFL	FVLDKVPFL
SVPLAATSM	SVPLAATSM
KSFATKANV	KSFATKANV
LMAPAPSTV	LMAPAPSTV
YLNENPLRAL	YLNENLRAL
ALYTVIETV	ALYTVIETV
QQINKLEEL	QQINKLEEL
VLMDRLPSL	VLMDRLPSL
FLAELPGSLSL	FLAELPGSL
VLWDLVDRI	VLWDLVDRI
MLVEITERA	MLVEITERA
SLYALHVKA	SLYALHVKA
SVTSHIYQV	SVTSHIYQV
YLEELPEKLKL	YLEELPEKL
KTYGVSFFL	KTYGVSFFL
YQFNPAFFQTT	YQFNPAFFQ
VLMPWIHEL	VLMPWIHEL
AMPPPPPQGV	AMPPPPQGV
AKNKLNDLED	KL----NDL
KIMKLAANI	KIMKLAANI
YLFERIKEL	YLFERIKEL
ATPLPAGIS	ATPLPAGIS
KTLGKLWRL	KTLGKLWRL
HTDDPLTWDYV	TDDPLWDYV
RVLEVVNHV	RVLEVVNHV
AVYKVSEYA	AVYKVSEYA
ALWAGLLTL	ALWAGLLTL
FLFDGSPTYV	FLFDGPTYV
FLNSVTDIHQL	FLNSVIHQL
YLFIVKNEL	YLFIVKNEL
FLDHVMYTI	FLDHVMYTI
FVLPELPSV	FVLPELPSV
IMLSEKHLISV	MLSEKLISV
MAVIKEKI	MA-VIKEKI
LLPPAPPHA	LLPPAPPHA
VSGAKGSKINI	VSGAKGSKI
RVAQLEQVYI	RVAQLQVYI
LLDTIRDEI	LLDTIRDEI
KLDDIVQHI	KLDDIVQHI
KLYEQHHVV	KLYEQHHVV
RLLENMTEV	RLLENMTEV
YQVGQLYSV	YQVGQLYSV
KMMDLEHKV	KMMDLEHKV
HVFDHPWETV	HVFDHWETV
TLYNPERTITV	TLYNPERTI
NLWSLVAKV	NLWSLVAKV
VIMWQKHYV	VIMWQKHYV
KVDTVWVNV	KVDTVWVNV
AMWEHPITA	AMWEHPITA
KLIDFGSGALL	KLIDFGSGA
AMYFIQQKV	AMYFIQQKV
SVLKVSHSV	SVLKVSHSV
KMWDLSSNQAI	KMWDLSNQA
RTWIEGLTGL	RTWIELTGL
FLVNPESGYNV	LVNPEGYNV
SLFPGKLEVV	SLFPGKLEV
KTFQMAEYL	KTFQMAEYL
RLYGLGTGV	RLYGLGTGV
ALAPAPPQV	ALAPAPPQV
TLYEAVREV	TLYEAVREV
SLYHVESTV	SLYHVESTV
SLDQPTQTV	SLDQPTQTV
SLDTQPKKV	SLDTQPKKV
VLFTGVKEV	VLFTGVKEV
IMAQLPQEQKA	AQLPQEQKA
KMADIEYRL	KMADIEYRL
ELYERPPHL	ELYERPPHL
LLQDHPWLL	LLQDHPWLL
SLMEKISKL	SLMEKISKL
IIFPLNKSWII	IIFPLNKSW
RLNEAAVTV	RLNEAAVTV
FLSEKLERI	FLSEKLERI
VTDIEEIIGV	TDIEEIIGV
SLQDPPGELAV	SLQDPPGEL
FLADPSAFV	FLADPSAFV
ALWEGPSKA	ALWEGPSKA
KLLDLSDSTSV	KLLDLSDST
ALFPAPLAQI	ALFPALAQI
ILMHHPPQV	ILMHHPPQV
SLFEKGLKNV	SLFEKLKNV
KVFLHEATV	KVFLHEATV
ALWHVPEHAV	ALWHVPEHA
MVQDPSQFDVL	VQDPSQFDV
YVYEMRDKL	YVYEMRDKL
MALDIDERHLL	ALDIDERHL
KVHFITDTL	KVHFITDTL
ALDFLKHHL	ALDFLKHHL
KLLGNIKNV	KLLGNIKNV
KIMDATNILV	KIMDATNIL
FMSSHIKSV	FMSSHIKSV
AVPPAPTATV	AVPPATATV
YLFDVQRNNI	YLFDVRNNI
LLANKVPAA	LLANKVPAA
YLADLYHFV	YLADLYHFV
KMMDVTVTI	KMMDVTVTI
SAPYGRITL	SAPYGRITL
VMLESPPKGV	VMLESPKGV
SLMDPNKFLLL	SLMDPNKFL
YLNDLHEVLL	YLNDLHEVL
YLFDVQRNNIA	YLFDVRNNI
ILAPAGSLPKI	ILAPALPKI
KLLDMVGKVQI	KLLDMVGKV
VLKEIVERV	VLKEIVERV
SIHVGQAGV	SIHVGQAGV
KMFQVHQVL	KMFQVHQVL
AIAYILQGV	AIAYILQGV
TLQDIVYKL	TLQDIVYKL
YVWDIKSIMSM	YVWDIKSIM
RVDKITEYL	RVDKITEYL
LLHSFVDSV	LLHSFVDSV
RLWQVQSRL	RLWQVQSRL
KLQEQIHRV	KLQEQIHRV
ALLDRIVSV	ALLDRIVSV
ALDEPTTNL	ALDEPTTNL
RLMNETTAV	RLMNETTAV
GMAFLDKRLQV	FL-DKRLQV
KLDLIHESI	KLDLIHESI
QMAEIAVNA	QMAEIAVNA
HLAHYVPKI	HLAHYVPKI
KIWTPTAKA	KIWTPTAKA
SLLDLHTKV	SLLDLHTKV
LLIENVASL	LLIENVASL
LLANTSWTGTV	LLANTSWTG
YAPKGSSL	YA-PKGSSL
QLDIIIHSL	QLDIIIHSL
VMAPRTLVL	VMAPRTLVL
FIWENIHTL	FIWENIHTL
MLFLGLHNV	MLFLGLHNV
ALMEIKQLL	ALMEIKQLL
KLLERVSAI	KLLERVSAI
QLWNKPLVGV	QLWNKLVGV
RVLDNIKAV	RVLDNIKAV
FLLHIQQQV	FLLHIQQQV
KAPSAARSL	KAPSAARSL
QVLELQHTL	QVLELQHTL
SLAPIIVHV	SLAPIIVHV
HIIENIVAV	HIIENIVAV
KVPEIEVTV	KVPEIEVTV
KVLEILHRV	KVLEILHRV
KLLEVYEQL	KLLEVYEQL
KVFDPVPVGV	KVFDPPVGV
ALYPNVVQV	ALYPNVVQV
YAHELPKYGV	YAHELKYGV
KQVEEIFNL	KQVEEIFNL
TLASALQV	TL-ASALQV
SLFNIKDTQQL	SLFNITQQL
VLLKIVEQI	VLLKIVEQI
SVTQIYHAV	SVTQIYHAV
YMNHIMVSV	YMNHIMVSV
NIFEPHVAV	NIFEPHVAV
FLEEEVYPL	FLEEEVYPL
SVHKGFAFV	SVHKGFAFV
RMVHILTSV	RMVHILTSV
LLFILKQLV	LLFILKQLV
YMDAPKAAL	YMDAPKAAL
SLIDKLYNI	SLIDKLYNI
YVYEFRDKL	YVYEFRDKL
MVDKYIPNI	MVDKYIPNI
FLSELTQQL	FLSELTQQL
KLADDVDLEQV	LADDVLEQV
VLFNKLTYL	VLFNKLTYL
ALMADMVYV	ALMADMVYV
KIYQWINEL	KIYQWINEL
RLWEYLLEL	RLWEYLLEL
SVWFGPKEV	SVWFGPKEV
GIMKKAYEL	GIMKKAYEL
SIPEKNRPL	SIPEKNRPL
QVYQLDTGHYL	YQLDTGHYL
YLDTINRSV	YLDTINRSV
KVMNWKETL	KVMNWKETL
VIWGKVTRA	VIWGKVTRA
KLAESVEKA	KLAESVEKA
RTGEVKWSV	RTGEVKWSV
KMWENRQNL	KMWENRQNL
NAPLVHATL	NAPLVHATL
RLLEIPAVSHV	RLLEIVSHV
VMQDPEFLQSV	QDPEFLQSV
VLWEVSHKGV	VLWEVHKGV
ALDKITASL	ALDKITASL
KTANITFSL	KTANITFSL
KLNDIKEKV	KLNDIKEKV
KLFDAPLSI	KLFDAPLSI
ILTDITKGV	ILTDITKGV
YQYPVIIHL	YQYPVIIHL
QMLEAIKALEV	QMLEAIKAL
RTTEILHHL	RTTEILHHL
LLAILPEAARA	LLAILPEAA
KLYEGKTKEV	KLYEGTKEV
ILNEFPGHGL	ILNEFGHGL
KMDLLVEKV	KMDLLVEKV
FVARMIPKV	FVARMIPKV
NLNSIVPSV	NLNSIVPSV
YTFDPVTKV	YTFDPVTKV
AQYEDIAQK	AQYEDIAQK
FLNDPRRLNV	FLNDPRLNV
FGPPIPKGV	FGPPIPKGV
VLQGKLAEV	VLQGKLAEV
VLYELLQHI	VLYELLQHI
SMYYNGIGV	SMYYNGIGV
VIYTLIHYI	VIYTLIHYI
YMSDSFINV	YMSDSFINV
RLFKIDKEYLL	RLFKIKEYL
ALITRIFGV	ALITRIFGV
LMGPVVHEV	LMGPVVHEV
IIWDVSKGQKI	IIWDVGQKI
YLHSQVVSV	YLHSQVVSV
YMDVVKERI	YMDVVKERI
RLQQLQHRV	RLQQLQHRV
SLWGQPAEA	SLWGQPAEA
NLLKLIAEV	NLLKLIAEV
AMAKIQAKI	AMAKIQAKI
LLDPNVKSI	LLDPNVKSI
KVIPVYVGV	KVIPVYVGV
KVAEITELI	KVAEITELI
FIWPMLIHI	FIWPMLIHI
KVASLLHQV	KVASLLHQV
HLSDAIVEV	HLSDAIVEV
LLQDKQFEL	LLQDKQFEL
ILLEMIHSI	ILLEMIHSI
KLHAVVETL	KLHAVVETL
FLLPIKTVGV	FLLPITVGV
RQLAKIHAI	RQLAKIHAI
ISPSRTEAL	ISPSRTEAL
MVFKPSDVMLV	FKPSDVMLV
KVFKLQTSL	KVFKLQTSL
GLYELVWRV	GLYELVWRV
SMMPPPVGMVA	SMMPPPVGM
KAFNISTTL	KAFNISTTL
AAALIIHHV	AAALIIHHV
FLAKLIAQA	FLAKLIAQA
VLWFKPVEL	VLWFKPVEL
YLLPAIVHI	YLLPAIVHI
VLLGKVYVV	VLLGKVYVV
YVFPGVTRL	YVFPGVTRL
ALAEMLKENKV	ALAEMLKEN
GMYVFLHAV	GMYVFLHAV
RVWQVTIGT	RVWQVTIGT
NLQDLARIYI	NLQDLRIYI
TVIRDPPSI	TVIRDPPSI
FLYPFPLAL	FLYPFPLAL
RLLEEGVLRQI	RLLEELRQI
ALKELMEIEEV	ALKELIEEV
SLFKIWLV	SL-FKIWLV
SIAEMGAYV	SIAEMGAYV
KSWRVRYMV	KSWRVRYMV
KLWPLFVKL	KLWPLFVKL
KTLDVDATYEI	KTLDVDATY
FLYKEKLVSV	FLYKELVSV
ALLGKLDAINV	ALLGKLDAI
ALAEPAWLHI	ALAEPWLHI
RLAEQIATL	RLAEQIATL
KLIQLPVVYV	KLIQLVVYV
ILSGVIRSV	ILSGVIRSV
NIMDIKIGL	NIMDIKIGL
KMDWIFHTI	KMDWIFHTI
KLQELEARV	KLQELEARV
ILPPTRPTDKP	ILPPTRPTD
ITDDLHFYV	ITDDLHFYV
ALNEKLVNL	ALNEKLVNL
SLFYLHNEL	SLFYLHNEL
QMISRIEYI	QMISRIEYI
RTFLVGERV	RTFLVGERV
IVRDIKEKL	IVRDIKEKL
LIMELINNV	LIMELINNV
HLWDPENSVL	HLWDPENSV
VLYSIAEKV	VLYSIAEKV
KIPTPIVGV	KIPTPIVGV
SLYEMVSRV	SLYEMVSRV
KLYNPENIYL	KLYNPNIYL
SVPDPSTRALL	SVPDPSTRA
YLWSRVEKL	YLWSRVEKL
SIAEVVHQL	SIAEVVHQL
FAYDGKDYI	FAYDGKDYI
FLEDLKSFV	FLEDLKSFV
RQPPPRPFLDM	RQPPPRPFL
VMFKITARA	VMFKITARA
VLYDQPRHV	VLYDQPRHV
SQPLGPRII	SQPLGPRII
FLLEKGYEV	FLLEKGYEV
ALHPVQFYL	ALHPVQFYL
LYIQRSAPL	LYIQRSAPL
TAMDVVYAL	TAMDVVYAL
RLFDDVPQV	RLFDDVPQV
KLLDKISSV	KLLDKISSV
LYGKIIHL	LY-GKIIHL
VTFVPVSKV	VTFVPVSKV
YLLNDASLISV	LLNDALISV
LLDPSTPVHI	LLDPSPVHI
IYLSDLTYI	IYLSDLTYI
FLMEEVHMI	FLMEEVHMI
YTFPLRINL	YTFPLRINL
SMMDVDHQI	SMMDVDHQI
SLIEKLWQT	SLIEKLWQT
KVADPTPFHI	KVADPPFHI
VLWSVLQQI	VLWSVLQQI
SLGKIFAL	SL-GKIFAL
KIFNITDNAAI	KIFNITDNA
YQFDKVGILTL	YQFDKVGIL
AMNGHVPAV	AMNGHVPAV
YLPHAPPFA	YLPHAPPFA
KIYEPPRYMSV	KIYEPPRYM
RLFEVPHEL	RLFEVPHEL
TVIRDPPSITP	TVIRDPPSI
KIFQVAQEL	KIFQVAQEL
YLQDTMNHV	YLQDTMNHV
KLYDIDVAKV	KLYDIVAKV
RVAVIKWGA	RVAVIKWGA
FLINFIHTL	FLINFIHTL
KLIEELETL	KLIEELETL
ALDHMVEYV	ALDHMVEYV
ILWEHLEIL	ILWEHLEIL
YLADVTNAL	YLADVTNAL
VVWPVPENI	VVWPVPENI
TLSERLWGL	TLSERLWGL
VAPPARVAP	VAPPARVAP
RLLEGYEIYV	RLLEGEIYV
KIQEILTQV	KIQEILTQV
FTDVIGHYI	FTDVIGHYI
RLFEASDPYQV	RLFEAPYQV
AQYLINARL	AQYLINARL
TLLDPGRFSKV	LLDPGFSKV
IMPAFIFEHI	IMPAFFEHI
TLLKKVWKV	TLLKKVWKV
KLVELDATGV	KLVELATGV
RISDVHFSV	RISDVHFSV
RLQEDPPAGV	RLQEDPAGV
ALYNVDAGHRA	ALYNVDAGH
AIIEARGVSV	AIIEAGVSV
HLYRIIQHL	HLYRIIQHL
VLMENIVYL	VLMENIVYL
FLNKEITSV	FLNKEITSV
LLNKAPEYL	LLNKAPEYL
KLILLITQV	KLILLITQV
WKPVGDLLI	WKPVGDLLI
YLFSTKTHL	YLFSTKTHL
KLEEIIHQI	KLEEIIHQI
KVLDILQHI	KVLDILQHI
VPAYFTSRDLF	AYFTSRDLF
SLDKFLANV	SLDKFLANV
ALIEAEKVAQV	IEAEKVAQV
RLLEVTNTI	RLLEVTNTI
LLKELRHGV	LLKELRHGV
QAPPPPQQV	QAPPPPQQV
YLADIFTKL	YLADIFTKL
GGLPERSVSL	GLPERSVSL
LLGPKPFPL	LLGPKPFPL
YLSELSEHV	YLSELSEHV
KTFFTKEYL	KTFFTKEYL
LMYPYIFHV	LMYPYIFHV
SLWSIISKV	SLWSIISKV
VLTESPPSL	VLTESPPSL
ADASLLKKV	ADASLLKKV
VMYGKVYRI	VMYGKVYRI
VAPPPPPVEV	VAPPPPVEV
VAFSVQKEV	VAFSVQKEV
AIRELNEYL	AIRELNEYL
FLLGPEGQHLL	FLLGPGQHL
RLPDDDPTAV	RLPDDPTAV
VMADIRELI	VMADIRELI
KLLDISELDMV	KLLDISELD
KVQDIKNNL	KVQDIKNNL
GQIEVVPEV	GQIEVVPEV
ILYDKLEKI	ILYDKLEKI
VIWEHDYTSV	VIWEHYTSV
ALAPAPSLP	ALAPAPSLP
DRVYIHPFHL	RVYIHPFHL
AIYHVIMSV	AIYHVIMSV
MLLDFIQHI	MLLDFIQHI
LLPAIVHI	LL-PAIVHI
KMYAVDTRV	KMYAVDTRV
ALFLLEHQA	ALFLLEHQA
NLFEWHFTV	NLFEWHFTV
SMMKNFFFV	SMMKNFFFV
KLMDHIYAV	KLMDHIYAV
ALNGHVEMV	ALNGHVEMV
FLSFPTTKT	FLSFPTTKT
IVSMGSLFPVI	SMGSLFPVI
LLLEPGSLYIL	LLLEPSLYI
YAYDGKDYIAL	YAYDGKDYI
NLAPTDVLEAL	APTDVLEAL
AMIAVVPGYI	AMIAVVPGY
ALHDQLFYL	ALHDQLFYL
ALFEQKGPVYV	ALFEQPVYV
RVFENIVAV	RVFENIVAV
ALGPTGRGV	ALGPTGRGV
SLSPIYPAA	SLSPIYPAA
SAPPRPPRA	SAPPRPPRA
KVGPVPVLV	KVGPVPVLV
RLLDYVVNI	RLLDYVVNI
MMWNNHYIL	MMWNNHYIL
SMWGSAVYL	SMWGSAVYL
KIWAPTAEA	KIWAPTAEA
QVANVRFNV	QVANVRFNV
ALAEALKEV	ALAEALKEV
NMAELFAVV	NMAELFAVV
ALLQRLEAL	ALLQRLEAL
SLFRWRHQA	SLFRWRHQA
FLLQIHEHI	FLLQIHEHI
FLRNINEYL	FLRNINEYL
IIAEPGRYYV	IIAEPRYYV
AVAWLVAHV	AVAWLVAHV
NAPWAVTSL	NAPWAVTSL
IIHNLGMYV	IIHNLGMYV
ILYTLPKLGV	ILYTLKLGV
FLHRIRQNV	FLHRIRQNV
AILLIDHQV	AILLIDHQV
VIHNLATYV	VIHNLATYV
TQILSVPKV	TQILSVPKV
KMNEKIASL	KMNEKIASL
YLMEVTHDL	YLMEVTHDL
HLAEVLERV	HLAEVLERV
ILIEKEYLERV	ILIEKLERV
QLIDGLEYL	QLIDGLEYL
KLPAEPPALL	KLPAEPPAL
TAPTGHTL	TA-PTGHTL
SAYLVAEKV	SAYLVAEKV
ALAKLVEAI	ALAKLVEAI
LAPTDVKEL	LAPTDVKEL
FLWDPAKRTSV	FLWDPRTSV
HMYKLRTNL	HMYKLRTNL
AQWLIQRGV	AQWLIQRGV
SLAKIPATL	SLAKIPATL
ALLGKIEKV	ALLGKIEKV
RMLDSVEKL	RMLDSVEKL
KIIDIQEKV	KIIDIQEKV
FLLPTGLSSL	FLLPTLSSL
SAWRVISSI	SAWRVISSI
NLANPKIFRDL	LANPKIFRD
QLQDRVYAL	QLQDRVYAL
KLDDLTQDLTV	KLDDLTQDL
KLWELLYKL	KLWELLYKL
LLVEVSNIF	LLVEVSNIF
LMEHIHKL	LM-EHIHKL
SLYDWNVKL	SLYDWNVKL
HLLHTVPAL	HLLHTVPAL
YLFREPATI	YLFREPATI
FLMELEQPA	FLMELEQPA
RLIESLFTI	RLIESLFTI
KLMDEVAGIVA	KLMDEVAGI
YMADRLLGV	YMADRLLGV
YLYDRLLRI	YLYDRLLRI
FVAPPTAAV	FVAPPTAAV
LAPPPPTSA	LAPPPPTSA
YMFEAREFL	YMFEAREFL
ALMDQVHHM	ALMDQVHHM
LQFDGIHVV	LQFDGIHVV
YQFDSALLPAV	FDSALLPAV
FLFGYPKRL	FLFGYPKRL
TLAHIHYGV	TLAHIHYGV
YIASLPFQV	YIASLPFQV
AQYENPPHI	AQYENPPHI
AVGQISVHV	AVGQISVHV
RLAEAHAKV	RLAEAHAKV
VLYENKVAV	VLYENKVAV
ALLDKLYAL	ALLDKLYAL
IMFQKPVEV	IMFQKPVEV
LLNEILEQV	LLNEILEQV
KLGHTDILVGV	KLGHTDILV
AMFERIVKA	AMFERIVKA
MAPPAHKSI	MAPPAHKSI
LLNHRIFQL	LLNHRIFQL
VAVDPSILARL	AVDPSLARL
KILSTGKYLNV	KILSTGKYL
RLYDGLFKVI	RLYDGLFKV
AQWAIHPTFNL	AQWAIHPTF
SLFRVITEV	SLFRVITEV
FIMEGTLTRV	FIMEGLTRV
LLNKKPHVV	LLNKKPHVV
VLYHVETEV	VLYHVETEV
YLQNWSHVL	YLQNWSHVL
ALWGGPISL	ALWGGPISL
LLDVPTAAV	LLDVPTAAV
AMAVIKEKI	AMAVIKEKI
KLWEMDNML	KLWEMDNML
HIYPLSFFL	HIYPLSFFL
SLLDRFLATV	SLLDRLATV
HLLGEGAFAQV	LLGEGFAQV
YLYDLNHTLY	YLYDLNHTL
KMFDLNGDGEV	KMFDLDGEV
TEELAYLK	TE-ELAYLK
SLFERLVVL	SLFERLVVL
RLFAVLEQL	RLFAVLEQL
LLASINSTV	LLASINSTV
LLAPAPAQA	LLAPAPAQA
KLFVIAQKI	KLFVIAQKI
KLAEIVKQV	KLAEIVKQV
QLMEQVAQL	QLMEQVAQL
RLWDHATMTEV	RLWDHMTEV
WEILHQQLL	WEILHQQLL
VSAHITEQL	VSAHITEQL
LLPPVTLAA	LLPPVTLAA
VLFELSKTV	VLFELSKTV
FVNDIFERI	FVNDIFERI
SMHEVVENL	SMHEVVENL
VLMNQPPQI	VLMNQPPQI
KMFFLIDKV	KMFFLIDKV
SLLEHLSHV	SLLEHLSHV
ATLNIIHSV	ATLNIIHSV
TYDDATKTFT	TYDDATKTF
KLWDPTVGKSL	KLWDPTVGK
KIWTSVPYL	KIWTSVPYL
MVAPAVASV	MVAPAVASV
KLLEKLYKV	KLLEKLYKV
SVFAGVVGV	SVFAGVVGV
VLLQIVHFL	VLLQIVHFL
RLLSIKEAFRL	RLLSIKEAF
KLYGKPIRV	KLYGKPIRV
VLFGVETHV	VLFGVETHV
ISPDVFTHV	ISPDVFTHV
VVWMVPENV	VVWMVPENV
RLYDGLFKV	RLYDGLFKV
IQVEKVFSI	IQVEKVFSI
FLFDHLLTL	FLFDHLLTL
ALASVIMGL	ALASVIMGL
WLWPFKETV	WLWPFKETV
SAPSRATAL	SAPSRATAL
FIWNMKTNI	FIWNMKTNI
TLAEINQKWNL	TLAEINQKW
QLVDIIEKV	QLVDIIEKV
KLFPGFEIETV	KLFPGIETV
KMAPALRKV	KMAPALRKV
FSDEIRHNL	FSDEIRHNL
SLAELKGFEV	SLAELGFEV
YLLEQDFPGM	YLLEQFPGM
KMLDKIISI	KMLDKIISI
TLADVLYHV	TLADVLYHV
ILNDPSQSEVM	ILNDPQSEV
HLFNVAHTL	HLFNVAHTL
SLASFIPAV	SLASFIPAV
QLIDKVWQL	QLIDKVWQL
ILMEHIHKLKA	ILMEHIHKL
VLRNSTTLV	VLRNSTTLV
ILHEIALGV	ILHEIALGV
LLSAAEPVPA	LLSAAPVPA
YMMPVNSEV	YMMPVNSEV
YLITLLEHL	YLITLLEHL
FLSSVIQNL	FLSSVIQNL
FLVTVIHTL	FLVTVIHTL
RLWNMPENNGL	RLWNMPENN
YLDGHLITTV	YLDGHITTV
TTYKLVINGK	TTYKLVING
LIWNIKDEL	LIWNIKDEL
ALLEKGITEA	ALLEKITEA
SVLGALIGV	SVLGALIGV
FLFQGFRLV	FLFQGFRLV
SLYGQFRVV	SLYGQFRVV
VMFKEPVEV	VMFKEPVEV
VLSSPLALA	VLSSPLALA
KLHGVNINV	KLHGVNINV
RMYELVHRM	RMYELVHRM
SVVSPSSFENV	VVSPSFENV
YIFQPQQSV	YIFQPQQSV
SQLDISDPYKV	SQLDIPYKV
ALVEIGPRFVL	ALVEIPRFV
FLHPEPFSI	FLHPEPFSI
LQLEAIHKV	LQLEAIHKV
YAYETKDAL	YAYETKDAL
NMFEISDRL	NMFEISDRL
SVPDTVHHV	SVPDTVHHV
SLAEPRVSV	SLAEPRVSV
VLWTLHSEG	VLWTLHSEG
VLYDWKERL	VLYDWKERL
TVIAKVNNV	TVIAKVNNV
GLDIITNKV	GLDIITNKV
IPSFNLIGDSL	SFNLIGDSL
KMDDPDYWRTV	KMDDPYWRT
LQAPELANV	LQAPELANV
LSLEIGKTL	LSLEIGKTL
RLYPLAIQI	RLYPLAIQI
KIWDLEGKI	KIWDLEGKI
FAPPQPVAA	FAPPQPVAA
KQWKFPDGSFI	KQWKFPDGS
SLFSVIVRV	SLFSVIVRV
RLYPEGLAQL	RLYPELAQL
SMLEPVPEL	SMLEPVPEL
SVLGAITSV	SVLGAITSV
NLNEKINHL	NLNEKINHL
TMAKESSIIGV	TMAKESSII
KLWTIHELL	KLWTIHELL
RLFNHPNILRL	RLFNHPNIL
SLIPEGPPQV	SLIPEPPQV
KLWPLPKALL	KLWPLPKAL
TLWGGLLRL	TLWGGLLRL
SLVSPASFENV	LVSPAFENV
FLWKITNVT	FLWKITNVT
FLPDPSALQNL	FLPDPLQNL
SMMDRMFAL	SMMDRMFAL
SVYGKLRKV	SVYGKLRKV
RLFDMSGVRL	RLFDMGVRL
KLLDKISEL	KLLDKISEL
ALANQIPTV	ALANQIPTV
SVYGSLASV	SVYGSLASV
FLPEPMGTA	FLPEPMGTA
KLNLLTEYI	KLNLLTEYI
NLFKLEVRL	NLFKLEVRL
LLIFTEGAAV	LIFTEGAAV
VIAEILRGV	VIAEILRGV
KLQDQIFNL	KLQDQIFNL
NAIYYYADQIY	AIYYYADQI
KTWNPKFTL	KTWNPKFTL
FLQKIEALV	FLQKIEALV
LIYPWVHVV	LIYPWVHVV
KLWQTPLHV	KLWQTPLHV
ALSEKIVSV	ALSEKIVSV
FLLPHPGLQV	FLLPHGLQV
SIHDVTFQV	SIHDVTFQV
KVWDIVGTEL	KVWDIGTEL
LLAELPASVHA	LLAELPASV
LLHGHIVEL	LLHGHIVEL
QLWNNYFHL	QLWNNYFHL
ALADKELLPSV	ALADKLPSV
LLLPFTTTSL	LLLPFTTSL
LTHLVTAAV	LTHLVTAAV
RLSDAQIYV	RLSDAQIYV
VILFLNKQDLL	ILFLNKQDL
TLWEIAKAEV	TLWEIKAEV
KQMEKIQPA	KQMEKIQPA
ALIEVPDGFTA	ALIEVPDGF
ALNEQIARL	ALNEQIARL
ILYGEVEKL	ILYGEVEKL
RQLEEEGITFV	QLEEEITFV
SLNKHVEAV	SLNKHVEAV
KLIDLSQVMYL	KLIDLSQVM
VMYDLITEL	VMYDLITEL
LAIKVPPS	LA-IKVPPS
VLFLVAWTV	VLFLVAWTV
FLFNKVVNL	FLFNKVVNL
SLLPPDALVGL	SLLPPDALV
KAPAPRPSL	KAPAPRPSL
GMYIFLHTV	GMYIFLHTV
TVTEKPEVID	TVTEKPEVI
KMQETLVGL	KMQETLVGL
IIYIVHDEV	IIYIVHDEV
LLPDPRELIEI	LLPDPRELI
MVWEGLNVV	MVWEGLNVV
SFEDAKEAL	SFEDAKEAL
YAAELIERV	YAAELIERV
SLSKITTTV	SLSKITTTV
ALWPVSKQL	ALWPVSKQL
FLFDKVVIV	FLFDKVVIV
RIMEIVDAI	RIMEIVDAI
YLDEIVKEV	YLDEIVKEV
VMMDIGSTRL	VMMDISTRL
VSWGLVKGAEI	VSWGLVKGA
LQVEEVHQL	LQVEEVHQL
YMEEIYHRI	YMEEIYHRI
YLLEKFVAV	YLLEKFVAV
KLADKLYNL	KLADKLYNL
FLDEPTNHL	FLDEPTNHL
LLAEKIYKI	LLAEKIYKI
VLLEDGVLNHV	VLLEDLNHV
QLLDLMHTL	QLLDLMHTL
SLIKQIPRI	SLIKQIPRI
YFAERVTSL	YFAERVTSL
LAPPPPPAAA	LAPPPPPAA
KIKELNKKEAV	KELNKKEAV
NMYEGVGRMFI	NMYEGVGRM
NILELLHRL	NILELLHRL
NIFGPLVKL	NIFGPLVKL
KLLAVIHEL	KLLAVIHEL
AMTHITEGI	AMTHITEGI
ALAPTPSAV	ALAPTPSAV
RLFESINNL	RLFESINNL
EEQLQQIR	EE-QLQQIR
FLQEKSPAV	FLQEKSPAV
FLLEKPFSV	FLLEKPFSV
TLFRITSNA	TLFRITSNA
KVWLIDVSQSV	WLIDVSQSV
FMQAIKENI	FMQAIKENI
SLLGDDALVQV	LLGDDLVQV
IQDRAVPSL	IQDRAVPSL
KMWRDLEQL	KMWRDLEQL
RIWNLEGVQT	RIWNLGVQT
VLWLPHWGL	VLWLPHWGL
YLSKIIPAL	YLSKIIPAL
LMNPMVPGL	LMNPMVPGL
KIFPMGDRLYI	KIFPMGDRL
KLAKQPETV	KLAKQPETV
YIAPLKALV	YIAPLKALV
RIMEFTTTL	RIMEFTTTL
IQVTKVTQV	IQVTKVTQV
AAPAYSRAL	AAPAYSRAL
KLLDLKKQLAV	KLLDLKKQL
FLDTLKDLI	FLDTLKDLI
ALFAGFRAL	ALFAGFRAL
VVAAIAISE	VVAAIAISE
KLLDLQVRV	KLLDLQVRV
FAIDPHLLLSV	AIDPHLLSV
RVYNVTQHA	RVYNVTQHA
TVFLLEKPFSV	FLLEKPFSV
RVADILTQL	RVADILTQL
ELKPFIEEL	ELKPFIEEL
RQPDSGISSI	RQPDSISSI
FLFPNKESL	FLFPNKESL
ILFPLRFTL	ILFPLRFTL
FLGSFIDHV	FLGSFIDHV
RLIDLHTNV	RLIDLHTNV
FLDNLHINL	FLDNLHINL
KIFNITDNA	KIFNITDNA
ALPPPPPAA	ALPPPPPAA
NLFKHLAKA	NLFKHLAKA
RMFHIRAVI	RMFHIRAVI
SLLEKLSAL	SLLEKLSAL
IQLVHGLKL	IQLVHGLKL
RVLDPSKFLKI	RVLDPSKFL
KLMDLDVEQL	KLMDLVEQL
MLAWINESL	MLAWINESL
LFDRPMHV	LF-DRPMHV
VVWDLDRPLE	VVWDLDRPL
ILGKVYSV	IL-GKVYSV
KQWDVVSYL	KQWDVVSYL
YLNDGLWHM	YLNDGLWHM
ILGPKPQGV	ILGPKPQGV
RMNFPYFYV	RMNFPYFYV
KLTEIRHEV	KLTEIRHEV
MAMEPDRKAAV	MEPDRKAAV
SMADIPLGFGV	SMADIPLGF
SLLPEGPPAI	LLPEGPPAI
VLMDLKALL	VLMDLKALL
IMQLLRDNL	IMQLLRDNL
ILWETVPSM	ILWETVPSM
APSFLEGLW	APSFLEGLW
GLAPKPVQV	GLAPKPVQV
RAFLVEHNL	RAFLVEHNL
YTPPAGAKV	YTPPAGAKV
YALYVRDTL	YALYVRDTL
FQLPIRFNL	FQLPIRFNL
RLPEIYIQL	RLPEIYIQL
QQLDSKFLEQV	QLDSKLEQV
ALMPVLNQV	ALMPVLNQV
KLFDRPQEL	KLFDRPQEL
RILDIDIPMSV	LDIDIPMSV
TLLDPNEKYLL	LLDPNEKYL
RLLEFLVAL	RLLEFLVAL
PDPKLLEKV	PDPKLLEKV
KIWDLKERTNV	KIWDLKERT
KVMELLVHL	KVMELLVHL
KLLPGSAIQAL	LLPGSIQAL
KSFSLRAQV	KSFSLRAQV
KAEGVLLDYL	KAEGVLDYL
ITPTGTHPL	ITPTGTHPL
VAPPEYHRKAV	APPEYHRKA
YLSEEVQAV	YLSEEVQAV
ILFNRVLGV	ILFNRVLGV
KAPPAPLAA	KAPPAPLAA
MLPPPPLTA	MLPPPPLTA
LLGPRLVLA	LLGPRLVLA
SLLPAIVEL	SLLPAIVEL
KVYPVQEAL	KVYPVQEAL
TEKPEVID	TE-KPEVID
KMLEKLPEL	KMLEKLPEL
ALFQIEQGI	ALFQIEQGI
KMPEINAKV	KMPEINAKV
QLLDVIHYV	QLLDVIHYV
LLLPDYYLVTV	LLLPDYYLV
YLIPLLERL	YLIPLLERL
ALWHVPEHA	ALWHVPEHA
LLFDVHTTL	LLFDVHTTL
PDIIKDQKA	PDIIKDQKA
KIFEFKETL	KIFEFKETL
SVLDPRDLRQL	VLDPRLRQL
RLWKAIHTA	RLWKAIHTA
DRVYIHPF	DR-VYIHPF
AMWDLTTAM	AMWDLTTAM
FLLPILSQI	FLLPILSQI
SAPASQASL	SAPASQASL
KIWDVSVNS	KIWDVSVNS
RVREITENL	RVREITENL
VQTDYVPLL	VQTDYVPLL
AAPATRAAL	AAPATRAAL
GVYGDVQRV	GVYGDVQRV
KLLFWVTEV	KLLFWVTEV
KTTTIAVEV	KTTTIAVEV
KLWEMDNMLI	KLWEMDNML
KLLGELHTL	KLLGELHTL
RLLDYVATV	RLLDYVATV
ALANIAANI	ALANIAANI
YLLDHFLSM	YLLDHFLSM
YLNHLIQGL	YLNHLIQGL
SLYSQVHQI	SLYSQVHQI
RIWDPVLSV	RIWDPVLSV
KTWKVDVVL	KTWKVDVVL
KILPTLEAV	KILPTLEAV
TLWYVPLSL	TLWYVPLSL
FQADLSNLHL	FQADLNLHL
RIIDVVYNA	RIIDVVYNA
QLNEKVAQL	QLNEKVAQL
RLYGKLAKV	RLYGKLAKV
FILANEHNV	FILANEHNV
ALIEKLVEL	ALIEKLVEL
FEWENKVTV	FEWENKVTV
TKAVDAETAE	KAVDAETAE
RLLPPGAVVAV	RLLPPGAVV
TLQEKIHRL	TLQEKIHRL
LGGQLNVSV	LGGQLNVSV
KLFDLLDVL	KLFDLLDVL
ATDHIKVQV	ATDHIKVQV
ILNKQEFFV	ILNKQEFFV
MQGPIPERI	MQGPIPERI
KLLDIRSYL	KLLDIRSYL
LLDIIKSTV	LLDIIKSTV
SIYPLHDVFV	SIYPLDVFV
KLFPFYFHI	KLFPFYFHI
LLAAWTARA	LLAAWTARA
NQYRLIVNV	NQYRLIVNV
FLIEPEHVNTV	IEPEHVNTV
KLLDQMPSL	KLLDQMPSL
ALNELLQHV	ALNELLQHV
KLISELQKL	KLISELQKL
LLLDVTPLSL	LLLDVPLSL
YLTDRVMTV	YLTDRVMTV
KLQELNYNL	KLQELNYNL
YLQQVNHKL	YLQQVNHKL
YAWEIKDFL	YAWEIKDFL
RVYEFLDKL	RVYEFLDKL
ALWDIETGQQT	ALWDIETGQ
RLWDLENGKQI	RLWDLENGK
YLDQIRQTI	YLDQIRQTI
YVHMVTHFI	YVHMVTHFI
HIWDPLTNV	HIWDPLTNV
SLLENLEKI	SLLENLEKI
WPLTESQLTFV	LTESQLTFV
ALAAALAHI	ALAAALAHI
VLGKIWKL	VL-GKIWKL
GMYGKIAVMEL	GMYGKIAVM
KLAPPPKKA	KLAPPPKKA
HLANIVERL	HLANIVERL
KIMTEKELLAV	KIMTEKELL
ALGPVPTAI	ALGPVPTAI
LTWDVKDTLL	LTWDVKDTL
ISPTGHSL	IS-PTGHSL
RIIDTVAQV	RIIDTVAQV
RLLHVKETM	RLLHVKETM
LLWTPSVGL	LLWTPSVGL
LLMEPGAMRFL	LLMEPGAMR
MLDMSVPAV	MLDMSVPAV
RIFLLIQSV	RIFLLIQSV
SLEGIPLAQV	SLEGILAQV
RLISQIVSSI	LISQIVSSI
FLMDFIHQV	FLMDFIHQV
LKLDIDKSL	LKLDIDKSL
LLADLLHNV	LLADLLHNV
RLQEEINEV	RLQEEINEV
KINEAIVAV	KINEAIVAV
AMFRPFVEV	AMFRPFVEV
FVEIKGSV	FV-EIKGSV
ALWDLRNLKL	ALWDLNLKL
MLHTVTDMV	MLHTVTDMV
GLLYPTEDYKV	LLYPTDYKV
FTWNMNEKL	FTWNMNEKL
KLLNLISKL	KLLNLISKL
FLFGEVHKA	FLFGEVHKA
RLYHITDQV	RLYHITDQV
LLNDHIYVV	LLNDHIYVV
KMAPPPKEV	KMAPPPKEV
SVLVSPPAV	SVLVSPPAV
LMMDPLTGL	LMMDPLTGL
KVLKPDTTYQV	VLKPDTYQV
LLDQIRQGI	LLDQIRQGI
KLMDQLEAL	KLMDQLEAL
NMFKMAKNWSA	FKMAKNWSA
SQAERLFNL	SQAERLFNL
ILMEHIHKL	ILMEHIHKL
HLIDPNTLQVA	LIDPNTLQV
TIIDLPGITRV	IIDLPITRV
FLTDSNNIKEV	LTDSNIKEV
FLHDNMVEI	FLHDNMVEI
LLWPGAALL	LLWPGAALL
KVLEPSETLVV	KVLEPSETL
RVLELIPQI	RVLELIPQI
KLHDFGYRGV	KLHDFYRGV
KLLDPEDISV	KLLDPDISV
VLWMAPDGLYA	VLWMAPDGL
ATFKGIVRA	ATFKGIVRA
GLFAHPSLWQL	FAHPSLWQL
LMTKEISSV	LMTKEISSV
QQLDTRYLEQL	QLDTRLEQL
KLNDLIQRL	KLNDLIQRL
SLDERPVAV	SLDERPVAV
LAPPEGQTV	LAPPEGQTV
RLFPLSGHLLL	RLFPLGHLL
SLLDIIEKV	SLLDIIEKV
YLDAIRSGL	YLDAIRSGL
ILFDPKTSV	ILFDPKTSV
SLYDWHVKL	SLYDWHVKL
FLFELPSRL	FLFELPSRL
SLEELLHYV	SLEELLHYV
HLMEENMIVYV	HLMEENMIV
YAYDGKDYI	YAYDGKDYI
ALLEPEFILKA	ALLEPEFIL
FVPDTPVGV	FVPDTPVGV
VMDSKIVQV	VMDSKIVQV
ILAAIVNHL	ILAAIVNHL
VVFRLQEFI	VVFRLQEFI
ITTDVLYTI	ITTDVLYTI
SMLDDLRNV	SMLDDLRNV
YLPDGTASL	YLPDGTASL
VVGHITEGV	VVGHITEGV
LTAPPEALLMV	LTAPPEALL
GLAGVKIAEV	GLAGVIAEV
KLWEAESKL	KLWEAESKL
TVLLIMHTL	TVLLIMHTL
LILGKLHYV	LILGKLHYV
TIFDLSEVL	TIFDLSEVL
GLDGPPPTV	GLDGPPPTV
YLQEKLHAL	YLQEKLHAL
RLDELGGVYL	RLDELGVYL
KLDHINMNL	KLDHINMNL
YLLESVNKL	YLLESVNKL
YTAEIKQNL	YTAEIKQNL
KLWDVRDSM	KLWDVRDSM
KLFPDTPLAL	KLFPDPLAL
SLFDWNVKL	SLFDWNVKL
TLAAIIEHL	TLAAIIEHL
GLWSGPLPRV	GLWSGLPRV
ILQSKEPAYV	ILQSKPAYV
YLMDINGKMWL	YLMDINGKM
FMATIAEGL	FMATIAEGL
YSKYYKTID	YSKYYKTID
ALWREVASL	ALWREVASL
ILGPIPSHM	ILGPIPSHM
TLFPSKIGV	TLFPSKIGV
MLFDKFRSV	MLFDKFRSV
HLNEHLYNM	HLNEHLYNM
KLPTRPASTGV	KLPTRPAST
ALASLKKYGV	ALASLKYGV
HTYHIKNYI	HTYHIKNYI
SVMDWKDGV	SVMDWKDGV
VVDIIRVNV	VVDIIRVNV
VLDIIKHIV	VLDIIKHIV
LMVDHVTEV	LMVDHVTEV
HLPETKFSEL	HLPETFSEL
KLGPAPKTL	KLGPAPKTL
AVMAPRTLVLL	VMAPRLVLL
FLPPLPTSV	FLPPLPTSV
KQFLVKVLI	KQFLVKVLI
RLTDYISKV	RLTDYISKV
VEELKPTPE	VEELKPTPE
ILDESHERV	ILDESHERV
RLAQHITYV	RLAQHITYV
RLFPVPGSGLV	RLFPVGSGL
AAPAPAAHV	AAPAPAAHV
SLLPSVPAL	SLLPSVPAL
KLMDVGLIAI	KLMDVLIAI
QLFEDLVYL	QLFEDLVYL
YIMEPSIFNTL	YIMEPIFNT
KMFKMSEKI	KMFKMSEKI
TVADPSVISHL	ADPSVISHL
TVFEHTFHV	TVFEHTFHV
NVKVDPEIQ	NVKVDPEIQ
RLMNLPLHSV	RLMNLLHSV
SIFEFVHAL	SIFEFVHAL
KLFDLDEKLML	KLFDLDEKL
LMWELEKKSAV	LMWELKKSA
ALPAELLEAL	LPAELLEAL
YILLPRIIE	YILLPRIIE
SLGKVFGV	SL-GKVFGV
KLHYVVTEV	KLHYVVTEV
SLWKEVSEL	SLWKEVSEL
YLNKHIQKV	YLNKHIQKV
LMADLEGLHL	LMADLGLHL
YLDPRLAFTV	YLDPRAFTV
FLPPAQVTV	FLPPAQVTV
RLYDTHITV	RLYDTHITV
IVLPAGALHQV	VLPAGLHQV
LLALMHHSN	LLALMHHSN
KMWEEAISL	KMWEEAISL
YIMETVDAQHV	YIMETVDAQ
KLLTEVHAA	KLLTEVHAA
YMLDLQKQL	YMLDLQKQL
VLPNFLPYNV	VLPNFPYNV
RLQETEGMVAV	RLQETMVAV
SLLSPGLLPHL	LLSPGLPHL
YLATLTEKM	YLATLTEKM
GLMRKVPRV	GLMRKVPRV
SFGSLAPAPL	FGSLAPAPL
KVAEAPPNL	KVAEAPPNL
AMLAVLHTV	AMLAVLHTV
TLIDLPGITKV	TLIDLITKV
LLYDLADQLHA	LLYDLADQL
SLWANPKYV	SLWANPKYV
GQAPSVFSV	GQAPSVFSV
LTFRDPLALL	LTFRDPLAL
LMGFFPFRV	LMGFFPFRV
FLADPDTVNHL	FLADPVNHL
KLMELLEEI	KLMELLEEI
LLLAHIIAL	LLLAHIIAL
NLYPFVKTV	NLYPFVKTV
AVANIVNSV	AVANIVNSV
RLGPVPSGL	RLGPVPSGL
FLLDGFPRTV	LLDGFPRTV
FLQEHNTTL	FLQEHNTTL
TAPPIATGV	TAPPIATGV
QVFPGLLERV	QVFPGLERV
TLWPEVQKL	TLWPEVQKL
KLQEVLDYL	KLQEVLDYL
IMDKLKEYL	IMDKLKEYL
FLAHIYTEL	FLAHIYTEL
AMFENFVSV	AMFENFVSV
RAAEIRETL	RAAEIRETL
KLQEVGQVSV	KLQEVQVSV
FLFDTQHFI	FLFDTQHFI
QVPEAPGGSAV	QVPEAGSAV
AVGGIANATI	AVGGINATI
GLADASLLKKV	ADASLLKKV
VLDVIHEVL	VLDVIHEVL
KLQEQIFHL	KLQEQIFHL
KLHLILDYV	KLHLILDYV
NLFTVIAHL	NLFTVIAHL
SLLHLGALYGI	SLLHLLYGI
TAWELPKTYV	TAWELKTYV
ALFELSRVITL	ALFELSRVI
LTMEVIRQV	LTMEVIRQV
VLAELKEYA	VLAELKEYA
KMWENRQNLL	KMWENRQNL
YQILDGIHYL	QILDGIHYL
KLFLVNNKI	KLFLVNNKI
TVADKIHSV	TVADKIHSV
RLLDALEFL	RLLDALEFL
KLFDRPQELKL	KLFDRPQEL
KTALITEVV	KTALITEVV
RLPEAIEEV	RLPEAIEEV
VLFGLLREV	VLFGLLREV
YLVEDIQHI	YLVEDIQHI
FQHTGIYSV	FQHTGIYSV
YLQDVIMQV	YLQDVIMQV
FLLEGIRSL	FLLEGIRSL
ALYAVIEKA	ALYAVIEKA
ILDLIKKGV	ILDLIKKGV
VLLKARLVPA	VLLKALVPA
YLFTFLNHL	YLFTFLNHL
FTWPIKIQV	FTWPIKIQV
RMNPNSPSITY	RMNPNSPSI
ILWSHLELL	ILWSHLELL
FQIRNLPSL	FQIRNLPSL
ALFARPDLLLL	ALFARPDLL
SLPDFGISYV	SLPDFISYV
KLAEFIDFL	KLAEFIDFL
LLWERVEKL	LLWERVEKL
YLAPFLRNV	YLAPFLRNV
FMQDPMEVFV	FMQDPEVFV
SAPVGVTAL	SAPVGVTAL
KIFLLKVLL	KIFLLKVLL
TTTHITKTV	TTTHITKTV
ATYVFLHTV	ATYVFLHTV
KITTVIQHV	KITTVIQHV
YAPPPRDYTY	YAPPPRDYT
SMIDPPRAAV	SMIDPRAAV
NIFRWETTI	NIFRWETTI
RLFEVPHELVA	RLFEVPHEL
FAYTVKYVL	FAYTVKYVL
NLFHYLTEV	NLFHYLTEV
AMFDFSEKL	AMFDFSEKL
YMPKRGLEV	YMPKRGLEV
KLNNLNKKL	KLNNLNKKL
ILHHVNIGL	ILHHVNIGL
YLLEIPKGEMV	YLLEIPKGE
QLFEMHEKL	QLFEMHEKL
RLAELEEFI	RLAELEEFI
TYKLILNGK	TYKLILNGK
YIIVPPLTL	YIIVPPLTL
KLLKLFQGV	KLLKLFQGV
TVMDSKIVQV	VMDSKIVQV
VAPPGGSRKEV	VAPPGRKEV
WLVDHVYAI	WLVDHVYAI
ALDNVDARMYM	ALDNVDARM
YLLKINGKV	YLLKINGKV
LMDHTIPEV	LMDHTIPEV
FMDPQKMPYL	FMDPQMPYL
VLWAGTPMV	VLWAGTPMV
KMFEVDMKI	KMFEVDMKI
VLFSSPPQM	VLFSSPPQM
STYPIKNEV	STYPIKNEV
KIAEIKSLL	KIAEIKSLL
RLNKVIKSV	RLNKVIKSV
KLKNVNFEV	KLKNVNFEV
SLISNPPAM	SLISNPPAM
KLLEKERL	KL-LEKERL
TLSDLRVYL	TLSDLRVYL
RLWGEPVNL	RLWGEPVNL
KLVELPYTV	KLVELPYTV
RLAEVVHEL	RLAEVVHEL
SIPGGYNAL	SIPGGYNAL
VLVEPKTAWRL	VLVEPKTAW
ALYTVLHRL	ALYTVLHRL
SLITRLLEV	SLITRLLEV
ALATLIHQV	ALATLIHQV
LLFEGIARI	LLFEGIARI
HLFKITENI	HLFKITENI
FLLPDGLVRL	LLPDGLVRL
KTMELNVGNEA	KTMELNVGN
KLDQVIIHV	KLDQVIIHV
LTWLIVNHI	LTWLIVNHI
GLWGPVHEL	GLWGPVHEL
LMDPNSPERV	LMDPNPERV
HLPPVRLAEL	HLPPVLAEL
KLAEVSQNI	KLAEVSQNI
KTDVVVNSV	KTDVVVNSV
VLHELTFQA	VLHELTFQA
LLDKVYSSV	LLDKVYSSV
RQADKVWRL	RQADKVWRL
KLWDIRDGM	KLWDIRDGM
YLDPAQRGV	YLDPAQRGV
GMYPNLVHV	GMYPNLVHV
VIFILGKEHQL	FILGKEHQL
KVWDLAQQV	KVWDLAQQV
FMFDEKLVTV	FMFDELVTV
LLDPNVKSIFV	LLDPNVKSI
FLSEVFHQA	FLSEVFHQA
YLDPSVLSGV	YLDPSLSGV
YLGITPSITNW	YL-GITPSI
YMPPTSEAA	YMPPTSEAA
SLWQNEERA	SLWQNEERA
RLMNDMTAV	RLMNDMTAV
LLGQVFQV	LL-GQVFQV
FLDLLQERI	FLDLLQERI
RLWTPPEDYRL	RLWTPDYRL
ILLDNEFHV	ILLDNEFHV
KLAAVVNNL	KLAAVVNNL
ALMEVKMKEM	ALMEVMKEM
ILSEVQQAV	ILSEVQQAV
KMWDPHNDPNA	KMWDPHNDP
KLLETELLQEI	KLLETLQEI
RLLDMGFEA	RLLDMGFEA
ALNDPKMYV	ALNDPKMYV
FVIDRPNGTKV	FVIDRPNGT
VLLFIEHSV	VLLFIEHSV
KIGPITPLEF	KIGPITPLE
FLNKLIPVL	FLNKLIPVL
LQIDNARLA	LQIDNARLA
KLWDISEVMV	KLWDISEVM
LDKKVEKV	LD-KKVEKV
RTFHLLHTV	RTFHLLHTV
LAPPPRER	LA-PPPRER
FIIQGLRSV	FIIQGLRSV
SVMQLQEEAHL	SVMQLQEEA
RMWATQGLA	RMWATQGLA
TLYDIRAEL	TLYDIRAEL
GLIGVGLINV	GLIGVLINV
LLAELLTHL	LLAELLTHL
HLDTLHNFV	HLDTLHNFV
GLADKVYFL	GLADKVYFL
YLYQILQGI	YLYQILQGI
SPVVILPAV	SPVVILPAV
LLAEKVEQL	LLAEKVEQL
FLLDPYKYMTL	FLLDPYKYM
KVIDYVPGI	KVIDYVPGI
ALSKEGIVAL	ALSKEIVAL
LLYGHTVTV	LLYGHTVTV
KMWDVSTGM	KMWDVSTGM
KVAELFEKL	KVAELFEKL
RLAGADVVLGV	RLAGADVVL
RVMEYINRL	RVMEYINRL
HILGIPQSWRL	HILGIPQSW
TIAEVGKWLQA	TIAEVGKWL
RIADLSYTV	RIADLSYTV
RLLEPADMVLL	RLLEPADMV
HLWRGIVSI	HLWRGIVSI
MQAERIFSEV	MQAERFSEV
MAPKPGPYV	MAPKPGPYV
KLWESPNVL	KLWESPNVL
AIMEHAYYA	AIMEHAYYA
KILETLYTL	KILETLYTL
ALLENGIIHHV	ALLENIHHV
KVMNILHRI	KVMNILHRI
LAPEVEVRV	LAPEVEVRV
FLYDDNQRV	FLYDDNQRV
VIDGHIYAV	VIDGHIYAV
GLFGKELHKV	GLFGKLHKV
SMFLPPTTV	SMFLPPTTV
VMPHANMNV	VMPHANMNV
RLVQGSILKKV	VQGSILKKV
YLIELIDRV	YLIELIDRV
LLAEAKYYL	LLAEAKYYL
YVTDVLYRV	YVTDVLYRV
GVGPVPARA	GVGPVPARA
NMYGKVVTV	NMYGKVVTV
YAYDGKDYIA	YAYDGKDYI
IVNEPPPKL	IVNEPPPKL
IAPPGHTGV	IAPPGHTGV
GIFETKFQV	GIFETKFQV
KIVVVTAGV	KIVVVTAGV
KMMDKVEFV	KMMDKVEFV
LVWDLRNMGYV	LVWDLRNMG
LYDWKERL	LY-DWKERL
TLMDMRLSQV	TLMDMLSQV
ALFSFLYHL	ALFSFLYHL
IMWPIIAKL	IMWPIIAKL
RIFDLQNKV	RIFDLQNKV
KIFNNQEFA	KIFNNQEFA
YIFSVVENL	YIFSVVENL
ILQDLTFVHL	ILQDLFVHL
FMTTNVPNV	FMTTNVPNV
KMADEDALRKI	KMADEDALR
SSPQPGSAL	SSPQPGSAL
KMVYIYHSL	KMVYIYHSL
ALAPPPPAA	ALAPPPPAA
RLYSVSYLL	RLYSVSYLL
ILLAEVPTM	ILLAEVPTM
ILHSVTTNL	ILHSVTTNL
SLINVGLISV	SLINVLISV
FMNPHLISV	FMNPHLISV
VVPEPGQPL	VVPEPGQPL
SILEDPPSI	SILEDPPSI
KLQEFLQTL	KLQEFLQTL
FLDSLRDLI	FLDSLRDLI
KIMDLIGIQT	KIMDLGIQT
VGPPGRSSL	VGPPGRSSL
YTFPGWKVGV	YTFPGKVGV
TLMNLGGLAV	TLMNLGLAV
IWGKVTRA	IW-GKVTRA
YMKDIENYI	YMKDIENYI
KAAKIRVSV	KAAKIRVSV
RLISLTDENAL	RLISLDENA
ALSSVIKEL	ALSSVIKEL
KLGSVPVTV	KLGSVPVTV
GLLPDVPSL	GLLPDVPSL
LLASEVPQL	LLASEVPQL
FLHETGGAMV	FLHETGAMV
KVVALVHAV	KVVALVHAV
LLWDPSTGKQV	LLWDPSTGK
HLYDIHVTV	HLYDIHVTV
ALWIPEVSI	ALWIPEVSI
SLLRLQETL	SLLRLQETL
KLFSLEHFL	KLFSLEHFL
FLQEYVANL	FLQEYVANL
RLDNLKAHL	RLDNLKAHL
VLMDLKALLL	VLMDLKALL
FMMPRIVNV	FMMPRIVNV
ALMEQVAHQTI	ALMEQVAHQ
IVWKIKETV	IVWKIKETV
KLWDLLYKL	KLWDLLYKL
RMFPTQGFTEI	RMFPTFTEI
YLPDIIKDQKA	YLPDIKDQK
KLQEKIQEL	KLQEKIQEL
KLYEAVPQL	KLYEAVPQL
SLFLFGEVHKA	FLFGEVHKA
GLLENIPRV	GLLENIPRV
GLADNTVIAKV	GLADNTVIA
TLYERGFENI	TLYERFENI
QLDDLKVEL	QLDDLKVEL
FLYQPQYLNAI	YQPQYLNAI
NGTVAGFELLL	TVAGFELLL
ALADGVQKV	ALADGVQKV
MLLDPPPGSHV	LLDPPGSHV
YVWDIKSIM	YVWDIKSIM
AVWAAVQAV	AVWAAVQAV
AAPPPSVTV	AAPPPSVTV
YVYEYLLHV	YVYEYLLHV
KLFNVTSTL	KLFNVTSTL
NLFDISQSAQT	NLFDISQSA
IIHEIAVLEL	IIHEIVLEL
FLYDTHQNL	FLYDTHQNL
VLYPHEPTAV	VLYPHPTAV
TLGQIYYL	TL-GQIYYL
AIQDKLFQV	AIQDKLFQV
KLPGRENKTAV	KLPGRNKTA
KLSEPSSLQYL	KLSEPLQYL
YLPYPIHQV	YLPYPIHQV
TLYEMKSQV	TLYEMKSQV
GLTEALHFV	GLTEALHFV
LFLHAGIVLP	FLHAGIVLP
SVLEPQVLNYL	VLEPQLNYL
FLFSKFIEL	FLFSKFIEL
HVDEIKEFL	HVDEIKEFL
FLMNEVIKL	FLMNEVIKL
ILQDPRLITPL	LQDPRITPL
RLQDAIAKV	RLQDAIAKV
MMPPPVGMV	MMPPPVGMV
RLDYITAEI	RLDYITAEI
LVLEIIHRI	LVLEIIHRI
KMLAKVKQV	KMLAKVKQV
YVLEGLKSV	YVLEGLKSV
ALYTLVNKV	ALYTLVNKV
KLMSLGDIRL	KLMSLDIRL
MLAEKLPNL	MLAEKLPNL
RLSSVNAEV	RLSSVNAEV
KMMLIVNMV	KMMLIVNMV
TVPPPPAAA	TVPPPPAAA
LSLENLEKI	LSLENLEKI
KTLPVAFKV	KTLPVAFKV
KVLGKIEKV	KVLGKIEKV
