Data	Data aligned
KLKSFTYEY	KLKSFTYEY
SYFKIFKTK	SYFKIFKTK
LGRGASTFK	LGRGASTFK
RSIVRIIGK	RSIVRIIGK
ITKEDLIQK	ITKEDLIQK
SAPKGSVL	SA-PKGSVL
RVKDFFKNA	RVKDFFKNA
KVKDGQLTVGL	KVKDGQLTV
KYNWSAKAK	KYNWSAKAK
AYKKQFSQY	AYKKQFSQY
KSKSIFWNL	KSKSIFWNL
KFKFPGRQK	KFKFPGRQK
ATKEILAQK	ATKEILAQK
VTYVPVTTFK	TYVPVTTFK
IMHDVIKKVK	IMHDIKKVK
SQIQEQRIMK	QIQEQRIMK
KVKEFFEKL	KVKEFFEKL
RYIEVFREK	RYIEVFREK
VGPPGRSSL	VGPPGRSSL
QVFEKSPLRVK	QVFEKSPLR
AVLGTHKLK	AVLGTHKLK
GTKDLIREV	GTKDLIREV
QVHPDTGISSK	QVHPTGISS
TTKKIVLRL	TTKKIVLRL
GQRPTQPVY	GQRPTQPVY
RWKLSQIRK	RWKLSQIRK
RIREGYLVKK	RIREGYLVK
ASDPNVSKKLK	ASDPNVSKK
SFKPGDVIHYV	SFKPDVIHY
KTKDLYRDL	KTKDLYRDL
RVRNRVNFR	RVRNRVNFR
RMHQAIERF	RMHQAIERF
AQYEDIAQK	AQYEDIAQK
RTKNFIFRTK	RTKNIFRTK
GGISETRIEK	GISETRIEK
IVRGAVVEK	IVRGAVVEK
MAPLKMLAL	MAPLKMLAL
RGYYRYYNK	RGYYRYYNK
LQRPPVVSK	LQRPPVVSK
KYWQLPKEK	KYWQLPKEK
RLLDQRYGK	RLLDQRYGK
LVLPSPRPYV	LVLPPRPYV
SVPEAQSAL	SVPEAQSAL
RTIDKKFYK	RTIDKKFYK
SVRPAVLQV	SVRPAVLQV
YAKDIGFIKK	YAKDGFIKK
RVKQMFASR	RVKQMFASR
RIRKEPPVY	RIRKEPPVY
AFKISKIYK	AFKISKIYK
AVRPKVLMR	AVRPKVLMR
SVPGRAVRP	SVPGRAVRP
RTLYIQGERRL	RTLYQGERR
ATYERVVYK	ATYERVVYK
RLKPTFISK	RLKPTFISK
RFFDKVIEK	RFFDKVIEK
KSVLTDPAKLK	SVLTPAKLK
IVKQDSLVINL	KQDSLVINL
ATRKLALQK	ATRKLALQK
SLKADSINK	SLKADSINK
SSPLVGRPAK	SSPLGRPAK
LFKPPQPPA	LFKPPQPPA
SVKEIYNEK	SVKEIYNEK
KSRPPAPEL	KSRPPAPEL
STSRDFKIK	STSRDFKIK
KQRQEWEVK	KQRQEWEVK
AYVDLDRQLK	AYVDDRQLK
VEHSDLSFSK	HS-DLSFSK
LQKGEANIFTK	KGEANIFTK
VTRISSPQV	VTRISSPQV
RLGPPKRPPR	RLGPKRPPR
GTLEQWIEK	GTLEQWIEK
KTKEAVLLLK	KTKEVLLLK
ILKGIPIKK	ILKGIPIKK
VVRNPIIEK	VVRNPIIEK
SWRDGQKLVKK	SWRDQKLVK
RVKGVTIVK	RVKGVTIVK
ALKKLILSK	ALKKLILSK
VTLTGGFRRGK	TLTGFRRGK
RVNKPPYPK	RVNKPPYPK
SFKNVQQQL	SFKNVQQQL
ILIQNRAGK	ILIQNRAGK
HVAAIGPRFK	HVAAGPRFK
ITKPLRPLGK	ITKPRPLGK
KLFSEKRVEL	KLFSKRVEL
IWKNREPLVK	IWKNEPLVK
RVFSILKKHK	RVFSLKKHK
KSQLVRVSK	KSQLVRVSK
KTRLDAPRL	KTRLDAPRL
QIIPTEEKPYK	IIPTEKPYK
SSKPVTITV	SSKPVTITV
NAPWAVTSL	NAPWAVTSL
RVREKPPWR	RVREKPPWR
VYVKNFGRRK	YVKNFGRRK
VGKSSFINK	VGKSSFINK
AVRTSIVEK	AVRTSIVEK
HTQPSYRFK	HTQPSYRFK
KVWVPKQK	KV-WVPKQK
KVKSAFLLQNL	KVKSAFLLQ
KTTILYKLK	KTTILYKLK
RQRGINMRY	RQRGINMRY
KLKEGGLIDK	KLKEGLIDK
AVRGSNPHL	AVRGSNPHL
HVVNEPRIFK	VVNEPRIFK
AVNNIRLIK	AVNNIRLIK
GVKAWTPTK	GVKAWTPTK
LVRNIYKRK	LVRNIYKRK
IMNYIIGKNK	IMNYIGKNK
AYYPSSFPK	AYYPSSFPK
SSSTNPFRPQK	STNPFRPQK
RSYSDPPLK	RSYSDPPLK
KVKEFLSTL	KVKEFLSTL
YILTHKRILK	ILTHKRILK
RFVSVSKLK	RFVSVSKLK
KVKDILSKVQK	KVKDSKVQK
AILGTGRLLK	AILGGRLLK
RSRDFLVVNK	RSRDLVVNK
RLFDTPHTPK	RLFDPHTPK
LYKYFPKSEK	LYKYPKSEK
EGSYLAHTQGK	SYLAHTQGK
ALRAVYRLK	ALRAVYRLK
KVKAFIVTL	KVKAFIVTL
NSSRKFLQR	NSSRKFLQR
KISPYYRTK	KISPYYRTK
RVQLKYAAK	RVQLKYAAK
RVLSKAFSRLK	LSKAFSRLK
IVREIENIEK	IVREENIEK
IIQSIRMGM	IIQSIRMGM
AVKQSILAK	AVKQSILAK
GSVFRAHVK	GSVFRAHVK
KGLEGERPARL	KGLEERPAR
RAKNWVKEL	RAKNWVKEL
TYIYFKRLK	TYIYFKRLK
LGLDVERVNK	LGLDERVNK
IYKTPPGIQK	IYKTPGIQK
STLPRISLK	STLPRISLK
KYLDIHERMGK	KYLDIHERM
KVKDLRQYL	KVKDLRQYL
KWKDIELEKM	KWKDIELEK
SSGVPNPPK	SSGVPNPPK
VLNTNIDGRRK	NTNIDGRRK
KTKESSEYL	KTKESSEYL
GVMFGDRPLK	GVMFDRPLK
STNPFRPQK	STNPFRPQK
SVRDPSPEA	SVRDPSPEA
ITQENLGRVK	ITQELGRVK
TTKAVVSPPK	TTKAVSPPK
HARLAPPSL	HARLAPPSL
RYNDLMKKK	RYNDLMKKK
HFLQQPRPLM	HFLQQPRPL
KQLTSHPWK	KQLTSHPWK
QTQELRHLK	QTQELRHLK
RVRDDVAEY	RVRDDVAEY
LYWSHPRK	LY-WSHPRK
KVKNFAQLTV	KVKNAQLTV
VLTVINQTQK	LTVINQTQK
KVQPPGPVK	KVQPPGPVK
RLFPGFRPAV	RLFPFRPAV
LDKPELGPVIL	LDKPLGPVI
TYLEAHRIVK	TYLEHRIVK
KTKSLNKLLY	KTKSLNKLL
PIRLLAAAA	PIRLLAAAA
AAPEGVPL	AA-PEGVPL
RTIELDGKRIK	RTIEDGKRI
VAPRSGLAA	VAPRSGLAA
KTLDKAREKL	KTLDKAREK
RAYPHVFTK	RAYPHVFTK
GTKKRVITL	GTKKRVITL
RIKYVGAIEK	RIKYGAIEK
RVLDALVAREK	RVLDVAREK
VQFIGRESK	VQFIGRESK
SRKLAYRPPK	SRKLYRPPK
KYIDKTIRVK	KYIDTIRVK
SAPYGRITL	SAPYGRITL
KTKFPAEQYY	KTKFPAEQY
RVKDQPLSL	RVKDQPLSL
SVQEGIKFK	SVQEGIKFK
KFIEIAARKK	KFIEAARKK
RTMPLLSLHSR	RTMPLSLHS
TIIDTKGVTAL	TIIDKGVTA
TEELAYLK	TE-ELAYLK
AVQRTLLEK	AVQRTLLEK
HTFEQIPSRQK	HTFEQIPSR
RSYPVTEQRVK	SYPVEQRVK
VYRPPPKVK	VYRPPPKVK
RTPSFLKKNK	RTPSLKKNK
RLREFWMRY	RLREFWMRY
RSKSYELIRKI	RSKSELIRK
ASRQAPPHI	ASRQAPPHI
VLVGGSTRIPK	LVGGTRIPK
RINFYKKTYK	RINFKKTYK
YLPDGTASL	YLPDGTASL
AFFTRPFYK	AFFTRPFYK
KYKGDSTIREL	KGDSTIREL
RSWYLTWKYK	RSWYTWKYK
RSRENFLSKL	RSRENFLSK
TVTEKPEVIDA	TVTEKPEVI
KYVGSRPIKL	KYVGSRPIK
LFHPSNVEM	LFHPSNVEM
VLSTLSGRPVK	STLSGRPVK
KKERQILPVL	KERQILPVL
VSPYTEIHL	VSPYTEIHL
SSRPASLGY	SSRPASLGY
KLRPPGAEK	KLRPPGAEK
KTNLTSVTK	KTNLTSVTK
TFRVKNPDK	TFRVKNPDK
KTYEVSLREK	KTYESLREK
RVKTFQENL	RVKTFQENL
AQRPSSPAL	AQRPSSPAL
KTHMPFQK	KT-HMPFQK
RWLVIDRKVY	RWLVDRKVY
ASNPLLLKRRK	ASNPLKRRK
VVKPDQLIKRR	VVKPDQLIK
GTLERGILK	GTLERGILK
KSFGELVHK	KSFGELVHK
GSRPPGLSK	GSRPPGLSK
SVQKPKFPK	SVQKPKFPK
EITTERPKK	EITTERPKK
KSYSFIARMK	KSYSIARMK
GSLFLRTPK	GSLFLRTPK
RTKSAFSNL	RTKSAFSNL
RVKLPSGSK	RVKLPSGSK
AVLHEERFLK	VLHEERFLK
QVAPEKPVK	QVAPEKPVK
RWKPFQQDV	RWKPFQQDV
GFWDPIGRYK	GFWDIGRYK
SGPGPAAAL	SGPGPAAAL
RYRPGTVAL	RYRPGTVAL
MDGSFSVKPLK	GSFSVKPLK
ATSPDFDGKLK	TSPDDGKLK
RIFQGTRIVK	RIFQTRIVK
ITKPKVISK	ITKPKVISK
RTVDLPKSPK	RTVDPKSPK
LAKLPMPKIHY	KLPMPKIHY
RILMEHIHK	RILMEHIHK
GTIKKINILK	TIKKINILK
IVKLKHFEK	IVKLKHFEK
AVKAIIYQY	AVKAIIYQY
DSYVGDEAQSK	SYVGEAQSK
HYALPLGRKK	YALPLGRKK
RVLPEFKKK	RVLPEFKKK
SVRLPPITKF	SVRLPPITK
KVKTPEMIIQK	KTPEMIIQK
RFRDASLVFK	RFRDSLVFK
ASRPFASVNV	ASRPASVNV
VLDTPGPPV	VLDTPGPPV
NAPLVHATL	NAPLVHATL
RAFSFSKTPK	RAFSSKTPK
ILLPKRPPK	ILLPKRPPK
VTHRPPLSPK	VTHRPLSPK
GGNFGFGDSR	GGNFFGDSR
KGKYKFLQK	KGKYKFLQK
HTYLLIVRTK	TYLLIVRTK
ALKTGIVAK	ALKTGIVAK
TTKNVQQTV	TTKNVQQTV
QSVQVFGRKK	SVQVFGRKK
KIRPYWKNY	KIRPYWKNY
RIIKEVQKRYK	IIKEQKRYK
VYKNVILQV	VYKNVILQV
RVKPYIIDL	RVKPYIIDL
KITDTFKVK	KITDTFKVK
RGYWGNKIGK	GYWGNKIGK
KYKEETIEKM	KYKEETIEK
SRAPITSSER	RAPITSSER
KVRKIGELVRY	KVRKIGELV
AQNGQLFGRFK	NGQLFGRFK
KLLDVVHPAA	KLLDVHPAA
KSKVWQDGILK	KVWQDGILK
RFLHSYDLK	RFLHSYDLK
RIHPEGPPLK	RIHPGPPLK
KVRDKLNNL	KVRDKLNNL
AIKGMHIRK	AIKGMHIRK
KVRIQTQPGY	KVRITQPGY
AQRGLAVLK	AQRGLAVLK
RFRDASLVFKV	RFRDSLVFK
KMHVPAPKL	KMHVPAPKL
TRIPKIQK	TR-IPKIQK
KAKSPAPGL	KAKSPAPGL
RTHTGERPYY	RTHTERPYY
STRLKYAVK	STRLKYAVK
KLKEEVINK	KLKEEVINK
SVRPPKKSWK	SVRPKKSWK
IHIKIRVPK	IHIKIRVPK
STTTGHLIYK	STTTHLIYK
SAPDKSLEL	SAPDKSLEL
RQSPLPPQK	RQSPLPPQK
AARAIAVQK	AARAIAVQK
HSLSGRPLK	HSLSGRPLK
SWLDVRHIEK	SWLDRHIEK
ATKDAGTIAGL	ATKDAGTIA
ASRPPPPNSV	ASRPPPNSV
YAPKGSSL	YA-PKGSSL
RYVSVRDFK	RYVSVRDFK
GSRLIKVHL	GSRLIKVHL
RLLGRSRPQL	RLLGSRPQL
KVLKTLNV	KV-LKTLNV
AGLQFPVGR	AGLQFPVGR
AFRSTPPGM	AFRSTPPGM
RLKQQTIPLK	RLKQTIPLK
KSQIPLSKIK	KSQILSKIK
RLKENQISV	RLKENQISV
RVKEKIIKKF	RVKEKIIKK
KVKSLNDITAK	KSLNDITAK
KVREEFKEL	KVREEFKEL
GSTRIPKIQK	STRIPKIQK
KVKYLPQQQK	KVKYPQQQK
KTKSVVLQL	KTKSVVLQL
AYKDKDISFFK	KDKDISFFK
KTKGFHTTI	KTKGFHTTI
STRPVVYQV	STRPVVYQV
RFKDELDIMK	RFKDLDIMK
VTKGLYIAK	VTKGLYIAK
GYSFTTTAER	YSFTTTAER
RVKEGSKIRNL	RVKEGSKIR
NVEIDPEIQ	NVEIDPEIQ
SVNGKVLSK	SVNGKVLSK
KSQEIFLNL	KSQEIFLNL
ATRPVTPPR	ATRPVTPPR
GMRPPHPGM	GMRPPHPGM
AAPSAAREL	AAPSAAREL
RVYPESIPRK	RVYPSIPRK
RAMIIAERQK	RAMIAERQK
GTLKIIDRKK	TLKIIDRKK
KQRLQQLFK	KQRLQQLFK
MAPERVASL	MAPERVASL
KAPEATVTL	KAPEATVTL
KSRPAHLAVFL	KSRPAHLAV
SIPEKNRPLK	SIPENRPLK
RQKSAALIIQK	KSAALIIQK
KVKAEISFV	KVKAEISFV
KTRPPVRLV	KTRPPVRLV
STFSGGRIPK	STFSGRIPK
GSHFPGPFM	GSHFPGPFM
RNKAENLLRGK	KAENLLRGK
ATKPLYVAL	ATKPLYVAL
RTKALIEKL	RTKALIEKL
AMKKVFRVY	AMKKVFRVY
KTMDVSKVKLK	KTMDVSKVK
STREWAIKK	STREWAIKK
AVKNGDYITVK	AVKNDYITV
SSFLIKRNK	SSFLIKRNK
RFKEKVEETLK	RFKEVEETL
SVKEDVHLK	SVKEDVHLK
QIKPFYTVK	QIKPFYTVK
KIKEIAVTVK	KIKEAVTVK
KAPVTKVAA	KAPVTKVAA
KQRDSEIMQQK	KQRDSEIMQ
KFLNILEKPKK	KFLNLEKPK
ALKENSYVK	ALKENSYVK
ATRRVHPAL	ATRRVHPAL
KTFTGHREWV	KTFTHREWV
KGVTLGFRYK	GVTLGFRYK
QLLEVKRRMK	QLLEKRRMK
RVREITENL	RVREITENL
VQKAIPMYK	VQKAIPMYK
RQQIKELEKLK	QIKELEKLK
AVKPFGLKV	AVKPFGLKV
KTKVPEVTK	KTKVPEVTK
SVRAETVPK	SVRAETVPK
KYVDTNLQK	KYVDTNLQK
KTKDIVNGL	KTKDIVNGL
RYTDVSTRYK	RYTDSTRYK
KVKVTQELK	KVKVTQELK
QVKSLTQKV	QVKSLTQKV
TTSYLIGRQK	TSYLIGRQK
AAPGVDLT	AA-PGVDLT
TILLPKRPPK	ILLPKRPPK
KLYEKKLLK	KLYEKKLLK
SVASLVGRSK	SVASVGRSK
AFKELQSTFK	AFKEQSTFK
KYKSGEQILRL	KYKSEQILR
HQFPAKRPRL	HQFPKRPRL
ILRPSGPGA	ILRPSGPGA
KLFNKFIGK	KLFNKFIGK
FSKKPSLIK	FSKKPSLIK
KKEIVAFLK	KKEIVAFLK
STRPVYLKKL	STRPVYLKK
LYKDVMQETI	LYKDMQETI
RFSDIQIRRLK	RFSDQIRRL
RTPGPRPPR	RTPGPRPPR
KSKITHPVY	KSKITHPVY
KFKEEVNHY	KFKEEVNHY
KVKYLPQQQKK	KVKYPQQQK
HQQLYWSHPRK	QLYWSHPRK
RSRDFSAMTK	RSRDSAMTK
AVRIPGGPA	AVRIPGGPA
KMKEALLSIGK	KMKELSIGK
RLKELLRAK	RLKELLRAK
RYRAITSAY	RYRAITSAY
RLKPLAIGK	RLKPLAIGK
KMKETLQNV	KMKETLQNV
TIKEGSQLK	TIKEGSQLK
RFKNKITVV	RFKNKITVV
TTSAIQNRFK	TTSAQNRFK
AYRQGHFTYK	AYRQHFTYK
HVHEPNPLR	HVHEPNPLR
KFYGVKFRNK	KFYGKFRNK
ATKESGLISTK	ATKELISTK
TVKKPGPNL	TVKKPGPNL
KQKFVLKVQK	KQKFLKVQK
QARPPGIYK	QARPPGIYK
RQFPGSHRVK	RQFPSHRVK
KINEIKKLLK	KINEKKLLK
SVFAEERNLK	SVFAERNLK
RVFLRAINK	RVFLRAINK
KVKSYIHEV	KVKSYIHEV
TYKYEMINK	TYKYEMINK
STKGQSINV	STKGQSINV
KSRQTPPLA	KSRQTPPLA
LVVMPGAGK	LVVMPGAGK
AVKLGAVPK	AVKLGAVPK
KTFEGNLTTK	KTFENLTTK
RVRFFPYNY	RVRFFPYNY
KVLGVQRPLL	KVLGQRPLL
KLHGVNINV	KLHGVNINV
KALSDLGRYK	ALSDLGRYK
KYMPHAVLK	KYMPHAVLK
KNYIQIERQK	NYIQIERQK
KYIDVVINK	KYIDVVINK
SVITIVKSK	SVITIVKSK
RVKTEALIRYL	RVKTALIRY
KIHPFIRK	KI-HPFIRK
RIHGVGFKK	RIHGVGFKK
STHGTFLNK	STHGTFLNK
RTPSFLKKSK	RTPSLKKSK
KNKPEWFFK	KNKPEWFFK
RTKKLSDYVGK	RTKKLSDYV
SVKNFQIVHK	SVKNQIVHK
KTRPGLLNSKL	KTRPLLNSK
KYKDKIKTL	KYKDKIKTL
KIKELDHNISK	KELDHNISK
RMMKNRPFM	RMMKNRPFM
RVIAIRPIR	RVIAIRPIR
YENEVALRQ	YENEVALRQ
IAGQVAAANK	AGQVAAANK
ATLEETLVKKK	ATLEETLVK
KFKAQVQLNK	KFKAVQLNK
KVRQRAVAL	KVRQRAVAL
ATQPSWLGK	ATQPSWLGK
KTLDAEVVEK	KTLDEVVEK
TTFGSRVNV	TTFGSRVNV
VQRNVNIFK	VQRNVNIFK
KARIPAPLL	KARIPAPLL
KTYVIKRVK	KTYVIKRVK
RTKYIDDTVK	RTKYDDTVK
AQQLVQRVPK	AQQLQRVPK
AVRKPIVLK	AVRKPIVLK
KAKIKFIIK	KAKIKFIIK
SVWNFLKRHK	SVWNLKRHK
ATRRPPPARV	ATRRPPPAR
KLTFISGRTK	KLTFSGRTK
RVWDAEHPGL	RVWDEHPGL
VAPAAASSL	VAPAAASSL
KTAMSTPHV	KTAMSTPHV
RQFGPYRLNY	RQFGYRLNY
RQFWTRTKK	RQFWTRTKK
SIKKIFYMK	SIKKIFYMK
SLVNLGGSK	SLVNLGGSK
RTLLKKVWK	RTLLKKVWK
KSILQERVKK	SILQERVKK
VYKPPALKK	VYKPPALKK
RVQQHIESKLL	RVQQHIESK
EITALAPSTMK	TALAPSTMK
SAPSSDKPL	SAPSSDKPL
RMFLSFPTTK	RMFLFPTTK
AFKELLKEK	AFKELLKEK
RFKDIFQEI	RFKDIFQEI
VFRGPVLPK	VFRGPVLPK
KIKEIAVTVKK	KIKEAVTVK
RIKDEFQFL	RIKDEFQFL
KTITHPRL	KT-ITHPRL
KSIQSGPLK	KSIQSGPLK
RVKEIYNTY	RVKEIYNTY
KLKFIDPKKIK	KLKFIDPKK
TVTGAKPLK	TVTGAKPLK
TIQSGEQPYK	TIQSEQPYK
RLVDIKKEK	RLVDIKKEK
ATRIFASNLK	ATRIASNLK
DVNAAIATIK	DVNAIATIK
RLKPFYLVPK	RLKPYLVPK
STRPVYLKK	STRPVYLKK
GVLQGIRPGK	GVLQIRPGK
LIKDGLIIRK	LIKDLIIRK
RSKIKSFVK	RSKIKSFVK
SIKDVFEKK	SIKDVFEKK
SVFDFQKAYK	SVFDQKAYK
RYWTKTIEK	RYWTKTIEK
RVKEEVRKL	RVKEEVRKL
RVRDIQKQV	RVRDIQKQV
AVRPQSVFV	AVRPQSVFV
HYLPAEILQKK	HYLPEILQK
VSVAARMLK	VSVAARMLK
SSPQPGSAL	SSPQPGSAL
KYKVKLVEK	KYKVKLVEK
MWKQLSHIKK	MWKQSHIKK
KAPAPRPSL	KAPAPRPSL
KTHLPPPAL	KTHLPPPAL
ATFLKKVAK	ATFLKKVAK
QQKQEWLSK	QQKQEWLSK
RTQNVLGEK	RTQNVLGEK
RFYDLSSKYY	RFYDSSKYY
SFLDISRPKM	SFLDISRPK
KSKSMDAIRSL	KSMDAIRSL
RILSGVVTK	RILSGVVTK
KTRLINQVL	KTRLINQVL
MFLSFPTTK	MFLSFPTTK
KVLEFERVYL	KVLEERVYL
AYRPISASV	AYRPISASV
KTKDVTVWRK	KTKDTVWRK
RVIQVKKMK	RVIQVKKMK
KSNGTIIHV	KSNGTIIHV
PTEQPQAWAV	TEQPQAWAV
LGLDIKRQEK	LGLDKRQEK
ALRESWKTK	ALRESWKTK
QTQPIYLAK	QTQPIYLAK
HTKSFQLAK	HTKSFQLAK
KSKNILFVITK	KSKNFVITK
SLKDLVKEK	SLKDLVKEK
LVKPKIVKK	LVKPKIVKK
ADGRPAPPMK	DGRPAPPMK
RLKPTNPAAQK	RLKPTNPAA
KVKITTENV	KVKITTENV
KVLELQSPPK	KVLEQSPPK
ITREAQVNV	ITREAQVNV
ATAPPSPLK	ATAPPSPLK
SFKTVIKKK	SFKTVIKKK
KVKPPHGFQK	KVKPHGFQK
RVKSEYMRL	RVKSEYMRL
STKFWIKQK	STKFWIKQK
ASFSKRIQK	ASFSKRIQK
ATRFDQVMK	ATRFDQVMK
RVQDLEQKMK	RVQDEQKMK
KQKEVEQLIK	KQKEEQLIK
KFMDKKLSLK	KFMDKKLSL
KTKFAKVPLK	KTKFKVPLK
RLSDVLKRK	RLSDVLKRK
KTKEGYYYR	KTKEGYYYR
AVQKAIPMYK	VQKAIPMYK
RMQSLSLNK	RMQSLSLNK
KYKSVYKNV	KYKSVYKNV
AYKNVKFVLK	AYKNKFVLK
HSKVKVIYK	HSKVKVIYK
TSKKPNLILNV	TSKKPNLIL
KVFHAERIVRK	KVFHERIVR
AIRVTNPNA	AIRVTNPNA
VILPPRPPK	VILPPRPPK
AQYEDIAQKS	AQYEDIAQK
RQIPYTMMK	RQIPYTMMK
AFKNHVFNV	AFKNHVFNV
KLKGDDLQAIK	KLKGDDLQA
ASFDKAKLK	ASFDKAKLK
SVKDPSPLY	SVKDPSPLY
AVHPPGVSK	AVHPPGVSK
KYMAEVKKYK	KYMAVKKYK
RSKTVILVK	RSKTVILVK
KLQTPNTFPK	KLQTNTFPK
KTLPKIVGRTK	KTLPKIVGR
GTYHFLRTQK	TYHFLRTQK
ATKPMTYVV	ATKPMTYVV
KFREIQQEL	KFREIQQEL
TTVPRRLGPK	TVPRRLGPK
VIKDKFIRR	VIKDKFIRR
KVKDLVARI	KVKDLVARI
KTLAYRGFIFK	LAYRGFIFK
IFQEPTEPK	IFQEPTEPK
IVQPSRPVK	IVQPSRPVK
KTKSFFDNI	KTKSFFDNI
RLKDIGPEVVK	RLKDIGPEV
RTKRDWLVKQ	RTKRDWLVK
AVKTKILIK	AVKTKILIK
YIYDGELVSK	YIYDELVSK
SVLNLVIVKK	SVLNLVIVK
KTRIPPRTY	KTRIPPRTY
LQIDNARLA	LQIDNARLA
IQIERQKILK	IQIEQKILK
ASKTTTTIIPK	KTTTTIIPK
KVKDEYMVAEY	KVKDEYMVA
ATNPSFDGRLK	ATNPDGRLK
RQLEEKDRVLK	RQLEKDRVL
RLIQMRPFL	RLIQMRPFL
SAPVGVTAL	SAPVGVTAL
AVKEKAIQV	AVKEKAIQV
SFQDNLHNRKK	SFQDLHNRK
QITVNDLPVGR	TVNDLPVGR
TYDDATKTFT	TYDDATKTF
KVKDILSKV	KVKDILSKV
KSKAITPKRL	KSKATPKRL
SVKSITNPRY	SVKSTNPRY
RQFFDERWSK	QFFDERWSK
KAKEPPFVRK	KAKEPFVRK
SSHLPPPPK	SSHLPPPPK
DQVANSAFVER	VANSAFVER
AAPEGKRSL	AAPEGKRSL
AVKDIAINL	AVKDIAINL
RTKELGYTVK	RTKEGYTVK
SSFPLPGRKNK	SFPLGRKNK
RLKEAEEERLK	RLKEEEERL
KTRNVPVRL	KTRNVPVRL
AVIKGRPSKL	AVIKGRPSK
ITKGVDYIHSK	KGVDYIHSK
KQQNPRLVYV	KQQNPRLVY
ATKQMHFRV	ATKQMHFRV
GLKKFYITK	GLKKFYITK
VTNPDIAAKKK	VTNPIAAKK
RSLFLLGKHK	RSLFLGKHK
KWNTIPLRNK	KWNTPLRNK
STIPPELVKQK	STIPPELVK
EVLKVIRTGK	VLKVIRTGK
STLSGRPVK	STLSGRPVK
IGVSPGRPGK	GVSPGRPGK
RVIDILRGK	RVIDILRGK
IVRDHWVHV	IVRDHWVHV
RAFYSWGRRK	AFYSWGRRK
AVRVPAPSI	AVRVPAPSI
RTAAPSVRPEK	AAPSVRPEK
LRVDPVNFK	LRVDPVNFK
ATRSITNNV	ATRSITNNV
GSNLRVHFK	GSNLRVHFK
KSKPVAFAV	KSKPVAFAV
GVYSALRALK	GVYSLRALK
SFRYNGLIHRK	RYNGLIHRK
KSLPAEINRMK	KSLPAEINR
RVLEDRALK	RVLEDRALK
GMRSYYYGK	GMRSYYYGK
RYIPFTHGK	RYIPFTHGK
QFIPKGRPPKL	QFIPGRPPK
RLIQIAARKK	RLIQAARKK
TTKNLFLIK	TTKNLFLIK
RTKASVHTL	RTKASVHTL
KYIQDFQREK	KYIQFQREK
HLPETKFSEL	HLPEKFSEL
QLKAEVIAK	QLKAEVIAK
RIKSNQISKL	RIKSNQISK
YVKLSVGKK	YVKLSVGKK
NVPVGKVL	NV-PVGKVL
RYLDSSVRNSK	RYLDVRNSK
RSKDEKILHIK	RSKDKILHI
ATNYITRNK	ATNYITRNK
QTIQEIRHLK	TIQEIRHLK
KTFANRVNNLK	KTFARVNNL
KYLTKKYLK	KYLTKKYLK
ELPAPGLALDK	ELPAPGLAL
KVKSSVIGA	KVKSSVIGA
AVLKDRVNK	AVLKDRVNK
RYYNKYINVK	RYYNKYINV
ATRPAGQNL	ATRPAGQNL
FSIPEKNRPLK	SIPENRPLK
HSFYPTPAL	HSFYPTPAL
STKPSSIISTK	STKPIISTK
RLKDVVRAY	RLKDVVRAY
IARPTPPQA	IARPTPPQA
KLKAWNDIKK	KLKANDIKK
KLHFIFRHK	KLHFIFRHK
KNKQKFVLK	KNKQKFVLK
QSMFTCKTEV	SMFTCKTEV
KVKFEERYK	KVKFEERYK
RTRDYASLPPK	RTRDSLPPK
RVRQPPPRPFL	RQPPPRPFL
RLRAEPPNKL	RLRAEPPNK
RYRPGTVALR	RYRPGTVAL
KTRGIFETK	KTRGIFETK
KVAPAPAVVK	KVAPPAVVK
KERDFYFGK	KERDFYFGK
TYFQAKIRALK	TYFQKIRAL
QSRISPIQK	QSRISPIQK
TSRSIIRNV	TSRSIIRNV
RIKGQEFIRQV	KGQEFIRQV
RLFTSEKMVK	RLFTEKMVK
LSTLSGRPVK	STLSGRPVK
ALLDIIRSLK	ALLDIRSLK
RLQEKRFIQK	RLQERFIQK
KTRGIFETKF	KTRGIFETK
KVFNQPKAK	KVFNQPKAK
VIHPPQPPK	VIHPPQPPK
TLKGKLVQK	TLKGKLVQK
VVPEPGQPL	VVPEPGQPL
GYIATPRVWK	GYIAPRVWK
GSRFYFWTK	GSRFYFWTK
SLLELHKRRK	SLLEHKRRK
KLKDYLRSK	KLKDYLRSK
NYIEFTRILK	NYIETRILK
KTQEPFSVRNK	KTQESVRNK
KTRAPGDHQFY	KTRAPGDHQ
VQRTQAPAV	VQRTQAPAV
KVLDAIIQEK	KVLDIIQEK
KAWAIFKGK	KAWAIFKGK
TVRDPAWQK	TVRDPAWQK
GVRPPAPSL	GVRPPAPSL
HLATRKFLEK	LATRKFLEK
KTKDVEILHL	KTKDEILHL
RQYAKDIGFIK	YAKDIGFIK
LWKDVGERQK	LWKDGERQK
RTRQLFVRL	RTRQLFVRL
RMKDPTFLGK	RMKDTFLGK
IIKDFTKQK	IIKDFTKQK
RFSPYYRTK	RFSPYYRTK
RSSALLARTK	RSSALARTK
AVLDFVKQK	AVLDFVKQK
GTKEGYLTK	GTKEGYLTK
AGKTTWVTK	AGKTTWVTK
KTKPFQLQL	KTKPFQLQL
RIKRALDLNLK	RIKRLDLNL
KTIDKKTFYK	KTIDKTFYK
SVRLPPITK	SVRLPPITK
VTKPVQIQK	VTKPVQIQK
HSLEASRVPK	HSLESRVPK
AQQKVTLPK	AQQKVTLPK
KVISGIAREK	KVISIAREK
HLKDVIVGK	HLKDVIVGK
KVFVGRFK	KV-FVGRFK
ASRVVQVVK	ASRVVQVVK
GTKMTVNNL	GTKMTVNNL
KSFLTVPQRKK	SFLTPQRKK
IQKPADLARHL	IQKPADLAR
YTRPTPVQK	YTRPTPVQK
IGKPAHLIVSL	IGKPAHLIV
VARPAPVAV	VARPAPVAV
GTKSTWPQK	GTKSTWPQK
LYQQQGRLDK	YQQQGRLDK
RTLDAKMPRK	RTLDKMPRK
IFQPPSPPK	IFQPPSPPK
VVSSVTTKVK	VVSSTTKVK
ISPTGHSL	IS-PTGHSL
RLKEKKLVKEV	RLKEKKLVK
GVHPPAPGV	GVHPPAPGV
KLNDLLKEK	KLNDLLKEK
RYQTLYARFK	RYQTYARFK
KQLGEGLRPAL	QLGELRPAL
QVQKGPLKLK	VQKGPLKLK
KTWTTADFRTK	TT-ADFRTK
SVKPSTVVK	SVKPSTVVK
SVKGLLTEK	SVKGLLTEK
KIIDRKKHIFK	KIIDRKKHI
KVRAGGPGL	KVRAGGPGL
RYMFSRPFR	RYMFSRPFR
KSKPIFWNL	KSKPIFWNL
ALKNPPINTK	ALKNPINTK
KVLDHKDRVLK	KVLDKDRVL
RVKAVRILA	RVKAVRILA
ASKPPPISK	ASKPPPISK
KVSQVIMEK	KVSQVIMEK
KLKAIVASK	KLKAIVASK
ASRGPGPSL	ASRGPGPSL
LGRVRDGP	LG-RVRDGP
KVKEPPILRV	KVKEPILRV
GDRGDPPGDLR	RGDPPGDLR
KTIDGHINL	KTIDGHINL
KVKLAVLKYYK	KVKLAVLKY
SIFDGRVVAK	SIFDRVVAK
AVKESTITL	AVKESTITL
RIFDLGRKKAK	RIFDLGRKK
AAPATRAAL	AAPATRAAL
IAKAKFIVK	IAKAKFIVK
GSLGSRPPL	GSLGSRPPL
AVRPASLNL	AVRPASLNL
RVVLVEKRTK	RVVLEKRTK
VAPVASAL	VA-PVASAL
FRVPTANVS	FRVPTANVS
ASKRPPLRGV	ASKRPLRGV
RQIEIPKVSK	RQIEPKVSK
KLKDDEVAQLK	KLKDEVAQL
GLLDKKSLK	GLLDKKSLK
KVLALQARKK	KVLAQARKK
RLRDPAQQV	RLRDPAQQV
AVNLLDRFLSK	NLLDRFLSK
ASRPNSPQL	ASRPNSPQL
ATRSSAVRL	ATRSSAVRL
AVKGKYKFLQK	KGKYKFLQK
SFSVKPLK	SF-SVKPLK
IREEYPDR	IR-EEYPDR
TMKGFEYILAK	KGFEYILAK
HLGDFHRTYK	HLGDHRTYK
STKKFWIQKL	STKKFWIQK
RQRGIAVEV	RQRGIAVEV
RTLTQIKEK	RTLTQIKEK
YAPSGNFV	YA-PSGNFV
VVKPDQLIK	VVKPDQLIK
RYNGLIHRK	RYNGLIHRK
ITILLPKRPPK	ILLPKRPPK
STRIPKIQK	STRIPKIQK
NIRPLFINK	NIRPLFINK
RLFVGSIPK	RLFVGSIPK
SFKPLENAVFK	KPLENAVFK
RTLEFNRRQK	RTLENRRQK
SVSPASTLK	SVSPASTLK
AGFAGDDAPR	AGFADDAPR
RIREPALLSK	RIREALLSK
SISPYPKVK	SISPYPKVK
RKLAYRPPK	RKLAYRPPK
RVKNAVKYL	RVKNAVKYL
AYKEYISNK	AYKEYISNK
AAPAYSRAL	AAPAYSRAL
SVILKPENIKK	ILKPENIKK
SYKDSTLIMQL	SYKDSTLIM
TVTEKPEVID	TVTEKPEVI
KVKAEVQNL	KVKAEVQNL
RTVTGAKPLK	RTVTAKPLK
VTNNVIRLK	VTNNVIRLK
VISPPTVPK	VISPPTVPK
RTLSKDDVNYK	LSKDDVNYK
RVKEPVKELL	RVKEPVKEL
RTQSIFTRHK	RTQSFTRHK
RIATGSFLK	RIATGSFLK
SIKIKTDSAK	SIKITDSAK
KGFESPRPYKL	KGFEPRPYK
ISRPVGVSK	ISRPVGVSK
GTRPPPTPNA	GTRPPTPNA
IGKENFIEK	IGKENFIEK
AFQQKPPPPPK	QQKPPPPPK
LLKEKFHFK	LLKEKFHFK
TQMVRMILK	TQMVRMILK
SAPTETHSL	SAPTETHSL
KVRITLVTK	KVRITLVTK
SFRYNGLIHR	SFRYGLIHR
ASKTQYFHV	ASKTQYFHV
AYFKRYQVK	AYFKRYQVK
RTIAKRLVL	RTIAKRLVL
RLKYPPFAKK	RLKYPFAKK
GGPGGVGGL	GGPGGVGGL
VNLPINGNGKQ	VNLPNGNGK
NLKSVRELILK	KSVRELILK
IMPTVVRPPK	IMPTVRPPK
DSDSSNPALQV	SS-NPALQV
HSRDSSFRL	HSRDSSFRL
MIRAAPPPL	MIRAAPPPL
KAPGSTSNL	KAPGSTSNL
VARPPPIGA	VARPPPIGA
STSFLEKKVK	STSFEKKVK
SLKTTLKPK	SLKTTLKPK
KISWLKERVK	KISWKERVK
RTRPPSVQV	RTRPPSVQV
KTKHEEILQNL	KTKHEEILQ
RVRQPPPRP	RVRQPPPRP
AFRVPTANV	AFRVPTANV
STKKFWIQK	STKKFWIQK
GGLPERSVSL	GLPERSVSL
RVRDVFEAK	RVRDVFEAK
RTRELPDGTFY	RTREDGTFY
KTIGVKHPEL	KTIGKHPEL
STRFITRPAK	STRFTRPAK
RQKIVVIAK	RQKIVVIAK
KYIDKTIRV	KYIDKTIRV
LMNELRRVPK	LMNERRVPK
ASSGVPNPPK	ASSGPNPPK
AVSSLIRNK	AVSSLIRNK
KVPVEKRVFK	KVPVKRVFK
VVKSVELMSVY	VVKSELMSV
RIKPPWVVK	RIKPPWVVK
RSLGSSPVK	RSLGSSPVK
MQMQVEAERRK	MQVEAERRK
TFKTGSILK	TFKTGSILK
KTRIIDVVY	KTRIIDVVY
RFLEKREPK	RFLEKREPK
KYVGSRPIK	KYVGSRPIK
STFFYPKLK	STFFYPKLK
KTRDEYLSL	KTRDEYLSL
KKFPGIRPYL	KFPGIRPYL
YSKYYKTID	YSKYYKTID
KTKDRDYIDFL	KTKDDYIDF
KTREWAEQL	KTREWAEQL
MLKQLSILK	MLKQLSILK
RLKVLYSQK	RLKVLYSQK
SVRQPSLHM	SVRQPSLHM
RLKSIKNIQK	RLKSKNIQK
KANILTNRYK	KANITNRYK
KINNEIRSVK	KINNIRSVK
RTKAATIIQKY	RTKATIIQK
SFKDFAKSK	SFKDFAKSK
AQFGGKILRK	AQFGKILRK
AAPVSATVL	AAPVSATVL
HEVKKVTL	HE-VKKVTL
RIKPNAITY	RIKPNAITY
SSPQAGSSL	SSPQAGSSL
KTLDEILQEKK	KTLDILQEK
KFLPFKVVEK	KFLPKVVEK
VFQETQKLK	VFQETQKLK
KILAKRINV	KILAKRINV
QPSPTGGLMQR	SPTGGLMQR
QQLYWSHPRK	QLYWSHPRK
GSIPRNIPK	GSIPRNIPK
AVKGKYKFL	AVKGKYKFL
KIREYFQKY	KIREYFQKY
GSYVINGRTK	SYVINGRTK
VFLPQAIRHLK	FLPQIRHLK
KVKKLVVKV	KVKKLVVKV
RIKDEFQLL	RIKDEFQLL
KSRVSPPFK	KSRVSPPFK
AVKDTILQL	AVKDTILQL
FKQYANDNGVD	KQYANDNGV
KGLLIRERLK	KGLLRERLK
QVRVEGPVK	QVRVEGPVK
RLIDQKWQRKK	RLIDKWQRK
QVLFLAGKTK	QVLFAGKTK
RYFALVERRL	RYFAVERRL
AIKAKIMAK	AIKAKIMAK
IIKLAPPPK	IIKLAPPPK
ATAPPAPAY	ATAPPAPAY
HVYRERFPK	HVYRERFPK
RQKTELQQIGK	KTELQQIGK
AYYALTKFK	AYYALTKFK
AVKSESQSLPK	AVKSESQSL
KYWAPHIKK	KYWAPHIKK
IVRMIESRQK	IVRMESRQK
KTRGPGYTQY	KTRGGYTQY
AYKSHFRNV	AYKSHFRNV
ASHISKLPK	ASHISKLPK
AVRIRAPQI	AVRIRAPQI
VVKSSFPEK	VVKSSFPEK
GTRPPHVFA	GTRPPHVFA
QFIPYMKKYK	QFIPMKKYK
GPGAQSALR	GPGAQSALR
YFRDLFIEK	YFRDLFIEK
QTRPPASLK	QTRPPASLK
RLKDELIAK	RLKDELIAK
IVKDASIIHRL	IVKDSIIHR
KERDVFLVK	KERDVFLVK
RTQMPDPKTFK	QMPDPKTFK
SFKEKFVRK	SFKEKFVRK
KTLPFSRSYY	KTLPFSRSY
RSIFIKYKSK	RSIFKYKSK
NVKVDPEIQ	NVKVDPEIQ
TTRNTSPSL	TTRNTSPSL
RIFEPPPPK	RIFEPPPPK
EIFGLHENV	EIFGLHENV
KQKSLYREV	KQKSLYREV
RTRSAIILHL	RTRSIILHL
AVHEAWAGMLK	AVHEAWAGM
RFKVSQVIMEK	KVSQVIMEK
RVQEVPKLK	RVQEVPKLK
QIGPAPPLK	QIGPAPPLK
IAPGVTHEL	IAPGVTHEL
KESYSVYVYK	ESYSVYVYK
KLRGIVSEK	KLRGIVSEK
VLKIMPVQK	VLKIMPVQK
ILLYIQRTK	ILLYIQRTK
YTKDAMPINK	YTKDMPINK
VGVNGFGR	VG-VNGFGR
IVLPLKKPPK	IVLPKKPPK
GTNPGIITK	GTNPGIITK
RSRSLPQPKL	RSRSPQPKL
KAFNQGKIFK	AFNQGKIFK
SILQERVKK	SILQERVKK
GRTGPRAPL	GRTGPRAPL
AGPLRKSSL	AGPLRKSSL
RFQAFVKKK	RFQAFVKKK
FAPYNKPSL	FAPYNKPSL
LVKPVTINV	LVKPVTINV
RYRLPLRVVK	RYRLLRVVK
RTKDTPLSL	RTKDTPLSL
RTIQRPVTM	RTIQRPVTM
RWVELEKPLK	RWVEEKPLK
KTKQVIQGL	KTKQVIQGL
KIKSFVKVY	KIKSFVKVY
RLKQIEEQTK	RLKQEEQTK
RLKEVFQTK	RLKEVFQTK
RWKPASQPTI	RWKPSQPTI
KVLDHFRRK	KVLDHFRRK
KILQLYARKK	KILQYARKK
LSNAPRPLK	LSNAPRPLK
ILKPTSSVK	ILKPTSSVK
AVKEKYAKY	AVKEKYAKY
RSFFHQHYL	RSFFHQHYL
HAKGIVLEK	HAKGIVLEK
RVREIIINA	RVREIIINA
VASRVGSLK	VASRVGSLK
KQIGIIKTNK	KQIGIKTNK
YARLHPRAV	YARLHPRAV
LVRTKTLVK	LVRTKTLVK
AQRDPIIAK	AQRDPIIAK
ATILREILK	ATILREILK
VAPVTHVSV	VAPVTHVSV
SIPILASAL	SIPILASAL
RSNYRVFLK	RSNYRVFLK
KIRLFQPNL	KIRLFQPNL
RIRKLEKLIKK	RIRKEKLIK
SVRGTSFDA	SVRGTSFDA
RTRPALWNK	RTRPALWNK
DGRDGGICIFN	DGRDGGICI
TYDDATKTF	TYDDATKTF
RQKQQLVERLK	KQQLVERLK
KSHFIVALK	KSHFIVALK
VQRNVNVFK	VQRNVNVFK
KVSDLTIPK	KVSDLTIPK
SRDSFLKRVK	RDSFLKRVK
GSNVKIVK	GS-NVKIVK
VTLTSEEEAR	VTLTSEEEA
TLRAASPPR	TLRAASPPR
GTRESAINV	GTRESAINV
STRIPKIQKL	STRIPKIQK
TVLHRIYGK	TVLHRIYGK
RWKPKVAISK	RWKPVAISK
TEKPEVID	TE-KPEVID
AVRPHSAPEY	AVRPSAPEY
RITGRLIHPK	RITGLIHPK
KTTKLYSRFK	TTKLYSRFK
LIRSPSLAK	LIRSPSLAK
IIHEIAVLEL	IIHEAVLEL
KVKTKVIEL	KVKTKVIEL
RTIDRSVFK	RTIDRSVFK
RTKTEDMVSQL	KTEDMVSQL
SAGPPSLRK	SAGPPSLRK
MVKSLMHLGK	MVKSMHLGK
KILDKQKVVK	KILDQKVVK
RIKATVMDV	RIKATVMDV
RYLYYTGRIK	RYLYTGRIK
KGKNIKIISK	KGKNKIISK
SPRPSVPAP	SPRPSVPAP
GTKVIVMEK	GTKVIVMEK
KTKWGTIEV	KTKWGTIEV
KSRVSPPFKQA	KSRVSPPFK
KVKWFYNEY	KVKWFYNEY
RIKFPDNPEK	RIKFDNPEK
ATFARIWYL	ATFARIWYL
GPSSVEDIK	GPSSVEDIK
GHYADSYLKRK	HYADYLKRK
KSRDSFLKR	KSRDSFLKR
FPRKPSAPK	FPRKPSAPK
YRPPPKVK	YR-PPPKVK
RVFTGQAKVK	RVFTQAKVK
TSRPPSMHV	TSRPPSMHV
QAPPPRPPK	QAPPPRPPK
RLYFGERNVK	RLYFERNVK
KLKPYVSYL	KLKPYVSYL
AGTQHSGLTK	GTQHSGLTK
RVWDISGLRKK	RVWDSGLRK
ATLPKNPPPK	ATLPNPPPK
KTKQAWNFL	KTKQAWNFL
RVMGIRVLR	RVMGIRVLR
HSFALLGKKK	HSFALGKKK
RVKPLHYISWL	RVKPHYISW
SSSPVNVKKLK	SSSPVNVKK
SVRDKLLVK	SVRDKLLVK
KMKGDYYRY	KMKGDYYRY
GSFSVKPLK	GSFSVKPLK
RLKGDAWVYK	RLKGAWVYK
KFRSNLPAK	KFRSNLPAK
DGSFSVKPLK	GSFSVKPLK
KSRGPTPPAM	KSRGPTPPA
RLKDKIPNV	RLKDKIPNV
RVQEAVESMVK	RVQEESMVK
ASSPPAIPK	ASSPPAIPK
AMKISFAKK	AMKISFAKK
KLKSFFKEY	KLKSFFKEY
GTKDVVVSV	GTKDVVVSV
KTLEGVITRTK	KTLEGVITR
FVKRQFMNK	FVKRQFMNK
LGKTIVITK	LGKTIVITK
SVKGPELINMY	SVKGELINM
RAKTVVLHI	RAKTVVLHI
HAIPIIKEK	HAIPIIKEK
ATLKDITRRLK	TLKDTRRLK
GTKLPGLLK	GTKLPGLLK
NLKSVNELIYK	KSVNELIYK
IARIPEAFK	IARIPEAFK
KTAVAPIERVK	AVAPIERVK
RVKTNLPIFK	RVKTLPIFK
KVRAYIQMK	KVRAYIQMK
SLKQKLVNK	SLKQKLVNK
TAPQPGSAV	TAPQPGSAV
AFKDIKLWRK	AFKDKLWRK
KFIEDRVKK	KFIEDRVKK
RLLHHKRIYK	RLLHKRIYK
RLQELLERRK	RLQELERRK
SVRGVSISK	SVRGVSISK
RVAPRSGLAAK	APRSGLAAK
AIRNDYIVK	AIRNDYIVK
RTIELDGKKIK	RTIELDGKK
ILQEYRKIK	ILQEYRKIK
KLKEYLKNK	KLKEYLKNK
RMLSLRDQRLK	LSLRDQRLK
FEDENFILK	FEDENFILK
IVHQAGMLK	IVHQAGMLK
ALRPLVKPK	ALRPLVKPK
RSHYFEGVLK	RSHYEGVLK
IQFLHKEKK	IQFLHKEKK
GGSTRIPKIQK	STRIPKIQK
RFYDRRFLK	RFYDRRFLK
ATRTQNVLGEK	RTQNVLGEK
GSTRIPKVQK	STRIPKVQK
KSFSEDRLIK	KSFSDRLIK
IAPTGHSL	IA-PTGHSL
RYFQVEVEK	RYFQVEVEK
HLITTGRPTK	HLITGRPTK
KIRIEDPPR	KIRIEDPPR
AVQEFGLARFK	AVQELARFK
KVKEKFQQL	KVKEKFQQL
KTKPVAFAV	KTKPVAFAV
ATKFFQSTK	ATKFFQSTK
KVKDGQLTV	KVKDGQLTV
SVFVIVNKEK	SVFVVNKEK
RFKDVRNPEA	RFKDRNPEA
RIKDTVQKL	RIKDTVQKL
QTLKMIRQGK	TLKMIRQGK
RSQFYFLTK	RSQFYFLTK
QIPEIKQTL	QIPEIKQTL
ATVTPSPVK	ATVTPSPVK
SSHLPPPPKL	SSHLPPPPK
RIRDGDFVVLK	RIRDDFVVL
KLKEKFQHY	KLKEKFQHY
EVLATVKEER	VLATVKEER
RTLGAIVRQK	RTLGIVRQK
KTKFTIENV	KTKFTIENV
KLVDVVKKK	KLVDVVKKK
RQFDNFKRVFK	RQFDNFKRV
GTKGTVIKV	GTKGTVIKV
LAPTDVKEL	LAPTDVKEL
KVKDYISAK	KVKDYISAK
TSRMAPPAS	TSRMAPPAS
KYIQELWRKK	KYIQLWRKK
SYINLNPRLK	SYINNPRLK
TVFPKAKQVK	TVFPKAKQV
GFKNKTVLK	GFKNKTVLK
KLREDLERLK	KLRELERLK
AMYSRKAMYK	AMYSKAMYK
GWKPLGKEK	GWKPLGKEK
KLRQPFFQK	KLRQPFFQK
KVFEVHVRPKK	KVFEHVRPK
RTHLPGRTY	RTHLPGRTY
KFKGPEFVRK	KFKGEFVRK
ATKIKNYYK	ATKIKNYYK
RVVWKRPRL	RVVWKRPRL
KYKERFLVY	KYKERFLVY
SSNPALALRRK	SSNPLALRR
DAIKARLLNPK	AIKALLNPK
KFYGNRHLI	KFYGNRHLI
RTRVQKVQV	RTRVQKVQV
ATKKITESV	ATKKITESV
SYRSLTLGY	SYRSLTLGY
AVLHHLVNK	AVLHHLVNK
RYAQTQLDKLK	AQTQLDKLK
KLIDVLKRQK	KLIDLKRQK
AVIFINTRRK	AVIFNTRRK
AQYWKRNNK	AQYWKRNNK
KYKDAIHFY	KYKDAIHFY
GTQILRPPK	GTQILRPPK
RIREFYRGR	RIREFYRGR
RVKELEVRK	RVKELEVRK
RFKGTESISKV	RFKGESISK
HSRIEYMIK	HSRIEYMIK
RTQEKFALK	RTQEKFALK
KTKEVYELL	KTKEVYELL
LLPSHPLEL	LLPSHPLEL
REKPAPPQK	REKPAPPQK
RLQGVERIMK	RLQGERIMK
SLKEKFNGK	SLKEKFNGK
STLTNPRQSP	STLTNPRQS
AQSIYRPSK	AQSIYRPSK
KTIDMELVKRK	KTIDMELVK
RVKSFALKY	RVKSFALKY
RTNNLFKQV	RTNNLFKQV
ATKSSYLNI	ATKSSYLNI
KLMTVRIVK	KLMTVRIVK
HYLPDLQRSK	YLPDLQRSK
SVKKIQVEK	SVKKIQVEK
KTKQQIEEQRV	KTKQIEEQR
RWKALIEMEK	RWKAIEMEK
YAPSGNYV	YA-PSGNYV
RLKQEILEK	RLKQEILEK
IEEELGSK	IE-EELGSK
RTKQIRESL	RTKQIRESL
RVKEYFVFR	RVKEYFVFR
SGLDVIRIRK	SGLDIRIRK
KSKEFVQKV	KSKEFVQKV
QLAFLEGRKK	LAFLEGRKK
KQLIEKRIGK	KQLIKRIGK
RVRDGSKIRNL	RVRDGSKIR
KQLGRIMLK	KQLGRIMLK
SSRGPLPVK	SSRGPLPVK
KTKDLFPSL	KTKDLFPSL
KTKDLLNNV	KTKDLLNNV
SSTNPFRPQK	STNPFRPQK
VLDLVDPV	VL-DLVDPV
HVYKERFPK	HVYKERFPK
KMPKIKMPK	KMPKIKMPK
KLFPGRPPVK	KLFPRPPVK
GTRYPEVNR	GTRYPEVNR
GSILDAKPPK	SILDAKPPK
RTKYTITPVK	RTKYITPVK
KYKPLDLRPK	KYKPDLRPK
GTKGPSNVFK	GTKGSNVFK
VLRGVMINK	VLRGVMINK
RAKDMHLVKKL	RAKDMHLVK
TAAPSVRPEK	AAPSVRPEK
KTKEAVLLLKK	KTKEVLLLK
