Data	Data aligned
STPSDINSPR	STPSDISPR
SAASTALER	SAASTALER
DVFRDPALK	DVFRDPALK
EIVKDLAKPR	EIVKDLKPR
ELPIVTPALR	ELPIVTALR
ESAQDFASR	ESAQDFASR
SAPVGVTAL	SAPVGVTAL
MVAKVDEVK	MVAKVDEVK
GTFGEVFKAR	GTFGEVKAR
SVLDYFSER	SVLDYFSER
DTIEIITDR	DTIEIITDR
EAAVVAVAEK	EAAVVAAEK
NVPAVVVGR	NVPAVVVGR
QPAPPTSQPPR	APPTSQPPR
MTPPVNPSR	MTPPVNPSR
TTAQEVLARAR	TTAQEVLAR
SVFNEHPSR	SVFNEHPSR
HTIAPMGTRR	TIAPMGTRR
EIFYTAIVNR	EIFYTAVNR
DSVNIGRKR	DSVNIGRKR
QIFSDLNATYR	IFSDLNTYR
QAVDVSPLRR	QAVDVSLRR
LPAKAIGHR	LPAKAIGHR
EVVDVMVIGR	EVVDVMIGR
STANIDDLK	STANIDDLK
SGPSIVHR	-SGPSIVHR
LPSPLSDPR	LPSPLSDPR
AGLQFPVGR	AGLQFPVGR
SVGEITGHNK	SVGEITHNK
NMFDHPIPR	NMFDHPIPR
EAIAKGIRR	EAIAKGIRR
YVFPKPFNR	YVFPKPFNR
ETPQVAVIVR	ETPQVAIVR
ETAEAYLGK	ETAEAYLGK
YAPSGNYV	-YAPSGNYV
ETLMETHER	ETLMETHER
DVSHPIIYR	DVSHPIIYR
YSPGIVSTR	YSPGIVSTR
YAPKGSSL	-YAPKGSSL
TADGVPVSSR	TADGVPSSR
SAASYFQKR	SAASYFQKR
SAHFSPVLR	SAHFSPVLR
SADTLWGIQK	SADTLWIQK
TSEAPQPPR	TSEAPQPPR
TTTSLVLER	TTTSLVLER
ESFPSVNSR	ESFPSVNSR
TVAVSDIPR	TVAVSDIPR
QVANSAFVERL	QVANSAVER
EVIPISDPELK	EVIPISPEL
DTPGFIVNR	DTPGFIVNR
MTPELAGVIKR	TPELAGIKR
LLEGEESR	-LLEGEESR
HVIETLIGK	HVIETLIGK
NTFRRDPTAR	NTFRRDTAR
APAGPIVRP	APAGPIVRP
EVIPITDSELR	EVIPITSEL
FIFQGNPYFR	FIFQGNYFR
IDERAINKK	IDERAINKK
ETAPRTIFQR	ETAPRTFQR
DAAHPTNVQRL	DAAHPTVQR
QVFNKLIRR	QVFNKLIRR
STAPAQLGK	STAPAQLGK
ETTPLTIEKL	ETTPLTIEK
VAAVAARR	-VAAVAARR
EVVGIIESR	EVVGIIESR
FSTTAVSAR	FSTTAVSAR
EVDAAMAAR	EVDAAMAAR
ITPTGTHPL	ITPTGTHPL
NVAEKNWYPR	NVAEKNYPR
EVAQFLTGR	EVAQFLTGR
EIPALSVSR	EIPALSVSR
HTVRDHLVGR	HTVRDHVGR
ADAPVTQIGF	ADAPVTIGF
ETTVYVIVR	ETTVYVIVR
MTSALPIIQK	TSALPIIQK
ETVPAFSER	ETVPAFSER
ELIKPPTILR	ELIKPPILR
AVFPSIVGRPR	AVFPSIVGR
ESIDPQFTIRR	ESIDPQTIR
DVITDSPTHKR	DVITDSTHK
SVSDIIRLR	SVSDIIRLR
SVISGPQNTR	SVISGPNTR
DASRNVFSR	DASRNVFSR
MFLSFPTTK	MFLSFPTTK
SVFPQNGAAR	SVFPQNAAR
TTTQITKTVK	TTTQITTVK
TIMEDYFAYR	TIMEDYAYR
DVVYNAVHR	DVVYNAVHR
DIFQQTPLGR	DIFQQTLGR
TVIQLQNIAEK	TVIQLQAEK
EVGDIVVGR	EVGDIVVGR
ETVKVQIHSR	ETVKVQHSR
EDYNLIVIER	EDYNLIIER
DPAGALQAAFR	DPAGALAAF
DLFYNIATR	DLFYNIATR
DVFVVGTERGR	DVFVVGTER
STVGAGAYAYK	TVGAGAAYK
ETSKMKVLRF	ETSKMKVLR
DTSSLPTVIMR	TSSLPTIMR
STIALALGVER	TIALALVER
LVAEGLATRR	LVAEGLATR
TAFEEAQLPR	TAFEEALPR
WSLLQQQK	-WSLLQQQK
AVVAVAEKR	AVVAVAEKR
DTFSVAFIKK	DTFSVAIKK
ESIDQYIER	ESIDQYIER
EIPEHFGAVR	EIPEHFAVR
ELIQDITQR	ELIQDITQR
EVVNYVQKR	EVVNYVQKR
GVSSVIHPK	GVSSVIHPK
HVAQIYAIR	HVAQIYAIR
FSIDVGYER	FSIDVGYER
GTVELGPKR	GTVELGPKR
LVQAFQFTDK	LVQAFQTDK
NTIDQKIVER	NTIDQKVER
KASAALSVPR	ASAALSVPR
HVFEDPQRR	HVFEDPQRR
VFDAKRLIGR	FDAKRLIGR
HSIDGRVVEPK	SIDGRVEPK
HVVQPGYPAHR	VVQPGYAHR
QTIQGILER	QTIQGILER
EVNQETIQRL	EVNQETIQR
AIVDVVANR	AIVDVVANR
ATIQGAYAR	ATIQGAYAR
EAFNMIDQNR	EAFNMIQNR
ESAGGLIQTAR	SAGGLITAR
FTYDPWIGK	FTYDPWIGK
EAFKDIPVQR	EAFKDIVQR
DTFWKGTTR	DTFWKGTTR
HVFVEKVLQR	HVFVEKLQR
LSSGVSEIR	LSSGVSEIR
AITQVVVSR	AITQVVVSR
HSAPLTPVAR	HSAPLTVAR
EAVAVDVAVPK	VAVDVAVPK
FIIDDKGILR	FIIDDKILR
DMFATPQYR	DMFATPQYR
NAFGPGTANER	NAFGPGNER
EVVKNTENFLK	EVVKNTNFL
GVSPVITVR	GVSPVITVR
EVTTTVLVR	EVTTTVLVR
ESMLTPPIARR	ESMLTPIAR
EAYFVPLVKR	EAYFVPVKR
EVAPPKAHEVR	EVAPPKEVR
DPFHKAIRR	DPFHKAIRR
TTVEGLITR	TTVEGLITR
EIIAPSPQRSR	EIIAPSPQR
NIISGSGRPR	NIISGSRPR
ELNPSTGNR	ELNPSTGNR
NVNEVISNR	NVNEVISNR
HTPENPVIR	HTPENPVIR
DAFAYVQER	DAFAYVQER
EVPELYHQR	EVPELYHQR
STISEVLGR	STISEVLGR
DVFRDPALKR	DVFRDPLKR
STPEIAEQR	STPEIAEQR
VVPEPGQPL	VVPEPGQPL
GVAALYKFR	GVAALYKFR
LVHDGLGDLR	LVHDGLDLR
LADIMAKR	-LADIMAKR
TTVPHVFSK	TTVPHVFSK
TYDDATKTFT	TYDDATKTF
TIVNILTNR	TIVNILTNR
IIHEIAVLEL	IIHEIALEL
FPAGVPVSER	FPAGVPSER
EVYDGPKNVR	EVYDGPNVR
FAITAIKGVGR	ITAIKGVGR
DAAEPDVQR	DAAEPDVQR
DAVQTVTGGLR	AVQTVTGLR
YDAEISRKR	YDAEISRKR
SIPEKNRPL	SIPEKNRPL
TSETPQPPR	TSETPQPPR
EVFTTLSVTKR	EVFTTLVTK
DTPGFIVNRL	DTPGFIVNR
NGTSSVIVSR	GTSSVIVSR
ETYLNENLRKR	ETYLNENLR
AALPGIVHR	AALPGIVHR
DVFPGPSFR	DVFPGPSFR
EAVKLIIGR	EAVKLIIGR
DIYEFLPSKR	DIYEFLSKR
AIPGFTINR	AIPGFTINR
DVMASGTVKR	DVMASGVKR
EVLEQSAQTLR	EVLEQSTLR
ETFQFILGK	ETFQFILGK
NVALIRDTK	NVALIRDTK
ASAPVTVKR	ASAPVTVKR
NSMGFGAER	NSMGFGAER
DAWLPGEATR	DAWLPGATR
TTQQADIPR	TTQQADIPR
EVVDKSQVSR	EVVDKSVSR
MTNLPAVGR	MTNLPAVGR
SVPLAATSM	SVPLAATSM
HLVDEPQNLIK	HLVDEPQNL
SVFPQNGAARR	SVFPQNAAR
EVMRQRGINMR	EVMRQRINM
SVYGYGVQKR	SVYGYGQKR
ESQSPDTTIQR	QSPDTTIQR
DTQKFSVMR	DTQKFSVMR
HVIRGYVGNR	HVIRGYGNR
ETFNSITKRR	ETFNSITKR
DSSGLTVHR	DSSGLTVHR
LQDAEIAR	-LQDAEIAR
SVSPPQEARL	SVSPPQEAR
TTLEHQKTFR	TTLEHQTFR
TTFPESHLRT	TTFPESHLR
FVWTEPHSKR	FVWTEPSKR
NVVEYIPNAER	NVVEYIAER
LVKGAEITGK	LVKGAETGK
ATSPIIIHRL	ATSPIIIHR
ESIDPQFTIR	ESIDPQTIR
TFSGVYKK	-TFSGVYKK
EAHAQSIGMNR	HAQSIGMNR
DTYSWLLKER	DTYSWLKER
ESVSEGLNVPR	SVSEGLVPR
EIYEYIIFR	EIYEYIIFR
LFHPSNVEM	LFHPSNVEM
STWGSPGWVR	STWGSPWVR
AVYDFFIGR	AVYDFFIGR
EVSSMVLTK	EVSSMVLTK
ETSGPTYIK	ETSGPTYIK
NLAEKSTVHMR	LAEKSTHMR
EAAYIGSMR	EAAYIGSMR
FTNEVLTKTYR	FTNEVLTKT
DSFTGPRRR	DSFTGPRRR
STYATTIRDSK	STYATTIRD
DAAPGASKLR	DAAPGAKLR
HQGVMVGMGQK	GVMVGMGQK
TVAQIKATVKR	TVAQIKTVK
EAVATIMSGSK	AVATIMGSK
EVVTPNIFNSR	VVTPNINSR
EVFTTTEGRTR	EVFTTTEGR
IVKGPRGTLR	IVKGPRTLR
EAFDYIKQR	EAFDYIKQR
ETPDPSGGFR	ETPDPSGFR
MVWEGYNVVR	MVWEGYVVR
DTIRPEHVLR	DTIRPEVLR
TVATLPRGR	TVATLPRGR
YFAERVTSL	YFAERVTSL
FAFEGILIKK	FAFEGIIKK
ETASNEVVYR	ETASNEVYR
EAFPSQGTKR	EAFPSQTKR
EVHYHLPVAR	EVHYHLVAR
NTFEFAKPVQR	NTFEFAVQR
EVFAGVTTH	EVFAGVTTH
IVLVYITYHW	IVLVYITYH
ETIKSLLIRR	ETIKSLIRR
LSFEGATKR	LSFEGATKR
ETMPYVKKK	ETMPYVKKK
QLYDKGLVYR	QLYDKGVYR
ELFHVEPGLQR	ELFHVELQR
DSFHHNVAALR	FHHNVAALR
TPAGVQVILRR	TPAGVQILR
GTADVHFER	GTADVHFER
EAIGPSTIR	EAIGPSTIR
EVHGEAQRVLR	EVHGEARVL
DIIGPMPAK	DIIGPMPAK
IPAAIATAK	IPAAIATAK
EVIQLQGDQRK	EVIQLQDQR
TSAALPQSQR	TSAALPSQR
EVYPVGIFQK	EVYPVGFQK
ATENIPVVRR	ATENIPVRR
QANGFSVVR	QANGFSVVR
VDVRIGMTR	VDVRIGMTR
EIVKPSPKR	EIVKPSPKR
ETVQKETIHPR	TVQKETHPR
SVISGISSR	SVISGISSR
EIPTFQPLLK	EIPTFQLLK
NTFLGTPVQK	NTFLGTVQK
LVAEKVVVITK	VAEKVVITK
EIAPDIRGR	EIAPDIRGR
EVFHAGTSQR	EVFHAGSQR
ISSGAVVHR	ISSGAVVHR
EVPAAYQTPK	EVPAAYTPK
ETALYGNLILR	ALYGNLILR
TIIGVAAGR	TIIGVAAGR
LVSESSDVLPK	LVSESSVLP
ESAPKASLR	ESAPKASLR
TLSNIIEQR	TLSNIIEQR
GVTDVVITR	GVTDVVITR
AVTDVEATR	AVTDVEATR
NTVTPAVGR	NTVTPAVGR
ETIHADSVAKR	TIHADSAKR
SDAGIFFTR	SDAGIFFTR
ELYAEKVATR	ELYAEKATR
ETADVIAKV	ETADVIAKV
YVQRFHYSR	YVQRFHYSR
EVFDFSQRRK	EVFDFSQRR
ASSYIAHLR	ASSYIAHLR
YVFPVSQKR	YVFPVSQKR
EAAEVLQNNR	EAAEVLNNR
EVPSFTMGR	EVPSFTMGR
NASQLITQR	NASQLITQR
EVAPPEYHR	EVAPPEYHR
STPDLAANR	STPDLAANR
FEPAKGGEK	FEPAKGGEK
EVAPDVRLR	EVAPDVRLR
TVVQNLMER	TVVQNLMER
ESFASDPILYR	FASDPILYR
DTAAWTVGR	DTAAWTVGR
TAAFGHVQR	TAAFGHVQR
ETASNEVVYRF	ETASNEVYR
TTGESVITR	TTGESVITR
NVTTPISKR	NVTTPISKR
EVIKPWITK	EVIKPWITK
DAFGTGIVEK	DAFGTGVEK
SAAGPVAAPR	SAAGPVAPR
DVFIPKPFR	DVFIPKPFR
SAFATPFLVVR	FATPFLVVR
EMFVGVGASR	EMFVGVASR
TVPEVIVAR	TVPEVIVAR
EAFTSEHWLVR	FTSEHWLVR
ETLPPVGVNR	ETLPPVVNR
AMVIVALIDRM	MVIVALIDR
SVSEVVVNR	SVSEVVVNR
DIYFNPKTR	DIYFNPKTR
ISSSSFSR	-ISSSSFSR
TAIEAQHLLKR	TAIEAQLLK
NVIESKAYVGR	NVIESKVGR
EVAPPEYHRK	EVAPPEYHR
SVPWYIDPSKR	SVPWYIPSK
SVFNEHPSRR	SVFNEHSRR
DAAFIIGSGR	DAAFIISGR
IPFGNNPIFR	IPFGNNIFR
ESSSESFISR	ESSSESISR
SSAGGSFTVR	SSAGGSTVR
QLAQFHFTNR	QLAQFHTNR
HVVTIIKGK	HVVTIIKGK
SSGAVVHR	-SSGAVVHR
LVQEQPLPEP	LVQEQPPEP
EVAPPEYHRKA	EVAPPEYHR
MAAAAFAEK	MAAAAFAEK
STINGYEGTGR	TINGYETGR
GKDPPVHFR	GKDPPVHFR
DVPSPFNHR	DVPSPFNHR
EIVGSIKMR	EIVGSIKMR
DTSGGTTALR	DTSGGTALR
EVVIPQKKGK	EVVIPQKGK
ETVTGGFGAK	ETVTGGGAK
EVFSHILKR	EVFSHILKR
SSSFVLSHR	SSSFVLSHR
HSTDFEVHR	HSTDFEVHR
EAFSVFGQVER	EAFSVFVER
SVVSWKTGVFR	VVSWKTVFR
GLEAGLQGR	GLEAGLQGR
NSISSVVSR	NSISSVVSR
EAGPSIVHR	EAGPSIVHR
EAFEHPNVVR	EAFEHPVVR
EIKGFYDPPR	EIKGFYPPR
IVFPETSQPR	IVFPETQPR
DLFPTSDTPR	DLFPTSTPR
EIYGVTHTR	EIYGVTHTR
FASQGGLAR	FASQGGLAR
NTFDFIKVLR	NTFDFIVLR
SVFQTTDTK	SVFQTTDTK
LPAPAAVGR	LPAPAAVGR
ESYTPSKISVR	YTPSKISVR
HIAVGSPGR	HIAVGSPGR
TVFDAKRLIGR	FDAKRLIGR
EINKLLAHR	EINKLLAHR
KAPSAARSL	KAPSAARSL
VTIFIRGGNK	TIFIRGGNK
ETFNSITKR	ETFNSITKR
DVISVEKTVKR	ISVEKTVKR
SPASIGQPR	SPASIGQPR
TSAAALSRP	TSAAALSRP
AVSSVVNNSR	AVSSVVNSR
EVFDKTYQF	EVFDKTYQF
ETGVPIAGR	ETGVPIAGR
DTIDERAINKK	DTIDERINK
EVVRTIKER	EVVRTIKER
YAGGPSGVAR	YAGGPSVAR
DVSPVKPLSR	DVSPVKLSR
AEFAEVSK	-AEFAEVSK
DAAAVLVSR	DAAAVLVSR
DSIGSTVSSER	SIGSTVSER
EAGPGPRPLAR	EAGPGPRPL
TAYGGKYSVK	TAYGGKSVK
DIFYKAIQK	DIFYKAIQK
NVYPSKPLTK	NVYPSKLTK
TAAPAYGLPK	TAAPAYLPK
EANQAINPK	EANQAINPK
ETVGVKINEK	ETVGVKNEK
WTMSNITAGR	TMSNITAGR
SLPDFPAAAK	SLPDFPAAK
EAAVVAVAEKR	EAAVVAAEK
HSVIPPAAR	HSVIPPAAR
STARHLYLR	STARHLYLR
FSGEGQSLR	FSGEGQSLR
STYEQVDLIGK	STYEQVIGK
EVSTVNVRR	EVSTVNVRR
EIIEEHLANR	EIIEEHANR
ESFPELTIITR	ESFPELITR
EVFRTKIVEK	EVFRTKVEK
TTYKLVINGKT	TTYKLVNGK
AVVALAVGR	AVVALAVGR
SLYYYIQQDTK	LYYYIQDTK
STVPVNTNR	STVPVNTNR
ETFSGVYKKL	ETFSGVYKK
ETFTPNRVEK	ETFTPNVEK
NSPDISATR	NSPDISATR
NVTYVVKER	NVTYVVKER
AVVDFKAVQGR	VDFKAVQGR
VIPQKKGK	-VIPQKKGK
QVIIFVKSVQR	IIFVKSVQR
ETQSRTITVTR	ETQSRTVTR
DSSSVASKVFR	SSVASKVFR
MTQDAQNALR	MTQDAQALR
DAAFNKITR	DAAFNKITR
FLSAVFFAK	FLSAVFFAK
DSAPPSSVAR	DSAPPSVAR
NAPWAVTSL	NAPWAVTSL
EVAGLQVGR	EVAGLQVGR
ETFEHPNVVRL	ETFEHPVVR
DTVILPIKK	DTVILPIKK
TSTPVIVMR	TSTPVIVMR
TSFDGSLIQK	TSFDGSIQK
EVIKPWITKR	EVIKPWTKR
ETISKKEFQVR	TISKKEQVR
SVIGAREER	SVIGAREER
AVVGVVAGGGR	AVVGVVGGR
EVPEGGLVPK	EVPEGGVPK
HVVAIGRTR	HVVAIGRTR
HSLSLEAPRLH	HSLSLEAPR
DVITIIDRSFR	DVITIIRSF
SVFLYQSLR	SVFLYQSLR
EVEQFTQVAK	EVEQFTVAK
FSAPENAVR	FSAPENAVR
DAWEPKVLR	DAWEPKVLR
QVFNSKVTSR	QVFNSKTSR
LEEALQQAKED	EALQQAKED
EVVSGSGLTR	EVVSGSLTR
ELFPAPILR	ELFPAPILR
TTFPLPVATR	TTFPLPATR
DSVLMEQPPLR	SVLMEQPLR
TTASVVIIR	TTASVVIIR
EVLPKPRMR	EVLPKPRMR
SAAPGTPLAR	SAAPGTLAR
EAFYIKDPK	EAFYIKDPK
EVFSIAGTVKR	EVFSIATVK
ELIQEITQR	ELIQEITQR
EVFVGKIPR	EVFVGKIPR
EIAIIPSKK	EIAIIPSKK
ETSPLTAEKL	ETSPLTAEK
EVQSNPKIR	EVQSNPKIR
SVESIISPK	SVESIISPK
EVILIDPFHK	EVILIDFHK
NTVDEVYVSR	NTVDEVVSR
EAYEVLSDAKK	EAYEVLDAK
DIFSEVVGR	DIFSEVVGR
EANSNAVRFR	EANSNARFR
YTFYSISQER	YTFYSIQER
SAIHIRVFR	SAIHIRVFR
EAAQKFLER	EAAQKFLER
EIIAKEEQR	EIIAKEEQR
EVPREKLASR	EVPREKASR
ETLGPKPAAR	ETLGPKAAR
FNSDVVIVER	FNSDVVVER
EVAGIVAAR	EVAGIVAAR
EVFLAQGTLR	EVFLAQTLR
GYSFTTTAER	YSFTTTAER
EAAAISGLQKR	EAAAISLQK
DAAKDSILR	DAAKDSILR
FVYEPKEQK	FVYEPKEQK
STTTGHLIYK	STTTGHIYK
FAIQPNTTGK	FAIQPNTGK
ETPAISPSK	ETPAISPSK
EVGSIIGKK	EVGSIIGKK
EVGKAGHIMR	EVGKAGIMR
EVASFVADRL	EVASFVADR
HNMDVPNIKR	HNMDVPIKR
SSSTVVSTQR	SSSTVVTQR
RNVSTGDVNVE	NVSTGDVNV
YTYEHDPITK	YTYEHDITK
NSAGPYFNPR	NSAGPYNPR
AQYEDIANR	AQYEDIANR
EAFRNLVPVTR	EAFRNLVTR
SSIDISQSR	SSIDISQSR
TVIRNPNGGFR	TVIRNPNGG
EAIGPVHQNR	EAIGPVQNR
IASLIPTPR	IASLIPTPR
FVTPVTNQR	FVTPVTNQR
EVESLTAAR	EVESLTAAR
EVVVSVPQR	EVVVSVPQR
STSEAPQPPR	STSEAPPPR
HPSKVVITRL	HPSKVVITR
FTMASSPAQR	FTMASSAQR
HVTLHVHEP	HVTLHVHEP
LGPHERSPALR	GPHERSALR
STTEVTQPRT	STTEVTQPR
ESGPSIVHR	ESGPSIVHR
ITPAVVSER	ITPAVVSER
STYAAFVQTHR	YAAFVQTHR
GDEPPVFSR	GDEPPVFSR
FDSDVGVYR	FDSDVGVYR
MTEGGVVLR	MTEGGVVLR
YSVNVDYSK	YSVNVDYSK
EAHFVPLVK	EAHFVPLVK
TVAEIKKQYR	TVAEIKQYR
QVATVIQSR	QVATVIQSR
YVTDVGVLQR	YVTDVGLQR
EAFGKIVAER	EAFGKIAER
EIISKLQGR	EIISKLQGR
EVVPEPVAR	EVVPEPVAR
NTSPYSVQQR	NTSPYSQQR
ETPTFAKVQR	ETPTFAVQR
TVVGENGSVLR	VVGENGVLR
NTITPVVGKK	NTITPVVGK
ETVEDIAAR	ETVEDIAAR
EVPGSPIFVMR	EVPGSPVMR
DTIDERTINKK	DTIDERINK
FASLPQVER	FASLPQVER
EAFREDLHNR	EAFREDHNR
TSSEITTKDLK	TSSEITTKD
ESAIAIATGK	ESAIAITGK
TVIFVASQK	TVIFVASQK
ESSTVFELK	ESSTVFELK
TSEAAVKEGK	TSEAAVEGK
DLALSFRVGAR	LALSFRGAR
ATAGDGLIELR	TAGDGLELR
TLSPAFSTR	TLSPAFSTR
EVFGAEGFHEK	EVFGAEHEK
AVFPSLLTNPK	AVFPSLTNP
EIASVAYRYR	EIASVARYR
DAVQLNVIATR	AVQLNVATR
YAAISQVDRL	YAAISQVDR
QVFEKSPLR	QVFEKSPLR
ELAKIMRTR	ELAKIMRTR
EVLHIGSAHNR	EVLHIGSAH
FAAGILESKR	FAAGILSKR
TTGWGVSPR	TTGWGVSPR
EMFDGSLYHK	EMFDGSYHK
LAQTGSLGR	LAQTGSLGR
HVYPKNSVVR	HVYPKNVVR
EAANKVVLQLK	EAANKVLQL
DSYVGDEAQSK	YVGDEAQSK
EAFQTTISK	EAFQTTISK
EVIQLQGDQR	EVIQLQDQR
EVIQESGTKLK	EVIQESTKL
DSAPPTPVNR	DSAPPTVNR
TVYYSPETIGR	YYSPETIGR
ELAQVIVSR	ELAQVIVSR
STPAGVQVILR	TPAGVQILR
DITTGQPPR	DITTGQPPR
ITNNIDPVGR	ITNNIDVGR
SAVDITKVAR	SAVDITVAR
EVSDVEIITR	EVSDVEITR
SAAAVFNDRL	SAAAVFNDR
TSSAQIIQR	TSSAQIIQR
ETALPGAFKTR	ETALPGAFK
HTAQIEIVRL	HTAQIEIVR
LEDALQQAKED	DALQQAKED
ELIKIIRRR	ELIKIIRRR
EAAPDPAGVGR	AAPDPAVGR
NVADLTSLR	NVADLTSLR
DVFERPSAK	DVFERPSAK
FEDENFILK	FEDENFILK
EAAPVVVGH	EAAPVVVGH
SLADIMAKR	SLADIMAKR
TDSPVHVGR	TDSPVHVGR
EGVGILLTR	EGVGILLTR
TTISKYFSER	TTISKYSER
HSADFETVR	HSADFETVR
TNSDIVETLR	TNSDIVTLR
ELITQRELVSR	ITQRELVSR
EVYPVGIFQKR	EVYPVGFQK
ETALNSKAYK	ETALNSAYK
TAYDPDKKDLR	YDPDKKDLR
VPKAAIVAR	VPKAAIVAR
SSALPTTGR	SSALPTTGR
NNSPVLSER	NNSPVLSER
TTAAAPTLR	TTAAAPTLR
HTPTPGIYMGR	TPTPGIMGR
ETIGTGGFAK	ETIGTGFAK
AVVPFLPLQR	AVVPFLLQR
HVVDIVALK	HVVDIVALK
GEEPPIVRR	GEEPPIVRR
TVYHSPVSR	TVYHSPVSR
FTSGYIPAR	FTSGYIPAR
EAVFNPQSR	EAVFNPQSR
EVVGSVQGK	EVVGSVQGK
ELSDLHAHK	ELSDLHAHK
YSSTQVSVR	YSSTQVSVR
ESVPPGTTISR	SVPPGTISR
EVIKDGYENAR	EVIKDGNAR
EVFQNANFR	EVFQNANFR
STVGGWVSTR	STVGGWSTR
SAYDQKNIRR	SAYDQKIRR
EVPHELVAQSR	EVPHELQSR
ETFSYPDFLR	ETFSYPFLR
EVRADTGGLGR	VRADTGLGR
EVFKDKPEAR	EVFKDKEAR
EIYGGSDSRF	EIYGGSDSR
TTISSFPQLK	TTISSFQLK
NVKGPGLQR	NVKGPGLQR
EVVSLLLDR	EVVSLLLDR
FEITPPVVLR	EITPPVVLR
VVAPPGVVVSR	VAPPGVVSR
GVMPSHFSR	GVMPSHFSR
SIIGVTEPR	SIIGVTEPR
LVSPEQPPK	LVSPEQPPK
TDLEPPVVKR	DLEPPVVKR
ETVFESRNLR	TVFESRNLR
NTQTEEAIQTR	QTEEAIQTR
NASQIRELR	NASQIRELR
SVVGFLSQR	SVVGFLSQR
EIIQSTPYGR	EIIQSTYGR
SVSSLISGR	SVSSLISGR
TGIFLPILR	TGIFLPILR
STASVGRFQER	TASVGRQER
FSVPVIYER	FSVPVIYER
LPFGSSPHR	LPFGSSPHR
ATAELIMSR	ATAELIMSR
DPYSTGHLR	DPYSTGHLR
STAKIQIVR	STAKIQIVR
AVTDAIMSR	AVTDAIMSR
ITIEIPEVLK	ITIEIPVLK
TSAESWGTGR	TSAESWTGR
FVFDRPVHR	FVFDRPVHR
EVTNIKKTLK	EVTNIKTLK
TVSAAVAER	TVSAAVAER
EVSSVSPLKN	EVSSVSPLK
HAAVGQLGR	HAAVGQLGR
HVFPTDENIKR	FPTDENIKR
EVWIPKNGTRR	EVWIPKGTR
EVSSVSPLK	EVSSVSPLK
SASSVTVTR	SASSVTVTR
ENYGQKIIKK	ENYGQKIKK
SAAEVGFVR	SAAEVGFVR
IDERTINKK	IDERTINKK
FAAESIIKR	FAAESIIKR
SPSPLGGIKR	SPSPLGIKR
EVFSMAGVVVR	FSMAGVVVR
EVEPQGVIVTR	EPQGVIVTR
EIAEAYLGK	EIAEAYLGK
GSSDVIIHR	GSSDVIIHR
DVFISAAER	DVFISAAER
EVSAEVRER	EVSAEVRER
EVVTGVIGQR	EVVTGVGQR
EVAELTRLR	EVAELTRLR
SSSKTTWPR	SSSKTTWPR
SVINPGAIYR	SVINPGIYR
YANEVGEAFR	YANEVGAFR
EVQDLHLAQR	EVQDLHAQR
VTQEIVTER	VTQEIVTER
SIPGGYNAL	SIPGGYNAL
EVGTASPMAR	EVGTASMAR
ESFSDYPPLGR	SFSDYPLGR
ETFEHPNVVR	ETFEHPVVR
TTSVITIVK	TTSVITIVK
FVFGLPLER	FVFGLPLER
EVFTPVVQR	EVFTPVVQR
YVIKPGNTK	YVIKPGNTK
NVIEAVYNR	NVIEAVYNR
ESHYALPLGR	ESHYALLGR
TASQGQWGR	TASQGQWGR
TVFNAHEPFRR	TVFNAHPFR
DIINGDAIHKR	DIINGDIHK
QTIPPPYVVR	QTIPPPVVR
LHVDPENFR	LHVDPENFR
EIKHFVSER	EIKHFVSER
STIEYVIQR	STIEYVIQR
EIASFDKAKLK	EIASFDKAK
TEKPEVID	-TEKPEVID
YLITFNPVGR	YLITFNVGR
NTVNTSLNVYR	TVNTSLVYR
RTSEIYVHR	RTSEIYVHR
EIIEQPRQR	EIIEQPRQR
FASPLGAGR	FASPLGAGR
PRNPVNKR	-PRNPVNKR
EVVAGEFGSR	EVVAGEGSR
HTVNMRDPLNR	TVNMRDLNR
DTVAQITQR	DTVAQITQR
TTVTPFTAQQR	TVTPFTQQR
TTVDIFHKKH	TTVDIFHKK
EVPQIEVTRF	EVPQIEVTR
DVTKITKLR	DVTKITKLR
EVFFSEKIYK	EVFFSEIYK
STPLIIAAR	STPLIIAAR
ESQSNPVFR	ESQSNPVFR
DAIQDKKNFR	DAIQDKNFR
IVVPKAAIVAR	VVPKAAVAR
TTAPVVSTR	TTAPVVSTR
YTKDAMPINK	YTKDAMINK
LQAEIEGLK	LQAEIEGLK
EAVKPFGLK	EAVKPFGLK
IGSPIVSPR	IGSPIVSPR
DVQGALVNLR	DVQGALNLR
NATYVQPRR	NATYVQPRR
STKFPAYER	STKFPAYER
ESYSIYVYK	ESYSIYVYK
SSSLIIHQR	SSSLIIHQR
EDFYTATER	EDFYTATER
DVARLVVER	DVARLVVER
HVYDGKFLAR	HVYDGKLAR
DLFDFITER	DLFDFITER
ETMGTIEVQR	ETMGTIVQR
EVIKVEDTTK	EVIKVETTK
SSAPVVVTR	SSAPVVVTR
TTFQDQLNR	TTFQDQLNR
TTVQPSATLQR	TVQPSALQR
DAEAIYVTR	DAEAIYVTR
EAMEWVIHK	EAMEWVIHK
QIAEGMAYIER	IAEGMAIER
TTVAKTVTVTR	TVAKTVVTR
ETEPTIIER	ETEPTIIER
EVISGQKLTR	EVISGQLTR
ESTNFATLR	ESTNFATLR
DAYGSELVER	DAYGSEVER
DTYPALPPSAR	DTYPALSAR
EVFEYIIFR	EVFEYIIFR
DSMLVDPKHHR	MLVDPKHHR
EIGPVSSSR	EIGPVSSSR
DVNSFVRSR	DVNSFVRSR
NLLSVAYK	-NLLSVAYK
MISDIEKKR	MISDIEKKR
EVPEVTRSR	EVPEVTRSR
DANGNSFATRI	DANGNSATR
NVIEPSFGLGR	NVIEPSFGL
HVFESNPSIRK	HVFESNSIR
DIFNQVVPR	DIFNQVVPR
ETSTEAATRL	ETSTEAATR
NIQVNNISI	NIQVNNISI
NIPEKTTAL	NIPEKTTAL
QVANSAFVER	QVANSAVER
EIATVVKKR	EIATVVKKR
EAYTHAQISR	EAYTHAISR
FVYGSGVYR	FVYGSGVYR
ETYTAYLIETR	YTAYLIETR
MTKSGYQPPR	MTKSGYPPR
QITAVIINR	QITAVIINR
LPSPVTAQK	LPSPVTAQK
DTVTMQVTAR	DTVTMQTAR
LVVENSAQR	LVVENSAQR
EAHQAETEVLR	HQAETEVLR
ATTPIFANR	ATTPIFANR
EVLNDPENMEK	EVLNDPENM
YIDQEELNK	YIDQEELNK
MTFGIEPFKTK	MTFGIEPFK
NVKFIQEKK	NVKFIQEKK
ETVTSFRKR	ETVTSFRKR
DAFFNPATR	DAFFNPATR
TVAPSVGITR	TVAPSVITR
DTVDLTSVLR	DTVDLTVLR
FVYGEPVTR	FVYGEPVTR
SVPPPPAVGR	SVPPPPVGR
ETIGEILKK	ETIGEILKK
SVVAVPLPLHR	SVVAVPLPL
ETPETFYIGK	ETPETFIGK
DTISNKKVLPK	TISNKKLPK
HAVDGNTVELK	HAVDGNVEL
VTIKKDVDG	VTIKKDVDG
TTPNISVKK	TTPNISVKK
NVIDWSDVRK	NVIDWSVRK
IVIDFDSINSR	IDFDSINSR
VATDITSTR	VATDITSTR
SSMFGTLPR	SSMFGTLPR
QAADKIHSSFR	AADKIHSFR
ETYKYLYGR	ETYKYLYGR
EVVPRVTKK	EVVPRVTKK
ETAVFINISR	ETAVFIISR
MTQDAQNALRR	MTQDAQALR
DVAVVAGGLGR	AVVAGGLGR
DIIPNPQER	DIIPNPQER
ETYEGSPVSK	ETYEGSVSK
SSVTFWRHR	SSVTFWRHR
DSFQKVILR	DSFQKVILR
ETVPKDLRHLR	ETVPKDRHL
DAGSVPHVNR	DAGSVPVNR
EIFDGIQPK	EIFDGIQPK
EAVTGITVSR	EAVTGIVSR
ELTAVVQKR	ELTAVVQKR
GDLGIEIPAEK	LGIEIPAEK
KTGGPIYKR	KTGGPIYKR
EAASYLDQISR	EAASYLISR
EAAQLREERL	EAAQLREER
ETIDVHSGY	ETIDVHSGY
EVPSEIEVPR	EVPSEIVPR
NTTSAVTVK	NTTSAVTVK
SPIGASGVAHR	IGASGVAHR
YAFNSGNVER	YAFNSGVER
SLPAPVAQR	SLPAPVAQR
DIFYKAIQKR	DIFYKAQKR
DSGDVAALR	DSGDVAALR
GGLPERSVSL	GLPERSVSL
TTSPSGSLLR	TTSPSGLLR
ETESVVSLR	ETESVVSLR
HSAMAVVSR	HSAMAVVSR
EIIEQPKQR	EIIEQPKQR
EIKGTNGQVTR	EIKGTNVTR
DLFDPIIEDR	DLFDPIEDR
WVIGSVVAR	WVIGSVVAR
SVAGLARLG	SVAGLARLG
PALAPVVSR	PALAPVVSR
HIIEKDKITTR	IIEKDKTTR
DTAAQITQR	DTAAQITQR
ELALIYGTPR	ELALIYTPR
TTADGSSILDR	TTADGSSIL
MVYPFTGDHK	MVYPFTDHK
EIPQLVPIGK	EIPQLVIGK
TTFEDLIQR	TTFEDLIQR
GTYVSSVPR	GTYVSSVPR
QVVPVSSHR	QVVPVSSHR
EVSSIIKKK	EVSSIIKKK
TTVDESQVVTR	TVDESQVTR
DVVKLTKNSK	DVVKLTNSK
ESLPATHIRGK	ESLPATHIR
DVAEEIANYR	DVAEEINYR
TTVGTLSQR	TTVGTLSQR
EVMGTGAVR	EVMGTGAVR
STVGSAISR	STVGSAISR
FTVTVGNNR	FTVTVGNNR
EIKKPPVSER	EIKKPPSER
HVPEGQTIKGR	HVPEGQTIK
TTTGVDPVAK	TTTGVDVAK
TVIHFNNPK	TVIHFNNPK
DVFESKLSTR	DVFESKSTR
ELFAGKPVLR	ELFAGKVLR
FTGSIFIGR	FTGSIFIGR
SVFDAYVLPK	SVFDAYLPK
SAFRNVNTR	SAFRNVNTR
EVIEIMTDR	EVIEIMTDR
SVISVEDPPQR	ISVEDPPQR
EVPRTIIVTTR	EVPRTITTR
EINQNVEIQR	EINQNVIQR
QVEEIFNLK	QVEEIFNLK
TYDDATKTF	TYDDATKTF
TVSGPGVAR	TVSGPGVAR
ETSSLESFVR	ETSSLEFVR
ISPSRTEAL	ISPSRTEAL
PAISPSKR	-PAISPSKR
QVSDVPATSR	QVSDVPTSR
NVAPIAGETK	NVAPIAETK
SVVGIPVFR	SVVGIPVFR
TTIFSPEGR	TTIFSPEGR
ELYNAPEGR	ELYNAPEGR
EAVGSYAENQR	AVGSYANQR
ELGKAIVKR	ELGKAIVKR
AVIQVSQIVAR	AVIQVSVAR
ESFETFINKR	ESFETFNKR
DAAIVGAVR	DAAIVGAVR
EVISLSQVTPK	EVISLSVTP
HLPETKFSEL	HLPETKSEL
FSFSKTPKR	FSFSKTPKR
GVARIFNTR	GVARIFNTR
DTVATLPRGR	TVATLPRGR
EVAGQFVIK	EVAGQFVIK
ITFDVAPSRL	ITFDVAPSR
ETALIDRTGR	ETALIDTGR
EVAPEIKASER	EVAPEISER
EVSTVNVRRR	EVSTVNVRR
QTPNTFPKR	QTPNTFPKR
SVAKIVSDR	SVAKIVSDR
TIIDLPGITR	TIIDLPITR
MHKAELVK	-MHKAELVK
EIADTMVQIFK	EIADTMVQI
EVTEEGVRFR	EVTEEGRFR
DSFSAGEPR	DSFSAGEPR
EVYVWDVNSR	EVYVWDNSR
EVIKAMTKAR	EVIKAMKAR
DTHGSFVVR	DTHGSFVVR
LVFPSEIVGKR	LVFPSEVGK
DPTDVAALR	DPTDVAALR
ESFPGSFRGR	ESFPGSRGR
ESSAGGSFTVR	SSAGGSTVR
NTNDFVTLR	NTNDFVTLR
EVKRPGESLR	EVKRPGSLR
NVAPLKTHFR	NVAPLKHFR
EAFDFVKQR	EAFDFVKQR
SAINEVVTR	SAINEVVTR
STFDTQITKK	STFDTQTKK
AIATIKTKR	AIATIKTKR
VPSEVVKQR	VPSEVVKQR
TTSPSVIYR	TTSPSVIYR
EAAAVHGARF	EAAAVHGAR
ESFGPQPISR	ESFGPQISR
TTAQEVLAR	TTAQEVLAR
TTVDIFHKK	TTVDIFHKK
SVQGIIIYR	SVQGIIIYR
ITSIVVLVER	ITSIVVVER
ESVFTVEGGHR	SVFTVEGHR
AVANIVNSVK	AVANIVSVK
DVISNINITR	DVISNIITR
DVTPIPSDSTR	TPIPSDSTR
EVNGAPVYVVR	NGAPVYVVR
ESGGASVISTR	GGASVISTR
ELVPFESPR	ELVPFESPR
SSIRPISER	SSIRPISER
DVKNAGDLR	DVKNAGDLR
EAIEGTYIDK	EAIEGTIDK
ETPAISPSKR	ETPAISSKR
SVISSRNTGQR	ISSRNTGQR
IAAGEVIQR	IAAGEVIQR
NVADLHEKY	NVADLHEKY
YQSKYEEL	-YQSKYEEL
ETLTRPFSGR	ETLTRPSGR
DVFYLQPER	DVFYLQPER
STSETPQPPR	STSETPPPR
SVYDHQGIFKR	SVYDHQIFK
LSNNNQALR	LSNNNQALR
EVVEEAENGR	EVVEEANGR
EVASYQPLQR	EVASYQLQR
NVAEVDKVTGR	NVAEVDTGR
EVADLKIKR	EVADLKIKR
ELMGYIMGK	ELMGYIMGK
EVVRLLVTR	EVVRLLVTR
EASEEAVSVQR	ASEEAVVQR
LVAEQVTYQR	LVAEQVYQR
NVAPGIFKQR	NVAPGIKQR
QTSGLPSSVR	QTSGLPSVR
ETAGSTSIPK	ETAGSTIPK
SAISAAKTGVR	ISAAKTGVR
TVIDSQTHYR	TVIDSQHYR
EAINITNNEK	EAINITNEK
EVFYPGETVVH	EVFYPGETV
EVFPLKVFGY	EVFPLKFGY
EPVEVVAPR	EPVEVVAPR
LVFPSEIVGK	LVFPSEVGK
EVINTPRVVDR	EVINTPVDR
EVPSFLVERM	EVPSFLVER
EVIQLIKTNKK	EVIQLITNK
ASADISLERL	ASADISLER
YTPTISRER	YTPTISRER
TSFPLSGPPR	TSFPLSPPR
YTSGIPSSSR	YTSGIPSSR
SVAGLTAAAYR	SVAGLTAYR
ELFRPKDPQGR	ELFRPKQGR
LPAPTSTSTGR	APTSTSTGR
SASPSVISR	SASPSVISR
NTIEKPILR	NTIEKPILR
TTVQVKEVNR	TTVQVKVNR
ETNTGEVYR	ETNTGEVYR
TNQELQEINR	TNQELQINR
SVVEGGLRAR	SVVEGGRAR
GVAPVFKKR	GVAPVFKKR
IVTGTSIQR	IVTGTSIQR
FTNSKKSVTLR	NSKKSVTLR
SAISYINQR	SAISYINQR
DSTLIMQLLR	DSTLIMLLR
LAGDVPAAR	LAGDVPAAR
ILIDPFHK	-ILIDPFHK
QVADVVVSRW	QVADVVVSR
EVVVAFPAAR	EVVVAFAAR
APPEYHRK	-APPEYHRK
DTMKVLGVQR	DTMKVLVQR
TLIDPETLLPR	TLIDPETLL
DPAGVHPPR	DPAGVHPPR
TVFGATGFLGR	TVFGATLGR
EAVRPGVLR	EAVRPGVLR
FTAPSTVGK	FTAPSTVGK
ETFKSIMKK	ETFKSIMKK
EIIKKLIER	EIIKKLIER
ETLSQSPPK	ETLSQSPPK
SVINSVSTSR	SVINSVTSR
STFNQVVLK	STFNQVVLK
EVVVSGKLR	EVVVSGKLR
ETFDFQAMGR	ETFDFQMGR
ETNMYEGVGR	ETNMYEVGR
KAPAPRPSL	KAPAPRPSL
TVFRTPAIKR	TVFRTPIKR
SVAKTILKR	SVAKTILKR
DVVGPVSLPR	DVVGPVLPR
DASLGNLFAR	DASLGNFAR
ETQLPVSFR	ETQLPVSFR
EVITAQDTVIK	ITAQDTVIK
TTITAPPSR	TTITAPPSR
QVAPPVLKR	QVAPPVLKR
NANPLIYQR	NANPLIYQR
PAKAIGHR	-PAKAIGHR
DVAALHGPVVR	DVAALHVVR
EVQDRVMLTGR	EVQDRVTGR
EIWKTDTKGR	EIWKTDKGR
TAAAAASIR	TAAAAASIR
VVAPPGAPK	VVAPPGAPK
AGFAGDDAPR	AGFAGDAPR
FSNDVIRKR	FSNDVIRKR
EIAQNNVEVAR	IAQNNVVAR
EVSPITGRSK	EVSPITRSK
EALNQVTQR	EALNQVTQR
SVNELIYKR	SVNELIYKR
AAPATRAAL	AAPATRAAL
SVFEDPVISK	SVFEDPISK
DLFEDGGIIRR	DLFEDGIIR
LGGSRGAPGL	GGSRGAPGL
GTFGATSLQQR	FGATSLQQR
HIFAKVQQR	HIFAKVQQR
ETIGKKFEKR	ETIGKKEKR
ENAPLAKR	-ENAPLAKR
EVSETLVQR	EVSETLVQR
EVQVVNTER	EVQVVNTER
HTSISSLFER	TSISSLFER
EAVAPEFTNR	EAVAPETNR
SSSPVVVQH	SSSPVVVQH
EVISTPGVVAR	EVISTPVAR
TSEIYVHR	-TSEIYVHR
EVPLEENVNRR	EVPLEEVNR
ETSPLTAEK	ETSPLTAEK
TPAGGGFPR	TPAGGGFPR
ESFKEKFVR	ESFKEKFVR
HAVGIVVNK	HAVGIVVNK
HAVVVGVYR	HAVVVGVYR
DVAYINVETK	DVAYINETK
STFRESFKK	STFRESFKK
EVVIYVVER	EVVIYVVER
DAAEIRLVSK	DAAEIRVSK
EAYHRVFVNR	EAYHRVVNR
TTPIFANRR	TTPIFANRR
SVLEATRVNRR	SVLEATVNR
HVHGLPVTR	HVHGLPVTR
ETISSKNIISR	TISSKNISR
EVASVWVERI	EVASVWVER
WTISNITAGNR	TISNITGNR
EAVGVTSQR	EAVGVTSQR
TVISQEPFVPK	ISQEPFVPK
EVSPMYGVQK	EVSPMYVQK
FTYMNPAQR	FTYMNPAQR
MAPERVASL	MAPERVASL
ATSEASAITRT	ATSEASITR
ENSPLGEALR	ENSPLGALR
NVAANVTSR	NVAANVTSR
SVFEERPERR	SVFEERERR
TVGDIVLLR	TVGDIVLLR
DAEAWFTSR	DAEAWFTSR
YEELQSLAGK	EELQSLAGK
EVENPQNQLR	EVENPQQLR
ELVEPSSVALR	LVEPSSALR
EVTRILDGK	EVTRILDGK
TVFPNHTVKR	TVFPNHVKR
NSFDPSKITR	NSFDPSITR
EVTPAMQIPR	EVTPAMIPR
TSFPSGEATPR	FPSGEATPR
EIYRPPASR	EIYRPPASR
SSPQPGSAL	SSPQPGSAL
FVFDRQTGHKK	FVFDRQGHK
EVAAMENVHR	EVAAMEVHR
SLANIARQR	SLANIARQR
EAFKPILSTR	EAFKPISTR
ETISTATGR	ETISTATGR
AVYGQKEIHR	AVYGQKIHR
EIVGNLPSAMR	EIVGNLSAM
GFEITPPVVLR	EITPPVVLR
DAQKPSLTR	DAQKPSLTR
DSFIGENSR	DSFIGENSR
IAPTGHSL	-IAPTGHSL
EVPFSNENPR	EVPFSNNPR
SVYSPSGPVNR	YSPSGPVNR
EVVEFLKNPQK	EVVEFLKNP
EPYANPTKR	EPYANPTKR
QTMSDQIIGR	TMSDQIIGR
YVNQGEILR	YVNQGEILR
HSVGVVIGR	HSVGVVIGR
DVSPVVSTY	DVSPVVSTY
NSKESYELR	NSKESYELR
ETVNVEPLTK	ETVNVELTK
EVNQETIQR	EVNQETIQR
TAMDVVYALK	TAMDVVALK
HAADPIITR	HAADPIITR
ITSPVVTQK	ITSPVVTQK
LVAEITPKGR	LVAEITKGR
DVYENLHTK	DVYENLHTK
EIYDRREYSR	EIYDRRYSR
ESYQEVTVQR	ESYQEVVQR
EVGPGAVGER	EVGPGAGER
ETPGHTPSLR	ETPGHTSLR
EAEPDLLAVLR	EPDLLAVLR
PGEEPPIVRR	GEEPPIVRR
ESAAINQILGR	SAAINQLGR
FDAKRLIGR	FDAKRLIGR
QTQGPPDYPR	QTQGPPYPR
EIAEVNKKLK	EIAEVNKLK
EAGAPELQR	EAGAPELQR
DVASVIVTK	DVASVIVTK
YVVEKVLDR	YVVEKVLDR
EISSPAVER	EISSPAVER
TSFDGSLIQKM	TSFDGSIQK
NVAELKKSFNR	NVAELKKSF
YLPDGTASL	YLPDGTASL
TELSVRAKPSA	-TELSVRAK
DLGEEHFK	-DLGEEHFK
EIINEDIAKR	EIINEDAKR
EVVQSSPVER	EVVQSSVER
DSQYPPVQR	DSQYPPVQR
EIPDNVGDWLR	EIPDNVWLR
EVIPYTPAMQR	EVIPYTMQR
RVDPVNFK	-RVDPVNFK
HTADISSHF	HTADISSHF
HTINGHNAEVR	TINGHNEVR
EALPHVVPTLR	ALPHVVTLR
RAAIPIAKR	RAAIPIAKR
ESIDKKISR	ESIDKKISR
ETFSGVYKK	ETFSGVYKK
EISAPVSER	EISAPVSER
STFNFHPNVR	STFNFHNVR
ELIKVLIQR	ELIKVLIQR
SVASTPISQR	SVASTPSQR
DVAEVDTVRR	DVAEVDVRR
HVSLITPTKR	HVSLITTKR
HTGPQQDPRL	HTGPQQDPR
FIIDGKGVLR	FIIDGKVLR
EAFSQFGPIER	EAFSQFIER
DVVYALKRQGR	VVYALKQGR
EVTQDFMMYR	EVTQDFMYR
SVSSSTHFTR	SVSSSTFTR
GTIGKKFAR	GTIGKKFAR
NVKNVSVKDVR	NVKNVSVKD
FTQKPGFPK	FTQKPGFPK
HPAVVIRQR	HPAVVIRQR
NTVHDIVNR	NTVHDIVNR
EVHAVVTVR	EVHAVVTVR
EIVKAIKER	EIVKAIKER
EVVEIQIDR	EVVEIQIDR
NVAATFKGIVR	VAATFKIVR
ATAGIIGVNR	ATAGIIVNR
YIITGGGFLR	YIITGGFLR
ATSGVVAVR	ATSGVVAVR
ETYLNENLR	ETYLNENLR
ETIPGPDAKVR	ETIPGPDAK
EVISLGLPFGK	EVISLGLPF
EVVEGMDISTR	EVVEGMSTR
GTVFIIQGLR	TVFIIQGLR
QASAVTVTR	QASAVTVTR
FSPVGSVL	-FSPVGSVL
MAGPGGLAR	MAGPGGLAR
TVNTSLNVYR	TVNTSLVYR
DVFERPSAKK	DVFERPAKK
IVYGQPRTR	IVYGQPRTR
HAVEISAVHSR	AVEISAHSR
DVIGVTKGK	DVIGVTKGK
AVAAVAARR	AVAAVAARR
IVVDAIDVLK	IVVDAIVLK
YPVGIFQKR	YPVGIFQKR
SVGPAVQAR	SVGPAVQAR
NSFDPSKITRK	NSFDPSITR
IDQKIVER	-IDQKIVER
TSSNLVIHR	TSSNLVIHR
ESQAAKDLLYR	QAAKDLLYR
NTAVSQLTK	NTAVSQLTK
STVENFGQLGR	TVENFGLGR
DVYDAFPPLR	DVYDAFPLR
NTVGLVVER	NTVGLVVER
EVVEQGITR	EVVEQGITR
HVKTGGKISLR	KTGGKISLR
DVYTPKSSR	DVYTPKSSR
TTNVPEIQR	TTNVPEIQR
TVAEKLDWAR	TVAEKLWAR
EVIRAYDTTK	EVIRAYTTK
DVFVVGTER	DVFVVGTER
SVSEVHPSRL	SVSEVHPSR
TTNDIVISKL	TTNDIVISK
EAAPGALGQVK	EAAPGALGQ
DTITTDTGFMR	ITTDTGFMR
TAAAIGATPR	TAAAIGTPR
NTKSQSAFDLK	TKSQSADLK
QAVDVSPLR	QAVDVSPLR
DTYGVRPLFK	DTYGVRLFK
SAALPQSQR	SAALPQSQR
DVMVGPFKLR	DVMVGPKLR
TTYKLVINGK	TTYKLVNGK
DVIKPGTVKR	DVIKPGVKR
LPSPSHVGPI	LPSPSHVGP
EVTEGLDVLR	EVTEGLVLR
TIIEKPPAER	TIIEKPAER
EAKNPADLPK	EAKNPALPK
DTAQIFRVNLR	DTAQIFVNL
NVVKFYGHRR	NVVKFYHRR
TAPTGHTL	-TAPTGHTL
TVVEDVTVGR	TVVEDVVGR
TIIDIITHR	TIIDIITHR
DVIDGPISQR	DVIDGPSQR
YTFQDKQVSR	YTFQDKVSR
MVSSQTKTVR	MVSSQTTVR
EIINIMQDR	EIINIMQDR
ETPITSVPR	ETPITSVPR
ELFHQQGTPR	ELFHQQTPR
IWHHTFYNELR	HHTFYNELR
ESIRAAVNR	ESIRAAVNR
ETFLTSPEELY	ETFLTSEEL
FEVDTVAP	-FEVDTVAP
ETYEEIYKSTK	ETYEEISTK
SVIDSVTKKR	SVIDSVKKR
ETAGSTSIPKR	ETAGSTIPK
NVVRNISYK	NVVRNISYK
TVIEKTESWPR	TVIEKTESW
NTIKLIVGR	NTIKLIVGR
AVIDVGINR	AVIDVGINR
QIFSGTSKR	QIFSGTSKR
HTIPIPVAR	HTIPIPVAR
LSFETTDESLR	LSFETTESL
VPIGYHVPR	VPIGYHVPR
EVRLNVEEK	EVRLNVEEK
EVVSGVVSK	EVVSGVVSK
SIFEPAKGGEK	SIFEPAKGG
AKNKLNDLED	AKNKLNLED
YVADLGDILK	YVADLGILK
EVEPGVHLGR	EVEPGVLGR
VSFELFADK	VSFELFADK
ATIDGSVNPK	ATIDGSNPK
TVFSPTLPAAR	TVFSPTAAR
NTSNMPVAAR	NTSNMPAAR
SVSNVVITK	SVSNVVITK
VATVSLPR	-VATVSLPR
NIADIEEKR	NIADIEEKR
FSWSISLR	-FSWSISLR
GYEPLPPTIGR	EPLPPTIGR
NVKVDPEIQ	NVKVDPEIQ
HSAVGQGVPR	SAVGQGVPR
NLTDIVAQR	NLTDIVAQR
TAAATVLKR	TAAATVLKR
SSPAPRTAL	SSPAPRTAL
ETAKPIPAR	ETAKPIPAR
LRVDPVNFK	LRVDPVNFK
EVGPGPGGITR	EVGPGPITR
SNSGITRVEK	SNSGITVEK
EAHARIHLR	EAHARIHLR
EIISERTKPR	EIISERKPR
NTPSFGSKIIR	TPSFGSIIR
TVISGPGTGK	TVISGPTGK
FIVNTNVPR	FIVNTNVPR
ETPQSLAFTR	ETPQSLFTR
STYYGSFVTR	STYYGSVTR
VVFEKAIQR	VVFEKAIQR
DIIQPSSTR	DIIQPSSTR
TTTEIIKRR	TTTEIIKRR
ETAFAFHLR	ETAFAFHLR
EVPPNQIVGR	EVPPNQVGR
TVIDVSTADR	TVIDVSADR
AAVAAVAAR	AAVAAVAAR
SIFDKNHER	SIFDKNHER
YDPRNPVNKR	DPRNPVNKR
EVAQLIQGGR	EVAQLIGGR
QVVEVNPVR	QVVEVNPVR
IAIKPDGVQR	IAIKPDVQR
ETLKNTKEIQR	TLKNTKIQR
NAYTGIVLLR	NAYTGILLR
TTFPKIHSR	TTFPKIHSR
AAVDSSVPR	AAVDSSVPR
EVPNKIINR	EVPNKIINR
ESVAAPITVR	SVAAPITVR
TAADLGSVVR	TAADLGVVR
EPSEVFINR	EPSEVFINR
EVQQARDLQNR	EVQQARQNR
NIADLAVRR	NIADLAVRR
NTFGKAGIKTK	NTFGKAGIK
SVYSWDIVVQR	YSWDIVVQR
YSKYYKTID	YSKYYKTID
ESAYNAFNR	ESAYNAFNR
AAAAAGAFAGR	AAAGAFAGR
HSMDFVAYR	HSMDFVAYR
EVMQWSQSLEK	EVMQWSQSL
LLLPGELAK	LLLPGELAK
NTPAIPSFKR	NTPAIPFKR
EAAVAIKAMAK	AAVAIKMAK
TTFPMSNHTR	TTFPMSHTR
ETLLLQAER	ETLLLQAER
VFRDPALK	-VFRDPALK
ETALNSKAYKR	ETALNSAYK
DIIEKVMAR	DIIEKVMAR
NATPLTIER	NATPLTIER
ETVGSIFSR	ETVGSIFSR
ITSPPNALPR	ITSPPNLPR
YIMPKPARR	YIMPKPARR
TTARIRDTLR	TTARIRTLR
EVTGFGVTR	EVTGFGVTR
ETILASSGTDR	TILASSTDR
LVGPVPAGR	LVGPVPAGR
EVIAQLENAAK	VIAQLEAAK
EVTDYAIAR	EVTDYAIAR
YVANVGTNR	YVANVGTNR
MPASVVGQR	MPASVVGQR
EVQRILHQR	EVQRILHQR
TTQGLDGLSER	QGLDGLSER
VISSIEQK	-VISSIEQK
SVENAPLAKR	SVENAPAKR
EVGDIVKVTR	EVGDIVVTR
MAISSGAVVHR	ISSGAVVHR
YAASIIIRR	YAASIIIRR
EVIKVIHGK	EVIKVIHGK
TVSRIQSPK	TVSRIQSPK
EIFGTIGMR	EIFGTIGMR
LAAGIVGNLR	LAAGIVNLR
EIAMATVTALR	AMATVTALR
EIYDRREYSRF	EIYDRRYSR
EVGPEGALGK	EVGPEGLGK
EPAAVIVEK	EPAAVIVEK
DSAPVETPR	DSAPVETPR
ETSNLIIMR	ETSNLIIMR
EIAQLKKDQR	EIAQLKDQR
DVVNVVFVDR	DVVNVVVDR
TVENFGQLGR	TVENFGLGR
NAARVQPPR	NAARVQPPR
ELVSPKLNR	ELVSPKLNR
DTVSVPYVFR	DTVSVPVFR
ETSGFPSQR	ETSGFPSQR
SVISATSSAGR	ISATSSAGR
EATAMAMGR	EATAMAMGR
EVILATPYGR	EVILATYGR
NVAPMKAPK	NVAPMKAPK
DAWPGQRER	DAWPGQRER
ETVEKFRQR	ETVEKFRQR
TTAAGPLFQQR	TAAGPLQQR
DVFNEDFSNR	DVFNEDSNR
TIPQFQNFYR	TIPQFQFYR
EAVKKLIER	EAVKKLIER
VAFINEKMAR	VAFINEMAR
EAANYQDTIGR	EAANYQIGR
TVAGGAWTYK	TVAGGATYK
ETLSAVTNNR	ETLSAVNNR
EVNQPKFNQR	EVNQPKNQR
ISPTGHSL	-ISPTGHSL
NTIESVHTEK	NTIESVTEK
ETNEIANANSR	ETNEIANSR
EAPIISNSER	EAPIISSER
EAGAIISTR	EAGAIISTR
TSSPSSIPR	TSSPSSIPR
EAAIGVTKR	EAAIGVTKR
SIFDGRVVAK	SIFDGRVAK
SVAGMPATSR	SVAGMPTSR
TVIPATVVTSR	IPATVVTSR
YVYPDKTRPR	YVYPDKRPR
SVSEVHPSRLQ	SVSEVHPSR
EAEVASLNR	EAEVASLNR
SAIPAYSKR	SAIPAYSKR
STYPPSGPTYR	STYPPSTYR
STIGFKLPNHR	TIGFKLNHR
ESAPVHNSF	ESAPVHNSF
EVFTPVFER	EVFTPVFER
QVFKPPPEGTR	QVFKPPGTR
DTSRLTKITK	DTSRLTITK
HVAESSLSRLR	HVAESSLSR
EAQKPYLVQR	EAQKPYVQR
ETIPLTAEKL	ETIPLTAEK
EVANIPVAR	EVANIPVAR
EVVYRFTAR	EVVYRFTAR
NVAALPGIVHR	AALPGIVHR
TTVTVAPAPR	TTVTVAAPR
TADVHFER	-TADVHFER
ESFFPYQVTER	SFFPYQTER
LLVVYPWTQR	LVVYPWTQR
DYNVTANSK	DYNVTANSK
AEVDKVTGR	AEVDKVTGR
EAHFVPLVKR	EAHFVPVKR
SVAEMPQNYR	SVAEMPNYR
ETIPSFTGR	ETIPSFTGR
EAAAIIAQR	EAAAIIAQR
NAAFSANER	NAAFSANER
FTAFEEAQLPR	TAFEEALPR
VGEFSGANK	VGEFSGANK
DTGTLRPVRR	DTGTLRVRR
TVISLKKLIVR	TVISLKIVR
GSSPVFNQR	GSSPVFNQR
MTVPPPSVSGR	TVPPPSSGR
QVIGPLTEGQR	VIGPLTGQR
ESVSEVVVNR	SVSEVVVNR
EVVSQEAELR	EVVSQEELR
VATLPRGR	-VATLPRGR
TNAAVTVLR	TNAAVTVLR
TPFNYNPSPR	TPFNYNSPR
AVPEAIPTPR	AVPEAITPR
TVAELKQLVAR	TVAELKVAR
RVFPVRPGSGR	FPVRPGSGR
STIETVPYWTR	TIETVPWTR
EAYRFVKEK	EAYRFVKEK
NVHGGTILK	NVHGGTILK
WVSENFQER	WVSENFQER
EAAPNEELVQR	AAPNEEVQR
ELVSITANK	ELVSITANK
FVVEKVLDR	FVVEKVLDR
ETIGKKFEK	ETIGKKFEK
DSINVIDVNK	DSINVIVNK
FTASGEAEAR	TASGEAEAR
AAAGLAGPR	AAAGLAGPR
ETQPPVALK	ETQPPVALK
SVAGLLPRR	SVAGLLPRR
LVAPGLSARK	LVAPGLSAR
DIAEPGSVAGR	IAEPGSAGR
TSSGNPIFR	TSSGNPIFR
DVAAQQSLR	DVAAQQSLR
STMPHTSGMNR	STMPHTSGM
PASPVVHIR	PASPVVHIR
EAKFPTMNR	EAKFPTMNR
LAPERRSTL	LAPERRSTL
HAYPDELIRQR	HAYPDELIR
FSSGETATYR	FSSGETTYR
EVVTSMGTQR	EVVTSMTQR
SVPEFPLSPPK	SVPEFPSPP
QIFPSKPVSR	QIFPSKVSR
LPMQGNPPR	LPMQGNPPR
ESYSVYVYK	ESYSVYVYK
FVFKPNSKK	FVFKPNSKK
EVPEIVPFRL	EVPEIVPFR
EVIQNPATITR	EVIQNPITR
DAATEIVER	DAATEIVER
FVWSGTAEARK	FVWSGTEAR
EALHQKNIVHR	ALHQKNVHR
STFSTNYR	-STFSTNYR
EVESTEYVNR	EVESTEVNR
ATSPLQENR	ATSPLQENR
FSVSDLAPPR	SVSDLAPPR
ETIKQLQER	ETIKQLQER
EVFNKFFKER	EVFNKFKER
EALGSGLVSR	EALGSGVSR
EVVDTTASTKR	EVVDTTSTK
HTLEPLIPR	HTLEPLIPR
SAAAVLSHNR	SAAAVLHNR
QLFDPMTGTFR	QLFDPMTFR
ITTGNSPPR	ITTGNSPPR
EIVDVPVEK	EIVDVPVEK
ESFPSIGPQRL	ESFPSIPQR
ESMLTPPIAR	ESMLTPIAR
EAAKDLLYRR	EAAKDLLYR
MSHGVPVVR	MSHGVPVVR
EVTPVTGASLR	EVTPVTASL
ETFLAQRQR	ETFLAQRQR
FTASGEAEARR	TASGEAARR
DVAEVDTVR	DVAEVDTVR
NVPNSAIYKR	NVPNSAYKR
ETYLHRIGR	ETYLHRIGR
SVFGSGNTGR	SVFGSGTGR
ETDGFQVKR	ETDGFQVKR
SVPEAQSAL	SVPEAQSAL
HVYVNQGEILR	YVNQGEILR
TAYVMKDPETR	YVMKDPETR
EIFQNEVAR	EIFQNEVAR
EVLGAPVKGK	EVLGAPKGK
NAAGLLAAR	NAAGLLAAR
FVIDSDHLGHR	FVIDSDLGH
EVTDYTTGR	EVTDYTTGR
DSYASGEGLKR	YASGEGLKR
EVFFSEKIYKL	EVFFSEIYK
EGIGSTVFR	EGIGSTVFR
ISFSGLPSGR	ISFSGLSGR
MVGGVLVER	MVGGVLVER
EVTDVDSVVGR	TDVDSVVGR
EVKRLKVTELR	EVKRLKTEL
EITPPVVLR	EITPPVVLR
TTHSMALIHNR	HSMALIHNR
DLYQGLLLQR	DLYQGLLQR
IPVNGGLAAR	IPVNGGAAR
ETFRSSDPATR	ETFRSSATR
TTAFEVEER	TTAFEVEER
DAAGPREAFR	DAAGPRAFR
ENTAITIGR	ENTAITIGR
AEITPKGR	-AEITPKGR
EVYDIAFSR	EVYDIAFSR
SAPSRATAL	SAPSRATAL
NIIDNPYLR	NIIDNPYLR
ETSRLNIERM	ETSRLNIER
EMTGYVVTR	EMTGYVVTR
EAIGNEVTR	EAIGNEVTR
ETATTPIFANR	TATTPIANR
EVAGTVTGQKR	EVAGTVGQK
NTIGKEEIQQR	TIGKEEQQR
EVYHNLKNVIK	EVYHNLKNV
ETVSEEKRIYR	TVSEEKIYR
GLSPGVSVRS	GLSPGVSVR
DIQGHPFFR	DIQGHPFFR
NVIYINETHTR	IYINETHTR
EVYNEFVRKR	EVYNEFRKR
TTLELLEVRR	TTLELLVRR
EAFGPEDGLQR	EAFGPELQR
ETAIPSSTR	ETAIPSSTR
EVFGVTDNPR	EVFGVTNPR
TTGQVVAMK	TTGQVVAMK
QSSNLIQHR	QSSNLIQHR
ESTPITAVK	ESTPITAVK
AVFPSIVGR	AVFPSIVGR
FVSTVPSKLR	FVSTVPKLR
NVTDDTYYYR	NVTDDTYYR
EVYKELRLR	EVYKELRLR
DIYDRKNMPR	DIYDRKMPR
AAVPVAAAR	AAVPVAAAR
MVQQLGKA	-MVQQLGKA
EITALAPSTMK	TALAPSTMK
ETIDNGFGHSR	ETIDNGHSR
NSASATALVSR	SASATAVSR
EAMIEVNINK	EAMIEVINK
EVVDSNPYSR	EVVDSNYSR
EVNIPTDLR	EVNIPTDLR
SVAALTSKR	SVAALTSKR
QVVIFVKSVQR	VVIFVKVQR
DTISPYSRMKR	TISPYSMKR
DSMPEPASR	DSMPEPASR
LSELEAALQR	SELEAALQR
YSSTVVVKR	YSSTVVVKR
NVYPNFRPTPK	NVYPNFRPT
EVAGIINDAK	EVAGIIDAK
QVAPAQLVTR	QVAPAQVTR
TTKVTGSLETK	KVTGSLETK
EVFNDPKVLK	EVFNDPVLK
TVFESRNLR	TVFESRNLR
EVINKNVTEK	EVINKNTEK
EIIVDIATKR	EIIVDITKR
EVLSDPQTR	EVLSDPQTR
FSSSEKIKD	FSSSEKIKD
NTMDADSLVSR	MDADSLVSR
EIPENFTTR	EIPENFTTR
ESVGGRVAER	ESVGGRAER
MAAAGAAVARS	AAAGAAVAR
AAVPVIISR	AAVPVIISR
EVYVEVAYPR	EVYVEVYPR
EIVTERSVSSR	IVTERSSSR
EVQGISEHYLR	EVQGISHYL
EVVAKFLHK	EVVAKFLHK
TPTISRER	-TPTISRER
AAVDVVRAR	AAVDVVRAR
EVLNKHSLSGR	EVLNKHSGR
ETFKEQGNAYY	ETFKEQNAY
TYKLILNGK	TYKLILNGK
TGNPTVVR	-TGNPTVVR
EIVSRVSKR	EIVSRVSKR
EVWKGIKKR	EVWKGIKKR
ATIDVEHSHVR	ATIDVEHSH
MTFTSQLIVER	FTSQLIVER
YAAFVQTHR	YAAFVQTHR
ETLKHSGIGR	ETLKHSIGR
TVVDIDPPLR	TVVDIDPLR
EAVSVYPEKL	EAVSVYPEK
EVPSPEAGR	EVPSPEAGR
ETQPGRLLGR	ETQPGRLGR
ELFEDSQLTTR	ELFEDSTTR
EVFDFSQRR	EVFDFSQRR
YSFTTTAER	YSFTTTAER
ENADVPVVR	ENADVPVVR
FNEKSKEL	-FNEKSKEL
EVVNKRFVR	EVVNKRFVR
EAFETFINKR	EAFETFNKR
TVAAVFRGR	TVAAVFRGR
EIAAVIETV	EIAAVIETV
DAYPKNPHLR	DAYPKNHLR
DTPGIQIGR	DTPGIQIGR
SVFTNERFPLR	FTNERFPLR
VTLTSEEEAR	TLTSEEEAR
HAIKSVKIYR	HAIKSVIYR
DVAAVVDGRL	DVAAVVDGR
HVYVGNISKK	HVYVGNISK
HVHEPNPLR	HVHEPNPLR
QVADVVVSR	QVADVVVSR
MVGPPGTGK	MVGPPGTGK
ESFGVPKGR	ESFGVPKGR
IPAAIATAKR	IPAAIAAKR
SVSEGLNVPR	SVSEGLVPR
DTIVSGTLPQR	TIVSGTPQR
QISEVVVVK	QISEVVVVK
NTIPEVHKK	NTIPEVHKK
DLAKIIFKR	DLAKIIFKR
NAIGGKYNR	NAIGGKYNR
SVTPEGVIKQR	VTPEGVKQR
QVVGEATFIAR	VVGEATIAR
EIAKLKAAQR	EIAKLKAQR
MVIDLEKQIEK	IDLEKQIEK
ITAGLDPVGR	ITAGLDVGR
HIVSIEVQR	HIVSIEVQR
EVIKSMKPK	EVIKSMKPK
DVYPEIIER	DVYPEIIER
ETATPAPVEK	ETATPAVEK
EISPSVTKK	EISPSVTKK
ATSGIDPVVR	ATSGIDVVR
NVKDKPTVER	NVKDKPVER
NTIQNEAQR	NTIQNEAQR
EVAERLGVTR	EVAERLVTR
EVYPFGIVGM	EVYPFGVGM
DTITETDLR	DTITETDLR
IGGIGTVPVGR	GIGTVPVGR
SVIRPILKR	SVIRPILKR
ETPDIKLFGK	ETPDIKFGK
DAVNLAFGR	DAVNLAFGR
ETAIPFRSR	ETAIPFRSR
EIISHDTRRFR	EIISHDTRR
