Data	Data aligned
REIEELLAEA	REIEELAEA
AEPSFPFQVA	AEPSFFQVA
QEILGVLVP	QEILGVLVP
QEFNRLLEA	QEFNRLLEA
HEYPPGLLVA	HEYPPLLVA
IESPPAFTA	IESPPAFTA
SELPFTIAS	SELPFTIAS
GEIPKVLVA	GEIPKVLVA
LEDRPRLLP	LEDRPRLLP
GEFLAFQTV	GEFLAFQTV
IINTDTLA	IINTDT-LA
GEIPAELRAA	GEIPALRAA
GELPFLTHV	GELPFLTHV
AEIASSLPAA	AEIASLPAA
KEYLFYLNV	KEYLFYLNV
LEHYFHAVVA	LEHYFAVVA
AEYLLGPLYA	AEYLLPLYA
AEGPVAVVV	AEGPVAVVV
GEHLPFLTSV	GEHLPLTSV
LEIENLNLA	LEIENLNLA
KDYPFYLTV	KDYPFYLTV
QEINTLLEA	QEINTLLEA
GEFQSFPKVF	GEFQSFPKV
GETIFVTAP	GETIFVTAP
KEFSPFGTI	KEFSPFGTI
SELAGLLSA	SELAGLLSA
IEIELENSRP	IEIELNSRP
LEAWLQREA	LEAWLQREA
YEYRFLEFT	YEYRFLEFT
AEQPWPPLPA	AEQPWPPLP
SEVNLFLVP	SEVNLFLVP
TELLWPGAA	TELLWPGAA
LELPHLTSA	LELPHLTSA
IEAKFYEEV	IEAKFYEEV
LEAAQGLLVEA	LEAAQGLLV
ELWQVLGAP	ELWQVLGAP
FEFGVFPAIL	FEFGVFPAI
AETEFFSKA	AETEFFSKA
VEVIKPLVA	VEVIKPLVA
GEIFDHLVA	GEIFDHLVA
AELLGFLTHA	AELLGLTHA
YEIPPITPP	YEIPPITPP
REYEIPSNLTP	YEIPSNLTP
FEARIALLP	FEARIALLP
PEFKFWHAA	PEFKFWHAA
LEINFGDLGRP	LEINFLGRP
LEVLKLLVA	LEVLKLLVA
YELLFKEGV	YELLFKEGV
AEYLHWLLT	AEYLHWLLT
AEADKIGLLLA	AEADKLLLA
FEKVFSIGP	FEKVFSIGP
FDKTFEISA	FDKTFEISA
FEQKGFRLV	FEQKGFRLV
LEAVLKLLP	LEAVLKLLP
DEYQFFTQA	DEYQFFTQA
QEFQDAWKLP	QEFQDWKLP
GELGNGNIKL	GELGNNIKL
LEFAFRYVTT	LEFAFRYVT
GEYGGWYKA	GEYGGWYKA
KEFQLFQGV	KEFQLFQGV
EEFPAFPRA	EEFPAFPRA
REHPVPLLP	REHPVPLLP
GEYDFRYIFV	GEYDFYIFV
SEVGKLLSA	SEVGKLLSA
REIWNQISA	REIWNQISA
LEIEFKETQA	LEIEFETQA
VEFMHYIIA	VEFMHYIIA
AEALPSLAA	AEALPSLAA
FEFGVFPAI	FEFGVFPAI
VEVGGLLGV	VEVGGLLGV
QEFQNFKTL	QEFQNFKTL
WEIDNNPKV	WEIDNNPKV
LEFPYGILAA	LEFPYILAA
LEAILAAVP	LEAILAAVP
LEVPGLRSV	LEVPGLRSV
KEHLYFETV	KEHLYFETV
KDLLFILTA	KDLLFILTA
TDFAFRITP	TDFAFRITP
LEHPFVSSI	LEHPFVSSI
LEIVNPQAA	LEIVNPQAA
TEAPRWPLP	TEAPRWPLP
KELEFLTQA	KELEFLTQA
YELEHLSTP	YELEHLSTP
LAEVANFIP	LAEVANFIP
AEIIFNPSA	AEIIFNPSA
LEIAPHALLQA	LEIAPLLQA
VERVIEFAA	VERVIEFAA
AEIKVKLIEA	AEIKVLIEA
KEIDVISIP	KEIDVISIP
SELEKTFNLP	SELEKFNLP
AELLIFSVP	AELLIFSVP
RESGQLFHIDF	RESGQLFHI
KEYFGIVSV	KEYFGIVSV
VEIRSGFLAA	VEIRSFLAA
VEHEDFLTV	VEHEDFLTV
IEILPVAVA	IEILPVAVA
KEYAAFVLGA	KEYAAVLGA
SEFSFSKLAA	SEFSFKLAA
AEANAFSVLQH	AEANAFSVL
FEARFFHLA	FEARFFHLA
TEAQHLFLQA	TEAQHFLQA
YEKILFTEA	YEKILFTEA
KEYPFILDA	KEYPFILDA
SELAFPITA	SELAFPITA
LEIEGERELP	LEIEGRELP
LEFEHQRAP	LEFEHQRAP
LEAHFVPLV	LEAHFVPLV
AEIDAHLVAL	AEIDAHLVA
WEYDESHVITA	WEYDEVITA
FEFTDFTLP	FEFTDFTLP
SEYQWITSP	SEYQWITSP
FEFPRPFLP	FEFPRPFLP
IELDMRTIA	IELDMRTIA
TEILKSVVA	TEILKSVVA
AELEFAIQP	AELEFAIQP
SEFQPSFHQA	SEFQPFHQA
WEALVSPVV	WEALVSPVV
GEYEWVHKP	GEYEWVHKP
GEAEAFAIGA	GEAEAAIGA
FEYVKVPLA	FEYVKVPLA
AEVWWNLVP	AEVWWNLVP
GEIVTTIPTI	GEIVTIPTI
LENPSPFHSP	LENPSFHSP
QELSRFIAA	QELSRFIAA
TEFPLFLQT	TEFPLFLQT
RETDFYLQSV	RETDFLQSV
REINTILKA	REINTILKA
REFPVISVV	REFPVISVV
IEIERILSV	IEIERILSV
YEFDFSKVYW	YEFDFSKVY
VEFPDFSST	VEFPDFSST
YELALILKA	YELALILKA
AELADVLTEA	AELADLTEA
AEILRSLNSA	AEILRLNSA
TEIDSIPPLP	TEIDSPPLP
AEFWKFSGIVF	AEFWKFSGI
AELGVPLSQV	AELGVLSQV
KEFPYGIEA	KEFPYGIEA
WELLPSAAA	WELLPSAAA
REVYSILQA	REVYSILQA
REHAPFLVA	REHAPFLVA
VEFNFGQRA	VEFNFGQRA
AEFPGLPEA	AEFPGLPEA
FEFLTKELA	FEFLTKELA
AENYFQLSV	AENYFQLSV
LELPPPGLP	LELPPPGLP
WEVYLRETA	WEVYLRETA
LEYDPLSNYSA	LEYDPLSNY
YEIPGLEPITF	YEIPGLEPI
VELFFQEVA	VELFFQEVA
AEFLQKLLP	AEFLQKLLP
FEFRAIEA	FEFRAI-EA
QEVFGLAVV	QEVFGLAVV
AEAQLRFIQA	AEAQLFIQA
EEHNFFLAP	EEHNFFLAP
AEYEFLSFV	AEYEFLSFV
REIFLSQPILL	REIFLQPIL
IEYKDFKLIY	IEYKDFKLI
SEIDESVKLIP	SEIDESVKL
AEAFGFKVNA	AEAFGKVNA
LEALPQIAA	LEALPQIAA
GETIFVERP	GETIFVERP
AEHPTIKIFW	AEHPTIKIF
LEAIPTSGLTA	LEAIPGLTA
YEAPIFTIP	YEAPIFTIP
IEWRFTEA	IEWRFT-EA
AETPGFGAVTF	AETPGFGAV
SEFISFITS	SEFISFITS
TEDPHTVLVEF	TEDPHTVLV
KEYDFGLGAP	KEYDFGLGA
TELELFKAA	TELELFKAA
GEYKFFWTA	GEYKFFWTA
LEFKEFVGLP	LEFKEVGLP
KEFEFSQLP	KEFEFSQLP
LEIIEFRAA	LEIIEFRAA
KELIFQETA	KELIFQETA
RELLIIGGVAA	RELLIGGVA
TEFQEFLSV	TEFQEFLSV
IDRLFDTSA	IDRLFDTSA
REYNARLFGLA	REYNAFGLA
VEFVKSFNLP	VEFVKFNLP
KEFNFPEEA	KEFNFPEEA
VEFEDFSQP	VEFEDFSQP
IEIYPLAEA	IEIYPLAEA
GEFRQGLISA	GEFRQLISA
TEYAFAFIQV	TEYAFFIQV
VELSQLRVA	VELSQLRVA
YELDLGLNHVV	YELDLLNHV
EEYYPFSEV	EEYYPFSEV
AEFLTFHYA	AEFLTFHYA
FEILPGLSV	FEILPGLSV
REGDLLFTVA	REGDLFTVA
LEVKLGELP	LEVKLGELP
GEILGLLGP	GEILGLLGP
VEFHRLWSA	VEFHRLWSA
FERPEGFLQA	FERPEFLQA
WEVVPEPVA	WEVVPEPVA
YEILNNPEL	YEILNNPEL
EEHEWFIPA	EEHEWFIPA
AEHDLWHIIKF	AEHDLWHII
YEYKFGFEL	YEYKFGFEL
AEIQFADYIFP	AEIQFADYI
RELDPSLVSA	RELDPLVSA
KEIQGFFNIP	KEIQGFNIP
LELIGHAVA	LELIGHAVA
HEFLHEVPAA	HEFLHVPAA
ASIALEDLLP	ASIALDLLP
LEFPFRKDL	LEFPFRKDL
GEINVIGEP	GEINVIGEP
LEVVKFTQA	LEVVKFTQA
LEFLNRFEEA	LEFLNFEEA
MEYPNFEET	MEYPNFEET
REYPNLVTI	REYPNLVTI
AEDVLSGKVSA	AEDVLKVSA
FEAPATINSA	FEAPAINSA
LESLPEPVI	LESLPEPVI
TEIWFLDRA	TEIWFLDRA
AEFQVKITA	AEFQVKITA
AEAVFASEV	AEAVFASEV
TELRFEVEA	TELRFEVEA
DAKIRIFDL	DAKIRIFDL
NEYRFAWVEA	NEYRFWVEA
QERIDAWAQL	QERIDWAQL
QEFSFGNLRA	QEFSFNLRA
GEDSSFLVVRL	GEDSSFLVV
FEFDIFTRL	FEFDIFTRL
REAFGFEQA	REAFGFEQA
READFFWSL	READFFWSL
REYEIEFIYA	REYEIFIYA
AEWLGVLKA	AEWLGVLKA
IEAFTPLLA	IEAFTPLLA
REIEIPLGELF	REIEILGEL
AERFHFEAL	AERFHFEAL
DPFNPFELTNH	DPFNPFELT
GEADVPFYYA	GEADVFYYA
WEFPINNEA	WEFPINNEA
AEVDRQVIP	AEVDRQVIP
VEVPETPKA	VEVPETPKA
YEQDFAVLTA	YEQDFVLTA
GEFLPIQPA	GEFLPIQPA
AEAIPEPVV	AEAIPEPVV
AELDSVFSSA	AELDSFSSA
FEVPHELVA	FEVPHELVA
KEYPDFNFV	KEYPDFNFV
REIFFPETA	REIFFPETA
AEFAPFVVFI	AEFAPFVVF
FENLFSKPP	FENLFSKPP
AEAAVVAVA	AEAAVVAVA
QELPGLPAP	QELPGLPAP
TEFRNFIVW	TEFRNFIVW
YEILRLLVT	YEILRLLVT
TEAPPIIFA	TEAPPIIFA
AEVLTFLDA	AEVLTFLDA
AEKDFWELA	AEKDFWELA
SEIYGLMKA	SEIYGLMKA
LEYGLPIQV	LEYGLPIQV
VEYNGGFHLA	VEYNGFHLA
WEIENNPTV	WEIENNPTV
GEFVFATSL	GEFVFATSL
AEAIRILAA	AEAIRILAA
AEYIPLTPAA	AEYIPLTPA
TEYSFLKEV	TEYSFLKEV
NAPWAVTSL	NAPWAVTSL
AEILNGKEISA	AEILNEISA
AEYDRPNLLP	AEYDRNLLP
VEWSAFLEA	VEWSAFLEA
TEFLSIITS	TEFLSIITS
GEFTFLLPA	GEFTFLLPA
VEHDAFIFA	VEHDAFIFA
SEYSGFVNPVL	SEYSGFVNP
RPPGFSPFR	RPPGFSPFR
LEYLAFSDS	LEYLAFSDS
GELLFVHSA	GELLFVHSA
REYDRFYVINY	REYDRFYVI
REFDFFNKI	REFDFFNKI
QEYPTLKVP	QEYPTLKVP
AEQPYFIEA	AEQPYFIEA
TEFPGVVA	TEFPGV-VA
IEVEKPFAIA	IEVEKFAIA
AEHFSIIRA	AEHFSIIRA
AEARPFEVL	AEARPFEVL
AEYEFISSGL	AEYEFSSGL
VEFMHYIIAA	VEFMHIIAA
FEVKKWNAV	FEVKKWNAV
IEAPHFPLP	IEAPHFPLP
VEFNGKLLAS	VEFNGKLLA
TEIVKILSA	TEIVKILSA
GEEFLFRTA	GEEFLFRTA
YELDLGLNHV	YELDLLNHV
IEVSLPEAA	IEVSLPEAA
SEAIFLEA	SEAIFL-EA
LEIPDILNA	LEIPDILNA
LEVVRFFY	LEVVRF-FY
GEFGGFSEV	GEFGGFSEV
LEREEFLVP	LEREEFLVP
FELLDRILP	FELLDRILP
AELSFFGHA	AELSFFGHA
AEITELIHIA	AEITEIHIA
LEYPDFYRKL	LEYPDYRKL
TEYENFKVQVL	TEYENKVQV
AEAFRLPTA	AEAFRLPTA
MEIERILGV	MEIERILGV
LEVFPEFAAA	LEVFPFAAA
DAERQLLAP	DAERQLLAP
GEYGKFFVT	GEYGKFFVT
AEFHQIEGVVA	AEFHQIEGV
GENLGFWEA	GENLGFWEA
AEILELAGNAA	AEILEAGNA
GEITFLEA	GEITFL-EA
SEIPKLPAV	SEIPKLPAV
HLPETKFSEL	LPETKFSEL
AEVEKWLGP	AEVEKWLGP
KEVEQFTQV	KEVEQFTQV
AEHFSMIRA	AEHFSMIRA
REFSDFIRV	REFSDFIRV
VEFRNFKIIY	VEFRNFKII
MEVELPAAA	MEVELPAAA
GEIVRLTTP	GEIVRLTTP
KEYLFYAEA	KEYLFYAEA
QEYFGSLAA	QEYFGSLAA
AEYGHFVDIRI	AEYGHFVDI
QEFAEGFVKA	QEFAEFVKA
AEINNIIKIV	AEINNIIKI
AEALAAFTA	AEALAAFTA
LEYDPAKRITL	LEYDPAKRI
LEHGAWRLP	LEHGAWRLP
AEIYEEFLAA	AEIYEFLAA
AEGAFPNLA	AEGAFPNLA
SETPFHFTLP	SETPFFTLP
AEYAGLKVA	AEYAGLKVA
AEIDPKQLVDI	AEIDPKQLV
SEVELMKVA	SEVELMKVA
RVYIHPFHL	RVYIHPFHL
VEFNGKLLA	VEFNGKLLA
GEIEGFRLSA	GEIEGRLSA
WEIKTITSA	WEIKTITSA
HENILGFIAA	HENILFIAA
REFLFNAIETM	REFLFAIET
LEIVPFRVA	LEIVPFRVA
SEFRNPLAP	SEFRNPLAP
AEVKPILQA	AEVKPILQA
GEVPPGPLP	GEVPPGPLP
FEFLLKLTP	FEFLLKLTP
AEYGHFVDI	AEYGHFVDI
AEHGIFLPP	AEHGIFLPP
AEDLNLLIA	AEDLNLLIA
AEIDLFRAA	AEIDLFRAA
AELDVPALP	AELDVPALP
AEAIPGLAA	AEAIPGLAA
GENFDKLLA	GENFDKLLA
AEYIPLTPAAA	AEYIPLTPA
VEALPLVEA	VEALPLVEA
FEIRGTLLP	FEIRGTLLP
TEFESFSF	TEFESF-SF
FEWTFPTRP	FEWTFPTRP
FEYPVQIEP	FEYPVQIEP
GELPLSLAA	GELPLSLAA
REFALRLVA	REFALRLVA
HEYPWILSA	HEYPWILSA
AEAQLWWAA	AEAQLWWAA
AEIAHLYIA	AEIAHLYIA
REFVLLPAA	REFVLLPAA
LETLPFGIA	LETLPFGIA
WEAYLSRLGV	WEAYLRLGV
ESLAGILGT	ESLAGILGT
IEQEFLTEA	IEQEFLTEA
AEIAPFVEI	AEIAPFVEI
AEINNIIKI	AEINNIIKI
REYMGFIQA	REYMGFIQA
AEFPLGPVTTA	AEFPLVTTA
VEIFHPLRL	VEIFHPLRL
AELDKLTSV	AELDKLTSV
AEYSRFVNQI	AEYSRVNQI
AEIIQLVNA	AEIIQLVNA
LEWPSLTA	LEWPSL-TA
IELPSMAVA	IELPSMAVA
VEYIFGIVGIP	VEYIFIVGI
TLPPPDFPPP	LPPPDFPPP
GETDPLLIA	GETDPLLIA
GEAIPALAA	GEAIPALAA
FEFEYQTKV	FEFEYQTKV
SEVTFALHSA	SEVTFLHSA
GEREIWNQI	GEREIWNQI
AEFDTFLAS	AEFDTFLAS
LEIPRLPPP	LEIPRLPPP
FEFDTKTSA	FEFDTKTSA
FEVGPPAFRIA	FEVGPFRIA
QEFDYQPIAA	QEFDYQPIA
SELDRLLSA	SELDRLLSA
LEHALFTAL	LEHALFTAL
GELSDWSLP	GELSDWSLP
YEFNVWTRP	YEFNVWTRP
TEFPNFKY	TEFPNF-KY
LEYGFLRLSQA	LEYGFLRLS
IEIDFPRAA	IEIDFPRAA
VNLPINGNGKQ	LPINGNGKQ
GEYGKFFVTI	GEYGKFVTI
SEYNFEDLSA	SEYNFDLSA
AEYDNFFQHL	AEYDNFQHL
YELQFRLGP	YELQFRLGP
SEHVWVEVV	SEHVWVEVV
GEAWPFESV	GEAWPFESV
QEYGSIFTGA	QEYGSFTGA
REALFNEFVAA	REALFNEFV
MEFQRFVTP	MEFQRFVTP
LEIIQSSLP	LEIIQSSLP
YELAQVLLA	YELAQVLLA
GEIFNVQLP	GEIFNVQLP
AELATRAIP	AELATRAIP
YEFPRVFSSV	YEFPRFSSV
YEAFLVGKP	YEAFLVGKP
YEVRLTQTV	YEVRLTQTV
YEYLLHVGA	YEYLLHVGA
YERLFGTTV	YERLFGTTV
AEHDLWHII	AEHDLWHII
REFSDFIQAV	REFSDFIQA
RENVFKLLP	RENVFKLLP
WEAYLGLLQA	WEAYLLLQA
EEFGDFRLV	EEFGDFRLV
AEALNVFQQA	AEALNFQQA
AEFEWENKV	AEFEWENKV
SELERLIVP	SELERLIVP
LEIQQELKTA	LEIQQLKTA
QEFPFPETP	QEFPFPETP
AEVYRILSV	AEVYRILSV
EEFSFIPSA	EEFSFIPSA
KEIFQTTVP	KEIFQTTVP
DRVYIHPFHL	RVYIHPFHL
LEFERWLNA	LEFERWLNA
FEANFGKIQA	FEANFKIQA
QELEFLRVA	QELEFLRVA
AEIDSLWEIS	AEIDSLWEI
QEYDALAKVI	QEYDALAKV
AEWKFLNPA	AEWKFLNPA
AEFFLSQQA	AEFFLSQQA
GWHTFPLTEA	GWHTFLTEA
LELDTNLPA	LELDTNLPA
FEYSIRTTP	FEYSIRTTP
MEALPLLAA	MEALPLLAA
SEWKFTITP	SEWKFTITP
RESVFKLLP	RESVFKLLP
FELPYVSVT	FELPYVSVT
LFTGELAE	LFTGEL-AE
AELWKNPTA	AELWKNPTA
TEIGKLLSS	TEIGKLLSS
KEIDAYIVQA	KEIDAIVQA
MEHPYFYTV	MEHPYFYTV
VTQLDIVP	VTQLDI-VP
YEVRLTQTVA	YEVRLQTVA
YELTYFLEA	YELTYFLEA
YEFGQIINA	YEFGQIINA
LEARFTGVGV	LEARFGVGV
YEYYPHVYP	YEYYPHVYP
AELYGPFTSA	AELYGFTSA
KITPLEIEVL	LEIEVL---
QEFLTEALP	QEFLTEALP
QEFSFFDKV	QEFSFFDKV
TVEYVTFTSIA	VEYVTFTSI
LSVAVDLSLP	SVAVDLSLP
YEKLGFPGA	YEKLGFPGA
TEFLFHTA	TEFLFH-TA
VEIFKFEEA	VEIFKFEEA
READAALFSEL	ADAALFSEL
GEYVSLGKVEA	GEYVSLGKV
AEIDAHLVA	AEIDAHLVA
RELLIIGGVA	RELLIGGVA
AEIDFRLVSF	AEIDFRLVS
KEFPFDVQP	KEFPFDVQP
TEIRDMLLA	TEIRDMLLA
SEIAFHTIP	SEIAFHTIP
QELPRLLSA	QELPRLLSA
LSENITLA	LSENIT-LA
LELPGQPVA	LELPGQPVA
GEITLRGLVLP	GEITLRGLV
IERPIRIVA	IERPIRIVA
FEIPTGREA	FEIPTGREA
AELLPLVSA	AELLPLVSA
LEYYDFYEV	LEYYDFYEV
LEAPDLLLA	LEAPDLLLA
QEVFPVLAA	QEVFPVLAA
LEHQVFTVL	LEHQVFTVL
GEFGGFGSVT	GEFGGFGSV
AEVGRVLQV	AEVGRVLQV
GEFGGFGSV	GEFGGFGSV
LEYIARAILSA	LEYIAILSA
KEYDGFTITI	KEYDGFTIT
