Data	Data aligned
DMKKFGGPGR	DMKKFGPGR
DFLVVPPSRYR	DFLVVPPSR
DVLNPSGTQR	DVLNPSTQR
DMVSSHVER	DMVSSHVER
DSIDQKWTR	DSIDQKWTR
ETVQKETIHPR	TVQKETHPR
DPMFRGIYR	DPMFRGIYR
MSMEISIHR	MSMEISIHR
DVFNITIAR	DVFNITIAR
DMLPNSTER	DMLPNSTER
DVEVLKVGR	DVEVLKVGR
SYLDKFFSR	SYLDKFFSR
SMLEYFINR	SMLEYFINR
DIYLRMTGR	DIYLRMTGR
DFRDKMMGR	DFRDKMMGR
DLRQYLILR	DLRQYLILR
NTMMRKAIR	NTMMRKAIR
DVVPVDSKRYR	DVVPVDSKR
DLMRRQEELR	DLMRRQELR
IAAVPPQYR	IAAVPPQYR
DVRSVTSVRR	DVRSVTSVR
DVQEMNAVR	DVQEMNAVR
DASLQRIER	DASLQRIER
DATSRNITEAR	TSRNITEAR
DAFRPASR	DAFRP-ASR
DAMEEFLNR	DAMEEFLNR
DVLQTGTQR	DVLQTGTQR
DTTLPASAR	DTTLPASAR
HSLAPMYYR	HSLAPMYYR
SANDYFSER	SANDYFSER
DYLHSGKIVYR	DYLHSGVYR
EISGTFTHR	EISGTFTHR
DYNPSFAIR	DYNPSFAIR
DSLGVYQGR	DSLGVYQGR
NYFEPPIPR	NYFEPPIPR
AAPEGKRSL	AAPEGKRSL
DTRPHYITR	DTRPHYITR
TTFTWNINHAR	FTWNINHAR
EFNPNFVAR	EFNPNFVAR
GDDFLRRSSSR	DFLRRSSSR
SVPEAQSAL	SVPEAQSAL
VAVTPFSLR	VAVTPFSLR
DVKFSHSGR	DVKFSHSGR
SLKGVDPKFLR	SLKGVDFLR
EVLDHKEFK	EVLDHKEFK
DVAAQQSLR	DVAAQQSLR
VLYDRQGIGR	VLYDRQIGR
DLLVVTKIFQK	LVVTKIFQK
MVNVPKTR	MVNVP-KTR
QSNLIVHQR	QSNLIVHQR
DTLVPYGNR	DTLVPYGNR
DANPVRYGR	DANPVRYGR
QAFEREVGR	QAFEREVGR
NAQGPLYEQR	NAQGPLEQR
NSNLITWNR	NSNLITWNR
EALQPLINR	EALQPLINR
DSKRVFGER	DSKRVFGER
EILRGLTPR	EILRGLTPR
VPYVPLRQR	VPYVPLRQR
DINGKMWLR	DINGKMWLR
DIMAAVSGR	DIMAAVSGR
VVKDITNAFR	VVKDITAFR
EVAGIVAAR	EVAGIVAAR
EVAQREAETLR	VAQREATLR
NNANVTWWR	NNANVTWWR
DNSPGTLTLR	DNSPGTTLR
LYRHFDETVNR	HFDET-VNR
SYVELSQYR	SYVELSQYR
DSLSLSTQR	DSLSLSTQR
DFRQPPEEDLR	DFRQPPDLR
NDFVPPAPR	NDFVPPAPR
EILRRLTGR	EILRRLTGR
DIKDTDVIMKR	DTDVI-MKR
DVFSHRFYK	DVFSHRFYK
EVFEYIIFR	EVFEYIIFR
DYLVPILAPR	DYLVPIAPR
TGNPTVVR	TGNPT-VVR
MFAERLAKR	MFAERLAKR
DTKEVFAGK	DTKEVFAGK
TYKYFKDYR	TYKYFKDYR
DFLKVLNRAR	DFLKVLRAR
HFKKPGLTGR	HFKKPGTGR
DINKKFSVR	DINKKFSVR
EFKAVQQVQR	EFKAVQVQR
DRALESLR	DRALE-SLR
DVRNFDYTAR	DVRNFDTAR
DSIKIWNR	DSIKI-WNR
FDFSTRFITR	DFSTRFITR
DAYGIGTYR	DAYGIGTYR
QIPEIKQTL	QIPEIKQTL
DIKPENILVDR	DIKPENVDR
EVLAEFERRKR	EVLAEFERR
DLLKSIVSR	DLLKSIVSR
DVARLVVER	DVARLVVER
DSMKSFFRRL	DSMKSFFRR
DATVTISHR	DATVTISHR
EYVNIQTFR	EYVNIQTFR
DNYIPVIKR	DNYIPVIKR
DYQQTIKKYR	DYQQTIKYR
NSNLIVHQR	NSNLIVHQR
EYISTEFNR	EYISTEFNR
EVYVPHPR	EVYVP-HPR
DMRKIGSSR	DMRKIGSSR
VASTPISQR	VASTPISQR
DNFNGIKIKGR	NFNGIKKGR
DLLLIRKNR	DLLLIRKNR
DALTGHLR	DALTG-HLR
EIASVAYRYR	EIASVARYR
EVQDRVMLTGR	EVQDRVTGR
DYVDIVQGR	DYVDIVQGR
DAVNLAFGR	DAVNLAFGR
DILSVASVR	DILSVASVR
DLKKIQFPK	DLKKIQFPK
DMFIYWIHR	DMFIYWIHR
DAQRLISER	DAQRLISER
EVRVANELNAR	VANEL-NAR
GFLYRKTDFYR	LYRKTDFYR
DIAFKIVNR	DIAFKIVNR
DAMQFSKKR	DAMQFSKKR
SFFSPSPARKR	SFFSPSPAR
DTYVEFPLR	DTYVEFPLR
TMYPGLPSRL	TMYPGLPSR
DVNQQEFVR	DVNQQEFVR
DVLEVTKKFMR	DVLEV-TKK
DFLHNKGIAHR	DFLHNKAHR
DVRFPEKRR	DVRFPEKRR
EDYRDTVVKR	DYRDTVVKR
GASLLSNMSR	SLLSN-MSR
HNLNIMIKR	HNLNIMIKR
DYIHSKKLIHR	HSKKL-IHR
DNFPFDPPFVR	FPFDPPFVR
DAKFVEERR	DAKFVEERR
SVQPSSSLSAR	QPSSSLSAR
DILFPKMPK	DILFPKMPK
DAWPGQRER	DAWPGQRER
DMFKDFAAR	DMFKDFAAR
TIIEVNGKRVR	EVNGK-RVR
DVWTPPAR	DVWTP-PAR
DSQDIQGRNR	DSQDIQRNR
DLKKEINER	DLKKEINER
IARDRALEGR	IARDRAEGR
EIKDFLLTAR	EIKDFLTAR
DYRKLSQER	DYRKLSQER
DSLGQDLRRLR	DSLGQDLRR
ETNYGIPQR	ETNYGIPQR
SAIHIRVFR	SAIHIRVFR
DVQHFKVLR	DVQHFKVLR
DTQLVLGNR	DTQLVLGNR
DVRERIIKR	DVRERIIKR
NALTLPHNR	NALTLPHNR
DVSTTIYNR	DVSTTIYNR
IPYTPAMQR	IPYTPAMQR
DAAALVAGR	DAAALVAGR
EVEPQGVIVTR	EPQGVIVTR
DTIVSGTLPQR	IVSGTLPQR
DLQAHINHR	DLQAHINHR
DTFLKGKSGLR	DTFLKGSGL
DSQYPPVQR	DSQYPPVQR
DTHKQLLER	DTHKQLLER
DTWHYFLHR	DTWHYFLHR
LVVTKIFQK	LVVTKIFQK
DTQNALKNYR	DTQNALNYR
DIKSYYTVR	DIKSYYTVR
DESGPSIVHR	ESGPSIVHR
YFAERVTSL	YFAERVTSL
DINGFTTGR	DINGFTTGR
TAIRPIALR	TAIRPIALR
DLNAQYERR	DLNAQYERR
DLFNKLVMR	DLFNKLVMR
ETLETIINRL	ETLETIINR
QQLYWSHPR	QQLYWSHPR
EVRAVGQGVLR	EVRAVGVLR
DTRARELKEQL	DTRAR-ELK
DFKGRFKAR	DFKGRFKAR
DSFQKVILR	DSFQKVILR
NLLDLKNPFFR	DLKNP-FFR
DIFYKAIQKR	DIFYKAQKR
DVFIPKPFR	DVFIPKPFR
GGIAGIFNWAV	IAGIFNWAV
NMFDHPIPR	NMFDHPIPR
IALTDNALIAR	LTDNALIAR
DYKTIAKER	DYKTIAKER
DTKGHSLSVQR	DTKGHSVQR
DLQRNLPER	DLQRNLPER
LPWVPPDTKL	LPWVPPDTK
ENFGNTTPR	ENFGNTTPR
SVPLAATSM	SVPLAATSM
NAESRVNR	NAESR-VNR
DIIQPSSTRAR	DIIQPSSTR
DLRELFARR	DLRELFARR
NARDTVFYR	NARDTVFYR
DPWARGSYSYV	DPWARGSYS
DMRKIGQAR	DMRKIGQAR
HALELVVSR	HALELVVSR
DLLAKEKDNSR	LAKEKDNSR
SVLDYFSER	SVLDYFSER
MLWERLSSTKR	ERLSS-TKR
VAFKPTSNR	VAFKPTSNR
DILDHERKR	DILDHERKR
NFNYIEFTR	NFNYIEFTR
MVLAHVTNR	MVLAHVTNR
DAFAYVQER	DAFAYVQER
DVSVISSR	DVSVI-SSR
SVDFHFRTDER	DFHFRTDER
DLSPWAVSR	DLSPWAVSR
STRPPSVTR	STRPPSVTR
DSNSIIKDR	DSNSIIKDR
DGYVPPKSR	DGYVPPKSR
DAHARPFGTIR	HARPFGTIR
DMLFPKFLK	DMLFPKFLK
DAFSYGYVR	DAFSYGYVR
DYIKLYVRR	DYIKLYVRR
LAQAWIAQR	LAQAWIAQR
DLQSMEQIRR	DLQSMEIRR
DPNNIFGNR	DPNNIFGNR
HIFRPQIER	HIFRPQIER
MAYVPVSR	MAYVP-VSR
NLKPPQAKR	NLKPPQAKR
DVKDAVVQH	DVKDAVVQH
DLATIHGMNR	DLATIHMNR
GDYKTIAKER	DYKTIAKER
DLFVFPYR	DLFVF-PYR
EYLEKIKQR	EYLEKIKQR
FYKAIQKRR	FYKAIQKRR
DLFVNTNR	DLFVN-TNR
MNFNPIISR	MNFNPIISR
NAMLPFHHR	NAMLPFHHR
DLKKPIYQR	DLKKPIYQR
HNQGPVIKR	HNQGPVIKR
DLWKRWKTSEV	DLWKRWTSE
YDRQGIGR	YDRQG-IGR
NTIQKFVSR	NTIQKFVSR
DFRRAPFAGR	DFRRAPAGR
DYKLRADDYR	DYKLRADYR
EFQQLPYHR	EFQQLPYHR
HFNAPSHVR	HFNAPSHVR
DLLKKFQTK	DLLKKFQTK
DPSGDFSVR	DPSGDFSVR
DAAGTSLYVR	DAAGTSYVR
DAKDDFPLR	DAKDDFPLR
DVIGSRRQPR	DVIGSRQPR
FYKDGRIVQSR	DGRIV-QSR
DYIIRNTDR	DYIIRNTDR
NLAGAEELFAR	LAGAEEFAR
DLKAQAQLQKR	DLKAQAQKR
EVYDGPKNVR	EVYDGPNVR
DTITLPQNR	DTITLPQNR
DMMDLPRSR	DMMDLPRSR
DIEQLPSYR	DIEQLPSYR
EYIQMSGRAGR	EYIQM-SGR
HTRTPPIIHR	HTRTPPIHR
DLYKFLTKR	DLYKFLTKR
EYNVRVASR	EYNVRVASR
DLFYKRKAISR	FYKRKAISR
EVQPPRVDR	EVQPPRVDR
DYGFPERKER	DYGFPEKER
SVLKMLQAAR	SVLKMLAAR
VVMTPPRNR	VVMTPPRNR
DFHFRTDER	DFHFRTDER
DFYHNVAER	DFYHNVAER
EIYDRREYSR	EIYDRRYSR
DADKPQWLR	DADKPQWLR
LPEEAVGHAR	LPEEAVHAR
DVQRKVTYR	DVQRKVTYR
DARGRSIAIAR	DARGRSIAR
DFSGVTPQR	DFSGVTPQR
DVVEKTIQK	DVVEKTIQK
SMASEEVLKNR	MASEEVKNR
ETLTRPFSGRR	ETLTRPSGR
EVLSKALSQR	EVLSKASQR
DAIEKAVSR	DAIEKAVSR
ESMQRFHNR	ESMQRFHNR
DVKSMEMLVEH	DVKSMEMLV
DLQQVGGASAR	DLQQVGSAR
NSQLIVHQR	NSQLIVHQR
DLLAASQVVNR	LAASQVVNR
SFFDKKRSER	SFFDKKSER
EYFSPVGYNR	EYFSPVYNR
DTYIKAYLR	DTYIKAYLR
HAREIFDSR	HAREIFDSR
DMRVHPYQR	DMRVHPYQR
TVTEKPEVIDA	VTEKPEVID
DVKPSNVLINK	DVKPSNVLI
EYVDNTNLVPR	DNTNL-VPR
DMRRPSSVLR	DMRRPSVLR
EVFVGKIPR	EVFVGKIPR
STQLTIHQR	STQLTIHQR
EVLHGLIGR	EVLHGLIGR
DTLEKLISHR	DTLEKLSHR
DIQTRMAGR	DIQTRMAGR
EYNAIGGKYNR	NAIGGKYNR
DASRNVFSR	DASRNVFSR
EALNQVTQR	EALNQVTQR
DAFFNPATR	DAFFNPATR
ETAFLSWFR	ETAFLSWFR
EVHAVVTVR	EVHAVVTVR
STKPGSYIFR	STKPGSIFR
DVRSVTSVR	DVRSVTSVR
DTKELEKMTNR	DTKELETNR
EPLLPWNR	EPLLP-WNR
EYFSDLPPR	EYFSDLPPR
DIYRPTIHK	DIYRPTIHK
NATVPLLGR	NATVPLLGR
DSQAYDQKNIR	QAYDQKNIR
DFKELGRFMLR	DFKELGMLR
NNKEYLEFR	NNKEYLEFR
DLLPKQEKR	DLLPKQEKR
DVKPENFLVGR	DVKPENVGR
LFRPVASQLPR	LFRPVASQL
LALLPPQAR	LALLPPQAR
DFSAGVANR	DFSAGVANR
TYLATFHQR	TYLATFHQR
DMMEGRVGR	DMMEGRVGR
EINKLLAHR	EINKLLAHR
DIYFNPKTR	DIYFNPKTR
DSLSRHRPR	DSLSRHRPR
EILSVLSHR	EILSVLSHR
ETYLMKHMR	ETYLMKHMR
DLQDDIQNR	DLQDDIQNR
EFKTLEGVITR	KTLEGVITR
DVVYALKRQGR	VYALKRQGR
DNGGYYITTR	DNGGYYTTR
DAQTLDAIRHR	DAQTLDAIR
DVFPDRDHFGR	VFPDRDFGR
DMKLRGMYIAR	DMKLRGIAR
EALPGSGQAR	EALPGSQAR
YTINIHKR	YTINI-HKR
EMREMLTHR	EMREMLTHR
DFKDPPTAK	DFKDPPTAK
DLLDILRER	DLLDILRER
DVLFVYAVR	DVLFVYAVR
DIYKKFLTR	DIYKKFLTR
DYVPYVPLR	DYVPYVPLR
EYHKFLIGK	EYHKFLIGK
DINSRRNINYR	NSRRNINYR
ETLMETHER	ETLMETHER
DSMPEPASR	DSMPEPASR
DVLSHFAQRL	DVLSHFAQR
EYIKTWRPR	EYIKTWRPR
DTVTGLLER	DTVTGLLER
EVINDYHFR	EVINDYHFR
DINDVKRLK	DINDVKRLK
WNLSPVGR	WNLSP-VGR
DNFRFTPRIQR	DNFRF-TPR
DTQSIGPKVQR	QSIGPKVQR
GDAKSVFHTR	DAKSVFHTR
SYQEVTVQR	SYQEVTVQR
AYKSILQER	AYKSILQER
DPFGHHVAR	DPFGHHVAR
DVQSIIGLQR	DVQSIILQR
DLLEGQKKSSR	DLLEGQSSR
MLRLPTVFR	MLRLPTVFR
EYAHTRYFR	EYAHTRYFR
ESLPRVVKR	ESLPRVVKR
LPQGHFQER	LPQGHFQER
DNAPEHALR	DNAPEHALR
NARITDLR	NARIT-DLR
NNIDYTVHSVR	DYTVH-SVR
SILSHIHKR	SILSHIHKR
DLIDRGWRR	DLIDRGWRR
DIINGDAIHKR	INGDAIHKR
DYQRYREERFR	DYQRYREER
DLNLIQQER	DLNLIQQER
SAGGSFTVR	SAGGSFTVR
EVFNKFFKER	EVFNKFKER
NVKVDPEIQ	NVKVDPEIQ
DNTVPLASR	DNTVPLASR
EAQVKIWRR	EAQVKIWRR
DISIIKGRYR	DISIIKRYR
EVPKHLVGR	EVPKHLVGR
EYVPETVYR	EYVPETVYR
LAHVGPRLR	LAHVGPRLR
DVRDRMIHR	DVRDRMIHR
FTNKPTTFR	FTNKPTTFR
DILSALVTR	DILSALVTR
DSYSPRWKGR	DSYSPRKGR
DNLTLTVAR	DNLTLTVAR
EYMRVISQR	EYMRVISQR
LARDVYVGR	LARDVYVGR
DLKPLPTAR	DLKPLPTAR
VATLPRGR	VATLP-RGR
DAWESLFSR	DAWESLFSR
DLPERDQFR	DLPERDQFR
HAKAVVSLR	HAKAVVSLR
IPLAPNTGR	IPLAPNTGR
EYAGLKVAR	EYAGLKVAR
HSRVILQGR	HSRVILQGR
EFFIPRVGR	EFFIPRVGR
EIKKPPVSER	EIKKPPSER
DAADKPRGFAR	DAADKPFAR
EVWKGIKKR	EVWKGIKKR
DLKSRLDSR	DLKSRLDSR
SFEDAKEAL	SFEDAKEAL
LFKSKAYER	LFKSKAYER
DTFRPTAR	DTFRP-TAR
DVQRHPFFR	DVQRHPFFR
VMKDFEEMR	VMKDFEEMR
DLQPPEALVER	DLQPPEVER
DFETVRMIK	DFETVRMIK
EYMEKIKQR	EYMEKIKQR
DFHVINGVLR	DFHVINVLR
SYFSFSRNR	SYFSFSRNR
PRIRIETR	PRIRI-ETR
ESMEPKVFR	ESMEPKVFR
DTWVLLNQR	DTWVLLNQR
EAETRAEFAER	ETRAEFAER
LALLGNHLK	LALLGNHLK
ELQREISNR	ELQREISNR
DAWRFWHKR	DAWRFWHKR
DGLGPAQIVGR	DGLGPAVGR
DLKRPFLSR	DLKRPFLSR
DSIDPASIEAR	DPASI-EAR
NFIDVIITR	NFIDVIITR
EVLLVSSSR	EVLLVSSSR
EYVETVTSR	EYVETVTSR
IRDATDLR	IRDAT-DLR
VMADPKGKAYR	DPKGK-AYR
YVKDLVVQR	YVKDLVVQR
YIRPVFVSR	YIRPVFVSR
DYISRAESQSR	ISRAESQSR
DVQPKLWAR	DVQPKLWAR
DAFDGHAAR	DAFDGHAAR
DLLRRPGAR	DLLRRPGAR
DNMNESELFGR	NMNESEFGR
NLKSPAVKR	NLKSPAVKR
MTILQTYFR	MTILQTYFR
DFPEKFFPK	DFPEKFFPK
DYLHYIRKYNR	DYLHYIYNR
SIRDPVHNR	SIRDPVHNR
DNNPLAVNR	DNNPLAVNR
DFIQEEFQHLK	DFIQEEQHL
DIQLLKRTV	DIQLLKRTV
EVNAWLVHR	EVNAWLVHR
DYQLVRKLGR	DYQLVRLGR
ITPTGTHPL	ITPTGTHPL
VNMVPFPR	VNMVP-FPR
FTRGKSALLER	RGKSALLER
NALEGSTFVSR	NALEGSVSR
TTYKLVINGKT	TYKLVINGK
DLLELIDTR	DLLELIDTR
SVYIPAHGR	SVYIPAHGR
DTFSYNFYNR	DTFSYNYNR
DSVVIVDERRR	DSVVIVDER
DYYARVEGR	DYYARVEGR
IAFAPNLGR	IAFAPNLGR
DVSHTFYPR	DVSHTFYPR
DYLEQQVAR	DYLEQQVAR
ELNKIFALR	ELNKIFALR
QTYEKFLHR	QTYEKFLHR
QDTLVPYGNR	DTLVPYGNR
NVRNGYGFINR	NVRNGYINR
VEELKPTPE	VEELKPTPE
DLAKIIFKR	DLAKIIFKR
DAEAIYVTR	DAEAIYVTR
DLRKVLDHR	DLRKVLDHR
DFSDRIGKTKR	DFSDRITKR
EYRSEQSVKLR	EYRSEQSVK
NTIKHYVHR	NTIKHYVHR
IVNENLVER	IVNENLVER
DMILKNIEK	DMILKNIEK
NAGRLFHYR	NAGRLFHYR
DVISRNEIQGR	ISRNEIQGR
NGRPLEMIEPR	RPLEMIEPR
INRPIIVFR	INRPIIVFR
DAQVALTLR	DAQVALTLR
SILLWATQR	SILLWATQR
DIFNQPPNRER	DIFNQPPNR
HYYDGTIFHR	HYYDGTFHR
DSYSPPHVR	DSYSPPHVR
DNFDNISLAQR	DNISL-AQR
NPWQRLVKR	NPWQRLVKR
EVEEYKNFR	EVEEYKNFR
EVFYFEVTR	EVFYFEVTR
DNSIITKR	DNSII-TKR
DTIDVSNLNR	DTIDVSLNR
DVIKEQNRELR	DVIKE-QNR
MVMDKKHFK	MVMDKKHFK
EIRQQIPVFR	EIRQQIVFR
IMAELLTGR	IMAELLTGR
SMRDHIDYR	SMRDHIDYR
DLLERLVQR	DLLERLVQR
TYLTKFIAR	TYLTKFIAR
DNHVVPVLR	DNHVVPVLR
DFAPEVAWVTR	DFAPEVVTR
DTSTWKILR	DTSTWKILR
EYIHDFNRR	EYIHDFNRR
DAAFIIGSGR	DAAFIISGR
EFKPEISMR	EFKPEISMR
DISSFKNIYR	DISSFKIYR
DVWRKKYMR	DVWRKKYMR
EVKRPGESLR	EVKRPGSLR
HLQDLSGRISR	DLSGR-ISR
DLKSESENIQR	DLKSESIQR
DYLNAESRVNR	LNAESRVNR
DLREQTHSR	DLREQTHSR
HLRDFNFSR	HLRDFNFSR
EYLHNYGIVHR	HNYGI-VHR
LAQGDSLAAR	LAQGDSAAR
DYLHAKNIIHR	HAKNI-IHR
DTKLSKLDTLR	DTKLSKTLR
DVRHYLQGR	DVRHYLQGR
TYKRFEGLTQR	TYKRFETQR
DFLWFFSKR	DFLWFFSKR
NNLTAPVSR	NNLTAPVSR
SSYFRIHER	SSYFRIHER
FTLDINTAYAR	DINTA-YAR
EVRRLVIGR	EVRRLVIGR
DNIAGKSFQNR	NIAGKSQNR
EYTINIHKR	EYTINIHKR
DAKMRVFER	DAKMRVFER
DARARFLER	DARARFLER
DVGRLPHAR	DVGRLPHAR
ETYKYLYGR	ETYKYLYGR
DSFSAGEPR	DSFSAGEPR
DMKFITPVRR	DMKFITVRR
IAKPGWKNSIR	IAKPGWSIR
DSLIKSKEELR	LIKSKEELR
DFLLRNDPLHR	LLRNDPLHR
QPLSPIRNRTP	QPLSPIRNR
DAVSGLAFR	DAVSGLAFR
DWVPYINGKFK	DWVPYINGK
EALAMGSRALR	LAMGSRALR
IVRPPESGLGR	IVRPPESGL
SYKGSISYR	SYKGSISYR
DTSQFILNR	DTSQFILNR
NLMELTQIYQR	ELTQI-YQR
DVLQWIVQR	DVLQWIVQR
LLKPPHPHHR	LLKPPHHHR
DIESLRGALGR	ESLRGALGR
KPSNIFISR	KPSNIFISR
DNLLHEKRYLR	DNLLH-EKR
EYYKHPISR	EYYKHPISR
EYQTQLIQR	EYQTQLIQR
LAPTDVKEL	LAPTDVKEL
INRPADVIQAR	RPADVIQAR
EYWDRQRNR	EYWDRQRNR
DVKPENFLIGR	DVKPENIGR
DFSVPDVPK	DFSVPDVPK
DAYSSFGSR	DAYSSFGSR
DLFRYFVHR	DLFRYFVHR
EALPGLQRR	EALPGLQRR
EYRQSLHTYLR	EYRQSLTYL
DLQYREKEVKR	QYREKEVKR
EYLESKQFLHR	EYLESKQFL
EVLYAPRRLR	VLYAPRRLR
DLQHGSLFLR	DLQHGSFLR
EVAPPKAHEVR	EVAPPKAHE
VYHYFQWRR	VYHYFQWRR
NFMLRIGMNK	NFMLRIMNK
NALQQVVAR	NALQQVVAR
DFRRELEER	DFRRELEER
DFSTRFITR	DFSTRFITR
VFKDEATVR	VFKDEATVR
DLNEKIAQR	DLNEKIAQR
DVRDVRDLR	DVRDVRDLR
DLIEITDAKKR	DLIEITDAK
HSFRPAYR	HSFRP-AYR
DVFVVGTERGR	DVFVVGTER
DNRTLYHLR	DNRTLYHLR
EVQVLDDKNVR	QVLDDKNVR
DSFPERRAPR	DSFPERAPR
DISDPYKVYR	DISDPYVYR
MTNLPAVGR	MTNLPAVGR
HYWVPAKR	HYWVP-AKR
VYRNPESFKEK	VYRNPESFK
INKDVTHPR	INKDVTHPR
ETLPPFPTRL	ETLPPFPTR
DIYSKTWTK	DIYSKTWTK
DMKEFTKRR	DMKEFTKRR
SYKGTPAMR	SYKGTPAMR
EAMLWERHR	EAMLWERHR
SYREQWSQR	SYREQWSQR
DFHSVSKLR	DFHSVSKLR
EVQRILHQR	EVQRILHQR
HFIELDENRQR	HFIELDENR
SFRYNGLIHR	SFRYNGIHR
LFRGRISER	LFRGRISER
NYAAPPSTR	NYAAPPSTR
HAKGLHIPRL	HAKGLHIPR
DAVDVFETR	DAVDVFETR
DVLEREFQR	DVLEREFQR
NLYFHDVGR	NLYFHDVGR
EMLEILINR	EMLEILINR
DFIDPQEGWKK	DFIDPQEGW
NTREPKLFR	NTREPKLFR
DAAELPGVSR	DAAELPVSR
DIMNKVWNK	DIMNKVWNK
EMLRAAVKR	EMLRAAVKR
DFKEIEHLVER	DFKEIEVER
ETQLPVSFR	ETQLPVSFR
STYIRLYGR	STYIRLYGR
SIPEKNRPL	SIPEKNRPL
EVAPPEYHR	EVAPPEYHR
VYYRVYYTR	VYYRVYYTR
DYINGDSKYMR	DYING-DSK
DIAGRDITR	DIAGRDITR
DIYRPTIHKL	DIYRPTIHK
HTLEPLIPR	HTLEPLIPR
DIAKVSIGRLR	DIAKVSIGR
EIKHFVSER	EIKHFVSER
DVNIIVFR	DVNII-VFR
DIRTPPLQSER	DIRTPPSER
DGRKRSLEELR	DGRKRSELR
ELRQKYNVR	ELRQKYNVR
EYLEGNNFVHR	EYLEGNVHR
HSLAVFIKR	HSLAVFIKR
TFEHPNVVR	TFEHPNVVR
AYKDPEKNWNR	DPEKN-WNR
DAQEILHSR	DAQEILHSR
STKGLNLPR	STKGLNLPR
IFKEREEDLR	IFKEREDLR
EVAFPHHPR	EVAFPHHPR
DLKEVAIKQFR	DLKEVAQFR
DSAEFHYTR	DSAEFHYTR
EIFRPFYR	EIFRP-FYR
DAADFIRAGR	DAADFIAGR
NTSTSIVNR	NTSTSIVNR
DYQGIKFVKR	DYQGIKVKR
MTIMEDYFAYR	IMEDYFAYR
MVVPAALKVVR	VPAALKVVR
AAEPKVNR	AAEPK-VNR
HAQLLEQHR	HAQLLEQHR
EYFKYKSMR	EYFKYKSMR
DYFSPDNLKER	DYFSPDNLK
DSLQAFLQDR	DSLQAFQDR
PVGIFQKR	PVGIF-QKR
SQPLGPRII	SQPLGPRII
EYMEHVYLIHR	EYMEHVIHR
EVKSITKER	EVKSITKER
DYFKQWINLKK	DYFKQWINL
DTIRKEYWR	DTIRKEYWR
EVFQNANFR	EVFQNANFR
DADEFGYSR	DADEFGYSR
NVKELFSVR	NVKELFSVR
DVFQKFYAR	DVFQKFYAR
DVLIPKIMR	DVLIPKIMR
ETIPSFTGR	ETIPSFTGR
VTYKYYVGR	VTYKYYVGR
DYKGEEELR	DYKGEEELR
ETYLNENLR	ETYLNENLR
DSQGENMFLR	DSQGENFLR
VSYVPITGR	VSYVPITGR
YFLHRLLHHKR	FLHRLLHKR
EVLLRAGVSR	EVLLRAVSR
ESGPSIVHR	ESGPSIVHR
DMFATPQYR	DMFATPQYR
ELLIRKLPFQR	LIRKLPFQR
ELMVPFTR	ELMVP-FTR
VAIKPSKGQR	VAIKPSGQR
DVSARDWLTRR	SARDWLTRR
DVNKKFSVR	DVNKKFSVR
DSLEKHIVR	DSLEKHIVR
DFKRYVTDR	DFKRYVTDR
DVKTTDGYLLR	DVKTTDYLL
DSLDELVAR	DSLDELVAR
HSVIPPAAR	HSVIPPAAR
DFFPGSDRFAR	DFFPG-SDR
DYIHIRIQQR	DYIHIRQQR
DTRTGLVLR	DTRTGLVLR
EVWPHSTER	EVWPHSTER
EMMADMYNR	EMMADMYNR
VYNEYISHR	VYNEYISHR
DIFYKAIQK	DIFYKAIQK
DARDWTISR	DARDWTISR
HYIQLGTVYR	YIQLGTVYR
VETDIPLKTR	ETDIPLKTR
SNKELAIER	SNKELAIER
EFKDKTWTR	EFKDKTWTR
NAQNWGMQR	NAQNWGMQR
EVAIPHNR	EVAIP-HNR
DAKKRDIYDKY	DAKKRDIYD
DFNGVAAVR	DFNGVAAVR
MALLLSVLR	MALLLSVLR
HSQDLSGRLR	HSQDLSRLR
DVKLEDTYFDR	DVKLEDTYF
DYLEFTDARGR	DYLEFTDAR
DVLDVYIEHR	DVLDVYEHR
DVNTREPKLFR	NTREPKLFR
ETLPPVGVNR	ETLPPVVNR
EVNIPNRR	EVNIP-NRR
IPRIRIETR	IPRIRIETR
DTISDWNLR	DTISDWNLR
DTRPQLLMR	DTRPQLLMR
DLFEKRTNR	DLFEKRTNR
EAVRPGVLR	EAVRPGVLR
DAHDPKYWR	DAHDPKYWR
DYLRFLQKR	DYLRFLQKR
EMLQQIANR	EMLQQIANR
DSLVPIGR	DSLVP-IGR
VANIPVAR	VANIP-VAR
DNNMGFYR	DNNMG-FYR
EYVDRLSKR	EYVDRLSKR
DLKSTVISR	DLKSTVISR
VSNKWLHER	VSNKWLHER
EARLLEEQR	EARLLEEQR
AAQDRDQIYR	AAQDRDIYR
EVIPYTPAMQR	IPYTPAMQR
DGFLFVVNR	DGFLFVVNR
DVFQKFYAK	DVFQKFYAK
DISNVKIPK	DISNVKIPK
DVELREAQR	DVELREAQR
DVRKEEVLILR	DVRKEEILR
EVKIPKPR	EVKIP-KPR
EVNDRPVRR	EVNDRPVRR
DTKENLEGTLR	DTKENLTLR
EVLREGELEKR	VLREGEEKR
DFQAPYLLHGK	DFQAPYLLH
DVEPIHAFR	DVEPIHAFR
NTQEMPWNVR	NTQEMPNVR
DNQGVKFLR	DNQGVKFLR
DYLKTVLHR	DYLKTVLHR
DILHSIVKR	DILHSIVKR
DSTLPMNR	DSTLP-MNR
STKDILSQHER	DILSQ-HER
DTAQRALYR	DTAQRALYR
EYKDPGKMIR	EYKDPGMIR
DLANVRVGR	DLANVRVGR
DTRSVHETRF	DTRSVHETR
DAWGPGAAK	DAWGPGAAK
NMNVIDVGR	NMNVIDVGR
NANPLIYQR	NANPLIYQR
DSLIPPQSR	DSLIPPQSR
DYQTHFRLR	DYQTHFRLR
DMHSLVRSR	DMHSLVRSR
EVQGEIHLR	EVQGEIHLR
EVFSHILKR	EVFSHILKR
DGIRKVWQR	DGIRKVWQR
DYLHMVHR	DYLHM-VHR
DTFWKGTTR	DTFWKGTTR
DAVRRYLTR	DAVRRYLTR
DFFNGKELNK	DFFNGKLNK
DMAHHPTFR	DMAHHPTFR
DTSLIRKTR	DTSLIRKTR
MTLSPSYR	MTLSP-SYR
DFKNVLSNR	DFKNVLSNR
DYVPETVYR	DYVPETVYR
DAQKPSLTR	DAQKPSLTR
DAWEPKVLRA	DAWEPKVLR
ESLGQSELASR	LGQSELASR
NANLPSSLR	NANLPSSLR
NALRLSVGR	NALRLSVGR
DTAQQIVYR	DTAQQIVYR
DALESLVAR	DALESLVAR
DVYDRKNIPR	DVYDRKIPR
DGYEFFAKR	DGYEFFAKR
LEELNERYR	LEELNERYR
DTYLHRVAR	DTYLHRVAR
DLFRRTDGR	DLFRRTDGR
DSLASKVTR	DSLASKVTR
ENLPRTVIR	ENLPRTVIR
NNLVIDTPR	NNLVIDTPR
DVLGMKVLR	DVLGMKVLR
EYLDMKNTR	EYLDMKNTR
DYFLNNKHVGR	FLNNKHVGR
DGIILPGK	DGIIL-PGK
DAAMFYTNR	DAAMFYTNR
DNIIPFLR	DNIIP-FLR
DNHNLIERR	DNHNLIERR
TVKDLRLVTNR	DLRLV-TNR
LSNRPIMFR	LSNRPIMFR
DAAHPTNVQRL	DAAHPTVQR
DLHFHFTAR	DLHFHFTAR
NQDTLVPYGNR	DTLVPYGNR
ELKGIYKDR	ELKGIYKDR
NLHKLLYNR	NLHKLLYNR
NFRGSLNTYR	NFRGSLTYR
DAAKPLPIYR	DAAKPLIYR
VTKNVSKPR	VTKNVSKPR
DVKQLSEIVVR	DVKQLSVVR
EYKELLQRR	EYKELLQRR
FAPYNKPSL	FAPYNKPSL
DLQLPPSQR	DLQLPPSQR
DVSLPFVSR	DVSLPFVSR
DLLWRRIAR	DLLWRRIAR
YYLPYYKRER	YYLPYYRER
NVLEFTSARKR	NVLEFTSAR
WVKPIIIGR	WVKPIIIGR
DIFNQVVPR	DIFNQVVPR
NVLGRVKGR	NVLGRVKGR
TYLGEFSLR	TYLGEFSLR
DNKELKAFNIR	ELKAF-NIR
VVKPDQLIKRR	VVKPDQIKR
DLNKTRLR	DLNKT-RLR
SAPYGRITL	SAPYGRITL
NTIKLIVGR	NTIKLIVGR
DFYLQSVER	DFYLQSVER
NYIGSFLAR	NYIGSFLAR
LDTNLPANR	LDTNLPANR
NVLQAPLPPMR	VLQAPLPMR
DTQDSMSLLFR	DSMSL-LFR
DIYDRKNMPR	DIYDRKMPR
DALNLSVPR	DALNLSVPR
VIIGGDGRRN	VIIGGDGRR
ESLIPSANR	ESLIPSANR
SYKDFSESR	SYKDFSESR
DASLGNLFAR	DASLGNFAR
EFLDIMKRNR	EFLDIMRNR
IFYTAIVNR	IFYTAIVNR
ETLNQMIAR	ETLNQMIAR
FLFVPPQFR	FLFVPPQFR
EYIQQLRSR	EYIQQLRSR
GTYLATFHQR	TYLATFHQR
YWKEVAEKR	YWKEVAEKR
HNQRPTFR	HNQRP-TFR
EALTALMSR	EALTALMSR
DVARISWYL	DVARISWYL
DNLSSEEIQQR	LSSEEIQQR
NVKGPGLQR	NVKGPGLQR
EYIKNWRPR	EYIKNWRPR
DVLRRMKKR	DVLRRMKKR
DIWAKTPPITR	WAKTPPITR
DVLAWVKKR	DVLAWVKKR
NFKSPVKTIR	NFKSPVTIR
YLPDGTASL	YLPDGTASL
EVYKELRLR	EVYKELRLR
EVLKHLKER	EVLKHLKER
DLLGTLHNL	DLLGTLHNL
SFFRREIKR	SFFRREIKR
EYISSDGSYAR	ISSDGSYAR
DNLERDFFLRR	DNLERDFLR
DFAGEEVRVTK	DFAGE-EVR
DLARHFIQR	DLARHFIQR
EVFLHVVKR	EVFLHVVKR
YYIVLITKR	YYIVLITKR
DIHNIHVMR	DIHNIHVMR
DTVATLPR	DTVAT-LPR
TRAEFAER	TRAEF-AER
TNTVPKLYR	TNTVPKLYR
DYSKFIQTR	DYSKFIQTR
EVRPVETLR	EVRPVETLR
DIQDIWVVR	DIQDIWVVR
HANPRLWLR	HANPRLWLR
LHIGSAHNR	LHIGSAHNR
DYAKLGAAR	DYAKLGAAR
LPLQRSAAR	LPLQRSAAR
AYRISSSLR	AYRISSSLR
EFQDFTVPR	EFQDFTVPR
EYRKYIHSR	EYRKYIHSR
DSKPIDVSR	DSKPIDVSR
ILAFREKEWQR	AFREKEWQR
EFDDRRGVLR	EFDDRRVLR
DAIELFNR	DAIEL-FNR
DYNPLYKER	DYNPLYKER
SFRKKYELR	SFRKKYELR
RMLERVIGR	RMLERVIGR
DLYPFGTMR	DLYPFGTMR
DAQMRAAINQK	QMRAAINQK
EWWHRTIQR	EWWHRTIQR
DIQFRLVTR	DIQFRLVTR
EVLGPHLER	EVLGPHLER
DIEERPKELVR	DIEERPKEL
DNVKAYFKR	DNVKAYFKR
DNFFDGQRKR	NFFDGQRKR
DLKEVTDLR	DLKEVTDLR
QYLDPAQRGVR	QYLDP-AQR
SYRKFLNLR	SYRKFLNLR
NLAEKSTVHMR	NLAEKSTVH
DAKHTNFVEFR	DAKHTNVEF
DVSTIKAPR	DVSTIKAPR
EAIKITNR	EAIKI-TNR
DVFVVGTER	DVFVVGTER
DFNLRTHVR	DFNLRTHVR
DSMLVDPKHHR	MLVDPKHHR
DVYTPKSSR	DVYTPKSSR
DLQSRILKR	DLQSRILKR
YPYSPPAFR	YPYSPPAFR
DFLDLGYNR	DFLDLGYNR
HTFDHINKR	HTFDHINKR
DSAMHLALR	DSAMHLALR
DVHRHLDVR	DVHRHLDVR
DMFYRNWAL	DMFYRNWAL
ETYLHRIGR	ETYLHRIGR
VPSTPIAHR	VPSTPIAHR
DLNIKVDGR	DLNIKVDGR
IDEVRTGTYR	EVRTG-TYR
DLGPMRKSYR	DLGPMRSYR
NILNKVVTR	NILNKVVTR
STLSPIAPR	STLSPIAPR
EVKPSIRAR	EVKPSIRAR
TAYRPPALR	TAYRPPALR
DTKNYVEVTR	DTKNYVVTR
EVRVPVPK	EVRVP-VPK
MDAKSLTAWSR	DAKSLTWSR
DVNSGFAKR	DVNSGFAKR
IIRDRQEVR	IIRDRQEVR
EYREKIETELR	EYREKITEL
DSKGQHLIYR	DSKGQHIYR
DAQEILHSRF	DAQEILHSR
EYVDVVFANR	EYVDVVANR
DTQERIKAER	DTQERIAER
NVRETHSLFFR	ETHSL-FFR
DMADHSNLIR	DMADHSLIR
DFRNPGPGRHR	DFRNPGPGR
EYKMILVVR	EYKMILVVR
DVQGDDKRYFR	DVQGD-DKR
DLMKKYDKSLR	DLMKKYSLR
DMQTEIKLR	DMQTEIKLR
DLFYSFWER	DLFYSFWER
IPYDQSPGPK	IPYDQSGPK
VFDAKRLIGR	DAKRL-IGR
NLKEIISQR	NLKEIISQR
EIRNLTVKDFR	EIRNLTVKD
DLIQMLVQR	DLIQMLVQR
MVQNRVFLR	MVQNRVFLR
DFLEKLAFR	DFLEKLAFR
NYYGYQGYR	NYYGYQGYR
DMFNIYIKR	DMFNIYIKR
DLFYNIATR	DLFYNIATR
EMKLQVTQR	EMKLQVTQR
DMQHQVLER	DMQHQVLER
DDFLRRSSSR	DFLRRSSSR
DNIDWVKIRER	DNIDWVKIR
LPKAVDDKQLR	KAVDDKQLR
DSLQRAWTV	DSLQRAWTV
DAHDWNQNR	DAHDWNQNR
DGLNQRYFR	DGLNQRYFR
RYRPGTVALR	RYRPGTALR
DYRTPTLR	DYRTP-TLR
MLKPALEPR	MLKPALEPR
STKNIHFSRL	STKNIHFSR
DILESITNR	DILESITNR
EMLSSVALINR	LSSVALINR
EYKDPENILHR	EYKDPELHR
YYYYHRQYR	YYYYHRQYR
DYFTPQGEFR	DYFTPQEFR
YVKEQFAWR	YVKEQFAWR
DALDLFRGR	DALDLFRGR
EAYSVGTGR	EAYSVGTGR
EVVYRFTAR	EVVYRFTAR
DTAHTFSLR	DTAHTFSLR
DAVKPGVRYR	DAVKPGRYR
VEKSKIPGR	VEKSKIPGR
DYKVVSPALR	DYKVVSALR
DVVVSRWLR	DVVVSRWLR
DALGAAFATR	DALGAAATR
DSMKSFFRR	DSMKSFFRR
DTLQEIFQR	DTLQEIFQR
DVKLQDAGVYR	DVKLQDVYR
DVRVQEVPK	DVRVQEVPK
STARHLYLR	STARHLYLR
DVISNINITR	DVISNIITR
VFIYRGKEYER	IYRGKEYER
DLQEFVPFGR	DLQEFVFGR
DIKNLVVKR	DIKNLVVKR
PDYLVPPALR	DYLVPPALR
DFASIDWLAQR	ASIDWLAQR
IVKPVKVSAPR	IVKPVKVSA
NNLGNFINR	NNLGNFINR
DTNALRVPR	DTNALRVPR
EYLRWKQER	EYLRWKQER
VYFKRFYAR	VYFKRFYAR
EVLQPLQQR	EVLQPLQQR
DIKRIIKAR	DIKRIIKAR
NLQELKDLNQR	ELKDL-NQR
LPWVPPHLR	LPWVPPHLR
EAQAWEQAR	EAQAWEQAR
PFDITVMIR	PFDITVMIR
DAGSVPHVNR	DAGSVPVNR
MIKGKTPEEIR	KGKTPEEIR
DANLHKDRFLR	NLHKDRFLR
VANSAFVER	VANSAFVER
EDTRDKGLVNR	DTRDKGVNR
DTFIKIAQK	DTFIKIAQK
DAREMLNSR	DAREMLNSR
NALLRDPYALR	LLRDPYALR
DYIVKIFDR	DYIVKIFDR
EYVGPRLSR	EYVGPRLSR
IYLPPEASSQR	LPPEASSQR
LFKEPNAEGR	LFKEPNEGR
ESLEVRMRE	ESLEVRMRE
DYKDQLKTGER	DYKDQLKTG
LPYTPNNR	LPYTP-NNR
DVINVFHHL	DVINVFHHL
DFQIEKKIGR	DFQIEKIGR
QTKPVVVYR	QTKPVVVYR
EAVKLIIGR	EAVKLIIGR
DLAQALINR	DLAQALINR
DSSGLTVHR	DSSGLTVHR
DVRPFAPKER	DVRPFAKER
ESKILHLQR	ESKILHLQR
DNSSTVSIVGR	SSTVSIVGR
DALGAGILHHL	DALGAGILH
DITTPKAAR	DITTPKAAR
TAASRPPVTLR	ASRPPVTLR
HTKAVNVVRF	HTKAVNVVR
EILEVATAR	EILEVATAR
SNLPAKAIGHR	LPAKAIGHR
DNFLMGIGR	DNFLMGIGR
PEEAVGHAR	PEEAVGHAR
DILELLEKR	DILELLEKR
DSRPPFLSR	DSRPPFLSR
EVLNEVNRR	EVLNEVNRR
DSLWPYKGR	DSLWPYKGR
HVFLRTTGR	HVFLRTTGR
DFLSLEHIGR	DFLSLEIGR
VMKPPQVVR	VMKPPQVVR
IADGGKKLR	IADGGKKLR
EVFDHMMKR	EVFDHMMKR
DVSEGPLIPR	DVSEGPIPR
YLNAESRVNR	LNAESRVNR
DYYSLLNVR	DYYSLLNVR
EYRASLQQR	EYRASLQQR
ETLLLQAER	ETLLLQAER
DTVATLSER	DTVATLSER
DIRNHIVQR	DIRNHIVQR
DVYDYKIAR	DVYDYKIAR
DFKEISSVK	DFKEISSVK
LYQIITVER	LYQIITVER
DSKQFNILR	DSKQFNILR
QYMEEIYHR	QYMEEIYHR
DYVPYVPLRQR	DYVPYVPLR
MTKSGYQPPR	MTKSGYPPR
DVLSHFAQR	DVLSHFAQR
QTKTVRVFR	QTKTVRVFR
EVRLGGSLR	EVRLGGSLR
DSLLFAHKR	DSLLFAHKR
ADTLAVRQKR	DTLAVRQKR
SVMDQEMRVKR	MDQEMRVKR
DIREDARLFYR	DIREDAFYR
DLSRFIHTR	DLSRFIHTR
DIQDPGVPR	DIQDPGVPR
EYLHGKGIIHR	EYLHGKIHR
SFQDNLHNR	SFQDNLHNR
NTVHDIVNR	NTVHDIVNR
DMISAVKSR	DMISAVKSR
EYLEKKNFIHR	EYLEKKIHR
ENYSPVSR	ENYSP-VSR
SFKDVDQMFQR	DVDQM-FQR
VYTDTIQQR	VYTDTIQQR
NGWNRDAYSLR	DAYSL---R
DMYLAPHVR	DMYLAPHVR
DIKPLTSFR	DIKPLTSFR
DIERINHER	DIERINHER
TTKPAIIFR	TTKPAIIFR
DTKRSQIYGSR	DTKRSQIYG
DSQKDIMQR	DSQKDIMQR
DVLPLAFTRL	DVLPLAFTR
EYILPGSRER	EYILPGRER
EVNPQTRIPR	EVNPQTIPR
DAYWPEAKR	DAYWPEAKR
QARLRDDTELR	RLRDDTELR
DGYWVVSNR	DGYWVVSNR
VMQKRISFR	VMQKRISFR
DVARHFIQR	DVARHFIQR
DLRTRVVLR	DLRTRVVLR
EYLQKMVQR	EYLQKMVQR
DAVSKEVTR	DAVSKEVTR
DAILHSEDSLR	DAILHSSLR
EVVQITWNR	EVVQITWNR
VNMVPFPRL	VNMVPFPRL
ESLEWLASR	ESLEWLASR
EFLPKEYIKQR	LPKEYIKQR
EVLAEFERR	EVLAEFERR
EYLSLETTR	EYLSLETTR
VVPEPGQPL	VVPEPGQPL
SYKDPATLR	SYKDPATLR
IAGRDITR	IAGRD-ITR
DYHTLPRAR	DYHTLPRAR
EVRKLMHVR	EVRKLMHVR
DILEKTWNM	DILEKTWNM
IYQYMEEIYHR	QYMEEIYHR
DFKTGQIDR	DFKTGQIDR
QNLQLENLR	QNLQLENLR
TTLGATQLSER	LGATQLSER
ETIGKKFEK	ETIGKKFEK
TYYPPPRLR	TYYPPPRLR
DGKWHLVYR	DGKWHLVYR
DLQKLSISR	DLQKLSISR
NYVNKIKNR	NYVNKIKNR
ELKRLYVER	ELKRLYVER
ETMPSPYGR	ETMPSPYGR
DAKAIFTGH	DAKAIFTGH
EIRKPEVLR	EIRKPEVLR
DVYRGLQER	DVYRGLQER
DIQIVSTTR	DIQIVSTTR
ETVPKDLRHLR	VPKDLRHLR
DLRGSNWVPR	DLRGSNVPR
YNFTPLAR	YNFTP-LAR
DFLELQRRYR	DFLELQRYR
EMRQMFVQR	EMRQMFVQR
DLYYHVFRR	DLYYHVFRR
DIRPGLPMLR	DIRPGLMLR
KSDFKKYVENR	DFKKYVENR
TAYGEFLSRL	TAYGEFLSR
QVMFRNYQR	QVMFRNYQR
ETFNSITKR	ETFNSITKR
VPFGAGRHR	VPFGAGRHR
TFYSISQER	TFYSISQER
EALGSGLVSR	EALGSGVSR
EYFADMKRHR	EYFADMRHR
DTRRESLFSAR	DTRRESSAR
DGQKRYTFR	DGQKRYTFR
EVKTPEFVSR	EVKTPEVSR
EYAKLLAKR	EYAKLLAKR
NPFEVKVNR	NPFEVKVNR
LINNKIANR	LINNKIANR
DSKGVYDVR	DSKGVYDVR
MVNVPKTRR	MVNVPKTRR
DIKPLTSFRQR	DIKPLTSFR
ESQDRKIFR	ESQDRKIFR
EYIELHRKR	EYIELHRKR
DAMNREVSSLK	DAMNRESSL
VMFDKITSR	VMFDKITSR
DAQLRLQLR	DAQLRLQLR
EYHWRKHLR	EYHWRKHLR
DSLRYIYPK	DSLRYIYPK
NTLQLHRYR	NTLQLHRYR
DNQLLEERNRR	DNQLLERNR
NGKQIYVGR	NGKQIYVGR
DIEFPPPFGR	DIEFPPFGR
VNLPPELRRQR	VNLPPELRR
DGLSAAARKQR	DGLSA-AAR
DALVTIRNR	DALVTIRNR
DALRVEDMMKR	DALRVEMKR
DNRGFMVTR	DNRGFMVTR
DTVATLPRGR	DTVATLRGR
SAKEVLSAR	SAKEVLSAR
SLWKKTVYR	SLWKKTVYR
VFKEEGVLR	VFKEEGVLR
DNWMNINLR	DNWMNINLR
DAYEPEISRL	DAYEPEISR
LAQFHFTNR	LAQFHFTNR
EVNDKRYLR	EVNDKRYLR
DVNDPMPNR	DVNDPMPNR
ELFADKVPK	ELFADKVPK
NSAGPYFNPR	NSAGPYNPR
DTAAWTVGR	DTAAWTVGR
ELREYNLEQQR	EYNLE-QQR
NYGPGPSLR	NYGPGPSLR
DSALLPAVR	DSALLPAVR
DYKLHFIFR	DYKLHFIFR
EVNIPRKR	EVNIP-RKR
FSMGNEVLQNR	MGNEVLQNR
EYLKLGYVSR	EYLKLGVSR
NALLVQHER	NALLVQHER
DLGGPLPADPM	DLGGPLPAD
DMWAGLWQKR	DMWAGLQKR
DTIDERTINKK	DTIDERINK
DINKEIEQR	DINKEIEQR
SLDFNLRTHVR	DFNLRTHVR
EDYYARVEGR	DYYARVEGR
NIRDIDKIYVR	DIDKI-YVR
EYVDATNLTPR	DATNL-TPR
NILKLVVSR	NILKLVVSR
EYLHSQGVVHR	HSQGV-VHR
DYLHRHGIIHR	DYLHRHIHR
DVLNIQGVQR	DVLNIQVQR
DYLTVLQQR	DYLTVLQQR
DYLEFQKNR	DYLEFQKNR
EVYPVGIFQKR	EVYPVGFQK
DVVIVKNGR	DVVIVKNGR
NLKPVWASR	NLKPVWASR
DILKIHSR	DILKI-HSR
DNRPSVEFHER	DNRPSVHER
DYIAPWERER	DYIAPWRER
EILRHHVNR	EILRHHVNR
EVLKLLVAR	EVLKLLVAR
YPNKPPTVR	YPNKPPTVR
NFAELKIKRLR	NFAELKIKR
DGNPFRVPR	DGNPFRVPR
EYAEYIYQR	EYAEYIYQR
DFLTSREIVNR	LTSREIVNR
DYLIKTGSER	DYLIKTSER
DNYRGPAVR	DNYRGPAVR
DAFGLLESRL	DAFGLLESR
DIKVPKSR	DIKVP-KSR
DYRGFLAEMKR	DYRGFLAEM
TILIPPHAR	TILIPPHAR
TTYKLVINGK	TYKLVINGK
SVTPEGVIKQR	VTPEGVKQR
SVREVRQLTLR	EVRQL-TLR
DTAALSHARLR	DTAALSHAR
DARVPFTR	DARVP-FTR
VPIGYHVPR	VPIGYHVPR
DLRPATDYHVR	DLRPATHVR
TSWVPLVSR	TSWVPLVSR
DMQYVQRMK	DMQYVQRMK
EYAADIFYSR	YAADIFYSR
DTEEEFYLR	DTEEEFYLR
EYMEVRERIHR	EVRER-IHR
ILKTGGGFQR	ILKTGGFQR
DAVGFTFPNR	DAVGFTPNR
EFRAGMSNR	EFRAGMSNR
DSIVIQQGR	DSIVIQQGR
DALEKNQQWLV	DALEKNQQW
DFHLLDHRGR	DFHLLDRGR
ETKRIFLDR	ETKRIFLDR
EVLRHPRDWVR	EVLRH--PR
TSRNITEAR	TSRNITEAR
DGKGVVVVIKR	DGKGVVIKR
EALRRLEER	EALRRLEER
DNLRPFHDR	DNLRPFHDR
DWKEKYINR	DWKEKYINR
DLIKQIGKK	DLIKQIGKK
DAWEPKVLR	DAWEPKVLR
NAPLVHATL	NAPLVHATL
HTKAVNVVR	HTKAVNVVR
DIRPEIHENYR	DIRPEINYR
EVKRLKVTELR	EVKRLKTEL
EVQQARDLQNR	QARDL-QNR
QPFLKKWYR	QPFLKKWYR
HSMALIHNR	HSMALIHNR
DTWDRVKAAQR	DTWDRVAQR
SANLIVHQR	SANLIVHQR
DTFDVFRQR	DTFDVFRQR
VTQAPISAR	VTQAPISAR
DIRKGFQLR	DIRKGFQLR
EFREPRPPR	EFREPRPPR
EFQTSVVSR	EFQTSVVSR
DYLVFANNR	DYLVFANNR
DTKRVEAPRL	DTKRVEAPR
DARDWTISRNR	DARDWTISR
DALMDRDLVHR	LMDRDLVHR
LTKEEDLAALR	DLAAL---R
VTVDGPREPR	TVDGPREPR
DTISPYSR	DTISP-YSR
MTSVPVKER	MTSVPVKER
NLESGWGSGR	NLESGWSGR
DGRGHLLGR	DGRGHLLGR
SYTAAVANR	SYTAAVANR
EYLHRFYGR	EYLHRFYGR
DVINFKKIYK	DVINFKIYK
EAVLWEALR	EAVLWEALR
NALLVVKHR	NALLVVKHR
DYRMKEWSR	DYRMKEWSR
SAKGVSILR	SAKGVSILR
EVVPEPVAR	EVVPEPVAR
DANDVILER	DANDVILER
DLKKPDPASLR	DLKKPDASL
DWQKYETAR	DWQKYETAR
DNLYPESITSR	LYPESITSR
DVLLEPFRR	DVLLEPFRR
ETIAPKIAR	ETIAPKIAR
DVNNPGLRVR	DVNNPGRVR
INYDLPTNR	INYDLPTNR
DSKTEELRFLR	DSKTE-ELR
DYKRNLPR	DYKRN-LPR
EYRDMRDGFR	EYRDMRGFR
DYFKKPQSR	DYFKKPQSR
DAVARLVAR	DAVARLVAR
ESLNFLIGR	ESLNFLIGR
EWTSKLWHR	EWTSKLWHR
VFGKWHSVPR	VFGKWHVPR
HINTVFVLR	HINTVFVLR
QTKPVYVYR	QTKPVYVYR
DSHQPLWSR	DSHQPLWSR
EYAERPEVAR	EYAERPVAR
DTIIDIITHR	TIIDIITHR
IAQARIFPR	IAQARIFPR
DNLPSASMYER	NLPSASYER
VTNTRTPSSVR	NTRTPSSVR
STKPPGTFLLR	STKPPGTFL
MVKPTPGLTPR	MVKPTPTPR
DATLLIVNR	DATLLIVNR
DVYVPEASR	DVYVPEASR
EMATRAALQAR	ATRAALQAR
DIYNHRFHR	DIYNHRFHR
ETISSKNIISR	ISSKNIISR
DNFNFLHLNR	DNFNFLLNR
SAPVGVTAL	SAPVGVTAL
DFSGNPLSR	DFSGNPLSR
LTKHTKFVR	LTKHTKFVR
DVLPTRPKK	DVLPTRPKK
NINDRSMLGKR	NDRSMLGKR
DAFLLKHVR	DAFLLKHVR
DAAKDSILRR	DAAKDSILR
DTLHNFVSR	DTLHNFVSR
NPNVPAYR	NPNVP-AYR
EIYRPPASR	EIYRPPASR
HLLEKSNIYSK	LEKSNIYSK
DLREQTHTR	DLREQTHTR
IYKAISSNR	IYKAISSNR
DIRRMEEETKR	DIRRMETKR
DLSEKVVYR	DLSEKVVYR
DLQSMEQIR	DLQSMEQIR
DIGAYGEPR	DIGAYGEPR
EYKEPESTLR	EYKEPETLR
EAMKHVYFR	EAMKHVYFR
DTIEIITDR	DTIEIITDR
STIDWNKLYRR	IDWNKLYRR
DYVPSTTKTPR	VPSTTKTPR
DLLVPTKAR	DLLVPTKAR
EVFDKFSNK	EVFDKFSNK
NVIEAVYNR	NVIEAVYNR
NIKNSSVPR	NIKNSSVPR
EVFTPVVQR	EVFTPVVQR
EKGVYVHTVR	GVYVH-TVR
DFRLPTEEEIR	DFRLPTEEE
VMIHPVTNR	VMIHPVTNR
DLARSIVTR	DLARSIVTR
EYLKNIIYR	EYLKNIIYR
DMAAQITQR	DMAAQITQR
DVAQWNIGSLR	VAQWNISLR
IVNENLVERF	IVNENLVER
DMKPKHLLSGK	DMKPK-HLL
HLFDHVVNR	HLFDHVVNR
DAFNLPSSHLR	DAFNLPSSH
DIFSEVVGR	DIFSEVVGR
DAIAVHVVR	DAIAVHVVR
ESLQGQDLFNR	SLQGQDFNR
DTASRFLHR	DTASRFLHR
DLIAIVSNR	DLIAIVSNR
EYIHSKNFIHR	HSKNF-IHR
DLVRAGVLKEK	DLVRAGVLK
VYNEFVRKR	VYNEFVRKR
DAFPKRILR	DAFPKRILR
EIKDKDQLVLR	EIKDKDVLR
DAQEIIRPR	DAQEIIRPR
DVKLPQGQR	DVKLPQGQR
DGLAFNALIHR	LAFNALIHR
DNAEKLVLR	DNAEKLVLR
DTRDKGLVNR	DTRDKGVNR
EFRQRIILR	EFRQRIILR
DINSRNMIR	DINSRNMIR
SDTYLHRVAR	DTYLHRVAR
TVTEKPEVID	VTEKPEVID
DAYGSELVER	DAYGSEVER
DYLENIFVK	DYLENIFVK
DIMDAQRRQR	DIMDAQRQR
EFKEDIHNR	EFKEDIHNR
DFIAHLLGR	DFIAHLLGR
NLYELKEGR	NLYELKEGR
NVLEKTEQR	NVLEKTEQR
VIIEKYYTR	VIIEKYYTR
DVYSLYEPRYR	DVYSLYEPR
DLQLKNARL	DLQLKNARL
EIIEKNFDYLR	EIIEKNYLR
NFAELKIKR	NFAELKIKR
DFDYLRFLQKR	DYLRFLQKR
EVLHIGSAHNR	EVLHIGSAH
DAHQYLRLR	DAHQYLRLR
NSQKKYFGR	NSQKKYFGR
DTLLYDSLYTR	LLYDSLYTR
ETVSEEKRIYR	VSEEKRIYR
LLQEKRFLR	LLQEKRFLR
IYQDSFEQR	IYQDSFEQR
EANVPVYR	EANVP-VYR
ELRGKLVAR	ELRGKLVAR
EVNRLTESTYR	EVNRLTTYR
HSMDFVAYR	HSMDFVAYR
DLRHDIDRR	DLRHDIDRR
EAWRPLER	EAWRP-LER
NAIVWKIKR	NAIVWKIKR
TYDDATKTF	TYDDATKTF
EYAERPEVARR	EYAERPVAR
NTLTNIAMR	NTLTNIAMR
LVATHDYYR	LVATHDYYR
DTISKIRLR	DTISKIRLR
DTQKFSVMR	DTQKFSVMR
DSSNPSWWTGR	SNPSWWTGR
EALHQKNIVHR	EALHQKVHR
MYREYIRNR	MYREYIRNR
HAWEPTGTR	HAWEPTGTR
SDFKKYVENR	DFKKYVENR
DYAFVHFTSR	YAFVHFTSR
RVYIHPFHL	RVYIHPFHL
EAWLLPAVGR	EAWLLPVGR
NINLIVQKR	NINLIVQKR
IIHEIAVLEL	IIHEIALEL
DNFNWGVRR	DNFNWGVRR
DNLAEDIMRLR	DNLAEDIMR
TFTVGLVFLK	TFTVGLVFL
NFMLIITHR	NFMLIITHR
DLLMVPMQR	DLLMVPMQR
TLRKPPAVGR	TLRKPPVGR
NNKDLYVLR	NNKDLYVLR
EAMALPLYR	EAMALPLYR
LVKPVTINVGR	LVKPVTVGR
LSYQPVAQR	LSYQPVAQR
NLWVPSRR	NLWVP-SRR
TYLSESQIQSR	LSESQIQSR
DLMQKISTQNR	LMQKISQNR
DLQNLKRVR	DLQNLKRVR
ILQILSLNR	ILQILSLNR
DMMPEGIKQNK	MPEGIKQNK
DAKEKKLLEMR	DAKEKKEMR
DVRIGMTR	DVRIG-MTR
TIDQKIVER	TIDQKIVER
ELFNRIEKR	ELFNRIEKR
VKPDQLIKRR	VKPDQLIKR
DVNYKMHFR	DVNYKMHFR
DYLMKILTER	DYLMKITER
DYLHAKSIIHR	HAKSI-IHR
EAIYSGYIRNR	IYSGYIRNR
DSHGVAQVR	DSHGVAQVR
IDRTIDQIRG	IDRTIDQIR
DYSDITSSK	DYSDITSSK
ELFGRVTSR	ELFGRVTSR
EALHLAGMDR	EALHLAMDR
YYGSFVTR	YYGSF-VTR
NVNEVISNR	NVNEVISNR
DNKKTRIIPR	DNKKTRIPR
DNLEPKFR	DNLEP-KFR
DFKRVVGKK	DFKRVVGKK
SVREGQGFAFR	EGQGF-AFR
EYLQSSGLAQR	EYLQSSAQR
DVVSKFLNR	DVVSKFLNR
FERIAGEASR	ERIAGEASR
EMTSLSEYVSR	TSLSEYVSR
DVLVPWHL	DVLVP-WHL
NLSAPIMSR	NLSAPIMSR
NFLKRMSGMIR	NFLKRMSGM
DYPDYKYRPR	DYPDYKRPR
DVNEELPAR	DVNEELPAR
DVLRSAAKFYR	DVLRSAAKF
EFQVIMGRKR	EFQVIMRKR
DLSKRSFSSQR	LSKRSFSQR
ADFKNVLSNR	DFKNVLSNR
GLGLVLER	GLGLV-LER
EVYDIAFSR	EVYDIAFSR
DWDEKRPEFVR	DEKRPEFVR
ESYRPPKSR	ESYRPPKSR
DLKHLIYYR	DLKHLIYYR
MYKDGDSVLQR	DGDSV-LQR
YPYSFWIGR	YPYSFWIGR
EYLHKAVFR	EYLHKAVFR
NALQRAVER	NALQRAVER
EDYNLIVIER	DYNLIVIER
ENRKPVSFR	ENRKPVSFR
DSYKKIFYR	DSYKKIFYR
DTVTYSALHKR	VTYSALHKR
HAQSIGMNR	HAQSIGMNR
VFQERNYPR	VFQERNYPR
DMNKVKLR	DMNKV-KLR
DISDTIYPR	DISDTIYPR
DGKNVKAFYR	DGKNVKFYR
DATPLHVAR	DATPLHVAR
NTGNWMHIR	NTGNWMHIR
DLINIHFQR	DLINIHFQR
FKEEGVLR	FKEEG-VLR
GEVPLTPT	GEVPL-TPT
TYNEHITKR	TYNEHITKR
NAFKTWNR	NAFKT-WNR
VFRSPLSRA	VFRSPLSRA
DFRRPPEEDFR	DFRRPPDFR
SGYKQVQVPR	GYKQVQVPR
EAKAPILKR	EAKAPILKR
DAMKRIVGM	DAMKRIVGM
LAAVREAER	LAAVREAER
DNKDFAILR	DNKDFAILR
EAKLREELR	EAKLREELR
SFQRRWITR	SFQRRWITR
DYEHQFHLR	DYEHQFHLR
LNYVPFAER	LNYVPFAER
SIMKWNRER	SIMKWNRER
DVLLFPDKKQR	DVLLFPDKK
DARGTVVLR	DARGTVVLR
TVIEKTESWPR	IEKTESWPR
DLFRYNPYLKR	DLFRYNYLK
EAAFATKDRLR	EAAFATKDR
EVTAALRER	EVTAALRER
DTVSTLYNR	DTVSTLYNR
DLLPKEKRHVL	DLLPK-EKR
DVVYNAVHR	DVVYNAVHR
DIKHFVSER	DIKHFVSER
QFLERFKSSAR	LERFKSSAR
DTKEDVFVH	DTKEDVFVH
FFNDRPWRR	FFNDRPWRR
DSMASGTLHLR	MASGTLHLR
DLNRLITQR	DLNRLITQR
DANNGNLQLR	DANNGNQLR
TALKVASTR	TALKVASTR
DAIHSMGLIHR	DAIHSMIHR
SFFGERRIPR	SFFGERIPR
LAAEPKVNR	LAAEPKVNR
NVKNVSVKDVR	NVKNVSVKD
IVKPPASAR	IVKPPASAR
DYITFIEGR	DYITFIEGR
DALSSIISR	DALSSIISR
DTIGYLLTR	DTIGYLLTR
DIKPSNIFISR	DIKPSNISR
DIQGHPFFR	DIQGHPFFR
DVLTLLESER	DVLTLLSER
EILHHLSER	EILHHLSER
DVRQYVVRK	DVRQYVVRK
VGKDPGLAGR	VGKDPGAGR
NFRGMYNQR	NFRGMYNQR
LMNIHVTPR	LMNIHVTPR
DYNNIGKFLNR	NNIGKFLNR
DVFNEDFSNR	DVFNEDSNR
VAMEPVSTR	VAMEPVSTR
SYIDRLAPR	SYIDRLAPR
NLKPKSWVR	NLKPKSWVR
DLKDRTIKR	DLKDRTIKR
DVNNIGKYR	DVNNIGKYR
NSREKIYNR	NSREKIYNR
DAFTAPFHR	DAFTAPFHR
EAMRRLQER	EAMRRLQER
EIASFDKAKLK	EIASFDKAK
DILTSVVSR	DILTSVVSR
DFALIHKER	DFALIHKER
DTMPPKGVR	DTMPPKGVR
SVNELIYKR	SVNELIYKR
EYSTSIATR	EYSTSIATR
DFLAFILHR	DFLAFILHR
DAIKLWTNR	DAIKLWTNR
EILKRNIQR	EILKRNIQR
PKDIQLAR	PKDIQ-LAR
DLLNIIREK	DLLNIIREK
DFREPTEEER	DFREPTEER
DVYIPRDR	DVYIP-RDR
TVFDAKRLIGR	DAKRL-IGR
DVASVIVTKL	DVASVIVTK
DYERIINLR	DYERIINLR
LVREIRQYR	LVREIRQYR
HSKGFGFVR	HSKGFGFVR
ADFQIEKKIGR	DFQIEKIGR
ISPSRTEAL	ISPSRTEAL
DLNIRDLR	DLNIR-DLR
DDFRARFWYR	DFRARFWYR
DAQEILQAR	DAQEILQAR
DTRSEFYKH	DTRSEFYKH
DALGSLTHSR	DALGSLHSR
DMKAANVLITR	KAANVLITR
FVVGTERGR	FVVGTERGR
EVRGGGLTR	EVRGGGLTR
DTKNIAFER	DTKNIAFER
TYYGSFVTRA	TYYGSFVTR
IFQSISFNR	IFQSISFNR
HARYILTNR	HARYILTNR
DLKKQIMGR	DLKKQIMGR
DIKASQILASR	DIKASQASR
DYLPPEMIEGR	DYLPPEEGR
DAQNPQIKR	DAQNPQIKR
NVKDKPTVER	NVKDKPVER
DFVGVHQER	DFVGVHQER
DVTDFISHL	DVTDFISHL
LPISRENL	LPISR-ENL
DYYTPTGEFR	DYYTPTEFR
DLRAKFKER	DLRAKFKER
DYGHLSVYR	DYGHLSVYR
YLEKIKQR	YLEKI-KQR
DTHGSFVVR	DTHGSFVVR
ETRQITWSR	ETRQITWSR
TLLDKYWTK	TLLDKYWTK
EVVNKRFVR	EVVNKRFVR
DYFDALYKR	DYFDALYKR
EIMEVAKERSR	EIMEVAKER
DAGLLDESFLR	GLLDESFLR
DYYEESYFTTR	DYYEESTTR
GVMSPPLSR	GVMSPPLSR
DLKRTVDAR	DLKRTVDAR
DAFNMQMRQR	DAFNMQRQR
DMLDIREIFR	DMLDIRIFR
DFYGEVRTR	DFYGEVRTR
DYVRYRLPLR	DYVRYRPLR
SVKEVALGR	SVKEVALGR
EVLDRVFER	EVLDRVFER
EALLPYTER	EALLPYTER
SNNTPQLNR	SNNTPQLNR
NNKRWYFTR	NNKRWYFTR
EVQGISEHYLR	EVQGISHYL
SDYIKLYVRR	DYIKLYVRR
LNSSPITTR	LNSSPITTR
SAWYPFFR	SAWYP-FFR
DMKRRIHLELR	DMKRRIELR
DNKIIIIHR	DNKIIIIHR
DVQERLVYR	DVQERLVYR
NLRRLENNR	NLRRLENNR
DFIGVDSTGKR	DFIGVDTGK
DVKPSWTTR	DVKPSWTTR
DSLAKIPKR	DSLAKIPKR
DFYALVAQR	DFYALVAQR
LYRKMEIYR	LYRKMEIYR
DAWLPGEATR	DAWLPGATR
DSNNEKGLFRR	DSNNEKLFR
EVHMLLEHR	EVHMLLEHR
YPDYKYRPR	YPDYKYRPR
DTIDSLRSR	DTIDSLRSR
QYIRPVFVSR	YIRPVFVSR
DNYANIRFR	DNYANIRFR
VYFGGFFIR	VYFGGFFIR
MVLPSRLHWIR	VLPSRLWIR
DVQPFLPVLR	DVQPFLVLR
DLKGSLRNR	DLKGSLRNR
DLRDQLKGIER	DLRDQLIER
DTSSRSHIFR	DTSSRSIFR
ATIHGMNR	ATIHG-MNR
DWKTISKER	DWKTISKER
EVFKEFIYR	EVFKEFIYR
EVMEKLVKR	EVMEKLVKR
HIIEKDKITTR	IEKDKITTR
VFLLWKNWR	VFLLWKNWR
DAFGHRKLR	DAFGHRKLR
DVRPTLVLVEK	DVRPTLVLV
ESLVPTAR	ESLVP-TAR
DAKTIFTGH	DAKTIFTGH
ETEREYFNR	ETEREYFNR
DLQYIKITR	DLQYIKITR
EVASVWVER	EVASVWVER
AANGKLFSR	AANGKLFSR
DFLKQIIGR	DFLKQIIGR
DALLKNQRR	DALLKNQRR
DFLKQRPTK	DFLKQRPTK
TYKENFLKR	TYKENFLKR
DYRALVHER	DYRALVHER
DLFHRDFQFGH	DLFHRDFQF
DLQKWREER	DLQKWREER
DYYDDFLQRL	DYYDDFLQR
DYRYFDPKMLR	RYFDPKMLR
EYLEFRRER	EYLEFRRER
NVLTESARIAR	NVLTE-SAR
TVATLPRGR	TVATLPRGR
MFRAAAPGQLR	RAAAPGQLR
DNYPQSVPR	DNYPQSVPR
DVYAKLLHRYR	DVYAKLLHR
EALVPVIHR	EALVPVIHR
FHSTQWLR	FHSTQ-WLR
EPLLRENPR	EPLLRENPR
EIISHDTRRFR	EIISHDTRR
DILPFDHSR	DILPFDHSR
NIRAPEWPR	NIRAPEWPR
SNDIPHVVR	SNDIPHVVR
LSNIPWRR	LSNIP-WRR
MLLRLFLAM	MLLRLFLAM
DLRHKLNLR	DLRHKLNLR
IFKGVFVHR	IFKGVFVHR
DVHNRIVIR	DVHNRIVIR
SALRPSTSR	SALRPSTSR
EAQYIRTER	EAQYIRTER
EFMQRALQDLR	FMQRALDLR
DYFAKREQWKK	DYFAK---R
NTIGKEEIQQR	IGKEEIQQR
DAWSTTAARKR	DAWSTTAAR
DFLLHIIQR	DFLLHIIQR
DVKPSNFLYNR	DVKPSNYNR
DLRHLIVSR	DLRHLIVSR
TYRNSMFHNR	TYRNSMHNR
EYLQIPPVSR	EYLQIPVSR
DIFQQTPLGR	DIFQQTLGR
IVNHPKVGR	IVNHPKVGR
DFKPGDLIFAK	DFKPGDIFA
SVKEIYNEK	SVKEIYNEK
DLASPLIGR	DLASPLIGR
DSITVPVAR	DSITVPVAR
DMNRLLKQR	DMNRLLKQR
DVYNMQSGIHR	NMQSG-IHR
DLIKVTQVR	DLIKVTQVR
NTNDFVTLR	NTNDFVTLR
SYGPGPSLR	SYGPGPSLR
RFYYTTPNSY	FYYTTPNSY
IIAERHFDHLR	IAERHFHLR
DPLGAIHLR	DPLGAIHLR
DIKSSETGAFR	DIKSSETGA
DTKPTRIIR	DTKPTRIIR
ITYLMEHKR	ITYLMEHKR
DIFKKSKPR	DIFKKSKPR
NYFFYNKRLKR	FFYNKRLKR
DSFKPPQR	DSFKP-PQR
MYPDYFAKR	MYPDYFAKR
DFANFGVLR	DFANFGVLR
ETLKHSGIGR	ETLKHSIGR
DLFKLGEPHHR	DLFKLGHHR
EFYNLVRFR	EFYNLVRFR
SVQGIIIYR	SVQGIIIYR
APEYLHRFYGR	EYLHRFYGR
SALIPHAR	SALIP-HAR
DFARRLGLR	DFARRLGLR
ELWLVIHGR	ELWLVIHGR
DAYEPEISR	DAYEPEISR
IVKGPRGTLR	IVKGPRTLR
DISKRYSGR	DISKRYSGR
EDTQIPTSR	EDTQIPTSR
DARIPLSGR	DARIPLSGR
DAISYRFPR	DAISYRFPR
DSWTPFYQR	DSWTPFYQR
DSRDGKFIHR	DSRDGKIHR
NTILRHLGR	NTILRHLGR
NSLDTVLNR	NSLDTVLNR
DMLKIRSEFKR	DMLKIRSEF
DAKDFFKRK	DAKDFFKRK
DMTARDLLQQR	TARDLLQQR
DVLAWEHERF	DVLAWEHER
ETKDSGSFLLR	DSGSF-LLR
ETREVQNLR	ETREVQNLR
DTKGRFAVHR	DTKGRFVHR
EYTEGISQR	EYTEGISQR
ISPTGHSL	ISPTG-HSL
DTFLPRHR	DTFLP-RHR
DIYLPTHVR	DIYLPTHVR
DAVGFTFPNRL	DAVGFTPNR
TFKPVSSVKER	TFKPVSSVK
DFFLANASRAR	DFFLANASR
ETVRIINR	ETVRI-INR
LTQYRVSLR	LTQYRVSLR
DVNIKSTER	DVNIKSTER
VYIERLRHR	VYIERLRHR
YVQRFHYSR	YVQRFHYSR
DAMEYDEKLAR	EYDEK-LAR
EVQVVNTER	EVQVVNTER
DVKAPAMFNIR	DVKAPANIR
DNVKVVVR	DNVKV-VVR
DVYAKLLHR	DVYAKLLHR
DIWEKKLAQTK	DIWEKKLAQ
NISERRTYR	NISERRTYR
EVYTRLKSR	EVYTRLKSR
NAPWAVTSL	NAPWAVTSL
DVWVNESER	DVWVNESER
EAMTIFQNR	EAMTIFQNR
TAYRPDWNR	TAYRPDWNR
DIKSHYAFR	DIKSHYAFR
EVFGQITER	EVFGQITER
DARRQQLVYR	DARRQQVYR
PQGHFQER	PQGHF-QER
ELNTLRVTR	ELNTLRVTR
DNHVHVAR	DNHVH-VAR
DYNLIVIER	DYNLIVIER
EAQRITGLR	EAQRITGLR
DYILLSLVRTR	DYILLSLVR
TAFDRDRAMQR	FDRDRAMQR
DYLGTVAAR	DYLGTVAAR
DLASRLVTR	DLASRLVTR
DYIKVFKPK	DYIKVFKPK
DAWGIKVER	DAWGIKVER
DLNASVSAFQR	NASVSAFQR
DTLGIGKVKR	DTLGIGVKR
DTKELVVAK	DTKELVVAK
FELDLVTLRSE	FELDLVTLR
DILHKDGIINR	DILHKDINR
LNSVPSILR	LNSVPSILR
DVYFPKDLR	DVYFPKDLR
NTMDADSLVSR	DADSL-VSR
DALGGLLNR	DALGGLLNR
LNAESRVNR	LNAESRVNR
DFESILPTR	DFESILPTR
NVQVHFTER	NVQVHFTER
MAPERVASL	MAPERVASL
EVQAHPFFR	EVQAHPFFR
DVYAKYVLR	DVYAKYVLR
DIHLGPTVGR	DIHLGPVGR
DAVTYTEHAKR	VTYTEHAKR
DTMKVLGVQR	DTMKVLVQR
DLLTPVSR	DLLTP-VSR
DAAAVLVSR	DAAAVLVSR
NAKALSTLR	NAKALSTLR
DVQSVQEKR	DVQSVQEKR
VFLGRDTYGVR	DTYGV---R
IYFHDRVG	IYFHD-RVG
DIIPNPQER	DIIPNPQER
EVMRILISR	EVMRILISR
DLFSFMQKR	DLFSFMQKR
EVFTPVFER	EVFTPVFER
SSQQFSGIGR	SSQQFSIGR
DMQRIHLR	DMQRI-HLR
DNFLAFER	DNFLA-FER
EAFNMIDQNR	EAFNMIQNR
EWRDKLRPR	EWRDKLRPR
TSNMPVAAR	TSNMPVAAR
DILNGGPSKR	DILNGGSKR
TFEVLRKVGK	EVLRK-VGK
DDRSPEVFR	DDRSPEVFR
DSFTGPRRR	DSFTGPRRR
RNLDHVYNR	RNLDHVYNR
DILKVVEKR	DILKVVEKR
DIMHLTDSVVR	HLTDS-VVR
DARGLLSGLRR	DARGLLSGL
YPYSPPTFR	YPYSPPTFR
VILKPKMLDK	VILKPKMLD
ETILRTNKR	ETILRTNKR
IPRTPSSFR	IPRTPSSFR
NSNLVIHQR	NSNLVIHQR
DMWDTRIAK	DMWDTRIAK
DFRARFWYR	DFRARFWYR
EIYGVTHTR	EIYGVTHTR
EAYLPETFR	EAYLPETFR
EYLDTYNNR	EYLDTYNNR
DAYDMRKALSR	DMRKA-LSR
DVSHPIIYR	DVSHPIIYR
VNAPYNKINQR	APYNKINQR
SAALRAVYR	SAALRAVYR
TIMPKDIQLAR	MPKDIQLAR
TYYGSFVTR	TYYGSFVTR
DANGNSFATRI	DANGNSATR
DMTGLPHNR	DMTGLPHNR
DNYRVFER	DNYRV-FER
SDNKIIIIHR	DNKIIIIHR
TELSVRAKPSA	ELSVRAPSA
DLISKLLVR	DLISKLLVR
SAWVPSHR	SAWVP-SHR
DILDKVIER	DILDKVIER
DFYVRVFVR	DFYVRVFVR
DILEKKVEK	DILEKKVEK
VVAPRLNSR	VVAPRLNSR
EVRKLIIRR	EVRKLIIRR
ENKPLYQMR	ENKPLYQMR
DLFVNTNRR	DLFVNTNRR
DVVRRPPIHR	VVRRPPIHR
FFGERRIPR	FFGERRIPR
DFSKISIVR	DFSKISIVR
QAQKPSVPR	QAQKPSVPR
DTYPRKWGL	DTYPRKWGL
PTSPLTPT	PTSPL-TPT
DVKFGADAR	DVKFGADAR
DVNSFVRSR	DVNSFVRSR
HNTMPSQFR	HNTMPSQFR
EVFRPYAK	EVFRP-YAK
NSKESYELR	NSKESYELR
DLKGSLVSR	DLKGSLVSR
GGLPERSVSL	GLPERSVSL
DVNSNNNMSYR	NSNNNMSYR
ENFAPGTTR	ENFAPGTTR
LNQGEGTIRSR	LNQGEGTIR
EVPELYHQR	EVPELYHQR
DANPFLSKR	DANPFLSKR
DVITALTHR	DVITALTHR
DVRMGGSFR	DVRMGGSFR
DASLGVINR	DASLGVINR
DFRDISKWNNR	DISKW-NNR
DVVGRFNER	DVVGRFNER
YDENWFYTR	YDENWFYTR
DYLVPPALR	DYLVPPALR
EVAQFLTGR	EVAQFLTGR
DLQKNHIFR	DLQKNHIFR
DLYLKPIQR	DLYLKPIQR
DSKLSGRYR	DSKLSGRYR
DIHEELPKR	DIHEELPKR
TAQEVETYR	TAQEVETYR
EVRPDTQYTGR	EVRPDTTGR
FEVDTVAP	FEVDT-VAP
IYSGYIRNR	IYSGYIRNR
LALNIIQNR	LALNIIQNR
QTQSIYIPR	QTQSIYIPR
DVRELVVGR	DVRELVVGR
DSSNFITHR	DSSNFITHR
SFYQFQHYR	SFYQFQHYR
EINMWVSQR	EINMWVSQR
DSRRLSIQR	DSRRLSIQR
EYLHSRDVVYR	HSRDV-VYR
DASLLIVNR	DASLLIVNR
EMQLRQEEERR	EMQLRQEER
LAWEHERF	LAWEH-ERF
DYGRYDKTQLR	GRYDKTQLR
ELRDFFHDR	ELRDFFHDR
NWINVDPSRAR	INVDPSRAR
NILSRLANR	NILSRLANR
EIMSMGYERER	EIMSMGYER
DMIGVKELR	DMIGVKELR
EFLKLDRER	EFLKLDRER
EAKPPTVTMPR	EAKPPTVTM
DAQAFEREVGR	QAFEREVGR
DLQVRQDVR	DLQVRQDVR
EAHARIHLR	EAHARIHLR
INKPDGTFLLR	NKPDGTLLR
EVKEAIITR	EVKEAIITR
EVQEQYTERL	EVQEQYTER
VAWLVAHVR	VAWLVAHVR
NLKPKSWVRL	NLKPKSWVR
DYYDSHNVNTR	DSHNV-NTR
DIIQPSSTR	DIIQPSSTR
MFEYLAPPR	MFEYLAPPR
IFETIVNNR	IFETIVNNR
LTKDHYIER	LTKDHYIER
DFLQKRKER	DFLQKRKER
NNIGKFLNR	NNIGKFLNR
DFLRDRHVR	DFLRDRHVR
NTRIPEQRF	NTRIPEQRF
TAPTGHTL	TAPTG-HTL
EIGHFLRER	EIGHFLRER
ISKEVLAGR	ISKEVLAGR
DTLTLKERER	DTLTLKRER
EFIEITTER	EFIEITTER
DYYGYDYHNYR	YGYDYHNYR
YLKEREEFR	YLKEREEFR
SLKDPSNNFR	SLKDPSNFR
EVTDHNLHELR	EVTDHNHEL
LPLSPASTR	LPLSPASTR
DFEAHNILR	DFEAHNILR
EVLPKPRMR	EVLPKPRMR
EYIEARVTK	EYIEARVTK
DNIRKYWSR	DNIRKYWSR
NIKDIKVNR	NIKDIKVNR
DYYDDFLQR	DYYDDFLQR
MFLSFPTTK	MFLSFPTTK
DVYLGRYR	DVYLG-RYR
DTKALYATK	DTKALYATK
EILNAILNR	EILNAILNR
NLKDRDFLVQR	NLKDRDVQR
DVGRRFLVNR	DVGRRFVNR
DAIGVRRAAQR	DAIGVRAQR
DAFADAVQR	DAFADAVQR
SGYPPFVGR	SGYPPFVGR
EAKFPTMNR	EAKFPTMNR
SMALIHNR	SMALI-HNR
EYFADMERHR	EYFADMRHR
DMLHRFYGK	DMLHRFYGK
EAMEWVIHK	EAMEWVIHK
EALNVLVNR	EALNVLVNR
DLDLKKPIYQR	DLKKPIYQR
WFKGWKVTR	WFKGWKVTR
DLQLIKVTR	DLQLIKVTR
EALGEVMVSR	EALGEVVSR
DAGSGLVTR	DAGSGLVTR
DWQRHAIYR	DWQRHAIYR
EMFTPILGR	EMFTPILGR
EVRSQLKLR	EVRSQLKLR
EFFSINAQR	EFFSINAQR
DSFPWEVPK	DSFPWEVPK
DVNGELIAVQR	DVNGELVQR
ENYIHRIGR	ENYIHRIGR
DAGFPFVSR	DAGFPFVSR
DYSQSLHAR	DYSQSLHAR
EMQAKVAVR	EMQAKVAVR
LMFDKTTNR	LMFDKTTNR
VPMRPGILVQR	PMRPGIVQR
DFRDPRDLR	DFRDPRDLR
EIEKFDKSKLK	EKFDKSKLK
DFLDKQMSR	DFLDKQMSR
IFKPRFAMR	IFKPRFAMR
EYFPTKNRQR	EYFPTKRQR
NFIDIQFPK	NFIDIQFPK
DVRFPEKR	DVRFP-EKR
DNMPLRGKQLR	MPLRGKQLR
TVQKETIHPR	TVQKETHPR
DNNEYIARR	DNNEYIARR
DLLKRAFVR	DLLKRAFVR
TFVAILIAR	TFVAILIAR
DFGGIFHTR	DFGGIFHTR
DMNYIIQR	DMNYI-IQR
EIKERIAKR	EIKERIAKR
ELLPKEKFVSR	LPKEKFVSR
DIWHKVGNA	DIWHKVGNA
DVYPEIIER	DVYPEIIER
DYIHHMGYVHR	DYIHHMVHR
DTKVVSMVGR	DTKVVSVGR
TILIILTGR	TILIILTGR
DFNRGVNYR	DFNRGVNYR
EYAEFQYRR	EYAEFQYRR
TVRIPSQR	TVRIP-SQR
EYIFLAVGR	EYIFLAVGR
DLKPQNLLINR	DLKPQNINR
EYKPHSIPLR	EYKPHSPLR
EFLHANQVIHR	HANQV-IHR
DVFMFLTNR	DVFMFLTNR
DLKETDIKHLR	DLKETDHLR
DARIVINR	DARIV-INR
ILGPPGPRGA	ILGPP-GPR
EFHKQITAR	EFHKQITAR
DIAGRDVSR	DIAGRDVSR
DSWKITGR	DSWKI-TGR
DVINPMALR	DVINPMALR
DVKDPVSIEER	DVKDPVEER
DYRDTVVKR	DYRDTVVKR
TVQQLEGRWR	TVQQL-EGR
ETRAEFAER	ETRAEFAER
EFLGHRIVR	EFLGHRIVR
VNTSLNVYR	VNTSLNVYR
VDIINAKQ	VDIIN-AKQ
DAFAPVAYL	DAFAPVAYL
DTANKKVFLGR	TANKKVLGR
DYKALGILKR	DYKALGLKR
DGLDRIVER	DGLDRIVER
EYLQRYHIIHR	EYLQRYIHR
YSKYYKTID	YSKYYKTID
DVKPSNILVNS	DVKPSNILV
DARLFTEKILR	DARLFTILR
DYIHRIGRTAR	DYIHR-IGR
DIQRGLVLR	DIQRGLVLR
DLFDFITER	DLFDFITER
EGDYKTIAKER	DYKTIAKER
DLRQELAVRER	DLRQELAVR
DFKKYVENR	DFKKYVENR
NVARRIEFR	NVARRIEFR
SAPSRATAL	SAPSRATAL
DVWVPQER	DVWVP-QER
YSWDIVVQR	YSWDIVVQR
DVVPKTAENFR	VPKTAENFR
ETLNIVLVGR	ETLNIVVGR
DIKPGNIMR	DIKPGNIMR
EARPFRGSVGR	EARPFRVGR
DIQQVGVIR	DIQQVGVIR
DGQTPISQR	DGQTPISQR
EVQGDRMHLR	EVQGDRHLR
NAIKWNFTK	NAIKWNFTK
DSFNVVSTR	DSFNVVSTR
EVRQIASIVQR	EVRQIAVQR
DIRDFIHQR	DIRDFIHQR
DVGGKQFPVTR	DVGGKQVTR
DARGTVVLRVR	DARGTVVLR
DVKNAGDLR	DVKNAGDLR
DGHEFIVKR	DGHEFIVKR
DLRPGVIVR	DLRPGVIVR
EYKDIFIRH	EYKDIFIRH
DALKRYAGALR	DALKRYALR
DLQLIKVTRL	DLQLIKVTR
SVKEISDIVQR	EISDI-VQR
NVRLIEVER	NVRLIEVER
LKKPIYQR	LKKPI-YQR
YVAYIKWHR	YVAYIKWHR
DYYEVLGVQR	DYYEVLVQR
TTLDESLTNR	TTLDESTNR
PPAHISSVR	PPAHISSVR
SVKSITNPR	SVKSITNPR
SLVNLGGSK	SLVNLGGSK
HTLKRDVLR	HTLKRDVLR
DTAAQITQR	DTAAQITQR
DVFPGPSFR	DVFPGPSFR
TLYERIVSR	TLYERIVSR
DMKSVTDRAAR	DMKSV-TDR
NNQSFYSNR	NNQSFYSNR
SIPGGYNAL	SIPGGYNAL
HSLPPIARR	HSLPPIARR
DAWNTVSR	DAWNT-VSR
DASSGPIQVR	DASSGPQVR
EVSTVNVRR	EVSTVNVRR
DLKDSSLLKTK	DLKDSSLLK
EARAFGVTR	EARAFGVTR
DLRILPEAHQR	DLRILPHQR
ETLETIINR	ETLETIINR
DTKSPQFNR	DTKSPQFNR
