Data	Data aligned
NSDYLALLQAY	NSDYLALLQ
HLDLGILYY	HLDLGILYY
YTEEFDFKEY	YTEEDFKEY
ASDRNIVLY	ASDRNIVLY
YLDKEDTFF	YLDKEDTFF
ITDKNSLAY	ITDKNSLAY
TVEELTDTFYY	TVEETDTFY
PSDPRYHEVHY	PSDPRYHEV
FTDVNSILRY	FTDVSILRY
FSQPENQNLLY	QPENQNLLY
VTEDGNQHVY	VTEDNQHVY
VTDDSPKYNY	VTDDPKYNY
ATSKVALVY	ATSKVALVY
TDLAQHLY	TDL-AQHLY
VTEKDLLLY	VTEKDLLLY
AIDRLVNIY	AIDRLVNIY
ATESFASDPI	ATESASDPI
YMEEEIPKNY	YMEEIPKNY
IMEKSTMLY	IMEKSTMLY
AVDVNNMLHLY	AVDVNMLHL
YMDYRGYSY	YMDYRGYSY
YTLYRPEEGY	YTLYPEEGY
LSERYAELY	LSERYAELY
LTDEQIRFLY	LTDEIRFLY
ETEMAAYRLY	ETEMAYRLY
LLDPMGGIVMT	LLDPMGGIV
LLDSSQKNLY	LLDSQKNLY
YTMGYGESMYY	YTMGGESMY
TEHVAEKHIY	TEHVEKHIY
PLDHLKPLEY	PLDHKPLEY
HSDVAPTHILY	DVAPTHILY
TADTLMGLRY	TADTMGLRY
ETDLHGSLRV	ETDLGSLRV
YIDPIAMEY	YIDPIAMEY
VIDSAELQAY	VIDSELQAY
FTEHVAEKHIY	FTEHVAEKH
YTDLLRLFEY	YTDLRLFEY
VTDSGPTFN	VTDSGPTFN
VWDLRNMGY	VWDLRNMGY
LSDLGKLSY	LSDLGKLSY
LLEIAQTHY	LLEIAQTHY
NSEEMKEAYY	NSEEMKEAY
YTDILIGLL	YTDILIGLL
ATEYKNEEY	ATEYKNEEY
LLENDVSTLGY	LLENDVSTL
FLEQVHQLY	FLEQVHQLY
YQDLLQLQY	YQDLLQLQY
GTDGQGGTFRY	GTDGQGGTF
NLDSQRLQY	NLDSQRLQY
VTDSIRDEY	VTDSIRDEY
ATEDPWKTNY	ATEDWKTNY
LTDIFQHDTY	LTDIQHDTY
LVDSKGFDEY	LVDSGFDEY
ITDFINILHRY	ITDFNILHR
SFDETVTHFI	SFDETVTHF
MLDSHEEL	MLD-SHEEL
NLDPLTET	NLD-PLTET
FSEPRAIFY	FSEPRAIFY
TSAPRGLFDEY	SAPRLFDEY
YSDSGLFGIY	YSDSLFGIY
YTAPPLQSKY	YTAPLQSKY
AIDQLHLE	AID-QLHLE
MTELPAPLSY	MTELAPLSY
ITDPDPDIRY	ITDPPDIRY
QLDVAGRVMQY	DVAGRVMQY
DADSSVMMTY	DADSVMMTY
TSDFSRFTNY	TSDFRFTNY
IADSNYNWFY	IADSYNWFY
EIDDIGYALY	IDDIGYALY
DADYPLRVLY	DADYLRVLY
LTDDLHKQY	LTDDLHKQY
NLEEGKLAFY	NLEEKLAFY
VSDSKQFTYY	VSDSKQFTY
LSEINKPNFY	LSEIKPNFY
FADQLIAAGHY	ADQLAAGHY
HLDSDQKLLY	HLDSQKLLY
YSDSLVQKGY	YSDSVQKGY
HLDEAQRLLY	HLDEQRLLY
ATDRWYDEY	ATDRWYDEY
ELDPLTGEWHY	ELDPLTGEW
ECDMAFHIY	ECDMAFHIY
VLDVLNEVDEY	VLDVEVDEY
LSEVFMKTLNY	LSEVFMKTL
LSDFGLERY	LSDFGLERY
FSEGEKVNY	FSEGEKVNY
VLDSEGYLLFY	DSEGYLLFY
QLEWDDSTLSY	EWDDSTLSY
LTDMTLLHY	LTDMTLLHY
ASDHEFLNHY	ASDHFLNHY
QLDSPQRALY	QLDSQRALY
ILDTYLGKY	ILDTYLGKY
FSDFLFRWY	FSDFLFRWY
FLDASGAKLD	FLDASGAKL
MLDRGHLDY	MLDRGHLDY
LVDVEEMNY	LVDVEEMNY
RTDFQKDFAKY	RTDFQKDFA
EIDIPHVWLY	EIDIHVWLY
ISEDKNPDY	ISEDKNPDY
ETDEKDFYLY	ETDEDFYLY
LLDSLREQY	LLDSLREQY
DSEKVIAGLY	DSEKIAGLY
SIQDLLLEY	SIQDLLLEY
YSEIKDFLS	YSEIKDFLS
FLNDSYLKY	FLNDSYLKY
ITNTRPLSY	ITNTRPLSY
YIDEQFERY	YIDEQFERY
YSEGYPGQRY	YSEGPGQRY
FAEAHYLSY	FAEAHYLSY
ITEDSENQRLA	ITEDENQRL
PSDPKQYRY	PSDPKQYRY
TELNHLGY	TEL-NHLGY
ESDVRNTVTY	ESDVNTVTY
LSSTIQRFY	LSSTIQRFY
LLDIDFGTY	LLDIDFGTY
VTEGGEPYRLY	VTE-GGEPY
HCDFFISKY	HCDFFISKY
FLDPITGTFRY	FLDPITGTF
DLDKSGSMSAY	DLDKSGSMS
MTDPEMVEV	MTDPEMVEV
SIDSLQLGY	SIDSLQLGY
TIDKATGILLY	TIDKTGILL
FVAEPDNKNVY	VAEPNKNVY
VTDPEKLNNY	VTDPKLNNY
IMDPYKASY	IMDPYKASY
MDEGAHLHIY	MDEGHLHIY
RIEDGKLYY	RIEDGKLYY
NIDHLHVGWY	NIDHHVGWY
YLEELSQRY	YLEELSQRY
EADRNPPVLY	EADRPPVLY
NSELLNDRY	NSELLNDRY
GSDVHYWEY	GSDVHYWEY
LLDKGVYGLLY	LLDKVYGLL
SMDVSLAY	SMD-VSLAY
VMDPALAAQY	VMDPLAAQY
GTDPATLY	GTD-PATLY
DSDLMEPVFRY	LME-PVFRY
SLEIRALLY	SLEIRALLY
MLDRWSIMTY	MLDRSIMTY
SVDPHGFISY	SVDPGFISY
ISEELVQKY	ISEELVQKY
FMDPQKMPY	FMDPQKMPY
QSDVIHQSVY	QSDVHQSVY
VADVHQYFY	VADVHQYFY
ATDIFSYLVEY	ATDIFSYLV
IIEAQYLRY	IIEAQYLRY
QTDPATLL	QTD-PATLL
STELNHLGY	STELNHLGY
VTDTSMDTY	VTDTSMDTY
LSDIERQIY	LSDIERQIY
VTEITRYSFY	VTEIRYSFY
LTDDGNKWLY	LTDDNKWLY
TSYPMHDFY	TSYPMHDFY
FAEMIQPEY	FAEMIQPEY
EADTVLATLY	EADTLATLY
FTDWKGYLM	FTDWKGYLM
NLDIERPTY	NLDIERPTY
FVDKNNDLLY	FVDKNDLLY
ISDGKEYLFY	ISDGEYLFY
LTEPTGLLY	LTEPTGLLY
LTHWEQLDY	LTHWEQLDY
SLHDTVFDK	SLHDTVFDK
DLDLSPLEY	DLDLSPLEY
ELEDSTLRY	ELEDSTLRY
KADLGKIVL	KADLGKIVL
YTDKIMTYL	YTDKIMTYL
ELAKQVIEY	ELAKQVIEY
LLDPAQKILY	LLDPQKILY
VSAEEALKY	VSAEEALKY
QTALPGNDRY	QTALGNDRY
YTDNLVRVW	YTDNLVRVW
YSDSAVLKL	YSDSAVLKL
TLDLIDEAY	TLDLIDEAY
YTEAIADIK	YTEAIADIK
ASDPFFRHY	ASDPFFRHY
VVDDWIESY	VVDDWIESY
VTEKIPVRHLY	VTEKVRHLY
STDLQDYTYY	STDLDYTYY
QADIARMLY	QADIARMLY
QTETGTPYM	QTETGTPYM
ELEKSVYWDY	ELEKVYWDY
LLDPSVFHVKY	LLDPVFHVK
YSAAWAEYY	YSAAWAEYY
HSEVLIDLTEY	EVLIDLTEY
KLDRSVFTAY	KLDRVFTAY
DFSSDDSKLEY	SSDDSKLEY
LTDFIQEE	LTD-FIQEE
LTEPVIPFHLY	LTEPIPFHL
ITDIVNKY	ITD-IVNKY
ESDDDMGFGLF	ESDDMGFGL
LVDPWTPHLY	LVDPTPHLY
YADRALAFY	YADRALAFY
FSDVMEDLYN	FSDVMEDLY
FVDTDIWNQY	FVDTIWNQY
LTDPDGALAK	LTDPGALAK
LVDDGTVGKY	LVDDTVGKY
TTDNEISRTEY	TTDNEISRT
DTDHYFLR	DTD-HYFLR
QTPIVPLLY	QTPIVPLLY
VSDGIIAPGY	VSDGIAPGY
FADGFVLVY	FADGFVLVY
FVDPLVTNY	FVDPLVTNY
YSDISGGGHPY	YSDISGGGH
YSEGYPGKRY	YSEGPGKRY
NLDKFNVSNFY	NLDKNVSNF
VSELQVLLGY	VSELVLLGY
RSDSYVELSQY	DSYVELSQY
FLDSKGLEY	FLDSKGLEY
NTDEKYYGSY	NTDEYYGSY
SEPRKGFMY	SEPRKGFMY
VFDVTERTAL	VFDVERTAL
SDHFETIMKY	SDHFTIMKY
LSDIGSGIRYL	LSDISGIRY
YTEKMVSISNY	YTEKMVSIS
VTDEDVFPTKY	TDEDFPTKY
YSDEFGNLDF	YSDEGNLDF
MDAVPRIDHY	MDAVRIDHY
YTSSVNRLNYY	YTSSNRLNY
STDPEALHYDY	STDPEALHY
FTDIDGQV	FTD-IDGQV
FTEQYNEQ	FTE-QYNEQ
YSDGLGGNSLY	YSDGGGNSL
HLDLIEAKF	HLDLIEAKF
LLYESPERY	LLYESPERY
YLDSIPPGQY	YLDSPPGQY
FTEQWTDGY	FTEQWTDGY
LLDGTLFDSSY	LLDGLFDSS
FLDKSGLQGY	FLDKGLQGY
SLLGKPLSY	SLLGKPLSY
ISSENLLDAVY	SSENLDAVY
ETDIVVDHY	ETDIVVDHY
EADEYLDKY	EADEYLDKY
YSDSFPMEL	YSDSFPMEL
ASNLENSTYDL	ASNLENSTY
SSDANPVRY	SSDANPVRY
TSDHFETIMKY	TSDHETIMK
NIDNFLSRY	NIDNFLSRY
LTEQRALLY	LTEQRALLY
VLDPYLLKYF	VLDPYLLKY
ETEYGLSVY	ETEYGLSVY
ASEIAVGHQY	ASEIVGHQY
QTVAWFPLYY	TVAWFPLYY
LTDDDLLRY	LTDDDLLRY
TSDLQDKNEY	TSDLDKNEY
GSDYINANY	GSDYINANY
VTEKVLAAVY	VTEKLAAVY
ITEIINPNY	ITEIINPNY
LTELTDDQAKY	LTD-DQAKY
MLDKSPIRY	MLDKSPIRY
YTENEVLEV	YTENEVLEV
VSDVEMQEHY	VSDVMQEHY
HTDSLHLLI	HTDSLHLLI
YSEDLSDMHY	YSEDSDMHY
NTDPWAGYRY	NTDPAGYRY
LDFREKGGY	LDFREKGGY
YSDTLLDYGFY	YSD-TLLDY
LTDPAIVKV	LTDPAIVKV
QTESAWAEEY	QTESWAEEY
YLDQISRYY	YLDQISRYY
FSDVMEDLY	FSDVMEDLY
ASDPYQVHV	ASDPYQVHV
QLEDGRTLSDY	LEDGTLSDY
QADPTKLELLY	QADPKLELL
LSEGVTISY	LSEGVTISY
TTSHLMGMF	TTSHLMGMF
ATESILHFAGY	ATE-SILHF
LSEDRWSSY	LSEDRWSSY
AVDPRFLAY	AVDPRFLAY
LVDTGIGMTK	LVDTIGMTK
DSDDDFDMSRY	SDDDDMSRY
ISEAGKDLLY	ISEAKDLLY
ITDIHIKY	ITD-IHIKY
GSDDTELRY	GSDDTELRY
YVDSHPITTY	YVDSPITTY
MTERQDLVY	MTERQDLVY
TAQIFSYL	TAQ-IFSYL
SSYLGDFPYY	SSYLDFPYY
LSDMPLKSFY	LSDMLKSFY
TSDELQFG	TSD-ELQFG
NSDLSEKLEY	NSDLEKLEY
KLDQLIEFY	KLDQLIEFY
YPEGFEIHSM	YPEGEIHSM
YLDLKSDEWEY	YLDLKSDEW
DTDIVDEAIY	DTDIDEAIY
YLDWIEICHY	YLDWEICHY
SVDQPPPSY	SVDQPPPSY
SSENLLDAVY	SSENLDAVY
DSENAERILY	DSENERILY
ATEFIMNEY	ATEFIMNEY
ALDTINILLY	ALDTNILLY
LIDLAIDTY	LIDLAIDTY
KTELERAFGYY	ELERAFGYY
LLDPSITLGQY	LLDPITLGQ
ALAFEPLSQLL	AFEPLSQLL
LLEGDIHGQYY	LLEGIHGQY
FSDSESADSLY	DSESADSLY
VLDDPNEDHLY	LDDPEDHLY
LVDEWLDSY	LVDEWLDSY
LLDTPAQLWY	LLDTAQLWY
HTDILKEKY	HTDILKEKY
YTELTTAIRTY	YTELTAIRT
VADRLGSLMQY	VADRLGSLM
LSDLYHPIQI	LSDLHPIQI
SDKYFDEHY	SDKYFDEHY
YTAPQPGKY	YTAPQPGKY
LSEERVWEY	LSEERVWEY
SLDVGGPLRY	SLDVGPLRY
KGDRDVLSY	KGDRDVLSY
ETDEKDFY	ETD-EKDFY
LSEPEEAAALY	LSEPEAAAL
QSDPWQQELY	QSDPQQELY
LLEDKHFQSY	LLEDHFQSY
MIDVTKSYY	MIDVTKSYY
VSSLGSGMMRY	SSLGGMMRY
YGSKEDPQTFY	GSKEPQTFY
TVDPASLWE	TVDPASLWE
HLDSLPSKY	HLDSLPSKY
ATDLTREVY	ATDLTREVY
FSEDGEYFAY	FSEDEYFAY
WTDLALQY	WTD-LALQY
DMVIVYKDY	DMVIVYKDY
SADSFQSFY	SADSFQSFY
QASAPMAPADY	ASAPAPADY
FIDRKDSYY	FIDRKDSYY
EDGQVKKETRY	QVK-KETRY
STEEARFLTY	STEERFLTY
TTESEVMKY	TTESEVMKY
LLDHTGGCMY	LLDHGGCMY
VVDPDEKSIMT	VVDPEKSIM
VTDPRVVDLLV	VTDPVVDLL
LTDYDIRFY	LTDYDIRFY
VSDPVGVLY	VSDPVGVLY
FTAEFSSRY	FTAEFSSRY
VTDAVFQEMY	VTDAFQEMY
DHFETIMKY	DHFETIMKY
ALDSHILDYY	ALDSHILDY
KSVTKIYNYY	SVTKIYNYY
DLEKEAPWEY	DLEKAPWEY
ATDPVTGDL	ATDPVTGDL
VSELGDKTFF	VSELDKTFF
ISDDEIENPHY	SDDEENPHY
FVDKLFESLY	FVDKFESLY
YVDPQFLTYM	YVDPQFLTY
DTDLFSQPTY	DTDLSQPTY
IVLDPMVGYMY	VLDPVGYMY
VSEVSSLNY	VSEVSSLNY
TIDTSMFCEY	TIDTMFCEY
FTDTVGNILK	FTDTGNILK
KMDDLNLHY	KMDDLNLHY
VTNESPLKY	VTNESPLKY
YSGYIFDYDYY	YSGYFDYDY
DSENQRLAY	DSENQRLAY
TTEGYQPPPVY	TTEGQPPPV
ILDYINGGELF	ILDYNGGEL
SADPDNLKY	SADPDNLKY
LSEEASLHY	LSEEASLHY
YLDSIPPGQYM	YLDSPPGQY
YTDFDGTRVY	YTDFGTRVY
LTDDKLSQY	LTDDKLSQY
YSAAQLHNQY	YSAALHNQY
TDFWKTLRY	TDFWKTLRY
YTIATILHY	YTIATILHY
YTDGPGGSGQY	YTDGGSGQY
YLDQISRY	YLD-QISRY
NTDSLDWALY	NTDSDWALY
IIDLAGDTVRY	DLAGDTVRY
ELDGFGLYLY	ELDGGLYLY
AIEEVNLAY	AIEEVNLAY
FLDDSTAIQHY	LDDSAIQHY
LLEGLTVVY	LLEGLTVVY
VTEEFQPV	VTE-EFQPV
VSDYLRQSY	VSDYLRQSY
FSEKLEAEY	FSEKLEAEY
VTDHLGVVYY	VTDHGVVYY
LDSRHLDHY	LDSRHLDHY
LTETIYKNYY	LTETYKNYY
ILDEVIMGY	ILDEVIMGY
ETEEGIYWRY	ETEEIYWRY
TTDWRCYGY	TTDWRCYGY
EADPELSKFLY	EADPELSKF
TENDKEYQEY	ENDKEYQEY
HLDGQPFLRY	HLDGPFLRY
YTDLLRLFE	YTDLLRLFE
IVDHNIADY	IVDHNIADY
ESEDPDYY	ESE-DPDYY
FLDAFRTFY	FLDAFRTFY
EPFLFNFLY	EPFLFNFLY
LTDITKGVQ	LTDITKGVQ
DSDINNRLV	DSDINNRLV
FTDPAHTEEF	FTDPHTEEF
PKYGMFRY	PKY-GMFRY
YINGGELFY	YINGGELFY
LIEQAAEMLY	LIEQAEMLY
LLDEDCVHY	LLDEDCVHY
EVVDKEKNLY	VVDKEKNLY
TIEEKPALY	TIEEKPALY
LSSRTNLQY	LSSRTNLQY
AMDVYKNLY	AMDVYKNLY
KTELERAFGY	KTELRAFGY
EIDHAEYYLY	EIDHEYYLY
FPGNYSGY	FPG-NYSGY
STEFNPLI	STE-FNPLI
SADLVALSY	SADLVALSY
KSDSGKPYYY	KSDSKPYYY
FLDPRQPSY	FLDPRQPSY
VTDTGALY	VTD-TGALY
LSSPVESVLF	LSSPESVLF
LTDLVDDNYFY	LTDLVDDNY
TSDELQFGY	TSDELQFGY
FSEIDLEKY	FSEIDLEKY
FSEINKAEEQY	FSEIKAEEQ
ASEFGNHYLY	ASEFNHYLY
RAEDAMRLY	RAEDAMRLY
HTDVGLLEY	HTDVGLLEY
AVESVTDSSRY	ESVTDSSRY
TSNLSSIDSFY	NLSSIDSFY
FLDGVYAFE	FLDGVYAFE
SSEVIKDANLY	EVIKDANLY
DTDHYFLRY	DTDHYFLRY
GWDINKDACLF	DINKDACLF
STDENFRY	STD-ENFRY
VTDGPGNYKY	VTDGGNYKY
ASDAAPLQY	ASDAAPLQY
DTPINYSLKY	DTPIYSLKY
TDLTREVY	TDL-TREVY
LTDDELFQY	LTDDELFQY
LVDERPFLHY	LVDEPFLHY
IVDDFFIGRY	IVDDFIGRY
VVDPFSKKDWY	VVDPFSKKD
YSDAFLNDSY	YSDALNDSY
LTSMVDDMWHY	MVD-DMWHY
KFDDSLVHI	KFDDSLVHI
ALDYIHHMGY	ALDYHHMGY
FLDTNETPY	FLDTNETPY
YSEDRIGLADY	SEDRGLADY
QTDIQGALSAY	QTDIQGALS
HSALLALRY	HSALLALRY
VTDLLKELV	VTDLLKELV
VTDPSTLEQY	VTDPTLEQY
YSDESGNMDF	YSDEGNMDF
LVDHFMEL	LVD-HFMEL
FSQKSTLVY	FSQKSTLVY
LTDYDIRF	LTD-YDIRF
ITDESPYVHY	ITDEPYVHY
LTDRGVMSY	LTDRGVMSY
GSDCTTIHY	GSDCTTIHY
FIYFIKGFLY	FIYFKGFLY
YADNQVMHFY	YADNVMHFY
YLDWAYRSGGY	YLDWRSGGY
LLEDSALSKY	LLEDALSKY
VMEKSFLEYY	VMEKSFLEY
VLDPYLLK	VLD-PYLLK
FSEFTGVWK	FSEFTGVWK
LSDILRFIY	LSDILRFIY
KSELGLNFY	KSELGLNFY
MSEIEAKVRY	MSEIAKVRY
ESEFEMKVYY	ESEFMKVYY
ETDLLDIRSE	ETDLLDIRS
YTDLHYGQTVT	YTDLYGQTV
QLDAAINHY	QLDAAINHY
ELDHTVSMQY	ELDHVSMQY
YMDLVLGTRAE	YMDLVLGTR
LSDVFPGVQ	LSDVFPGVQ
FSEPDFVAKFY	FSEPFVAKF
FVEPYFDEY	FVEPYFDEY
FIDNIPYSME	FIDNIPYSM
QMETFMLHY	QMETFMLHY
MIEPRTLQY	MIEPRTLQY
ITEDKTELY	ITEDKTELY
LLDSDEPLVY	LLDSEPLVY
FSEDPMEQDL	FSEDMEQDL
MIDETRNSLY	MIDERNSLY
TLDPHNVDY	TLDPHNVDY
NTDASGKIEKY	TDASKIEKY
QVDFSPDMSY	QVDFPDMSY
TSDDVKEQIY	TSDDKEQIY
YSEETLRARFY	YSEELRARF
ILDRLLDGY	ILDRLLDGY
KSDPFLVF	KSD-PFLVF
LLDDSVRVY	LLDDSVRVY
DGDLAGRYY	DGDLAGRYY
VLDGTIEY	VLD-GTIEY
VTECEKYAQLY	ECEKYAQLY
RLEKLQLEY	RLEKLQLEY
TTDSSYGQNY	TTDSYGQNY
TTEETLTML	TTEETLTML
PTDISYVYSGY	PTD-ISYVY
FADEGSIFY	FADEGSIFY
FTEIKNLLV	FTEIKNLLV
HFEEEEITF	HFEEEEITF
NSELGSETRY	NSELSETRY
YMDTAIQTY	YMDTAIQTY
EIDPTKENQLY	EIDPKENQL
YLDLTPNQEY	YLDLPNQEY
GDGGRLKPESY	DGGRKPESY
LIDNSFNRY	LIDNSFNRY
ITELANALSY	ITELNALSY
FTDMFKILTY	FTDMKILTY
DTDISLIRY	DTDISLIRY
STDTRYLGSY	STDTYLGSY
FSDNDKLYLY	FSDNKLYLY
LADWPLWY	LAD-WPLWY
VSDLEPHMNY	VSDLPHMNY
LDTHRGLLY	LDTHRGLLY
FSAFEKHQYY	FSAFEKHQY
MLERKFLEY	MLERKFLEY
TVDSRVSSRF	TVDSVSSRF
ATESEVESLQY	ESEVESLQY
LTDFIREEY	LTDFIREEY
VVDEDHELI	VVDEDHELI
GTEIDGRSISL	EIDGRSISL
ATEESFFILKY	TEESFILKY
FTDNFSFNTY	FTDNSFNTY
TLDPQTGLFY	TLDPTGLFY
SLDEYQVAQLY	LDEYVAQLY
ATDFDVLS	ATD-FDVLS
FLDKLSDYY	FLDKLSDYY
LTDILGIEDY	LTDIGIEDY
QVEEADDWLRY	VEEADWLRY
YLENLEKLM	YLENLEKLM
GADRNLLVY	GADRNLLVY
GVDVTGPHLY	GVDVGPHLY
VTDIHQLSF	VTDIHQLSF
RTDGILALY	RTDGILALY
MLEEGQEYAVM	MLE-EGQEY
LLEELPILY	LLEELPILY
FTASLAMKY	FTASLAMKY
LLEKEILFY	LLEKEILFY
VSDYYSQLIY	VSDYSQLIY
DSYSSSRSDLY	YSSSRSDLY
TLDPYRNEVSQ	TLDPYRNEV
TTDNNPPMKL	TTDNPPMKL
VVDPLNGWMY	VVDPNGWMY
LTDPIQGTEY	LTDPQGTEY
VTQNLEDQY	VTQNLEDQY
MTERQALSY	MTERQALSY
TTEESLRNYY	TTEELRNYY
ITEYMEHVY	ITEYMEHVY
FSDIVKQGY	FSDIVKQGY
WTDILSHGRY	WTDISHGRY
FQDQLHQLY	FQDQLHQLY
MLDDFGPHRY	LDDFGPHRY
YVDQAELEKY	YVDQELEKY
LTEPTGLL	LTE-PTGLL
FSEENSALEY	FSEESALEY
LVDLPEYY	LVD-LPEYY
ETDNMFNRY	ETDNMFNRY
LSDIGLEY	LSD-IGLEY
VTDAVALRV	VTDAVALRV
ESAFRKLDELY	SAFRLDELY
ATDEQPHIGNY	TDEQHIGNY
NSEQETLQKY	NSEQTLQKY
VIDDVREKY	VIDDVREKY
ATDIFSYLVE	ATDIFSYLV
FLDKVVGLQK	FLDKVGLQK
DTEKELQALY	DTEKLQALY
QTLTDYDIRFY	LTDYDIRFY
LSTNKELESY	STNKELESY
NVDAILEEY	NVDAILEEY
DSEGTFNSY	DSEGTFNSY
LLDTLRIYY	LLDTLRIYY
YLEETSIRY	YLEETSIRY
FSEVRVYNY	FSEVRVYNY
GSDEPAFMYY	GSDEAFMYY
SDVGLGKGRYY	DVGLGKGRY
FMEKETPLRY	FMEKTPLRY
GTEFTTILY	GTEFTTILY
FQDNRQLYY	FQDNRQLYY
YSENVERTKY	YSENERTKY
SVDNQEKLLY	SVDNEKLLY
LSAMKEFAY	LSAMKEFAY
QLTEDSVKNY	LTEDSVKNY
NMDPAKGIQY	NMDPKGIQY
NSDLNNLLF	NSDLNNLLF
SEQPDFSGHKY	QPDFSGHKY
YLEEFKENAY	YLEEKENAY
FSDYLHPQ	FSD-YLHPQ
STETHEELL	STETHEELL
AVDFAERHGY	AVDFERHGY
QSERQLLLY	QSERQLLLY
LSDEHVQFLVY	LSDEHVQFL
NVDPTGQSVAY	NVDPTGQSV
SSDALDKIRY	SSDADKIRY
LLEQGGRLSSF	LLEQGRLSS
TTDIPLEGY	TTDIPLEGY
STDKFKTDFY	STDKKTDFY
LLEIAQTHYY	LLEIQTHYY
FLDYDAGEVSF	FLDYDAGEV
LVDEWLDS	LVD-EWLDS
VSDIVGPDGLV	VSDIGPDGL
QLDPAQRCLY	QLDPQRCLY
FTDMMPLLH	FTDMMPLLH
YMELYTHVY	YMELYTHVY
TLDENPGVRY	TLDEPGVRY
ETFYSTERY	ETFYSTERY
SSEALYNQY	SSEALYNQY
VLDVETGNEY	VLDVTGNEY
HSDIFPARHY	HSDIPARHY
ATDMPVKNQY	ATDMVKNQY
GSDPVFRFY	GSDPVFRFY
WLEEGIHWQY	WLEEIHWQY
LTDIHGNVLQY	LTDIHGNVL
ASDLSQPDLVY	ASDLQPDLV
IIDGHTLKY	IIDGHTLKY
YSQPPYNQGGY	YSQPNQGGY
TLDPNFLDA	TLDPNFLDA
YVDVPFPNQY	YVDVFPNQY
FTDEEGYGRY	FTDEGYGRY
HSERHVLLY	HSERHVLLY
ETDPFVQEF	ETDPFVQEF
LTDEGLLY	LTD-EGLLY
LSDAEFHTY	LSDAEFHTY
YSDFPFHEDY	YSDFFHEDY
PSDPKQYRYI	PSDPKQYRY
QLDSAQKNLY	QLDSQKNLY
ATDFDVLSY	ATDFDVLSY
RVDQSAVGFEY	VDQSVGFEY
LTDFASFKPTY	LTDFFKPTY
MLDSHEELY	MLDSHEELY
SSDFDPLVY	SSDFDPLVY
ILDNLDAANHY	NLD-AANHY
LSDPAGAIIY	LSDPGAIIY
ILDIPNQLYY	ILDINQLYY
ALDESFLGTLY	LDESLGTLY
QADPSPLLFY	QADPPLLFY
ELQQELQEY	ELQQELQEY
KTLLRTWSELY	LLRTWSELY
HVEEISELFY	HVEESELFY
SIRGNNIRY	SIRGNNIRY
HWDPEYSDVKL	HWDPYSDVK
FSDIHDFEY	FSDIHDFEY
ISEVGTIRY	ISEVGTIRY
ATDLIRISQY	ATDLRISQY
EIDMNDIKAFY	DMNDIKAFY
LMEVDPIGHLY	EVDPIGHLY
FSDSKIQKY	FSDSKIQKY
GSARAAGYDLY	SARAGYDLY
LTELPDWS	LTE-LPDWS
SSDSTIDIL	SSDSTIDIL
DTELKQVAYIY	DTELKQVAY
LTELPPLDDY	LTELPLDDY
ETEEDKFL	ETE-EDKFL
GSSTDPEALHY	STDPEALHY
VSDILHSIFSS	VSDILHSIF
YMEVVSLLK	YMEVVSLLK
ATELLTLLK	ATELLTLLK
YSSYGQSQNSY	SSYGSQNSY
LLDPKYGMFRY	LLDPKYGMF
FSDPFLKYL	FSDPFLKYL
DTDMDQAMERY	DMDQAMERY
VVDKDFLDKY	VVDKFLDKY
QTDQLVLIF	QTDQLVLIF
QMEPAAFQALY	QMEPAFQAL
ISETPIIGNKY	ETPIIGNKY
LLETIILGKQY	LLETIILGK
ISDLIRDSY	ISDLIRDSY
LSDSLFLEV	LSDSLFLEV
HTDDPLTWDY	HTDDLTWDY
LLEKNPDSKY	LLEKPDSKY
YLDKDLKQY	YLDKDLKQY
YGDKHITLY	YGDKHITLY
QLEALRFLAKY	LEALFLAKY
PTDGPPNSF	PTDGPPNSF
SLDDVKNHTY	SLDDKNHTY
MADPGNPDLY	MADPNPDLY
YTMKEVLFY	YTMKEVLFY
LSKLIDYIY	LSKLIDYIY
LIDMERQGDVY	DMERQGDVY
KVDAGKLHY	KVDAGKLHY
FIDLNYMV	FID-LNYMV
YTELLAQVY	YTELLAQVY
MTDEWFSEY	MTDEWFSEY
YSQGNAVHLY	YSQGAVHLY
STDKQMGY	STD-KQMGY
ETTFLVDKY	ETTFLVDKY
VGDLAELLY	VGDLAELLY
YTFGTKEPL	YTFGTKEPL
VSDFRKEFY	VSDFRKEFY
SADQVALVY	SADQVALVY
VEAMEILELY	AME-ILELY
FTDFVNDVK	FTDFVNDVK
ETDSGAGLKW	ETDSGAGLK
YTSDYFISY	YTSDYFISY
TEQSPKVQSRY	QSPKVQSRY
YLDNLPSASMY	YLDNLPSAS
FSEFTGVWKY	FSEFGVWKY
ASDFEIGHF	ASDFEIGHF
ASALEKFFY	ASALEKFFY
ATEVDSRWQEY	EVDSRWQEY
SSDSVGGFRY	SSDSGGFRY
SSELATEVHFY	ELATEVHFY
ETEVSFLDY	ETEVSFLDY
YLDDPDLK	YLD-DPDLK
ETFKEQGNAYY	ETFKQGNAY
LLDPSVFHV	LLDPSVFHV
YMERAAESY	YMERAAESY
LLDSTFSWY	LLDSTFSWY
LVDKNIMGY	LVDKNIMGY
LLEIQKELLDY	LLEIQKELL
GSDKINYTY	GSDKINYTY
YIEEFNKSWDY	IEEFKSWDY
LTDPEAAKY	LTDPEAAKY
YTMGYGESMY	YTMGGESMY
QAEAPRLAEY	QAEARLAEY
SADYIGGSHY	SADYGGSHY
IVDRFTSKY	IVDRFTSKY
TSDAVTFITY	TSDATFITY
ISSSMHSLY	ISSSMHSLY
STDPWIQMAY	STDPIQMAY
YSDKLWIFAGY	YSD-KLWIF
TTDGYLLRL	TTDGYLLRL
PTDPKVVVY	PTDPKVVVY
VLDFITHLY	VLDFITHLY
YVDLEHQGTY	YVDLHQGTY
NSDVSLLNY	NSDVSLLNY
VSEQELLRY	VSEQELLRY
ASEDLMTQKY	ASEDMTQKY
ASEVGSPPSY	ASEVSPPSY
QLDLDFLKY	QLDLDFLKY
QSDPAPLQH	QSDPAPLQH
VLDEAFQRY	VLDEAFQRY
SSAFSQLIY	SSAFSQLIY
LVDLRNYQY	LVDLRNYQY
YTDKIMTY	YTD-KIMTY
WTEVSYTFSDY	EVSYTFSDY
YSFLDKMSFY	FLD-KMSFY
LERVDGEKDTY	RVDGEKDTY
PMDTRQYLY	PMDTRQYLY
TTDLSFLDKY	TTDLFLDKY
SMDEKVELY	SMDEKVELY
DLDDAQRTLY	DLDDQRTLY
ISGMKVPWLY	ISGMVPWLY
NTSDMMGRMSY	TSDMGRMSY
YVDKIHIGNY	YVDKHIGNY
YQDPDATSLKY	DPDATSLKY
YTDTGLWGLY	YTDTLWGLY
YVEKVANGQY	YVEKANGQY
YSDVHNCSY	YSDVHNCSY
YSEYTGYAETY	YTG-YAETY
WTENIQGSIKY	TENIGSIKY
ASDKETYELRY	ASDKETYEL
AADSSPSELKY	DSSPSELKY
YTDKVVIGM	YTDKVVIGM
LTDIHGNVLQ	LTDIHGNVL
VSDFGLSRY	VSDFGLSRY
MAELGPLNKY	MAELPLNKY
YSEVYPGQQY	YSEVPGQQY
QLDTRVSEFY	QLDTVSEFY
HLDTLTEHY	HLDTLTEHY
MTSKDYYFDSY	TSKDYFDSY
YSNWRKGEDEY	NWRKGEDEY
QTEGPELEERY	TEGPLEERY
LAEWKSLEY	LAEWKSLEY
RTDLHSTWQY	RTDLSTWQY
SSDVLVFDY	SSDVLVFDY
LIEEGGLQHLY	IEEGLQHLY
LTDTFTAYYR	LTDTFTAYY
LADHTVHVLRY	LADHTVHVL
SIDDGLGSQY	SIDDLGSQY
YSEGYPGKRYY	YSEGPGKRY
ITDLFIDKF	ITDLFIDKF
YTFSSIEREEY	FSSIEREEY
VLDRLTFDY	VLDRLTFDY
ATEQAPLWAY	ATEQPLWAY
QSDIAALHHFY	QSDIALHHF
TDGPGNYKY	TDGPGNYKY
PSDLTVGQFY	PSDLVGQFY
LVDCSTEKY	LVDCSTEKY
YLEQLILKY	YLEQLILKY
TTDTYKAITY	TTDTKAITY
LLDPAQTGFY	LLDPQTGFY
NSALGNSPY	NSALGNSPY
GTDLSIFKY	GTDLSIFKY
YSEEECRQY	YSEEECRQY
VIEIIEKNFDY	IIE-KNFDY
LTEEVSEKKSY	LTEEVSEKK
VLDVQNGILY	VLDVNGILY
TTESFEDGLKY	ESFEDGLKY
ETDAQSITY	ETDAQSITY
LTDDGRVFLW	LTDDGRVFL
VTPYGEKIY	VTPYGEKIY
ILDQKASGVKY	LDQKSGVKY
SADEPMTTFY	SADEMTTFY
FGDTLHIHY	FGDTLHIHY
IVDGHLQLSY	IVDGLQLSY
AVLGKGHQY	AVLGKGHQY
FSDETNTENLY	FSDENTENL
LLDSSLEY	LLD-SSLEY
SVDYGQTHYY	SVDYQTHYY
FVDPYPVNKY	FVDPPVNKY
NSELSCQLY	NSELSCQLY
PEIDEKLLY	PEIDEKLLY
MTEDPETGTY	MTEDETGTY
YSETLLSYFY	YSETLSYFY
VGNVTGAQAY	VGNVGAQAY
HLDAQRLHY	HLDAQRLHY
SSESGHYYSY	SSESHYYSY
PSEIAIDDY	PSEIAIDDY
FIEEYVTAY	FIEEYVTAY
YVDDTQFVG	YVDDTQFVG
QTEATQEKY	QTEATQEKY
NLESSNSKY	NLESSNSKY
VDVTGPHLY	VDVTGPHLY
ASDPNSSIFL	ASDPSSIFL
VLEINSLKY	VLEINSLKY
GSDFYSMHY	GSDFYSMHY
TDKKTHLY	TDK-KTHLY
LIDSRPFVEY	LIDSPFVEY
KTQEVTLRY	KTQEVTLRY
MTEKFLFLY	MTEKFLFLY
LTEKLKLLY	LTEKLKLLY
VLDDASDEY	VLDDASDEY
YSSNLGNFNY	YSSNGNFNY
MLDHQPPQY	MLDHQPPQY
FLDTQLESTY	FLDTLESTY
LSEKPPYSKY	LSEKPYSKY
KTDESLTKY	KTDESLTKY
RLEDGRTLSDY	LEDGTLSDY
FTDPGMGNLT	FTDPMGNLT
LIDPNTLQV	LIDPNTLQV
LIDYDMVHY	LIDYDMVHY
EIDDQVEGLQY	IDDQEGLQY
LVDQRVAEY	LVDQRVAEY
QTENLGVVYY	QTENGVVYY
ITDRFPLKK	ITDRFPLKK
EMDNYEPGVY	EMDNEPGVY
VSSSIVDKY	VSSSIVDKY
ITIFEKQEY	ITIFEKQEY
KVDKATRDLLY	KVDKTRDLL
YVDQVLQLVY	YVDQLQLVY
PFSKKDWY	PFS-KKDWY
YTDHQNSSSYY	YTDHNSSSY
AWDIFQPLLF	AWDIQPLLF
YSMPAVNNSY	YSMPVNNSY
YTDPFSNQTV	YTDPSNQTV
STDPSVLGKY	STDPVLGKY
GSSFIQHYY	GSSFIQHYY
VLDYINGGEL	VLDYNGGEL
QSEIFQYDKY	QSEIQYDKY
NSESGYILFY	NSESYILFY
DSEVILHHEY	DSEVLHHEY
YLDFINHY	YLD-FINHY
RLDTPLYFSY	RLDTLYFSY
VLDYDTSHIY	VLDYTSHIY
FTDKLFYIY	FTDKLFYIY
NSLFLTDLY	NSLFLTDLY
LSDIGSGIRY	LSDISGIRY
LMEDEMKEYY	LMEDMKEYY
FLWPEAFLY	FLWPEAFLY
TLDVPDAFY	TLDVPDAFY
STESMDFLKY	STESDFLKY
AADPLTDLRY	AADPTDLRY
ALDDSDFFTS	ALDDDFFTS
YLQNWSHVLSY	LQNWHVLSY
ASDYEVAPPEY	ASDYAPPEY
VLDFGDLTY	VLDFGDLTY
WSDYSDNLKY	WSDYDNLKY
QTESQQIRYF	QTESQQIRY
LSEEAVLGFE	LSEEAVLGF
LLDPAQRTLY	LLDPQRTLY
KLDEQGLNY	KLDEQGLNY
QVDNSLITKY	QVDNLITKY
SESGHSQPGLY	ESGHQPGLY
ATDIQVLALT	ATDIQVLAL
ETCPGLEQY	ETCPGLEQY
FLDSTGSRLDY	FLDSTGSRL
DALDKIRY	DAL-DKIRY
SSEDLMKELY	SSEDMKELY
TDIKDSKAYY	DIKDSKAYY
PSSPQYGKY	PSSPQYGKY
LADIYRELY	LADIYRELY
LSDDVLMEKY	LSDDLMEKY
NLDPLTETY	NLDPLTETY
FLDHKTLYY	FLDHKTLYY
VSEIKSSYY	VSEIKSSYY
DTEPPPLLVY	DTEPPLLVY
LLDRYCVEY	LLDRYCVEY
LDQATRVAY	LDQATRVAY
YTEVLKTHGLL	YTEVKTHGL
LTEVDNYHFY	LTEVNYHFY
LLDDMNHCY	LLDDMNHCY
LTDRLASLY	LTDRLASLY
SSETDAQSITY	ETDAQSITY
EIDKNDHLY	EIDKNDHLY
LTDIDPDVAY	LTDIPDVAY
YLDKEDTFFY	YLDKDTFFY
DFAERHGY	DFA-ERHGY
FTEMMRALGY	FTEMRALGY
DSDMQTLVY	DSDMQTLVY
ILDNADVLSQY	NAD-VLSQY
SMDPLPVFLY	SMDPPVFLY
LDEADRDKERY	EADRDKERY
ITDSAGHILYS	ITDSGHILY
QLDSEDLHNY	QLDSDLHNY
VLEDPVHAVVY	LEDPHAVVY
ATDSYKVTHY	ATDSKVTHY
LVDLAPLGY	LVDLAPLGY
SSDTADFRDLY	DTADFRDLY
YADGESFLGY	YADGSFLGY
VSDNDIRKY	VSDNDIRKY
YLDGRLEPLY	YLDGLEPLY
PSLSKTDSY	PSLSKTDSY
FTETSKLQY	FTETSKLQY
TSDTLNNVGY	TSDTNNVGY
LSDSFSDLYSS	LSDSFSDLY
ISEKIKEPLYY	ISEKKEPLY
EPDGFSHFHLY	PDGFHFHLY
LLDTAQKNLY	LLDTQKNLY
FIDASRLVY	FIDASRLVY
ASELEYDMKKY	ELEYDMKKY
FINPKPITY	FINPKPITY
NTDPSIVMTY	NTDPIVMTY
FSDFLIGRY	FSDFLIGRY
QSDIVSTMEHY	QSDISTMEH
FTEEELKEY	FTEEELKEY
YTDRALRASY	YTDRLRASY
YLDYDDTRY	YLDYDDTRY
EIDNELFQ	EID-NELFQ
NTDFGDSGRLY	NTDFDSGRL
TTEAVHYLY	TTEAVHYLY
QLDERRLYY	QLDERRLYY
TDDPLTWDY	TDDPLTWDY
YVDDASWMRY	YVDDSWMRY
YTEIDWKAY	YTEIDWKAY
RTEIIEDLAFY	IIE-DLAFY
TVDEHVWFY	TVDEHVWFY
HSDTIQWLY	HSDTIQWLY
LVDDPLEY	LVD-DPLEY
HLSERADWQY	LSERADWQY
PTDVLKIVY	PTDVLKIVY
FLDSQNLSAY	FLDSNLSAY
LLDFQEFTLY	LLDFEFTLY
NFDEKLVEHF	FDEKLVEHF
FVDKPVAY	FVD-KPVAY
TTEIETLLL	TTEIETLLL
ETEEDKFLL	ETEEDKFLL
VLDRLTFD	VLD-RLTFD
FTDESYLELY	FTDEYLELY
SSDDIKETGY	SSDDKETGY
LSDVFPGVQY	LSDVPGVQY
ETFLTSPEELY	FLTSPEELY
VVDGLEKAIY	VVDGEKAIY
GLDDKLLHY	GLDDKLLHY
QTAEASHVSRY	TAEAHVSRY
MSDPYMPSY	MSDPYMPSY
MSAVVQELY	MSAVVQELY
VLDQGKITEY	VLDQKITEY
VISLLAFGVY	ISLLAFGVY
VSDPSSPQY	VSDPSSPQY
YTGTPDWLY	YTGTPDWLY
VTEIDKGSAY	VTEIKGSAY
TSDDPWLTAY	TSDDWLTAY
LLDAAHFCY	LLDAAHFCY
FVEPVGLNY	FVEPVGLNY
LLDTTEKYLY	LLDTEKYLY
FVDEIRSQY	FVDEIRSQY
ATESPDTGLYY	ATESDTGLY
FSDNDKLYL	FSDNDKLYL
SSDYFQAPSDY	SSDYAPSDY
NTDHQTQLLYQ	NTDHTQLLY
CSDYVKDIY	CSDYVKDIY
YTDYGGLIF	YTDYGGLIF
LSDHLINQGY	LSDHINQGY
ESLQISLEY	ESLQISLEY
KLDSSAQFGYY	KLDSAQFGY
LLDHLSIVY	LLDHLSIVY
YLFEPHSGEEY	LFEPSGEEY
KTDPLSLEGY	KTDPSLEGY
YADHLDWHY	YADHLDWHY
ISDILDWK	ISD-ILDWK
ISDPPDQMT	ISDPPDQMT
YSTDENFRY	YSTDENFRY
NLDPKITEY	NLDPKITEY
SADFSTSTLY	SADFTSTLY
LLDENKSLSTY	LLDENKSLS
NTDSPLRY	NTD-SPLRY
SPAGHHPHVLY	PAGHPHVLY
YLEDKVYLTGY	LEDKYLTGY
LLLPGNFESY	LLLPNFESY
YTELEAIMY	YTELEAIMY
YTAVVPLVY	YTAVVPLVY
TTDDPALLY	TTDDPALLY
LLDRPGEGSY	LLDRGEGSY
IADMGHLKY	IADMGHLKY
ATALFSFLY	ATALFSFLY
YTDEDMLKYM	YTDEDMLKY
TYDFIKENSF	TYDFKENSF
VVDIQGVGDLY	VVDIVGDLY
FMERDYTGY	FMERDYTGY
FTDQSNLIK	FTDQSNLIK
TMDVDLFSQY	TMDVLFSQY
ILDIPNQLY	ILDIPNQLY
NIDVSATAFY	NIDVATAFY
ATDAYAGFIIY	ATDAYAGFI
YAALHGEFY	YAALHGEFY
STDWHVVNY	STDWHVVNY
SDHSGFHY	SDH-SGFHY
FGEKNGSWLY	FGEKGSWLY
RTEEGPTLSY	RTEEPTLSY
LVDVMPWLQ	LVDVMPWLQ
FADFDGVLY	FADFDGVLY
RVDQSLLLY	RVDQSLLLY
YSADREDLY	YSADREDLY
SLDYAGYNNM	SLDYGYNNM
QVDKMASLY	QVDKMASLY
LLDTPVKTQY	LLDTVKTQY
LTDYDIRFYMY	LTDYDIRFY
LTDITKGVQY	LTDIKGVQY
YIDQEELNK	YIDQEELNK
VIESRYLQY	VIESRYLQY
VSDAVNVMVY	VSDANVMVY
YSDPYVKTY	YSDPYVKTY
FIDHDITSQLY	DHDITSQLY
VTETNVFFY	VTETNVFFY
LVDDGWILAY	LVDDWILAY
DTEFPNFKY	DTEFPNFKY
VLDIKGGTQY	VLDIGGTQY
LQDPFHGVY	LQDPFHGVY
STDVKGCSMY	STDVGCSMY
VLDELKHYY	VLDELKHYY
ASAVIGLLY	ASAVIGLLY
TDDLTTWLY	TDDLTTWLY
TLDQLEDSEY	TLDQEDSEY
FTEIGIHLNAY	FTEIIHLNA
VTALSHPLLY	VTALHPLLY
TSEQLDDILKY	QLD-DILKY
ATDIKITVY	ATDIKITVY
FTSDLQDKNEY	TSDLDKNEY
LSDYGPPSLGY	LSDYGPPSL
SSEGRNLPY	SSEGRNLPY
VLEENQEHY	VLEENQEHY
YSQRLGAGDLY	RLG-AGDLY
LTEDSENQRLA	LTEDENQRL
GTDGHVHLY	GTDGHVHLY
FTDRATLY	FTD-RATLY
VIDPESGNTLY	VIDPSGNTL
FSSDSGFSNY	SSDSGFSNY
RMDTLAHVLYY	RMDTAHVLY
RSDELTRHY	RSDELTRHY
LLSTYLERY	LLSTYLERY
NTDFGDEFYS	NTDFGDEFY
PDGFSHFHLY	PDGFHFHLY
LSEEGLLRLY	LSEELLRLY
STDFTSRDYY	STDFSRDYY
SSDNIMVQY	SSDNIMVQY
FTDVAEIPAW	FTDVEIPAW
HLDAELDAY	HLDAELDAY
MLDPHVQGGFY	MLDPVQGGF
LVERLQALY	LVERLQALY
VTTISAGLIY	TTISAGLIY
QTENSLHMGY	QTENLHMGY
DSDLQLDRISV	DSDLQLDRI
SLDSPSYVLY	SLDSSYVLY
ELDPAVMDQFY	ELDPVMDQF
YTDHLQSYVIY	YTD-HLQSY
LIVEPGPPGP	IVEPGPPGP
LVDPSRQPY	LVDPSRQPY
YSEGYPGQRYY	YSEGPGQRY
MTDKFAQFDEY	MTDKQFDEY
NVERRILDLY	NVERILDLY
TMDLDHSIGTQ	DLDHSIGTQ
RTELPQFVSY	RTELQFVSY
SSDYVEIHY	SSDYVEIHY
WSERLMTAY	WSERLMTAY
YMDYRGYS	YMD-YRGYS
AIEEVNLA	AIE-EVNLA
PTAVVPLRY	PTAVVPLRY
PTDYIRNGVLY	TDYINGVLY
FLDQNLQKY	FLDQNLQKY
ISEYAADIFY	ISEYADIFY
EVDPDTILK	EVDPDTILK
QVDPLSALK	QVDPLSALK
ITDVSWRLEY	ITDVWRLEY
GTDMEPSLY	GTDMEPSLY
FIDLNYMVY	FIDLNYMVY
WIDFDNDYKTL	WID-FDNDY
ESDIRYLLGY	ESDIYLLGY
VTEELGAQY	VTEELGAQY
VIDVNKVVEY	VIDVKVVEY
YSTGYGGYEEY	STGYGYEEY
YSDRSSGGSY	YSDRSGGSY
LLDFSYEQ	LLD-FSYEQ
YSNKEIFL	YSN-KEIFL
FTSTGSSGLY	FTSTSSGLY
RVDPNGFFLY	RVDPGFFLY
VLDIQNNLY	VLDIQNNLY
LTELMFEHY	LTELMFEHY
VSDSKQFTY	VSDSKQFTY
FSSSHEGFSY	FSSSEGFSY
ESDIKVNGY	ESDIKVNGY
LLDTTQKYLY	LLDTQKYLY
VDAVLGKGHQY	AVLGKGHQY
KVDYNRLGY	KVDYNRLGY
HSEYHTLLY	HSEYHTLLY
ASEAEMRLF	ASEAEMRLF
YVEEPEEEQLY	VEEPEEQLY
ATDVLHAVW	ATDVLHAVW
LLDKPVFSFY	LLDKVFSFY
FTETEKFCLIY	ETEKFCLIY
TMDPFVDRIGY	TMDPFVDRI
IADTPYHLY	IADTPYHLY
VSDRYRFLY	VSDRYRFLY
YSDVAKGILQY	YSDVKGILQ
FTAFANSHY	FTAFANSHY
LLDPDIFDY	LLDPDIFDY
AIDEDVLRY	AIDEDVLRY
YLDIPNPRY	YLDIPNPRY
FMETLNTLKY	FMETNTLKY
LTELLKQGQY	LTELKQGQY
HIDFAIQY	HID-FAIQY
VVDRIFSLY	VVDRIFSLY
KTDLDLDGY	KTDLDLDGY
YSDPSVLY	YSD-PSVLY
NVDGTHWLEY	NVDGHWLEY
RTELAIKLLEY	ELAIKLLEY
VVEQGPSFAFY	VVEQPSFAF
LLDSPGAATEY	LDSPAATEY
VTEGLVDVILY	VTEGDVILY
ITDYLIEEV	ITDYLIEEV
VSDLRVTHY	VSDLRVTHY
TTLNGNSVF	TTLNGNSVF
LVEKSQLGY	LVEKSQLGY
VLDSFLQGY	VLDSFLQGY
YLDDGHSFQY	YLDDHSFQY
IIDVVRSGYY	IIDVVRSGY
FLEEVTEYY	FLEEVTEYY
YSDVEPDYKY	YSDVPDYKY
LSDSFSDLY	LSDSFSDLY
NSDWHLVNY	NSDWHLVNY
SVEESVLLY	SVEESVLLY
VLDNPSPFY	VLDNPSPFY
ELDQRLFENY	ELDQLFENY
NLEEISNYY	NLEEISNYY
LSEKLREVY	LSEKLREVY
LIDQDARDLY	LIDQARDLY
IIDHHDNTY	IIDHHDNTY
ISEEDIKTVFY	EEDIKTVFY
ITGDVEVVL	ITGDVEVVL
TTDRCLLNNY	TTDRLLNNY
YSQDYQQFY	YSQDYQQFY
ASEFFRSGKY	ASEFRSGKY
IVDAEWNILY	IVDAWNILY
TDARFGHGSDY	DARFHGSDY
ESDVTSTLSY	ESDVSTLSY
YSDVHNCSYNY	YSDVHNCSY
YTMSYGDSLY	YTMSGDSLY
TSDSTVYDY	TSDSTVYDY
VVDDWIES	VVD-DWIES
RTEAAFSYY	RTEAAFSYY
FSEDISYFGY	FSEDSYFGY
AVEFRQTGY	AVEFRQTGY
VIDWHNYGY	VIDWHNYGY
MVEEPSMNLEW	MVEEPSMNL
ISDLAQHY	ISD-LAQHY
ITELLYKDGRY	ELLYKDGRY
TTDKKSLAY	TTDKKSLAY
YSEIKDFLSY	YSEIDFLSY
ITETDLRNHFY	ETDLRNHFY
LLDDENDSLRY	LDDEDSLRY
DKETYELRY	DKETYELRY
ALDRFSSFY	ALDRFSSFY
QLDRISVY	QLD-RISVY
FVESSTSVLRY	ESSTSVLRY
YTDQFSRNY	YTDQFSRNY
YAEFQNIRY	YAEFQNIRY
LTDYFLKDEY	LTDYLKDEY
FTDQQKLIY	FTDQQKLIY
YIDSKFEDY	YIDSKFEDY
SMDELKDVY	SMDELKDVY
ESDPAYQQY	ESDPAYQQY
ATDPVTGDLY	ATDPTGDLY
FTDKKTHLY	FTDKKTHLY
YSELTTLTSQY	YSELTTLTS
DSDEPLVYFY	DSDELVYFY
NTEVLLSHLSY	NTEVLLSHL
YTDTGLWGL	YTDTGLWGL
LSDIASLKALY	LSDILKALY
LLDTVELATY	LLDTELATY
YSEEGVYNVQY	YSEEGVYNV
AASYLDQISRY	YLD-QISRY
FVEVGRVAY	FVEVGRVAY
AVDPGLLGY	AVDPGLLGY
PEVQKKKY	PEV-QKKKY
SERTVLRY	SER-TVLRY
DSELSGPGPY	DSELGPGPY
DSERFFIRY	DSERFFIRY
EVDYDVDSY	EVDYDVDSY
LLDVRSKWEY	LLDVSKWEY
SMDEKVEL	SMD-EKVEL
SKGKIYPVGY	KGKIYPVGY
QIDPETFKDFY	DPETFKDFY
DSDFEYSTQS	DSDFYSTQS
LDKPVFSFY	LDKPVFSFY
LLDTAQRALY	LLDTQRALY
GTEPHPTPAY	GTEPPTPAY
LLVSCVVILY	LLVSVVILY
ETEVYEGALLY	EVYEGALLY
QTDNIIYVY	QTDNIIYVY
LTAINGLSY	LTAINGLSY
ASQKEVVLY	ASQKEVVLY
VSDPLSDLK	VSDPLSDLK
EIDNELFQF	EIDNELFQF
MADKNIQYY	MADKNIQYY
VSDELVQQY	VSDELVQQY
ISDLNELLK	ISDLNELLK
ISSSPTHSLY	SSSPTHSLY
GTEFGPGTAY	GTEFPGTAY
AYDLAKALL	AYDLAKALL
YTEHFMAAGY	YTEHMAAGY
VLDIFGFEDY	VLDIGFEDY
MTELYDYPKY	MTELDYPKY
YSYSYPQYGY	YSYSPQYGY
LSDDRSNILIY	SDDRNILIY
TDDKENERLAY	TDDKENERL
VMDDTISPY	VMDDTISPY
NTDHQTQLLY	NTDHTQLLY
ASETAGSGFLY	ETAGSGFLY
ISENKFLKY	ISENKFLKY
FSELDENLE	FSELDENLE
YSDVGRYIDHY	YSDVYIDHY
YSEDARQGEQY	SEDAQGEQY
VLDVISLVDKY	LDVILVDKY
WSEPFYQETY	WSEPYQETY
ATEIADIKSKY	IAD-IKSKY
TTDFIYQLY	TTDFIYQLY
LQERNPENWAY	QERNENWAY
LSQSGDFLR	LSQSGDFLR
NSDYLALLQA	NSDYLALLQ
KMDLDNNFY	KMDLDNNFY
GTDTGVVQY	GTDTGVVQY
QVDPLSALKY	QVDPSALKY
NVDPAGDSVSY	NVDPAGDSV
SSDNATLTHY	SSDNTLTHY
TSELLGEGAY	TSELGEGAY
SVDSQILYY	SVDSQILYY
YSDSISPFNK	YSDSSPFNK
YLDDPTNSWY	YLDDTNSWY
AVDPTSGQLY	AVDPSGQLY
FTDVNSILR	FTDVNSILR
MTDPEMVE	MTD-PEMVE
LTDGHPLTL	LTDGHPLTL
TGDPKQDLAY	TGDPQDLAY
YSDKEFAGSY	YSDKFAGSY
NVDLLGSLA	NVDLLGSLA
MTDPIRILV	MTDPIRILV
YTEEDAASY	YTEEDAASY
LSDPSGPKSY	LSDPGPKSY
YIDIPFQNKY	YIDIFQNKY
IIDAIFNSY	IIDAIFNSY
LTEMQVESSYY	LTEMVESSY
HIDVGGHMY	HIDVGGHMY
GVDEHAPISY	GVDEAPISY
SEYPPFSHRY	SEYPFSHRY
VLDETRTAY	VLDETRTAY
YSEDHIIGAY	YSEDIIGAY
ALDYLIGGLY	ALDYIGGLY
LLDPASFEYL	LLDPASFEY
LSDLLDWK	LSD-LLDWK
LTDFDIRFY	LTDFDIRFY
NEIEDTFRQF	EIEDTFRQF
DTDIVDEAIYY	DTDIDEAIY
AADIFYSRY	AADIFYSRY
YVNGQLKNKY	YVNGLKNKY
FTENDKEYQEY	FTE-NDKEY
FLEPLGLAY	FLEPLGLAY
YTEAEEFFVKY	EAEEFFVKY
YLDPVQRDLY	YLDPQRDLY
FSDNDKLY	FSD-NDKLY
VTEEPQRLFY	VTEEQRLFY
MGEIETLDDY	EIE-TLDDY
TSEQNPPYSY	TSEQPPYSY
WSDSPGQHY	WSDSPGQHY
NSYWVGEDSTY	YWVGEDSTY
HLDDQMTLLQY	LDDQTLLQY
AADPNAAWAAY	AADPAAWAA
YTEVLDLSY	YTEVLDLSY
STDPLDAGVDY	STDPLDAGV
ATESPLDFTKY	ESPLDFTKY
MLDHLKLHSY	MLDHKLHSY
ASEFPGAQHY	ASEFGAQHY
AIMELDDTLKY	ELD-DTLKY
RSDCLGEHLY	RSDCGEHLY
NMERDINSLY	NMERINSLY
FTEEDVKFY	FTEEDVKFY
SSNYTLPAFY	SSNYLPAFY
ETELISTTANY	ELISTTANY
KSDVHLNFY	KSDVHLNFY
ASFKAELSY	ASFKAELSY
LLDTNRYLYF	LLDTNRYLY
NTDHLTTVLY	NTDHTTVLY
ETVPRSGEVY	ETVPSGEVY
YLDTVPEVY	YLDTVPEVY
VLEEIPKNAAY	LEEIKNAAY
MDMSPLRPQNY	DMSPRPQNY
ISERPKESMY	ISERKESMY
LMELTMLDY	LMELTMLDY
FVETESVRY	FVETESVRY
GLEGDLAGRYY	GLEGLAGRY
ATDLAQHLY	ATDLAQHLY
LTEILDRY	LTE-ILDRY
ASDYFDQL	ASD-YFDQL
QADPDVLHNSY	DPDVLHNSY
QLDLAQKSLY	QLDLQKSLY
LTWDGFPLHY	LTWDFPLHY
RLEIEPEWAY	RLEIPEWAY
FLDNPDAFYY	FLDNDAFYY
VLDASNQISVY	VLDANQISV
YLESFLRSQFY	YLESLRSQF
ISDRLIGIY	ISDRLIGIY
TTDFPGNYSGY	TTD-FPGNY
LADIYREL	LAD-IYREL
LSELKPMSY	LSELKPMSY
QAEILLSNHY	QAEILSNHY
TLDLPHFDEY	TLDLHFDEY
ASEAEMRLFY	ASEAMRLFY
LIDNSGLRLFY	LIDNSGLRL
FTDAGFEHY	FTDAGFEHY
FTANDSGPRHY	ANDSGPRHY
TVDSEKFSTY	TVDSKFSTY
WVDSDQLLY	WVDSDQLLY
TVEDPVTVEY	TVEDVTVEY
ASEYDQIRY	ASEYDQIRY
VSDRVTVLY	VSDRVTVLY
KSDLSKPLSY	KSDLKPLSY
LLDISGVLY	LLDISGVLY
LTHWVYKKY	LTHWVYKKY
FSDLPLRV	FSD-LPLRV
ETHEELKKQY	ETHELKKQY
LSEQLLNNY	LSEQLLNNY
IMELDDTLKY	ELD-DTLKY
YSDLNTQRPYY	YSDLTQRPY
TSETIYNPDYY	TSETYNPDY
CIEPDNIKY	CIEPDNIKY
LIEPHYQPWSY	LIEPQPWSY
DHATTALLHY	ATT-ALLHY
TSDVNKLSSFY	TSDVKLSSF
LVEEVQLNFY	LVEEQLNFY
ESSDNYEHWLY	SSDNEHWLY
VTEELLTDNRY	TEELTDNRY
ATQLAADLLKY	QLAADLLKY
ILDDFREAY	ILDDFREAY
FLNDSYLK	FLN-DSYLK
RIDTRNELESY	DTRNELESY
TDDGKVGLY	TDDGKVGLY
QSANDFFSY	QSANDFFSY
DTDDFTRNAY	DTDDTRNAY
LLDELPMIY	LLDELPMIY
RVDPAKGLFY	RVDPKGLFY
NTEVLKNMGY	NTEVKNMGY
DTDGKCLEY	DTDGKCLEY
GVDPFTGNSAY	GVDPFTGNS
QSELQSQVRY	QSELSQVRY
LLQNDGFFL	LLQNDGFFL
LLDKGVYGLL	LLDKVYGLL
AADTVLATL	AADTVLATL
TDLSFLDKY	TDLSFLDKY
NTDFGDEFY	NTDFGDEFY
VTEGLTDVILY	LTD--VILY
FLDHKTLY	FLD-HKTLY
ESDAVECLNY	ESDAECLNY
YLDPSLNSLVY	YLDPLNSLV
STDKASMEVRY	STDKASMEV
LSELFHSRNYY	LSELHSRNY
VLDVIAPPY	VLDVIAPPY
TTDDWKDFLY	TTDDKDFLY
QMEAKLWGEEY	EAKLWGEEY
FMDHVLRY	FMD-HVLRY
KIEPPDTGLY	KIEPDTGLY
RTDERLNWIY	RTDELNWIY
LLDTELDLY	LLDTELDLY
ETEERMKCLYY	ETEEMKCLY
STDPEALHY	STDPEALHY
TSDELEDLRY	TSDEEDLRY
PSSPDSLHY	PSSPDSLHY
LADQIFAYY	LADQIFAYY
FIDVDDERWHY	DVDDERWHY
ETALLVDRY	ETALLVDRY
VTDMVRLAF	VTDMVRLAF
YSDMREANY	YSDMREANY
GTEEYLHPDMY	TEEYHPDMY
LADFRNYQY	LADFRNYQY
VTEITDDLHFY	ITD-DLHFY
VSDWIKNTEY	VSDWKNTEY
QSDLLGELKY	QSDLGELKY
NTISTGLLY	NTISTGLLY
NIDLVSKLLY	NIDLSKLLY
NSDFLVHFY	NSDFLVHFY
LSEPSSLQY	LSEPSSLQY
NTDAFSREY	NTDAFSREY
FLDDGHTFN	FLDDGHTFN
KTDDSLEKYLY	KTDDSLEKY
QTDHLFFKYY	QTDHLFFKY
RIDLIPSLY	RIDLIPSLY
VLDDKGNIIGY	LDDKNIIGY
KTDHFIFTY	KTDHFIFTY
NSSVHVIMY	NSSVHVIMY
WLDIGTSISHY	LDIGSISHY
YTDIPKIIY	YTDIPKIIY
YLDLRSFQMQY	YLDLRSFQM
MTDEIFHDVAY	TDEIHDVAY
SDSLVQKGY	SDSLVQKGY
ATDVAKGMHYL	ATDVKGMHY
DTELQGMNEY	DTELGMNEY
FSEPEYSAEY	FSEPYSAEY
FFDEANKQVF	FFDENKQVF
LLDGKPLPQY	LLDGPLPQY
VTEGVAQTSFY	VTEGAQTSF
VTMEDMNEY	VTMEDMNEY
HSEMYSLLIDT	HSEMYSLLI
AVDPTSGQL	AVDPTSGQL
FLEEDDKDLY	FLEEDKDLY
ETSRLYEDSGY	TSRLEDSGY
SDVHLNFY	SDV-HLNFY
DTDPFLFY	DTD-PFLFY
LSDIASALRY	LSDISALRY
RIDDNGWGCAY	IDDNWGCAY
IIDGKTLKY	IIDGKTLKY
FASGLIHRV	FASGLIHRV
LPSPQGSNY	LPSPQGSNY
ILDERHDNY	ILDERHDNY
FSDPGQPMSF	FSDPQPMSF
NVDESLLGY	NVDESLLGY
LTDIDPDVA	LTDIDPDVA
YIDDRGFRY	YIDDRGFRY
VLEHVPLLLY	VLEHPLLLY
LTDYDIRFYM	LTDYDIRFY
LLDGFLVNY	LLDGFLVNY
ELDPSNTKALY	ELDPTKALY
DMDKVLLKY	DMDKVLLKY
EIDDVYEKY	EIDDVYEKY
FVDPAQITM	FVDPAQITM
TLDPKWNQHY	TLDPWNQHY
YSDKYFDEHY	YSDKFDEHY
ISEQTGKELLY	ISEQGKELL
NTDFRYFIY	NTDFRYFIY
FTDTEGLPYSI	FTDTEGLPY
QLDFEEFVH	QLDFEEFVH
YSDVSGLLANY	YSDVSGLLA
QMDLLQEFY	QMDLLQEFY
LDPKYGMFRY	LDPKGMFRY
DIDIRPGLY	DIDIRPGLY
MSDPYLSSY	MSDPYLSSY
EVDPIGHVY	EVDPIGHVY
LLDQGQLNKY	LLDQQLNKY
LTDFDIRF	LTD-FDIRF
RLEDPDGKVLY	LEDPGKVLY
TTDLFGRDLSY	TTDLGRDLS
NMDEDLLVKY	NMDELLVKY
VLDINSIDNLY	VLDISIDNL
QTEKQRIIWGY	QTEKQRIIW
DLDHSIGTQY	DLDHIGTQY
TADHNLLLYE	TADHNLLLY
YTDTLGSIQQH	YTDTLGSIQ
TDLRNHFY	TDL-RNHFY
LDFLKGETGKY	FLKGETGKY
YIDAQFENY	YIDAQFENY
HTDIRSQLRY	HTDISQLRY
FTSMTRLYY	FTSMTRLYY
TTDENKVPY	TTDENKVPY
TDIKLGKY	TDI-KLGKY
MTELPAPLSYF	MTELAPLSY
ESESVTLQQYY	ESESTLQQY
QLDRRILAY	QLDRRILAY
LSEYSKFLSY	LSEYKFLSY
DTDDEIAKY	DTDDEIAKY
DSEQADIARML	DSEQDIARM
QIDGDFEDY	QIDGDFEDY
IDKNDHLY	IDK-NDHLY
LSDEAIKY	LSD-EAIKY
NSEEMKEAY	NSEEMKEAY
VLDIPSKY	VLD-IPSKY
IVDNPADFY	IVDNPADFY
DIDTRSEFY	DIDTRSEFY
RAEDAMRLYY	AEDAMRLYY
LSAEVVEGSRY	SAEVEGSRY
DMDNQIVVSDY	MDNQVVSDY
DSDINNRLVY	DSDINRLVY
WTEETVKQCLY	TEETKQCLY
LSLARGLDYY	LSLARGLDY
TDVERIKDTY	DVERIKDTY
VTDSGPTFNY	VTDSPTFNY
LVDGYNVHY	LVDGYNVHY
YYEERTCIL	YYEERTCIL
FTEDALGLRY	FTEDLGLRY
TSDDPWLTA	TSDDPWLTA
HTDAVWGLAY	HTDAWGLAY
ASDFITKMDY	ASDFTKMDY
LLDEMQRLLY	LLDEQRLLY
TDWGLLKGHTY	GLL-KGHTY
YADPYRQLQY	YADPRQLQY
DDGNKWLYK	DDGNKWLYK
SSDPASQLSY	SSDPSQLSY
PTEPYLSSQNY	PTEPYLSSQ
YLDPSPEVQK	YLDPPEVQK
FLDFVKQIY	FLDFVKQIY
MLDEAHERTLY	LDEAERTLY
SDHWAPIHY	SDHWAPIHY
TDRALRASY	TDRALRASY
VADVLVDGY	VADVLVDGY
AVDPLSGFVY	AVDPSGFVY
LEEKKQVEWDY	LEEKKQVEW
HSELRKLFY	HSELRKLFY
FTDMMPLLHNY	FTDMMPLLH
VTEKLDLNWY	VTEKDLNWY
VTAALMEYY	VTAALMEYY
YTELEAIMYA	YTELEAIMY
TDDSPKYNY	TDDSPKYNY
YTSYPMHDFY	YTSYMHDFY
YTEQLLRGLSY	YTEQLRGLS
NLDQSLAHY	NLDQSLAHY
RSDPTSYAGY	RSDPSYAGY
NLDIIQQEY	NLDIIQQEY
FTQDTQPHY	FTQDTQPHY
ASDALDKIRY	ASDADKIRY
YTDIVGLLL	YTDIVGLLL
ATDTASGTGLY	DTASGTGLY
LLDFSYEQY	LLDFSYEQY
QLEDLDSRVLY	LEDLSRVLY
FLESTFLK	FLE-STFLK
SVDEYQVGQLY	VDEYVGQLY
FLEDAIAVTRY	LEDAAVTRY
ESDGKSRWFY	ESDGSRWFY
ATETQPIVY	ATETQPIVY
FTDQATFYDK	FTD-QATFY
LMEEVQTLY	LMEEVQTLY
FTEKTTTYQY	FTEKTTYQY
SSDVRTVSY	SSDVRTVSY
LTERLGSGTY	LTERGSGTY
TVDPASLWEY	TVDPSLWEY
MEKETPLRY	MEKETPLRY
EVDSRWQEY	EVDSRWQEY
STDTSLKIFY	STDTLKIFY
MDDLNLHY	MDD-LNLHY
LLDENNVSSY	LLDENVSSY
FSDVDSPYY	FSDVDSPYY
ATDYHVRVY	ATDYHVRVY
VFDPVQKTLL	VFDPQKTLL
HSELLEDYY	HSELLEDYY
VTIKELDLY	VTIKELDLY
IVEAEAMNY	IVEAEAMNY
FLDDEEDQGIY	LDDEDQGIY
KTKMDNLKY	KTKMDNLKY
EVDSLKEALTY	DSLKEALTY
EMDPSGQLNEY	EMDPQLNEY
STDHIIRVY	STDHIIRVY
QTEPHSFRY	QTEPHSFRY
IVDESNVKY	IVDESNVKY
FVNGFNSPGSY	NGFNSPGSY
YTNRTGAVY	YTNRTGAVY
FLEEVTEY	FLE-EVTEY
FLDPAQRDLY	FLDPQRDLY
ELEDDFKEGY	ELEDFKEGY
YTSPNGQTTRY	TSPNQTTRY
LIDTLLDGY	LIDTLLDGY
HSDLHILDF	HSDLHILDF
FTDFVNDVKDY	FTDFVNDVK
DSDYHDENMYY	DSDYDENMY
FTDVHIRDMEY	FTDVHIRDM
YSDERYQCY	YSDERYQCY
NSDPGLAVGY	NSDPLAVGY
TPDIKSHY	TPD-IKSHY
MTEPIDEY	MTE-PIDEY
TSDFALSNRY	TSDFLSNRY
TTDELEKLLY	TTDEEKLLY
ISAITDSAEY	ISAIDSAEY
DVDDEYSMQY	VDDEYSMQY
NIDNPDLAKY	NIDNDLAKY
QVDFSPDMS	QVDFSPDMS
TSDTDGKCLEY	DTDGKCLEY
VVELDLLEY	VVELDLLEY
YVDDVFLR	YVD-DVFLR
LTEIMSMGY	LTEIMSMGY
LLDPAQKCLY	LLDPQKCLY
WSEITELLY	WSEITELLY
QVDPNYAYAY	QVDPYAYAY
KIEEGHIGVYY	KIEEHIGVY
DTCKVQTKQY	DTCKQTKQY
ITDDQFDFHTY	TDDQDFHTY
FSDVISFILY	FSDVSFILY
NSDPNINQFFK	NSDPNINQF
YTIYRPDEGY	YTIYPDEGY
FTDELMEQGL	FTDEMEQGL
IIDAGPKGNY	IIDAPKGNY
SSEQVVDLLRY	SSEQVVDLL
GTELLSLVY	GTELLSLVY
ILDDHISHY	ILDDHISHY
FSELAEDKENY	ELAEDKENY
ACDKSFHFY	ACDKSFHFY
LLDDTGLAY	LLDDTGLAY
DKSIDNKALY	SID-NKALY
SSEVVTVFQYY	SSEVTVFQY
FTNPLYGSY	FTNPLYGSY
EQRLRDEY	EQR-LRDEY
ISDRYYTALY	ISDRYTALY
LEDKHFQSY	LEDKHFQSY
QLEEATRLTSY	LEEARLTSY
TTDLELIKY	TTDLELIKY
AVEKGVPLY	AVEKGVPLY
ISEQTGKELL	ISEQGKELL
HIDLGIKY	HID-LGIKY
FMDQHPEMDF	FMDQPEMDF
VVVSGAPMSVY	VSGAPMSVY
YTFGTKEPLY	YTFGKEPLY
TTAILQQKY	TTAILQQKY
YIDEQFER	YID-EQFER
ATDLLKRLY	ATDLLKRLY
MSEEQQQHLY	MSEEQQHLY
YADYHTHFLY	YADYTHFLY
YIDENQDRY	YIDENQDRY
VLEQGPSSHYY	VLEQPSSHY
LIDVGTGYY	LIDVGTGYY
LSDISVVSNY	LSDIVVSNY
PTDAQGKGLMY	TDAQKGLMY
YSSPYPQEY	YSSPYPQEY
RCELTPLKY	RCELTPLKY
FSAGLIDDNDL	FSAGLIDDN
NTDGFLLPKY	NTDGLLPKY
QIEEAGWSY	QIEEAGWSY
DTETVLKTTGY	ETVLKTTGY
VTEIRQYFY	VTEIRQYFY
QMDVHDGRSWY	DVHDGRSWY
NVDSSYLESLY	DSSYLESLY
MLDDFRDNHY	LDDFRDNHY
RLDVLVNNAY	RLDVVNNAY
TVDARVYSY	TVDARVYSY
QSEEAVAAY	QSEEAVAAY
VLERNPNGWWY	VLERNPNGW
LADGNVKAFY	LADGVKAFY
VVDEDHELIY	VVDEHELIY
YVENRPKYAGY	YVE-NRPKY
YSDVMLENY	YSDVMLENY
ELDAVQREY	ELDAVQREY
ASSIFDPLRY	ASSIDPLRY
IVDSLTEM	IVD-SLTEM
VMAPRTLIL	VMAPRTLIL
LTFVPSAEDFY	FVPSAEDFY
KLSKLKKLY	KLSKLKKLY
VLDPYLLKY	VLDPYLLKY
VSDILHSLFS	VSDILHSLF
ADMGHLKY	ADM-GHLKY
TDINSERHY	TDINSERHY
YSDNSNISRY	YSDNNISRY
FVDEVHAVGLY	VDEVAVGLY
YIDEYRNDY	YIDEYRNDY
QTDHLFFKY	QTDHLFFKY
SDDHGASWRY	SDDHASWRY
SSESLNHLLY	SSESNHLLY
YVDPEREIY	YVDPEREIY
YSDLVTLTK	YSDLVTLTK
LLDSTQRQLY	LLDSQRQLY
RVDFQGMEY	RVDFQGMEY
NLDPEIDEKLL	NLDPIDEKL
VTDSGRTVILY	VTDSRTVIL
STDKAEYTFY	STDKEYTFY
ENVEKSKAY	ENVEKSKAY
LTEATPNRY	LTEATPNRY
DLDFPNLPY	DLDFPNLPY
MLLQWPLSY	MLLQWPLSY
LLEKEREDLY	LLEKREDLY
DLDYGFLSNY	DLDYFLSNY
LTDLVDDNY	LTDLVDDNY
TLDRQLNHY	TLDRQLNHY
EIEAREVADSY	IEARVADSY
YIDAQFEAY	YIDAQFEAY
KSNDTAASEY	KSNDAASEY
ILDNSPASY	ILDNSPASY
ASDPIHTFDLY	ASDPHTFDL
ETDETTVSQNY	TDETVSQNY
FVDEIQGRY	FVDEIQGRY
QTESIQQDY	QTESIQQDY
TDVHIRDMEY	DVHIRDMEY
FIESVPLLK	FIESVPLLK
LDDFGPHRY	LDDFGPHRY
GTELLSLV	GTE-LLSLV
ETERFRELLLY	ETERRELLL
VTEDEEAIQQY	TEDEAIQQY
FTELAEDKENY	ELAEDKENY
HLDPSQRALY	HLDPQRALY
LTLGRVEDFY	LTLGVEDFY
YLDSAQRNLY	YLDSQRNLY
FTDGSRIVF	FTDGSRIVF
RTDALQPPHEY	TDALPPHEY
FIDASRLV	FID-ASRLV
LTEHLKNSY	LTEHLKNSY
VVDQETDEELR	VVDQTDEEL
VTDSGPTFNYL	VTDSPTFNY
YSDFLNEDF	YSDFLNEDF
RVDELLEKY	RVDELLEKY
NTDYLRQRALY	NTDYRQRAL
VSERDVYL	VSE-RDVYL
LTLSILDRY	LTLSILDRY
GTDDGKVGLY	GTDDKVGLY
FTDPSNSERF	FTDPNSERF
LVEEITEEQYY	LVEETEEQY
TTEILRSML	TTEILRSML
YSGYIFDYDY	YSGYFDYDY
GTDAEHVQQFY	DAEHVQQFY
YSEYLYQEQY	YSEYYQEQY
LTDDGNKWLYK	LTDDNKWLY
DSELMDITKLY	LMD-ITKLY
SDIHDFEY	SDI-HDFEY
FTDIDGQVY	FTDIDGQVY
KSEMEMAHLY	KSEMMAHLY
QTDKLKELY	QTDKLKELY
VSDHISKVLY	VSDHSKVLY
TSEPKPFLY	TSEPKPFLY
FVDVAQSTY	FVDVAQSTY
ISDAPAPAY	ISDAPAPAY
FTDPHIITF	FTDPHIITF
GAGVGSMTKIY	GVGSMTKIY
LSDPVHLTV	LSDPVHLTV
ADHTVHVLRY	ADHTHVLRY
LTEEFRLNY	LTEEFRLNY
VTALCDIKQAY	LCD-IKQAY
TDGKHWWEY	TDGKHWWEY
LLDPKYGMFR	LLDPKYGMF
YTDYGGLIFN	YTDYGGLIF
SSDEEFAAAL	SSDEFAAAL
SSDTADFRDL	SSDTDFRDL
YTEFVPQIPGY	YTEFQIPGY
IIDSAGPLYY	IIDSGPLYY
FTDPGMGNLTY	FTDPMGNLT
EVDMDLDSY	EVDMDLDSY
LTDTSLTDSY	LTDTLTDSY
RTEFTVEVY	RTEFTVEVY
MVDIIETVY	MVDIIETVY
LTDVREQNKY	LTDVEQNKY
NSELIMDQY	NSELIMDQY
LSDHSIRSF	LSDHSIRSF
NSDVVSECSY	NSDVSECSY
YVDQNKFLCY	YVDQKFLCY
HTGMRALIY	HTGMRALIY
MTHNLLLNY	MTHNLLLNY
YVEKFALNY	YVEKFALNY
ATEMTLQRY	ATEMTLQRY
TLDTKPGLY	TLDTKPGLY
MTSLGSYNKY	MTSLSYNKY
RTEEALQLY	RTEEALQLY
FSDPLYLTMFK	FSDPLYLTM
YSHFQHLLY	YSHFQHLLY
TLDAGKFQIY	TLDAKFQIY
NSDELQELY	NSDELQELY
ALDEKIAKY	ALDEKIAKY
LTELPDWSY	LTELPDWSY
FLESTFLKY	FLESTFLKY
FLERIHLQEY	FLERHLQEY
STDSEVLTHY	STDSVLTHY
GDPGHWDRY	GDPGHWDRY
LIDADPYLKY	LIDAPYLKY
VTEVDTLALHY	EVDTLALHY
ASSLPTTMNY	ASSLTTMNY
YCDPVVLTY	YCDPVVLTY
NTQPIPILY	NTQPIPILY
YMALSSLQY	YMALSSLQY
YQDGAFHTEY	YQDGFHTEY
GSDITSITERY	ITS-ITERY
QSELVGQLY	QSELVGQLY
VLDFITHL	VLD-FITHL
YSESNKAIY	YSESNKAIY
YTEDSPGLKV	YTEDPGLKV
ESQLPEKVEY	ESQLEKVEY
RLDINTNTY	RLDINTNTY
VTDLAGNEY	VTDLAGNEY
LLDVLNKKY	LLDVLNKKY
LMERNNLSY	LMERNNLSY
LTEDKETLQY	LTEDETLQY
ATDQDVYDTLT	ATDQVYDTL
AIDQLHLEY	AIDQLHLEY
LAESALQLL	LAESALQLL
QSEEARRLLGY	SEEARLLGY
SSEYHYVGGFY	SSEYYVGGF
FTAERSSYY	FTAERSSYY
STELNHLGYQF	STELNHLGY
VSEVVKDAY	VSEVVKDAY
YGGLIFNSY	YGGLIFNSY
FSDLNLEAHMY	FSDLLEAHM
LTDEQLLY	LTD-EQLLY
FSDPSQQPPSY	FSDPQPPSY
YTIAALLSPY	YTIALLSPY
FTEHEVQIY	FTEHEVQIY
DSEEAEIIRKY	DSEEEIIRK
ILDVLKQGY	ILDVLKQGY
YTSPGTQKY	YTSPGTQKY
CSDTSGPTMRY	DTSGPTMRY
MSGYHTGYY	MSGYHTGYY
KLDSLLLFY	KLDSLLLFY
ASDYFDQLY	ASDYFDQLY
YSATKNGILY	YSATNGILY
NIEDKTGLWY	IEDKTGLWY
LTEQYNEQY	LTEQYNEQY
LLDLDEELRY	LLDLEELRY
VSERDVYLTY	VSERVYLTY
VSDFGMARY	VSDFGMARY
FSDPFTGGGRY	FSDPGGGRY
LFGRDLSY	LFG-RDLSY
LLDSTQRSLY	LLDSQRSLY
QLDMQSSWV	QLDMQSSWV
FTATRPGVYY	FTATRPGVY
FTDELMEQGLT	FTDEMEQGL
LSEAGDLTEKY	LSEADLTEK
MTSPLNLSY	MTSPLNLSY
NTDRNIDKYNY	NTDRNIDKY
HTDHHMFFDY	HTDHMFFDY
RLETELDGLRY	ETELDGLRY
LLDKAFESY	LLDKAFESY
FIEQNLTNYY	FIEQLTNYY
FSDNQLQEGK	FSDNLQEGK
HLDGQPFLR	HLDGQPFLR
VSDELRQWY	VSDELRQWY
LLDDAQRLL	LLDDAQRLL
MTDLTNNKVY	MTDLNNKVY
MVDFAMDV	MVD-FAMDV
LADFGFGNF	LADFGFGNF
QTDEYVANL	QTDEYVANL
ASAITGYLSY	ASAIGYLSY
ELERLTSLY	ELERLTSLY
RADQELLMY	RADQELLMY
ITDEQRQYY	ITDEQRQYY
LVDAFVEHRY	LVDAVEHRY
AGPVDEIMLLY	PVDEIMLLY
YMSGYHTGY	YMSGYHTGY
ALDVVNLVY	ALDVVNLVY
LTEKLKVLY	LTEKLKVLY
YTDLLRLF	YTD-LLRLF
VSAYGPGLVY	VSAYPGLVY
SSDVGHDEY	SSDVGHDEY
QTEERVQPEY	QTEEVQPEY
LTEKMVHIY	LTEKMVHIY
FIEESRQLLSY	IEESQLLSY
FSDGTHGGLRY	FSDGGGLRY
HTDPDYSAAY	HTDPYSAAY
TEKMVHIY	TEK-MVHIY
GIDVWEHAY	GIDVWEHAY
TSCADTLRY	TSCADTLRY
ETEESNLNMY	ETEENLNMY
YVEGVHQQY	YVEGVHQQY
TDILKEKY	TDI-LKEKY
QIEDTVLYGYY	IEDTLYGYY
HMDTCKYVHY	HMDTKYVHY
TSERTVLRY	TSERTVLRY
FVELPDNHSSL	FVELDNHSS
TSEDISQTSKY	SEDIQTSKY
HIDFGGTSVWY	HIDFGGTSV
DAELVAQWNY	DAELAQWNY
LLDNSYYEQY	LLDNYYEQY
ETDEKDFYL	ETDEKDFYL
EVDPTSHSY	EVDPTSHSY
STDGKHWWEY	STDGHWWEY
QLDFEEFVHY	QLDFEFVHY
FSESVKMSTY	FSESKMSTY
LTEMNYSKY	LTEMNYSKY
VTDISDLIRDS	VTDISDLIR
MIEIAGVKLLY	EIAGVKLLY
ATDWGDTQAY	ATDWDTQAY
LSEVNRTGTQY	LSEVTGTQY
YSDINQEHV	YSDINQEHV
FCESADLIQHY	ESADLIQHY
TWDERFSAL	TWDERFSAL
YLDEQRAVKY	YLDERAVKY
ASDMLQLE	ASD-MLQLE
IIDSAGPLY	IIDSAGPLY
VIDEVRTGTY	VIDERTGTY
KTERSDLEY	KTERSDLEY
HSDWKSGEY	HSDWKSGEY
ITDSAGHIL	ITDSAGHIL
DSYVNADHDLY	YVNADHDLY
YTEDEIYELSY	TEDEYELSY
AVEDWDLLNSY	VEDWLLNSY
FSEPFHLIVSY	FSEPFHLIV
RLDASRLLLY	RLDARLLLY
QLEAEQYFSTL	QLEAEQYFS
QTDINLPYL	QTDINLPYL
LSEETSVKSDY	LSEETSVKS
FSEVYKAFDLY	EVYKAFDLY
DLDLESPKSLY	DLESPKSLY
NIDQNGNVEY	NIDQGNVEY
DTDIWNQYL	DTDIWNQYL
LLDTHRGLLY	LLDTRGLLY
VMDKMQLTY	VMDKMQLTY
DLDFARQYY	DLDFARQYY
LSELFMSSFQ	LSELFMSSF
FSEEKIQYLVY	FSE-EKIQY
WTHDGKGMFY	THDGKGMFY
VTEIDQDKY	VTEIDQDKY
LLDEGAMLLYK	LLDEAMLLY
DSDGSVVQFL	DSDGVVQFL
LTELLERAAFY	LLE-RAAFY
ISWYDNEFGY	ISWYNEFGY
FINGYKNIY	FINGYKNIY
FLDSTGSRLD	FLDSTGSRL
LSDFESGLKY	LSDFSGLKY
SLDVGGPLR	SLDVGGPLR
ETEQTKFWDY	ETEQKFWDY
LTELHGGSIM	LTELHGGSI
GLDEPLLK	GLD-EPLLK
FVDDQQTFF	FVDDQQTFF
FSEFLINTY	FSEFLINTY
DEADRDKERY	EADRDKERY
MSSRSWLSY	MSSRSWLSY
TTEVTDFAGQY	VTD-FAGQY
LSDPDYINQY	LSDPYINQY
YTDLEKEAPWE	YTDLKEAPW
ATDPTIDLRY	ATDPIDLRY
FFDHSGTLVMD	FFDHSGTLV
WTELFRGLGMT	WTELRGLGM
ITYLMTLEDHY	YLMTLEDHY
DLDSRVLY	DLD-SRVLY
FTDPGQVAY	FTDPGQVAY
DTDMYNTPYTY	DTDMYNTPY
SSDKGRLCYY	SSDKGRLCY
TSEPKPFLYY	TSEPKPFLY
TTSHLMGMFY	TTSHMGMFY
IFDSKTVSI	IFDSKTVSI
ELDRFMHYY	ELDRFMHYY
FSDYPPLGRF	FSDYPLGRF
YIEDRPLHMLY	IEDRLHMLY
STDIKDSKAYY	STDIDSKAY
TTDENKVPYF	TTDENKVPY
MTEEEQIAY	MTEEEQIAY
QTDSKMLLGMY	QTD-SKMLL
ASDPYVKLSLY	ASDPVKLSL
QVDEQIDHY	QVDEQIDHY
ESEEYQERY	ESEEYQERY
ILDTAGQEEY	ILDTGQEEY
LMDAERAWSY	LMDARAWSY
TTDFIFNL	TTD-FIFNL
LTEYLSTHY	LTEYLSTHY
LLDPSQKNLY	LLDPQKNLY
LTDRGGPLGY	LTDRGPLGY
FLDYEAGHLS	FLDYEAGHL
YTFPNGAKY	YTFPNGAKY
ISESIKELQF	ISESKELQF
STSGHVELY	STSGHVELY
FLEDHGLLV	FLEDHGLLV
YINGLLTGY	YINGLLTGY
QTDQMVFNAY	QTDQVFNAY
LIEEALQKY	LIEEALQKY
IMDDPAGNSY	IMDDAGNSY
YTEDHVFSSDY	TEDHFSSDY
LVDVSQPAY	LVDVSQPAY
LSDLLDWKY	LSDLLDWKY
FVDMGHSAY	FVDMGHSAY
ALDQFQEKY	ALDQFQEKY
EVDSVVAAEY	EVDSVAAEY
RLDHKFDLMY	RLDHFDLMY
TSDVDLDKY	TSDVDLDKY
SAFRKLDELY	SAFRLDELY
LTEITKGWLY	LTEIKGWLY
ASELKALGY	ASELKALGY
TTEFLYNLY	TTEFLYNLY
NTDFWKTLRY	NTDFKTLRY
ATEEAPYWTY	ATEEPYWTY
ALDENGNLWY	ALDEGNLWY
NFDTKDPLIL	NFDTDPLIL
ATDNLISDTSY	ATDNISDTS
TDNPRELQVKY	TDNPRELQV
LSDLKKTIY	LSDLKKTIY
LLEEHTEEY	LLEEHTEEY
TDSYKVTHY	TDSYKVTHY
MSEDKPQDY	MSEDKPQDY
WIDFDNDYKT	WID-FDNDY
LSELFMSSFQS	LSELFMSSF
YSQADALKY	YSQADALKY
ITQGTPLKY	ITQGTPLKY
LSDIDSRYI	LSDIDSRYI
KTEVNSGFFY	KTEVSGFFY
IVDHIHFQY	IVDHIHFQY
FFENHPYF	FFE-NHPYF
LVDIVKGTNSY	LVDIKGTNS
VTEARLSFY	VTEARLSFY
HVDLDSGLRY	HVDLSGLRY
ELDPLTGEWH	ELDPLTGEW
ASEYESEAKY	ASEYSEAKY
ITDEDNSIAAM	ITDEDNSIA
LSGFELELY	LSGFELELY
HVDEQVFLY	HVDEQVFLY
SLDYNVVHSLY	SLDYVVHSL
FSDTETEKHSY	DTETEKHSY
NTDLVFGQY	NTDLVFGQY
TIDINKDPY	TIDINKDPY
LVDTAGQDEY	LVDTGQDEY
TQDFKEKDGY	TQDFEKDGY
ATESVSLYYY	ATESVSLYY
DELEIKAYY	DELEIKAYY
FTATRPGVY	FTATRPGVY
ETEKDFSRY	ETEKDFSRY
EVDERPTEQY	EVDEPTEQY
ALETLGFLNHY	ETLGFLNHY
MVESLVGWGY	MVESVGWGY
ETEKFWMFY	ETEKFWMFY
IDEVRTGTY	IDEVRTGTY
QTDINLPY	QTD-INLPY
YLDKEDTF	YLD-KEDTF
RVDGRMLHY	RVDGRMLHY
VYDHLKDYL	VYDHLKDYL
LLDMPPVSY	LLDMPPVSY
ISDPPDQMTY	ISDPDQMTY
FSCLNQKSNLY	CLNQKSNLY
YIDQGRNPQLY	YIDQRNPQL
KTDAFVPVY	KTDAFVPVY
SSEELPLYY	SSEELPLYY
YLDVQRCLEY	YLDVRCLEY
NSDTNIRWNNY	DTNIRWNNY
LADSFRHLY	LADSFRHLY
YIEKLFERY	YIEKLFERY
STDMDKVLLKY	DMDKVLLKY
IVDLFQGQY	IVDLFQGQY
FLDEVMKKY	FLDEVMKKY
TEPPPLLVY	TEPPPLLVY
LLDPMGGIVM	LLDPMGGIV
FLDYEAGHLSF	FLDYEAGHL
NTDNKFISY	NTDNKFISY
FLDSRHLDHY	FLDSHLDHY
NIDILVNQY	NIDILVNQY
YWEERIFYL	YWEERIFYL
ATMDVDLFSQY	TMDVLFSQY
FLDANVKESY	FLDAVKESY
YTEPNYWIRY	YTEPYWIRY
ATDRFLPEGY	ATDRLPEGY
SMEDVNIAAEL	MEDVIAAEL
ATEPVIAF	ATE-PVIAF
STEIGKLLSSY	STEIGKLLS
TIDFDFLR	TID-FDFLR
STDGEVETQVY	STDGVETQV
KEIDEIHSKY	EIDEIHSKY
GSELYTQEY	GSELYTQEY
TFNLEGSLIY	NLE-GSLIY
NVDPEKAVQLY	NVDPKAVQL
YTVSREDGSFS	YTVSEDGSF
VVEQLKDWLY	VVEQKDWLY
AVDVEGMKTQY	DVEGMKTQY
IVDSLTEMY	IVDSLTEMY
LLETSADNQHY	ETSADNQHY
EASTKNIFGRY	ASTKIFGRY
ETEEDKFLLLY	EEDKFLLLY
STDSGLGLGCY	STD-SGLGL
SSDNYEHWLYY	SSDNEHWLY
DVDIRKDLY	DVDIRKDLY
FIEEKSSFEY	FIEESSFEY
LDQKASGVKY	LDQKSGVKY
PTDGDSHAVTY	DGDSHAVTY
FMDVSNPFY	FMDVSNPFY
LLDPRFEGY	LLDPRFEGY
VSSDDIKETGY	SSDDKETGY
AADVLVARY	AADVLVARY
PSYGGQQQSY	PSYGQQQSY
ILEVDLKNGY	ILEVLKNGY
GVDLTGPQLY	GVDLGPQLY
ASEDSVLLY	ASEDSVLLY
SVEDYKALQKY	VEDYALQKY
YTSHEDIGY	YTSHEDIGY
MSDVVKGVY	MSDVVKGVY
QTWAGSHSMRY	TWAGHSMRY
WTEYGLTFTEK	WTE-YGLTF
YTAHVGYSMY	YTAHGYSMY
SDSKIQKY	SDS-KIQKY
DSDLLDSQVQY	LLD-SQVQY
VSDPTSGLDF	VSDPSGLDF
FLEEKMAYQEY	FLE-EKMAY
QTDVERIKDTY	DVERIKDTY
LTDPMFRGIY	LTDPFRGIY
ITDQGIEFY	ITDQGIEFY
FVDKPVSPY	FVDKPVSPY
YADPVNAHY	YADPVNAHY
YTEHSVQEKNW	YTEHSVQEK
ALGEEWKGY	ALGEEWKGY
RSMGFIGHY	RSMGFIGHY
RSEEPETPAAY	SEEPTPAAY
WTDGLFTHV	WTDGLFTHV
STEVDGERY	STEVDGERY
YMELYTHVYNY	YMELYTHVY
LIDQDARDL	LIDQDARDL
VGDHQFLLY	VGDHQFLLY
NTDSPLRYV	NTDSPLRYV
DPEDPYKGYRY	PEDPKGYRY
SLEDFLYHEGY	LEDFYHEGY
MLDGILSKY	MLDGILSKY
NLDFLDLGY	NLDFLDLGY
ALDLVAAKCYY	ALDLAAKCY
LTALQGLYY	LTALQGLYY
NLEELPLNEY	NLEEPLNEY
SLDGDLAGRYY	SLDGLAGRY
DTGFMRGHGTY	FMR-GHGTY
MVDPLLTKY	MVDPLLTKY
STDHIPIL	STD-HIPIL
EMDWSDKMEAY	WSD-KMEAY
KTELQFSDYY	KTELFSDYY
QSDYYASYY	QSDYYASYY
VADVHQYF	VAD-VHQYF
MTELYDYPK	MTELYDYPK
ASETGFLTY	ASETGFLTY
FLDASGAKLDY	FLDASGAKL
YSEVLTDTRGL	YSEVLTDTR
FVEENLQHWSY	VEENQHWSY
NLDFQMEQY	NLDFQMEQY
YLDLKSDEWE	YLDLKSDEW
VDPFSKKDWY	VDPFKKDWY
PTDATLNRLLY	TDATNRLLY
QTAAVEFLLY	QTAAEFLLY
LEDGRTLSDY	LEDGTLSDY
VLEYNAIGGKY	VLEYIGGKY
LSAMDWHLY	LSAMDWHLY
TVDNVQPLLY	TVDNQPLLY
TVEEYRIAQLY	VEEYIAQLY
IIDYLTDHY	IIDYLTDHY
LVDPSVYGY	LVDPSVYGY
TSDDVKEQI	TSDDVKEQI
VLTDTRGLY	VLTDTRGLY
ISEDFVGHLY	ISEDVGHLY
TTEFLYNL	TTE-FLYNL
TVDVLKEAY	TVDVLKEAY
FSEPHARFY	FSEPHARFY
HYDEKTWFV	HYDEKTWFV
FSEPRAVFY	FSEPRAVFY
STMEGGTLKY	TMEGGTLKY
LSDDHGASWRY	SDDHASWRY
YTDSSYEEKKY	YTDSYEEKK
DFLTAIKNRY	LTA-IKNRY
ATEIERLITWY	EIERLITWY
DVDPETLSY	DVDPETLSY
DTEVEMKEIY	DTEVMKEIY
YSAWDKQFY	YSAWDKQFY
LSEEGLLVY	LSEEGLLVY
QVDDELEIKAY	VDDEEIKAY
VIDVDSGNSY	VIDVSGNSY
ATDLDVANFY	ATDLVANFY
AIDSFRHMY	AIDSFRHMY
NIDNFLNRY	NIDNFLNRY
STDVSQPPHVY	STDVQPPHV
HTELPRGDHY	HTELRGDHY
SLKLQSVEY	SLKLQSVEY
LSDSGVTQRY	LSDSVTQRY
FLDDGHTFNY	FLDDHTFNY
VSDIVGPDGL	VSDIGPDGL
EVDSGRQIEY	EVDSRQIEY
FTEAGLKELS	FTEALKELS
SSELFTLTY	SSELFTLTY
AVDLMTHNYY	AVDLMTHNY
TTESWSNYY	TTESWSNYY
ATELQSMM	ATE-LQSMM
STEERTFQY	STEERTFQY
VADLHLYLY	VADLHLYLY
DSDDRLYEAY	DSDDLYEAY
ISDPFYGPW	ISDPFYGPW
DTDEYVLKY	DTDEYVLKY
DTDSQRLAY	DTDSQRLAY
TIDFDFLRY	TIDFDFLRY
EVNKTGTQY	EVNKTGTQY
YTMSYGDSL	YTMSYGDSL
YSDQFLNMV	YSDQFLNMV
VIDEIRNGPY	VIDERNGPY
QLDPTQRILY	QLDPQRILY
DTFKLHCY	DTF-KLHCY
SADVPLVVEY	SADVLVVEY
LTDIKLGKY	LTDIKLGKY
SSDVIRLIMQY	SSDVIRLIM
ETDEKDFYLYY	ETDEDFYLY
NMEANVKSQY	NMEAVKSQY
QSALVSNLY	QSALVSNLY
SADPGNLKY	SADPGNLKY
YSQSQGDSEYY	YSQSGDSEY
IIDVVRSGY	IIDVVRSGY
GTDDGRLLEY	GTDDRLLEY
FSDLKSPLHY	FSDLSPLHY
FSENEKNAAY	FSENKNAAY
TSDMLAAASKY	TSDMAASKY
TDLELIKY	TDL-ELIKY
LLDIVARSLY	LLDIARSLY
EIDNELFQFY	EIDNLFQFY
TSEQTAEAMHY	QTA-EAMHY
VSSTSEIGTRY	STSEIGTRY
VSDRDRNLMVY	VSDRDRNLM
LLDYIGSQAQ	LLDYIGSQA
LLDFADVTY	LLDFADVTY
IVDEVNGLISM	IVDEVNGLI
LTMEFVEEY	LTMEFVEEY
GLMHSIGLGY	LMHSIGLGY
NTDPYKRAVY	NTDPKRAVY
QSDVQPVGHDY	DVQPVGHDY
FSENVEKSKAY	FSENEKSKA
TEVVDKEKNLY	VVDKEKNLY
VIDPVAPRY	VIDPVAPRY
YLSERYAELY	LSERYAELY
FTDEEGYGRYL	FTDEGYGRY
FIDRDGPLFRY	FIDRDGPLF
FSDVMEDL	FSD-VMEDL
TEYHDRDEQFY	YHDRDEQFY
MVDPFHTLF	MVDPFHTLF
FQDAHFEFY	FQDAHFEFY
YSAPQHDYY	YSAPQHDYY
ALEAQTSRY	ALEAQTSRY
ISEDTSKLY	ISEDTSKLY
LSDSPSNSSY	LSDSSNSSY
VSDPVGVL	VSD-PVGVL
QLDAELLRY	QLDAELLRY
ATDIQVLALTY	ATDIQVLAL
ASTKNIFGRY	ASTKIFGRY
ISDVGFGMLK	ISDVFGMLK
FTAKSPLMY	FTAKSPLMY
TDGAILGKLY	TDGALGKLY
EMDSERLQY	EMDSERLQY
LEGERDAIRY	EGERDAIRY
LTNPDELLSY	LTNPELLSY
QSEIISNQY	QSEIISNQY
VVDNLQHLY	VVDNLQHLY
DVDKTGASYY	DVDKGASYY
YSEDRIGLAD	YSEDRIGLA
LLDPGQRNIY	LLDPQRNIY
VMDELGYLY	VMDELGYLY
FTEPNRHFY	FTEPNRHFY
VTETVHTSY	VTETVHTSY
FSDIHLLAMMY	FSDIHLLAM
FSETALETTY	FSETLETTY
QSEDGSHTIQI	QSEDGSHTI
LSEDVKSYY	LSEDVKSYY
FSEEDFRLY	FSEEDFRLY
TTATGDTALTY	ATGDTALTY
VTEEIFLEY	VTEEIFLEY
YLDNVIGHSY	YLDNIGHSY
ILTLLRFSY	ILTLLRFSY
TDLHEHPLY	TDLHEHPLY
FLDPRPLTV	FLDPRPLTV
DTDFYILDKY	DTDFILDKY
YSVYRTVIEYY	YSVYTVIEY
SLDYAGYNNMY	SLDYGYNNM
ISEPWTQRSFY	ISEPWTQRS
FQNALLVRY	FQNALLVRY
YSDSFPME	YSD-SFPME
DTDLYDEFGNY	DTD-LYDEF
YVDVMLENY	YVDVMLENY
PTDATLNRLL	PTDATLNRL
VTESTKQITY	VTESKQITY
ITEIIRYSFY	ITEIRYSFY
DSDPLQDHNMY	DSDPLQDHN
TERAVFRY	TER-AVFRY
SSEDKRKTY	SSEDKRKTY
TSDKPLQGDGY	TSDKQGDGY
DARFGHGSDY	DARFHGSDY
DTDTLLSDTKY	DTDTLSDTK
YTDLTPLSK	YTDLTPLSK
GIDSRYFDLY	GIDSYFDLY
VLDERSALY	VLDERSALY
EIDILRTLY	EIDILRTLY
MVDFAMDVY	MVDFAMDVY
TDMEHTGHY	TDMEHTGHY
LADELITVY	LADELITVY
FTEEQAVLY	FTEEQAVLY
ELDKTPWQY	ELDKTPWQY
VTELHVISY	VTELHVISY
LSEAFHEEY	LSEAFHEEY
YLDEDTIYH	YLDEDTIYH
ESDINSVRY	ESDINSVRY
YLDSSSEHGFQ	YLDSSEHGF
DSDPFSSFY	DSDPFSSFY
TMDVNHPIY	TMDVNHPIY
FSDIHAGELYF	FSDIAGELY
LSDLGRLS	LSD-LGRLS
HLEEGKDLEY	HLEEKDLEY
LMEEVQTLYY	LMEEQTLYY
FSQLENNTNHY	QLENNTNHY
NVDEHSVMTY	NVDESVMTY
ALDSHILDY	ALDSHILDY
LVDADGPLA	LVDADGPLA
MSEKLGVMTY	MSEKGVMTY
GSDPYVRMY	GSDPYVRMY
MVEEPSMNL	MVEEPSMNL
VWDIFQPLLF	VWDIQPLLF
VMETKSMLY	VMETKSMLY
NIDGFLGPWAK	NIDGFLGPW
VTEQLDAGVRY	QLD-AGVRY
LSDYIEKEVKY	YIE-KEVKY
STEVGEMAKQY	STEVGEMAK
LTDADAMKY	LTDADAMKY
LDDHISHY	LDD-HISHY
LADWVSGKISF	LADWVSGKI
SSEITSLY	SSE-ITSLY
VMEKSFLEY	VMEKSFLEY
KTDSDSDLQLY	DSDSDLQLY
LLDPAQKIL	LLDPAQKIL
FTNLESAFY	FTNLESAFY
STESELQQSY	STESLQQSY
QTENLGVVY	QTENLGVVY
LSDSQMKSY	LSDSQMKSY
VTDFQDSVFND	VTDFQDSVF
CVDGTFHKY	CVDGTFHKY
FLDTNETPYF	FLDTNETPY
YLDESKQLY	YLDESKQLY
ITDTTRDVY	ITDTTRDVY
TTDCLQILAY	TTDCQILAY
NSDTLLFHY	NSDTLLFHY
HSEDYSKVPKY	SEDYKVPKY
TTDDWKDFL	TTDDWKDFL
YTAQPTQGYA	YTAQPTQGY
YTTPSGEVRY	YTTPGEVRY
ITDAYLDQY	ITDAYLDQY
TADVVKVAY	TADVVKVAY
HLDIAQQNLY	HLDIQQNLY
WMDEYKQYYY	WMDEYKQYY
ITDHGSLIY	ITDHGSLIY
YTDKIDRY	YTD-KIDRY
LLDLFMDRY	LLDLFMDRY
QSDEAVKYY	QSDEAVKYY
FTDKSAEDY	FTDKSAEDY
TSDSYGFKEEY	TSDSFKEEY
QLDISDPYKVY	ISD-PYKVY
YIDQQFEQY	YIDQQFEQY
ETEYSFLDY	ETEYSFLDY
FLDGTFSKY	FLDGTFSKY
YSGLLLPDAQY	GLLLPDAQY
YTDFDGTRV	YTDFDGTRV
FLDPASAGIG	FLDPASAGI
WVDDQRPENY	VDDQRPENY
NLDQATRVAY	NLDQTRVAY
VVFEGNHYFY	VVFENHYFY
YSEQFLKQMY	YSEQLKQMY
TDLTRDIY	TDL-TRDIY
ALDTKIGRY	ALDTKIGRY
YVDEEGNLVK	YVDEEGNLV
LSDPAAGAY	LSDPAAGAY
LSDFLVKTY	LSDFLVKTY
NLDKNTVGY	NLDKNTVGY
LTDFIKTGHY	LTDFKTGHY
MSDAEQYRSY	MSDAQYRSY
FTEHEIQEWY	FTEHIQEWY
NVEKKIDKY	NVEKKIDKY
FIDIFTSNTY	FIDITSNTY
ALDLGTFTGY	ALDLTFTGY
LSDPSITKLGY	LSDPSITKL
FTEEELARY	FTEEELARY
LTELTDEQAKY	LTD-EQAKY
TDSSYEEKKY	DSSYEEKKY
TEDPWKTNY	TEDPWKTNY
GTEIANTLY	GTEIANTLY
IVDEVNGLIS	IVDEVNGLI
VMDVVVKSV	VMDVVVKSV
WLDTFVSSY	WLDTFVSSY
KLDSSAQFGY	KLDSAQFGY
YVDDPYQKY	YVDDPYQKY
FLDPNNYSANY	FLDPNNYSA
ATEKLKSLGY	ATEKKSLGY
YSSDLIQHY	YSSDLIQHY
ETDTFKLHCY	ETDTKLHCY
NIEAAKDLLY	NIEAKDLLY
SEMKIKEEGY	EMKIKEEGY
DGSHTIQIMY	GSHTIQIMY
LLDIRSEY	LLD-IRSEY
STDLQDYTY	STDLQDYTY
VLEEAEAQHLY	LEEAAQHLY
YTQQATQSY	YTQQATQSY
ISDGKEYLF	ISDGKEYLF
FTDPRTMGY	FTDPRTMGY
LEIVSEKSRY	LEIVEKSRY
ISDAAQLPHDY	ISDALPHDY
FIDNIPYSMEY	IDNIYSMEY
YSSGLVRLY	YSSGLVRLY
ATEVLMWFY	ATEVLMWFY
QLDHLSLYY	QLDHLSLYY
ETDVVRAVY	ETDVVRAVY
YTDTGFLAEY	YTDTFLAEY
VTDKSMVDKY	VTDKMVDKY
IEDRPLHMLY	IEDRLHMLY
PIDDHFTYSRY	IDDHTYSRY
ETAMVTADSKY	AMVTADSKY
YTDIAIGLLK	YTDIIGLLK
LSDPQERAWY	LSDPERAWY
LSEDVRFYY	LSEDVRFYY
MTEKFLFL	MTE-KFLFL
TLAVAAGLYY	TLAVAGLYY
KTDLDLQQY	KTDLDLQQY
DAVLGKGHQY	AVLGKGHQY
LDSRVLYY	LDS-RVLYY
ITEEQREYY	ITEEQREYY
VVDKIDYY	VVD-KIDYY
ATAAALTYGLY	AAALTYGLY
NTSPLLGDARF	NTSPLGDAR
ITDPEILESRY	ITDPEILES
ASEAFVQKY	ASEAFVQKY
HTDYYAKYDRY	HTD-YYAKY
KSDMNTVLNY	KSDMTVLNY
YSDGYGRVY	YSDGYGRVY
ALDDYEHHY	ALDDYEHHY
NLEELSEMRY	NLEESEMRY
SDHISKVLY	SDHISKVLY
YTDKYFNKL	YTDKYFNKL
NVDSSYLESL	NVDSYLESL
FSDSAAIEKY	FSDSAIEKY
LLDRLYEHY	LLDRLYEHY
TSETPDYLLKY	ETPDYLLKY
TVDLNPQYY	TVDLNPQYY
VTDTGALYL	VTDTGALYL
IMDSTEAQLRY	STE-AQLRY
VTDHLRLFTLY	VTDHRLFTL
LLDTLSPAY	LLDTLSPAY
YTDAPPAYSEL	YTD-APPAY
VTEEEGSANMY	TEEESANMY
STESSVAVY	STESSVAVY
VIDVQTETVY	VIDVTETVY
YQDPDATSLK	YQDPATSLK
TVDRVVLLY	TVDRVVLLY
TTDCLQLLAY	TTDCQLLAY
SSDRTITEY	SSDRTITEY
LTDSTPRDLDY	LTDSTPRDL
VMDVKPVDY	VMDVKPVDY
GLDQPLLK	GLD-QPLLK
MSEQQHTFY	MSEQQHTFY
VLDQMNKYLY	VLDQNKYLY
TSDQKPDVMY	TSDQPDVMY
YSETVELIRY	YSETELIRY
LTDDHVQFLIY	TDDHQFLIY
VADKVHLMY	VADKVHLMY
LSDTKYLEMIY	LSDTKYLEM
LTALGKLLY	LTALGKLLY
RTDAILLGHY	RTDALLGHY
LSDIEWHIY	LSDIEWHIY
YADLSLKY	YAD-LSLKY
VLDSLLVQY	VLDSLLVQY
ETDNAGLKEY	ETDNGLKEY
VSMDVSLAY	VSMDVSLAY
ETDRGMSAEY	ETDRMSAEY
LDKDDRRLLSY	KDDRRLLSY
VMDVNSSKY	VMDVNSSKY
DFREKGGY	DFR-EKGGY
VSDPLSDLKW	VSDPLSDLK
RMDENSPLMY	RMDESPLMY
VTEFEDIKSGY	FED-IKSGY
YTDATVIPH	YTDATVIPH
VSDLQKSLNY	VSDLKSLNY
RVDPAKGLF	RVDPAKGLF
TTDEFDQRILY	TDEFQRILY
MMDPNSTQRY	MMDPSTQRY
LTDILGIED	LTDILGIED
TEENKTKGFDY	EENKKGFDY
LSDTKYLEMI	LSDTKYLEM
AADLNLVLY	AADLNLVLY
LVDYQMYD	LVD-YQMYD
NIDYPVLY	NID-YPVLY
YVDQYLYHY	YVDQYLYHY
ETVDPASLWEY	TVDPSLWEY
VTEESFDSKFY	VTEEFDSKF
TIDKATGILL	TIDKTGILL
WIERKQLDY	WIERKQLDY
QTDDTWRTEY	QTDDWRTEY
HWDVTEAVFH	HWDVTEAVF
RIEKQFLLY	RIEKQFLLY
MTDDKITEV	MTDDKITEV
ITDIQIPLDY	ITDIIPLDY
DSDHLTIYNAY	DSD-HLTIY
LTDLGQNLLY	LTDLQNLLY
VLDDPVLGY	VLDDPVLGY
ELDLTYGNRY	ELDLYGNRY
DTEAAIQSILY	EAAIQSILY
DVEAIFSKY	DVEAIFSKY
ASGLIHRV	ASG-LIHRV
LSYPWDGTQSY	PWD-GTQSY
VTDNRAFGY	VTDNRAFGY
STAKSATWTY	STAKATWTY
QSDPTQSGMY	QSDPQSGMY
VVDGFNVLY	VVDGFNVLY
TSDQRYVLY	TSDQRYVLY
ICDTSNFSDY	ICDTNFSDY
QLDAAQRTLY	QLDAQRTLY
YTDEDMLKY	YTDEDMLKY
YIDIDPLLY	YIDIDPLLY
TDIRSQLRY	TDIRSQLRY
EADGAAWVLLY	ADGAWVLLY
LLEDFLEHEGY	LEDFEHEGY
VTAIAVDRY	VTAIAVDRY
ATSPSSPLY	ATSPSSPLY
SCDLWSLGVI	SCDLWSLGV
LLDELLQKGY	LLDELQKGY
NTEGLHHLY	NTEGLHHLY
VADLVENSY	VADLVENSY
ELHNQKGY	ELH-NQKGY
VLDILLEQY	VLDILLEQY
VSDAVATYY	VSDAVATYY
LSETFLHIYQY	LSETFLHIY
LVDLYILTY	LVDLYILTY
LLEEDTPRY	LLEEDTPRY
DTELKQVAY	DTELKQVAY
MMEAFAQRY	MMEAFAQRY
ASETAGSGFL	ASETGSGFL
LSDIASALR	LSDIASALR
FTDREIDLY	FTDREIDLY
SSEEQKQLMLY	SSEEKQLML
MTESYEQEKY	MTESEQEKY
VTEQDSKDSTY	EQDSKDSTY
LSDTKYLEM	LSDTKYLEM
GLDEEGKGAVY	LDEEKGAVY
NTEPLPANSY	NTEPPANSY
DLDDVGKDVY	DLDDGKDVY
EGPHRVVAHLY	VVA---HLY
FTDADDVAILT	FTDADVAIL
ITDEEATKSSY	TDEETKSSY
SERLLRELY	SERLLRELY
ETELDGLRY	ETELDGLRY
YTDSYTDTY	YTDSYTDTY
YIDPIAMEYY	YIDPIAMEY
ISEDIKSYY	ISEDIKSYY
YSDPKSLET	YSDPKSLET
QMEDGHTLFDY	MEDGTLFDY
SSDISFIKY	SSDISFIKY
IADFGFGNF	IADFGFGNF
ELEKIIAELLY	ELEKIAELL
QIDITTENQY	QIDITENQY
YLEQLHQLY	YLEQLHQLY
DLDTGTNYDY	DLDTTNYDY
FADDMYSLY	FADDMYSLY
DTSRPLGDSMY	TSRPGDSMY
ISDGKMQLY	ISDGKMQLY
LADLKVQLY	LADLKVQLY
MSDPYMPSYY	MSDPMPSYY
YIEGKYIKY	YIEGKYIKY
LTDKSKELPLY	LTDKKELPL
NLEDQAHLATY	LEDQHLATY
WMEKELGLY	WMEKELGLY
PTDMEHTGHY	PTDMHTGHY
NSEILSIDLTY	NSEILSIDL
DPSVLGKY	DPS-VLGKY
LVDVMPWLQY	LVDVPWLQY
YTDVSTRY	YTD-VSTRY
RLDFNPDRY	RLDFNPDRY
LLDEAQRLLY	LLDEQRLLY
TMDNPTTTQY	TMDNTTTQY
QTDPTLLSV	QTDPTLLSV
TDVREQNKY	TDVREQNKY
RSALFALRY	RSALFALRY
ITKQGDGVDF	ITKQDGVDF
YSIDDQSQQSY	SIDDSQQSY
FSQVSKNDLY	FSQVKNDLY
TDGHVHLY	TDG-HVHLY
YLDDPDLKY	YLDDPDLKY
YLDKGILKY	YLDKGILKY
QLDHSKLLGY	QLDHKLLGY
TDYLRQRALY	TDYLQRALY
YMEKEEPIY	YMEKEEPIY
LDESRPLFERY	ESRPLFERY
FSDPSQQPPS	FSDPQQPPS
AVTEEFQPVY	VTEEFQPVY
VTEVGLSAY	VTEVGLSAY
VIDKNSGGWWY	VIDKNSGGW
LSDPQTRAIY	LSDPTRAIY
DTELLAERFYY	DTELAERFY
ITGKEDAANNY	KED-AANNY
YLDSIKELY	YLDSIKELY
LSSLPTQMDY	LSSLTQMDY
FAEESDLSRQY	ESD-LSRQY
YSDKYGLGY	YSDKYGLGY
STDGFMLNF	STDGFMLNF
TVDPASLW	TVD-PASLW
YSDHPSGGSY	YSDHSGGSY
LTEEVAQEY	LTEEVAQEY
PHYGHAGTVY	YGH-AGTVY
SAKTILKY	SAK-TILKY
LVVPGASIKY	LVVPASIKY
FLESVEGNQNY	ESVEGNQNY
LLESAKMFNY	LLESKMFNY
DSYTDSYTDTY	YTDSYTDTY
NIDIPEGNWY	NIDIEGNWY
ITEVKVEPMTY	EVKVEPMTY
TSSEDKRKTY	SSEDKRKTY
QVVVTVLDY	QVVVTVLDY
RLDSLTTLY	RLDSLTTLY
LIQSAVLY	LIQ-SAVLY
LSEPSSLQ	LSE-PSSLQ
DTDISLIR	DTD-ISLIR
LTDPSQRLV	LTDPSQRLV
SSDPASQLS	SSDPASQLS
FSENEKNAAYY	FSENKNAAY
TDLREEDSGHY	LREEDSGHY
LLDPRSYHTY	LLDPSYHTY
VLDEGKMKLDY	VLDEGKMKL
ISDAVYHMVY	ISDAYHMVY
SIDPGADLSQY	SIDPGADLS
LLDTVLPHLY	LLDTLPHLY
FLDPASAGIGY	FLDPAGIGY
FTEPNEISQY	FTEPEISQY
ILNDMVWKY	ILNDMVWKY
VVDQRPINY	VVDQRPINY
QTETGTPYML	QTE-TGTPY
QTEGTGAISGY	QTEGAISGY
ATDAYAGFII	ATDAYAGFI
QSDYFRALY	QSDYFRALY
QTEIRLRLHY	QTEILRLHY
STTTGHLIY	STTTGHLIY
SSTDPEALHY	STDPEALHY
ISEFPTLKY	ISEFPTLKY
DSDSDLQLY	DSDSDLQLY
FMDVKCPGCY	FMDVCPGCY
FLENAYEKY	FLENAYEKY
DTEENKLIY	DTEENKLIY
LSDFESGLKYI	LSDFSGLKY
PSPEVQKKKY	SPEVQKKKY
YTMAWAEYY	YTMAWAEYY
LMDRPIFY	LMD-RPIFY
DTDYRSMEY	DTDYRSMEY
AVDAARLHY	AVDAARLHY
ETDEQRLRDEY	TDEQLRDEY
VTEYHDMVTE	VTEYHDMVT
YIMYNILPIY	YIMYILPIY
RPPGFSPFR	RPPGFSPFR
YLETVAAYY	YLETVAAYY
LSDDLHVERY	LSDDHVERY
YTDTGFLAEYL	YTDTFLAEY
ITSTRSLNY	ITSTRSLNY
ESLEKALKY	ESLEKALKY
FTELAILY	FTE-LAILY
SLDNSYKMDY	SLDNYKMDY
IMDRAPSVY	IMDRAPSVY
FLDYEGYKY	FLDYEGYKY
VADLVENSYS	VADLVENSY
LTDAETSKLIY	LTDAETSKL
ASDMLQLEY	ASDMLQLEY
HTDIDAAKVY	HTDIAAKVY
HSDLKVGEY	HSDLKVGEY
FSESGGDMKEW	FSESGGDMK
NTDFYQTSY	NTDFYQTSY
TTDFEDDEFV	TTDFEDDEF
QGDEICLRY	QGDEICLRY
NLDHTKPCWY	NLDHKPCWY
TMDNPLLKY	TMDNPLLKY
LLDQRPAW	LLD-QRPAW
SLDIVLHDTYY	SLDILHDTY
YSQELSLLY	YSQELSLLY
KTDHFIFT	KTD-HFIFT
QCDSPYITRY	QCDSYITRY
TDRTGFTFKY	TDRTFTFKY
RTDIARTEY	RTDIARTEY
ETEGPHVLLY	ETEGHVLLY
WLDAYEDQY	WLDAYEDQY
VTENVVNLY	VTENVVNLY
DDTHYLLYIY	DTHYLLYIY
FSDTGNFGF	FSDTGNFGF
DSDGAQDYY	DSDGAQDYY
STDVDKTGASY	DVDKTGASY
ELDDTLKY	ELD-DTLKY
VTAQVVGTERY	TAQVGTERY
TSNNIYEAVKY	NIY-EAVKY
ATELQSMMY	ATELQSMMY
AVDLMTHNY	AVDLMTHNY
KLDLLEQEY	KLDLLEQEY
YTEKNGQLIY	YTEKGQLIY
VSERDVYLT	VSERDVYLT
EIDPDQADITY	DPDQADITY
QLENLEQQKY	QLENEQQKY
TTDPYLTNSY	TTDPLTNSY
FIDAQFEAY	FIDAQFEAY
SSDPKVLTL	SSDPKVLTL
TSSSHTLTY	TSSSHTLTY
MSEERTLLY	MSEERTLLY
ASDLSQPDL	ASDLSQPDL
SSSRYDDYDRY	SSRYDYDRY
TVDFTADKY	TVDFTADKY
LDALIDTYL	LDALIDTYL
VTYIPDKTGRY	YIPDKTGRY
SSDGAISLLTY	SSDGAISLL
TSETFPEAY	TSETFPEAY
ITDDLHFYV	ITDDLHFYV
GTELGNELFY	GTELNELFY
LLDPTQKALY	LLDPQKALY
SSDDSKLEY	SSDDSKLEY
WVDVAHLVLY	WVDVHLVLY
ASELHTSLY	ASELHTSLY
TEINRSFKEY	EINRSFKEY
LLDTNRYLY	LLDTNRYLY
LKDDLLLY	LKD-DLLLY
SSTSEIGTRY	STSEIGTRY
ETEPVFWYY	ETEPVFWYY
NSGDYEILY	NSGDYEILY
ETDKNGFLQY	ETDKGFLQY
SSDSTHVTFY	SSDSHVTFY
TEREYFNRY	TEREYFNRY
ILDEFLQTY	ILDEFLQTY
TSCLQTLKY	TSCLQTLKY
FSENTLQFY	FSENTLQFY
QLEHLQSKY	QLEHLQSKY
TLDAVKFSQY	TLDAKFSQY
YLDGTLAIY	YLDGTLAIY
ISQSGDFLRY	ISQSDFLRY
SSKISSEFTY	SSKISEFTY
ETEHEPTKMFY	ETEHEPTKM
TSEYHDIMY	TSEYHDIMY
VTDGAILGKLY	VTDGILGKL
LLDGIQDNY	LLDGIQDNY
GTEHPNTIQEY	TEHPTIQEY
FSDPFLKYLET	FSD-PFLKY
DLDNDLMKY	DLDNDLMKY
FIEERLLMY	FIEERLLMY
VIDQQNGLY	VIDQQNGLY
DKSMVDKY	DKS-MVDKY
YTLLDVLYY	YTLLDVLYY
ISEVITQDY	ISEVITQDY
VTDKNPAGDY	VTDKPAGDY
VSDGNFSNYY	VSDGFSNYY
FVDDYTVRV	FVDDYTVRV
DTDKFKGFCY	DTDKKGFCY
DLDEIVARY	DLDEIVARY
ISELGFKKIY	ISELFKKIY
LMDETHSHIY	LMDEHSHIY
FSDTYQDYEE	FSD-TYQDY
IVGPDGLVY	IVGPDGLVY
TMEDGKTMDY	TMEDKTMDY
TSLNGIQFY	TSLNGIQFY
YSDQDFLAK	YSDQDFLAK
DQRGQKPGDLY	RGQKPGDLY
YLEKFQNLT	YLEKFQNLT
SDKETYELRY	SDKEYELRY
ITDFSPEWSY	ITDFPEWSY
MTEKQLNLY	MTEKQLNLY
TSDVPGKLIY	TSDVGKLIY
YTDVPFHNQY	YTDVFHNQY
SIERLPLHLY	SIERPLHLY
LMDKSSTIY	LMDKSSTIY
SDPRYHEVHY	SDPRHEVHY
QLDLAQRTLY	QLDLQRTLY
LADVNNIGKY	LADVNIGKY
SVEEFVERY	SVEEFVERY
WVDPYEVSY	WVDPYEVSY
YSADGQLLHY	YSADQLLHY
LSQSGDFLRY	LSQSDFLRY
DSDWFAENY	DSDWFAENY
QAAAQQGYSAY	AAAQGYSAY
MIDVTKSY	MID-VTKSY
RLDHWIHSY	RLDHWIHSY
TTDFPGNYSG	TTD-FPGNY
LLDIEQDTYRY	LLDIEQDTY
SDALDKIRY	SDALDKIRY
ELDPTNMT	ELD-PTNMT
ESSDNYEHWL	SSDNYEHWL
LTDGVSQIHY	LTDGSQIHY
LTDFIQKY	LTD-FIQKY
NTEEEGLKY	NTEEEGLKY
ASDDFDQASY	ASDDDQASY
SSDEVNFLVY	SSDENFLVY
TDNLELKKLVY	NLELKKLVY
ATEQPQTLATY	ATEQQTLAT
EDGSHTIQIMY	GSHTIQIMY
PTDYADIMMGY	YAD-IMMGY
DEAEREKQQY	EAEREKQQY
LTHSLVLHY	LTHSLVLHY
DSKVQEARKSF	DSKVQEARK
ASDSIVLFY	ASDSIVLFY
QLEPTFIKGY	QLEPFIKGY
YLDTVPEV	YLD-TVPEV
VTDPTGFLRM	VTDPGFLRM
IMDPDVITGY	IMDPVITGY
FLDESRSTQY	FLDERSTQY
TSDTQWGWFY	TSDTWGWFY
YSDEFGNLD	YSDEFGNLD
TSEDRFIQY	TSEDRFIQY
GSELIQGLGY	GSELQGLGY
YTDLLQMKL	YTDLLQMKL
ALDGRETDFY	ALDGETDFY
YGSKEDPQTF	GSKEDPQTF
ELDIGDATQVY	ELDIDATQV
YADQLKEYLFY	YADQLKEYL
TTDFIFNLY	TTDFIFNLY
YSDFVVHEI	YSDFVVHEI
GIDDMCLKY	GIDDMCLKY
ATDFFGGIL	ATDFFGGIL
FLDLVNYVY	FLDLVNYVY
ILDYINGGEL	ILDYNGGEL
YSDLHAFYY	YSDLHAFYY
ASEDLLKEHY	ASEDLKEHY
MLDWASGTLY	MLDWSGTLY
YSSLNLFDTY	YSSLLFDTY
YSAESSFHY	YSAESSFHY
FLSFPTTKTY	LSFPTTKTY
AAGPPISEGKY	AGPPSEGKY
ATESVSLY	ATE-SVSLY
LTAAQQQQY	LTAAQQQQY
IYDFIGEFMKA	IYDFIGEFM
TTEDAQAAVDY	TEDAAAVDY
TMEGGTLKY	TMEGGTLKY
TSDNIHSASLY	TSDNHSASL
YIDDVFHAL	YIDDVFHAL
SLDNGELRSY	SLDNELRSY
QSDTADLLGGY	DTADLLGGY
FSEHGSLKY	FSEHGSLKY
SSDVIRLIMQ	SSDVIRLIM
RTEMGLYYSY	RTE-MGLYY
LSEAQRCLY	LSEAQRCLY
LSAVLKDLY	LSAVLKDLY
VGDWLQERY	VGDWLQERY
YTGVQILLY	YTGVQILLY
LSDHVIWKY	LSDHVIWKY
LLLEPYNKY	LLLEPYNKY
YLEREDFF	YLE-REDFF
ETDSFKLAY	ETDSFKLAY
PTDLETRSYKY	PTDLETRSY
SSEITSLYY	SSEITSLYY
FSAFEKHQY	FSAFEKHQY
SELQREGVSHY	ELQRGVSHY
ASEPSAQLS	ASEPSAQLS
PPQYSHQTHRY	YSH-QTHRY
LLDEMQRLL	LLDEMQRLL
HSDELTSLLGY	SDELSLLGY
ETDLRNHFY	ETDLRNHFY
YADYEESRMKY	DYEESRMKY
SSDIDKLQY	SSDIDKLQY
ASEFGNHYL	ASEFGNHYL
ESDREELNY	ESDREELNY
LTDFQKAVY	LTDFQKAVY
RSDPNSESLY	RSDPSESLY
LDKAHYGSSAY	KAHYGSSAY
VVDRIYSLY	VVDRIYSLY
YLSERYAEL	YLSERYAEL
SCDAMATHYY	SCDAMATHY
MTEDELREF	MTEDELREF
DSDHWAPIHY	DSDHAPIHY
EIEGTNVSTTY	GTN-VSTTY
TSDNGKDGLAY	TSDNGKDGL
LTELPDWSYAG	LTELPDWSY
LLELLHELY	LLELLHELY
LTQDLVQEKYL	LTQDVQEKY
NLDPSNVDSLF	NLDPNVDSL
KSDGSFIGY	KSDGSFIGY
HVDFGGTSVWY	HVDFGGTSV
SVDPTQTEY	SVDPTQTEY
DNLELKKLVY	NLELKKLVY
SEYDQIRY	SEY-DQIRY
ELDPTNMTY	ELDPTNMTY
SSDEEFAAALY	SDEEAAALY
VTDTNKFDNY	VTDTKFDNY
TDPSVLGKY	TDPSVLGKY
ELQREGVSHY	ELQRGVSHY
GLDEVIFSY	GLDEVIFSY
VVEDKVEGY	VVEDKVEGY
WTDINVVVY	WTDINVVVY
YIEFHSQSGFY	YIEFSQSGF
ASYEVKELY	ASYEVKELY
LDVRSKWEY	LDVRSKWEY
IVDITKDTFY	IVDIKDTFY
DLDIAVHMTY	DLDIVHMTY
SSQSDYYASYY	QSDYYASYY
WLDLVLLKY	WLDLVLLKY
DSDGELGSRY	DSDGLGSRY
ISSEELPLYY	SSEELPLYY
PSDYRYYPY	PSDYRYYPY
FVDNPVGTGFS	FVDNVGTGF
LVDNSIRELQY	LVDNSIREL
YLDFREKGGY	YLDFEKGGY
GAAASPTFLLY	AASPTFLLY
VLDYINGGELF	VLDYNGGEL
YSEFQSHPY	YSEFQSHPY
DSEPSTGMNY	DSEPTGMNY
YSFDNLPEKY	YSFDLPEKY
GSGNYNDFGNY	SGNYDFGNY
SIDSNISLVHY	DSNISLVHY
QTDKLKELYGQ	QTDKLKELY
QTETKTITY	QTETKTITY
LSDKNIEQY	LSDKNIEQY
SVDSNLLSDY	SVDSLLSDY
LDTPREKNSSY	DTPRKNSSY
MVDESGLW	MVD-ESGLW
TDAQQAFKY	TDAQQAFKY
FLDDFESKY	FLDDFESKY
NSYPRFLESEF	NSYPRFLES
FTEDNLKKLY	FTEDLKKLY
LLDVRDRDSY	LLDVDRDSY
DTDSAIGSFRY	DSAIGSFRY
SIGDIFLKY	SIGDIFLKY
MSDSYLPSY	MSDSYLPSY
YSDGLAASQMY	YSDGAASQM
ESEDPDYYQY	ESEDDYYQY
YSDLNTQRPY	YSDLTQRPY
GSEYLKLGY	GSEYLKLGY
VTFEKQWFY	VTFEKQWFY
LIDPDLTQY	LIDPDLTQY
LTDNLTFSSIY	LTDNLTFSS
YTDYGGLI	YTD-YGGLI
FVDYAQKNGY	FVDYQKNGY
FSDLKSPLHYY	FSDLSPLHY
ETEEDKFLLL	ETEEKFLLL
STDNFTRILEY	STDNRILEY
YVDPSTDERLS	YVDPTDERL
FSEREGSIY	FSEREGSIY
VDERPFLHY	VDERPFLHY
EREYFNRY	ERE-YFNRY
FSEDRPFAVGY	SEDRFAVGY
YSDFALKNPFY	YSDFLKNPF
QMDSPLDSSRY	DSPLDSSRY
TDTFKLHCY	TDTFKLHCY
WSEPFYQET	WSEPFYQET
ERVDGEKDTY	RVDGEKDTY
YTETVNHHY	YTETVNHHY
LSNYETLKY	LSNYETLKY
EIELRNGELQ	EIELRNGEL
TTDYRTPQGDY	TTDYPQGDY
NTDPWAGYR	NTDPWAGYR
TADHNLLLYEA	TADHNLLLY
LLDGNIDSSQY	LLDGNIDSS
IIDNSQGFY	IIDNSQGFY
ESSSVVLRY	ESSSVVLRY
NLDPEIDEKL	NLDPIDEKL
MSEGLGMRY	MSEGLGMRY
ISSESGHYYSY	SSESHYYSY
VSDDGTLHM	VSDDGTLHM
TTEETLTMLY	TTEELTMLY
VTEEFQPVY	VTEEFQPVY
ITAKFTALY	ITAKFTALY
YTDYGGLIFNS	YTDYGGLIF
PLDQTPLFY	PLDQTPLFY
LTDWKDFLLV	LTDWDFLLV
YSEYPPFSHRY	YSEYFSHRY
ISDGKEYL	ISD-GKEYL
SSDIVGQLY	SSDIVGQLY
TLDSTQNVY	TLDSTQNVY
TEEDKFLLLY	EEDKFLLLY
ASELGPTTPY	ASELPTTPY
SEIEAKVRY	SEIEAKVRY
TVARPVFTEY	TVARVFTEY
ATELTHEDY	ATELTHEDY
YSELGHPFGY	YSELHPFGY
TTEVHPELY	TTEVHPELY
ETAYPGQTQY	ETAYGQTQY
SDSSKRTFSVY	DSSKTFSVY
DISDSKIRY	DISDSKIRY
VLDVLSDYDAS	VLD-VLSDY
YSQSTDTSGY	YSQSDTSGY
ATEEAPYWTYL	ATEEPYWTY
SDVSLLNY	SDV-SLLNY
LTDLYSPEY	LTDLYSPEY
LTEELYGNTFQ	LTEEYGNTF
YLEHVGHNHTY	YLEHHNHTY
KSDNIINIGY	KSDNINIGY
FTSMTRLY	FTS-MTRLY
DSDSSLNQSY	DSDSLNQSY
TLDFALEEY	TLDFALEEY
MSDLNKMMV	MSDLNKMMV
KSDPFLVFY	KSDPFLVFY
MMEAFASRY	MMEAFASRY
SSEQLFLRY	SSEQLFLRY
YVDDTQFVGFD	YVDDQFVGF
ETEVYEGAL	ETEVYEGAL
PTDGPPNSFY	PTDGPNSFY
QTEIVDLLESY	IVD-LLESY
SDFSHPHY	SDF-SHPHY
FMDPEMETRY	FMDPMETRY
FTEIKVGVAY	FTEIVGVAY
NVSQDDVLY	NVSQDDVLY
ECSVCGELFRY	SVCGELFRY
LLDAVLIDY	LLDAVLIDY
VIDKESEVY	VIDKESEVY
STDVSDLLHQY	VSD-LLHQY
YLDHAGATLF	YLDHGATLF
SDGTHGGLRY	SDGTGGLRY
MVDQYDQLY	MVDQYDQLY
LTEIKGSVY	LTEIKGSVY
LVDIDLISF	LVDIDLISF
NIEDKTGLW	NIEDKTGLW
LDRLYEHY	LDR-LYEHY
FTDSDLRNDSY	DSDLRNDSY
TDAAKGFGGKY	DAAKFGGKY
VTEYAEEIYQY	VTEYAEEIY
RTEGAFGLY	RTEGAFGLY
TDEQRLRDEY	TDEQLRDEY
YTDQAFFSF	YTDQAFFSF
TSELDKLTTLY	ELDKLTTLY
LLDGNPLSK	LLDGNPLSK
LTDFEGALKF	LTDFGALKF
VLIDVGTGYY	LIDVGTGYY
ESDEDMGFGLF	ESDEMGFGL
ETERIVTTY	ETERIVTTY
PLDPSSLHY	PLDPSSLHY
LVEKKLEDYY	LVEKKLEDY
YINASFLDGY	YINAFLDGY
WSQHYHQGYY	WSQHHQGYY
KIDALQLEY	KIDALQLEY
LIDNGVTKGFV	LIDNVTKGF
FLDYDAGEVS	FLDYDAGEV
ASDAAPLQYL	ASDAAPLQY
YLDEGRLRY	YLDEGRLRY
ATEQVSWGHY	ATEQSWGHY
FSGRKPMLY	FSGRKPMLY
DQEKEDGKY	DQEKEDGKY
NTDFWKTLR	NTDFWKTLR
NTEEFITVY	NTEEFITVY
LLDIFSILHY	LLDISILHY
EAERVLFSYGY	EAERVLFSY
ITDEFVKQKY	ITDEVKQKY
EVDPGSAELQK	EVDPGSAEL
YSPGSTLNY	YSPGSTLNY
PSDPQVILY	PSDPQVILY
EDYKALQKY	EDYKALQKY
KTDPVRLTQLY	KTDPRLTQL
STDPEALHYD	STDPEALHY
YFDLLGELMKF	YFDLLGELM
DSRHLDHY	DSR-HLDHY
ITEIHEQTY	ITEIHEQTY
KTDREYQEY	KTDREYQEY
DSDLQLDRIS	DSDLQLDRI
ESESVTLQQY	ESESTLQQY
RVYIHPFHL	RVYIHPFHL
YIEEFLQQY	YIEEFLQQY
VSESHGQLSY	VSESGQLSY
FSDYPPLGR	FSDYPPLGR
FTESQKTKY	FTESQKTKY
YVSDWWEEY	YVSDWWEEY
TIDKSSPLY	TIDKSSPLY
YTAQPTQGY	YTAQPTQGY
LDKTKQREMVY	KTKQREMVY
LIGQFGVGFY	LIGQGVGFY
MSELPEEVLEY	ELPEEVLEY
LTDRELEEY	LTDRELEEY
FSDTYQDYEEY	FSD-TYQDY
EADVAQLEY	EADVAQLEY
PSEVDVEKY	PSEVDVEKY
PEGFSHFHLY	EGFSHFHLY
ITDFNIDTY	ITDFNIDTY
HWDAAIHGF	HWDAAIHGF
TSDDEKKDF	TSDDEKKDF
MSEKQEQLY	MSEKQEQLY
PTDITSLDQY	PTDISLDQY
WTESVQNSIKY	ESVQNSIKY
MVDESGLWAV	MVDEGLWAV
ILDLDDELYLG	ILDLDDELY
VIESTNLKY	VIESTNLKY
HTDIDAAKVYM	HTDIAAKVY
YSEPQPSMFY	YSEPPSMFY
ITDSFNATY	ITDSFNATY
LSDILATSKY	LSDIATSKY
SSDSGFSNY	SSDSGFSNY
YVAGGQHLQY	YVAGQHLQY
LSSPVESVL	LSSPVESVL
QIDREMLNLY	QIDRMLNLY
DLDRVLMGY	DLDRVLMGY
VQDRVGSGLLY	QDRVSGLLY
YTDTYTEAY	YTDTYTEAY
LSDYEIESKY	LSDYIESKY
YTDFDGTRVYS	YTDFGTRVY
ATESFASDPIL	ATESASDPI
FVDILTNWY	FVDILTNWY
TIDKYMVRY	TIDKYMVRY
ISERNQDATVY	ISERQDATV
TATRPGVY	TAT-RPGVY
ETDLLDIRSEY	LLD-IRSEY
RLDPATGSLY	RLDPTGSLY
LTDNRYLLL	LTDNRYLLL
TDISDLIRDSY	ISDLIRDSY
PTDMEHTGHYL	PTDMHTGHY
GTVYEDLRY	GTVYEDLRY
YTEKDPSYF	YTEKDPSYF
YGDPGHWDRY	YGDPHWDRY
IVDHIHFQ	IVD-HIHFQ
ADKVHLMY	ADK-VHLMY
RMDENSPLM	RMDENSPLM
FSVSNDLKY	FSVSNDLKY
YVKDIYQY	YVK-DIYQY
TDVFEKHPCLY	VFEKHPCLY
YTEEIERLK	YTEEIERLK
VYDVTKMTSF	VYDVKMTSF
SSDNYEHWLY	SSDNEHWLY
MTELEPSKF	MTELEPSKF
SSDNYEHWL	SSDNYEHWL
LTDPRGAQAHY	LTDPAQAHY
FLDFHALPY	FLDFHALPY
VSDPLIGGTYM	VSDPIGGTY
DTDAQQAFKY	DTDAQAFKY
ESFEDGLKY	ESFEDGLKY
NLDKNLIKY	NLDKNLIKY
ISDDIVDKLQY	SDDIDKLQY
YTENLVAYTSY	YTE-NLVAY
QLDMQSSWVY	QLDMSSWVY
LTDINSERHY	LTDISERHY
ASADPDNLKY	SADPDNLKY
TLEESAMLRY	TLEEAMLRY
PLSGGDQY	PLS-GGDQY
ETEKMIEKY	ETEKMIEKY
FTEILNYI	FTE-ILNYI
YSDFLNED	YSD-FLNED
NIDDGTSDRPY	IDDGSDRPY
KTDMEKLTFY	KTDMKLTFY
NMEADPGQY	NMEADPGQY
NSDVVEQIY	NSDVVEQIY
KSEFLNFF	KSE-FLNFF
TLEDIATSHLY	LEDITSHLY
LLDHDNVKY	LLDHDNVKY
LLDMPLWY	LLD-MPLWY
VLDKGEIQEY	VLDKEIQEY
ASDPASSLRV	ASDPSSLRV
LSDISAQVQQY	LSDIQVQQY
QTEDNMLFY	QTEDNMLFY
FIDVDDERWH	FIDVDDERW
LVDPSVYG	LVD-PSVYG
NVDPVQHTY	NVDPVQHTY
AVDWESLGY	AVDWESLGY
LDEGKMKLDY	LDEGMKLDY
YTEVLDLS	YTE-VLDLS
ALDDSDFFTSY	LDDSFFTSY
ATDISRQNEYL	ATDIRQNEY
VSEKEFNFLDY	VSEKEFNFL
YVDEYRNDY	YVDEYRNDY
QLAKEKPDEY	QLAKKPDEY
MLDIQQDEY	MLDIQQDEY
QTDNLELKK	QTDNLELKK
ISESIKELQFY	ISESKELQF
FPELGGGHAY	FPELGGHAY
LTTDHIERY	LTTDHIERY
LLDQRPAWY	LLDQRPAWY
TMDVDLFSQ	TMDVDLFSQ
ISEASVFDAY	ISEAVFDAY
TLDTIKQYY	TLDTIKQYY
TDYHVRVY	TDY-HVRVY
VSDILHSIFS	VSDILHSIF
VTDPTGFLR	VTDPTGFLR
YTDIINIFLY	YTDINIFLY
LMEFSLKDLY	LMEFLKDLY
DSEQSPSIGY	DSEQPSIGY
YSDPSVLYM	YSDPSVLYM
YVETQAKENAY	ETQAKENAY
YWDGEKETYV	YWDGEKETY
LLDKVKDGGY	LLDKKDGGY
AYDKAVASF	AYDKAVASF
VVDIQGVGDL	VVDIGVGDL
TEVNKAGTQY	EVNKAGTQY
EMDAALHYY	EMDAALHYY
IDVDDERWHY	DVDDERWHY
MSQDIVKYNTY	SQDIKYNTY
LTEMQTEQY	LTEMQTEQY
TDIFQHDTY	TDIFQHDTY
NLDPDNKMSY	NLDPNKMSY
LAELNQILY	LAELNQILY
QSDKVYEVY	QSDKVYEVY
GTDPNIPDEY	GTDPIPDEY
VSDPLIGGTY	VSDPIGGTY
TVEESTLKY	TVEESTLKY
YMDPICDFLY	YMDPCDFLY
PSSKELLFY	PSSKELLFY
DVDTSQVLY	DVDTSQVLY
VLDELSVTY	VLDELSVTY
RTELGKLVGY	RTELKLVGY
FVDNMYKGGQY	VDNMKGGQY
PTDLETRSY	PTDLETRSY
TTESQELSRY	TTESELSRY
TSDDHVIQY	TSDDHVIQY
KTEIMSPLY	KTEIMSPLY
LTDIGVLY	LTD-IGVLY
DSDFFTSYY	DSDFFTSYY
FLNGSYNDY	FLNGSYNDY
LLDKPVFSF	LLDKPVFSF
ATDPGRLLL	ATDPGRLLL
ADTLRYWASIY	DTLRWASIY
LTDTTILQV	LTDTTILQV
SSDAHTSYY	SSDAHTSYY
TDLLDIRSEY	LLD-IRSEY
ASDLSQPDLV	ASDLQPDLV
YSDTKGDVFVW	YSDTKGDVF
TLDSDQVGY	TLDSDQVGY
LTDTFTAYY	LTDTFTAYY
DEQRLRDEY	DEQRLRDEY
STDHVIRMY	STDHVIRMY
GTDPLVLAV	GTDPLVLAV
ELESGQISY	ELESGQISY
HLDQSQKSLY	HLDQQKSLY
SSNYTLPAF	SSNYTLPAF
SSDLVLQNY	SSDLVLQNY
STSEIGTRY	STSEIGTRY
YTTGHWDNY	YTTGHWDNY
YSYPTGNHTY	YSYPGNHTY
QLEDEALKY	QLEDEALKY
KSDVNAIIHY	KSDVAIIHY
LVDHFMELY	LVDHFMELY
IMDSGELDFY	IMDSELDFY
LTEEKMELY	LTEEKMELY
ASADPGNLKY	SADPGNLKY
STDPREALQY	STDPEALQY
LIDADPYLK	LIDADPYLK
YAEGDLTLY	YAEGDLTLY
FMEAVSSKY	FMEAVSSKY
STETTFLVDKY	ETTFLVDKY
ATDIFSYL	ATD-IFSYL
NTERTVWQY	NTERTVWQY
VSDRDILEH	VSDRDILEH
ILDLVKGTHY	ILDLKGTHY
VIDFSHGLALY	VIDFHGLAL
HLDAQRLHYY	HLDAQRLHY
VTAASTSYY	VTAASTSYY
TLDDESLKY	TLDDESLKY
KMDVSKITRY	KMDVKITRY
SDFRKEFY	SDF-RKEFY
VEKKIDKY	VEK-KIDKY
ASEQDILKY	ASEQDILKY
QAEGPNRLLY	QAEGNRLLY
VTDRSDARLQY	RSD-ARLQY
DSEGYLLF	DSE-GYLLF
FSDHHENKYL	FSDHHENKY
QTDGLKGFY	QTDGLKGFY
ILDGNELSY	ILDGNELSY
LVDTSKQWDYY	LVDTKQWDY
YTERAVFRY	YTERAVFRY
FTEGSTDKY	FTEGSTDKY
MTAKLQTPY	MTAKLQTPY
FTSPVTPEELL	FTSPTPEEL
YTSKWTNDY	YTSKWTNDY
ALIEFIRSEY	LIEFIRSEY
TEKANHYY	TEK-ANHYY
YSEVLDVLSDY	VLD-VLSDY
LTETVVTEY	LTETVVTEY
YTETEPYHNY	YTETPYHNY
ARFGHGSDY	ARFGHGSDY
FYDNKGITYL	FYDNKGITY
YSESSQLLYL	YSESSQLLY
MSEEAYEKY	MSEEAYEKY
DLDSLAVLTY	DLDSAVLTY
KTDAFICKY	KTDAFICKY
LAESALQLLY	LAESLQLLY
TTDFEDDEF	TTDFEDDEF
MSAGANISTWV	MSAGNISTW
LTEQQKALY	LTEQQKALY
WLESVRLEY	WLESVRLEY
LTDKDTGVTRY	LTDKGVTRY
GADDTVYMEY	ADDTVYMEY
VTDPRVVDLL	VTDPVVDLL
RVDPIGPLSY	RVDPGPLSY
KTDIVNTTY	KTDIVNTTY
TTDPMLALSVY	TTDPLALSV
SSEVTSQLY	SSEVTSQLY
LEIKKIGDEY	EIKKIGDEY
STEERHLLY	STEERHLLY
YMESMKPNKY	YMESKPNKY
ITDEEELNDY	ITDEELNDY
VDFAERHGY	VDFAERHGY
NSDGALLRFY	NSDGLLRFY
MSSLFQEFY	MSSLFQEFY
QADARMLMY	QADARMLMY
YLEREDFFF	YLEREDFFF
PVLIPGARY	PVLIPGARY
WTDNRELTY	WTDNRELTY
KVDDDFTAQDY	VDDDTAQDY
YTEQSQIKGY	YTEQQIKGY
YADYSGQQSTY	YSG-QQSTY
STSISSLSY	STSISSLSY
VSDPMSSTY	VSDPMSSTY
YIDIPFQNKYS	YIDIFQNKY
ETWAGSHSMRY	TWAGHSMRY
DLDSRVLYY	DLDSRVLYY
STDPRPASY	STDPRPASY
ETESVRYVY	ETESVRYVY
FTDGITNKLIG	FTDGITNKL
LDQEKEDGKY	LDQEEDGKY
VTDFIAPGY	VTDFIAPGY
ELDQGTPQY	ELDQGTPQY
ESEQEMKEMGY	EQEMKEMGY
GSNFRGGSDGY	NFRGGSDGY
TTEVVNELY	TTEVVNELY
LLDTMPKQY	LLDTMPKQY
DLDTDYGSGY	DLDTYGSGY
TLDPNFLDAY	TLDPFLDAY
ASELVAELSTL	ASELVAELS
FSDNIEFY	FSD-NIEFY
EADRDKERY	EADRDKERY
LLEVDATSKY	LLEVATSKY
DFDPALLEF	DFDPALLEF
TTEIMNPDY	TTEIMNPDY
ETDDLTIKL	ETDDLTIKL
ATDINGDDY	ATDINGDDY
YVDDVFLRV	YVDDVFLRV
IVDSGGGLLK	IVDSGGLLK
TVDEYKIGQLY	VDEYIGQLY
YLELFPAHLY	YLELPAHLY
YSVNGERLGTY	SVNGRLGTY
FSDAKENFY	FSDAKENFY
PTDTNVIRY	PTDTNVIRY
IVDTGIGMTK	IVDTIGMTK
LLEENVPEKY	LLEEVPEKY
LTQVASEHFY	LTQVSEHFY
SVDPHGFIS	SVDPHGFIS
ELDKLTTLY	ELDKLTTLY
LLEIKKIGDEY	LLEIIGDEY
TSDQATLLLY	TSDQTLLLY
RLDDKKFLY	RLDDKKFLY
LLLEGFNNY	LLLEGFNNY
TDRSDARLQY	RSD-ARLQY
ATDRFRSLY	ATDRFRSLY
GSDPEFARY	GSDPEFARY
YTEKQIGYL	YTEKQIGYL
YTAQEYGAGTY	AQEYGAGTY
DPNSTQRY	DPN-STQRY
MVDYAHNNY	MVDYAHNNY
ESETAVVNVTY	ETAVVNVTY
STELAKQVIEY	ELAKQVIEY
ITESNMKSRY	ITESMKSRY
VTFPEFLRY	VTFPEFLRY
VSELAGLLSAM	VSELAGLLS
SSDFLEFVNY	SSDFEFVNY
SIDVAGNLDY	SIDVGNLDY
ESENVVCHFY	ESENVCHFY
FTDVNSILRYL	FTDVSILRY
QTDLLKLLV	QTDLLKLLV
LIDEVIEDTRY	IDEVEDTRY
SLDDVLYRY	SLDDVLYRY
LLEMEDQKNSY	EMEDQKNSY
LTDSTQIKM	LTDSTQIKM
YSEEIVEMY	YSEEIVEMY
YSSEDDYVGY	SSEDDYVGY
LSGNDPAIHLY	GNDPAIHLY
DSEYVRAVY	DSEYVRAVY
GLDKAGSTALY	LDKASTALY
PTDYRKQLQY	PTDYKQLQY
FTDTEGLPYS	FTDTEGLPY
LTDEGYEHFY	LTDEYEHFY
QSMDSKLSGRY	SMDSLSGRY
LTSEDTGAY	LTSEDTGAY
NTTDIFQTV	NTTDIFQTV
SYEDRVTFL	SYEDRVTFL
KTDNDTILY	KTDNDTILY
FLEPLGTLGY	FLEPGTLGY
ISESQKLAHY	ISESKLAHY
NSSTIRSIY	NSSTIRSIY
ILDGNDEKY	ILDGNDEKY
LLDTVTMQV	LLDTVTMQV
ESEDYHFYQGL	ESE-DYHFY
IADSNYNWF	IADSNYNWF
SENVEKSKAY	NVE-KSKAY
KFDVSPVKI	KFDVSPVKI
ILNGSDIRSLY	GSD-IRSLY
AMDATKLEY	AMDATKLEY
FSNVTDDTYYY	VTD-DTYYY
QMDSRIAGYYY	QMDSIAGYY
ESDSRQIFY	ESDSRQIFY
NAETGNLPHSY	ETGNLPHSY
QVEDYPVDIYY	VEDYVDIYY
TLDRLLALNSL	TLDRLALNS
EVESSRTPWLY	ESSRTPWLY
ETERLTDDY	ETERLTDDY
STDKEEDYIRY	STD-KEEDY
LSDFFKTHY	LSDFFKTHY
LDESRSTQY	LDESRSTQY
LLDYIGSQAQY	LLDYSQAQY
RDTASSILTY	DTASSILTY
LTELHGGSIMY	LTELHGGSI
RVDPIGPLS	RVDPIGPLS
NSETDSFKLAY	ETDSFKLAY
TESARYTDAHY	ESARTDAHY
KTDMVEKALLY	MVE-KALLY
LTDTFTAY	LTD-TFTAY
TTERTVLGEY	TTERVLGEY
ETDPVENTY	ETDPVENTY
MTDLYPPELF	MTDLPPELF
DTATPDIKSHY	ATPDIKSHY
FSEQVAMGY	FSEQVAMGY
HLDFHCNEY	HLDFHCNEY
ISDPFYGPWY	ISDPYGPWY
QMDESEQYLY	QMDEEQYLY
VTEEMINPY	VTEEMINPY
QTDLHEHPLY	QTDLEHPLY
YSQSPAYNSQY	QSPAYNSQY
RSQGIPFLEY	RSQGPFLEY
YVDDASWMR	YVDDASWMR
SSDTTQQGWKY	DTTQQGWKY
RTDYGQVFT	RTDYGQVFT
NSAFFTGIY	NSAFFTGIY
SVDQIPYGMRY	VDQIYGMRY
FSDVMEDLYNY	FSDVMEDLY
CLMVQVEAQY	LMVQVEAQY
TDDGNKWLYK	TDDGNKWLY
RSDHEFLFHY	RSDHFLFHY
KTDVTMLL	KTD-VTMLL
LSDVDLSKY	LSDVDLSKY
SLDAASEYAKY	SLD-AASEY
QSDYTKAWEEY	QSDYKAWEE
ATDGKVLLW	ATDGKVLLW
TTDGLGKVYY	TTDGGKVYY
LIDSQQQDRY	LIDSQQDRY
GVDNPGHPY	GVDNPGHPY
LSDPGSGLY	LSDPGSGLY
MSSLFQEF	MSS-LFQEF
EGTDRKDVFFY	GTDRDVFFY
ESERLLRELY	ESERLRELY
ESDDPMAY	ESD-DPMAY
LTEFSELEY	LTEFSELEY
ALDTLIIEY	ALDTLIIEY
STDNFTRILE	STDNFTRIL
LMENRVQSFY	LMENVQSFY
IAEKETLEY	IAEKETLEY
SSDKITTGY	SSDKITTGY
VLDGELLNRY	VLDGLLNRY
KTEVNSGFF	KTEVNSGFF
QTDPATLLH	QTDPATLLH
LLEKKVLFY	LLEKKVLFY
HLESEKLLLY	HLESKLLLY
LSDEEAVHY	LSDEEAVHY
FSSDDSKLEY	SSDDSKLEY
ANPEVSILNY	NPEVSILNY
ASSPTPPHGY	ASSPPPHGY
KVDEEQMKY	KVDEEQMKY
FSEDGEYF	FSE-DGEYF
GTLDSVLRY	GTLDSVLRY
DIDIRKDLY	DIDIRKDLY
LTDRLQLTL	LTDRLQLTL
ATEDPVLERY	ATEDVLERY
GTDRTGFTFKY	GTDRGFTFK
LDLSHNKLDLY	LSHNKLDLY
HTEVPARNLY	HTEVARNLY
FSDPVYAEAY	FSDPYAEAY
LTELPDWSYA	LTELPDWSY
YTEDSPGLK	YTEDSPGLK
TSDLMENTY	TSDLMENTY
FTEDIQTRQY	FTEDQTRQY
QSEREYIRY	QSEREYIRY
ATNPESKVFY	ATNPSKVFY
YQFTGIKKY	YQFTGIKKY
LTEVDNYHF	LTEVDNYHF
TIDIGVKY	TID-IGVKY
FTVLEKFRY	FTVLEKFRY
VLEDSDLK	VLE-DSDLK
AADLVEALY	AADLVEALY
YAEALKENSY	YAEAKENSY
VVDPVHGFMY	VVDPHGFMY
LLDPSQRDLY	LLDPQRDLY
ILADQQDKY	ILADQQDKY
ALDPGTRDSY	ALDPTRDSY
LSDYLFTLARY	LSDYLFTLA
LSDILQITQY	LSDIQITQY
ESDLDYIQY	ESDLDYIQY
GTEFGGSIY	GTEFGGSIY
VSEPRKGFMY	VSEPKGFMY
ELDTLNEDSY	ELDTNEDSY
VLDVVYLVY	VLDVVYLVY
LLGIDVWEHAY	GIDVWEHAY
TMDPKPLAY	TMDPKPLAY
YSDKYGLG	YSD-KYGLG
MEDSMDMDM	MEDSMDMDM
TDITKGVQY	TDITKGVQY
LTEVSQKENY	LTEVQKENY
QSELDRINAQY	ELDRINAQY
GSDPLGLIAY	GSDPGLIAY
SSESLNHLL	SSESLNHLL
LLQNDGFF	LLQ-NDGFF
LSSPDNFRY	LSSPDNFRY
MDETHSHIY	MDETHSHIY
FTDLTRDIY	FTDLTRDIY
GLDFPNLPY	GLDFPNLPY
FTDVPSIQI	FTDVPSIQI
FMDPGPEGKLY	FMDPPEGKL
RIEEDNLTY	RIEEDNLTY
FSEEGAVGY	FSEEGAVGY
FIIPNVVKY	FIIPNVVKY
FTDTEGLPY	FTDTEGLPY
ATDLAYYLV	ATDLAYYLV
AIDEDVLR	AID-EDVLR
NTDPETFNV	NTDPETFNV
FTDDGFAMGVA	FTDDFAMGV
TSDDEVFKY	TSDDEVFKY
SDYPRGVRY	SDYPRGVRY
RADDADEFGY	ADDADEFGY
ETEAIKEELLY	ETEAKEELL
ASEPSAQLSY	ASEPAQLSY
VTELGRPAAEY	VTELPAAEY
TMESMNGGKLY	ESMNGGKLY
TDKASMEVRY	TDKAMEVRY
ILDHQQFDY	ILDHQQFDY
KSDLRPMLY	KSDLRPMLY
VSEDSSVTQIY	SEDSVTQIY
FLEAIENNKY	FLEAENNKY
QSMDELKDVY	SMDELKDVY
VSELEPDKY	VSELEPDKY
TDFLRKLKDAY	FLRKLKDAY
VTDTSMDTYL	VTDTSMDTY
YTDHVWTEVY	YTDHWTEVY
EVDPIGHLY	EVDPIGHLY
DSDRGLQEGY	DSDRLQEGY
IVDEAIYY	IVD-EAIYY
FTDTSYEEKRY	FTDTSYEEK
ELDSSLDQY	ELDSSLDQY
LTDLLVSPCYY	LTDLVSPCY
TMDTESSVY	TMDTESSVY
YLDDPDLKYG	YLDDPDLKY
SEASRLAHY	SEASRLAHY
ATEESFFILK	ATEEFFILK
LMEVDPIGHVY	EVDPIGHVY
FVDILTNW	FVD-ILTNW
STDYHISLV	STDYHISLV
SMESFPPLAY	SMESPPLAY
HTDPVHLYK	HTDPVHLYK
FTDTSIILF	FTDTSIILF
ISADYIGGSHY	SADYGGSHY
FTDIKFTKY	FTDIKFTKY
VTDHLGVVY	VTDHLGVVY
FSDTLRPYFQV	FSDTLRPYF
NVDLLGSLAD	NVDLLGSLA
ELDNVIKQGY	ELDNIKQGY
VVDTDVHVVY	VVDTVHVVY
DSDYHQEAY	DSDYHQEAY
YLENLEKLMY	YLENEKLMY
MTEADVNPKAY	EADVNPKAY
GTDGGRYDVY	GTDGRYDVY
ESDTLRFYAY	ESDTRFYAY
ITDQNSDGY	ITDQNSDGY
ISEKETLNEY	ISEKTLNEY
FLDISLEAHMY	FLDILEAHM
YTDVLQKIKY	YTDVQKIKY
LIEDSDQNLKY	DSD-QNLKY
ITDPDPDIR	ITDPDPDIR
IIGQFGVGFY	IIGQGVGFY
HADSPVLMVY	HADSVLMVY
AIDIHNKTLY	AIDINKTLY
FVNDVKDYL	FVNDVKDYL
TTWHSNDDDVY	HSN-DDDVY
LLDIGSLDY	LLDIGSLDY
HTEQLVQDQY	HTEQVQDQY
VSAADLEKY	VSAADLEKY
DKDDRRLLSY	KDDRRLLSY
DIKDSKAYY	DIKDSKAYY
FENQGQKPLY	FENQQKPLY
VTDSPSPEYL	VTDSPSPEY
ASEASRLAHY	ASEARLAHY
FLDESFPRY	FLDESFPRY
ATENIAVRY	ATENIAVRY
LAELPQQVVQY	ELPQQVVQY
TTEILRSMLY	TTEIRSMLY
TSEQEWDKY	TSEQEWDKY
LTPLLNPFIY	LTPLNPFIY
ESDILQRTY	ESDILQRTY
FSDGRVLCY	FSDGRVLCY
YSDRVAVDYY	YSDRAVDYY
VDAFVEHRY	VDAFVEHRY
VNLPINGNGKQ	NLPINGNGK
DSDMQTLV	DSD-MQTLV
NLDIDPKLQEY	DIDPKLQEY
VEDVRDECSKY	DVRDECSKY
VSDGNFSNY	VSDGNFSNY
MTDEWFSEYV	MTDEWFSEY
FMDSVIFTLY	FMDSIFTLY
FLDHRFSSY	FLDHRFSSY
FLDPRPLT	FLD-PRPLT
EMDSPILGDY	EMDSILGDY
EDFLEHEGYKY	FLEHEGYKY
IDIHNKTLY	IDIHNKTLY
EVNGLISMY	EVNGLISMY
KVEKHYLFY	KVEKHYLFY
VLDSEGYLLF	VLDSGYLLF
STDFAQYNSY	STDFQYNSY
LSDGGLLLSY	LSDGLLLSY
DVERIKDTY	DVERIKDTY
LSDIHIDIMD	LSDIHIDIM
YLDHFSRALQY	YLDHRALQY
TDKDTGVTRY	DKDTGVTRY
ATALFSFL	ATA-LFSFL
FTEYVKDGLK	FTEYVKDGL
NLEASGDYKY	NLEAGDYKY
ESDFKPYLY	ESDFKPYLY
MLDKNNLVKY	MLDKNLVKY
MLDLAKIIF	MLDLAKIIF
IMENANVLARY	MENAVLARY
FTDPGQVAYV	FTDPGQVAY
QVEPGALRY	QVEPGALRY
LTDIFQHDT	LTDIFQHDT
FLAPPGAGSY	FLAPGAGSY
GTEVRYVIDYY	GTEVYVIDY
YLWSAIEIFRY	WSAIEIFRY
DRSDARLQY	DRSDARLQY
FMDPASALYR	FMDPASALY
YLDHNSFDY	YLDHNSFDY
TTEERTQLY	TTEERTQLY
YSSQFGGGSQY	SSQFGGSQY
DTDSRFIPY	DTDSRFIPY
HSEAHTLLY	HSEAHTLLY
YSDKYDDEEFE	YSDKDDEEF
VTDKFTESVY	VTDKTESVY
TDKSMVDKY	TDKSMVDKY
QTMEFVEEY	QTMEFVEEY
VTDLHLDPTY	VTDLLDPTY
GVDSSQFSEY	GVDSQFSEY
LLDRGLDIY	LLDRGLDIY
LSDPPGAGTY	LSDPGAGTY
TWAGSHSMRY	TWAGHSMRY
LTDVAHEY	LTD-VAHEY
FTDVIGHY	FTD-VIGHY
LSEEPYIHANY	SEEPIHANY
YESINYIF	YES-INYIF
YIDEKSPIY	YIDEKSPIY
YTLPLVLLY	YTLPLVLLY
VFSEPRAVFY	FSEPRAVFY
RSDVEILGY	RSDVEILGY
TMDELVEHY	TMDELVEHY
YTEHQVVSSDF	YTEHQVVSS
LDEAEREKQQY	EAEREKQQY
ATVFRTVLDYY	ATVFTVLDY
VDPAKGLFY	VDPAKGLFY
LTENEMTTIHY	LTENEMTTI
NLEETLSTLEY	LEETSTLEY
LSENWIEEY	LSENWIEEY
SSDFGKITGKY	SSDFKITGK
TDAFKKIGNAY	DAFKIGNAY
RTDYSFHKFHY	RTDYSFHKF
LSDLKHMRY	LSDLKHMRY
TDDLHKQY	TDD-LHKQY
RTEYTITMY	RTEYTITMY
LSERYAEL	LSE-RYAEL
LSEPEEAAAL	LSEPEAAAL
KSDLFQEDLY	KSDLQEDLY
DSSYEEKKY	DSSYEEKKY
YTTSNHIKY	YTTSNHIKY
YSDIAARAY	YSDIAARAY
QSANDFFSYY	QSANFFSYY
YMDATAGSAY	YMDAAGSAY
ASDPNSSIF	ASDPNSSIF
AVDPKTRLLMY	AVDPKTRLL
ITDLPIKL	ITD-LPIKL
PSLSNQDRKY	SLSNQDRKY
VSWDGNPERY	SWDGNPERY
DMDRVLLKY	DMDRVLLKY
QLDTHMELY	QLDTHMELY
YTDTILDVK	YTDTILDVK
LLDNGQEVY	LLDNGQEVY
QVIQKAVIEY	VIQKAVIEY
LTEEFRLN	LTE-EFRLN
TVEQPNQVNY	TVEQNQVNY
TQGTPLKY	TQG-TPLKY
LNDPNPMKY	LNDPNPMKY
PTDAYQLNY	PTDAYQLNY
KSEMNVNMKY	KSEMVNMKY
ESELYFLIARY	ELYFLIARY
ATSVLVNYY	ATSVLVNYY
PTEESSINY	PTEESSINY
QTESQQIRY	QTESQQIRY
YLGSKTLF	YLG-SKTLF
VIENPEMLKY	VIENEMLKY
TSDILKMQLY	TSDIKMQLY
TDDGNKWLY	TDDGNKWLY
YTEEGKVWDY	YTEEKVWDY
VLDSEGYLL	VLDSEGYLL
NTDSVHLAL	NTDSVHLAL
ATDIFSYLV	ATDIFSYLV
LLDLDEELR	LLDLDEELR
VTTPNRLIY	VTTPNRLIY
FTEVLSPNMY	FTEVSPNMY
VVDPLNGWM	VVDPLNGWM
VFDEADRLFE	VFDEDRLFE
MIDPSGVSY	MIDPSGVSY
HTELERSLEY	HTELRSLEY
LTDDEKTYY	LTDDEKTYY
WSDGHLIYY	WSDGHLIYY
DSDFRKDDFY	DSDFKDDFY
LTDNGRHITY	LTDNRHITY
TVEDGLQKY	TVEDGLQKY
SEKIKEPLYY	SEKIEPLYY
LSEDDLLSQY	LSEDLLSQY
ASELESLEK	ASELESLEK
SSRYDDYDRY	SSRYDYDRY
KSELSHYTFY	KSELHYTFY
YLDPAQRSLY	YLDPQRSLY
TSEGLKLYY	TSEGLKLYY
KLDPHNHVLY	KLDPNHVLY
EVLAGHGHLY	VLAGHGHLY
YLEGERDAIRY	EGERDAIRY
FSDFLGLHSK	FSDFLGLHS
YTDPQSKLRF	YTDPSKLRF
LSDRLTFLGKY	LSDRTFLGK
RLDKSAHLFY	RLDKAHLFY
FTDGDAALEF	FTDGAALEF
VSEMKIKEEGY	EMKIKEEGY
TIDLGAAAHY	TIDLAAAHY
YSEEIVEM	YSE-EIVEM
AVDLLDKLNHY	LLD-KLNHY
QVEKENTYTSY	QVE-KENTY
NAPWAVTSL	NAPWAVTSL
LLDTTEKYL	LLDTTEKYL
RTDDYLDQPCY	TDDYDQPCY
ATDPNILSL	ATDPNILSL
YSENIIEMY	YSENIIEMY
TETDLRNHFY	ETDLRNHFY
QTCLELERY	QTCLELERY
LSEDLGVQEY	LSEDGVQEY
YQDLLQLQ	YQD-LLQLQ
YTDFLLNKSIY	YTDFLLNKS
ASDIAKHVY	ASDIAKHVY
LMDGSVSNIY	LMDGVSNIY
VVDEIFNEY	VVDEIFNEY
YSEAVASHY	YSEAVASHY
QVDLSVHAY	QVDLSVHAY
TDFDGTRVY	TDFDGTRVY
FSEDPNEQELY	SEDPEQELY
ATELDAWLAKY	ELDAWLAKY
HTETKTITY	HTETKTITY
AMDPVSVSY	AMDPVSVSY
TSDTVQHGAVY	TSDTQHGAV
GMDNDFHHY	GMDNDFHHY
PTWNDLGDKY	TWNDLGDKY
ADYEESRMKY	DYEESRMKY
ISDDLVNSY	ISDDLVNSY
IIDISGVL	IID-ISGVL
SFDVVTKCV	SFDVVTKCV
LTDVPPPSGFY	LTDVPPSGF
TADGKTYYY	TADGKTYYY
LDASGAKLDY	LDASAKLDY
VLDVQNGIL	VLDVQNGIL
LLDISGVL	LLD-ISGVL
YLESEEYQERY	ESEEYQERY
ILDNLPHPY	ILDNLPHPY
FVNDIFERI	FVNDIFERI
RLDTPLYFS	RLDTPLYFS
LDHCSSILNKY	HCSSILNKY
YLDLTPNQE	YLDLTPNQE
YIEGGTASGFY	YIEGTASGF
QTEDIVYRY	QTEDIVYRY
SLDDFYIGKY	SLDDYIGKY
SPEPTEPQPY	SPEPEPQPY
QLSLCLAEKY	LSLCLAEKY
VIDYGHASKY	VIDYHASKY
ELDVVREIY	ELDVVREIY
GSHTIQIMY	GSHTIQIMY
ETARKFLYY	ETARKFLYY
STNGNYDGVLY	NGNYDGVLY
QLDQHPIDGY	QLDQPIDGY
LSDPSKEVEY	LSDPKEVEY
IISQFNQGFY	ISQFNQGFY
DSFFGETSHNY	FGE-TSHNY
SIDDQSQQSY	SIDDSQQSY
VTEIMSMGY	VTEIMSMGY
IVDTVTLQY	IVDTVTLQY
QLDYLGIPLFY	LDYLIPLFY
KTEVPGSVTEY	TEVPSVTEY
PSETAGRYITY	PSE-TAGRY
VSDTVVEPY	VSDTVVEPY
TDKAVKDYSAY	KAVKDYSAY
FTDPRAYLKY	FTDPAYLKY
VSEMDSERLQY	EMDSERLQY
PTDSLNNDNKY	TDSLNDNKY
FSDTATPDIK	FSDTTPDIK
FLNQSSPFY	FLNQSSPFY
TSDNVIRIY	TSDNVIRIY
WSDNSPLKYL	WSDNSPLKY
VSEGTKAVTKY	VSEGKAVTK
LTEINRSFKEY	LTEINRSFK
ATDVAKGMHY	ATDVKGMHY
LSERADWQY	LSERADWQY
DTAMPYLTSY	DTAMYLTSY
AIDNSRNILY	AIDNRNILY
PTDEITVYY	PTDEITVYY
LSDPQTRAIYD	LSDPTRAIY
SEDDIHRSIKY	EDDIRSIKY
RVDVFTNLGY	RVDVTNLGY
SSDPYHSGY	SSDPYHSGY
IMDPHAMPY	IMDPHAMPY
EIDPSNTKALY	EIDPTKALY
LTDDGNKWL	LTDDGNKWL
VADKVHLM	VAD-KVHLM
KIDEPSTPY	KIDEPSTPY
LDRLGESKY	LDRLGESKY
LTEKANHYY	LTEKANHYY
ESDSSLNSNVY	DSSLNSNVY
LTEPALVKY	LTEPALVKY
NSDELQEL	NSD-ELQEL
ETEAVKRYNDY	ETE-AVKRY
VTDMSDAEQY	VTDMDAEQY
SLDGDLAGRY	SLDGLAGRY
TTETETIAKY	TTETTIAKY
TDKFKGFCY	TDKFKGFCY
AMEPTPGGVKY	AMEPGGVKY
YVERVDSPMAY	RVD-SPMAY
YLLFTSSSDQY	LLFTSSDQY
KTDSTGTHSLY	KTDSGTHSL
YSDEFGNL	YSD-EFGNL
DAAKGFGGKY	DAAKFGGKY
DTPREKNSSY	DTPRKNSSY
GLDPATEARY	GLDPTEARY
ALDESFLGTL	ALDEFLGTL
KSELKDFFQSY	ELKDFFQSY
VIDEDVKSGRY	IDEDKSGRY
SDGKSRWFY	SDGKSRWFY
ISNENIEQY	ISNENIEQY
LSDNTPEHY	LSDNTPEHY
LLYDLGHLERY	LYDLHLERY
MTDLYPPEL	MTDLYPPEL
LSALKGHLY	LSALKGHLY
TTDFEDDEFVV	TTDFEDDEF
YIDRPLPY	YID-RPLPY
LVDLRNYQ	LVD-LRNYQ
ELDSEQVRY	ELDSEQVRY
DVDDERWHY	DVDDERWHY
FTQDFKEKDGY	TQDFEKDGY
YLEDPAFDTNY	LEDPFDTNY
ATSEWTLDY	ATSEWTLDY
PSETERLTDDY	ETERLTDDY
RYTELVEEKY	YTELVEEKY
LTEVNKAGTQY	EVNKAGTQY
TVEERVINEEY	VEERINEEY
TDILSHGRY	TDILSHGRY
ITNPKSLLY	ITNPKSLLY
PPYTVVYFPVR	YTVVYFPVR
LADAISENY	LADAISENY
FLDKNDEEY	FLDKNDEEY
AMDVYKNLYS	AMDVYKNLY
SSENPWMTEY	SSENWMTEY
YSESAGGFY	YSESAGGFY
DVYADHLDWHY	YADHLDWHY
FTEDSLLRH	FTEDSLLRH
SDRLTFLGKY	SDRLFLGKY
YLGSKTLFY	YLGSKTLFY
FSEADMRFY	FSEADMRFY
TSDGGYSFKY	TSDGYSFKY
LTEYMEHTY	LTEYMEHTY
YLAQSPQLY	YLAQSPQLY
MTEETRIVY	MTEETRIVY
DTDYRHSYEY	DTDYHSYEY
KTEEAIIYSY	KTEEIIYSY
TEKMIEKY	TEK-MIEKY
LDGDREKY	LDG-DREKY
LMDAERAWS	LMDAERAWS
ISEGDDKIEY	ISEGDKIEY
PVFIQDAGNY	FIQ-DAGNY
LIEEKDFQMLY	IEEKFQMLY
VSSSDDKDAFY	SSDDKDAFY
YTDPYTGQQI	YTDPYTGQQ
PTDENLLKY	PTDENLLKY
ETDSSEEISRY	DSSEEISRY
MDEKVELY	MDE-KVELY
VDPASLWEY	VDPASLWEY
QLDNEKTNFMY	QLDNEKTNF
LLDAKELLKY	LLDAELLKY
YTNRTGAVYL	YTNRTGAVY
YMDDYIFTY	YMDDYIFTY
FLDALDHAGY	FLDADHAGY
FPTMDPKPLAY	TMDPKPLAY
YSDIDIILLK	YSDIIILLK
VLDWNQRAMDL	VLDWNQRAM
TERSKLIDHY	RSK-LIDHY
YVDEELPDY	YVDEELPDY
PQYSHQTHRY	YSH-QTHRY
VTEKAWNYY	VTEKAWNYY
LSEYSKFLS	LSEYSKFLS
AADTVLATLY	AADTLATLY
NSLFLTDL	NSL-FLTDL
STDPAAPNLK	STDPAPNLK
LLDVTPLSL	LLDVTPLSL
SENKFLKY	SEN-KFLKY
FQDMMGHGSDY	DMMGHGSDY
YTFEDGDIKY	YTFEGDIKY
YASPVFMQPVY	ASPVMQPVY
LTDLVLKSSVY	LTDLLKSSV
NVDFDAPLGY	NVDFAPLGY
MSEPDGRASGY	EPDGRASGY
FSDVISFI	FSD-VISFI
LLDVGLRY	LLD-VGLRY
LLERLFSYY	LLERLFSYY
TTDKALGEKLY	TTDKLGEKL
LLDEKFQAAY	LLDEFQAAY
FCEANGLRY	FCEANGLRY
SDNDIRKY	SDN-DIRKY
RLDKSAHLF	RLDKSAHLF
DTDVQVCPNY	DTDVVCPNY
YTDATSKY	YTD-ATSKY
ILDPPDADHLY	ILDPDADHL
YTELVEEKY	YTELVEEKY
YSYAGGRGSY	YSYAGRGSY
QTALGNTVLHY	ALGNTVLHY
TDFINILHRY	TDFIILHRY
YTDDANQEV	YTDDANQEV
ISDVETKETTY	DVETKETTY
STETHEELLY	STETEELLY
HSAVNMNLHY	HSAVMNLHY
GTDNPLSGGDQ	GTDNLSGGD
LTENVSVDY	LTENVSVDY
MTEELLQDLAQ	MTEELLQDL
VYEKQMLYLY	VYEKMLYLY
DFLKGETGKY	FLKGETGKY
FTDQQKLI	FTD-QQKLI
NADVALVNFY	NADVLVNFY
VTEKTNILLRY	VTEKTNILL
DTDLTEKMDY	DTDLEKMDY
YVEDPQGNTIY	VEDPGNTIY
LTALQGLY	LTA-LQGLY
VTDPDVVLH	VTDPDVVLH
NTDFGDEF	NTD-FGDEF
FSDYLHPQY	FSDYLHPQY
RGQIPQILYY	QIP-QILYY
LLDMVRYTY	LLDMVRYTY
LTALESLNL	LTALESLNL
YTELEAIM	YTE-LEAIM
YVPEHWEYY	YVPEHWEYY
RMDPLTKPMQY	MDPLKPMQY
RSDFFTSFY	RSDFFTSFY
LREEGGFEY	LREEGGFEY
PTEEGKEVWDY	TEEGEVWDY
SVSEPRKGFMY	VSEPKGFMY
PSENNKLTY	PSENNKLTY
QVDLNQQQY	QVDLNQQQY
ATDVLHAVWY	ATDVHAVWY
PSDIFMVMEY	PSDIMVMEY
LTDEQIRFL	LTDEQIRFL
YLEQLHQL	YLE-QLHQL
QTEIVDLLES	QTEIDLLES
VSSQESLEY	VSSQESLEY
SFQTQQAKLIY	QTQQAKLIY
LDEHHISY	LDE-HHISY
SLEQVFSKY	SLEQVFSKY
VTELHVIS	VTE-LHVIS
LTDLSPHLRY	LTDLPHLRY
NSDLVQKY	NSD-LVQKY
ALDKIGMEIMS	ALDKIGMEI
FTDKEVHSVY	FTDKVHSVY
CGLLVALSY	CGLLVALSY
SSDSTIDILY	SSDSIDILY
SSDSFWEVGNY	SSD-SFWEV
ATEPVIAFY	ATEPVIAFY
LSDLGLLSY	LSDLGLLSY
LMDEGAHLHIY	MDEGHLHIY
FSDIHAGELY	FSDIAGELY
LLEGDDGKTYF	LLEGDGKTY
YADIAVNSDRY	DIAVNSDRY
MTELPAPLS	MTELPAPLS
LSELDQIQRY	LSELQIQRY
ESPPQYQTSY	ESPPYQTSY
SLGSLLLDSYY	SLGSLLDSY
IQDYGMRYYY	IQDYMRYYY
YTDRETGKL	YTDRETGKL
MTEIADLTY	MTEIADLTY
YLDNDELLK	YLDNDELLK
YLEKFQNLTY	YLEKQNLTY
YSSSGHYDSVY	SSSGYDSVY
TIEELAPNQY	TIEEAPNQY
PSESEKLYSFY	ESEKLYSFY
LTDPYTISA	LTDPYTISA
ESEDPDYYQ	ESEDPDYYQ
VAAEVGVWDNY	AAEVVWDNY
LIDSQNNQY	LIDSQNNQY
FTDECVKKY	FTDECVKKY
STSSYFNHY	STSSYFNHY
FVDKNMKY	FVD-KNMKY
VLETNLTGTFY	ETNLTGTFY
LADFGFGNFY	LADFFGNFY
YTFITEDQARY	ITE-DQARY
YMDRTWMPY	YMDRTWMPY
HLPETKFSEL	LPETKFSEL
TELLYKDGRY	ELLYKDGRY
FTDVAEIPAWV	FTDVEIPAW
LYSLAHSY	LYS-LAHSY
NTEKLKLKY	NTEKLKLKY
IFEYIDRLF	IFEYIDRLF
FSEEHYIFY	FSEEHYIFY
VSDMVMYGY	VSDMVMYGY
LMERLSVDY	LMERLSVDY
ATDPFVAF	ATD-PFVAF
TSETPDYLLK	TSETDYLLK
FSEDGEYFA	FSEDGEYFA
YSDDDVPSVY	YSDDVPSVY
TTDTVIRSY	TTDTVIRSY
SSDPSLRSAAY	SSDPLRSAA
KSDVNKEYY	KSDVNKEYY
LSDVLLTWKY	LSDVLTWKY
VSEEDVSSRY	VSEEVSSRY
SSEAHLQQY	SSEAHLQQY
KLDDIVQHIY	LDDIVQHIY
HFDFIQSHI	HFDFIQSHI
LLDPAQRNLY	LLDPQRNLY
LDVGGPLRY	LDVGGPLRY
LLDPIKELY	LLDPIKELY
VLDSEGYL	VLD-SEGYL
VSEYISSDGSY	VSEYSSDGS
TSDFIPRLVY	TSDFPRLVY
KTEMAVPGTLY	EMAVPGTLY
QLDSAVKNLY	QLDSVKNLY
DSDESYMEKSL	DSDESYMEK
VIDEQTPLY	VIDEQTPLY
LLDLLPASY	LLDLLPASY
LLDKIKSYY	LLDKIKSYY
PSEIYRFGTQY	EIYRFGTQY
YLDQEKEDGKY	YLDQKEDGK
ELDPQSSNLY	ELDPSSNLY
LDEQRAVKY	LDEQRAVKY
DSDFEYSTQSY	DFEYSTQSY
DEGKMKLDY	DEGKMKLDY
TTDLFGRDL	TTDLFGRDL
YLEGKIDYGEY	YLE-GKIDY
ETEVYEGALL	ETEVEGALL
FTEEGLDLHY	FTEELDLHY
QMDARAGETMY	MDARGETMY
AAELGGLLKY	AAELGLLKY
STDGEVETQV	STDGVETQV
KTEALRLQY	KTEALRLQY
FTETSRAFDSY	ETSRAFDSY
FTASWGDLHY	FTASGDLHY
FLDEWLYKF	FLDEWLYKF
SSAKTILKY	SSAKTILKY
HSDLLEDSKY	HSDLEDSKY
IAQAESLRY	IAQAESLRY
ATEESDLAQQY	ESD-LAQQY
YMEDSFCHY	YMEDSFCHY
ITDDLHFY	ITD-DLHFY
DMDNQIFGAY	DMDNIFGAY
LSEEAVLGFEY	LSEEAVLGF
YVEINGEKY	YVEINGEKY
MVDKPDIGSY	MVDKDIGSY
YSDKYFDEHYE	YSDKFDEHY
FSALEQHILY	FSALQHILY
NVDLLGSLADL	NVDLLGSLA
GSQANRLFY	GSQANRLFY
KTDYTGPESY	KTDYGPESY
LVDHGDISFY	LVDHDISFY
FVEEEHQTWY	FVEEHQTWY
QLDVTQRALY	QLDVQRALY
HADILLETY	HADILLETY
MVDESGLWAVY	VDESLWAVY
KADFCIIHY	KADFCIIHY
ESDMIRNWSY	ESDMRNWSY
LLSEDVKSYY	LSEDVKSYY
IIDVVQDHY	IIDVVQDHY
HTDCPGHADY	HTDCGHADY
VVDPEMTPY	VVDPEMTPY
MADSGHYCVY	MADSHYCVY
FLEREPLCY	FLEREPLCY
LTEPTAEVY	LTEPTAEVY
YLETVAAY	YLE-TVAAY
SDKYFDEHYEY	YFD-EHYEY
LVDPASHTLY	LVDPSHTLY
YTDHLQSY	YTD-HLQSY
VVDPVHGFM	VVDPVHGFM
YISPDQLADLY	SPDQLADLY
ISESLLDKCLY	ESLLDKCLY
ESDLYSLAHSY	ESDLYSLAH
SSDPEEESVLY	SSDPEESVL
FVEEITENY	FVEEITENY
YTDSEPRATY	YTDSPRATY
LSGPQEAEKY	LSGPEAEKY
ASYPGASVDNY	YPGASVDNY
FTEQYNEQY	FTEQYNEQY
YTNKEMLKY	YTNKEMLKY
KFDLGQDVIDF	KFDLGQDVI
VLDRSLLEY	VLDRSLLEY
ESDVVQELLKY	ESDVVQELL
AADSYTDSY	AADSYTDSY
LSEFQLEGY	LSEFQLEGY
RSEKMTLSY	RSEKMTLSY
ASDSLQLVF	ASDSLQLVF
NSDDELSGKGY	SDDESGKGY
KLDELKLKY	KLDELKLKY
YSDAFLNDS	YSDAFLNDS
TTDLFGRDLS	TTDLGRDLS
SDDLHVERY	SDDLHVERY
TSDYVSQSY	TSDYVSQSY
LLDHGANIDAY	LLDHNIDAY
TDYGGLIFNSY	YGGLIFNSY
FLDGKDGDFDY	FLDGKDGDF
MTDEWFSEYVY	MTDEWFSEY
SDDDMGFGLF	SDDDGFGLF
FLDTIVPKY	FLDTIVPKY
FTAKSPLM	FTA-KSPLM
DNKDGTVTVRY	NKDGVTVRY
LTDHMGMTASY	LTDHMGMTA
HTIDRTILENY	TIDRILENY
DTEEFFVKY	DTEEFFVKY
ETTEDVKGRIY	TTEDKGRIY
FTENNGRWIEY	FTENRWIEY
SSELFTLT	SSE-LFTLT
DSEPNRGISY	DSEPRGISY
ASALEKFF	ASA-LEKFF
WSEWTGASLA	WSEWTGASL
DVDPETLS	DVD-PETLS
GSDELTQGY	GSDELTQGY
IMTLVDETNMY	LVD-ETNMY
ISDSYFPRY	ISDSYFPRY
SLDSDYFKY	SLDSDYFKY
ISQSGDFLR	ISQSGDFLR
ATESVSLYY	ATESVSLYY
ITDQVYEYKY	ITDQYEYKY
AIDWLTGNF	AIDWLTGNF
YTDMESEDY	YTDMESEDY
LTDLSPLNY	LTDLSPLNY
EEKKQVEWDY	EEKKVEWDY
FTERSKLIDHY	FTERSKLID
TVDEHVWF	TVD-EHVWF
TSDHFETIMK	TSDHETIMK
ALDNVDARMY	ALDNDARMY
FAYTDKIDRY	YTD-KIDRY
FLLFVCISY	FLLFVCISY
TTDELEKLL	TTDELEKLL
SDIAALHHFY	DIAALHHFY
YSEQSPLSH	YSEQSPLSH
LLDTPAQLW	LLDTPAQLW
VSAADIERY	VSAADIERY
TDHATTALLHY	ATT-ALLHY
LTDFIQEEF	LTDFIQEEF
MTQTEELKY	MTQTEELKY
MSDPYLSSYY	MSDPYLSSY
RTDYGQVFTY	RTDYQVFTY
SLDALQTHY	SLDALQTHY
TEKTNILLRY	KTN-ILLRY
GLDSANEKGLY	DSANEKGLY
DSDFFTSY	DSD-FFTSY
FIEPPESFEFY	FIEPESFEF
QLDAERLDSY	QLDARLDSY
ATALALRSLY	ATALLRSLY
TDRDIDRY	TDR-DIDRY
HFDHSGGLYQF	HFDHSGGLY
TTEDVKGRIY	TTEDKGRIY
FTEGRDQGSAY	FTEGRDQGS
VIDDPQETY	VIDDPQETY
LEDRRAAVDTY	EDRRAVDTY
DSELEKSVYW	DSELEKSVY
VSDPTSGLD	VSDPTSGLD
TTDEFDQRIL	TTDEDQRIL
PTEIQRLTY	PTEIQRLTY
YTESEQGLDY	YTESQGLDY
SSDDSVQLHAY	SDDSQLHAY
TEEVSEKKSY	TEEVEKKSY
FMEKETPLR	FMEKETPLR
HTDDPLTWD	HTDDPLTWD
YTETLESIEKY	TLE-SIEKY
TEIDQDKY	TEI-DQDKY
VLDKDDMVY	VLDKDDMVY
LDVRDRDSY	LDVRDRDSY
SMDPVTGYQY	SMDPTGYQY
ITEEDLSSHY	ITEELSSHY
FSDPGQPMS	FSDPGQPMS
ATELKNNSY	ATELKNNSY
QSSQPYGQQSY	SSQPGQQSY
FIDHDITSQL	FIDHITSQL
TSDAVTFIT	TSDAVTFIT
YTQLVDLHARY	LVD-LHARY
NSDFLRELV	NSDFLRELV
YVEGSFEKY	YVEGSFEKY
ISQVTVLKY	ISQVTVLKY
FTDEEVDELY	FTDEVDELY
YDECLRKY	YDE-CLRKY
LTALHTEEENY	ALHTEEENY
ATDLDVANF	ATDLDVANF
QTDNLELKKLV	QTDNLELKK
MSETERIWY	MSETERIWY
YSFLDKMSF	YSFLDKMSF
LTEVNKTGTQY	LTEVKTGTQ
DSDDDSCLWK	DSDDSCLWK
LGIDVWEHAY	GIDVWEHAY
LLDPMGGIV	LLDPMGGIV
HVDLLINKY	HVDLLINKY
IFTDVNSILRY	FTDVSILRY
FLQQNPVTEY	FLQQPVTEY
LSSPVESVLFY	SSPVSVLFY
LTEADLQYGY	LTEALQYGY
LLDEGAKLLY	LLDEAKLLY
VADDPNDPY	VADDPNDPY
LTDSENATCLY	DSENATCLY
LWDDKGPAKI	LWDDKGPAK
LVEKLHEEY	LVEKLHEEY
LIDPGFGIY	LIDPGFGIY
YQDRYQDLGAY	QDRYDLGAY
YEDSVIQSVF	YEDSIQSVF
