Data	Data aligned
TVKGVSLSSY	TVKGSLSSY
DALVITHY	DALV-ITHY
HIYDMSTVM	HIYDMSTVM
EVIKSQEVF	EVIKSQEVF
QIRELEAEF	QIRELEAEF
TLAPLNQVF	TLAPLNQVF
FIFREGDGVYY	IFREGDGVY
YPSIHITAY	YPSIHITAY
NLLDPGSSY	NLLDPGSSY
LLDDSVRVY	LLDDSVRVY
EQYESFVKF	EQYESFVKF
TLYQPSATSY	TLYQSATSY
VLPAALAVYM	VLPAALAVY
TVRAEDQVY	TVRAEDQVY
LIRPVSASF	LIRPVSASF
VILPPLSPY	VILPPLSPY
HLVKLGKAY	HLVKLGKAY
YVYPLQLKY	YVYPLQLKY
LLETVVRVY	LLETVVRVY
FNEKSKEL	FNEK-SKEL
HVTSNHVSY	HVTSNHVSY
QQNPQPLIF	QQNPQPLIF
SLGQPHIAY	SLGQPHIAY
ILRPEELGF	ILRPEELGF
LPFPGRSASY	LPFPRSASY
SLRKAIETVY	SLRKIETVY
FVAPEIVNY	FVAPEIVNY
HLRDYFEQY	HLRDYFEQY
SLFINTSSY	SLFINTSSY
EQWKSHRSY	EQWKSHRSY
VGPPGRSSL	VGPPGRSSL
DFFAQQTRF	DFFAQQTRF
NLKDADSTEF	NLKDDSTEF
TQAQIKAAY	TQAQIKAAY
ELAQTTRTAY	ELAQTRTAY
NLPDEIYHVY	NLPDIYHVY
YPHDRPTLY	YPHDRPTLY
TIKETDPDY	TIKETDPDY
DQVAIHEAM	DQVAIHEAM
SQFIFEHSY	SQFIFEHSY
TVYPVAIKY	TVYPVAIKY
NQIRPGLQY	NQIRPGLQY
MPAVKAIIY	MPAVKAIIY
DVNKVVEY	DVNK-VVEY
SLFASRTLF	SLFASRTLF
EVYHKSMTL	EVYHKSMTL
HPTSVISGY	HPTSVISGY
MPQFSTIEY	MPQFSTIEY
FQFIMKQSY	FQFIMKQSY
YIRGSTIKY	YIRGSTIKY
SMRSPELAL	SMRSPELAL
VHFPMVVY	VHFP-MVVY
SQRPPTRETF	SQRPTRETF
TAHIHATEY	TAHIHATEY
NIRPADSRW	NIRPADSRW
ELYRATREF	ELYRATREF
YMRDPDDQY	YMRDPDDQY
DLAVPHTSY	DLAVPHTSY
SIREAGGAF	SIREAGGAF
YLYGQTTTY	YLYGQTTTY
DIAAVPATAM	DIAAPATAM
ELVKSHSSY	ELVKSHSSY
EMARHLREY	EMARHLREY
TQRDFMLSF	TQRDFMLSF
FLRVDDESM	FLRVDDESM
NTHRHLTEF	NTHRHLTEF
FQTHTTPVL	FQTHTTPVL
ELYNTIRDY	ELYNTIRDY
SIFEHKIVF	SIFEHKIVF
DVRSQVTHY	DVRSQVTHY
MQREPNQAF	MQREPNQAF
FLADPVSNM	FLADPVSNM
TLYPLHILF	TLYPLHILF
HPAPPPSNY	HPAPPPSNY
FPYEEHLEM	FPYEEHLEM
TLTPISAAY	TLTPISAAY
SIRDGVRAY	SIRDGVRAY
FINPKPITY	FINPKPITY
DQYLGHLQQY	DQYLHLQQY
QVAPSLSAL	QVAPSLSAL
KAPAPRPSL	KAPAPRPSL
YATVHQSY	YATV-HQSY
MVKVDPETRY	MVKVPETRY
EEPIYIITEY	EPIYIITEY
DLLLVRQY	DLLL-VRQY
EVYAGSHQY	EVYAGSHQY
ILNPHGIPL	ILNPHGIPL
MLIHEPFKKY	LIHEPFKKY
NLRSPNNFLSY	NLRSNFLSY
FIVDARPAM	FIVDARPAM
NAISVTTSY	NAISVTTSY
DLYVLRYEY	DLYVLRYEY
TLRSEGFDTY	TLRSGFDTY
YLAVVHAVY	YLAVVHAVY
GAGGGFGSRS	AGGGFGSRS
TLPGHIQAVY	TLPGIQAVY
FVAEERVSF	FVAEERVSF
VLYDRVLKY	VLYDRVLKY
TFARVPVATY	FARVPVATY
HIMEIFSTY	HIMEIFSTY
DLRRDIAY	DLRR-DIAY
DHALHTISY	DHALHTISY
ALAPAGFSY	ALAPAGFSY
TILHSTGQY	TILHSTGQY
QVVFSGKAY	QVVFSGKAY
ELAPTLLTAM	ELAPLLTAM
HLYEGDNLY	HLYEGDNLY
DFLAALEY	DFLA-ALEY
DIRQERTAW	DIRQERTAW
DQAFGLPRL	DQAFGLPRL
SLDAPHSTY	SLDAPHSTY
TVSDAILRY	TVSDAILRY
FLIDRSPEY	FLIDRSPEY
KAPSAARSL	KAPSAARSL
KVRESERAF	KVRESERAF
FQYSKSPSL	FQYSKSPSL
ELRNASAVM	ELRNASAVM
DQMISRIEY	DQMISRIEY
FLSFPTTKTY	LSFPTTKTY
DAYPQRIKF	DAYPQRIKF
SLFPHHGTF	SLFPHHGTF
NLFGGEPLSY	NLFGEPLSY
MLYTIHNTY	MLYTIHNTY
EIMREGSAF	EIMREGSAF
SLSVKSSVY	SLSVKSSVY
HQAIHTIEF	HQAIHTIEF
TLPTLPAKVY	TLPTPAKVY
YDKKGPAAIQK	YDKKGPAAI
EQIRNQLTAM	QIRNQLTAM
SLRFIDVEF	SLRFIDVEF
LPREGEQNF	LPREGEQNF
TLRQTITTF	TLRQTITTF
DILFVRTSY	DILFVRTSY
ILRTDNISF	ILRTDNISF
QFYDNKGITY	QFYDKGITY
MVVGTGTSL	MVVGTGTSL
TVVEPYNATL	TVVEPYNAT
QVYGGVTYY	QVYGGVTYY
IMKNPEVEF	IMKNPEVEF
HQLRAQILAY	QLRAQILAY
NVIATETSY	NVIATETSY
NLHSSSSTF	NLHSSSSTF
NIFSEVRVY	NIFSEVRVY
SVIATIQEY	SVIATIQEY
AAPATRAAL	AAPATRAAL
ELYQRIYAF	ELYQRIYAF
HAYIHSVQF	HAYIHSVQF
SLSPFAITY	SLSPFAITY
SLRPLDIEF	SLRPLDIEF
NIKNDPDKEY	NIKNPDKEY
SLELLSSHY	SLELLSSHY
DQQQFNTMY	DQQQFNTMY
NTIDPSHPM	NTIDPSHPM
HVASVTDSF	HVASVTDSF
RNVSTGDVNVE	NVSTDVNVE
TLANIHKIY	TLANIHKIY
YINPAKLTPY	YINPKLTPY
GLGSGGSIRSS	GLGSGGSIR
SQLHARPSY	SQLHARPSY
HIGIPLTY	HIGI-PLTY
LLREELQAY	LLREELQAY
MMKTEGPSY	MMKTEGPSY
IQEESLRTY	IQEESLRTY
HVRPVTQGDVY	HVRPQGDVY
TVYMGKVTF	TVYMGKVTF
FIYDSVKVY	FIYDSVKVY
HLTVHNIAY	HLTVHNIAY
FPYPFQVVY	FPYPFQVVY
YVHDDGRVSY	YVHDGRVSY
EAYNAVVRY	EAYNAVVRY
MLAGATAVY	MLAGATAVY
MPFPAHLTY	MPFPAHLTY
TIRYPDPLI	TIRYPDPLI
SIMEHNVSY	SIMEHNVSY
MAHSFGESY	MAHSFGESY
ALAADHTVY	ALAADHTVY
YIFKERESF	YIFKERESF
SLYEDDITF	SLYEDDITF
MQRLIEKY	MQRL-IEKY
MLKIAEMEY	MLKIAEMEY
TLSRETIEY	TLSRETIEY
EVRKEEQRY	EVRKEEQRY
HVVAGTAGY	HVVAGTAGY
HLAGTHTSL	HLAGTHTSL
NIRDIDKAL	NIRDIDKAL
FLYDKALTF	FLYDKALTF
MMIPSQISY	MMIPSQISY
DLLDIRSEY	DLLDIRSEY
YMKSEDPLF	YMKSEDPLF
DSYKPIVEY	DSYKPIVEY
LPYTVVIHY	LPYTVVIHY
EQRFPVATM	EQRFPVATM
QLYQQSRAY	QLYQQSRAY
TVIDSQTHY	TVIDSQTHY
YQEKGVRVL	YQEKGVRVL
DMFEILTRY	DMFEILTRY
TMADKIIMY	TMADKIIMY
EVIPYTPAM	EVIPYTPAM
NIAGDGSVF	NIAGDGSVF
YVFQSENTF	YVFQSENTF
HAGPPHNEY	HAGPPHNEY
TMRQPSVIY	TMRQPSVIY
NPYDRGSAF	NPYDRGSAF
HLIDDYGNTY	HLIDYGNTY
MILTVGGTAY	ILTVGGTAY
FPYDYSASEY	FPYDSASEY
TYDDATKTF	TYDDATKTF
LPLVSSTY	LPLV-SSTY
DLRRERDSASF	DLRRDSASF
KPPPPPPPP	KPPPPPPPP
HLRPESHSY	HLRPESHSY
DLYPHVVGF	DLYPHVVGF
IMVKPHEEY	IMVKPHEEY
EVILHHEY	EVIL-HHEY
FQYLSKTY	FQYL-SKTY
SLFVSNHAY	SLFVSNHAY
YENEVALRQ	YENEVALRQ
NPNSPSITY	NPNSPSITY
ELYRVTREY	ELYRVTREY
DMMGHGSDY	DMMGHGSDY
TLQDSRTNTAY	DSRT-NTAY
TIMAHVTEF	TIMAHVTEF
DSYKVTHY	DSYK-VTHY
TVKPEDLEL	TVKPEDLEL
HLLLKSLTY	HLLLKSLTY
LVTVKPCYNY	TVKP-CYNY
DLDSRVLYY	DLDSRVLYY
YFYVIGSSY	YFYVIGSSY
SQYPFPVTL	SQYPFPVTL
NVVKTGRVM	NVVKTGRVM
YPYPYPHTLY	YPYPPHTLY
ILKPDGSLY	ILKPDGSLY
FPMEIRQY	FPME-IRQY
YIRDLALEY	YIRDLALEY
TLRPYFQVY	TLRPYFQVY
FLDPRQPSY	FLDPRQPSY
FPYGTTVTY	FPYGTTVTY
SIPEKNRPL	SIPEKNRPL
RLKDRDPEF	RLKDRDPEF
FLFDGSPTY	FLFDGSPTY
NLSEIHVAF	NLSEIHVAF
IGQSKSVKIY	GQSKSVKIY
HLSSAHLAF	HLSSAHLAF
SQLVAGVAF	SQLVAGVAF
HVGPGVLSM	HVGPGVLSM
HLYETQRKY	HLYETQRKY
FLLESGAAY	FLLESGAAY
LPYESQVY	LPYE-SQVY
MLYYQTEKY	MLYYQTEKY
LVYNGVYQY	LVYNGVYQY
TLMGPTRVF	TLMGPTRVF
MVHSEVAAY	MVHSEVAAY
ILAAANPAY	ILAAANPAY
SLPQYSPVTF	SLPQSPVTF
TLPDDHSSY	TLPDDHSSY
EVNPNTRVM	EVNPNTRVM
LQAVFVQSY	LQAVFVQSY
SLKGVDPKF	SLKGVDPKF
HIAIPQEAY	HIAIPQEAY
RQGVDADING	QGVDADING
HLFDIITQY	HLFDIITQY
EVMPAQWEF	EVMPAQWEF
DLLVHVEY	DLLV-HVEY
TQAYGQQSY	TQAYGQQSY
SARAGETRF	SARAGETRF
SVHQPGSHY	SVHQPGSHY
TLADVKHVF	TLADVKHVF
ELKAPGISY	ELKAPGISY
EPRKGEPAY	EPRKGEPAY
QAGPATGQAY	QAGPTGQAY
EVAPAGASY	EVAPAGASY
YPTQPGQGY	YPTQPGQGY
TLTQGGVTY	TLTQGGVTY
MVRFGEYQF	MVRFGEYQF
TLRAAGKTY	TLRAAGKTY
TLNVSTTRY	TLNVSTTRY
DVYALKKPY	DVYALKKPY
SQLEHLQSKY	SQLELQSKY
TAYPGQTQY	TAYPGQTQY
TQRMFEIDY	TQRMFEIDY
TVIPNSHVY	TVIPNSHVY
MAFQNDVY	MAFQ-NDVY
SISGVTAAY	SISGVTAAY
EVLPPIHAY	EVLPPIHAY
MQNPNAIIL	MQNPNAIIL
LIKKDVNY	LIKK-DVNY
TLKQQEEVF	TLKQQEEVF
SLAGPVVSM	SLAGPVVSM
LQHDFGHLSVF	HDFGHLSVF
DQMVYTVRY	DQMVYTVRY
LIRDKEVEF	LIRDKEVEF
MIIGGGMAF	MIIGGGMAF
IPAATTIAY	IPAATTIAY
VPPPPPPPP	VPPPPPPPP
GQRPTQPVY	GQRPTQPVY
FLNPLISKY	FLNPLISKY
DAYTSRLGY	DAYTSRLGY
GLSKPVSSY	GLSKPVSSY
SSSKGSLGGGF	SSKGLGGGF
MQKPFEDASF	MQKPEDASF
AAGPPISEGK	AAGPPISEG
HISPVTSTY	HISPVTSTY
SLAEPGSAY	SLAEPGSAY
HQHLSKESM	HQHLSKESM
FVYKGGKIY	FVYKGGKIY
FLHPFPSESY	FLHPPSESY
NAAFPFLAY	NAAFPFLAY
SALPTVVAY	SALPTVVAY
TARVITNQY	TARVITNQY
TVIPNSHVYY	TVIPNSHVY
DVAPTHILY	DVAPTHILY
HAVGPSTAM	HAVGPSTAM
HLLEKSNIY	HLLEKSNIY
TLFGNNKLTTF	TLFGKLTTF
NQVIFPVSY	NQVIFPVSY
YLLPHILVY	YLLPHILVY
DAWKLTTQY	DAWKLTTQY
HLGDFHRTY	HLGDFHRTY
VPYRIFPY	VPYR-IFPY
IIRENEFSF	IIRENEFSF
HLFEHILNGY	HLFEILNGY
TLQKQSVVY	TLQKQSVVY
MIASHLLAY	MIASHLLAY
FLNKASAVY	FLNKASAVY
FLNDSYLKY	FLNDSYLKY
QMWISKQEY	QMWISKQEY
LLTDIIAAY	LLTDIIAAY
HVIDVKFLY	HVIDVKFLY
EMIAQQREY	EMIAQQREY
TLRKPSPVY	TLRKPSPVY
TQTLVREY	TQTL-VREY
SLIQAGQQF	SLIQAGQQF
APPPPPPPP	APPPPPPPP
HQASHQPLY	HQASHQPLY
EQAPPVIYY	EQAPPVIYY
SVYDGAVGY	SVYDGAVGY
TLNERFTSY	TLNERFTSY
NLAEALLTY	NLAEALLTY
EQHESIVM	EQHE-SIVM
NFLLSHEY	NFLL-SHEY
HIRFDEISF	HIRFDEISF
HLLAGGFAEF	LLAGGFAEF
YQSKYEEL	YQSK-YEEL
TQAQTTATY	TQAQTTATY
ELAPNFQVF	ELAPNFQVF
TIIPKVLAM	TIIPKVLAM
FLHESLVEY	FLHESLVEY
ELSSVKLEY	ELSSVKLEY
YILDQTNVY	YILDQTNVY
MARDEKNYY	MARDEKNYY
WVLETKEVY	WVLETKEVY
SVINPGAIY	SVINPGAIY
ELWKNPTAF	ELWKNPTAF
NIREIEIDY	NIREIEIDY
DIREEKTSW	DIREEKTSW
SLRERDAAL	SLRERDAAL
SQRPAARAF	SQRPAARAF
ARAGETRFT	ARAGETRFT
FIGEFTTSY	FIGEFTTSY
HVVAASKAM	HVVAASKAM
NLAPKSTAM	NLAPKSTAM
TMMEDFRKY	TMMEDFRKY
NVADLHEKY	NVADLHEKY
SYGGGSGGGF	YGGGSGGGF
AVDSRTGKLT	AVDSRTGKL
FLAPLVTEY	FLAPLVTEY
QLRAQILAY	QLRAQILAY
HIMPPQQHY	HIMPPQQHY
SQFGTVTRF	SQFGTVTRF
SISKALVAY	SISKALVAY
SLRHVDASF	SLRHVDASF
YPVEIHEY	YPVE-IHEY
SILEKTSAY	SILEKTSAY
SLRSEDTAVY	SLRSDTAVY
EQYEQILAF	EQYEQILAF
NQKPPSAEY	NQKPPSAEY
NVYDFKTTY	NVYDFKTTY
TLLWPGHEY	TLLWPGHEY
HVYEIPVEY	HVYEIPVEY
SLRGTSDHEY	SLRGSDHEY
HVYPAGSQVM	HVYPGSQVM
NLLKEVRIY	NLLKEVRIY
FLHEHKIVY	FLHEHKIVY
NQKPPSAEF	NQKPPSAEF
TVRDSDSGL	TVRDSDSGL
HIRENSYSY	HIRENSYSY
TQKEHLLKY	TQKEHLLKY
NLYDHELVF	NLYDHELVF
ELVKLQQTY	ELVKLQQTY
IPRITIEM	IPRI-TIEM
QPIVWITPY	QPIVWITPY
LQRLENTQY	LQRLENTQY
HLHMETSDF	HLHMETSDF
MPTVHYEF	MPTV-HYEF
YVYPKYLKY	YVYPKYLKY
FPLKALQY	FPLK-ALQY
MPAAGGVLY	MPAAGGVLY
HLRETQAQY	HLRETQAQY
HPPPPPPPP	HPPPPPPPP
SAPSRATAL	SAPSRATAL
NMANIREYY	NMANIREYY
EAWRLLSTY	EAWRLLSTY
YIRQGEQSL	YIRQGEQSL
LLAHPDAPM	LLAHPDAPM
DLIGHIVEF	DLIGHIVEF
DLWLEREVF	DLWLEREVF
ATAQPPAPL	ATAQPPAPL
AVRPLELAY	AVRPLELAY
EMYNRPVEVY	EMYNPVEVY
SVYDHQGIF	SVYDHQGIF
HVNPYIGLFF	HVNPIGLFF
SDRVVVTY	SDRV-VVTY
ALAPALVETY	ALAPLVETY
MLRATGKAY	MLRATGKAY
ELAKQITSY	ELAKQITSY
HLKKHGLTY	HLKKHGLTY
DAFAPVAY	DAFA-PVAY
HLYARQLTL	HLYARQLTL
TFMDHVLRY	TFMDHVLRY
TVIPRVYTY	TVIPRVYTY
TLRDPGSQL	TLRDPGSQL
DFFQHVEM	DFFQ-HVEM
HQITVLHVY	HQITVLHVY
ELNPKILAL	ELNPKILAL
YLFAHAVDF	YLFAHAVDF
NAAPPPVTY	NAAPPPVTY
TVKVEDLTF	TVKVEDLTF
EAFLVPAY	EAFL-VPAY
AGHINPLIIY	HINP-LIIY
SQRIFITY	SQRI-FITY
SQSQPSSQY	SQSQPSSQY
NAPWAVTSL	NAPWAVTSL
FPVEIKSFY	FPVEIKSFY
TVTEVLLKY	TVTEVLLKY
SLRTDDTAVY	SLRTDTAVY
SVKPASSSF	SVKPASSSF
HLGEFVNVF	HLGEFVNVF
QLYDKQREEY	QLYDQREEY
PPSHLGSSSPF	SHLGSSSPF
QLTGQTPVF	QLTGQTPVF
FPHPHIHEY	FPHPHIHEY
DLYSAYDY	DLYS-AYDY
YDAEISQIHQ	YDAEISQIH
SLAPPHHPM	SLAPPHHPM
DIKKTGVVF	DIKKTGVVF
MVMEIRNAY	MVMEIRNAY
HQLRAQIMAY	QLRAQIMAY
YMFVDENTF	YMFVDENTF
SQKVSGPQY	SQKVSGPQY
TVLQAVSAF	TVLQAVSAF
TINAAHVEY	TINAAHVEY
DLRFIDAVY	DLRFIDAVY
HLGVFPSYY	HLGVFPSYY
TQAPIFISF	TQAPIFISF
FINQNLRTY	FINQNLRTY
MPKVHIEF	MPKV-HIEF
RIAPAFSSM	RIAPAFSSM
QVVPAGLAF	QVVPAGLAF
NLRGTTEGVYY	NLRGTEGVY
TLKSGDGITF	TLKSDGITF
HLRDYFEEY	HLRDYFEEY
NVAEKGPAY	NVAEKGPAY
HLLPIQSTY	HLLPIQSTY
SLSAPLTSY	SLSAPLTSY
LIYDGKVEM	LIYDGKVEM
NLMELTQIY	NLMELTQIY
HLFSPGTSF	HLFSPGTSF
HLITFETEVY	HLITETEVY
LSVGSPSVL	LSVGSPSVL
HLPAYLVAAF	HLPALVAAF
LLLILVAFGT	LLLI-LVAF
MQYPGRSLVF	MQYPRSLVF
TITDVPVTVY	TITDPVTVY
TEREPDQTF	TEREPDQTF
VLFEHAVGY	VLFEHAVGY
DTYKAITY	DTYK-AITY
SHLTHSSTF	SHLTHSSTF
TLNARTSIL	TLNARTSIL
FIAPTGHSL	FIAPTGHSL
EAYVHVNQY	EAYVHVNQY
SVIGASSQF	SVIGASSQF
DLYQVIHKM	DLYQVIHKM
TLTPIIQEY	TLTPIIQEY
SQYQGVVVY	SQYQGVVVY
DIYDHAVLF	DIYDHAVLF
DQVIHTSSF	DQVIHTSSF
DVPLVVEY	DVPL-VVEY
YPQPPSQSY	YPQPPSQSY
SEHVHSQGRVM	HVHSQGRVM
TLAFPSEHF	TLAFPSEHF
QVVLLNTSY	QVVLLNTSY
HLLPYNMTVY	HLLPNMTVY
TLLASNEAF	TLLASNEAF
LPYQGHNSF	LPYQGHNSF
SVFGTHQAF	SVFGTHQAF
SLADLKSLY	SLADLKSLY
LLREENEGY	LLREENEGY
DLFGRDLSY	DLFGRDLSY
SVYEGGVFF	SVYEGGVFF
ESRQITQVY	ESRQITQVY
HLQFPGAVY	HLQFPGAVY
EIREELEQY	EIREELEQY
TVSQPNLKY	TVSQPNLKY
DIADPFFAY	DIADPFFAY
HLYGSLLYY	HLYGSLLYY
IIRTGEKPY	IIRTGEKPY
FIKDGSSTY	FIKDGSSTY
NIYKEIENY	NIYKEIENY
IVAKSSLQY	IVAKSSLQY
TVFSRSQVF	TVFSRSQVF
HLRPRPRAY	HLRPRPRAY
FLGPLHPSF	FLGPLHPSF
YVAPAYGVY	YVAPAYGVY
EQVPQQPTY	EQVPQQPTY
SVVGAISSY	SVVGAISSY
TALPTRIAY	TALPTRIAY
YPWSQRVSF	YPWSQRVSF
TQRSQQLEF	TQRSQQLEF
NLAVSNHVF	NLAVSNHVF
DQREGGQVY	DQREGGQVY
ELAPKFLAM	ELAPKFLAM
EHVVVPIVAF	HVVVPIVAF
APAPPASQY	APAPPASQY
MVIRPHKSF	MVIRPHKSF
LLADPTGAF	LLADPTGAF
VTIKKDVDG	VTIKKDVDG
DLYKGSVAL	DLYKGSVAL
EFRKVVEY	EFRK-VVEY
VPAEHQVAM	VPAEHQVAM
SLFHAQLAY	SLFHAQLAY
HIKNPDWRY	HIKNPDWRY
NAAPGVDL	NAAP-GVDL
DVFSVKTEM	DVFSVKTEM
DFREQKHSY	DFREQKHSY
HLYPNTPYAY	HLYPTPYAY
YLYPDQTHF	YLYPDQTHF
MLAPLSTTY	MLAPLSTTY
EQYTPKAKY	EQYTPKAKY
SLFKSLSRY	SLFKSLSRY
HQYHIRAY	HQYH-IRAY
SQATPHSSY	SQATPHSSY
NQRLAYVTY	NQRLAYVTY
EVGPAGSQF	EVGPAGSQF
YLRELLTTM	YLRELLTTM
TLAPVQMTF	TLAPVQMTF
TLDASTKIY	TLDASTKIY
FVNPGVVEF	FVNPGVVEF
VLFEGDEVY	VLFEGDEVY
YIYPKHLKY	YIYPKHLKY
HLIERSQVF	HLIERSQVF
TMVNSENTY	TMVNSENTY
ESYSIYVY	ESYS-IYVY
DVKVERIEY	DVKVERIEY
TLAQLQQEF	TLAQLQQEF
IVYPQKAYY	IVYPQKAYY
NLFKTNHVF	NLFKTNHVF
SQFGGGSQY	SQFGGGSQY
TISPKSTVY	TISPKSTVY
NQWEALTEY	NQWEALTEY
SAAQPGVAF	SAAQPGVAF
FVAEQKVEY	FVAEQKVEY
DLFEQKVVF	DLFEQKVVF
SIAPGLSVTY	SIAPLSVTY
YIYTTKTLY	YIYTTKTLY
FPTISLEF	FPTI-SLEF
FLLPVINEM	FLLPVINEM
EFMPASRSEY	FMPASRSEY
QYEQILAF	QYEQ-ILAF
SVQGAGTSY	SVQGAGTSY
HVGPFIDSY	HVGPFIDSY
MAWLVDHVY	MAWLVDHVY
EVLMLLPPAHY	MLLP-PAHY
DLRHFDPEF	DLRHFDPEF
TVRGPPDSDF	TVRGPDSDF
TEKPEVID	TEKP-EVID
YLFEPHSGEEY	YLFESGEEY
HLLPEEQVY	HLLPEEQVY
HSIPSGHVY	HSIPSGHVY
DGHLFQVEY	DGHLFQVEY
HVAPVTSVEW	HVAPTSVEW
SLRPIDSNTF	SLRPDSNTF
QQNDQQLVY	QQNDQQLVY
SQTNPGSQF	SQTNPGSQF
TMKPSETSF	TMKPSETSF
HVYPAQVQY	HVYPAQVQY
HLRDPELAL	HLRDPELAL
EVAPVISSAY	EVAPISSAY
LIKEKEEAF	LIKEKEEAF
SQHQETPVY	SQHQETPVY
NQIESKAAY	NQIESKAAY
TAYVGSAVM	TAYVGSAVM
VTIKKDVDGAY	TIKKVDGAY
SIYEGDESF	SIYEGDESF
TIRPEETAW	TIRPEETAW
YISFRHHVY	YISFRHHVY
FIYQNPHIF	FIYQNPHIF
SVREWEMQF	SVREWEMQF
YLLPDTKAY	YLLPDTKAY
DIIKDQKAY	DIIKDQKAY
TLNNSTQTY	TLNNSTQTY
HLYSTHAAL	HLYSTHAAL
DQFLQLSQY	DQFLQLSQY
MMDQARSAF	MMDQARSAF
VGYRVATF	VGYR-VATF
EVLISRVY	EVLI-SRVY
QIGPVAGVM	QIGPVAGVM
ELAPSLPSY	ELAPSLPSY
MVTKPVQEY	MVTKPVQEY
TLWVDPYEVSY	DPYE--VSY
TIDPNTRTL	TIDPNTRTL
EIYPQSHSY	EIYPQSHSY
SLRDSRSLSY	SLRDRSLSY
TLTAPSLSY	TLTAPSLSY
IAPTGHSL	IAPT-GHSL
TVRSDLSTF	TVRSDLSTF
FLIDLKTRY	FLIDLKTRY
ILMDPSPEY	ILMDPSPEY
DVSPVVSTY	DVSPVVSTY
QQRVVRVY	QQRV-VRVY
NQYISQQEY	NQYISQQEY
TLFELHRTTF	TLFEHRTTF
IAKNRKDIENQ	IAKNKDIEN
TLAPASSSA	TLAPASSSA
IVYPGIAVF	IVYPGIAVF
TVTIPSAVY	TVTIPSAVY
YPYPYPHTL	YPYPYPHTL
THLNELLMA	THLNELLMA
SQVDPPTTTM	SQVDPTTTM
VPRIQLEEY	VPRIQLEEY
THYQLGLAY	THYQLGLAY
TLKEEWIAY	TLKEEWIAY
SVYHPQLAY	SVYHPQLAY
LLHASLSEY	LLHASLSEY
TQAGEGRVY	TQAGEGRVY
SLLVSVLEY	SLLVSVLEY
EIREAANAM	EIREAANAM
TLHKPTQVM	TLHKPTQVM
FIRVVGSEF	FIRVVGSEF
FLYTGGIGF	FLYTGGIGF
SVRGGDEVY	SVRGGDEVY
MMYSGELKF	MMYSGELKF
SPFQPHVPY	SPFQPHVPY
ISPTGHSL	ISPT-GHSL
GLNKVSPVY	GLNKVSPVY
LIKYLDPEY	LIKYLDPEY
DAFKASVY	DAFK-ASVY
HQREIQVM	HQRE-IQVM
NLLEKQLEY	NLLEKQLEY
NSAPEHISY	NSAPEHISY
SIMEHNVAY	SIMEHNVAY
ILTVGGTAY	ILTVGGTAY
LVRELEKKF	LVRELEKKF
SLPSHLNISY	SLPSLNISY
TLYPGQGNNSY	TLYPGNNSY
TILGPPGSVY	ILGPPGSVY
QVYEGERAM	QVYEGERAM
FQYDDSGNTF	FQYDSGNTF
SIYPGNSDTRY	SIYPSDTRY
VLIDVGTGY	VLIDVGTGY
HSAPGGPSY	HSAPGGPSY
SLFHGGKSHY	SLFHGKSHY
YPKANIVAY	YPKANIVAY
HLWDWRTGY	HLWDWRTGY
TIYESKMIEY	TIYEKMIEY
NVIKVSVY	NVIK-VSVY
DAYTLAKAY	DAYTLAKAY
NLPEETNEM	NLPEETNEM
LPYNHQHEY	LPYNHQHEY
MPYSHPSSY	MPYSHPSSY
QERPSVTSY	QERPSVTSY
DAFEFHEAF	DAFEFHEAF
SLYKTHPQY	SLYKTHPQY
YLRPGQAAAF	YLRPQAAAF
EIASSGTSY	EIASSGTSY
FLLNHSLEY	FLLNHSLEY
IPREVVAY	IPRE-VVAY
FAFEHSEEY	FAFEHSEEY
ELASWGHEY	ELASWGHEY
DVVAHEVY	DVVA-HEVY
NVIRDAVTY	NVIRDAVTY
TTKDGDTVF	TTKDGDTVF
NVIHNLATY	NVIHNLATY
AFYEHAQTY	AFYEHAQTY
LQYSGKTTF	LQYSGKTTF
LLYDTQQSF	LLYDTQQSF
HLAFFHQGY	HLAFFHQGY
LPYQVNQM	LPYQ-VNQM
TLIEQQFTY	TLIEQQFTY
HLYDTPGSTY	HLYDPGSTY
SLYDRIVLF	SLYDRIVLF
HQAIHTIEY	HQAIHTIEY
TQRLKIMEY	TQRLKIMEY
NIRNEIGVFY	NIRNEIGVF
HPLTPGSHY	HPLTPGSHY
MVSEAGTGF	MVSEAGTGF
TLYKAILEY	TLYKAILEY
IIHEGSSVY	IIHEGSSVY
HPTVVISAY	HPTVVISAY
SVRKDIESY	SVRKDIESY
IPPPPPPPP	IPPPPPPPP
SLVGPTQSF	SLVGPTQSF
DVLKALQM	DVLK-ALQM
HLPLLPNVSY	LPLLPNVSY
NAHEFITSF	NAHEFITSF
ILRETTVKY	ILRETTVKY
NAFEELVAF	NAFEELVAF
TVLPFSQEF	TVLPFSQEF
YMIERPEPEF	MIERPEPEF
DLKETNISY	DLKETNISY
IPFRPSIQF	IPFRPSIQF
TLLPSAEESY	TLLPAEESY
SQYRIKEY	SQYR-IKEY
IQKQFEELY	IQKQFEELY
FPSLQRLVY	FPSLQRLVY
LEQQNQVL	LEQQ-NQVL
DAYELKHAL	DAYELKHAL
HFIRPGNAL	HFIRPGNAL
SLRDEKGALF	SLRDKGALF
FIRGSVVRY	FIRGSVVRY
WLHETERVY	WLHETERVY
NLHSGARPY	NLHSGARPY
FLEETNRLY	FLEETNRLY
SQYPFPVTLY	SQYPPVTLY
HAVVVGVY	HAVV-VGVY
RLYFSQQTY	RLYFSQQTY
DLLGVGAEY	DLLGVGAEY
SQRYSGAY	SQRY-SGAY
CTPLFMNAY	CTPLFMNAY
EQIYPVNAISF	QIYPNAISF
DFLLSRQM	DFLL-SRQM
YLGEFSITY	YLGEFSITY
ALWIGTTSF	ALWIGTTSF
VAVAHAVY	VAVA-HAVY
FALVSQAY	FALV-SQAY
YMIDPSGVSY	MIDPSGVSY
HIASFLSVF	HIASFLSVF
FLQESNVLY	FLQESNVLY
YVHTTVNEM	YVHTTVNEM
DLYAVINHY	DLYAVINHY
DIYIQSAKY	DIYIQSAKY
SLAYLVNTY	SLAYLVNTY
EQRAHVQEF	EQRAHVQEF
FVAPSRPFVVY	APSRPFVVY
TLMKQYIEF	TLMKQYIEF
FVYEVTSTKY	FVYETSTKY
ELRAKFEEY	ELRAKFEEY
SIYWTAVTY	SIYWTAVTY
FLTAAKKARAG	TAAKKARAG
TLLLKIQEY	TLLLKIQEY
HLVAVFNEY	HLVAVFNEY
SVYETQTKY	SVYETQTKY
TLKEEVNELQY	TLKEEVNEL
YLISGGTSY	YLISGGTSY
SLRKELSHY	SLRKELSHY
SSPQPGSAL	SSPQPGSAL
DLRKSPVF	DLRK-SPVF
HIYTFPHASF	HIYTPHASF
NIEEAVRLY	NIEEAVRLY
GLGPPATVM	GLGPPATVM
FIRPVDPEY	FIRPVDPEY
FPALPGSSY	FPALPGSSY
TAAAVGAVF	TAAAVGAVF
ELFDTVQVY	ELFDTVQVY
SALPALVM	SALP-ALVM
DLRQELLAF	DLRQELLAF
ELESTNRRY	ELESTNRRY
TVIEPLKGY	TVIEPLKGY
QQEERKRLY	QQEERKRLY
NMWNTGSTY	NMWNTGSTY
QVFEGHTHY	QVFEGHTHY
HLNPGLQLY	HLNPGLQLY
TAAAVQVF	TAAA-VQVF
YLREEVKTF	YLREEVKTF
TLLEKQLEY	TLLEKQLEY
QMYRTEIRM	QMYRTEIRM
FVAPATGAH	FVAPATGAH
DAYTHLETF	DAYTHLETF
EAAPPGELY	EAAPPGELY
HLAPPPLKY	HLAPPPLKY
TIAKPTTHF	TIAKPTTHF
IPYQDRESY	IPYQDRESY
RVAPAHGLF	RVAPAHGLF
LPYAGDVSM	LPYAGDVSM
TLRAVELLY	TLRAVELLY
HLEGKPRIL	HLEGKPRIL
HVSGESSVF	HVSGESSVF
REEPIYIITEY	EPIYIITEY
QLRPEFEAM	QLRPEFEAM
HAADVFEAY	HAADVFEAY
SLVGITSAY	SLVGITSAY
ILHANVVVY	ILHANVVVY
TLLSSLSRY	TLLSSLSRY
QLVTGGESF	QLVTGGESF
SVMINKATPY	SVMIKATPY
TLLQSIISY	TLLQSIISY
HQQPPSQQY	HQQPPSQQY
QLYKMRNGY	QLYKMRNGY
ELFMSSFQSY	ELFMSFQSY
MPRVQTQQY	MPRVQTQQY
FLYGNEVSY	FLYGNEVSY
TMAPPVMAY	TMAPPVMAY
HVNGIVQKY	HVNGIVQKY
TLKDRELSF	TLKDRELSF
TVRETQTMY	TVRETQTMY
TLHERFTKY	TLHERFTKY
HPIEGSTTVF	HPIESTTVF
TVRDYEHQF	TVRDYEHQF
LAYLVNTY	LAYL-VNTY
HLYGLGSGSSY	HLYGSGSSY
DQKIHRPM	DQKI-HRPM
LQQVDTSTR	LQQVDTSTR
SIAHGTPVM	SIAHGTPVM
HLAAHIEEY	HLAAHIEEY
NQLKPGLQY	NQLKPGLQY
NLRPVGEDF	NLRPVGEDF
DVYGGTNRY	DVYGGTNRY
SLPPGVHISY	SLPPVHISY
EVYQVTVY	EVYQ-VTVY
NLKAPSRHY	NLKAPSRHY
IQQIFHTTY	IQQIFHTTY
TIRQEEGVF	TIRQEEGVF
MPYLEHESF	MPYLEHESF
TMMQSGGTF	TMMQSGGTF
YLRKEDMEY	YLRKEDMEY
SLLPAQAIY	SLLPAQAIY
QVSPATQQM	QVSPATQQM
DMNRHLHEY	DMNRHLHEY
ELDPESREY	ELDPESREY
AIYGGSASY	AIYGGSASY
TLLSHVALY	TLLSHVALY
SVYRTVIEY	SVYRTVIEY
IIREKDTEY	IIREKDTEY
TQREFMLSF	TQREFMLSF
DQGPAHPPG	DQGPAHPPG
HLSDSKNVF	HLSDSKNVF
NVRSEEQVF	NVRSEEQVF
HVIENSNAF	HVIENSNAF
ILAARSPVF	ILAARSPVF
TLRDIETFY	TLRDIETFY
FPHKFEISF	FPHKFEISF
DIREEAEKY	DIREEAEKY
DFFKERTSF	DFFKERTSF
FLKPDDIQY	FLKPDDIQY
DIREEKASW	DIREEKASW
MLAETSTVF	MLAETSTVF
YQHGHINSY	YQHGHINSY
YLYLRGLVY	YLYLRGLVY
ALVKAGKVY	ALVKAGKVY
APYQFLTAF	APYQFLTAF
ILGPPGSVY	ILGPPGSVY
TLFDSRHLLY	TLFDRHLLY
EIRKDISAM	EIRKDISAM
LQALFKEAY	LQALFKEAY
HIRQELAVF	HIRQELAVF
YLNQTSRSF	YLNQTSRSF
DIMKIREY	DIMK-IREY
FDRLVLQY	FDRL-VLQY
HLNYEHRVF	HLNYEHRVF
FLALGNSF	FLAL-GNSF
TVREEFIIF	TVREEFIIF
YPYTITEY	YPYT-ITEY
YPYAAISY	YPYA-AISY
SQFKGYFIF	SQFKGYFIF
MLYGTITEF	MLYGTITEF
TIRREDLISF	TIRRDLISF
EVIPPMKEF	EVIPPMKEF
TLVDNISTM	TLVDNISTM
QLGPVGGVF	QLGPVGGVF
DLRKNYTAY	DLRKNYTAY
SVIEQILHY	SVIEQILHY
YTGPSHHSY	YTGPSHHSY
VLYPHLSTY	VLYPHLSTY
DLPKAHTAF	DLPKAHTAF
SLYASSPGGVY	YASSPGGVY
QLYQENKREY	QLYQNKREY
EVYVPHTVY	EVYVPHTVY
TVKVFNTVY	TVKVFNTVY
SVKDPSPLY	SVKDPSPLY
NLYRQLISY	NLYRQLISY
DLLQHSEY	DLLQ-HSEY
HLPETKFSEL	HLPEKFSEL
HLIPAGSQL	HLIPAGSQL
TVLRLPVEAF	VLRLPVEAF
HGIDPTGTY	HGIDPTGTY
TIAPRTHPY	TIAPRTHPY
DFYEQNSRY	DFYEQNSRY
EVLIHGVSY	EVLIHGVSY
TLYVGNLSF	TLYVGNLSF
AVAPFFKSY	AVAPFFKSY
ESYENKEAY	ESYENKEAY
DIHRSIKY	DIHR-SIKY
YPHEPTAVF	YPHEPTAVF
MVAKVGVSM	MVAKVGVSM
SLAHAGVAL	SLAHAGVAL
FVYITDNAY	FVYITDNAY
TAWEVRAVY	TAWEVRAVY
HVFIGGTPL	HVFIGGTPL
PHIHARVYNY	HIHARVYNY
SQVPRSSSM	SQVPRSSSM
LLRFADNTF	LLRFADNTF
MVNPFAYEEY	MVNPAYEEY
DLRTKEVVF	DLRTKEVVF
SDRTITEY	SDRT-ITEY
LIYEHLQQY	LIYEHLQQY
TLLQSVHIY	TLLQSVHIY
SLLERLLTY	SLLERLLTY
DIYRELYAF	DIYRELYAF
NIVDKTASF	NIVDKTASF
EFFRVVSEY	EFFRVVSEY
SVYKAFVM	SVYK-AFVM
NLRHLDLAY	NLRHLDLAY
FIDASRLVY	FIDASRLVY
YVYSHFLQF	YVYSHFLQF
HAALHLMAF	HAALHLMAF
HPIQTQAQY	HPIQTQAQY
SVSHPMPTM	SVSHPMPTM
TSAPTGHTF	TSAPTGHTF
TLTDVAHEY	TLTDVAHEY
EMRKIVAEY	EMRKIVAEY
TQALASVAY	TQALASVAY
HVSTVNPNY	HVSTVNPNY
SIFKHEIPY	SIFKHEIPY
IVKKPGNIY	IVKKPGNIY
FLTEVTDVY	FLTEVTDVY
HVINTGNSM	HVINTGNSM
AIRQQIESY	AIRQQIESY
LIRDNRVVY	LIRDNRVVY
TMKDFNHSY	TMKDFNHSY
QIAEFKEAF	QIAEFKEAF
EVLGLILRY	EVLGLILRY
DAYAINSY	DAYA-INSY
YQRDLEVAL	YQRDLEVAL
SSKPWPDATY	SSKPPDATY
FVYKEEHPF	FVYKEEHPF
EAIIPGSVY	EAIIPGSVY
YPRPRDTSF	YPRPRDTSF
YVNSPGEKY	YVNSPGEKY
SLPNFKQNEF	SLPNKQNEF
NIHSGDRPY	NIHSGDRPY
MAAMPQTVY	MAAMPQTVY
NQHAYPTAY	NQHAYPTAY
SLVEVNPAY	SLVEVNPAY
TLKGPDSHY	TLKGPDSHY
HVIANSGQF	HVIANSGQF
LSGNNVVEY	LSGNNVVEY
NAAPSHTKF	NAAPSHTKF
SVPEAQSAL	SVPEAQSAL
DQKVHNVSF	DQKVHNVSF
SLFDNPRTF	SLFDNPRTF
HIKTETVTY	HIKTETVTY
NLLRISVY	NLLR-ISVY
SVVDISQQY	SVVDISQQY
TIVKAGPEY	TIVKAGPEY
MAYETLEQY	MAYETLEQY
RLQEFLTAY	RLQEFLTAY
TLGPVSRSY	TLGPVSRSY
DLYRIFSKY	DLYRIFSKY
TVFSRSQVY	TVFSRSQVY
LPFTPLSY	LPFT-PLSY
HVHHLINEY	HVHHLINEY
SQTEVSSEY	SQTEVSSEY
LLTKNGHVY	LLTKNGHVY
TVTEKPEVID	TVTEKPEVI
IQFEIAHAY	IQFEIAHAY
FLYLSAEY	FLYL-SAEY
HPILNDPIY	HPILNDPIY
ELRDNDKTRY	ELRDDKTRY
SLYSKGLVF	SLYSKGLVF
HIYDKTSVLF	HIYDKTSVL
SLPDYRAATY	SLPDRAATY
TLHDTRTHF	TLHDTRTHF
SLYIANHAY	SLYIANHAY
TLNPNAKEF	TLNPNAKEF
EVAPALSVF	EVAPALSVF
TILDDAKIY	TILDDAKIY
AEQRGENALKD	EQRG-ENAL
FLKPGEKTY	FLKPGEKTY
SLHDISTEM	SLHDISTEM
FFESFGDL	FFES-FGDL
TLYETIIGY	TLYETIIGY
TTAPSHAKF	TTAPSHAKF
TQFVSGSKY	TQFVSGSKY
SLARPGHPM	SLARPGHPM
LIREEKNSY	LIREEKNSY
TLFPEKQIY	TLFPEKQIY
TLKTPGKSF	TLKTPGKSF
QLIDLAEEY	QLIDLAEEY
NQRTDLGTSY	NQRTLGTSY
TLAPGSRGY	TLAPGSRGY
HQYSIQVAF	HQYSIQVAF
SIYEASSLY	SIYEASSLY
NMQLPNGVTY	MQLPNGVTY
FVRDDGSSM	FVRDDGSSM
FVNPHVSSF	FVNPHVSSF
TVKDSRTVY	TVKDSRTVY
EIFQHLMAY	EIFQHLMAY
YVAPEILSY	YVAPEILSY
ELREGFVEY	ELREGFVEY
TVSPAHTSY	TVSPAHTSY
ELAKQVIEY	ELAKQVIEY
HVKDANGNSF	HVKDNGNSF
NLIGPGHSF	NLIGPGHSF
HVYHHASML	HVYHHASML
QVAPVANSY	QVAPVANSY
LSLDQSTWN	LSLDQSTWN
TLAPAVERM	TLAPAVERM
ELFKEARKY	ELFKEARKY
SLREDQQSF	SLREDQQSF
QIYQQLSRY	QIYQQLSRY
SLFVPFTVY	SLFVPFTVY
SQQPASGVAY	SQQPSGVAY
VNLGGSKSIS	NLGGSKSIS
EMVDKTPVM	EMVDKTPVM
QVYETLLTY	QVYETLLTY
TLLAELREY	TLLAELREY
TLYFSYTHM	TLYFSYTHM
DTYEITKSY	DTYEITKSY
YLRESSLLAY	YLRESLLAY
NIFHPTDPVAY	HPTD-PVAY
HLVSPLTTY	HLVSPLTTY
SLLEHIMIY	SLLEHIMIY
FPHNFQETTY	FPHNQETTY
EVAPPRLVM	EVAPPRLVM
TPAPGGSPY	TPAPGGSPY
DIRKELEKY	DIRKELEKY
MPYNHQHKY	MPYNHQHKY
ESAPVHNSF	ESAPVHNSF
HVAPQQNAL	HVAPQQNAL
NQIPFIIQY	NQIPFIIQY
ELREQTVHY	ELREQTVHY
HVGLPSVSY	HVGLPSVSY
FVEVGRVAY	FVEVGRVAY
SLDIKSVSY	SLDIKSVSY
HIITGVAVF	HIITGVAVF
TVAPPVPATPY	TVAPPATPY
EVRLQNETSY	EVRLNETSY
TLITQFLVY	TLITQFLVY
FQKVITEY	FQKV-ITEY
AMNPTNTVF	AMNPTNTVF
NVHSFFSAF	NVHSFFSAF
YLIDRDPTY	YLIDRDPTY
DLLPSFHPY	DLLPSFHPY
LPFDKETGF	LPFDKETGF
SVIESHTEF	SVIESHTEF
TFMEQKITY	TFMEQKITY
HVSPDFKTY	HVSPDFKTY
HLRNPSAAF	HLRNPSAAF
DIYKILTSY	DIYKILTSY
SVYLHPNSY	SVYLHPNSY
FLWAGGRASY	FLWAGRASY
YMYRHKGTY	YMYRHKGTY
SMSDPGVSY	SMSDPGVSY
HFYQGLVY	HFYQ-GLVY
SINPLGGFVHY	NPLGGFVHY
TLPFHSVIY	TLPFHSVIY
LQRLVNLY	LQRL-VNLY
RPREIINTY	RPREIINTY
LPPPPPPPP	LPPPPPPPP
YLFEWRTQY	YLFEWRTQY
SVVAHLSTY	SVVAHLSTY
LLHAFQATF	LLHAFQATF
DLRPDEEVF	DLRPDEEVF
SVADIRNAY	SVADIRNAY
SAYAQIVQF	SAYAQIVQF
NMYKGGQYY	NMYKGGQYY
YLNEKAVSY	YLNEKAVSY
HINSIKSVF	HINSIKSVF
QVKPNDQHF	QVKPNDQHF
MVADRVEVY	MVADRVEVY
LLREEDNKY	LLREEDNKY
DMFAHPYQY	DMFAHPYQY
TVHQVTEAF	TVHQVTEAF
DLWPAKQY	DLWP-AKQY
MIAEPAHFY	MIAEPAHFY
TVKQEDSLF	TVKQEDSLF
SIRPDNMSEY	SIRPNMSEY
NLYPGNEGY	NLYPGNEGY
QVAENPHSEY	QVAEPHSEY
LAYLQRIAL	LAYLQRIAL
FLAQHGSEY	FLAQHGSEY
VIFAGGQAY	VIFAGGQAY
HQYFSYNQM	HQYFSYNQM
QLYEQVVKF	QLYEQVVKF
MQLPNGVTY	MQLPNGVTY
EERADLIAY	EERADLIAY
NIYHPLDPVAY	HPLD-PVAY
TLIDSSSSF	TLIDSSSSF
FPYLSESY	FPYL-SESY
AVSAVVHEY	AVSAVVHEY
SVNTPTKTY	SVNTPTKTY
MLRDIIREY	MLRDIIREY
GAGGGFGSRSL	AGGGGSRSL
DVYLLHESY	DVYLLHESY
DQRVIYYY	DQRV-IYYY
NQVQSGRAF	NQVQSGRAF
AVYKVSEY	AVYK-VSEY
SVKASSVVY	SVKASSVVY
SLRQVVNVY	SLRQVVNVY
SVAGHVEVY	SVAGHVEVY
TLITGLEEY	TLITGLEEY
ELADIKQAY	ELADIKQAY
SVVSTGTSF	SVVSTGTSF
ELFSSRSKY	ELFSSRSKY
NMNDLVSEY	NMNDLVSEY
RAYQQSEAY	RAYQQSEAY
DMHSGHFVTY	DMHSHFVTY
NIREVGFEY	NIREVGFEY
HLTVDARVY	HLTVDARVY
HLYQNTRSY	HLYQNTRSY
HQYKVRAY	HQYK-VRAY
TLLESYQVY	TLLESYQVY
AGFAGDDAPR	AGFAGDDAP
HIAEEADRKY	HIAEADRKY
HPWGSSSSF	HPWGSSSSF
DQVKELLTSF	QVKELLTSF
NIKTGGRVY	NIKTGGRVY
TVETASREY	TVETASREY
YVHETLTVY	YVHETLTVY
TLRDSMLKY	TLRDSMLKY
AVRTTGNVY	AVRTTGNVY
TQAIHNTVF	TQAIHNTVF
EMMKVVQVY	EMMKVVQVY
TQILQSPAF	TQILQSPAF
HLRGNEVLY	HLRGNEVLY
HLFGQPNSAY	HLFGPNSAY
MVASMRLAY	MVASMRLAY
HLKFEINAY	HLKFEINAY
TLQRATGISF	LQRATGISF
TLLFPGREF	TLLFPGREF
SLVNLGGSK	SLVNLGGSK
SLVQPQSQY	SLVQPQSQY
YVTTSTRTY	YVTTSTRTY
DMKAFVENY	DMKAFVENY
NVVQPMKELY	NVVQPMKEL
NVAVPSHLY	NVAVPSHLY
FVKGWGAEY	FVKGWGAEY
IVRTGESSY	IVRTGESSY
DPYGSGGQKF	DPYGGGQKF
YIRPEGQDSAF	YIRPQDSAF
FPLLATAY	FPLL-ATAY
EVIPTHTVY	EVIPTHTVY
LLADITSKY	LLADITSKY
FPHSAHQKY	FPHSAHQKY
KAPGSTSNL	KAPGSTSNL
TVNQFLTQY	TVNQFLTQY
NLKKSDRYY	NLKKSDRYY
FMRQAGEVTY	FMRQGEVTY
TLFETDERY	TLFETDERY
LLYTTPTTY	LLYTTPTTY
FQAPTAKEM	FQAPTAKEM
TVGNNKTL	TVGN-NKTL
TISDHGTVTY	TISDGTVTY
EVLPINTQY	EVLPINTQY
HMFEAHSDY	HMFEAHSDY
ILRLGGIAY	ILRLGGIAY
TIVPKVLVM	TIVPKVLVM
PIYIITEY	PIYI-ITEY
SLFGSSRVQY	SLFGSRVQY
TLSPTGDVY	TLSPTGDVY
FIGKPDMAY	FIGKPDMAY
TVVDVLTSY	TVVDVLTSY
ILINSGSRY	ILINSGSRY
TVSEEKRIY	TVSEEKRIY
NLVKHAEVY	NLVKHAEVY
ARAGETRF	ARAG-ETRF
TQYERFIPSAY	TQYEIPSAY
NIVHATQLY	NIVHATQLY
LLKSEKSSY	LLKSEKSSY
IVADHVASY	IVADHVASY
LLYPYEQAQY	LLYPEQAQY
TQYESKVFY	TQYESKVFY
SLTEYPRETF	SLTEPRETF
HVRAELPSSHY	HVRAPSSHY
IQRLITEM	IQRL-ITEM
SVAKESIPL	SVAKESIPL
DQMAKVLQF	DQMAKVLQF
HVGQAGVQM	HVGQAGVQM
AVRDYEKVY	AVRDYEKVY
TMVGKTFTY	TMVGKTFTY
SKNLSSIS	SKNL-SSIS
AVHDITVAY	AVHDITVAY
DTGRPSTTVR	TGRPSTTVR
DVYNHFLLY	DVYNHFLLY
EVFKERIGY	EVFKERIGY
HLANEMETY	HLANEMETY
TVHGVTQAF	TVHGVTQAF
LTTKQSSY	LTTK-QSSY
ALQEASEAY	ALQEASEAY
QLPKPTSTY	QLPKPTSTY
NLPVPSGVAF	LPVPSGVAF
FQYESKVFY	FQYESKVFY
DGRVFQVEY	DGRVFQVEY
SPPPPPPPP	SPPPPPPPP
QMPPWNQTEF	QMPPNQTEF
TPYEGQRSY	TPYEGQRSY
FLWQEGHSAF	FLWQGHSAF
SMRQPDLKY	SMRQPDLKY
SALEHSIQY	SALEHSIQY
HAIMRSPQM	HAIMRSPQM
TLMLEHQAF	TLMLEHQAF
TVAPAQVAL	TVAPAQVAL
EQAPAPARPY	EQAPPARPY
DIAPPLIAF	DIAPPLIAF
DAGPPTHAF	DAGPPTHAF
GYTLLAAI	GYTL-LAAI
VPRSGDRVY	VPRSGDRVY
EVFMHVSTAY	EVFMVSTAY
TQVIHSIEY	TQVIHSIEY
VVAPITTGY	VVAPITTGY
AAAPAGTTF	AAAPAGTTF
SQIEEHKVF	SQIEEHKVF
HLKEDQTEY	HLKEDQTEY
TVRHGTVRY	TVRHGTVRY
