Data	Data aligned
MPKLKPVEL	MPKLKPVEL
VPRLPGETL	VPRLPGETL
LPNGMIVTL	LPNGMIVTL
AAKDPSPSV	AAKDPSPSV
IAEMVRHAL	IAEMVRHAL
RPRGPGLEF	RPRGPGLEF
GPKPGGGPGL	GPKPGGPGL
SPNSILKAA	SPNSILKAA
MPPLQPKHM	MPPLQPKHM
TPTSVIRKM	TPTSVIRKM
IPLADQPHL	IPLADQPHL
VPRQPTVTSV	VPRQPTTSV
SPREAARVL	SPREAARVL
IPMTGKPSL	IPMTGKPSL
VPAPLPKKI	VPAPLPKKI
SPQPQRAQL	SPQPQRAQL
TPKKPEAKF	TPKKPEAKF
SPSDSFSVL	SPSDSFSVL
HPMPRVNEI	HPMPRVNEI
SVPLAATSM	SVPLAATSM
SPQPPKKDSL	SPQPPKDSL
KPRDSSVEV	KPRDSSVEV
SPASRSISLL	SPASRSISL
FPGISVKSV	FPGISVKSV
IPKSILEPAL	IPKSILPAL
MPHEKHYTL	MPHEKHYTL
SPAFSTRVL	SPAFSTRVL
SVKEVLQSL	SVKEVLQSL
APALPGPAL	APALPGPAL
TPYIKKPSL	TPYIKKPSL
LPSSVLHII	LPSSVLHII
RPSGEAFVEL	RPSGEAVEL
HPPLTIDGKTI	PPLTIDKTI
LPKLPMNLL	LPKLPMNLL
TPPPVKEYL	TPPPVKEYL
APKHPISEEL	APKHPIEEL
VPKAHVDEF	VPKAHVDEF
VPKEPPPEF	VPKEPPPEF
AVEPGRPPL	AVEPGRPPL
VPKSALIPVI	VPKSALPVI
QPASFAVSL	QPASFAVSL
TPSERITSL	TPSERITSL
IPPSYKSTVTL	PPSYKSVTL
NPKPKFFVL	NPKPKFFVL
FPKGFSVEL	FPKGFSVEL
VPPREKSVAL	PPREKSVAL
APLQHRHVL	APLQHRHVL
PAKLHNSL	PAKLH-NSL
SPHDISNVL	SPHDISNVL
RPKSFILPKL	RPKSFIPKL
VPAEPKLAF	VPAEPKLAF
RPKYAGYSF	RPKYAGYSF
IPPVKATPL	IPPVKATPL
IPYAGETL	IPYAG-ETL
DTNADKQLSF	TNADKQLSF
YPRKGRIAV	YPRKGRIAV
SPRLPAREL	SPRLPAREL
AVPRPGAPA	AVPRPGAPA
LPAWPHRGL	LPAWPHRGL
SPSLPKKSL	SPSLPKKSL
HPSLPASSL	HPSLPASSL
APKSQIVML	APKSQIVML
ISKQFHHQL	ISKQFHHQL
SPADLRTNHTL	SPADLRHTL
SPKVVIQTI	SPKVVIQTI
SPNQARAQAAL	SPNQARQAA
APRLPITGL	APRLPITGL
SPEDRGSSL	SPEDRGSSL
SPLNSSSAL	SPLNSSSAL
TPKSSASSTF	TPKSSASTF
RPFGSISRIYL	RPFGSISRI
EPRYPPHSL	EPRYPPHSL
SPFYLKEAF	SPFYLKEAF
VPPAVTGITF	VPPAVTITF
RPKSYIYRT	RPKSYIYRT
IPNTQIKAL	IPNTQIKAL
RPSVGVQSL	RPSVGVQSL
LVKDALRQL	LVKDALRQL
TPWFKIIAA	TPWFKIIAA
APASVHSEI	APASVHSEI
QPYSKLPGVSL	YSKLPGVSL
KPKPGNMPF	KPKPGNMPF
RPKPSASEVL	RPKPSAEVL
RPRTPPEAI	RPRTPPEAI
RPKEYTVRF	RPKEYTVRF
VVKNVGLTL	VVKNVGLTL
VPKPGTAPTSL	KPGTAPTSL
EPRVATVTRIL	RVATVTRIL
LPSQMGSVL	LPSQMGSVL
TPILKPVSL	TPILKPVSL
APVAPHFAL	APVAPHFAL
HPSASLIDRTI	SASLIDRTI
APRGDKEEL	APRGDKEEL
RVKVFNIDL	RVKVFNIDL
LVKGLGILSL	LVKGLGLSL
AEQRGENALKD	AEQRGENAL
NPRQPLPASGL	QPLPA-SGL
IPYPKREFL	IPYPKREFL
KPESKVAKL	KPESKVAKL
NPKKPNANL	NPKKPNANL
SPKGTIENIL	SPKGTINIL
TPLYKKKEL	TPLYKKKEL
TAPNTFKTL	TAPNTFKTL
AVKESTITL	AVKESTITL
VPKDLTQPT	VPKDLTQPT
RPVQKLIRL	RPVQKLIRL
SPKVDPSL	SPKVD-PSL
SPFPTSTPL	SPFPTSTPL
TPSDGRPEL	TPSDGRPEL
SPIERNEQL	SPIERNEQL
RPIKTEMAHQL	RPIKTEMAH
FPREPRPKL	FPREPRPKL
VPRVLGSSV	VPRVLGSSV
VPRIASKPIIV	VPRIASKPI
VLSAADKGNV	SAADK-GNV
KPNEGAIVEV	KPNEGAVEV
TPKHISESL	TPKHISESL
MPSSSKTKPVL	SSSKTKPVL
LPLHKVKSL	LPLHKVKSL
SPRPTGSDL	SPRPTGSDL
TPKTNNDIL	TPKTNNDIL
RPKEPQLSLL	RPKEPQLSL
SPLFNNVKL	SPLFNNVKL
HAKMIFMEL	HAKMIFMEL
HPKFVGKTL	HPKFVGKTL
VPKTVVSSW	VPKTVVSSW
RPRLPRKL	RPRLP-RKL
GPWRDKDPAL	GPWRDKPAL
TPKPMIRAF	TPKPMIRAF
IPQGGRGAIQF	IPQGGRGAI
VPNGALKKSL	VPNGALKSL
RPKLYIVNL	RPKLYIVNL
NPPPIIKYL	NPPPIIKYL
QAQTDRVSL	QAQTDRVSL
MPRHFATKL	MPRHFATKL
VPAESAAVL	VPAESAAVL
LANKDRPAL	LANKDRPAL
TPQSNRPVM	TPQSNRPVM
VPASKRPPL	VPASKRPPL
APREALAQTVL	APREALQTV
TPAPVKKSGKL	APVKKSGKL
APYPSPVL	APYPS-PVL
IPPPIKSF	IPPPI-KSF
ISLSKDLEL	ISLSKDLEL
TPSASTPYRQL	SASTPYRQL
LPNAKIKEL	LPNAKIKEL
MPKKDPVKI	MPKKDPVKI
SPAYRDLAA	SPAYRDLAA
LPKEPQGII	LPKEPQGII
IPNFPRSTV	IPNFPRSTV
RPHHKILDM	RPHHKILDM
PLYKDSWLL	PLYKDSWLL
IVIGVLHQL	IVIGVLHQL
APQADPRPSM	APQADPPSM
MPTGGGKSL	MPTGGGKSL
APRELGLGL	APRELGLGL
QPMDIHVEL	QPMDIHVEL
APKHFLPEML	APKHFLPEM
AGIKEYFNVM	GIKEYFNVM
SPPRPQPAF	SPPRPQPAF
HPVSREWTL	HPVSREWTL
RPRLALNVM	RPRLALNVM
LPHDIRWEL	LPHDIRWEL
IPKPPVPEI	IPKPPVPEI
LPKKGVTSI	LPKKGVTSI
SPGPEKMAL	SPGPEKMAL
SPHLQVML	SPHLQ-VML
IPKKGFVEV	IPKKGFVEV
RPKEGTSTL	RPKEGTSTL
KPSATGKVI	KPSATGKVI
QPPDAVKPAI	QPPDAVPAI
TPINRIPIM	TPINRIPIM
TPSSRPASL	TPSSRPASL
TPSPYDHDSL	TPSPYDDSL
IPNVRIQAVL	IPNVRIAVL
SPRKLPTSL	SPRKLPTSL
APHEPVKTL	APHEPVKTL
PLKYPSSSTLI	LKYPSSSTL
QPQDRNQAL	QPQDRNQAL
SPKIEVHFL	SPKIEVHFL
SPKSPGLKA	SPKSPGLKA
YPNGVVVHYF	YPNGVVHYF
TPSPVIRST	TPSPVIRST
FPRSYVQPVHL	FPRSYVQPV
KPKTTEPTF	KPKTTEPTF
GAAVRIGSVL	AAVRIGSVL
MPALRSINL	MPALRSINL
VPNPDPVTM	VPNPDPVTM
GPASDHPSL	GPASDHPSL
FPTGNIHMF	FPTGNIHMF
RPKESMYSW	RPKESMYSW
IPYGERITL	IPYGERITL
APHEILIQI	APHEILIQI
KPMQPGPHVV	KPMQPGHVV
NPKIAVSKM	NPKIAVSKM
NVEIDPEIQ	NVEIDPEIQ
APADYFRIL	APADYFRIL
HPKVNVPGSQA	HPKVNVPGS
RPNMAYKVKVL	RPNMAYVKV
YPSVGQLAHKL	SVGQLAHKL
RPNFNIKGI	RPNFNIKGI
LPKKPVGL	LPKKP-VGL
MPHVPITTL	MPHVPITTL
IPSPVLVKL	IPSPVLVKL
RPKIDDVLHTL	RPKID-DVL
APKPAAPTTL	APKPAATTL
TPRVPDNSL	TPRVPDNSL
SPKPPTSMF	SPKPPTSMF
SPHATAQGL	SPHATAQGL
APYMRSMM	APYMR-SMM
KAYFKRYQV	KAYFKRYQV
FPIEVRHYL	FPIEVRHYL
KPINVRVTTM	KPINVRTTM
MPFKDRATSM	MPFKDRTSM
VPKPIGGVVVF	VPKPIGVVV
TPEERYQKL	TPEERYQKL
SPEAVGPEL	SPEAVGPEL
RPTLPVKSL	RPTLPVKSL
HPFFGRVVL	HPFFGRVVL
IPPYPASSL	IPPYPASSL
APSGSLAVPL	APSGSLVPL
APYFKGTAV	APYFKGTAV
MPSTDLLMLKA	MPSTDLLML
APSPVIPRL	APSPVIPRL
IPPEHGKRL	IPPEHGKRL
TPEEVRLPL	TPEEVRLPL
APVGSGSAL	APVGSGSAL
VPKPGAFDL	VPKPGAFDL
HPPTSGVEKVL	PPTSGVKVL
TPNPGYQPSM	TPNPGYPSM
KAYLKKISM	KAYLKKISM
KPVYPGQTL	KPVYPGQTL
APNEKMKQV	APNEKMKQV
QPAERHQLL	QPAERHQLL
VPRTAENFRAL	RTAENFRAL
TPLPQPNRAL	TPLPQPRAL
RPLYKNIVL	RPLYKNIVL
VPREPPVSL	VPREPPVSL
SPFLQPKL	SPFLQ-PKL
TPNKAGPKL	TPNKAGPKL
KPRPVSQLV	KPRPVSQLV
SPAPGRRLSL	SPAPGRLSL
APPEYHRKAV	APPEYHKAV
SPSYENSLHSL	SPSYE-NSL
APYGRITL	APYGR-ITL
RPNGTKVAVLL	RPNGTKAVL
VPNNKITVV	VPNNKITVV
PKPGAGSKL	PKPGAGSKL
RPRDYTVNL	RPRDYTVNL
PRPPPKPM	PRPPP-KPM
LPKDAVKHL	LPKDAVKHL
LPAPLPGL	LPAPL-PGL
VPASLMVSL	VPASLMVSL
LPTSVQGHVL	LPTSVQHVL
APRDPIPYL	APRDPIPYL
LPAEQHPVL	LPAEQHPVL
YPEELKPVL	YPEELKPVL
VPYSTSASL	VPYSTSASL
VPSKPPMSL	VPSKPPMSL
VNLPINGNGKQ	LPINGNGKQ
TAKEVEESL	TAKEVEESL
SPRGSTDSL	SPRGSTDSL
HPKEDIFISV	HPKEDIISV
MPHSSSAKL	MPHSSSAKL
RPRAGASISTL	RPRAG-ASI
YPHLLEQL	YPHLL-EQL
MPSLKHIVEL	MPSLKHVEL
SPSPRLKSV	SPSPRLKSV
APTQEKIFAVL	APTQEKFAV
SPHGPSAKF	SPHGPSAKF
TPTRPVQAL	TPTRPVQAL
MAPLKMLAL	MAPLKMLAL
SPKQILDPA	SPKQILDPA
SPNEFKVYM	SPNEFKVYM
QPQPQPYAV	QPQPQPYAV
SPALTISKVL	SPALTIKVL
APRHPSTNSLL	APRHPSNSL
VPKSSVSRV	VPKSSVSRV
KPNANRIAL	KPNANRIAL
MPMKVKQL	MPMKV-KQL
TPMHPPSSL	TPMHPPSSL
PKPKAKTL	PKPKA-KTL
RPPGSIKAL	RPPGSIKAL
VPKPIGGVVV	VPKPIGVVV
LPQPDKKGL	LPQPDKKGL
VPRGQGSQF	VPRGQGSQF
YPSAYIKVF	YPSAYIKVF
RPSLNIATVL	RPSLNITVL
RPMYSKPSI	RPMYSKPSI
MPPPINPIL	MPPPINPIL
APKPTLLWL	APKPTLLWL
TPTSAPRSVM	TPTSAPRSV
HPHAVNEIAL	HPHAVNIAL
FPQEVKDLL	FPQEVKDLL
IPHIHKSL	IPHIH-KSL
APAQPQPQL	APAQPQPQL
TPQRLFAL	TPQRL-FAL
NPHDRVVAL	NPHDRVVAL
TPVAGSQSL	TPVAGSQSL
APKKSATQF	APKKSATQF
RPPDTKATL	RPPDTKATL
IPEAGKALL	IPEAGKALL
FPRRAQPKM	FPRRAQPKM
SVKTPKISM	SVKTPKISM
WPKDVGIVAL	WPKDVGVAL
LPDLQRSKQAL	LPDLQRQAL
RPFPKLRIL	RPFPKLRIL
RPSERPSL	RPSER-PSL
IPKVQHVIHY	IPKVQ-HVI
APADTSDPL	APADTSDPL
RPQDQTVVF	RPQDQTVVF
RPSTGLLRHIL	RPSTGLRHI
KPTPVKPNYAL	TPVKPNYAL
LPQDKKEYRL	LPQDKKYRL
TPTGYIESL	TPTGYIESL
NPTWKRFSV	NPTWKRFSV
VPHPVSRPL	VPHPVSRPL
LPLFPEPLHVF	LPLFP-EPL
KPNGKVASVEM	KPNGKVASV
APKPEENPSL	APKPEEPSL
APEDKKEIL	APEDKKEIL
SSALRVNPAL	SALRVNPAL
SPNNPFSRVAL	SPNNPFSRV
KIRPHIATL	KIRPHIATL
SPQELYEL	SPQEL-YEL
LPQNEPKTL	LPQNEPKTL
MPSSSGSARSL	SSSGSARSL
SPLAVDEAL	SPLAVDEAL
APRDSYHLV	APRDSYHLV
MPRGIYHSAL	MPRGIYSAL
HPAGPRTVF	HPAGPRTVF
TPKLFHEVV	TPKLFHEVV
RPDDKRILEF	RPDDKRLEF
KPAKPQPKL	KPAKPQPKL
NPKPASPRF	NPKPASPRF
RPLGKAASL	RPLGKAASL
KPYVRVTM	KPYVR-VTM
LPPGLAVKEL	LPPGLAKEL
FPKGYRHPAL	FPKGYRPAL
RPKTVRDTL	RPKTVRDTL
VPAPSANKEL	VPAPSAKEL
SPSGAMSNL	SPSGAMSNL
APRLQSEVA	APRLQSEVA
APMNVRRGL	APMNVRRGL
RPALPRSEL	RPALPRSEL
SPQGVSKTL	SPQGVSKTL
VPWKEVLL	VPWKE-VLL
NPKGRIWTM	NPKGRIWTM
HPMKPHRLAL	HPMKPHLAL
TPHFSGLAA	TPHFSGLAA
IPAEGRVAL	IPAEGRVAL
HPNKPKDHVF	HPNKPKHVF
RPENYREAL	RPENYREAL
GPKVGVEV	GPKVG-VEV
SPKVNKDTL	SPKVNKDTL
APYFRLLRL	APYFRLLRL
IPRRQEHDISL	RRQEHDISL
APLFTAEAL	APLFTAEAL
KPTHVVVTL	KPTHVVVTL
YPNVNIHNF	YPNVNIHNF
VPKAQKETV	VPKAQKETV
TPYGRPANI	TPYGRPANI
IVKPVKVSA	IVKPVKVSA
TGPRVGEAL	TGPRVGEAL
IPKKEIHTV	IPKKEIHTV
RPEPATGYTL	RPEPATYTL
APELQRHEL	APELQRHEL
TPKIGAISSL	TPKIGASSL
VPRSPVREL	VPRSPVREL
NAKDFFRVL	NAKDFFRVL
RPAGKDMMRKL	RPAGK-DMM
AGPARLSPAA	GPARLSPAA
QPVAGRPSL	QPVAGRPSL
VPSEPKLSL	VPSEPKLSL
KPEIRVTSL	KPEIRVTSL
APAAAGAAL	APAAAGAAL
YAKKRGWVL	YAKKRGWVL
LPALPLAEL	LPALPLAEL
SPKSMSNKL	SPKSMSNKL
VPKTASTSF	VPKTASTSF
APRAAREAL	APRAAREAL
MPKAEKNAV	MPKAEKNAV
SPFNDRFPL	SPFNDRFPL
HPKKPGPSL	HPKKPGPSL
SPNSYFMDV	SPNSYFMDV
MPNPQLNIKAL	NPQLNIKAL
GVSSSHVRVL	VSSSHVRVL
TPQMPTQAM	TPQMPTQAM
VPYGTPLSV	VPYGTPLSV
RVMNVHKML	RVMNVHKML
LIKEGGVQL	LIKEGGVQL
RPAQLHIGF	RPAQLHIGF
APYFKPKV	APYFK-PKV
FPKEPVEL	FPKEP-VEL
MPSPVSPKL	MPSPVSPKL
APRADEITRRL	RADEITRRL
RPQEVPAEAL	RPQEVPEAL
AVDPNRAVPL	AVDPNRVPL
KPSGVSAAL	KPSGVSAAL
SPLAFEHVM	SPLAFEHVM
APKRPPSAF	APKRPPSAF
LPKLHIVKV	LPKLHIVKV
SPPAPHPTL	SPPAPHPTL
HPFYTRAATM	HPFYTRATM
APGPSGQSV	APGPSGQSV
MPTPVIKAF	MPTPVIKAF
HPRYNLIVV	HPRYNLIVV
VPYEKGFAL	VPYEKGFAL
IPMSDPQVL	IPMSDPQVL
TPTQGSVL	TPTQG-SVL
KPNDSRALQLM	KPNDSRLQL
RPGPVLPAV	RPGPVLPAV
APTPVPAL	APTPV-PAL
AEFAEVSK	AEFAE-VSK
RPKLPDNEV	RPKLPDNEV
AAKAAGVSF	AAKAAGVSF
SAPPPKKSL	SAPPPKKSL
SPHSVINIF	SPHSVINIF
LPKDQQITAL	LPKDQQTAL
LPRPVPQNL	LPRPVPQNL
KPSFARTVL	KPSFARTVL
KPKPPAPEDL	KPKPPAEDL
SAPVGVTAL	SAPVGVTAL
SPLLKQYIL	SPLLKQYIL
LPKSIYSQI	LPKSIYSQI
IPWNHIRL	IPWNH-IRL
APTPLRPGF	APTPLRPGF
IPRNQLQSV	IPRNQLQSV
APSLVAPAL	APSLVAPAL
RPKTVRDTLL	RPKTVRDTL
YPLESRPSL	YPLESRPSL
TPRPMTAEL	TPRPMTAEL
LPPGKIVAL	LPPGKIVAL
TPRPGQEL	TPRPG-QEL
SPWLLRVEL	SPWLLRVEL
APYERRAM	APYER-RAM
APREPPPVEL	APREPPVEL
IPNNVKTAV	IPNNVKTAV
KPADRVNVTV	KPADRVVTV
TPLPAGHMI	TPLPAGHMI
LPKVQSIQL	LPKVQSIQL
VPSAGLRLFAL	VPSAGLRLF
TPRGPDPALL	TPRGPDPAL
IPESKLTSL	IPESKLTSL
VPRFQAVQI	VPRFQAVQI
IPKEKFWKI	IPKEKFWKI
MPNNSLTPSL	MPNNSLPSL
SPAGSIVHEL	SPAGSIHEL
TPAPHEPVKTL	APHEPVKTL
YPNSHTHYF	YPNSHTHYF
APKVSPEAV	APKVSPEAV
SPKKPGREIEL	SPKKPGREI
RPNGTKVAVL	RPNGTKAVL
RPKTPPVVI	RPKTPPVVI
LPKPPFGML	LPKPPFGML
LPSESMKVV	LPSESMKVV
MPNGDHIVSA	MPNGDHVSA
APAAYPREVAL	AAYPREVAL
VPQAKPVAV	VPQAKPVAV
VPMEIKPGISL	VPMEIKPGI
SPKPPVAVK	SPKPPVAVK
SPPTKFLEL	SPPTKFLEL
IPIKKSDPV	IPIKKSDPV
FPKKLLEL	FPKKL-LEL
APSGQHSQAQL	APSGQHSQA
RPKAAIMETL	RPKAAIETL
GVSVKKGHEL	SVKKG-HEL
VPDEHFSTL	VPDEHFSTL
DAIKLNPRL	DAIKLNPRL
LPKPFFRLL	LPKPFFRLL
QISEVKPVL	QISEVKPVL
RPFDKLEQL	RPFDKLEQL
SPQKKNHLVL	SPQKKNLVL
FPKWFHEGL	FPKWFHEGL
TPMGPGRTV	TPMGPGRTV
QPTFTEHLL	QPTFTEHLL
NPKSSFWKL	NPKSSFWKL
RPILTIITL	RPILTIITL
NIKAHIHML	NIKAHIHML
VPLVRPVTM	VPLVRPVTM
SPYQNIKIL	SPYQNIKIL
PKPGGAHSL	PKPGGAHSL
SPKPQIQAF	SPKPQIQAF
KPKHQPYKL	KPKHQPYKL
QPRIQNPKF	QPRIQNPKF
APRPAGSYL	APRPAGSYL
RPKSSQIGAVV	RPKSSQGAV
SVPEAQSAL	SVPEAQSAL
VPNPRIKLIDF	VPNPRIKLI
APSTIIFHL	APSTIIFHL
APKRPPSAFF	APKRPPSAF
EPRPPHGEL	EPRPPHGEL
YPYLGPSTL	YPYLGPSTL
TPKRPSTSQTV	TPKRPSTSQ
APSSPRPALP	APSSPRPAL
QPFSAKDLSI	QPFSAKLSI
RPRPTEATVSL	RPTEATVSL
NVKNIIIAL	NVKNIIIAL
LPAPKGPAL	LPAPKGPAL
KPKNIVEKI	KPKNIVEKI
NPQKVGKDHTL	NPQKVGHTL
RPAPVAVAA	RPAPVAVAA
SPYKRDNTF	SPYKRDNTF
SPWLHAPSL	SPWLHAPSL
SPRIYSNSL	SPRIYSNSL
SPHGHILVL	SPHGHILVL
VPSLIKQQVL	VPSLIKQVL
PKRIAKAVN	PKRIAKAVN
RPGLLNSKL	RPGLLNSKL
KPSQITGTVF	KPSQITTVF
APNYRLKSL	APNYRLKSL
VPRPPPLYSH	VPRPPPYSH
YPKRPLLGL	YPKRPLLGL
IPYHSEVPVSL	IPYHSEVPV
APAAAPSSL	APAAAPSSL
RLKPPPPVAI	RLKPPPVAI
APRKPDWDL	APRKPDWDL
MPKMKMPTF	MPKMKMPTF
SPLDMKDGFL	SPLDMKDGF
RPPLKKYSF	RPPLKKYSF
RPRPDPSPEI	RPRPDPPEI
VPNPMVHPSF	VPNPMVPSF
LPFFNDRPW	LPFFNDRPW
HPEPPKAEL	HPEPPKAEL
HPHSGSGRSVL	HPHSGSRSV
TVKVHVVAL	TVKVHVVAL
SPALPGLKL	SPALPGLKL
MPSVFQNVL	MPSVFQNVL
APKPQGTKI	APKPQGTKI
YPNPLPVL	YPNPL-PVL
RPIFPGKHYL	RPIFPGHYL
RPLEMIEPRTL	RPLEMIRTL
RPALFANLF	RPALFANLF
HPYNPHPGF	HPYNPHPGF
RPKPIITSV	RPKPIITSV
KPIEPRRELL	KPIEPRREL
ITKPPDGSA	ITKPPDGSA
HPMNSISSL	HPMNSISSL
APAAAVPTL	APAAAVPTL
RPSTRIQQQL	RPSTRIQQL
KVKEFFEKL	KVKEFFEKL
IPLPHGTHTF	IPLPHGHTF
SPLYLAHEV	SPLYLAHEV
IPKVTKTSAL	IPKVTKSAL
EPRHEFPEL	EPRHEFPEL
QLQEERPEL	QLQEERPEL
IVSNTLVRAL	IVSNTLRAL
FPKRPKHML	FPKRPKHML
NPNKTQPIL	NPNKTQPIL
IPRILGPGL	IPRILGPGL
PAEPKLAF	PAEPK-LAF
SVMDKQYEIL	SVMDKQEIL
RPLVVIHEL	RPLVVIHEL
TPAPPGPATM	TPAPPGPAT
IPKNVATET	IPKNVATET
LPPPPPHAL	LPPPPPHAL
TARPPGYEF	TARPPGYEF
SPKPPSQQL	SPKPPSQQL
PKFEVIEKPQA	EVIEK-PQA
VPSVSSISRIL	SVSSISRIL
RPKPPNVRTA	RPKPPNRTA
RPTDVAISF	RPTDVAISF
VPSPKVVL	VPSPK-VVL
GPREQEPEL	GPREQEPEL
RPHNLPVV	RPHNL-PVV
MPQNPHIIAT	MPQNPHIIA
KPSESIYSAL	KPSESISAL
QPYLTHRL	QPYLT-HRL
APDEAAEAL	APDEAAEAL
RPYYPRKAL	RPYYPRKAL
RVKPYIRTSL	RVKPYITSL
SPKGHLTRL	SPKGHLTRL
LPNEQTKTL	LPNEQTKTL
APMSPSTAL	APMSPSTAL
APAAATVAV	APAAATVAV
IPQQLLTTL	IPQQLLTTL
MPHPATGKTV	MPHPATKTV
RPRPPQKAL	RPRPPQKAL
APYGGPIAL	APYGGPIAL
APAPVQPPM	APAPVQPPM
KPMEGWIAV	KPMEGWIAV
TPIPGTIEM	TPIPGTIEM
PEAKKPRL	PEAKK-PRL
RPKLNEGVVEF	RPKLNEGVV
RPADVIFAT	RPADVIFAT
LPKLHIVQV	LPKLHIVQV
LPKKLALL	LPKKL-ALL
KPRGFARGL	KPRGFARGL
RNKEVTWEVL	RNKEVTEVL
RPALQHVVKVL	RPALQHVKV
KPADVIGKSM	KPADVIKSM
SPKEPEQL	SPKEP-EQL
HPRPPIPLSL	HPRPPILSL
KPNDVSVFTTL	KPNDV-SVF
QPNTTGKQL	QPNTTGKQL
LPKEKQPVA	LPKEKQPVA
IPKDYKTMAAL	IPKDY-KTM
APAPSKGQTL	APAPSKQTL
LKERDFEIK	LKERDFEIK
FPMEIRQYL	FPMEIRQYL
IPDASKLQFIL	IPDASKLQF
QPGRPLRVV	QPGRPLRVV
APQAKQRAEVL	APQAKQAEV
APLAVFQML	APLAVFQML
SPRPNHSYIF	SPRPNHSYI
MPMERQMSV	MPMERQMSV
IPKSAVGTL	IPKSAVGTL
TPISRLVAL	TPISRLVAL
APQPIRNIVF	APQPIRIVF
NPLPSKETI	NPLPSKETI
PQRVRVTL	PQRVR-VTL
LPSWGRAEL	LPSWGRAEL
EPSDAIRVV	EPSDAIRVV
RPHPKPKQF	RPHPKPKQF
SPKLPVSSLGL	SPKLPVSSL
HPRTSITVVL	HPRTSIVVL
LPKPPGRGV	LPKPPGRGV
KPKPIDVQVI	KPKPIDVQV
KPADLARHL	KPADLARHL
LPNQVLKSI	LPNQVLKSI
RPHAPHSPIKF	RPHAPHSPI
RPGDLHVVL	RPGDLHVVL
SPRAPVQVI	SPRAPVQVI
RPKSNIVLLS	RPKSNIVLL
FPQKLRPRLL	FPQKLRPRL
VPFHRVDTI	VPFHRVDTI
SPKSTGSVRQL	SPKSTGRQL
VPLPPGKPAL	VPLPPGPAL
RIKLYSESL	RIKLYSESL
RPAQVSQPF	RPAQVSQPF
VPNDRPTWHIL	VPNDR-PTW
VPPEQAKVV	VPPEQAKVV
LPRPPPPEM	LPRPPPPEM
RPENRSFYL	RPENRSFYL
SPQGLKPVV	SPQGLKPVV
LPTSPGPAL	LPTSPGPAL
HPKYPDGKTF	HPKYPDKTF
SPKSTVESF	SPKSTVESF
YPAERKQAL	YPAERKQAL
VPKEGKVV	VPKEG-KVV
HPFLQRQQL	HPFLQRQQL
APLNEAMAVL	APLNEAAVL
TPIQGTSEL	TPIQGTSEL
VPATDRNAL	VPATDRNAL
APVQRPKL	APVQR-PKL
LPRKQGSIL	LPRKQGSIL
QPSEVLRTV	QPSEVLRTV
HPRSPTPTL	HPRSPTPTL
IPFERDQEIL	IPFERDEIL
GMGQKDSYVGD	GQKDSYVGD
KVSYVIKKL	KVSYVIKKL
VPKPPSIEEF	VPKPPSEEF
VPRPPDTVST	VPRPPDVST
VPDTSRIYVAL	VPDTSRIYV
SPKTTISVA	SPKTTISVA
SPEVPKPAL	SPEVPKPAL
SPQDLRRRL	SPQDLRRRL
RPGGDYNTSL	RPGGDYTSL
SPAVLRPI	SPAVL-RPI
SPQDTFEAL	SPQDTFEAL
VVKPPGQDL	VVKPPGQDL
TVKPPTSVA	TVKPPTSVA
SVKAQVTSL	SVKAQVTSL
FPRDPEIEM	FPRDPEIEM
LPKKDIIKF	LPKKDIIKF
LPQSTDPLRTF	LPQST-DPL
RPKSAFKVQ	RPKSAFKVQ
NPHEPWNRL	NPHEPWNRL
TAKRSGAVF	TAKRSGAVF
SPGKGVVSL	SPGKGVVSL
MPLLKSEVA	MPLLKSEVA
APRYSAPVI	APRYSAPVI
MPSQFRDIL	MPSQFRDIL
FPKIPPHSL	FPKIPPHSL
APKSPSSEWL	APKSPSEWL
LPVGRSVDETL	LPVGRSETL
DPFNPFELTNH	DPFNP-FEL
LAYLQRIAL	LAYLQRIAL
MIKGVTLGF	MIKGVTLGF
RPTTGNTL	RPTTG-NTL
KPVIPAAAL	KPVIPAAAL
KPANAVLHKVL	KPANAVHKV
MPTIPALAL	MPTIPALAL
TPMSSHGRVL	TPMSSHRVL
KPPVSITKKKL	PPVSITKKL
RPRPWRGNTL	RPRPWRNTL
IPLAKRVAL	IPLAKRVAL
SPSPINSSQAL	SPINSSQAL
SPQAEQPSL	SPQAEQPSL
QPFSKGDRL	QPFSKGDRL
SPKSYLEIL	SPKSYLEIL
YPPWPGKIV	YPPWPGKIV
VPSNSHLVLVL	VPSNSHLVL
HIKDSFHSL	HIKDSFHSL
RPKIPDPEAV	RPKIPDEAV
FPRDKLAEL	FPRDKLAEL
FPNKQGYVL	FPNKQGYVL
APRIALHTAL	APRIALTAL
LPKLGVHKV	LPKLGVHKV
RPKASGATERL	RPKASGERL
SPTQLPIL	SPTQL-PIL
RPQVKSLGM	RPQVKSLGM
YPASAGTSL	YPASAGTSL
TAKPQSTTSL	TAKPQSTSL
RPYSQVNVL	RPYSQVNVL
TPSAVFRVW	TPSAVFRVW
MPNSPAPHF	MPNSPAPHF
VPENKGISL	VPENKGISL
SPAHAVDAV	SPAHAVDAV
TPGLVSPAL	TPGLVSPAL
FPNIPGKSL	FPNIPGKSL
APASRLLAL	APASRLLAL
SPHLQYIAF	SPHLQYIAF
IPKKNILLTI	IPKKNILTI
LPWASTHSL	LPWASTHSL
APPPVVGAKRL	PPPVVGKRL
SPNGLYVL	SPNGL-YVL
HPRGGVIQSV	HPRGGVQSV
TPLARGDTL	TPLARGDTL
HPSGATPTL	HPSGATPTL
SPASSTTARVI	SPASSTARV
MPESGVAL	MPESG-VAL
LPASVHPQL	LPASVHPQL
RPLKGRINL	RPLKGRINL
IPKVEWSAF	IPKVEWSAF
SPRPKMDAI	SPRPKMDAI
MPQDLSEAL	MPQDLSEAL
KPFAGRPMI	KPFAGRPMI
APHLSKVSM	APHLSKVSM
VPHPNWPNHTL	HPNWPNHTL
TPMLKEGGISM	MLKEGGISM
TPHDFIEHIL	TPHDFIHIL
RTKASVHTL	RTKASVHTL
HPISSEELLSL	HPISSEELL
APKYGSYNVF	APKYGSNVF
SPILVATAV	SPILVATAV
YPQEVIPTF	YPQEVIPTF
TVKPNANRIAL	KPNANRIAL
APYERRAMEL	APYERRMEL
QPLGTLPQAVM	QPLGTLQAV
RAKPEDRESL	RAKPEDESL
LPLSAANITL	LPLSAAITL
APLGGTPTL	APLGGTPTL
RAAPHRISL	RAAPHRISL
APGLIGNVM	APGLIGNVM
SPSEILQEL	SPSEILQEL
LPDSGGVAKTM	LPDSGGVAK
APLPPYFSRTL	LPPYFSRTL
IPNERTMQLL	IPNERTMQL
KPATKTAEL	KPATKTAEL
APKIGPLGL	APKIGPLGL
RPKQEKAFSL	RPKQEKFSL
SPGEFSVSV	SPGEFSVSV
SPIEKSGVL	SPIEKSGVL
LPAAAMARAM	LPAAAMRAM
RPVPPPPSL	RPVPPPPSL
SPKPGTGEPVL	SPKPGTEPV
TPQSVNSGKTF	TPQSVNKTF
TPMLLRAL	TPMLL-RAL
RPDLRMAAI	RPDLRMAAI
HPMYGAGHKF	HPMYGAHKF
IPMAKSYVL	IPMAKSYVL
NPQEVGPLL	NPQEVGPLL
APHAPGPPA	APHAPGPPA
APGPGRKEL	APGPGRKEL
APIDRVGQTI	APIDRVQTI
FPKKALVVTI	FPKKALVTI
KPHFRNTVERM	KPHFR-NTV
SPQASIIAM	SPQASIIAM
TPAPSRTASF	TPAPSRASF
IPKEIIEKL	IPKEIIEKL
RPYAAGGKKL	RPYAAGKKL
APVGRDAETL	APVGRDETL
SVSPVVRVA	SVSPVVRVA
QPLARPNTL	QPLARPNTL
MPRPLPYHL	MPRPLPYHL
MPPFQRKTL	MPPFQRKTL
RPKPDYFAV	RPKPDYFAV
RPNNAYTAM	RPNNAYTAM
VPIPVKESI	VPIPVKESI
TPHLRNLAV	TPHLRNLAV
KAYERGISL	KAYERGISL
APNLGRSFHIL	APNLG-RSF
VPFEKKDFVGL	VPFEKKDFV
KPEGKDYAL	KPEGKDYAL
RPFHGWTSL	RPFHGWTSL
APHWRMKQL	APHWRMKQL
QPYNSRPAV	QPYNSRPAV
SPSSILSTL	SPSSILSTL
SPMEEREKL	SPMEEREKL
SPQPWGHML	SPQPWGHML
FPNIVIKGSEL	FPNIVISEL
APRTVALTAL	APRTVATAL
SPKPWIPVL	SPKPWIPVL
SPQPRLIYL	SPQPRLIYL
KPQHVFSVL	KPQHVFSVL
HPNGNITEL	HPNGNITEL
APPTETKSL	APPTETKSL
QVAVHKIYQQL	AVHKIYQQL
KPKSAPWNSF	KPKSAPNSF
RPNPILARLL	RPNPILARL
LPKAKLITL	LPKAKLITL
KPHEGIIHSL	KPHEGIHSL
APQPAKPRL	APQPAKPRL
SARPADEIAV	RPADE-IAV
SPYIRTKL	SPYIR-TKL
HPISDHEATL	HPISDHATL
RPSQVVAET	RPSQVVAET
SPLGSPEL	SPLGS-PEL
RVSHSHVGYTL	VSHSHVYTL
APPRPGSSF	APPRPGSSF
RIKLGIKSL	RIKLGIKSL
APLALHLL	APLAL-HLL
RPRQTPFAEKL	RPRQTPEKL
IPKHINPVA	IPKHINPVA
SPLRPQNYL	SPLRPQNYL
VPMFRNVSL	VPMFRNVSL
FPTVQHQEL	FPTVQHQEL
RPRNALLLL	RPRNALLLL
IPTGEGPPL	IPTGEGPPL
KPFAEVRIL	KPFAEVRIL
RPRKAFLLLL	RPRKAFLLL
NADPLKVYPPL	DPLKVYPPL
SPFPLEAV	SPFPL-EAV
TPKWITPVLL	TPKWITPVL
VPVLNTKKAL	VPVLNTKAL
HLAAPKLGVAL	APKLG-VAL
APKAVWLPAM	APKAVWPAM
SPRSSTVHIL	SPRSSTHIL
NPKNPGLWL	NPKNPGLWL
IIRENSISL	IIRENSISL
LPKPSSHGL	LPKPSSHGL
LPKTGTVSL	LPKTGTVSL
LSSPKLPVSSL	SPKLPVSSL
RPSQAAPAV	RPSQAAPAV
IPGLNLNAL	IPGLNLNAL
LVKEYIIQL	LVKEYIIQL
LPKEKRHVL	LPKEKRHVL
KIKPNNPKHTL	KPNNPKHTL
RPKPKIIQT	RPKPKIIQT
RPEERPTFEFL	RPEER-PTF
APFDREPFTL	APFDREFTL
HPYPPGPGVAL	YPPGPGVAL
VPIPNSPFKVA	IPNSPFKVA
APKYILEQF	APKYILEQF
HPRPAHKAIL	HPRPAHKAI
MPKVSGPDLDL	MPKVSGPDL
HPAARMLVEL	HPAARMVEL
RPAYRKVFL	RPAYRKVFL
IPELHRPVV	IPELHRPVV
KPTDKLRAL	KPTDKLRAL
RPKTPFKAW	RPKTPFKAW
RPMKVGHVT	RPMKVGHVT
APMSEPRVL	APMSEPRVL
APKLPERTVL	APKLPETVL
ILMEHIHKL	ILMEHIHKL
FPQHLRHLL	FPQHLRHLL
LPKTHIEQI	LPKTHIEQI
RPLPAQDLF	RPLPAQDLF
IPNERTMQL	IPNERTMQL
RPKQPDKEGKL	RPKQPDEGK
SPWADNTAL	SPWADNTAL
IARLPSSTL	IARLPSSTL
LPWPARPAL	LPWPARPAL
LAKNFFNEL	LAKNFFNEL
RPLSKTVRF	RPLSKTVRF
SPISSNSHRSL	ISSNSHRSL
MPANMDKHAL	MPANMDHAL
SPAHPKQTL	SPAHPKQTL
APMSAAHQL	APMSAAHQL
RPRKAFLL	RPRKA-FLL
APVGVHPSL	APVGVHPSL
IPYKREESL	IPYKREESL
SPWKRQIDL	SPWKRQIDL
RPGRADPRF	RPGRADPRF
IPKEHHRFV	IPKEHHRFV
SSPKLPVSSL	SPKLPVSSL
APEVTREEL	APEVTREEL
SPKQWLPLEVL	SPKQWLLEV
NPKNQSETL	NPKNQSETL
LPKSPNPSF	LPKSPNPSF
IPLAKDFYVAF	LAKDFYVAF
RPQAVQGGKAL	RPQAVQKAL
VVKMPSGEF	VVKMPSGEF
SPNAIFKAL	SPNAIFKAL
QVQGPRPVL	QVQGPRPVL
RPADSMLNVL	RPADSMNVL
NPASKVIAL	NPASKVIAL
VPQESRFNL	VPQESRFNL
PPEVSKKL	PPEVS-KKL
RLKAFKVAL	RLKAFKVAL
RPAFPVKKL	RPAFPVKKL
APQAPGDNHVV	APQAPGNHV
HPYGHRKFITM	HPYGHRKFI
IPASGLHLF	IPASGLHLF
APSGLRSQVQF	APSGLRSQV
KPYLPSRAL	KPYLPSRAL
RPKLIGEEL	RPKLIGEEL
IPANPPMAF	IPANPPMAF
SPPELKRPRL	SPPELKPRL
KPPNPALGKTA	PPNPALKTA
KPKPKKPTL	KPKPKKPTL
NPWKREVKL	NPWKREVKL
SPEPTREQL	SPEPTREQL
FPRTAAPGHDL	RTAAPGHDL
TPTEKPKLL	TPTEKPKLL
QPKKVKGVGF	QPKKVKVGF
SVKTKFYVL	SVKTKFYVL
LVMAPRTVL	LVMAPRTVL
GPESRTISL	GPESRTISL
APRGPGAEL	APRGPGAEL
TPSEPHPVL	TPSEPHPVL
RPNSIDPAL	RPNSIDPAL
KPKWNHLVHKF	KPKWN-HLV
RPSAAGINL	RPSAAGINL
SPQANRTYV	SPQANRTYV
MTQQPRPVL	MTQQPRPVL
QPSSSLSARMM	QPSSSLARM
IPKNSPPTL	IPKNSPPTL
QPYAGFVL	QPYAG-FVL
SPKASSKLAIM	SPKASSLAI
SPLSAARAAL	SPLSAAAAL
LVKKYMNSL	LVKKYMNSL
NPNHRTPTL	NPNHRTPTL
SPKAPDPEGL	SPKAPDEGL
SPSLPTASL	SPSLPTASL
TIKDMMFQL	TIKDMMFQL
QPPELGRPL	QPPELGRPL
IAKAYPPTSM	IAKAYPTSM
NPRQAAYEM	NPRQAAYEM
SPQEFIHEL	SPQEFIHEL
LPAAANSRKQF	AAANSRKQF
RPQPQTLQL	RPQPQTLQL
SPNTDREVL	SPNTDREVL
SPEEKQEML	SPEEKQEML
PASSKPISI	PASSKPISI
SPSPSDPVL	SPSPSDPVL
VPKKAWRKL	VPKKAWRKL
VPRPPSNPPA	VPRPPSPPA
FPMELRQFL	FPMELRQFL
APEERPAAL	APEERPAAL
GPRAPGPSL	GPRAPGPSL
APVSPRPGL	APVSPRPGL
SPVDNTPSHQL	SPVDNTPSH
RPKDMDPRLI	RPKDMDPRL
SPRPALPALL	SPRPALPAL
YPLILKEL	YPLIL-KEL
TPVASRQSL	TPVASRQSL
KPYKNDPEIL	KPYKNDEIL
QPPGAAKPAL	PPGAAKPAL
YPNPYSKHVL	YPNPYSHVL
SPKPLLTGL	SPKPLLTGL
SPEQSRNVL	SPEQSRNVL
SPSDRPLSL	SPSDRPLSL
LPFPPGVPT	LPFPPGVPT
APNPAKATVTA	APNPAKATV
VPKGNTAVSV	VPKGNTVSV
VVMNVVHQL	VVMNVVHQL
SPPPPAIAV	SPPPPAIAV
VPRPVLRALSF	VPRPVLRAL
KPKSEMTPEEL	KPKSEMEEL
RPKGESKDLL	RPKGESKDL
RLKPPSNVV	RLKPPSNVV
SPKDVILKV	SPKDVILKV
APFGPIKSI	APFGPIKSI
IPRAKAEEM	IPRAKAEEM
RPRPDEERPL	RPRPDERPL
KPHNPGFGM	KPHNPGFGM
HPKNPHAPTI	HPKNPHPTI
TPAWVRQVL	TPAWVRQVL
VPRLPATAA	VPRLPATAA
HLPETKFSEL	LPETKFSEL
MPQDLRSPA	MPQDLRSPA
IPKKHISQI	IPKKHISQI
RPRLQHSFSF	RPRLQ-HSF
LPMGALPQGPM	LPMGALPQG
KPKITPVTV	KPKITPVTV
KPKIATANL	KPKIATANL
RPPPIGAEV	RPPPIGAEV
RPNPGFSML	RPNPGFSML
PSEERVREI	PSEERVREI
TPSLVKSTSQL	LVKST-SQL
IPMPGHPVNF	IPMPGHVNF
RPADVYSYKQV	RPADVYSYK
MPYSNGRPAL	MPYSNGPAL
HPINPRVAL	HPINPRVAL
SPYSKSGPAL	SPYSKSPAL
TPNETISTL	TPNETISTL
SPFARGNVF	SPFARGNVF
QPITTPQYHQL	ITTPQYHQL
LPAEVKEQI	LPAEVKEQI
VPLGAGIAL	VPLGAGIAL
HPYLFPVAA	HPYLFPVAA
MPKISMPGF	MPKISMPGF
RPAPPREEI	RPAPPREEI
APLPSIKEI	APLPSIKEI
RPSEKNQHIM	RPSEKNQHI
APKSPSQDV	APKSPSQDV
RPSHFLNFALL	RPSHFLFAL
SPLYSPVSF	SPLYSPVSF
TAYTRQQVL	TAYTRQQVL
KIRPHITTL	KIRPHITTL
VPKLVKEEV	VPKLVKEEV
SPNDFSVSL	SPNDFSVSL
RPSDEVIREL	RPSDEVREL
APYFKGTAVV	APYFKGTAV
FVKKIGGIF	FVKKIGGIF
HPYIQYNVL	HPYIQYNVL
APRVPVQAL	APRVPVQAL
MPEPTVLSL	MPEPTVLSL
IPVSRDWELL	IPVSRDWEL
IPLSKIKTL	IPLSKIKTL
QPKLPITVL	QPKLPITVL
SPSEIVKQI	SPSEIVKQI
TPEERDARTVF	TPEERDRTV
SPNKLYTL	SPNKL-YTL
VPRTIGAEL	VPRTIGAEL
APQLPNPEV	APQLPNPEV
KVRVPRQSL	KVRVPRQSL
TPVPIKDMEI	TPVPIKMEI
RPNPILARL	RPNPILARL
LPKSQVTDTL	LPKSQVDTL
LPQLTGPVL	LPQLTGPVL
APGLGPRAV	APGLGPRAV
KPRPPQGL	KPRPP-QGL
FPVGRVHRL	FPVGRVHRL
VPEEARPAL	VPEEARPAL
HPRDPNLLLSV	HPRDPNLLL
TPAKAIAAV	TPAKAIAAV
SPRPVVVET	SPRPVVVET
IPKEVADIF	IPKEVADIF
AAKRSGLAV	AAKRSGLAV
MPADSGYPA	MPADSGYPA
TPRPGSHTI	TPRPGSHTI
APMGREGVTAM	APMGREVTA
GPQEKKVVV	GPQEKKVVV
VPVNHTQVM	VPVNHTQVM
APKPPFQSHF	APKPPFQSH
KPRDVSSVEL	KPRDVSVEL
VPFHLHINL	VPFHLHINL
NPKSLTTSL	NPKSLTTSL
GPKAHIRKL	GPKAHIRKL
RPHAPGRPA	RPHAPGRPA
GPNSNIRTV	GPNSNIRTV
NPNLRKNVL	NPNLRKNVL
IPPPGGTSL	IPPPGGTSL
YPVPASKRPPL	VPASKRPPL
SPREEPRAPW	SPREEPRAP
HPKRPLLAF	HPKRPLLAF
IPGMGGNSL	IPGMGGNSL
KPTGTPKAL	KPTGTPKAL
VPKAPGFAQM	VPKAPGAQM
FPKAAIKRL	FPKAAIKRL
VPSEGKKSL	VPSEGKKSL
SPHPAATAL	SPHPAATAL
TPKPSFFDF	TPKPSFFDF
APFQGDQRSL	APFQGDRSL
SPNSKVNTL	SPNSKVNTL
NPKEFFWNV	NPKEFFWNV
TPEEKLAAL	TPEEKLAAL
KPRNVVFVDM	KPRNVVVDM
IPKGRPPKL	IPKGRPPKL
VPKPFRPIL	VPKPFRPIL
RPALQHVVKV	RPALQHVKV
KPFSQHVRKL	KPFSQHRKL
GPNAVIFTL	GPNAVIFTL
KPPALSKGL	KPPALSKGL
TPGTSTTPGLR	TPGTSTPGL
KPNHTLVLL	KPNHTLVLL
LPPLPKRPAL	LPPLPKPAL
ILKDNLAI	ILKDN-LAI
AKNKLNDLED	AKNKL-NDL
RPAEVGGMQL	RPAEVGMQL
LPKYGVKV	LPKYG-VKV
VPQQAIDSHSV	VPQQAIDSH
VPHGHITSL	VPHGHITSL
KPKFSGVEKI	KPKFSGEKI
RPQEVSAYL	RPQEVSAYL
LPRGRKQLAL	LPRGRKLAL
SPDLGKNLQTL	SPDLG-KNL
LPKEIGELTQL	LPKEI-GEL
KPVEKNYAF	KPVEKNYAF
LPQRVLEQHKL	RVLEQ-HKL
SPPPAKKLAL	SPPPAKLAL
FPRTPARSV	FPRTPARSV
QPITPGPSI	QPITPGPSI
IPLKPSPSKKF	IPLKPSPSK
KPYQGNPTF	KPYQGNPTF
RPRPSGEEVL	RPRPSGEVL
IPMDPEHVEL	IPMDPEVEL
LPKDQGITL	LPKDQGITL
APGIRSWSL	APGIRSWSL
AGAAVRIGSVL	AAVRIGSVL
LPSSVISAI	LPSSVISAI
VPRLKTWLL	VPRLKTWLL
TPSPIIQQL	TPSPIIQQL
IPSADRHKSKL	SADRHKSKL
TPRRPAGLL	TPRRPAGLL
HEVKKVTL	HEVKK-VTL
MPYGSRENSL	MPYGSRNSL
TPQGFRSTL	TPQGFRSTL
RPKGFYVET	RPKGFYVET
LPYNGVVL	LPYNG-VVL
TPYNGTEAL	TPYNGTEAL
APKGTKRDPAL	APKGTKPAL
PAYHSSLMD	PAYHSSLMD
SPNYDHVVL	SPNYDHVVL
IPQPTPASL	IPQPTPASL
HPPYLVSKEL	PPYLVSKEL
SPGVVHLVAF	SPGVVHVAF
MPVEKNITL	MPVEKNITL
IPKPSKDGVTV	KPSKDGVTV
LPSGVTRVV	LPSGVTRVV
RPGHKPSIL	RPGHKPSIL
APAARAPQAL	APAARAQAL
MPGKTAIEL	MPGKTAIEL
KPRKLVNTI	KPRKLVNTI
SPNRSFTEM	SPNRSFTEM
TPMPKDVRQSL	MPKDVRQSL
KVKEKFQQL	KVKEKFQQL
SPKLSNKEL	SPKLSNKEL
NPEVRRAVL	NPEVRRAVL
SPMEMEDAL	SPMEMEDAL
IPRDPSQQEL	IPRDPSQEL
NPRPTAQDL	NPRPTAQDL
VPSKVPTSMVL	VPSKVPTSM
YPTISLHAL	YPTISLHAL
HPQPGAVEL	HPQPGAVEL
KPFDQTTISL	KPFDQTISL
SPAAPSPLAL	SPAAPSLAL
IPGEPGFPL	IPGEPGFPL
RPAPPPEAL	RPAPPPEAL
YPKLPVWVV	YPKLPVWVV
SPPDNPQVKEI	SPPDN-PQV
ESGPSIVH	ESGPS-IVH
SPMKEKGNIQL	SPMKEKIQL
FPKAVSVFF	FPKAVSVFF
RPQRATSNVF	RPQRATNVF
SPPPTKFIVM	SPPPTKIVM
TPETVRMVL	TPETVRMVL
RPKALTQVL	RPKALTQVL
LPHAPGVQM	LPHAPGVQM
LPHHRVIEV	LPHHRVIEV
RPKEAPEPMEL	RPKEAPEPM
HPKVGRVSI	HPKVGRVSI
PQKPHLKL	PQKPH-LKL
GPIYPGHGM	GPIYPGHGM
MPRQPSATRL	MPRQPSTRL
LPKPPKPVSK	LPKPPKVSK
SPRPPLGSSL	SPRPPLSSL
KPTSKDQVL	KPTSKDQVL
TPARKEISL	TPARKEISL
RPKRPPLKEFF	RPKRPPKEF
RPAERLDYL	RPAERLDYL
VPNAGRGLVRL	VPNAG-RGL
RPKTFGMDM	RPKTFGMDM
APKPRLNQL	APKPRLNQL
RPRPPITLL	RPRPPITLL
IPYEGFASL	IPYEGFASL
TPQAQAQSL	TPQAQAQSL
APDAAPAPASI	APDAAPAPA
MPAAKKQKL	MPAAKKQKL
FPHPLPSL	FPHPL-PSL
LPSRKLVAL	LPSRKLVAL
VPAGIRPQSI	VPAGIRQSI
SPPKIHVSA	SPPKIHVSA
TPQNGRYQI	TPQNGRYQI
RPADYLFML	RPADYLFML
LPKPHGIRAL	LPKPHGRAL
APWARVDEM	APWARVDEM
SIKDYFLEF	SIKDYFLEF
RPKEIKVSKM	RPKEIKVSK
APRHGLQSL	APRHGLQSL
APAPPSKVI	APAPPSKVI
RPKSSSPIRL	RPKSSSIRL
APKPSSRPSL	APKPSSPSL
YPHLHNAEL	YPHLHNAEL
APREPFAHSL	APREPFHSL
QPKIVKWDRDM	QPKIVKWDR
SPGSPRPAL	SPGSPRPAL
TPKQKPKTPF	TPKQKPTPF
KPMEGNFEEI	KPMEGNEEI
RPHRGILAV	RPHRGILAV
SPQYRLRIAM	SPQYRLIAM
GPKDAIRAL	GPKDAIRAL
LPAPPHIDV	LPAPPHIDV
KPRVPPATAF	KPRVPPTAF
PINGNGKQ	PINGN-GKQ
MPKPPNLIM	MPKPPNLIM
APSSSGPGHLV	APSSSGGHL
RPDERRFAVF	RPDERRFAV
APRSVAVSSI	APRSVASSI
MPKKSIKKLVL	MPKKSIKKL
IPKDYKTMAA	IPKDY-KTM
MPLPGTKAL	MPLPGTKAL
LPAGSRVEL	LPAGSRVEL
GPRGMGTAL	GPRGMGTAL
FPKDPVYTF	FPKDPVYTF
TPRPDDPSPL	TPRPDDSPL
KPVFLPRNL	KPVFLPRNL
HPKYGSIPKL	HPKYGSPKL
RPAPLSAEL	RPAPLSAEL
TLNSFIHVL	TLNSFIHVL
RPNTSEILRTL	RPNTS-EIL
KPIGSLHPGL	KPIGSLPGL
HPVNAFKLM	HPVNAFKLM
SPAPRTAL	SPAPR-TAL
IPQEFQKTV	IPQEFQKTV
VPKNYKLVAA	VPKNYKLVA
SPEAPKPQL	SPEAPKPQL
SPKVEPRAL	SPKVEPRAL
LPKSVQNKL	LPKSVQNKL
FPEPSRPPL	FPEPSRPPL
LPAEGVKEL	LPAEGVKEL
QPRTEPMPSL	QPRTEPPSL
LPEEFMKTL	LPEEFMKTL
RPSQLGQVF	RPSQLGQVF
SPMSADRVVAF	SPMSADRVV
QPLKAKTSL	QPLKAKTSL
LPKTTALEL	LPKTTALEL
KPRGLFITI	KPRGLFITI
IPMLPHLL	IPMLP-HLL
ASVKKPHTL	ASVKKPHTL
TPGGSHPAL	TPGGSHPAL
FPMGDRLYIGL	FPMGDRLYI
MPAFSKIGGIL	MPAFSKGGI
RPRNPAGRTGL	RPRNPATGL
NPISTHIGNEL	NPISTHNEL
SPNSAHAVSL	SPNSAHVSL
TPGNFFHVL	TPGNFFHVL
LPKATILDL	LPKATILDL
TVKEVLPAL	TVKEVLPAL
APAAGAGRLL	APAAGARLL
HVKDANGNSF	HVKDANNSF
NPNGDKTKVMV	NPNGDKTKV
LPKQPPLAL	LPKQPPLAL
FPISRGIPNML	FPISRGPNM
KPKPFGSEEQL	KPFGSEEQL
MPNVAPAAI	MPNVAPAAI
SPRDKIYTI	SPRDKIYTI
LPKPGGAHSL	LPKPGGHSL
TPLHLAVI	TPLHL-AVI
LPYSVGRVL	LPYSVGRVL
FPWEVPKKL	FPWEVPKKL
HPKSVIVGL	HPKSVIVGL
MPEKPTTTV	MPEKPTTTV
SPTTAFTVL	SPTTAFTVL
GIKEYFNVM	GIKEYFNVM
RPWLEGRHTL	RPWLEGHTL
APWSGRFYSL	APWSGRYSL
IPEELKPWL	IPEELKPWL
RPMPPEARRL	RPMPPERRL
LVQENRPTL	LVQENRPTL
NPNTSEPQHLL	NPNTSEQHL
SPRPQPESV	SPRPQPESV
APQPGKYVI	APQPGKYVI
IPYAQPPL	IPYAQ-PPL
QPPGPVKEM	QPPGPVKEM
VPNDIQSEL	VPNDIQSEL
RPIDTSRLTKI	RPIDT-SRL
PSSKLIRIL	PSSKLIRIL
KVKAEGPGL	KVKAEGPGL
FASKEIAENAL	ASKEIANAL
IPKSAVGEL	IPKSAVGEL
LPKKFIATI	LPKKFIATI
YPNYLIRKF	YPNYLIRKF
KPKSWVRL	KPKSW-VRL
VAKAPSQAL	VAKAPSQAL
LPNVPSIAL	LPNVPSIAL
RPEKAQPSL	RPEKAQPSL
KPRPIIPML	KPRPIIPML
MPDVGRSMQQL	MPDVG-RSM
RPIASGPVV	RPIASGPVV
SPQSGNFRQL	SPQSGNRQL
SASVKKPHTL	SVKKP-HTL
IPEKFQHIL	IPEKFQHIL
LPKAPGLEH	LPKAPGLEH
IVKGPRGTL	IVKGPRGTL
VPKPIGGVV	VPKPIGGVV
SPLSSHPVV	SPLSSHPVV
RVKEPVKEL	RVKEPVKEL
VPRFLMSSTM	VPRFLMSST
IPKDNRLYL	IPKDNRLYL
IPLPLVKSL	IPLPLVKSL
EPPPVKIAW	EPPPVKIAW
NPKEAGQRL	NPKEAGQRL
KVKASGPGL	KVKASGPGL
TAKDSDPEL	TAKDSDPEL
SPKQILDPAA	SPKQILPAA
SPSPATDGKVF	SPATDGKVF
TPLARIVAF	TPLARIVAF
PDRSHPKLL	PDRSHPKLL
LPSEHQTIL	LPSEHQTIL
SPKKPVIVF	SPKKPVIVF
HPSSYTKVI	HPSSYTKVI
FPNAIEHTL	FPNAIEHTL
MPRHNLHKI	MPRHNLHKI
KPLSIPKRL	KPLSIPKRL
ILPRSLALI	ILPRSLALI
IPVKKRMAL	IPVKKRMAL
VPELPGPSV	VPELPGPSV
MPPPANLPSL	MPPPANPSL
RPRDSQLYAV	RPRDSQYAV
LRLSHLKPS	LRLSHLKPS
SPFPSHPSL	SPFPSHPSL
RPKYPGIKF	RPKYPGIKF
YVMDTRPKL	YVMDTRPKL
APARAVSAV	APARAVSAV
RPKIQQQF	RPKIQ-QQF
TPKNTSVSL	TPKNTSVSL
VPPPLAKAI	VPPPLAKAI
VPKESLVYF	VPKESLVYF
RPAFFAERL	RPAFFAERL
SPFLTITSM	SPFLTITSM
SPYYRTKL	SPYYR-TKL
QPAGHRPAL	QPAGHRPAL
KPRVTPVEV	KPRVTPVEV
KPKNPEFTSGL	KPKNPESGL
VPRENMEAI	VPRENMEAI
VPVAKTAEL	VPVAKTAEL
SPEPSKIML	SPEPSKIML
MPKMNFANVF	MPKMNFNVF
RVKAPNKSL	RVKAPNKSL
QPYRRPLNF	QPYRRPLNF
GPMPQTREHLL	MPQTREHLL
SPKDKFSYI	SPKDKFSYI
KPRTEGKITL	KPRTEGITL
TPNENRQKL	TPNENRQKL
KPMKSVLVV	KPMKSVLVV
KPVNRISL	KPVNR-ISL
KPKNTIAIF	KPKNTIAIF
FPAPGKTVTL	FPAPGKVTL
QPPGPGQEL	QPPGPGQEL
EPLRPGPAL	EPLRPGPAL
RPPKVKITEL	PPKVKITEL
RPWVSGHRKL	RPWVSGRKL
TPQERVEEVL	TPQERVEVL
RPRTPPEAIAL	RPRTPPEAI
NPQERTLTL	NPQERTLTL
APNERPYSL	APNERPYSL
SPNNDKQKYTL	SPNNDKYTL
VPADVLEAL	VPADVLEAL
DPKSKFFEL	DPKSKFFEL
SPREVFFRV	SPREVFFRV
FPRHIEPEL	FPRHIEPEL
TIRDKFARL	TIRDKFARL
VPLAQAQAL	VPLAQAQAL
APRPDSRHHSL	RPDSRHHSL
LKMRPSLL	LKMRP-SLL
EPNRRVLETL	EPNRRVETL
VPATPRLPA	VPATPRLPA
SPLTQTPEHRL	SPLTQTPEH
SPKSTGPRPSL	SPKSTGPSL
YPYRYPAL	YPYRY-PAL
VPQPHPQTL	VPQPHPQTL
KPKKGIQFL	KPKKGIQFL
GPMPKHIAF	GPMPKHIAF
EPSRELAEQTL	SRELAEQTL
IPKRPIPTI	IPKRPIPTI
RPMGAGEAL	RPMGAGEAL
LPKHLLHSV	LPKHLLHSV
RPKMQEVVA	RPKMQEVVA
SPKQIGEHL	SPKQIGEHL
FPYMTHPSV	FPYMTHPSV
LPVGRSVEETL	LPVGRSETL
APAEKVGGVL	APAEKVGVL
LPSPFLRAL	LPSPFLRAL
SPKLPVSSL	SPKLPVSSL
KPKDPVEV	KPKDP-VEV
VPVPHTTAL	VPVPHTTAL
KPIFSKIVSL	KPIFSKVSL
FPWEKPTTL	FPWEKPTTL
VPTPIHPIF	VPTPIHPIF
SPVPSHWMVAL	VPSHWMVAL
APSAKVKLL	APSAKVKLL
HPKTGRISV	HPKTGRISV
VPRNYDPAL	VPRNYDPAL
GPKQQFSTL	GPKQQFSTL
MPQHIMAIL	MPQHIMAIL
TPAALAAL	TPAAL-AAL
LPKNPDLRI	LPKNPDLRI
RPSSQYIVAL	RPSSQYVAL
KPKEHKKLFL	KPKEHKKLF
RPYPSPGAVL	RPYPSPAVL
APYNKPSL	APYNK-PSL
SPEQPPKAKFL	SPEQPPAKF
LPQGIVPAL	LPQGIVPAL
SPPPVKEL	SPPPV-KEL
IPSSHPVSL	IPSSHPVSL
HPKPVPGF	HPKPV-PGF
SPKITTSLL	SPKITTSLL
TPRPPPVGHSF	RPPPVGHSF
RPKNVVLRL	RPKNVVLRL
RPRHQGVMVGM	RPRHQGVMV
LPTDTLQEL	LPTDTLQEL
RPHKPGLYL	RPHKPGLYL
VPASQKLRQL	VPASQKRQL
SPPDLKLEL	SPPDLKLEL
VPNLRGSEERL	VPNLRGERL
SPRYIFTML	SPRYIFTML
TPKGETRQL	TPKGETRQL
YPAAVPQAL	YPAAVPQAL
SPLKKEQPL	SPLKKEQPL
GPQAVRAAL	GPQAVRAAL
APTDVLEAL	APTDVLEAL
VVPPFLQPEV	VPPFLQPEV
QPADRPREPL	QPADRPEPL
LPALRSIGL	LPALRSIGL
NPSSVIHVV	NPSSVIHVV
YPNFAGPHAAL	YPNFAGHAA
QVKYPVNSL	QVKYPVNSL
TVTEKPEVID	TVTEKPEVI
RPRSWRELPL	RPRSWRLPL
KPSSTTPRL	KPSSTTPRL
MPKMDQDSL	MPKMDQDSL
TPPIPKITI	TPPIPKITI
TPKVTQALNVL	TPKVT-QAL
LPRGKGIRL	LPRGKGIRL
RPNPITVIL	RPNPITVIL
VPVSVGAYFF	VPVSVGAYF
VPEKPRPAL	VPEKPRPAL
QPFFQKRSEL	QPFFQKSEL
RPRPGTGL	RPRPG-TGL
VAKEIIYTL	VAKEIIYTL
SPKRDLIAL	SPKRDLIAL
SPIPAGSKKI	SPIPAGKKI
SPQEDGVEL	SPQEDGVEL
RPYEKGRL	RPYEK-GRL
SPKADVKNL	SPKADVKNL
APPPGGWPL	APPPGGWPL
APKPQGPAF	APKPQGPAF
RPGLVSETL	RPGLVSETL
LPSRSLSVNTL	LPSRS-LSV
LPASIPHVI	LPASIPHVI
SPGWVRLAL	SPGWVRLAL
LPKIPSNATL	LPKIPSATL
APGGAIASV	APGGAIASV
VPDGFLSEL	VPDGFLSEL
TPASAGHVW	TPASAGHVW
QPKQRGFRF	QPKQRGFRF
KPKEPITDV	KPKEPITDV
LPRRPLRAF	LPRRPLRAF
HPSFQVKEL	HPSFQVKEL
TPRLPQRNL	TPRLPQRNL
VPTPIQPTF	VPTPIQPTF
RPRDASTLGL	RPRDASLGL
LPYAGDVSM	LPYAGDVSM
SPQGRVMTI	SPQGRVMTI
VPAFRDEHL	VPAFRDEHL
MPQIPVASV	MPQIPVASV
VPNPSLKTF	VPNPSLKTF
KPLGIKTAL	KPLGIKTAL
HPYQRIVTA	HPYQRIVTA
APNEKMKQVL	APNEKMQVL
RPQAPATVGL	RPQAPAVGL
RPSGLHGDVSL	RPSGLHVSL
TPIQWLPGHDL	IQWLPGHDL
NPKSHILSI	NPKSHILSI
LPATEKPVL	LPATEKPVL
MPNGTVQRF	MPNGTVQRF
VPAENKSVL	VPAENKSVL
GPSRSNVVKIL	SRSNVVKIL
FPQVGRTAL	FPQVGRTAL
SARTPGPAV	SARTPGPAV
SPEARPAQEAL	EARPAQEAL
IPQIRNPSL	IPQIRNPSL
MPYHIQRTI	MPYHIQRTI
HPISNNNSL	HPISNNNSL
RPAPARPTM	RPAPARPTM
RPKMQEVVANL	RPKMQEVVA
APKSGNTGEL	APKSGNGEL
IPKGVSRKL	IPKGVSRKL
APKIIDEQL	APKIIDEQL
SPPLHEHPL	SPPLHEHPL
RPSQFPHSL	RPSQFPHSL
RPSPPVQSV	RPSPPVQSV
MPPAHYDAKQL	PPAHYDKQL
LPTAGTVGRVL	TAGTVGRVL
VPFGPHRGL	VPFGPHRGL
TPAEVRQVL	TPAEVRQVL
TPVMNSEAKVL	TPVMNSAKV
RPRDALPRL	RPRDALPRL
RPQLLKNAL	RPQLLKNAL
FPPPVSPRL	FPPPVSPRL
LDPVLQNPL	LDPVLQNPL
LPRKNLPERLL	LPRKNLERL
KVKSILNSL	KVKSILNSL
RPPDPGPTL	RPPDPGPTL
PKYGVKVGL	PKYGVKVGL
SPMEVGKKL	SPMEVGKKL
HPKPTQRTF	HPKPTQRTF
LPRAVGTQTL	LPRAVGQTL
QPYSKDSPF	QPYSKDSPF
KPSPPPVKEL	KPSPPPKEL
SVKSPNQSL	SVKSPNQSL
VPQSGVPAL	VPQSGVPAL
TPPEVSKKL	TPPEVSKKL
LPYKAGLSL	LPYKAGLSL
KAASVRPVL	KAASVRPVL
IPNARIEL	IPNAR-IEL
SPTENSFTL	SPTENSFTL
VPNKFLVTAEI	VPNKFLVTA
TVKTHLTSL	TVKTHLTSL
TPLASFKIL	TPLASFKIL
LPEAKKPRL	LPEAKKPRL
KAFARPWSL	KAFARPWSL
APVYLAAVI	APVYLAAVI
TPTQNNIFKVL	TQNNIFKVL
RPKMPGRRL	RPKMPGRRL
RPNQHNTVKL	RPNQHNVKL
KPQDYKKRL	KPQDYKKRL
SPSRPPPSL	SPSRPPPSL
TPKPVEPAA	TPKPVEPAA
VAPVASAL	VAPVA-SAL
NPRQINWTV	NPRQINWTV
VPAEPSSLL	VPAEPSSLL
RPKEDTQKLL	RPKEDTQKL
AARPATSTL	AARPATSTL
APGEVGSVL	APGEVGSVL
IPASKVFSL	IPASKVFSL
KPFLGIGL	KPFLG-IGL
MPTIQITAL	MPTIQITAL
IPSSSHVSNNM	IPSSSHVSN
SPKVTKDGVTV	SPKVTKDGV
GPYLTHQQKVL	GPYLTHQKV
VPYPRIHFPL	VPYPRIFPL
RPSGPSKAL	RPSGPSKAL
YSKYYKTIDD	YSKYY-KTI
APNGAGLVL	APNGAGLVL
VPSTAIREI	VPSTAIREI
APEEHPVL	APEEH-PVL
SPILAHGGVRF	SPILAHGGV
HLKPISREL	HLKPISREL
HPKDNLIKL	HPKDNLIKL
ALKKAGLSL	ALKKAGLSL
LPRNAQVAL	LPRNAQVAL
LPKKPKKVAF	LPKKPKVAF
KLNPYAKTM	KLNPYAKTM
IPRGVNVSAL	IPRGVNSAL
RPAANPIQF	RPAANPIQF
PKLHIVKV	PKLHI-VKV
SPRLMSNAL	SPRLMSNAL
QAQPTKPAL	QAQPTKPAL
KPSLPFTSL	KPSLPFTSL
KPIQPKPTV	KPIQPKPTV
SPSFPRPSL	SPSFPRPSL
HPPPASPSSL	HPPPASSSL
FPQHTIASL	FPQHTIASL
SPNYEGPLHSL	SPNYEGHSL
KPLSNMKIL	KPLSNMKIL
MPRPPETFL	MPRPPETFL
LPSQKTASL	LPSQKTASL
RPKDPNNLL	RPKDPNNLL
SPAPPRPSL	SPAPPRPSL
LPKGKALEL	LPKGKALEL
APSEKLEQIL	APSEKLQIL
RPKTGVRGL	RPKTGVRGL
SPDTVSPSL	SPDTVSPSL
TPPPLPKPAL	TPPPLPPAL
LPAPPKIYF	LPAPPKIYF
GPKPTEVVL	GPKPTEVVL
APQTSTPSL	APQTSTPSL
LPPPPHPSV	LPPPPHPSV
SPDYERIINL	SPDYERINL
SPAKLHEL	SPAKL-HEL
AVKDVAKAL	AVKDVAKAL
LPMTTEVL	LPMTT-EVL
VPNATIRNV	VPNATIRNV
APSLKQFSL	APSLKQFSL
SPDTKKIAL	SPDTKKIAL
LPRFQPRVL	LPRFQPRVL
IPELPDPSL	IPELPDPSL
SPAGPILSI	SPAGPILSI
IPRPKPAPL	IPRPKPAPL
APSPLSSSL	APSPLSSSL
LPQGIVREL	LPQGIVREL
RPANHRQLTF	RPANHRLTF
VPKNYVTVM	VPKNYVTVM
APQRVRVTL	APQRVRVTL
KPEVPREKL	KPEVPREKL
HPVVRNLAVL	HPVVRNAVL
MPHHTPHQL	MPHHTPHQL
IPALRDISI	IPALRDISI
QPYEKKAAKL	QPYEKKAKL
FPAPDRKKL	FPAPDRKKL
IPNEIIHAL	IPNEIIHAL
PKTAENFRAL	KTAENFRAL
APSHLMALLTL	APSHLMALL
RPHKVDGRVV	RPHKVDRVV
YPTDERKLL	YPTDERKLL
IPFEFPLHL	IPFEFPLHL
KPSLAQSIAKI	KPSLA-QSI
LPSMPEPAL	LPSMPEPAL
LPKTGVSQL	LPKTGVSQL
SPSSVTGNAL	SPSSVTNAL
MPSSHRILHKL	MPSSH-RIL
ATKRIFSAL	ATKRIFSAL
NPIPTHLSL	NPIPTHLSL
LPSSIYRLL	LPSSIYRLL
KPKATAKAAL	KPKATAAAL
RPSLRLQLL	RPSLRLQLL
YPLLKNISM	YPLLKNISM
LPTSFVKEI	LPTSFVKEI
YPIALTRAEM	YPIALTAEM
APHEPDGVAL	APHEPDVAL
SPMDGTSSAL	SPMDGTSAL
KPRPPLHLL	KPRPPLHLL
APSGIGSIF	APSGIGSIF
APSPLQPAL	APSPLQPAL
SPQDSRLYL	SPQDSRLYL
MPSPIMHPLIL	MPSPIMHPL
MPKMKMPKF	MPKMKMPKF
HPKYGSIPK	HPKYGSIPK
VVKPPGSSL	VVKPPGSSL
NPKDATSIHL	NPKDATIHL
LPNDVISSL	LPNDVISSL
TPLLMQAL	TPLLM-QAL
NPLPNIDHEL	NPLPNIHEL
RVAPEEHPVL	APEEH-PVL
RPYVRVEL	RPYVR-VEL
SPHDVSSVL	SPHDVSSVL
SPLDSIHTI	SPLDSIHTI
TPNEHHDHLL	TPNEHHHLL
MPEEPKLTL	MPEEPKLTL
SPLGHRMQL	SPLGHRMQL
APAPAEKTPV	APAPAETPV
SPSDFSVSL	SPSDFSVSL
PRGFARGL	PRGFA-RGL
IPKDPRQW	IPKDP-RQW
SPVSYLRVSM	SPVSYLVSM
RPSTPHTITL	RPSTPHITL
FPHLVHAEL	FPHLVHAEL
IVKEVSTYI	IVKEVSTYI
HPLINPVAF	HPLINPVAF
SPQTSFPYKIM	SPQTSFYKI
VPKTTGEGTSL	VPKTTGTSL
APQRAHEVL	APQRAHEVL
HPTGKMFIL	HPTGKMFIL
SPATTVVRTL	SPATTVRTL
LPSLPTAEL	LPSLPTAEL
NPISTVTEL	NPISTVTEL
APLLKKQTL	APLLKKQTL
HPKPEGLAA	HPKPEGLAA
QPKQRGMRF	QPKQRGMRF
SPRSVIHHL	SPRSVIHHL
LPRGSIPRSL	LPRGSIRSL
KSKNPGEAL	KSKNPGEAL
KPYAFDRVF	KPYAFDRVF
GPFFRTEQL	GPFFRTEQL
HPFPFHPSL	HPFPFHPSL
RPWTVMESL	RPWTVMESL
RPKSVDFDSL	RPKSVDDSL
LPRQPPMSL	LPRQPPMSL
APSAAKLLVQL	APSAAKLLV
TPREPNRWAV	TPREPNWAV
KIKPVSLTF	KIKPVSLTF
RPSGPGPEL	RPSGPGPEL
MPKRIVNAKI	MPKRIVAKI
KPSAMKVGEKL	SAMKVGEKL
LPWKRIVAV	LPWKRIVAV
RPIPNQPPTA	RPIPNQPTA
KTKDPTAAL	KTKDPTAAL
LPSQLAHRL	LPSQLAHRL
SPDPLRPLEFL	SPDPLRLEF
TVKKPGPNL	TVKKPGPNL
LPHSTAAL	LPHST-AAL
IPRKPDGKM	IPRKPDGKM
YPNERFELL	YPNERFELL
LPDSGHLHPL	LPDSGHHPL
SPKTTITMA	SPKTTITMA
RPAPQKALYST	RPAPQ-KAL
GPAPSRPAL	GPAPSRPAL
APKMPVVTSV	APKMPVTSV
RPPNIVLIF	RPPNIVLIF
LPEKNRQML	LPEKNRQML
IPNGSSITV	IPNGSSITV
VPKNFIDIQF	VPKNFIIQF
SPIKRALGL	SPIKRALGL
KPNQISGTVF	KPNQISTVF
NPNQNKNVAL	NPNQNKVAL
APAPKAYVL	APAPKAYVL
RVFNRPRIETL	FNRPRIETL
QPMQPLPESL	QPMQPLESL
TPPAVSSVL	TPPAVSSVL
KPKTFQAYL	KPKTFQAYL
LPSTVKQAV	LPSTVKQAV
LPKEGIFAV	LPKEGIFAV
LVKPEVWTL	LVKPEVWTL
LPKRTIQEVL	LPKRTIEVL
SPMPWKGVTV	SPMPWKVTV
RPAELYTQII	RPAELYTQI
NPRQGYSL	NPRQG-YSL
MPFGNVISA	MPFGNVISA
RPKNLMQTL	RPKNLMQTL
LPNNMIHQV	LPNNMIHQV
VPIDVVSQHLM	VPIDVVQHL
APSWREPEVL	APSWREEVL
VPAPGKLFAL	VPAPGKFAL
VPHDPVAL	VPHDP-VAL
VPRAILVDL	VPRAILVDL
MAPSETQFSHL	APSETQSHL
APIASIHSF	APIASIHSF
VPKLQPQITMI	VPKLQPITM
SPGQRSISL	SPGQRSISL
HPKFQKPKQL	HPKFQKKQL
YAKRPGIGL	YAKRPGIGL
LPRREGYEF	LPRREGYEF
KPHSGFHVA	KPHSGFHVA
TVKDVNQQEF	TVKDVNQEF
SPREEQQLL	SPREEQQLL
SPKRPPSPIKF	SPKRPPSPI
FPETNNILKIV	FPETN-NIL
SPAGVSATL	SPAGVSATL
LPAEFPDKVF	LPAEFPKVF
TPKPQTKEL	TPKPQTKEL
RPHYSLRTL	RPHYSLRTL
LPRKFPSL	LPRKF-PSL
SPKGKFSLF	SPKGKFSLF
IPAKPPVSF	IPAKPPVSF
QPIPILYEHQL	IPILYEHQL
IPKKMENPHSL	KKMENPHSL
FPFSRPELL	FPFSRPELL
SPEETRAAL	SPEETRAAL
LPSSKLIRIL	LPSSKLRIL
EIAALVID	EIAAL-VID
KPKENNFKAVL	KPKENNKAV
RPYKLQVL	RPYKL-QVL
GPLPPHLAL	GPLPPHLAL
RPQSKAPDSTL	QSKAPDSTL
LPSEWRPL	LPSEW-RPL
VPRFYIRIL	VPRFYIRIL
LPEEPVSQL	LPEEPVSQL
APVPYVRPAI	APVPYVPAI
IPFEKKPAL	IPFEKKPAL
NPDGVRIMHSL	NPDGVRHSL
IPPPPPPVGF	IPPPPPVGF
KVSGVLKKL	KVSGVLKKL
AAKLVSEKL	AAKLVSEKL
RVKEIGSTM	RVKEIGSTM
SPKPAVVET	SPKPAVVET
ALKNVTVSF	ALKNVTVSF
TPIGVQAEAL	TPIGVQEAL
SVKPASSSF	SVKPASSSF
RPHVAQPTL	RPHVAQPTL
SPDPHKGLVLL	SPDPHKLVL
SPSPAHPQL	SPSPAHPQL
PASKRPPL	PASKR-PPL
APSSETGTSL	APSSETTSL
LPWGGGTAL	LPWGGGTAL
RPKSTVNTHYF	RPKSTVNTH
SPKGTYLATF	SPKGTYATF
SPSLPNITL	SPSLPNITL
MPKEPHIREM	MPKEPHREM
RPKVPVLQL	RPKVPVLQL
SPAGPGLSL	SPAGPGLSL
HPESERISM	HPESERISM
RPQASAWKKL	RPQASAKKL
SPNGNLIRML	SPNGNLRML
APPDVWKKV	APPDVWKKV
APKDSFAL	APKDS-FAL
TVKATGPAL	TVKATGPAL
RPNDIMAEV	RPNDIMAEV
MPTLPPPSV	MPTLPPPSV
RPRAPIIAV	RPRAPIIAV
SPIRREKLAL	SPIRRELAL
GPRWADPQI	GPRWADPQI
KLKPTSKDQVL	KPTSKDQVL
KPQHVTETF	KPQHVTETF
VPAGGAVAV	VPAGGAVAV
VPSPYLSSL	VPSPYLSSL
SPAPTITSL	SPAPTITSL
APLPGMTSL	APLPGMTSL
RPKEKSLVL	RPKEKSLVL
LPSAPGVVL	LPSAPGVVL
VPKLVKEEVF	VPKLVKEEV
QPFLQRYYEVL	QPFLQRYEV
TPAGVQVIL	TPAGVQVIL
EVKPNTPVL	EVKPNTPVL
APKQELPSAL	APKQELSAL
QPMQPHPQHL	QPMQPHQHL
RPKQPGPVKL	RPKQPGVKL
YLPDGTASL	YLPDGTASL
IPAYKLETL	IPAYKLETL
VAKPPVMSF	VAKPPVMSF
TAAPPAQPL	TAAPPAQPL
TPKEEAQSL	TPKEEAQSL
SPNSTSRPTLP	SPNSTSPTL
NPKQAATQSEL	NPKQAASEL
SPRDSPAVSL	SPRDSPVSL
SPQQVSAQL	SPQQVSAQL
TPEEAKYKL	TPEEAKYKL
VPDERRYSL	VPDERRYSL
RPSSKKTYSL	RPSSKKYSL
LTPMLAPAL	LTPMLAPAL
TPKEAFRQL	TPKEAFRQL
LVKDVFISA	LVKDVFISA
LPTNFRDL	LPTNF-RDL
RPSTTVRVH	RPSTTVRVH
MPYDSNRVVL	MPYDSNVVL
HPFHILIAL	HPFHILIAL
FPKGSRSVV	FPKGSRSVV
LPSSIMRNL	LPSSIMRNL
LPGELFHVV	LPGELFHVV
SPSETVSSL	SPSETVSSL
HPYNKLWSL	HPYNKLWSL
NPRKYLRSV	NPRKYLRSV
QPSPVSNQSL	QPSPVSQSL
PREKKISIL	PREKKISIL
RPKPSSSPVI	RPKPSSPVI
MPPEKVHKEL	MPPEKVKEL
VPIQSSVVL	VPIQSSVVL
SPANPAHIL	SPANPAHIL
KPVSLGQAL	KPVSLGQAL
SPKSTAQEGTL	SPKSTAEGT
RPKVPAGVQEL	VPAGV-QEL
QPQAAAGSHQL	QAAAGSHQL
RPFLLRRI	RPFLL-RRI
SPITGRSKL	SPITGRSKL
HAKPPTPSL	HAKPPTPSL
VPLPISHKRVL	LPISHKRVL
TPTTIIKQV	TPTTIIKQV
HPNSLMKKI	HPNSLMKKI
RPGLEGYAL	RPGLEGYAL
RAARGAPPL	RAARGAPPL
APQTQHVSPM	APQTQHSPM
LPKQEKRHVL	LPKQEKHVL
KPYIRTSL	KPYIR-TSL
VPYKKDVGKTL	YKKDVGKTL
YPKEDKENRIL	YPKEDKNRI
GPPGTGKTI	GPPGTGKTI
APSMKELQVL	APSMKEQVL
RPEQRLALL	RPEQRLALL
TPSAQVKPI	TPSAQVKPI
RPIQPIAGL	RPIQPIAGL
SPKETFNASF	SPKETFASF
RPHSSLREL	RPHSSLREL
RVKLPSKAL	RVKLPSKAL
EPQAKNISV	EPQAKNISV
KPIVRKKLSL	KPIVRKLSL
APRDGRVVF	APRDGRVVF
LPFDHSRVIL	LPFDHSVIL
VSKPDMGLVAL	KPDMGLVAL
VPGKIQHIL	VPGKIQHIL
ADPLKVYPPL	DPLKVYPPL
VPAEHQVAM	VPAEHQVAM
LPRGSSRLL	LPRGSSRLL
IVKGGRIVAM	IVKGGRVAM
TPSPTRYSL	TPSPTRYSL
KPKGGVIF	KPKGG-VIF
HPIQGHRVEV	HPIQGHVEV
KPKPGHTPIF	KPKPGHPIF
IPAKLHNSL	IPAKLHNSL
PYSRPKQL	PYSRP-KQL
HPKPSGKPLP	HPKPSGKPL
MPSSAVRVL	MPSSAVRVL
TPSPAPRTL	TPSPAPRTL
TPAPPKKDI	TPAPPKKDI
QPNERQVRIQL	QPNERQVRI
SPHPGVGVPT	SPHPG-VGV
APLQRSQSL	APLQRSQSL
VPKSLVSNL	VPKSLVSNL
APDGSQRAVL	APDGSQAVL
KPKPTNPVEI	KPKPTNVEI
KPKPIGKLA	KPKPIGKLA
FPSNFIKEL	FPSNFIKEL
IPKSSDPEM	IPKSSDPEM
PKRPPSAF	PKRPP-SAF
SPAGKTNAL	SPAGKTNAL
RAKELFHEL	RAKELFHEL
APPVLKRPIL	APPVLKPIL
SPVVRVAV	SPVVR-VAV
EPQGPRPVL	EPQGPRPVL
KPSVVYRFF	KPSVVYRFF
RPITPGTLRQL	RPITP-GTL
IPSEWHIEL	IPSEWHIEL
HPHGSYSRL	HPHGSYSRL
TVKPASGSQTL	KPASGSQTL
AVKEKSPSL	AVKEKSPSL
APKSMQSAI	APKSMQSAI
VPFLKKVGF	VPFLKKVGF
TPRPATEAELL	TPRPATAEL
YPKGAGEML	YPKGAGEML
RPPQRQVVL	RPPQRQVVL
APRAALVFAL	APRAALFAL
SPSQPRDAL	SPSQPRDAL
IAKRPPLQSL	AKRPPLQSL
SPNSYVVIM	SPNSYVVIM
MPANSGLAL	MPANSGLAL
APYHSRSAYIA	APYHS-RSA
YPFKPPKVAF	YPFKPPVAF
LPPDEIKEL	LPPDEIKEL
LPATATMSL	LPATATMSL
RPFLRPNII	RPFLRPNII
VPKTVDNFVAL	VPKTVDNFV
APRQPGLMA	APRQPGLMA
LSKAAGPEL	LSKAAGPEL
KPKNAIHTF	KPKNAIHTF
HPKRPMHILL	HPKRPMHIL
VPSPAVPKL	VPSPAVPKL
APDAKSFVL	APDAKSFVL
IPLSGRNPL	IPLSGRNPL
TPAPPGPAT	TPAPPGPAT
SPHFKSGSL	SPHFKSGSL
IPKKPIPRI	IPKKPIPRI
TPAIKRSIL	TPAIKRSIL
TIRSKRPAL	TIRSKRPAL
TPKPIPIL	TPKPI-PIL
VPAPVPLMSL	VPAPVPMSL
IPQQSQSVKQL	IPQQS-QSV
RPKGSEMKYAL	RPKGSEYAL
APYMRSMMQTL	APYMR-SMM
KPRSPPRAL	KPRSPPRAL
VPKSPDASSAF	VPKSPDSSA
KPMLNNNSF	KPMLNNNSF
YPRSLFPSL	YPRSLFPSL
HPKLSKENVI	HPKLSKENV
SPKSFTLDF	SPKSFTLDF
TPHLRNLAVAM	TPHLRNLAV
APQVHIFSL	APQVHIFSL
APRSTEESL	APRSTEESL
APALPGPQF	APALPGPQF
SPQSPGDAL	SPQSPGDAL
TPDQGKARLL	TPDQGKARL
FPAGIVRVF	FPAGIVRVF
VPPPVMKTF	VPPPVMKTF
APLDSIHSL	APLDSIHSL
APRDSLRSL	APRDSLRSL
SPSDRDFMETL	SDRDFMETL
APAERQIDL	APAERQIDL
TPKKTTPIL	TPKKTTPIL
SPGLRDVAL	SPGLRDVAL
HPRYFGPNL	HPRYFGPNL
YPKKPKDEAF	YPKKPKEAF
YPAAKRVKL	YPAAKRVKL
RPDTLDPAL	RPDTLDPAL
RPQDDYSVL	RPQDDYSVL
LPYTERHFQRL	LPYTE-RHF
RPQIHGYDL	RPQIHGYDL
SPKRPRLQL	SPKRPRLQL
LPRPHASIMF	LPRPHASIM
KPQVDRYRL	KPQVDRYRL
NVKVDPEIQ	NVKVDPEIQ
SPKLLHKF	SPKLL-HKF
VKPVKVSA	VKPVK-VSA
LPKGVVLKL	LPKGVVLKL
APTPARPVL	APTPARPVL
GPRAPGPSLL	GPRAPGPSL
APQPAQVAL	APQPAQVAL
APRSFHPPAA	APRSFHPAA
NPYIPHPGM	NPYIPHPGM
VPPPPHRPL	VPPPPHRPL
GPREAFRQL	GPREAFRQL
VARPLSTAL	VARPLSTAL
LPHSATVTL	LPHSATVTL
RPRPTEATV	RPRPTEATV
VPKVMKVKL	VPKVMKVKL
TPIQRTPHEIM	TPIQRTHEI
APYMRSMMQSL	APYMR-SMM
MPKKSGRWWF	MPKKSGWWF
RPVAPSGTAL	RPVAPSTAL
TAKRQPIL	TAKRQ-PIL
HPKENIIAV	HPKENIIAV
LARPASAAL	LARPASAAL
HPHLVAEAF	HPHLVAEAF
TPKEVGDVIAL	TPKEVGDVI
SPRELTQNPL	SPRELTNPL
KPNGATPVF	KPNGATPVF
SPYDHSRVKL	SPYDHSVKL
FPIHVQTSL	FPIHVQTSL
VPKAPGFAQML	VPKAPGAQM
NPKVQASL	NPKVQ-ASL
TVYLRDIAL	TVYLRDIAL
KPHSGFHVAF	KPHSGFVAF
IPNHYAEDL	IPNHYAEDL
KPPEPVKPEV	KPPEPVPEV
SPKGTIENI	SPKGTIENI
KPKSLWKSV	KPKSLWKSV
LPSPPAVAV	LPSPPAVAV
SPAFRILSV	SPAFRILSV
APLGQFVSL	APLGQFVSL
SPTDVHRQF	SPTDVHRQF
KPPPSKEEL	KPPPSKEEL
IPISLHTSL	IPISLHTSL
TVTEKPEVIDA	TVTEKPEVI
HPREPLPPIQ	HPREPLPPI
IPGLLSPHPL	IPGLLSHPL
KPSDVMLVHF	KPSDVMVHF
HPFFKDMSL	HPFFKDMSL
VPLKQPTL	VPLKQ-PTL
LPHNRLVSL	LPHNRLVSL
YVNLPTIAL	YVNLPTIAL
APAPIHNQF	APAPIHNQF
IPQKPSQPA	IPQKPSQPA
RPQLRSVLL	RPQLRSVLL
IPFWRNTAV	IPFWRNTAV
LPAEFFEVL	LPAEFFEVL
RPYAKHWL	RPYAK-HWL
RPPSVGDVF	RPPSVGDVF
HPRDFFSRL	HPRDFFSRL
VPVPPNVAF	VPVPPNVAF
APAYLPRSL	APAYLPRSL
QPQFQRQGL	QPQFQRQGL
RPKMQEVV	RPKMQ-EVV
SDPILYRPVAV	DPILYRVAV
LPQYKEREVV	LPQYKEREV
HAKEYIQQL	HAKEYIQQL
PKSAVGEL	PKSAV-GEL
IPSPSLVSL	IPSPSLVSL
HPESVSQSL	HPESVSQSL
TVSSVGALHAL	SSVGALHAL
EPEEFVVEKVL	EPEEFVEKV
QPYLARRPKL	QPYLARPKL
APAKHLIASML	APAKHLASM
KPHLITHGF	KPHLITHGF
IPKFAVATL	IPKFAVATL
SPQGPGALF	SPQGPGALF
NLKAHVVAV	NLKAHVVAV
RPKEKRVTL	RPKEKRVTL
SPRNEVEAL	SPRNEVEAL
RPKDFLSKF	RPKDFLSKF
FPESERPEM	FPESERPEM
IPQKQREITL	IPQKQRITL
RPKRFEVATSL	RPKRFEVAT
LPKKNGLYL	LPKKNGLYL
RPKPESQGI	RPKPESQGI
SPMAERSMM	SPMAERSMM
VPIPRSPYTV	VPIPRSYTV
TPFPFRTGL	TPFPFRTGL
SPLQASSAL	SPLQASSAL
SIPGGYNAL	SIPGGYNAL
LPIERVKKNLL	LPIERVKNL
TAAPAGAAL	TAAPAGAAL
LPNYRWTQTL	LPNYRWQTL
ILKKVLEAL	ILKKVLEAL
RPQLHKNTVL	RPQLHKTVL
RPKIKVSLI	RPKIKVSLI
LPQRKPSL	LPQRK-PSL
KPKSSLPAV	KPKSSLPAV
SPSIKDLPA	SPSIKDLPA
LPKSPPYTAF	LPKSPPTAF
SPLTKSISL	SPLTKSISL
PPPPHRLP	PPPPH-RLP
QPAPPREAHF	QPAPPREAH
HPDQAQAIL	HPDQAQAIL
APESVQKAKMM	APESVQAKM
APKPGGLSL	APKPGGLSL
RPHGRTVRL	RPHGRTVRL
LPKPPKPVSKM	LPKPPKVSK
HPNVLPVL	HPNVL-PVL
TPVDDRISL	TPVDDRISL
WISKQEYD	WISKQ-EYD
HPNFTEKTI	HPNFTEKTI
VPRPASVSA	VPRPASVSA
KPKLTPQEKL	KPKLTPEKL
DMEKIWHHTFY	MEKIWHHTF
LAKTQGNVF	LAKTQGNVF
QPKRHREFL	QPKRHREFL
VPRPVLRAL	VPRPVLRAL
SPKPNGPVL	SPKPNGPVL
LAKPPVVSV	LAKPPVVSV
RPKAQPTTL	RPKAQPTTL
QPNGKVFKKL	QPNGKVKKL
RPFWREEHI	RPFWREEHI
SPRVPASET	SPRVPASET
LPSKPSSTL	LPSKPSSTL
KPRSPDHVL	KPRSPDHVL
KPEERYFISH	KPEERYISH
VPMNSLRFL	VPMNSLRFL
APVGIRHRL	APVGIRHRL
RPREEVRAL	RPREEVRAL
EPREASPLHSL	REASPLHSL
ASPKSPTAAL	SPKSPTAAL
RPWLRPAAL	RPWLRPAAL
APIIRVGGAL	APIIRVGAL
LPIFHKNVF	LPIFHKNVF
HPIPRVFQNRF	IPRVFQNRF
YPMDLGGRNFL	YPMDLGRNF
QPQNPDMTHVI	QPQNPDTHV
KPPPQKSLKEL	PPQKSLKEL
IPKSAIRVI	IPKSAIRVI
TAMKKGETL	TAMKKGETL
RPAQKHWVL	RPAQKHWVL
APYFLPEHIF	APYFLPHIF
NPNAQQTKAVL	NPNAQQKAV
IPYKPNYSL	IPYKPNYSL
IPKNPPSGF	IPKNPPSGF
TPKPSVGSISL	KPSVGSISL
SPQQIDHAKQL	SPQQIDHAK
APHALLQAVL	APHALLAVL
SPNEPKAATL	SPNEPKATL
LPYRRSVPT	LPYRRSVPT
HPTAAVKML	HPTAAVKML
NPKFAEHGETL	KFAEHGETL
APHLTHHTL	APHLTHHTL
HESEQLGSISV	SEQLGSISV
IPYMKKYKI	IPYMKKYKI
EPQPPHSVL	EPQPPHSVL
HPRDPNLLL	HPRDPNLLL
SPRVYWLGL	SPRVYWLGL
GPSNVFKIV	GPSNVFKIV
RPHVSPRHSF	RPHVSPHSF
RVKEPVKELL	RVKEPVKEL
APQPHRHVLEI	APQPHRHVL
KPHVLPAVL	KPHVLPAVL
SPKSDPTL	SPKSD-PTL
LPKDKPRYL	LPKDKPRYL
RPPLNPVSA	RPPLNPVSA
LPAPPTQNM	LPAPPTQNM
TPAPVPTSL	TPAPVPTSL
LPLLSPVTF	LPLLSPVTF
GVRPPAPSL	GVRPPAPSL
EPAPASVTAL	APASV-TAL
SPEGPSKPSL	SPEGPSPSL
TPRPGSAESAL	RPGSAESAL
IVSQKKADEVL	SQKKADEVL
RPADVIFATV	RPADVIATV
RPAQPQEHPF	RPAQPQHPF
MPKDGTVHEL	MPKDGTHEL
LPSQVSRVV	LPSQVSRVV
IPAVELIVKL	IPAVELVKL
NPRQVFNLL	NPRQVFNLL
TPQAKKIKL	TPQAKKIKL
RVAPEEHPVLL	APEEHPVLL
APKPPFQSH	APKPPFQSH
HPSNVLHFF	HPSNVLHFF
KPASVFVQL	KPASVFVQL
VPQQPHPGF	VPQQPHPGF
RPKGFYVETV	RPKGFYETV
APYSRPKQL	APYSRPKQL
RPAVALIRKL	RPAVALRKL
KPKFILSVL	KPKFILSVL
HPNLHGPEI	HPNLHGPEI
RPRPPARSL	RPRPPARSL
LPYVSVTSL	LPYVSVTSL
IPDSSKISL	IPDSSKISL
TTYKLVINGK	TYKLVINGK
APELLRALL	APELLRALL
WPQPDKPMF	WPQPDKPMF
LPIAASSSL	LPIAASSSL
IPDHFRPPL	IPDHFRPPL
IPMEFVNKM	IPMEFVNKM
IPNSHHHHQMM	IPNSHHHQM
NPHGARLSL	NPHGARLSL
APAGGLTEQEL	APAGGLQEL
HPKLGSYTKI	HPKLGSTKI
MPYTRPVKF	MPYTRPVKF
APDSIRGSFGL	APDSIRGSF
KPIPSKPQL	KPIPSKPQL
HPRSPNVLSV	HPRSPNLSV
SPTQVVSQL	SPTQVVSQL
MPKPPITL	MPKPP-ITL
VPKYWGSGL	VPKYWGSGL
IPLQTPHKL	IPLQTPHKL
TPMNPANTI	TPMNPANTI
AAQDKPSAEVL	QDKPSAEVL
RPKLPEDPLL	RPKLPEPLL
RPGAHLTVKKI	RPGAH-LTV
LRVDPVNFK	LRVDPVNFK
MPKKDARTLL	MPKKDARTL
VPVGWESHLA	VPVGWESHL
LPAAPASSL	LPAAPASSL
PHPKKPEHTL	HPKKPEHTL
APSPRPLSL	APSPRPLSL
LPKQPVIV	LPKQP-VIV
LPKARPMSL	LPKARPMSL
SPRPGGPYL	SPRPGGPYL
VPVSTINHAF	VPVSTIHAF
MPDSLRSGEYL	SLRSG-EYL
MPSASRVILL	MPSASRVIL
VPRVPTHTL	VPRVPTHTL
LPPPPKLL	LPPPP-KLL
KPAASATPFAL	KPAASATPF
SPLGKEDTL	SPLGKEDTL
RIKDTVQKL	RIKDTVQKL
HPSASYNQL	HPSASYNQL
KPAKVKVEL	KPAKVKVEL
VPPPPPVAL	VPPPPPVAL
KPKAPPPSL	KPKAPPPSL
APWEKRVDL	APWEKRVDL
APFLRNVEL	APFLRNVEL
RPEILTDESL	RPEILTESL
LPVDHKGELL	LPVDHKELL
RPQELDEAVL	RPQELDAVL
KPANVFITA	KPANVFITA
LPQEQKAKI	LPQEQKAKI
KPKTGRSLL	KPKTGRSLL
VPSEPGGVL	VPSEPGGVL
SPKELVVVL	SPKELVVVL
YPYEHSYGL	YPYEHSYGL
HPLEGTHEL	HPLEGTHEL
KVRDHMVTL	KVRDHMVTL
IPKDYKTMTAL	IPKDY-KTM
RPITDSPVL	RPITDSPVL
QPPKPLSSL	QPPKPLSSL
HPAAFPLPV	HPAAFPLPV
KVKNVGIFL	KVKNVGIFL
MPSSRAYGL	MPSSRAYGL
AAKAGLLAL	AAKAGLLAL
IPSTELAKQVI	IPSTELKQV
LMEHIHKL	LMEHI-HKL
VPKMKVPKF	VPKMKVPKF
RPKKPGQSF	RPKKPGQSF
LPSDSHFKITF	LPSDSHFKI
YPQGQAPPL	YPQGQAPPL
MPKPNHDTL	MPKPNHDTL
KPYQKVGL	KPYQK-VGL
VPFPRLHFF	VPFPRLHFF
QPNRYTNRVV	QPNRYTRVV
NPKPASPRFL	NPKPASPRF
APKAGPGVV	APKAGPGVV
LVRDVVSSL	LVRDVVSSL
SPADIVKNL	SPADIVKNL
SPLPAGNAL	SPLPAGNAL
PSITHGPRLS	PSITHGPRL
VPPVQVSPL	VPPVQVSPL
APRHPSTNSL	APRHPSNSL
SPRFPAQYL	SPRFPAQYL
MPKKNRIAI	MPKKNRIAI
VPFNHEIL	VPFNH-EIL
SPSATLAAL	SPSATLAAL
SPWSGLMAL	SPWSGLMAL
RPKVGLGA	RPKVG-LGA
HPKTPLPPEL	HPKTPLPEL
HPRLVVIVL	HPRLVVIVL
RPNFNIKGIRF	RPNFNIKGI
KVKQVHKEVL	KVKQVHEVL
SPAPTHNSL	SPAPTHNSL
EPPDIVKKL	EPPDIVKKL
SPKYSLYEV	SPKYSLYEV
NPKEFYHEV	NPKEFYHEV
TPIREQHVL	TPIREQHVL
WVKEKVVAL	WVKEKVVAL
SPRRTLEHYF	SPRRTLHYF
APQGGMAAL	APQGGMAAL
SPYQRKAGL	SPYQRKAGL
VPLPPKGRVL	VPLPPKRVL
EPQPERSSV	EPQPERSSV
SPALKTTRL	SPALKTTRL
APSPTHVAEL	APSPTHAEL
KPSPLLVGREF	SPLLVGREF
FSASVKKPHTL	SVKKP-HTL
APALARTLQSL	APALA-RTL
PQAKKIKL	PQAKK-IKL
IPKKEKPEL	IPKKEKPEL
EVKPVGPDL	EVKPVGPDL
HLKPLVPSL	HLKPLVPSL
RPREAEVRF	RPREAEVRF
AVKKVIASM	AVKKVIASM
SAKPYAHIL	SAKPYAHIL
HPRAYFMQL	HPRAYFMQL
SPKPNNSYMF	SPKPNNSYM
SPNPDREAIL	SPNPDREAI
VPAKKITAA	VPAKKITAA
RAKPDFKEL	RAKPDFKEL
VQVHIEVL	VQVHI-EVL
RPFHGISTVSL	RPFHGISTV
PPLPKRPAL	PPLPKRPAL
VPQALTGL	VPQAL-TGL
TYDDATKTFT	TYDDATKTF
YPKRPLLGLVL	YPKRPLLGL
VPSPAHIEKL	VPSPAHEKL
NPKVQVEAI	NPKVQVEAI
KPAHLIVSL	KPAHLIVSL
AAKTVFEAL	AAKTVFEAL
LPSNTKFVAL	LPSNTKVAL
YPKQGIFSV	YPKQGIFSV
MPKFSMPGF	MPKFSMPGF
RVKYNLNSL	RVKYNLNSL
SPRKPIDSL	SPRKPIDSL
KPVKPHSSF	KPVKPHSSF
QPIPFPKEAL	IPFPK-EAL
MPFGNVVSA	MPFGNVVSA
LPKLPISL	LPKLP-ISL
VPFERPAVI	VPFERPAVI
SPSHAIFKL	SPSHAIFKL
TPLSSTVTL	TPLSSTVTL
LPASPRARL	LPASPRARL
LVKPVTINV	LVKPVTINV
HPNSNIYNTL	HPNSNINTL
TVWTRPGPEVL	WTRPGPEVL
APSAARELSL	APSAARLSL
LPHLPSLEI	LPHLPSLEI
KPKRSTWRF	KPKRSTWRF
LPSEELNRQL	LPSEELRQL
HPIRVVNAL	HPIRVVNAL
APGYLPTSL	APGYLPTSL
SPYERQLNL	SPYERQLNL
APSESFVVL	APSESFVVL
APEEHPVLL	APEEHPVLL
QPHTILRVV	QPHTILRVV
KPKPPEPSW	KPKPPEPSW
PRSPPRAL	PRSPP-RAL
RPSQNNTIGL	RPSQNNIGL
LVRPHIDISF	LVRPHIISF
MPGALPSL	MPGAL-PSL
LQAPVLVA	LQAPV-LVA
RPRPPPVEQV	RPRPPPEQV
RPRVALQQSF	RPRVALQSF
RPKDYANTL	RPKDYANTL
VPPLPGKAF	VPPLPGKAF
TPTPFFHTF	TPTPFFHTF
NPYFENKVL	NPYFENKVL
APGPEFSGHSL	GPEFSGHSL
SPTPVSWHVM	SPTPVSHVM
KPKPIDVQV	KPKPIDVQV
KIKNVVHEL	KIKNVVHEL
ALGRPSPTL	ALGRPSPTL
RPKLSSPAL	RPKLSSPAL
VPRPAPYSKAL	RPAPYSKAL
LPSGDRVAVSV	LPSGDRVAV
VPRPPATL	VPRPP-ATL
TTYKLVINGKT	TYKLVINGK
AVKQRGISL	AVKQRGISL
APTGSGKTI	APTGSGKTI
SPPGPKPGF	SPPGPKPGF
TPAPPKAVL	TPAPPKAVL
SPNKKPFSL	SPNKKPFSL
FPGVTPRVL	FPGVTPRVL
KVKNSLLSL	KVKNSLLSL
SPKLGLLMV	SPKLGLLMV
SPMADRSMM	SPMADRSMM
FSKPPNPAL	FSKPPNPAL
LPASGQIAL	LPASGQIAL
EPPEKKMAL	EPPEKKMAL
APRSEVEAL	APRSEVEAL
APAPTAVVL	APAPTAVVL
LVKSVDPTL	LVKSVDPTL
LPRRPLPPA	LPRRPLPPA
QPNKPSKEL	QPNKPSKEL
VPRIQPQSL	VPRIQPQSL
TPGMLHAGQSL	TPGMLHQSL
LVKVPDPQM	LVKVPDPQM
SPKHGFTIM	SPKHGFTIM
LPSQSRNKETL	LPSQSRETL
SPHLGPAPA	SPHLGPAPA
TPRPPGPGL	TPRPPGPGL
TPQNKITVV	TPQNKITVV
VPYLKIFTV	VPYLKIFTV
VPFFPARVL	VPFFPARVL
TVSDSIKKL	TVSDSIKKL
TPDPQRVPL	TPDPQRVPL
RPRPPRQL	RPRPP-RQL
HPSETRTLVAV	HPSET-RTL
MPWFKGWKV	MPWFKGWKV
QPDPESVVL	QPDPESVVL
LPKYGVKVGL	LPKYGVVGL
GEYKFQNAL	GEYKFQNAL
RPYEPINSI	RPYEPINSI
TPATTLHLL	TPATTLHLL
SPKPVSSTV	SPKPVSSTV
TVRAVIATL	TVRAVIATL
GPKPKTFLL	GPKPKTFLL
RPMNENVQM	RPMNENVQM
VPKVVGSAV	VPKVVGSAV
NPNLSGHLL	NPNLSGHLL
ETYVPKEF	ETYVP-KEF
APFDRRATSL	APFDRRTSL
ALPHAILRLDL	LPHAILLDL
APKANATIEV	APKANAIEV
RPHTVLTVI	RPHTVLTVI
RAKEIRLSL	RAKEIRLSL
LPKSTVNGV	LPKSTVNGV
RPLPPPDTL	RPLPPPDTL
PPNHVGKPL	PPNHVGKPL
VPLEQSPVL	VPLEQSPVL
VPKKPGPPVL	VPKKPGPVL
VPKIAPDVL	VPKIAPDVL
IPKNNPPTL	IPKNNPPTL
RPRTEVSL	RPRTE-VSL
ILKPTGNQL	ILKPTGNQL
SPMIPSIVV	SPMIPSIVV
APQSFRAEL	APQSFRAEL
IPTVNPVAI	IPTVNPVAI
TAAAVGAVF	TAAAVGAVF
IPKFFKHFPEL	IPKFFKPEL
IPQERGLSSL	IPQERGSSL
NPKESSSSL	NPKESSSSL
YPSLPKSLPL	YPSLP-KSL
KIKNGTPPM	KIKNGTPPM
SPNENFKTV	SPNENFKTV
IPRNPPPRL	IPRNPPPRL
YPLERGFIYV	YPLERGIYV
RPRQQDPHL	RPRQQDPHL
RPKVLMRL	RPKVL-MRL
KAKDPFAHL	KAKDPFAHL
QPPYHLKAF	QPPYHLKAF
IPPYALGKSL	PPYALGKSL
LPKKVGKWYQL	LPKKVGYQL
RPQIKDFKEKI	RPQIKDKEK
APAAPGLSL	APAAPGLSL
MPFQRAGVNF	MPFQRAVNF
FPTQVIPLKTL	FPTQV-IPL
KAKPVTTNL	KAKPVTTNL
IPKPVHTRF	IPKPVHTRF
KPTSERKVSL	KPTSERVSL
YPYPYPHTL	YPYPYPHTL
RPRDSPTL	RPRDS-PTL
SPNSVKPEM	SPNSVKPEM
SPSHNLKSL	SPSHNLKSL
EPRPAEPPA	EPRPAEPPA
YVALVHPDL	YVALVHPDL
PMLVAGLKGL	LVAGL-KGL
IPHMDIEAL	IPHMDIEAL
FPHPVNQVTF	FPHPVNVTF
SPNTAGLRSL	SPNTAGRSL
MIRAAPPPL	MIRAAPPPL
APRPPVSAA	APRPPVSAA
TASPVIKAV	TASPVIKAV
APRPGPRAV	APRPGPRAV
PRPSTGPHKL	RPSTGPHKL
TPATLHIL	TPATL-HIL
TPSNIAIVL	TPSNIAIVL
IPKEVDKIVF	IPKEVDIVF
IAHAKAVAA	IAHAKAVAA
SPQEARNML	SPQEARNML
LPPPAAKTV	LPPPAAKTV
HPQPGSANSL	HPQPGSNSL
KPKGPTSAELL	KPKGPTAEL
APAPPKAEA	APAPPKAEA
RPFPPHIQL	RPFPPHIQL
APHARNGLSL	APHARNLSL
IPPGTHEAL	IPPGTHEAL
APKPEASPSM	APKPEAPSM
TPAPPTHAL	TPAPPTHAL
SPMERRLVEQL	SPMERREQL
QVRPVTEKL	QVRPVTEKL
IVKEIHEQL	IVKEIHEQL
RPHAFQVIL	RPHAFQVIL
IPQKFHRSV	IPQKFHRSV
MPHRGRLNVL	MPHRGRNVL
MPPPVGMVA	MPPPVGMVA
KPEYGRPNV	KPEYGRPNV
FPQLKSLETL	FPQLKSETL
RPWEKNSTTL	RPWEKNTTL
MPKFSMPSL	MPKFSMPSL
VVSEVDIAKAD	VVSEVDIAK
APYERRAMELL	APYERRMEL
VPSFRPYLL	VPSFRPYLL
MPISSHVDL	MPISSHVDL
VPKPGAGSKL	VPKPGASKL
LPTPVVKTT	LPTPVVKTT
QPHRVSQVL	QPHRVSQVL
APRVKEGPL	APRVKEGPL
APRLETKSL	APRLETKSL
VPNVHGAL	VPNVH-GAL
APRQPGLMAQM	APRQPGLMA
SPRLPVGGF	SPRLPVGGF
LPLGPGREAL	LPLGPGEAL
IPRQVAQTL	IPRQVAQTL
LPALPTQAL	LPALPTQAL
KPIEPRREL	KPIEPRREL
VPSPALPRSL	VPSPALRSL
TPHQTFVRL	TPHQTFVRL
LPPMTPKTM	LPPMTPKTM
SPKQGVSL	SPKQG-VSL
HPKGRDNIIDL	HPKGRDNII
TPAGNFVTL	TPAGNFVTL
MPNPSLAQVKI	MPNPSLAQV
HPGPVNSEL	HPGPVNSEL
RVSSHLKHL	RVSSHLKHL
SVKKGFEF	SVKKG-FEF
LPDGQVITI	LPDGQVITI
MPADTNKAF	MPADTNKAF
EVKRPGESL	EVKRPGESL
VPDQPHPEI	VPDQPHPEI
IPAPGSGVSF	IPAPGSVSF
RPFGTIRPM	RPFGTIRPM
SPKKPVIVFV	SPKKPVIVF
YPKFKYALL	YPKFKYALL
IAPTGHSL	IAPTG-HSL
YPVKSEGKEL	PVKSEGKEL
APMMVSNIL	APMMVSNIL
SPPKAMKKF	SPPKAMKKF
TPNRATFVV	TPNRATFVV
YPAYLGARL	YPAYLGARL
APAPASISL	APAPASISL
APILKRAL	APILK-RAL
IPQVTSDGKRL	QVTSDGKRL
QPDQTRIVAL	QPDQTRVAL
TPAVHASL	TPAVH-ASL
RPYQPLGAL	RPYQPLGAL
IPKVAVEVF	IPKVAVEVF
RPKQENHLHSL	RPKQE-NHL
RPRPNTFVIR	RPRPNTFVI
TPSASRKSL	TPSASRKSL
KPKPVKPVTF	KPKPVKVTF
TAKATVAAF	TAKATVAAF
QPGSTVHVL	QPGSTVHVL
TAKFHFVDL	TAKFHFVDL
TPIEGMLSHQL	TPIEGMLSH
RPRPEYVAIF	RPRPEYVAI
KPILSTRSL	KPILSTRSL
RPKYQFLSL	RPKYQFLSL
TPLLMQALPM	TPLLM-QAL
FAPYNKPSL	FAPYNKPSL
LPKPPKPVS	LPKPPKPVS
SAKTPGFSV	SAKTPGFSV
HVQQNRAVL	HVQQNRAVL
TPSAGKAML	TPSAGKAML
PLDSIHSL	PLDSI-HSL
RPHIPISKL	RPHIPISKL
IPKHINPVAA	IPKHINPVA
VPLKQGRSL	VPLKQGRSL
FPHKRLQQL	FPHKRLQQL
IPPPYDKKKRM	PPYDKKKRM
MPQNRTIYVTL	MPQNRTIYV
MPKKGGRWWF	MPKKGGWWF
YPMKSEKIHGL	MKSEKIHGL
HPTFNLKSL	HPTFNLKSL
VPMTPLRTV	VPMTPLRTV
QPRNDFGNFF	QPRNDFNFF
SPKVPRTL	SPKVP-RTL
MPKFSVPGF	MPKFSVPGF
VPRQNVPVI	VPRQNVPVI
VPKTHLEL	VPKTH-LEL
LPEKKGNTL	LPEKKGNTL
APFLRQEFI	APFLRQEFI
LPQKPHLKL	LPQKPHLKL
KPKMNYEKL	KPKMNYEKL
LPQPPRDVL	LPQPPRDVL
SPKFPDSQNQL	SPKFPDNQL
KPFLPSIIAL	KPFLPSIAL
VPHPKKPEHTL	HPKKPEHTL
SPNGHRPQL	SPNGHRPQL
VPNQKRLTL	VPNQKRLTL
NPQKEKVRL	NPQKEKVRL
MPAFLRSAL	MPAFLRSAL
HPIYNIKSL	HPIYNIKSL
APISVRVEL	APISVRVEL
GPKPLFRRM	GPKPLFRRM
FPPPSLPSKSV	PPSLPSKSV
YPNPKPEVL	YPNPKPEVL
SPMSDVVSREL	SPMSDVREL
MPKVKMPKF	MPKVKMPKF
IPKPLNPAL	IPKPLNPAL
TVKPLTLEL	TVKPLTLEL
APSRSLNEL	APSRSLNEL
RPKLNRENF	RPKLNRENF
VPPYGVAL	VPPYG-VAL
TPKSQVGTL	TPKSQVGTL
RPKSNIVLL	RPKSNIVLL
SPKPAIKSI	SPKPAIKSI
KPLVPREHQF	KPLVPRHQF
SPKFPIWIV	SPKFPIWIV
TPPTTVSGKVM	PPTTVSKVM
TPLASTSNSL	TPLASTNSL
APRWGNPRAL	APRWGNRAL
SPKIHARVF	SPKIHARVF
SPQAPTHFL	SPQAPTHFL
LPQEDLEAL	LPQEDLEAL
VPASFRLQM	VPASFRLQM
MPFYNPAQL	MPFYNPAQL
VPPNHVGKPL	VPPNHVKPL
MPLSTIREV	MPLSTIREV
LPKKSIDTGM	LPKKSITGM
HPFPESKPVL	HPFPESPVL
RPMSYDEKRQL	MSYDEKRQL
TPFIRPVM	TPFIR-PVM
RPEEGRPVV	RPEEGRPVV
KPKEPQPEV	KPKEPQPEV
RPQLQRQVL	RPQLQRQVL
SPSKPNPVF	SPSKPNPVF
LPKEHAASL	LPKEHAASL
APRPPPARL	APRPPPARL
LPAGIVAVL	LPAGIVAVL
APELPIKIL	APELPIKIL
NPKRQTLVF	NPKRQTLVF
TPAVGRLEV	TPAVGRLEV
SPYIRALGF	SPYIRALGF
RLRNHMAVA	RLRNHMAVA
MPTRPHQHL	MPTRPHQHL
TLLPPIKVL	TLLPPIKVL
RVKKLSLSL	RVKKLSLSL
VPIDITVKL	VPIDITVKL
SPKGASVSI	SPKGASVSI
KPRPPPSQL	KPRPPPSQL
SPGLLPHLL	SPGLLPHLL
APGSARRPL	APGSARRPL
RPQLKGVVL	RPQLKGVVL
NPKNVNRVL	NPKNVNRVL
FPQEIRQDL	FPQEIRQDL
NPAPPIDAV	NPAPPIDAV
APVFRDYVF	APVFRDYVF
TPKYSQVLGL	TPKYSQLGL
LPARFYQAL	LPARFYQAL
HPLSNPAEL	HPLSNPAEL
LLTTAKNL	LLTTA-KNL
TISPIIKLL	TISPIIKLL
APTVTMVRVV	APTVTMRVV
SPADHRGYASL	SPADHRASL
GVKKPTKAL	GVKKPTKAL
LPSSGRSSL	LPSSGRSSL
FPPKKLFSL	FPPKKLFSL
APLLRWVL	APLLR-WVL
KPGVSSKKF	KPGVSSKKF
APMQEKVTL	APMQEKVTL
GPSGAAAMRSM	GPSGA-AAM
APRGTGIVSA	APRGTGVSA
RPLKRPRL	RPLKR-PRL
TPKQPVVRF	TPKQPVVRF
SPKAALRYAA	SPKAALYAA
KVHSLQSSL	KVHSLQSSL
VPRPAARVAL	VPRPAAVAL
MPRHFAAKL	MPRHFAAKL
KVPQLEIVPN	VPQLEIVPN
MPKKDARTL	MPKKDARTL
EPRPFPKLRIL	RPFPKLRIL
SPEAQPKTL	SPEAQPKTL
QPNEQHPVSL	QPNEQHVSL
APGPINFTM	APGPINFTM
SPEDPGAEV	SPEDPGAEV
VPNSAIYKRVL	VPNSAIKRV
RPRGFAYVQF	RPRGFAVQF
TPKQEIQHL	TPKQEIQHL
RPKGLGVFF	RPKGLGVFF
VPKTAENFRAL	KTAENFRAL
IPQPPILQL	IPQPPILQL
SPHPQPTHL	SPHPQPTHL
IVKKQIVKL	IVKKQIVKL
KVKSYIHEV	KVKSYIHEV
RPKLQHSTSIL	RPKLQHTSI
SPKEPPNGNAF	SPKEPPNAF
FPRPDQQHSV	FPRPDQHSV
RPPPVGHSF	RPPPVGHSF
IPYMKKYKIQ	IPYMKKYKI
TPKSERYEHVL	TPKSERHVL
SPPPSHPLKAV	SPPPS-HPL
APIEAQVRL	APIEAQVRL
APQTHLGL	APQTH-LGL
LPKPKAKTL	LPKPKAKTL
SPKFSELVM	SPKFSELVM
RPNDSRMLVAL	RPNDSRMLV
SPGPSRPGL	SPGPSRPGL
HPNKPKDHVFL	HPNKPKHVF
VAKAVTQAL	VAKAVTQAL
MPKKSSVVL	MPKKSSVVL
LPDERTISL	LPDERTISL
RPKPKTLHEL	RPKPKTHEL
PRPPHGEL	PRPPH-GEL
SPRDPVLTL	SPRDPVLTL
PAAKRVKL	PAAKR-VKL
HPKPSDLHL	HPKPSDLHL
VPQDTKLVL	VPQDTKLVL
GPKKGSVL	GPKKG-SVL
RPHPLRPEAEL	RPHPLRPEA
APRPSTGPHKL	RPSTGPHKL
DIAALVVD	DIAAL-VVD
VPFSVPKIPL	VPFSVPIPL
APSSPRPAL	APSSPRPAL
APMPPIIHA	APMPPIIHA
IPSANPAKTM	IPSANPKTM
KVKQLFNSL	KVKQLFNSL
RIKNNDPKL	RIKNNDPKL
LPYNNKDRDAL	LPYNNKDAL
FPQEGMHQM	FPQEGMHQM
VPRLFSLTL	VPRLFSLTL
TPHLHSIL	TPHLH-SIL
NPNSNTLGHIL	NPNSNTHIL
LPSALVSHVL	LPSALVHVL
IPSSVIHPAMV	IPSSVIPAM
KPMEKLLGL	KPMEKLLGL
VPSAAGYAL	VPSAAGYAL
RPAVIGDVL	RPAVIGDVL
NPKKPITEI	NPKKPITEI
IPLFHGTLAL	IPLFHGLAL
APKGLWSQNQL	APKGLWNQL
TPQLNKNTL	TPQLNKNTL
IANAVVKEL	IANAVVKEL
SPMDDGFVSL	SPMDDGVSL
LPIPRPGEVL	LPIPRPEVL
LPKPPPGVGL	LPKPPPVGL
APKIGSNGVEM	APKIGSNGV
YPKLKTDVL	YPKLKTDVL
SPKNTVISV	SPKNTVISV
APAAGAVRAL	APAAGARAL
PRSPQPEL	PRSPQ-PEL
SPNQKLLAVSL	SPNQKLLAV
KPGTFPKAL	KPGTFPKAL
APFTAGTSL	APFTAGTSL
KPKTPSLTVFL	KPKTPSLTV
RPHSIDGRVV	RPHSIDRVV
APRIPVTL	APRIP-VTL
HPSDIEVDL	HPSDIEVDL
TPKGLSPAM	TPKGLSPAM
APIGPHLQSM	APIGPHQSM
EVKPYSIEM	EVKPYSIEM
NPKFNDPHV	NPKFNDPHV
SPITARDAL	SPITARDAL
SPKSGEEAAVL	SPKSGEEAA
KPRKPITFV	KPRKPITFV
TPQEKEAIERL	TPQEK-EAI
TITQVIKVL	TITQVIKVL
RPQVAKTLL	RPQVAKTLL
RPRPPTLL	RPRPP-TLL
NPEKRYNVL	NPEKRYNVL
TAKAVAVTL	TAKAVAVTL
LPLPLRKPTTL	LPLRKPTTL
VPAAVFGSL	VPAAVFGSL
KPQGPRGFL	KPQGPRGFL
SPSDPSSSL	SPSDPSSSL
GPKGTMKML	GPKGTMKML
KPPSAEYKVV	KPPSAEYKV
MPSDVLEVT	MPSDVLEVT
RPVKLFRV	RPVKL-FRV
RPQPVLPLL	RPQPVLPLL
RPRPGNILL	RPRPGNILL
VPKSGTPQL	VPKSGTPQL
TPRHKQPTL	TPRHKQPTL
APYGKNQVQAL	APYGKNQAL
TPNEYIKTL	TPNEYIKTL
HPRPYFKSV	HPRPYFKSV
TPKTTGARVEL	TPKTTGARV
MPEEKLVEAL	MPEEKLEAL
IVKPPVRKL	IVKPPVRKL
HPTDERVAL	HPTDERVAL
KPWEKSPIL	KPWEKSPIL
RPKPPNVRT	RPKPPNVRT
RPRPPVLSV	RPRPPVLSV
LPYDRNISNYF	LPYDRNISN
VPKGNTAVSVL	VPKGNTVSV
HPMGGLNAM	HPMGGLNAM
IPYPRPIHL	IPYPRPIHL
VPAARSILAL	VPAARSLAL
RPASEATFNVF	RPASE-ATF
MPYLSHQQL	MPYLSHQQL
SPLPSPSAM	SPLPSPSAM
TTKPVGLLL	TTKPVGLLL
TAKPQQIQAL	TAKPQQQAL
SPPTPTVTL	SPPTPTVTL
TPADGFTVL	TPADGFTVL
MPQKERESI	MPQKERESI
RPRDPTPSF	RPRDPTPSF
SPRHSFNNL	SPRHSFNNL
HPADSVVSV	HPADSVVSV
KPNPNQIISV	KPNPNQISV
RPKAVREQLL	RPKAVREQL
IPSEDIARNLM	IPSEDIRNL
APKSRQELIAL	APKSR-QEL
KPFDKFQFERL	KPFDK-FQF
RPPEITGQVSL	PPEITGVSL
MPKKSIKKL	MPKKSIKKL
VPKSAVQQV	VPKSAVQQV
RPRHQGVMV	RPRHQGVMV
FPAKPGSLTL	FPAKPGLTL
HPAGPRTVFF	HPAGPRTVF
SPPATSKAL	SPPATSKAL
LPQANRDTL	LPQANRDTL
SPKAALRYAAV	SPKAALYAA
KPSEERVREI	KPSEERREI
RPRPHSAPSL	RPRPHSPSL
RPAPPLRPSA	RPAPPLPSA
APALVSKKL	APALVSKKL
RPNGVITGL	RPNGVITGL
APRPVDEPAM	APRPVDPAM
SPISHFLDL	SPISHFLDL
VPLVREITF	VPLVREITF
MPALFSDHTF	MPALFSHTF
LPAKFKKLL	LPAKFKKLL
APKASLRLGF	APKASLLGF
SPVVHSVL	SPVVH-SVL
SPNAEIHIL	SPNAEIHIL
RPDDRSQGAII	RPDDRSQGA
SVKRGFEF	SVKRG-FEF
APSPPLRAL	APSPPLRAL
RPFERTITM	RPFERTITM
KPSNSKSETTL	KPSNSKSET
KPKEVTTVKV	KPKEVTVKV
SPKTKVTTV	SPKTKVTTV
MIQNSRPSL	MIQNSRPSL
RVQGDKRLSSL	VQGDKRSSL
RPRPVLRSV	RPRPVLRSV
NPRIPYTEL	NPRIPYTEL
RPRPSEDTF	RPRPSEDTF
RPKLPLLKI	RPKLPLLKI
LLLPGELAK	LLLPGELAK
APRAASTESL	APRAASESL
IPYMFEAREF	IPYMFEREF
YPLEKGHLF	YPLEKGHLF
RPKELVEVI	RPKELVEVI
RPRPGNILLQL	RPRPGNILL
KPHWNDGAIL	KPHWNDAIL
NPRKHITSL	NPRKHITSL
VPKADSGAFL	VPKADSAFL
TPRSYVGVTL	TPRSYVVTL
KPKIQHVGL	KPKIQHVGL
APFKFDMEL	APFKFDMEL
KPNEFASQINL	KPNEFASQI
LPSGSKKVI	LPSGSKKVI
APEPASQARVL	EPASQARVL
RPHYGKLKEI	RPHYGKKEI
LPFLRITSL	LPFLRITSL
RPMQQVDTL	RPMQQVDTL
SPHLLEAL	SPHLL-EAL
VPDSSGPERIL	VPDSSGERI
VPRNTRAL	VPRNT-RAL
WIKEKIYVL	WIKEKIYVL
TDAIKLNPRL	AIKLN-PRL
RPKAISPYHL	RPKAISYHL
YPGQPHPAL	YPGQPHPAL
KPQDYKKRLSV	KPQDYKKRL
RPREKKLGL	RPREKKLGL
TPHAVGVLL	TPHAVGVLL
HPIDGFLQSL	HPIDGFQSL
PLSKIKTL	PLSKI-KTL
SPKDNPSIF	SPKDNPSIF
KPPSPGTVL	KPPSPGTVL
QPSPMQHQF	QPSPMQHQF
YPFKPPKVTF	YPFKPPVTF
VPKPGKGADL	VPKPGKADL
KPGDFIHTL	KPGDFIHTL
PFSFHHVL	PFSFH-HVL
RPIYIDGRPVL	RPIYIDPVL
IPADTFAAL	IPADTFAAL
MPKFSVSGL	MPKFSVSGL
TPQKLPSL	TPQKL-PSL
YPSVENVRTSL	SVENVRTSL
AVRKPAISL	AVRKPAISL
NPAENFRVL	NPAENFRVL
KPAEVVKIL	KPAEVVKIL
TPKTPKGPSSV	TPKGP-SSV
APKSMQSAIM	APKSMQSAI
KPFYVNVEF	KPFYVNVEF
RVKPAVFDL	RVKPAVFDL
LPKESVKIL	LPKESVKIL
APATVGLAF	APATVGLAF
SPMPGTLTAL	SPMPGTTAL
TPKPQTKELM	TPKPQTKEL
KPMMKEFRF	KPMMKEFRF
RPGWRSIEEVL	RPGWRSEEV
HPMYGNIL	HPMYG-NIL
WAMDLRPEL	WAMDLRPEL
IVKPKPRAL	IVKPKPRAL
HPNTRIGVFL	HPNTRIVFL
IPSPGQLQHRV	SPGQLQHRV
RPHNLKVHIL	RPHNLKHIL
TAKGHIVLL	TAKGHIVLL
TPRPTAAEL	TPRPTAAEL
IPSGSVTAL	IPSGSVTAL
RPHTNETSL	RPHTNETSL
VPAKSTLLQVL	VPAKS-TLL
TPHARIIEL	TPHARIIEL
APMIKKIAF	APMIKKIAF
RAKKPDPGL	RAKKPDPGL
TPSNNVHTSL	TPSNNVTSL
APMKAPKRM	APMKAPKRM
KPESKYVSL	KPESKYVSL
APKEINIDF	APKEINIDF
LPSGNNNGKVL	LPSGNNKVL
APKKPTGVDL	APKKPTVDL
RPWSNSRGL	RPWSNSRGL
HPADPGSRPHL	HPADPGPHL
VPKPPVPAVL	VPKPPVAVL
SPAQVKTSV	SPAQVKTSV
IRSHSKAVL	IRSHSKAVL
VPKLQPQI	VPKLQ-PQI
KPKDPKVISEL	KPKDPKSEL
HAAEYGAEALE	HAAEYGEAL
SPFLPGFSQSL	SPFLPGQSL
TPRHLDPSL	TPRHLDPSL
SPIERQKSL	SPIERQKSL
HPKNPEVGL	HPKNPEVGL
SPRVPNSSV	SPRVPNSSV
SPSEIMESL	SPSEIMESL
YPKGIHVETL	YPKGIHETL
SPMEGTGISL	SPMEGTISL
LPYGREDVL	LPYGREDVL
RPKSNIVLLSA	RPKSNIVLL
LVNEVTEFAK	LVNEV-TEF
FPEADKVRTM	FPEADKRTM
KPKGKVTIL	KPKGKVTIL
APHLVGPHL	APHLVGPHL
VPKNYVVVL	VPKNYVVVL
SPKSPTAAL	SPKSPTAAL
RPQDGVAVL	RPQDGVAVL
KVKAFIVTL	KVKAFIVTL
RPKPSSSPVIF	RPKPSSPVI
MPKVSGPDL	MPKVSGPDL
AAYLRALSL	AAYLRALSL
TPSSSKKVTF	TPSSSKVTF
SPASPKISL	SPASPKISL
KPGPVGPEL	KPGPVGPEL
LPWVGKEL	LPWVG-KEL
NPYFRNEGL	NPYFRNEGL
RPNPPPVSV	RPNPPPVSV
RPILIIVTL	RPILIIVTL
MPTMRLLSF	MPTMRLLSF
RPYKPVVL	RPYKP-VVL
VPPLVPKVL	VPPLVPKVL
VTRLPDGPA	VTRLPDGPA
VPKQVVTGTVL	VPKQVVTVL
TPKWITPVL	TPKWITPVL
VPHGAGYEL	VPHGAGYEL
RVKIQTVAA	RVKIQTVAA
VPVGPHLSL	VPVGPHLSL
LPIVTPAL	LPIVT-PAL
SPETRENAL	SPETRENAL
NAPWAVTSL	NAPWAVTSL
SPQVQRPSF	SPQVQRPSF
SPKLHAEAI	SPKLHAEAI
MPNENIPEL	MPNENIPEL
LPQLAQPTL	LPQLAQPTL
SPKVPRTLL	SPKVPRTLL
TPINKRPVL	TPINKRPVL
QPAEMAAEL	QPAEMAAEL
PSVGQLAHKL	SVGQLAHKL
LPTTTGSAHAL	TTTGSAHAL
RPRPTWEEV	RPRPTWEEV
QPVARPVSV	QPVARPVSV
VPKKISFKSL	VPKKISKSL
RPAPPAQSL	RPAPPAQSL
RPFEDQTSL	RPFEDQTSL
SPQDKRTLL	SPQDKRTLL
QPTIERVAL	QPTIERVAL
SPRQGNSKNVL	SPRQGNKNV
SPKMPLKTL	SPKMPLKTL
IVKMVMISL	IVKMVMISL
MPRNLREYM	MPRNLREYM
SPKPPPQRVTL	KPPPQRVTL
APWDRVVDL	APWDRVVDL
LLKDSIVQL	LLKDSIVQL
VPRPGKAAF	VPRPGKAAF
LPFKKGEIL	LPFKKGEIL
HPQTHETAL	HPQTHETAL
IPREVSETL	IPREVSETL
MTKPPVQEM	MTKPPVQEM
APKRPPSGF	APKRPPSGF
SPRTPSTRL	SPRTPSTRL
AVKPAVTTL	AVKPAVTTL
IPAIRDITL	IPAIRDITL
VPKSMRVKL	VPKSMRVKL
RPREAEVRFL	RPREAEVRF
SPKIRSHAV	SPKIRSHAV
GPRSSLRVL	GPRSSLRVL
TPQALRFEEL	TPQALREEL
LPAKILVEF	LPAKILVEF
RPAAPGQTPL	RPAAPGTPL
IIHEIAVLEL	IIHEIALEL
RPLEQQQPHHI	RPLEQQQPH
KPKKTEITDKL	KPKKTEITD
APKRPPLAF	APKRPPLAF
IPFAAPTAL	IPFAAPTAL
SPFSFHHVL	SPFSFHHVL
KPKDMGFTRL	KPKDMGTRL
FAKPVYPGQTL	KPVYPGQTL
SPQKVTLYL	SPQKVTLYL
YPMDLGGRNF	YPMDLGRNF
SPGNIGKLL	SPGNIGKLL
SPKATSSPLYL	SPKATSSPL
SPNLRLLDL	SPNLRLLDL
LIMGFLVLGL	LIMGFLLGL
IPPPPPPAM	IPPPPPPAM
PSESTVVST	PSESTVVST
RPRPSEDTFL	RPRPSEDTF
KPKPEDPKF	KPKPEDPKF
LPKPTEPPM	LPKPTEPPM
VPAAREPEVL	VPAAREEVL
RPRDKQMELL	RPRDKQMEL
APGPPGRSM	APGPPGRSM
FPKAVSVF	FPKAV-SVF
SPAILPPL	SPAIL-PPL
APVYFPEEL	APVYFPEEL
TPSSVRKQL	TPSSVRKQL
APAPAAHVA	APAPAAHVA
NPKTGPTL	NPKTG-PTL
MPKVKTIEL	MPKVKTIEL
LPKEDPTAV	LPKEDPTAV
HPKPVPGFQV	HPKPVPFQV
TPKEAIEGTYI	TPKEAIEGT
SPNPEIPAL	SPNPEIPAL
LPESNNQVKTL	LPESNNKTL
NPTATVKML	NPTATVKML
PHLVGPHL	PHLVG-PHL
SPFKRQLSL	SPFKRQLSL
TPMPSRPST	TPMPSRPST
SPKSALGSSAL	SPKSALSSA
SPKIASHQF	SPKIASHQF
SPTGNHVNEIL	SPTGNHNEI
RPREVTVSL	RPREVTVSL
LPSDLRTISL	LPSDLRISL
SPIKDQPVM	SPIKDQPVM
HPPLKIDGKTI	PPLKIDKTI
PSGSKKVI	PSGSK-KVI
