Data	Data aligned
VAGPVGGSL	VAGPVGGSL
NAVDPDVSA	NAVDPDVSA
SPLKHFVTA	SPLKHFVTA
SSDPKVLTL	SSDPKVLTL
VAGPALEAL	VAGPALEAL
NADPLKVYPPL	NADPLKVYP
NAVAAAHSV	NAVAAAHSV
RALEHFTDL	RALEHFTDL
VPKPIGGVVVF	VPKPIGVVV
AALQDRSIL	AALQDRSIL
RPFEGFQRKA	RPFEGFRKA
AADKGVYII	AADKGVYII
AEQRGENALKD	AEQRGENAL
FSYYNSHDSL	FSYYNSDSL
SWFTHPSL	SWFTH-PSL
FAIPMIHAV	FAIPMIHAV
SAAENFLVL	SAAENFLVL
FAVEPQGPAL	FAVEPQPAL
FADGKVYAL	FADGKVYAL
NSHVIQEYL	NSHVIQEYL
LATRAIPEL	LATRAIPEL
TIFKDHVSL	TIFKDHVSL
LSDPQVHTV	LSDPQVHTV
LAIESANEL	LAIESANEL
SAHIMGEAM	SAHIMGEAM
FAFESDLHSL	FAFESDHSL
VADRLMLEL	VADRLMLEL
VATPPDGVSL	VATPPDVSL
VATDFFTVL	VATDFFTVL
YASDYFDQL	YASDYFDQL
FIIYDTHSL	FIIYDTHSL
KAIGPHDVL	KAIGPHDVL
YAPKGSSL	YAPKG-SSL
FAYPAPLEV	FAYPAPLEV
SADGMRLAL	SADGMRLAL
FANDDRHVM	FANDDRHVM
AADPVSPLL	AADPVSPLL
KAPGSTSNL	KAPGSTSNL
TVTEKPEVIDA	TVTEKPEVI
YALDLSTFL	YALDLSTFL
AAMKALQAL	AAMKALQAL
TAQILLKAL	TAQILLKAL
YASPDLSKL	YASPDLSKL
AANLLNDAL	AANLLNDAL
LPKPPGRGV	LPKPPGRGV
YAPSGNFV	YAPSG-NFV
VVDGTPLVA	VVDGTPLVA
TVVEPYNATL	TVVEPYATL
GATAAAPVP	GATAAAPVP
DRVYIHPFHL	RVYIHPFHL
AAEQSFAEL	AAEQSFAEL
FAFLISERL	FAFLISERL
YIDDVFHAL	YIDDVFHAL
FLDEKTHEL	FLDEKTHEL
KSVDPENNPTL	SVDPENPTL
YAYETKDAL	YAYETKDAL
AAEEANAVL	AAEEANAVL
AAIKPGTPL	AAIKPGTPL
AAAAANPTL	AAAAANPTL
VAAPASLSL	VAAPASLSL
ANITPREGDEL	ITPREGDEL
AAPATRAAL	AAPATRAAL
MIIENFEAL	MIIENFEAL
FALEPIDITV	FALEPIITV
SASPPGPTL	SASPPGPTL
NADHTTLLL	NADHTTLLL
QADTTRLEL	QADTTRLEL
AAFYEDKKGVL	AAFYEDGVL
IAQGSYIAL	IAQGSYIAL
TVKPPTSVA	TVKPPTSVA
IIDDVMKEL	IIDDVMKEL
AAVPPAEEL	AAVPPAEEL
NVKFPDEDEIL	FPDED-EIL
TAAPVQETL	TAAPVQETL
NAILVDTPL	NAILVDTPL
FSDPIHPQL	FSDPIHPQL
AAAAAAKVPA	AAAAAKVPA
FATADEYHL	FATADEYHL
MSADVPLVV	MSADVPLVV
VAVISGEAL	VAVISGEAL
AAVEPDVVV	AAVEPDVVV
YAAYPLTEV	YAAYPLTEV
RAVQDVESL	RAVQDVESL
FSHTQVIEL	FSHTQVIEL
VSDQANHVL	VSDQANHVL
VAEEPAGTSL	VAEEPATSL
AAAPAGTTF	AAAPAGTTF
SAAPPLPSL	SAAPPLPSL
NSFTHEAL	NSFTH-EAL
AALLDHDAFVL	AALLDHDAF
NALDLNSVL	NALDLNSVL
VVIEPISEL	VVIEPISEL
FISHLFMQL	FISHLFMQL
RVMELFFTV	RVMELFFTV
YWQNHPEL	YWQNH-PEL
FAEDITTGQVL	FAEDITQVL
VADRLLVEL	VADRLLVEL
AATEEAQAL	AATEEAQAL
LLPPRAATL	LLPPRAATL
KAIGNAFAVL	AIGNAFAVL
IIQDIDDTHVF	IIQDIDTHV
YAAQASQAL	YAAQASQAL
RSHYSPIYL	RSHYSPIYL
STYDGAETL	STYDGAETL
SPYHNFDSV	SPYHNFDSV
FLFSKFIEL	FLFSKFIEL
VATWVDETL	VATWVDETL
IITDFDMTL	IITDFDMTL
FIYNPTTGEFL	YNPTTGEFL
VADDQGQHPL	VADDQGHPL
FAVSDGLEL	FAVSDGLEL
AAHVIAEDV	AAHVIAEDV
SPHPSPLGA	SPHPSPLGA
KAFADSSYL	KAFADSSYL
YSYFEKETL	YSYFEKETL
SAVGQFVSL	SAVGQFVSL
SPKQILDPA	SPKQILDPA
SIPEPIDPL	SIPEPIDPL
FADGHVLEL	FADGHVLEL
VTYPGELLL	VTYPGELLL
TALAIYHVI	TALAIYHVI
FAQTLHPSL	FAQTLHPSL
RALDHEEEAL	RALDHEEAL
AADPSVVNL	AADPSVVNL
KVVDPDHPL	KVVDPDHPL
KAAAAKVEL	KAAAAKVEL
VASEVYKAV	VASEVYKAV
AGWEGTESL	AGWEGTESL
VAVGEFQEV	VAVGEFQEV
SPFGTITSA	SPFGTITSA
IADPKTDHRL	IADPKTHRL
YIDEGRLVL	YIDEGRLVL
HAVSDPSIL	HAVSDPSIL
RGDETFAVL	RGDETFAVL
KAVTPSPEQVF	AVTPSPEQV
FAIPGSSFL	FAIPGSSFL
RVFLDHNAL	RVFLDHNAL
KILDTFEKL	KILDTFEKL
VAVGVIKAV	VAVGVIKAV
SALKAIHAL	SALKAIHAL
SASGPFESH	SASGPFESH
FLPDHPIVL	FLPDHPIVL
KAPEATVTL	KAPEATVTL
KALGIDNVL	KALGIDNVL
KADAVVPEL	KADAVVPEL
NAVPGDVLVL	AVPGDVLVL
KAFVFSVAL	KAFVFSVAL
YSLDHISSL	YSLDHISSL
YAISPGLDI	YAISPGLDI
VSQVGKEL	VSQVG-KEL
SAASPAVAL	SAASPAVAL
FTDDQLLVL	FTDDQLLVL
RPAGALVALVV	RPAGALVAL
SAIFNFQSL	SAIFNFQSL
FSHYMEENL	FSHYMEENL
RPAAAPPAGA	AAAPP-AGA
IAVEPGNQWF	IAVEPGNQW
AKNKLNDLED	KNKLNDLED
FAHHGRSL	FAHHG-RSL
LAWLDEHTL	LAWLDEHTL
VASEVNLTA	VASEVNLTA
FAVATPEEL	FAVATPEEL
NAHIQNEL	NAHIQ-NEL
TAIEAQHLL	TAIEAQHLL
KAINVFVSA	KAINVFVSA
VAYVSSVAL	VAYVSSVAL
YAYEKPHVV	YAYEKPHVV
YVSFPLEL	YVSFP-LEL
IAAGIFNDL	IAAGIFNDL
IADSNPMVV	IADSNPMVV
SAIDVLGETL	SAIDVLETL
RVYEFLDKL	RVYEFLDKL
LAMEPTPEL	LAMEPTPEL
YSDGPGEAL	YSDGPGEAL
NASESKLEL	NASESKLEL
NAVDDHGKSAL	AVDDHGSAL
NSVEPAQPL	NSVEPAQPL
AAILPDMAL	AAILPDMAL
VAPEEHPVL	VAPEEHPVL
AADSSPSEL	AADSSPSEL
FIISDFESV	FIISDFESV
LAAGPSAAA	LAAGPSAAA
LSDPQVHTVL	LSDPQVHTV
QAIPVTSEL	QAIPVTSEL
ASYTGAETL	ASYTGAETL
YATIILSKM	YATIILSKM
VATKIFQEL	VATKIFQEL
AALGPIREL	AALGPIREL
ASVESSSGEAF	ASVESSGEA
IADEGTYTL	IADEGTYTL
FLDDVNLIL	FLDDVNLIL
YSNLHEQTL	YSNLHEQTL
SADPRPLAV	SADPRPLAV
LSDDHVLIL	LSDDHVLIL
FALNLFKHL	FALNLFKHL
LSYLEKEAL	LSYLEKEAL
GGLPERSVSL	GLPERSVSL
VSQAQKDEL	VSQAQKDEL
LADETLLKV	LADETLLKV
LTAEILEL	LTAEI-LEL
VIAPPDFVL	VIAPPDFVL
AADPGLHETL	AADPGLETL
KAFFDRSSL	KAFFDRSSL
LPHSAGRYAA	LPHSAGRYA
FSDDSDLQL	FSDDSDLQL
RAEEPPTPAL	RAEEPPPAL
AAPVPTTTL	AAPVPTTTL
YAPSGNYV	YAPSG-NYV
FVYGESVEL	FVYGESVEL
ATIDPDTISAL	TIDPDTSAL
YADPSILYI	YADPSILYI
NAIREVLEL	NAIREVLEL
FVDPNGKISL	FVDPNGISL
AGPLRKSSL	AGPLRKSSL
AAADITSSL	AAADITSSL
FADALEVIP	FADALEVIP
NTIDPSHPM	NTIDPSHPM
RAIDNQYTPL	AIDNQYTPL
SSAPPLSEL	SSAPPLSEL
RAIEALHGHEL	RAIEALHEL
EAAPDGPAL	EAAPDGPAL
GADPSTVEM	GADPSTVEM
YILDLQVVL	YILDLQVVL
LAVDPNRAVPL	LAVDPNRAV
TYDDATKTF	TYDDATKTF
NAASPLIV	NAASP-LIV
YSFYNQQTL	YSFYNQQTL
VTVSPDGSL	VTVSPDGSL
IAYLIVKEL	IAYLIVKEL
YALDLIDKL	YALDLIDKL
IASTFDHPEL	ASTFDHPEL
GAVDPLLAL	GAVDPLLAL
TAPQGNVDL	TAPQGNVDL
NSFTLDADF	NSFTLDADF
YVINDLTAV	YVINDLTAV
YAILEKKGAL	AILEKKGAL
FAADLAEEL	FAADLAEEL
RAAELFHQL	RAAELFHQL
FSSSDFSDL	FSSSDFSDL
FVALPGVAV	FVALPGVAV
YSAEPLPEL	YSAEPLPEL
FAQEALTVL	FAQEALTVL
YENEVALRQ	YENEVALRQ
AALDEYEEL	AALDEYEEL
LPWQGLKAA	LPWQGLKAA
TSAAIYHVL	TSAAIYHVL
VSSNDFSSL	VSSNDFSSL
VVPEPGQPL	VVPEPGQPL
FIFSDTHEL	FIFSDTHEL
AATSATHEL	AATSATHEL
GAYDPADYEHL	YDPADYEHL
KQFVQWDEL	KQFVQWDEL
YLIEPDVEL	YLIEPDVEL
KIDRLILEL	KIDRLILEL
SAAGLKLYL	SAAGLKLYL
AIIALFHLL	AIIALFHLL
KAVNPDEAV	KAVNPDEAV
SIEPNFHSL	SIEPNFHSL
FADDTYPRWV	FADDTYRWV
FALPILNAL	FALPILNAL
VTEQGHEL	VTEQG-HEL
FAHIDGDHL	FAHIDGDHL
FADHVVPLL	FADHVVPLL
VAIGTHDLDTL	VAIGT-HDL
LIVEPSREL	LIVEPSREL
VADNRIQEL	VADNRIQEL
AALEDKNSL	AALEDKNSL
FVDRSLLTL	FVDRSLLTL
YAINQPDVL	YAINQPDVL
IASPVIAAV	IASPVIAAV
LASEPQEVL	LASEPQEVL
NADSQFWSL	NADSQFWSL
TAVAVFEIL	TAVAVFEIL
VAQELPTTL	VAQELPTTL
IAAPELETL	IAAPELETL
VADHPFLFL	VADHPFLFL
LAQDPENQAL	LAQDPEQAL
VVAEPVEL	VVAEP-VEL
YAQTQLDKL	YAQTQLDKL
IADGLPVAV	IADGLPVAV
LAVDKSASL	LAVDKSASL
VPYGVGKAA	VPYGVGKAA
VSVDASTKDSL	SVDASTDSL
TAYLDGVSL	TAYLDGVSL
APVPTAPAA	APVPTAPAA
KSNTLPISL	KSNTLPISL
SNHLLEDSL	SNHLLEDSL
VSHLLQDNL	VSHLLQDNL
AAAQPQPSV	AAAQPQPSV
FANLIKEFV	FANLIKEFV
VADPYVVIM	VADPYVVIM
FATEVRAVI	FATEVRAVI
SALQIFEKL	SALQIFEKL
FALPSPQHIL	FALPSPHIL
LAIDTEERL	LAIDTEERL
YASNITSVL	YASNITSVL
SASDWYDAL	SASDWYDAL
FAVVPSTAT	FAVVPSTAT
NVYETTEFDQL	YETTEFDQL
YADQHSVQV	YADQHSVQV
APRPPVSAA	APRPPVSAA
FVAEGGPEL	FVAEGGPEL
HADDSFLVL	HADDSFLVL
MPQPVPTA	MPQPV-PTA
NAAAIYDLL	NAAAIYDLL
VAPVASAL	VAPVA-SAL
TAMDVVYAL	TAMDVVYAL
STAGPSEAL	STAGPSEAL
TASEPLTL	TASEP-LTL
FTADPLSL	FTADP-LSL
KAIQDTNNL	KAIQDTNNL
AADPGLHET	AADPGLHET
QIPEIKQTL	QIPEIKQTL
HPTEDLVVSA	HPTEDLVSA
ITTEVVNEL	ITTEVVNEL
KASIEHEAL	KASIEHEAL
SADATPLHV	SADATPLHV
VALAWLHVL	VALAWLHVL
RTDDTPVVL	RTDDTPVVL
IAGPVVEI	IAGPV-VEI
VWYESPSL	VWYES-PSL
VADPTPFHI	VADPTPFHI
VATTALEL	VATTA-LEL
AAEYGAEAL	AAEYGAEAL
FGSEFSPEL	FGSEFSPEL
VIIGSTHVL	VIIGSTHVL
QADAPNPSL	QADAPNPSL
AAMEDLTRL	AAMEDLTRL
VAAYEFTTL	VAAYEFTTL
SAAHAIVSV	SAAHAIVSV
VVDHVFPLL	VVDHVFPLL
SSPQPGSAL	SSPQPGSAL
RAHSEPLAL	RAHSEPLAL
AAVKATQTL	AAVKATQTL
FADGVYLVL	FADGVYLVL
LPLSLLKTA	LPLSLLKTA
YAAGVHSVL	YAAGVHSVL
RIPSFVTEL	RIPSFVTEL
SPFHFQPSA	SPFHFQPSA
RAVSETESL	RAVSETESL
FSIGADTAL	FSIGADTAL
FAHGNAEL	FAHGN-AEL
NAINITSAL	NAINITSAL
LADVIIHEI	LADVIIHEI
VADGYPVRL	VADGYPVRL
IADEAFYGL	IADEAFYGL
RALDVNVAL	RALDVNVAL
LAYSGKLEEL	LAYSGKEEL
LAVEHDNISL	LAVEHDISL
FAEDPPTSL	FAEDPPTSL
YSYVTEEL	YSYVT-EEL
ASAAVLLTL	ASAAVLLTL
LTDQTLIYL	LTDQTLIYL
LAATPHSLP	LAATPHSLP
RPAPHFERTA	RPAPHFRTA
FAHPPLLVL	FAHPPLLVL
VADFQRYIL	VADFQRYIL
NIPEKTTAL	NIPEKTTAL
TALNLFFKL	TALNLFFKL
VAQSNFEAL	VAQSNFEAL
VNHFQKDSI	VNHFQKDSI
NALDGNRDTPL	ALDGNRTPL
FAHHLPVWL	FAHHLPVWL
AALFKAWAL	AALFKAWAL
ISISDHTAL	ISISDHTAL
IIVDIFHGL	IIVDIFHGL
SAVSIFHEL	SAVSIFHEL
VAVDGINAL	VAVDGINAL
AAAPQLLIV	AAAPQLLIV
TALGPELLAL	TALGPELAL
SPRVPNSSV	SPRVPNSSV
VAEDKFITL	VAEDKFITL
TADDFLNRIAL	TADDFLIAL
YAETLFDIL	YAETLFDIL
AADGKGVVV	AADGKGVVV
VAMTGEITL	VAMTGEITL
VASKVFYHL	VASKVFYHL
YGDHTKLIL	YGDHTKLIL
RPAPVAVAA	RPAPVAVAA
VSPYTEIHL	VSPYTEIHL
ITDPSVIVM	ITDPSVIVM
SAVTTFEAL	SAVTTFEAL
VVFDDSEPV	VVFDDSEPV
FLYPFPLAL	FLYPFPLAL
TSDPLELFL	TSDPLELFL
TIIEATHVL	TIIEATHVL
KITEDFRAL	KITEDFRAL
TAISLFYEL	TAISLFYEL
IPLYLKGGVA	IPLYLKGVA
SAAMVFSAL	SAAMVFSAL
ITAPPSRVL	ITAPPSRVL
YALPAGLSA	YALPAGLSA
VSAGIQTSF	VSAGIQTSF
RAMEGELGEL	RAMEGEGEL
IAHNMQSTL	IAHNMQSTL
HADTVGIDAVL	HADTVGDAV
RNVSTGDVNVE	NVSTGDVNV
AAFHQIEAV	AAFHQIEAV
VALDFEQEM	VALDFEQEM
FADYRPTEV	FADYRPTEV
LIKPESKVA	LIKPESKVA
SIIDDRVIL	SIIDDRVIL
AATDITSSL	AATDITSSL
VVANVQLVL	VVANVQLVL
VADGLITTL	VADGLITTL
KAVNPGRSL	KAVNPGRSL
RPVLPRTEA	RPVLPRTEA
YAIESQLQL	YAIESQLQL
GPWVGTGLAA	PWVGTGLAA
FSFDGPEIM	FSFDGPEIM
LRPLLAAAA	LRPLLAAAA
FLAHIYTEL	FLAHIYTEL
FAEEVGAAL	FAEEVGAAL
SIVDPQNQTM	IVDPQNQTM
FLDSTSPLL	FLDSTSPLL
LLSDVRFVL	LLSDVRFVL
SPIENIQRVAA	SPIENIQRV
VANVSLLAL	VANVSLLAL
ISSLLEEQF	ISSLLEEQF
QADQTFISL	QADQTFISL
LANIIYYSL	LANIIYYSL
HSNTIVVSL	HSNTIVVSL
TVKGVSLSS	TVKGVSLSS
TVTEKPEVID	TVTEKPEVI
AAHLLGSTL	AAHLLGSTL
AAFNSGKVDIV	AAFNSGKVD
YTIYDSETL	YTIYDSETL
IAITSGEWEVL	ITSGEWEVL
SAMDLPDVTL	SAMDLPVTL
YVDDTQFVQ	YVDDTQFVQ
YLADIFTKL	YLADIFTKL
TADGAHFEL	TADGAHFEL
MADPEVQQI	MADPEVQQI
TAYDNFVEL	TAYDNFVEL
VSHVIVDEV	VSHVIVDEV
APRPAPVA	APRPA-PVA
NAISIHHAL	NAISIHHAL
NADPQAVTM	NADPQAVTM
RPKPPSATSI	RPKPPSTSI
AAIDARIFHEL	AAIDARHEL
RALEDRHSL	RALEDRHSL
SISGITMVL	SISGITMVL
ISPTGHSL	ISPTG-HSL
SADENYRPL	SADENYRPL
LTGPVLEL	LTGPV-LEL
VPTNIIAA	VPTNI-IAA
FGHYQQAEL	FGHYQQAEL
HAIPPTLAM	HAIPPTLAM
RASFIFISV	RASFIFISV
AALVDLDSL	AALVDLDSL
FASDVQFVL	FASDVQFVL
AAINHYIEA	AAINHYIEA
PSSAAPPLFN	SAAPP---L
RASSIYSKL	RASSIYSKL
FASSFKIVL	FASSFKIVL
AVADTLLVL	AVADTLLVL
NVDPDSVVL	NVDPDSVVL
VPSYPSKSA	VPSYPSKSA
AAPSAAREL	AAPSAAREL
FADPNMLDTL	FADPNMDTL
RADDTFEAL	RADDTFEAL
YTSPVNPAV	YTSPVNPAV
QAINPKLLQL	AINPKLLQL
SASPPPPAL	SASPPPPAL
TVIDYFHQL	TVIDYFHQL
FSFVMPSL	FSFVM-PSL
LAVTDTGAL	LAVTDTGAL
ISHVIVDEI	ISHVIVDEI
YTDATPLRV	YTDATPLRV
AAISQVDRL	AAISQVDRL
IASAIVNEL	IASAIVNEL
YAYNDKAIL	YAYNDKAIL
TPSAAALAA	TPSAAALAA
AVIGSTEEL	AVIGSTEEL
ASLLIQQAL	ASLLIQQAL
KAYYAGHVL	KAYYAGHVL
AATTVLQEL	AATTVLQEL
ASAPPGPPA	ASAPPGPPA
LADPGIITI	LADPGIITI
VVVDPIQSV	VVVDPIQSV
APRPASGPIRP	APRPASGPI
IATELLKLN	IATELLKLN
KASDLYITL	KASDLYITL
FAMAGHENL	FAMAGHENL
LAYLQRIAL	LAYLQRIAL
IASPVQPVL	IASPVQPVL
AAPTSSAL	AAPTS-SAL
NAGPAIVI	NAGPA-IVI
MSQVAPSL	MSQVA-PSL
VAHDGSATYL	VAHDGSTYL
FADQEVRSL	FADQEVRSL
SNHWQIPEL	SNHWQIPEL
APYFKGTAVV	APYFKGTAV
HADPEPSVI	HADPEPSVI
SASSDFNTL	SASSDFNTL
SAAPAIQL	SAAPA-IQL
IVDQVMVTL	IVDQVMVTL
FAEEPGLVL	FAEEPGLVL
KAIEVLLTL	KAIEVLLTL
KSDPSIVRL	KSDPSIVRL
RAFSDRSSL	RAFSDRSSL
HAFGGLGSHAL	FGGLGSHAL
SAAMPGASL	SAAMPGASL
RALDEATKYAL	ALDEATYAL
WALDDHHAL	WALDDHHAL
FAVPENSSV	FAVPENSSV
KADPQGPEL	KADPQGPEL
TQHLHPSL	TQHLH-PSL
APRTVALTA	APRTVALTA
VGDPSVHLL	VGDPSVHLL
FAYKQENEML	FAYKQENEM
KAFFTSKAL	KAFFTSKAL
RAYYESEINSL	RAYYESNSL
FAVNMFRTL	FAVNMFRTL
YVSDLELSA	YVSDLELSA
YAAAAEVL	YAAAA-EVL
QALEQFHQL	QALEQFHQL
ITYDDRFNL	ITYDDRFNL
LAGPVLGL	LAGPV-LGL
SAVSHFFSL	SAVSHFFSL
YTADGKEVL	YTADGKEVL
AALKPLETL	AALKPLETL
YSFHKFHYL	YSFHKFHYL
AAPEGKRSL	AAPEGKRSL
EADRTLIYITL	EADRTLIYI
SSDGHEFIV	SSDGHEFIV
FSLPHPEAL	FSLPHPEAL
LSHLQQDSL	LSHLQQDSL
VSFPGQEAL	VSFPGQEAL
LAFSRALEL	LAFSRALEL
FAHDDSVMYL	FAHDDSMYL
YVPDQPHPEI	VPDQPHPEI
FIDGHFVEM	FIDGHFVEM
AADAKPESL	AADAKPESL
YGLEPAHPL	YGLEPAHPL
KVDEVGGEAL	KVDEVGEAL
APQETRGIPS	APQETRGIP
SAEHSHPAL	SAEHSHPAL
ITPTGTHPL	ITPTGTHPL
VVVAVGRAL	VVVAVGRAL
SPVTDFREA	SPVTDFREA
RPRTEVSLSA	RPRTE-VSL
LSAPLIGAL	LSAPLIGAL
VADTVARVL	VADTVARVL
SSHFLEQTL	SSHFLEQTL
TADGMVHLL	TADGMVHLL
KSEGNHPAL	KSEGNHPAL
FAGQPLTI	FAGQP-LTI
TAHVMPSTL	TAHVMPSTL
MVDGTLLLL	MVDGTLLLL
IAIEDPFSV	IAIEDPFSV
VAKDPQDDDDL	VAKDPQDDL
SAAEPVPAA	SAAEPVPAA
FLDKALEL	FLDKA-LEL
YSFYLPIAA	YSFYLPIAA
AAAPVLTPA	AAAPVLTPA
FADDNRFDFL	FADDNRDFL
RQALLLLAL	RQALLLLAL
SSPTSPNAL	SSPTSPNAL
YAGAILEV	YAGAI-LEV
FSEPFHLIV	FSEPFHLIV
KADPSHFEL	KADPSHFEL
KIIDIFTTL	KIIDIFTTL
TAVEGDEVSL	TAVEGDVSL
SAPYGRITL	SAPYGRITL
AIAAVFHTL	AIAAVFHTL
YQTEIGQTL	YQTEIGQTL
TSVPPGSAL	TSVPPGSAL
KTVDNFVAL	KTVDNFVAL
TPAHVLPSA	TPAHVLPSA
KAPAPRPSL	KAPAPRPSL
FALDSGLEI	FALDSGLEI
SIWDGSEVL	SIWDGSEVL
HPWETVTTAA	HPWETVTTA
LTAEVLEL	LTAEV-LEL
YTDHQFTEL	YTDHQFTEL
LASEIYDIL	LASEIYDIL
LAFLGNGDVL	LAFLGNDVL
FAVGYKTDEF	FAVGYKDEF
LADGLKVVL	LADGLKVVL
ATDDSLHQL	ATDDSLHQL
SAFYDVDFL	SAFYDVDFL
VPAKKITAA	VPAKKITAA
VAPVTHVSV	VAPVTHVSV
YAFPKSITV	YAFPKSITV
SAAFPGASL	SAAFPGASL
SSSKGSLGGGF	SSSKG--SL
RSIHIFDTL	RSIHIFDTL
RPNDIMAEV	RPNDIMAEV
IAVEAQEIL	IAVEAQEIL
AAFFARDEL	AAFFARDEL
HAVGPSTSL	HAVGPSTSL
FAVPESDHL	FAVPESDHL
SPIENIQRVA	SPIENIQRV
VIGPPVVL	VIGPP-VVL
SADMSHVAL	SADMSHVAL
SVVDVFAQL	SVVDVFAQL
VPYGTPLSV	VPYGTPLSV
LAFVSPSL	LAFVS-PSL
FLIRESETL	FLIRESETL
AAAPPAKEI	AAAPPAKEI
SIVEPKDEI	SIVEPKDEI
FADELSHLL	FADELSHLL
FVDGSAIQV	FVDGSAIQV
NVYNPSHSDSL	YNPSHSDSL
NAVGDGIVL	NAVGDGIVL
APAPPKAEA	APAPPKAEA
AAILGMHTL	AAILGMHTL
SAAPPGLEA	SAAPPGLEA
KPANVFITA	KPANVFITA
SVDDTIVAL	SVDDTIVAL
HPTSIVKA	HPTSI-VKA
ISVASFQEL	ISVASFQEL
FAEESYQKL	FAEESYQKL
VAVDGGKDSL	VAVDGGDSL
TALSFFHML	TALSFFHML
LSLFIDDKL	LSLFIDDKL
LSSPPTESL	LSSPPTESL
LPRKPVAGA	LPRKPVAGA
QAFIGEEVL	QAFIGEEVL
FSVGADTAL	FSVGADTAL
VIDGHIYAV	VIDGHIYAV
FSFYFHEAL	FSFYFHEAL
AADGKLLKL	AADGKLLKL
ASHIQLDSL	ASHIQLDSL
FAHGLGEL	FAHGL-GEL
FADYNLLDL	FADYNLLDL
RALDHYLTL	RALDHYLTL
IGAPVGISL	IGAPVGISL
LTVEPGASL	LTVEPGASL
HADHSSLTL	HADHSSLTL
NAAVPDSVAL	AAVPDSVAL
TADSYLLQL	TADSYLLQL
KAIDIYEQV	KAIDIYEQV
YLFPGHPPT	YLFPGHPPT
KAADTIEAL	KAADTIEAL
AATDIFSYL	AATDIFSYL
FGYDKPHVL	FGYDKPHVL
AASYISQSL	AASYISQSL
ISDPFIFNL	ISDPFIFNL
HAAASFETL	HAAASFETL
VASPPTHAA	VASPPTHAA
SPLSAARAA	SPLSAARAA
FSIEPWLKV	FSIEPWLKV
YAYDGKDYIA	YAYDGKDYI
FAHVIFQNV	FAHVIFQNV
MPNGDHIVSA	NGDHI-VSA
AADFAQMEL	AADFAQMEL
IIHDPGRGAPL	IIHDPGRGA
AADPEAPEI	AADPEAPEI
TAPTGHTL	TAPTG-HTL
FAYVEGESL	FAYVEGESL
RSAEVTLEV	RSAEVTLEV
RAQLQQVEL	RAQLQQVEL
FSNVFEHYL	FSNVFEHYL
AAAPASGEM	AAAPASGEM
LSHSLLVTL	LSHSLLVTL
LVDENFTEL	LVDENFTEL
YVIDSTDEERL	VIDSTDERL
VVIEDFESSL	VVIEDFSSL
VAHTSLDAL	VAHTSLDAL
KAHLMEIQV	KAHLMEIQV
SVVKEMLEL	SVVKEMLEL
PASAPHPPP	PASAPHPPP
TASQVYETL	TASQVYETL
FAQGDVITL	FAQGDVITL
NVVEALIAL	NVVEALIAL
SAHLFEVEL	SAHLFEVEL
MAFHQEHEV	MAFHQEHEV
RAIENIDTL	RAIENIDTL
YAQDFGLVEEA	AQDFGLEEA
LANVSTVL	LANVS-TVL
LAVRDVSEL	LAVRDVSEL
AAHDALVEL	AAHDALVEL
FSHGQVVSL	FSHGQVVSL
YSLYPDREL	YSLYPDREL
FITDPVVL	FITDP-VVL
SVPEAQSAL	SVPEAQSAL
NIVKVFEIL	NIVKVFEIL
SAVVDFEAL	SAVVDFEAL
LQGPILRL	LQGPI-LRL
IADNVFLFL	IADNVFLFL
KADGVGPPL	KADGVGPPL
IADPRGNTL	IADPRGNTL
YAVELVNDSL	YAVELVDSL
KADMNVHLL	KADMNVHLL
FVYEDMEAL	FVYEDMEAL
VAEERGAVL	VAEERGAVL
ISQVFEIAL	ISQVFEIAL
YAIGVSHPL	YAIGVSHPL
FGVIPSTPL	FGVIPSTPL
IAFPTSISV	IAFPTSISV
SIAGIFKEV	SIAGIFKEV
EAQPDLSI	EAQPD-LSI
YASSPGMSL	YASSPGMSL
IAGPVVEISH	IAGPV-VEI
FAADIISVL	FAADIISVL
STSAPGPAL	STSAPGPAL
RSAEPAEAL	RSAEPAEAL
SDDIPHAL	SDDIP-HAL
TAHWLNTVL	TAHWLNTVL
KAIGLFISF	KAIGLFISF
RAFGIPIRV	RAFGIPIRV
HAHTIKPAL	HAHTIKPAL
VLDAHFLVL	VLDAHFLVL
FVAETHIVL	FVAETHIVL
RPKSAFKVQNA	SAFKV-QNA
SAHSHFISL	SAHSHFISL
IAAVTDIPL	IAAVTDIPL
HAWSGGLDHQL	AWSGGLHQL
FVIQEQNVAL	VIQEQNVAL
FGVDPDKEL	FGVDPDKEL
AADGQLHTL	AADGQLHTL
IIYEDPQHHPL	YEDPQHHPL
LAAARLAAA	LAAARLAAA
AAHALREHL	AAHALREHL
NAVRIEQEFL	NAVRIEEFL
NQFAYDGKDYI	FAYDGKDYI
FQVNHTVAL	FQVNHTVAL
FSIDSPDSL	FSIDSPDSL
KASIIFVTL	KASIIFVTL
TAIPVTQEL	TAIPVTQEL
RAAPLDSIHSL	APLDSIHSL
FVNDIFERI	FVNDIFERI
NVLDHFSEL	NVLDHFSEL
VSYYEKHSL	VSYYEKHSL
VAAAVDLII	VAAAVDLII
KSQVHPVL	KSQVH-PVL
SAGPVGDDL	SAGPVGDDL
AAIESGHKL	AAIESGHKL
RAAPGAEF	RAAPG-AEF
FAHSFIEL	FAHSF-IEL
VGAPVGIAL	VGAPVGIAL
FAISILQQI	FAISILQQI
VALPMVLVL	VALPMVLVL
SALEFLTQL	SALEFLTQL
VAAEILEI	VAAEI-LEI
KPKEVTTVKV	KPKEV-TTV
RQAPPHIEL	RQAPPHIEL
AASAQLLRL	AASAQLLRL
SAIHILDVL	SAIHILDVL
FALSKDASL	FALSKDASL
FVADVRLIF	FVADVRLIF
APAPAAHVA	APAPAAHVA
AADDSKLVL	AADDSKLVL
MAAEPYETI	MAAEPYETI
YSLFDNSKL	YSLFDNSKL
AAAESGAKEEL	AAESGAEEL
VTEAVFHSL	VTEAVFHSL
VIQEAFIEL	VIQEAFIEL
HLPETKFSEL	LPETKFSEL
VAYDSDYAL	VAYDSDYAL
FSQVIPVSL	FSQVIPVSL
KAASVRPVL	KAASVRPVL
VAILDINRL	VAILDINRL
KALEEPKYSSL	KALEEPSSL
KAHLGTAL	KAHLG-TAL
TAVAPNVAL	TAVAPNVAL
VAEGGKAEL	VAEGGKAEL
FGIDRPAEL	FGIDRPAEL
TNHLHQTPL	TNHLHQTPL
KAVTEQGAEL	AVTEQGAEL
MAHADPTEL	MAHADPTEL
NVVDVFHAV	NVVDVFHAV
IAHELGHSL	IAHELGHSL
VSDSGAHVL	VSDSGAHVL
RALHQGDSL	RALHQGDSL
FAYDGKDYLTL	FAYDGKDYL
SPADRQLVA	SPADRQLVA
VADPIIYVL	VADPIIYVL
GGSFRGSYGSS	SFRGSYGSS
AAPEGVPL	AAPEG-VPL
VASEIMAVL	VASEIMAVL
VTDHNLHEL	VTDHNLHEL
SAIGYIHSL	SAIGYIHSL
VVAPAGITL	VVAPAGITL
LAVHPSGVAL	AVHPSGVAL
SSHVQQQAL	SSHVQQQAL
YANEVGEAF	YANEVGEAF
FAARPVLL	FAARP-VLL
LAGPVQEV	LAGPV-QEV
SPVPVPRA	SPVPV-PRA
YAFLLDKAL	YAFLLDKAL
LLSDTKLEL	LLSDTKLEL
AAEEGLREL	AAEEGLREL
IQRTPKIQV	IQRTPKIQV
VAAAHSVVL	VAAAHSVVL
NSAPAGETL	NSAPAGETL
VSGPAMTL	VSGPA-MTL
KAADIDQEV	KAADIDQEV
NADAIVVKL	NADAIVVKL
QAIENAHVL	QAIENAHVL
VAADAVASL	VAADAVASL
SGPGPAAAL	SGPGPAAAL
TAAPVPTTL	TAAPVPTTL
YSHFLQFAL	YSHFLQFAL
FAGLVQEI	FAGLV-QEI
TADENPDKSTL	TADENPSTL
VAYIDGQVL	VAYIDGQVL
YLLDLHSYL	YLLDLHSYL
IPHLVTHDA	IPHLVTHDA
TAIDVQVGL	TAIDVQVGL
TAHFEQNTL	TAHFEQNTL
KAIEQADLL	KAIEQADLL
DGIFKAEL	DGIFK-AEL
FQDPVPLTV	FQDPVPLTV
LADMHSTEISL	LADMHSTEI
LAMRPLASL	LAMRPLASL
SANVVPEAL	SANVVPEAL
AALDERSTI	AALDERSTI
VASEYPVIL	VASEYPVIL
VAVGAEHTL	VAVGAEHTL
SAAPEGVPL	SAAPEGVPL
FADVAPLQL	FADVAPLQL
VASELHTSL	VASELHTSL
APMPPIIHA	APMPPIIHA
IADTNFDVL	IADTNFDVL
KPFKEFVEA	KPFKEFVEA
FVDPSQDHAL	FVDPSQHAL
YAFPLAHSL	YAFPLAHSL
FLVPTFEQL	FLVPTFEQL
AALQGDPAL	AALQGDPAL
YAISKPEVL	YAISKPEVL
VAAAVPVII	VAAAVPVII
SALDSTPAL	SALDSTPAL
RPSPAPPAA	RPSPAPPAA
AALPDASPGNL	LPDASPGNL
KAQLQQVEA	KAQLQQVEA
FLDDNQIIT	FLDDNQIIT
RAFLDEDDMSL	FLDEDDMSL
AQYEHDLEV	AQYEHDLEV
TASEMILVL	TASEMILVL
LADGSIAVL	LADGSIAVL
AADVAQSTHVL	VAQST-HVL
AAGPVGPAL	AAGPVGPAL
YADPTKRLEL	YADPTKLEL
SAAGPGFSL	SAAGPGFSL
FADKHIQVL	FADKHIQVL
SAAPGTASL	SAAPGTASL
QAAPPIEL	QAAPP-IEL
TADDPSLSL	TADDPSLSL
ASHVSPEV	ASHVS-PEV
LAADIHQAL	LAADIHQAL
RAYNHLDEL	RAYNHLDEL
AAAGDHVSL	AAAGDHVSL
SSPQAGSSL	SSPQAGSSL
AAAHFYFEL	AAAHFYFEL
YSMPVHAAV	YSMPVHAAV
KAIDLFTDAI	KAIDLFTDA
IIDDTIFNL	IIDDTIFNL
RIDDLQMVL	RIDDLQMVL
TIDPIPHQL	TIDPIPHQL
RPYDKNISP	RPYDKNISP
VAIKAGTTL	VAIKAGTTL
ISPSRTEAL	ISPSRTEAL
YAEQLHVQL	YAEQLHVQL
SATELMNIL	SATELMNIL
SAFFDSTTL	SAFFDSTTL
SLVNLGGSK	SLVNLGGSK
IALGEFSTL	IALGEFSTL
AAAGPGEVL	AAAGPGEVL
FADPIAANL	FADPIAANL
LLPSHPLEL	LLPSHPLEL
FIISRTQAL	FIISRTQAL
VGHVMGSAL	VGHVMGSAL
FRVPTANVS	FRVPTANVS
SADPNVVDL	SADPNVVDL
FSLDDVEVL	FSLDDVEVL
YAVRDTIAL	YAVRDTIAL
FADGSIRTSEL	FADGSISEL
LADHTVHVL	LADHTVHVL
SAFPFPVTV	SAFPFPVTV
IQDPSFLHEAL	IQDPSFHEA
LAADPGLHETL	AADPGLETL
FASGAVEL	FASGA-VEL
ASPSSIRSL	ASPSSIRSL
FADAVQEL	FADAV-QEL
APKAGPGVV	APKAGPGVV
KPMKSVLVV	KPMKSVLVV
VAYGLHELL	VAYGLHELL
IIDETMAQL	IIDETMAQL
KADGVPVYL	KADGVPVYL
ASHLNLDAL	ASHLNLDAL
TVTTVILEV	TVTTVILEV
KAMELIREL	KAMELIREL
YAIHGVLEV	YAIHGVLEV
NAIGPLVAL	NAIGPLVAL
RADESTYVL	RADESTYVL
PASPAISVV	PASPAISVV
VAAAYADEL	VAAAYADEL
NSTGVLLEV	NSTGVLLEV
TASPVIKAV	TASPVIKAV
FTEWLHEVL	FTEWLHEVL
HPYRLILTV	HPYRLILTV
LRNVSTGD	LRNVS-TGD
VPRPPSNPP	VPRPPSNPP
FADFERHFL	FADFERHFL
TTHLSPEL	TTHLS-PEL
ISDTQRISL	ISDTQRISL
SAVSPSESV	SAVSPSESV
LAIHGMETL	LAIHGMETL
AAAPPLTL	AAAPP-LTL
LASPVSPEL	LASPVSPEL
LATDVQTVA	LATDVQTVA
AADLGSPSL	AADLGSPSL
LADRNVTVL	LADRNVTVL
VAFSPDQQQVL	FSPDQQQVL
HIDPNFASL	HIDPNFASL
AAVAPGHPL	AAVAPGHPL
FSITPLSEL	FSITPLSEL
KAIRPQIDL	KAIRPQIDL
AAIEDLNAV	AAIEDLNAV
FSSDVTHEM	FSSDVTHEM
VAPRSGLAA	VAPRSGLAA
FAVPPALGSNL	FAVPP--AL
FAANVYEAF	FAANVYEAF
MAMEPDRKAA	MAMEPDRKA
QADPTKLEL	QADPTKLEL
YALYVRDTL	YALYVRDTL
SAIDTREEL	SAIDTREEL
LVNEVTEFAK	LVNEVTEFA
SVGESSSKGP	SVGES-SSK
FALNHPEL	FALNH-PEL
AAIDHQIEV	AAIDHQIEV
ISPANYEPVHW	ISPANYEPV
AAGPPLVAA	AAGPPLVAA
IAAPTSSAL	IAAPTSSAL
IADSPSPAV	IADSPSPAV
FSEETPVVL	FSEETPVVL
SASESILEL	SASESILEL
RPKPPNVRTA	RPKPPNRTA
FATGSADAL	FATGSADAL
AAHLLNDAL	AAHLLNDAL
VLPEHVSVL	VLPEHVSVL
YVYSGVETL	YVYSGVETL
FILDPNQENVL	ILDPNQNVL
VTHLLQQEL	VTHLLQQEL
FVAPPGNISL	VAPPGNISL
SASRVVQVV	SASRVVQVV
NTIETFNEL	NTIETFNEL
VATEGAEVL	VATEGAEVL
FALFEKKGAL	FALFEKGAL
YAFSGVEEL	YAFSGVEEL
IADDTRVVV	IADDTRVVV
NPKVQASLAA	KVQAS-LAA
FAEDVGSNKGA	FAEDVGSNK
FIIDDKGIL	FIIDDKGIL
YLPDGTASL	YLPDGTASL
VAEHHVATL	VAEHHVATL
ISHYHETL	ISHYH-ETL
YLTAEVLEL	YLTAEVLEL
VASSLYDIL	VASSLYDIL
FWKEHPEI	FWKEH-PEI
RVYIHPFHL	RVYIHPFHL
SASALAVAL	SASALAVAL
LAYHLAVVL	LAYHLAVVL
AADYSQLEL	AADYSQLEL
YAVELFEGL	YAVELFEGL
LAVDPAILLI	LAVDPAILL
IAYYVSNEEL	IAYYVSEEL
YVLDGSGHIL	VLDGSGHIL
FIESAHTEL	FIESAHTEL
FADHVSSSL	FADHVSSSL
VAYEAPSL	VAYEA-PSL
YAVDAYFREAL	AVDAYFEAL
FSLDLVHTL	FSLDLVHTL
VIDGEFKEL	VIDGEFKEL
FAGDDAPRA	FAGDDAPRA
LAGPPLEI	LAGPP-LEI
FAHPYQYEL	FAHPYQYEL
NAMEDAQTL	NAMEDAQTL
LAAHIPLFL	LAAHIPLFL
FAYDGKDYI	FAYDGKDYI
HAASVFLTL	HAASVFLTL
SAVDPVAVL	SAVDPVAVL
SIPEKNRPL	SIPEKNRPL
KIIESEEEL	KIIESEEEL
YAAQPELL	YAAQP-ELL
VIADPRGNTL	IADPRGNTL
LADDSVRSL	LADDSVRSL
TVYGGSDEL	TVYGGSDEL
SASEVEVQL	SASEVEVQL
FAYDPSNYEYL	FAYDPSEYL
NAENIFHSM	NAENIFHSM
AATKILTEL	AATKILTEL
RAASPIITL	RAASPIITL
AAAPPAPAA	AAAPPAPAA
FAMDVYKNL	FAMDVYKNL
HSMLDINAL	HSMLDINAL
FSHAQTVVL	FSHAQTVVL
FAFEGIGDEDL	FAFEGIEDL
NATWVRAEL	NATWVRAEL
AAIVEMQEL	AAIVEMQEL
YSVNDGAQL	YSVNDGAQL
RAAEPLLTL	RAAEPLLTL
FAQEAISVL	FAQEAISVL
SAPKGSVL	SAPKG-SVL
VIQENEHAL	VIQENEHAL
TAAAVNLLL	TAAAVNLLL
YGVTVFKAL	YGVTVFKAL
VAFSPVTEL	VAFSPVTEL
AAAPASGAL	AAAPASGAL
RAHDDPVAL	RAHDDPVAL
AAASHFFNL	AAASHFFNL
SSAKPGPAL	SSAKPGPAL
NASEDRLEL	NASEDRLEL
VAVSPDDRFIL	VSPDDRFIL
NASPVISSV	NASPVISSV
VADNLAIQL	VADNLAIQL
AAIEGNLQL	AAIEGNLQL
KPKPIGKLA	KPKPIGKLA
QALLDLHAL	QALLDLHAL
SAYLQREEL	SAYLQREEL
AAMYKSLEL	AAMYKSLEL
AASHPLLL	AASHP-LLL
TAAPPAQPL	TAAPPAQPL
FAGYSEEVL	FAGYSEEVL
APRAPRALAAA	RAPRALAAA
SPITGEKIPA	SPITGEIPA
LILEPDKQEAL	LILEPDEAL
GAVPIFIEL	GAVPIFIEL
LMQLLQESL	LMQLLQESL
KAVEHLDDL	KAVEHLDDL
AASALPAL	AASAL-PAL
AAAALHPAL	AAAALHPAL
AAQWQKEEM	AAQWQKEEM
YAYRDAVFL	YAYRDAVFL
VADGIFKAEL	VADGIFAEL
IAIEDPYSV	IAIEDPYSV
FSDPAVSQSL	FSDPAVQSL
IALDKDAPL	IALDKDAPL
FASEVSNVL	FASEVSNVL
IAQDFKTDL	IAQDFKTDL
VNLPINGNGKQ	LPINGNGKQ
SAVEPSDEI	SAVEPSDEI
RSIPVNEKDTL	IPVNEKDTL
YAFQDENHL	YAFQDENHL
FVFDERYAL	FVFDERYAL
FVFPGELLL	FVFPGELLL
YASFIEDNEL	YASFIENEL
AAASAFTSL	AAASAFTSL
RADPESPIL	RADPESPIL
VAPVGSGSAL	APVGSGSAL
IAGEFKEQL	IAGEFKEQL
AAVRDISEA	AAVRDISEA
VIIDDHPEV	VIIDDHPEV
SAAEPPTAL	SAAEPPTAL
FAHFPGLASEL	FAHFPGLAS
FSFPEPEAL	FSFPEPEAL
IAPTGHSL	IAPTG-HSL
FYQEHPDL	FYQEH-PDL
YVVDDAAVL	YVVDDAAVL
IPKHINPVAA	IPKHINPVA
YSLDMWRL	YSLDM-WRL
VALNSFDDL	VALNSFDDL
AAYYHPSYL	AAYYHPSYL
KAISGVHTV	KAISGVHTV
LADPHAQLL	LADPHAQLL
SAPVGVTAL	SAPVGVTAL
VATAADLEL	VATAADLEL
IVGPVVGL	IVGPV-VGL
VASQITEAL	VASQITEAL
KVDEAVAVL	KVDEAVAVL
KAPSAARSL	KAPSAARSL
YSAPVIHVL	YSAPVIHVL
SATSVHTSV	SATSVHTSV
VIMEPHKEV	VIMEPHKEV
VAPPVSGDL	VAPPVSGDL
RAAPAAAGAAL	APAAAGAAL
FTAPATVSL	FTAPATVSL
VVVQPYNSL	VVVQPYNSL
FAYDGKDYIA	FAYDGKDYI
FSLDPDIDTL	SLDPDIDTL
AALDIYETL	AALDIYETL
LAVPDMSSL	LAVPDMSSL
VGDPHTVTV	VGDPHTVTV
FAYPNRPDVL	FAYPNRDVL
FAYDGKDYIAL	FAYDGKDYI
YTAEPVTL	YTAEP-VTL
YTFEPRTPDEL	YTFEPRDEL
APVAEVPTA	APVAEVPTA
NADPASHEI	NADPASHEI
AQNVGTTHDL	QNVGTTHDL
HASDAYTAL	HASDAYTAL
YAFQDDRYL	YAFQDDRYL
HVDGHLYEL	HVDGHLYEL
QAFGIMNEL	QAFGIMNEL
ISFFIGQEL	ISFFIGQEL
KAFNDPSAL	KAFNDPSAL
YAIREEIVL	YAIREEIVL
YSDPGLAGVSL	YSDPGLVSL
VADKILWEI	VADKILWEI
SADPGILVL	SADPGILVL
AAAWPLLL	AAAWP-LLL
YTGGSLIPLL	YTGGSLIPL
RALLDRDAL	RALLDRDAL
TADDFLVFL	TADDFLVFL
VVDGGAIPA	VVDGGAIPA
SAAEIMAVL	SAAEIMAVL
QADEVIAIL	QADEVIAIL
FAATADPAAL	AATADPAAL
YGDEIAIEL	YGDEIAIEL
PAAAPGHPL	PAAAPGHPL
FQEADSPTL	FQEADSPTL
NAANIFERL	NAANIFERL
SPHLGPAPA	SPHLGPAPA
FQDHTKLIL	FQDHTKLIL
LIGPPLLI	LIGPP-LLI
VALSPKTNQTL	VALSPKQTL
YIMEPSIFNTL	YIMEPSNTL
KAVDPSSVAL	AVDPSSVAL
AALEEADKMFL	AALEEADKM
VPYPPLLRA	VPYPPLLRA
YITDLFQVL	YITDLFQVL
LADETLLKVDL	LADETLLKV
AAINPNHPL	AAINPNHPL
LAPTDVKEL	LAPTDVKEL
SADNVRQQL	SADNVRQQL
SAFDHFASV	SAFDHFASV
FVHDLVLYL	FVHDLVLYL
ITHLLGVAL	ITHLLGVAL
FIVSDESIL	FIVSDESIL
KAFTQTSHL	KAFTQTSHL
SVDPTRLLL	SVDPTRLLL
AAAQPTEEQVL	AAQPTEQVL
VASEVSTSL	VASEVSTSL
SFGAGGGFGSR	GAGGGFGSR
APTGDLPRA	APTGDLPRA
YALEEHENQRL	YALEEHQRL
FIEDAVHVL	FIEDAVHVL
FIDDANYSV	FIDDANYSV
VIISDAHVL	VIISDAHVL
KAAELEMEL	KAAELEMEL
TAFSPDSRHVL	FSPDSRHVL
LADVTHLLL	LADVTHLLL
YAFNSGNVERF	YAFNSGVER
VALHSAVSA	VALHSAVSA
NAVFTFEQL	NAVFTFEQL
YAVDRAITHL	AVDRAITHL
YAFPKAVSV	YAFPKAVSV
KILNDDTAL	KILNDDTAL
AAADASPSL	AAADASPSL
AAVDPDSGL	AAVDPDSGL
HVDSTWLLL	HVDSTWLLL
FPKPYPNSEA	KPYPN-SEA
LVAPPLPAA	LVAPPLPAA
YQYPRPLLI	YQYPRPLLI
SAETPTIPL	SAETPTIPL
YAFGQETNVPL	FGQETNVPL
AAADVLEAL	AAADVLEAL
RPSPPVQSV	RPSPPVQSV
FASFEAQGAL	ASFEAQGAL
FAVLEDHTL	FAVLEDHTL
FAIDPHLLLSV	FAIDPHLLL
LAAPVISVL	LAAPVISVL
NAEPEPRSL	NAEPEPRSL
IAIAPNGAL	IAIAPNGAL
RSIGEYDVL	RSIGEYDVL
NPYNGGGRVA	NPYNGGRVA
QAADVLEL	QAADV-LEL
RAIEIYTDM	RAIEIYTDM
FADQTAVQL	FADQTAVQL
YVNLPTIAL	YVNLPTIAL
AAPAYSRAL	AAPAYSRAL
ASFFDRNTL	ASFFDRNTL
NSDPYSVAL	NSDPYSVAL
TPFQGQGHGA	TPFQGQHGA
VSDGVPLVL	VSDGVPLVL
AIIDPGDSDII	AIIDPGDSD
VAESGLPAL	VAESGLPAL
ILDPHVVLL	ILDPHVVLL
SAVDLPVTL	SAVDLPVTL
NAYDEHQTL	NAYDEHQTL
YAYTGRLEL	YAYTGRLEL
LALFPGVAL	LALFPGVAL
IADPTLAEM	IADPTLAEM
STIGTYATL	STIGTYATL
GFGGGGFGSR	FGGGGFGSR
SAFGYFITA	SAFGYFITA
LSHLLAIGL	LSHLLAIGL
NAVPLFLRL	NAVPLFLRL
LAGPALEL	LAGPA-LEL
AASVINQAL	AASVINQAL
SATRVYIVL	SATRVYIVL
KAFSDHSSL	KAFSDHSSL
IAHLEITAL	IAHLEITAL
VAIHPTSSEEL	AIHPTSEEL
FADYLAHES	FADYLAHES
IAHFLDRHL	IAHFLDRHL
HALDYADEL	HALDYADEL
SPIENIQRV	SPIENIQRV
TADGDLYTL	TADGDLYTL
VALPPGLAV	VALPPGLAV
TADEVHYFL	TADEVHYFL
VTVPPGPSL	VTVPPGPSL
VADPDNPLV	VADPDNPLV
QALPPDVVSL	ALPPDVVSL
KAVDPTSGQL	AVDPTSGQL
APRQPGLMA	APRQPGLMA
SVDSHFQEV	SVDSHFQEV
RIVDPEIAL	RIVDPEIAL
VAEEVNAIL	VAEEVNAIL
TPKPPGTGP	TPKPPGTGP
FADREVQLL	FADREVQLL
ISQEHQEL	ISQEH-QEL
AAVDATVNQVL	AVDATVQVL
FAEAGRSTL	FAEAGRSTL
FTPAVHASL	FTPAVHASL
TAMDAQEAL	TAMDAQEAL
AAATDFESL	AAATDFESL
HAAEYGAEAL	AAEYGAEAL
FLDDNQIVT	FLDDNQIVT
FAVEEGDHL	FAVEEGDHL
VSAPVTHQL	VSAPVTHQL
NTATIFHEL	NTATIFHEL
MSVQPTVSL	MSVQPTVSL
YQYLLVTAL	YQYLLVTAL
FIAPTGHSL	FIAPTGHSL
FAVESEHDQAM	FAVESEDQA
SAINQVEAL	SAINQVEAL
YENEVALR	YENEV-ALR
AATKVTTVL	AATKVTTVL
SASEVPSEL	SASEVPSEL
TVYEGFISA	TVYEGFISA
AAAPHLLLL	AAAPHLLLL
YGYEHILTL	YGYEHILTL
LADEAFFSV	LADEAFFSV
RPKPSSSPVIF	RPKPSSSPV
YADGYSPPL	YADGYSPPL
FGLNIFHQL	FGLNIFHQL
AAAYPHTSL	AAAYPHTSL
AAIEVHEVL	AAIEVHEVL
FSYAFPKAV	FSYAFPKAV
RAMVASGSEL	RAMVASSEL
YAMDELRSL	YAMDELRSL
LVDDHFVEL	LVDDHFVEL
VAEGPGAEL	VAEGPGAEL
IIHEIAVLEL	IIHEIALEL
YADPGAEVKI	YADPG-AEV
NAVSGQESL	NAVSGQESL
LTDGHPLTL	LTDGHPLTL
FNDSTRLIL	FNDSTRLIL
FTSAAFHEL	FTSAAFHEL
NAFEDSFSSIL	NAFEDSSSI
TAAPTIGVL	TAAPTIGVL
SAAPPEPAV	SAAPPEPAV
LTDANIHEL	LTDANIHEL
NSSPVINHL	NSSPVINHL
NADSSNTAL	NADSSNTAL
NAVAALSEI	NAVAALSEI
NAIDKLFVL	NAIDKLFVL
IITTVGPEL	IITTVGPEL
KAIRPYHAL	KAIRPYHAL
FSDDPNVTKTL	FSDDPNVTK
AAPDGTRNL	AAPDGTRNL
AHSFFDEL	AHSFF-DEL
FSDPESQTL	FSDPESQTL
YAFKDNSNL	YAFKDNSNL
AAIEPDGNGL	AAIEPDNGL
AAINPELLQL	AAINPELQL
RPFHGISTV	RPFHGISTV
KADSVVVLL	KADSVVVLL
AVDGNTVEL	AVDGNTVEL
YIWDPHNGDIL	IWDPHNDIL
IADHYMQVL	IADHYMQVL
AAFLGHLEVL	AAFLGHLEV
KASAVYQAL	KASAVYQAL
VAVQPGEQL	VAVQPGEQL
LAVDPNRAV	LAVDPNRAV
HAMVILLTL	HAMVILLTL
ISHESPAV	ISHES-PAV
TIIDKSKSV	TIIDKSKSV
LAQAMETAL	LAQAMETAL
SAAQPGVAF	SAAQPGVAF
YADPNFVRTFL	YADPNFVRT
AQYEDIAQK	AQYEDIAQK
AAAAPSPVM	AAAAPSPVM
YAIQATETL	YAIQATETL
VATGVISTL	VATGVISTL
VPRQPTVTSV	VPRQPTTSV
SADSLEHVL	SADSLEHVL
VPHQPFSQA	VPHQPFSQA
FVIDLQTRL	FVIDLQTRL
NAPLVHATL	NAPLVHATL
YSDFVVHEI	YSDFVVHEI
VIEDKTIEL	VIEDKTIEL
SPHAHISEQA	SPHAHIEQA
YADPNFVRT	YADPNFVRT
FAVHPEPEA	FAVHPEPEA
LSDETLLEI	LSDETLLEI
VAVQHFSLL	VAVQHFSLL
KAVEIYASV	KAVEIYASV
VAYLQAHAL	VAYLQAHAL
HAAEALLL	HAAEA-LLL
AASKVMVEL	AASKVMVEL
AAENPGKYNIL	AAENPGNIL
LAIDAIHQL	LAIDAIHQL
VIVPLYDTL	VIVPLYDTL
IIDRTNTTL	IIDRTNTTL
VADDTPVLL	VADDTPVLL
SPHSQVLTA	SPHSQVLTA
ISSPVVTSL	ISSPVVTSL
AAFGRDLFL	AAFGRDLFL
AADDIHRSL	AADDIHRSL
AADWHNLIL	AADWHNLIL
YAAGAKLVL	YAAGAKLVL
FAALHGPAL	FAALHGPAL
FAHTNVESL	FAHTNVESL
SSHTLLQVL	SSHTLLQVL
VTDGALVVV	VTDGALVVV
KTPDFILQV	KTPDFILQV
AADTSEARPF	AADTSEARP
FASFPHMVL	FASFPHMVL
YAIGRSDTV	YAIGRSDTV
KAFADPEVL	KAFADPEVL
RAYDGTTYL	RAYDGTTYL
FAIDIGGSL	FAIDIGGSL
APRLQSEVA	APRLQSEVA
GIWEPKKGDVL	IWEPKKDVL
YVAQAGLEL	YVAQAGLEL
FVAPPTAAV	FVAPPTAAV
SADTILIGHSL	SADTILHSL
KAIDLMNAL	KAIDLMNAL
VADPETRTV	VADPETRTV
VADTVYRAL	VADTVYRAL
LADTSDSRAL	LADTSDRAL
FVMETFVHL	FVMETFVHL
YGDPHSPVI	YGDPHSPVI
VAGPEMQV	VAGPE-MQV
AAIGTDKEL	AAIGTDKEL
AAVDTNLTL	AAVDTNLTL
AAVAPVLSI	AAVAPVLSI
FAQDGQHQVL	FAQDGQQVL
PDQPHPEI	PDQPH-PEI
TSNVITESL	TSNVITESL
FSQALQHAL	FSQALQHAL
RALYDFEAL	RALYDFEAL
VIDPATATSV	VIDPATTSV
KADNVGSAL	KADNVGSAL
FVNVQKEL	FVNVQ-KEL
YSDDIPHAL	YSDDIPHAL
FAAEVVHPGDL	FAAEVVHPG
SAGPPLLAV	SAGPPLLAV
FADQAEILL	FADQAEILL
IAPDVDTYKEI	IAPDVDTYK
AADHTVYKL	AADHTVYKL
TTMVPTAAL	TTMVPTAAL
LILTPTSKDVL	LTPTSKDVL
IATDDITEL	IATDDITEL
AADETAVQL	AADETAVQL
NAIEGGTQL	NAIEGGTQL
YAVEGRDLTL	YAVEGRLTL
RPIPNQPPTA	RPIPNQPTA
SPHPPSEVTA	SPHPPSVTA
MAPERVASL	MAPERVASL
RPAPLPAAVV	RPAPLPAAV
NSHWDPVSL	NSHWDPVSL
HAYDGKDYISL	HAYDGKDYI
SADHLAHEV	SADHLAHEV
FAHRIWDTL	FAHRIWDTL
YIHFSEDLTL	YIHFSELTL
LAHVGPRL	LAHVG-PRL
VAAEAFSEL	VAAEAFSEL
FGHVQRAEM	FGHVQRAEM
FIVEETLPL	FIVEETLPL
TTSPVLPSL	TTSPVLPSL
AAAAPRAVA	AAAAPRAVA
AAIKAFIAV	AAIKAFIAV
SIESIHSEM	SIESIHSEM
TIANPTDVL	TIANPTDVL
HAIEESVVL	HAIEESVVL
VAVEPGAAV	VAVEPGAAV
VSHALQAAL	VSHALQAAL
KADPAAASHPL	KADPAAHPL
AAAPSLLIL	AAAPSLLIL
SAIFPDVAL	SAIFPDVAL
HAVGPSTAM	HAVGPSTAM
STPSEPHPVL	TPSEPHPVL
LTTEVHPEL	LTTEVHPEL
KPKEPQPEV	KPKEPQPEV
ASDKETYEL	ASDKETYEL
AQAEVYKEL	AQAEVYKEL
KAYTAVEGDEV	TAVEG-DEV
SAAEPTPAV	SAAEPTPAV
FVIPVVQAL	FVIPVVQAL
VPSAVLIVA	VPSAVLIVA
IIVDPAREL	IIVDPAREL
YAYDGKDYI	YAYDGKDYI
APGYSYTAA	APGYSYTAA
SPVPSHWMVA	SPVPSHMVA
YKDGTELEL	YKDGTELEL
IADEVQQRFEL	IADEVQQRF
IVIGVLHQL	IVIGVLHQL
TIHLLAPLL	TIHLLAPLL
VANFQKTTL	VANFQKTTL
QAISGMIVPPM	QAISGMIVP
RAVEVSAEL	RAVEVSAEL
FVDELRITL	FVDELRITL
KTDNSLLDQAL	NSLLD-QAL
AALDVYNAV	AALDVYNAV
FLDGNELTL	FLDGNELTL
SADKFQVLL	SADKFQVLL
AAIEIFEKV	AAIEIFEKV
TTDGYLLRL	TTDGYLLRL
IVKPVKVSA	IVKPVKVSA
LAHEIEAL	LAHEI-EAL
FAYTGRTAQEL	YTGRTAQEL
AALDDGSAL	AALDDGSAL
AATAVTQAL	AATAVTQAL
NAFDIAEEL	NAFDIAEEL
IVIDPKNPL	IVIDPKNPL
TASPVAVSL	TASPVAVSL
KALEEANAL	KALEEANAL
SADPEVMLL	SADPEVMLL
LALDASQHSSL	LALDASSSL
AADRPGVSL	AADRPGVSL
VVQGDPREL	VVQGDPREL
IADPNIAKL	IADPNIAKL
SAMEVVPAL	SAMEVVPAL
AAAEIYEEFL	AAAEIYEEF
YTSEVQAIL	YTSEVQAIL
VANTMRTSL	VANTMRTSL
YILGKFFAL	YILGKFFAL
FAIDPHLLL	FAIDPHLLL
AAVDRTTEL	AAVDRTTEL
LTDDTLQEL	LTDDTLQEL
HAAHIISEL	HAAHIISEL
AAAKTFEQL	AAAKTFEQL
SVIGHHETL	SVIGHHETL
RAQDPSEVL	RAQDPSEVL
AAVSFAKDFL	AAVSFADFL
LVDDNYFYL	LVDDNYFYL
YTDPSAEEL	YTDPSAEEL
VTLEPHIEL	VTLEPHIEL
AALPVYQEL	AALPVYQEL
NAAPGVDL	NAAPG-VDL
SAFSSWEEL	SAFSSWEEL
TDHNLHEL	TDHNL-HEL
VAWADARSL	VAWADARSL
RALGFSEEL	RALGFSEEL
YVADLGDIL	YVADLGDIL
YAYDGKDYIAL	YAYDGKDYI
TVDGSPHEL	TVDGSPHEL
VSDDTVMHL	VSDDTVMHL
VAGPSVTL	VAGPS-VTL
FGYDKDTSL	FGYDKDTSL
YTSPVIPAL	YTSPVIPAL
VIVDPETGKEM	IVDPETKEM
YIIKDKHIL	YIIKDKHIL
TIDADAPEL	TIDADAPEL
LADGVPVAL	LADGVPVAL
HPFYTRAA	HPFYT-RAA
YAISKPDIL	YAISKPDIL
LALDPSLVPTF	LALDPSLVP
FADDGVKYLEL	FADDGVKYL
FAEPGSEVYL	FAEPGSVYL
SGHLQNDTL	SGHLQNDTL
NAPWAVTSL	NAPWAVTSL
SILSHFQSL	SILSHFQSL
RTVDLFPVL	RTVDLFPVL
ASSPEHPEL	ASSPEHPEL
AAIHPSLEI	AAIHPSLEI
ITAPPGTAA	ITAPPGTAA
TFLNHPAL	TFLNH-PAL
APRGTGIVSA	APRGTGVSA
FNHINVEL	FNHIN-VEL
SANYTEIAL	SANYTEIAL
VAVGSAVGHTL	VGSAVGHTL
FAMPYFIQV	FAMPYFIQV
VSQELKEPL	VSQELKEPL
KAFQKIVVL	KAFQKIVVL
SSHLLSLTL	SSHLLSLTL
