Data	Data aligned
DFSAGVANR	DFSAGVANR
NTLTNIAMR	NTLTNIAMR
EYLHRFYGR	EYLHRFYGR
DYQTHFRLR	DYQTHFRLR
SYDLVIHQR	SYDLVIHQR
EYQPSKNMFEK	EYQPSKNMF
DYGHLSVYR	DYGHLSVYR
EVGKVIQQGR	EVGKVIQGR
DLAQALINR	DLAQALINR
HVKPSIMKR	HVKPSIMKR
EVVPEENWHTR	EVVPEEHTR
EVIDQRLIEAR	EVIDQREAR
ESFEGFIAR	ESFEGFIAR
EYIEENKYSR	EYIEENYSR
EVTDHNLHELR	EVTDHNHEL
YYFLPLKKR	YYFLPLKKR
TYKGEVLGITR	TYKGEVITR
MTHEVPVYR	MTHEVPVYR
NYIGSFLAR	NYIGSFLAR
DFKDPPTAKYR	DFKDPPTAK
EVKIPKPR	EVKIP-KPR
EVYKELRLR	EVYKELRLR
NANPLIYQR	NANPLIYQR
EVGLLFTNR	EVGLLFTNR
EIFDGIQPK	EIFDGIQPK
EYRQSLHTYLR	EYRQSLTYL
ETLVIQQR	ETLVI-QQR
EALLPTRR	EALLP-TRR
MASNSIFDS	MASNSIFDS
TYLRPPHTSR	TYLRPPTSR
DTKSPQFNR	DTKSPQFNR
EFLPKEYIKQR	EFLPKEYIK
EAIKKPLTQKR	EAIKKPTQK
ETSNLIIMR	ETSNLIIMR
EVPKHLVGR	EVPKHLVGR
ENTRPKFLSR	NTRPKFLSR
EYSPQLTRR	EYSPQLTRR
FLQEYIVNR	FLQEYIVNR
EARLLEEQR	EARLLEEQR
SANDYFSER	SANDYFSER
ESLGQSELASR	ESLGQSASR
DTPGFIVNR	DTPGFIVNR
EVLPSPRGQR	EVLPSPGQR
EFLTKPEVAR	EFLTKPVAR
EYVEFEVKR	EYVEFEVKR
HNYAAPPSTR	NYAAPPSTR
TSTVPPSLR	TSTVPPSLR
DAQEIIRPR	DAQEIIRPR
YNKYINVKK	YNKYINVKK
FFNDRPWRR	FFNDRPWRR
EATLGSGNLR	EATLGSNLR
EFLHSNQVIHR	HSNQV-IHR
EVINVLINK	EVINVLINK
FTRPFYKALLR	FTRPFYALL
NYRDDEKSFSR	NYRDDEFSR
TYMPSSSGSAR	MPSSSGSAR
EAFAIGARAR	EAFAIGRAR
YSNKEIFLR	YSNKEIFLR
ATQSFSTFR	ATQSFSTFR
EYKEPESTLR	EYKEPETLR
DSRGQEAISKR	RGQEAISKR
EAAAIIAQR	EAAAIIAQR
EAKFFTESR	EAKFFTESR
DYKVASPALR	DYKVASALR
SYLGVAHQR	SYLGVAHQR
FYNAIKSYK	FYNAIKSYK
TAMLPSSQR	TAMLPSSQR
EFREKHNIR	EFREKHNIR
SSLRIAATR	SSLRIAATR
PKDIQLAR	PKDIQ-LAR
ETLPPGKVR	ETLPPGKVR
ETSPFGAPR	ETSPFGAPR
HSKESKPTFSR	ESKPT-FSR
EVAGLQVGR	EVAGLQVGR
FTNEVLTKTYR	EVLTK-TYR
STYLRPPHTSR	TYLRPPTSR
EAYNPKIKR	EAYNPKIKR
TYQVTPMTPR	TYQVTPTPR
NFRGSLNTYR	NFRGSLTYR
EARLNAALR	EARLNAALR
ESIDQYIER	ESIDQYIER
ETVRIINR	ETVRI-INR
EYYSFYDDRQK	EYYSFYDDR
MTIMEDYFAYR	TIMEDYAYR
EMREMLTHR	EMREMLTHR
EAFLHQQKR	EAFLHQQKR
ELRRLEELR	ELRRLEELR
EAVHDLLRPR	EAVHDLRPR
ELQALTTSR	ELQALTTSR
SVQPSSSLSAR	QPSSSLSAR
EALPENRLSR	EALPENLSR
RYRPGTVALR	RYRPGTALR
MVNVPKTRR	MVNVPKTRR
DYKVASAEYHR	KVASAEYHR
QALPSQAFIYR	LPSQAFIYR
EAQRLPGVSGR	EAQRLPSGR
ETKGQDIFQR	ETKGQDFQR
EAIKITNR	EAIKI-TNR
SNKELAIER	SNKELAIER
EALHQKNIVHR	EALHQKVHR
NTNDFVTLR	NTNDFVTLR
EYLIKPLNK	EYLIKPLNK
HVFLRTTGR	HVFLRTTGR
ELAERLGLR	ELAERLGLR
EYLEYEKTR	EYLEYEKTR
EIIAPSPQRSR	EIIAPSPQR
EYLQIPPVSR	EYLQIPVSR
YEDIAQKS	YEDIA-QKS
EYSSLPLPR	EYSSLPLPR
TTKPVNWLK	TTKPVNWLK
EYQPSNIKR	EYQPSNIKR
EVKSITKER	EVKSITKER
DVQPKLWAR	DVQPKLWAR
ENRKPVSFR	ENRKPVSFR
EVAKQALNRLR	EVAKQALNR
TGNPTVVR	TGNPT-VVR
EALKLDGKNVK	EALKLDKNV
DYMASTIGR	DYMASTIGR
MVMDKKHFK	MVMDKKHFK
EYNRYTWVTGR	EYNRYTTGR
ELKGIYKDR	ELKGIYKDR
EIGHFLRER	EIGHFLRER
EYEQRVVKR	EYEQRVVKR
NWINVDPSRAR	INVDPSRAR
DIINGDAIHKR	INGDAIHKR
SLKGVDPKFLR	KGVDPKFLR
EANSQYFHL	EANSQYFHL
EFWQGQTNR	EFWQGQTNR
EVLTPEYMGQR	LTPEYMGQR
ESMIPKAR	ESMIP-KAR
ELLEKIASR	ELLEKIASR
YLPDGTASL	YLPDGTASL
EVYPVGIFQKR	EVYPVGFQK
VYHYFQWRR	VYHYFQWRR
EYLKLGYVSR	EYLKLGVSR
AYMQYIHHR	AYMQYIHHR
DTTLPASAR	DTTLPASAR
ESFSNLRNR	ESFSNLRNR
YPNKPPTVR	YPNKPPTVR
ITQIEHEVS	ITQIEHEVS
EYLSSLQPRL	EYLSSLQPR
ETNVFFYPR	ETNVFFYPR
EYVANLTNL	EYVANLTNL
DVKPSWTTR	DVKPSWTTR
SANLIVHQR	SANLIVHQR
YFKEPSLR	YFKEP-SLR
NTSNMPVAAR	TSNMPVAAR
EVLDVQKRR	EVLDVQKRR
DYGFPERKER	DYGFPEKER
EVYVPHPR	EVYVP-HPR
LAQFHFTNR	LAQFHFTNR
MYKSLDQAISR	KSLDQAISR
DWKTISKER	DWKTISKER
SVREGQGFAFR	SVREGQAFR
HAWEPTGTR	HAWEPTGTR
AVVPGTLLLFR	VVPGTLLFR
EYTKRTLMR	EYTKRTLMR
ELKQEGSLR	ELKQEGSLR
ETSALPRPR	ETSALPRPR
ESMEKWQTR	ESMEKWQTR
HTLEPLIPR	HTLEPLIPR
EYPDFNFVGR	EYPDFNVGR
EAFPSQGTKR	EAFPSQTKR
EITALAPSTMK	TALAPSTMK
SLWKKTVYR	SLWKKTVYR
EYTTKEIFR	EYTTKEIFR
TVYEGPFASR	TVYEGPASR
TTYKLVINGK	TYKLVINGK
HFNAPSHVR	HFNAPSHVR
QVKTWFQNR	QVKTWFQNR
IVQAVSAHRHR	IVQAVSAHR
DYGVAFKGR	DYGVAFKGR
EIKGTNGQVTR	EIKGTNVTR
EATAGFTIGR	EATAGFIGR
EALTALMSR	EALTALMSR
STWQRNAMR	STWQRNAMR
EARRTMTNALR	EARRTMALR
DYLHRHGIIHR	DYLHRHIHR
FATPFLVVR	FATPFLVVR
EAAKDLLYR	EAAKDLLYR
EYVMGLESRVR	EYVMGLESR
LFRPVASQLPR	LFRPVASQL
LEDALQQAKED	DALQQAKED
DYRGSGFDR	DYRGSGFDR
QYIEFVADR	QYIEFVADR
TYKRFEGLTQR	TYKRFETQR
EVINRIQKLR	EVINRIKLR
EYILPGSRER	EYILPGRER
MPEKVTWMR	MPEKVTWMR
EGRDIPIVHR	EGRDIPVHR
ESMMPNKVR	ESMMPNKVR
LVRKIQEESLR	LVRKIQSLR
DMRVHPYQR	DMRVHPYQR
HVYDGKFLAR	HVYDGKLAR
TYANIAMVR	TYANIAMVR
SVRSGYSHLPR	SVRSGYSHL
NNRELYIHR	NNRELYIHR
DYQGIKFVKR	DYQGIKVKR
EVLAEPSSR	EVLAEPSSR
EVQGSLALVSR	EVQGSLVSR
EILSVLSHR	EILSVLSHR
EYNWATVGGR	EYNWATGGR
EYEEIPKRR	EYEEIPKRR
FYKAIQKRR	FYKAIQKRR
MFKGKGIEER	MFKGKGEER
SYREQWSQR	SYREQWSQR
EAFVIDAVR	EAFVIDAVR
LLLPGELAK	LLLPGELAK
NSREKIYNR	NSREKIYNR
DYQQTIKKYR	DYQQTIKYR
ELRENGINR	ELRENGINR
EALAMGSRALR	LAMGSRALR
DANPVRYGR	DANPVRYGR
TELSVRAKPSA	ELSVRAKPS
EVVPEPVAR	EVVPEPVAR
MVLPSRLHWIR	MVLPS---R
IARDRALEGR	IARDRAEGR
EYSRYQRWR	EYSRYQRWR
MYRLPNVHGR	MYRLPNHGR
IFETIVNNR	IFETIVNNR
ISPTGHSL	ISPTG-HSL
ETIGKKFEK	ETIGKKFEK
IAPTGHSL	IAPTG-HSL
TVLQQQYNR	TVLQQQYNR
EVFDFSQRR	EVFDFSQRR
VPFGAGRHR	VPFGAGRHR
ENQRITAVR	ENQRITAVR
TMLDDDKRQLR	MLDDDKQLR
SYAEYIASR	SYAEYIASR
EVESLTAAR	EVESLTAAR
MVEYITHNR	MVEYITHNR
SYKDFSESR	SYKDFSESR
EMNRYLKNR	EMNRYLKNR
FAMNVGKAR	FAMNVGKAR
EVFTPVVQR	EVFTPVVQR
DYVPSKSKIGK	YVPSKSIGK
NNKRWYFTR	NNKRWYFTR
NGKQIYVGR	NGKQIYVGR
EMVDKHIRR	EMVDKHIRR
EAWEKKVER	EAWEKKVER
ESISLAAIKNR	ISLAAIKNR
EGAPPGSLALR	EGAPPGALR
QTADHRFLR	QTADHRFLR
EGLSGRVLR	EGLSGRVLR
EAISSLDGKNR	EAISSLKNR
EYFADMERHR	EYFADMRHR
HTFIITGRKR	HTFIITRKR
ENTTPITSR	ENTTPITSR
EVGVIPSKR	EVGVIPSKR
MFLSFPTTK	MFLSFPTTK
STKFPAYER	STKFPAYER
EAFEFVKQR	EAFEFVKQR
EVSAAIIQR	EVSAAIIQR
EVLAEFERRK	EVLAEFERR
EIYVHRSGR	EIYVHRSGR
EFDPYFNYR	EFDPYFNYR
EVKLPGKGK	EVKLPGKGK
ELLIRKLPFQR	LIRKLPFQR
TVLQYVVGR	TVLQYVVGR
EAIPGLAAR	EAIPGLAAR
MAFQGISER	MAFQGISER
ESEEVRQFR	ESEEVRQFR
EMQLRQEEERR	EMQLRQEER
ELRQKYNVR	ELRQKYNVR
ESIPGGYNALR	SIPGGYALR
EVVQITWNR	EVVQITWNR
AKNKLNDLED	KNKLNDLED
EVSTVNVRR	EVSTVNVRR
EYAERPEVAR	EYAERPVAR
MATKPLHVR	MATKPLHVR
ETNGFISAH	ETNGFISAH
EVQPAYATR	EVQPAYATR
EYLSLETTR	EYLSLETTR
YAQPPLGRLR	YAQPPLRLR
DLREQTHTR	DLREQTHTR
EIYRPPASR	EIYRPPASR
DMKPKHLLSGK	DMKPKHSGK
EVEKRFEGR	EVEKRFEGR
EYLLTHPKNR	EYLLTHKNR
EAQNLGNFIVR	QNLGNFIVR
EANSNAVRFR	EANSNARFR
QTKEMDLSVVR	EMDLS-VVR
EVFGQITER	EVFGQITER
ETRDGQVLGR	ETRDGQLGR
TYIAEEYSRLR	TYIAEEYSR
EVRTGGMAFH	EVRTGGAFH
ELSAVLIHR	ELSAVLIHR
QVKDVQKLR	QVKDVQKLR
EVNDRPVRR	EVNDRPVRR
EYAADIFYSR	EYAADIYSR
QTLDAIRHR	QTLDAIRHR
EVLDYFLRR	EVLDYFLRR
QAQLLFENR	QAQLLFENR
FTNKITSVHSR	TNKITSHSR
TAAQFIYSR	TAAQFIYSR
NVLEFTSARKR	NVLEFTSAR
SVDRPIIDR	SVDRPIIDR
DMKAANVLITR	KAANVLITR
NMFDHPIPR	NMFDHPIPR
EILRVPFRR	EILRVPFRR
EFFTVLAQR	EFFTVLAQR
EVAQFLTGR	EVAQFLTGR
EYAKLLAKR	EYAKLLAKR
HNKYMVTER	HNKYMVTER
EVSETLVQR	EVSETLVQR
ETAVFINISR	ETAVFIISR
EQGNRLFVGR	EQGNRLVGR
EFIDVIVGNR	EFIDVIGNR
DYLHSGKIVYR	YLHSGKVYR
TAYGEFLSRL	TAYGEFLSR
ETLNSSVQSIR	ETLNSSVQS
EYMAPEVVNR	EYMAPEVNR
EAIGPVHQNR	EAIGPVQNR
EYLPTLWVK	EYLPTLWVK
EFASIPANSSR	FASIPASSR
ETKDIKEIAKK	ETKDIKIAK
EFKELTRKR	EFKELTRKR
TYLGEEGKRVR	TYLGEEGKR
FTKFPTKTGR	FTKFPTTGR
TFEHPNVVR	TFEHPNVVR
EAEEEFWYR	EAEEEFWYR
EILELLNQR	EILELLNQR
ELAVVREQR	ELAVVREQR
YVKLSVGKK	YVKLSVGKK
ETYLNENLR	ETYLNENLR
EVFKGIDNR	EVFKGIDNR
ETLGQVVRR	ETLGQVVRR
EGKYIFKER	EGKYIFKER
EYIHDFNRR	EYIHDFNRR
EILGIANNR	EILGIANNR
SINKPTSER	SINKPTSER
TVNTSLNVYR	TVNTSLVYR
EARGRLLER	EARGRLLER
NVKELFSVR	NVKELFSVR
EIKDLAIKR	EIKDLAIKR
SNLPAKAIGHR	NLPAKAGHR
EFIHINNKLR	EFIHINKLR
TYLEPGIGR	TYLEPGIGR
EFDPWFNYR	EFDPWFNYR
EFLVKSKHR	EFLVKSKHR
EAIYSGYIRNR	IYSGYIRNR
EAMTIFQNR	EAMTIFQNR
HVKTGGKISLR	KTGGKISLR
EVPGSPIFVMR	EVPGSPVMR
EAMDQYSIALR	EAMDQYALR
TVKVQIHSR	TVKVQIHSR
SFQKVISRR	SFQKVISRR
EYVAIKTKK	EYVAIKTKK
ELLAWTEKR	ELLAWTEKR
SVKEIYNEK	SVKEIYNEK
LMMDPLSGQNR	MMDPLSQNR
HAKAVVSLR	HAKAVVSLR
ILAENVPPR	ILAENVPPR
EFRQRIILR	EFRQRIILR
EVGDIVVGR	EVGDIVVGR
EFQFRGGFGR	EFQFRGFGR
DYTDFYSSR	DYTDFYSSR
EYVGKTSLVER	YVGKTSVER
YTMKVFAKR	YTMKVFAKR
LARDVYVGR	LARDVYVGR
EFRSGKVAFR	EFRSGKAFR
DIKASQILASR	KASQILASR
EVAPPEYHR	EVAPPEYHR
SYAEYLAHR	SYAEYLAHR
MVNLLQIVR	MVNLLQIVR
EMKRDLDSIFR	EMKRDLIFR
ELRRELYGR	ELRRELYGR
EGKTDYYAR	EGKTDYYAR
EAKEYFADMKR	EYFAD-MKR
EIKHFVSER	EIKHFVSER
EYQNQISRQNK	EYQNQ-ISR
DYVPYVPLR	DYVPYVPLR
ETARMLAQR	ETARMLAQR
EVMRQRGINMR	EVMRQRNMR
TVLIIKSLR	TVLIIKSLR
MSMEISIHR	MSMEISIHR
EAIGIDKDR	EAIGIDKDR
EGKDLFTQR	EGKDLFTQR
EYLHGKGIIHR	EYLHGKIHR
EVQRQLAIQR	EVQRQLIQR
VAFKPTSNR	VAFKPTSNR
HTIAPMGTRR	HTIAPMTRR
LRPLLAAAA	LRPLLAAAA
EAAYIGSMR	EAAYIGSMR
EVISTPGVVAR	EVISTPVAR
DAKSVFHTR	DAKSVFHTR
MTMDKSELVQK	MDKSELVQK
TTLGATQLSER	TLGATQSER
ESLIKQIPR	ESLIKQIPR
DVRSVTSVR	DVRSVTSVR
EVLNKHSLSGR	EVLNKHSGR
DNRTLYHLR	DNRTLYHLR
EILSDVASR	EILSDVASR
DTRRESLFSAR	DTRRESSAR
EAVRPGVLR	EAVRPGVLR
ESWPRIIMR	ESWPRIIMR
HSRVILQGR	HSRVILQGR
EYSSEEIMRER	EYSSEEIMR
SYGEVFKVR	SYGEVFKVR
VNMVPFPR	VNMVP-FPR
EVLDPTAANR	EVLDPTANR
DVRELVVGR	DVRELVVGR
YVFPKPFNR	YVFPKPFNR
HVKPLLQKR	HVKPLLQKR
ATNILTATR	ATNILTATR
EVFVGKIPR	EVFVGKIPR
EISSPAVER	EISSPAVER
EYVPEKVKK	EYVPEKVKK
NTIKLIVGR	NTIKLIVGR
ETALIDRTGR	ETALIDTGR
ESRTLAIAR	ESRTLAIAR
EALLPYTER	EALLPYTER
MTKSGYQPPRL	MTKSGYPPR
EVHTKINTR	EVHTKINTR
ETLAKEKGMNR	LAKEKGMNR
ELQAFAHHGR	ELQAFAHGR
ELQKLLTTR	ELQKLLTTR
TLQEYPAIRYR	TLQEYPAIR
DLNEKIAQR	DLNEKIAQR
MYREVITQR	MYREVITQR
HTLEDQALYNR	TLEDQAYNR
EVISKLYAV	EVISKLYAV
EFSTLIVQR	EFSTLIVQR
DSYSPPHVR	DSYSPPHVR
EVFQNANFR	EVFQNANFR
ETLEEAAMRSR	ETLEEAAMR
EVLGRGGLAER	EVLGRGAER
ESAYNAFNR	ESAYNAFNR
NNKSAEAILKR	KSAEAILKR
STHFRIHER	STHFRIHER
ETEPTIIER	ETEPTIIER
EALGEQALRRR	EALGEQALR
MYFSAVMVR	MYFSAVMVR
EVVNKRFVR	EVVNKRFVR
SVSNGWTVYR	VSNGWTVYR
HTNDTIGSVRR	HTNDTISVR
DYLEFTDARGR	DYLEFTDAR
FVATKDTRALR	ATKDTRALR
EYIQILERRR	EYIQILERR
DYYEILGVSR	DYYEILVSR
AEAALGLAR	AEAALGLAR
DFYLQSVER	DFYLQSVER
DFLELQRRYR	DFLELQRYR
MTLSPSYR	MTLSP-SYR
HSKIFTDASSR	KIFTDASSR
ELNKIFALR	ELNKIFALR
DVNIRHSGR	DVNIRHSGR
EYWDRNTRNVK	EYWDR-NTR
GYKQVQVPR	GYKQVQVPR
SVKFGATLR	SVKFGATLR
EILEVATAR	EILEVATAR
DYQGIKFVK	DYQGIKFVK
HLPETKFSEL	HLPETKSEL
EALDSSWVSR	EALDSSVSR
ETQPGRLLGR	ETQPGRLGR
EAETRAEFAER	ETRAEFAER
MVIIIMDELG	MVIIIMDEL
ETDRRTLQMLR	ETDRRTMLR
EVNGLKASR	EVNGLKASR
ESKKFGGPGAR	ESKKFGGAR
EVLDRVFER	EVLDRVFER
NVIESKAYVGR	ESKAY-VGR
EYVHQIGRVGR	YVHQIGVGR
EVLPQVYNV	EVLPQVYNV
TLREYKVVGR	TLREYKVGR
ETNTGEVYR	ETNTGEVYR
DYLHYIRKYNR	DYLHYIYNR
VVAPRLNSR	VVAPRLNSR
NYYEILGVSR	NYYEILVSR
DRPHEGTRPVR	EGTRP--VR
ETQHEKILR	ETQHEKILR
EVQLKQHISSR	QLKQHISSR
EIMEVAKERSR	EIMEVAKER
YALAVSKQR	YALAVSKQR
EIFRHILQR	EIFRHILQR
DSRDGKFIHR	DSRDGKIHR
ETKDSGSFLLR	ETKDSGSFL
QQLYWSHPR	QQLYWSHPR
EALDGVVKR	EALDGVVKR
DYNPSFAIR	DYNPSFAIR
EYTINIHKR	EYTINIHKR
EVKQELAASR	EVKQELASR
EGINISGNFYR	INISGNFYR
EYEDKQKVLR	EYEDKQVLR
YPYSPPAFR	YPYSPPAFR
NVQRLKEYR	NVQRLKEYR
EVADLKIKR	EVADLKIKR
FTYMNPAQR	FTYMNPAQR
ENFFRIYKR	ENFFRIYKR
EAFNMIDQNR	EAFNMIQNR
SLVNLGGSK	SLVNLGGSK
IYSGYIRNR	IYSGYIRNR
DYYTPTGEFR	DYYTPTEFR
NSQKKYFGR	NSQKKYFGR
TVIEKTESWPR	TVIEKTWPR
EVLQGGSQR	EVLQGGSQR
ETVKDFVAR	ETVKDFVAR
ESFLPPEFR	ESFLPPEFR
ETYTEIAGMQR	TYTEIAMQR
EVYIIAVQR	EVYIIAVQR
EVLDHKEFKAR	EVLDHKEFK
EVVGIIESRAR	EVVGIIESR
YTKVPIKR	YTKVP-IKR
EVKNAEILR	EVKNAEILR
ESGPSIVHR	ESGPSIVHR
EAAAPGKRIR	EAAAPGRIR
EVTPDQKLLSR	EVTPDQKLL
STARHLYLR	STARHLYLR
SYNYLGFAR	SYNYLGFAR
EVLGPHLER	EVLGPHLER
HYVKDRFLR	HYVKDRFLR
DVYVPEASR	DVYVPEASR
TLLESEREAR	TLLESEEAR
EVNQETIQR	EVNQETIQR
TVRDAVVGR	TVRDAVVGR
QTFLRVQER	QTFLRVQER
EAKFPTMNR	EAKFPTMNR
EYKIADMGHLK	EYKIADMGH
NTLQLHRYR	NTLQLHRYR
EVEPGVHLGR	EVEPGVLGR
DFSTRFITR	DFSTRFITR
EFREGIVVDR	EFREGIVDR
VFGKWHSVPR	FGKWHSVPR
EVQVVNTER	EVQVVNTER
MPRQPSATR	MPRQPSATR
EVLPKPRMR	EVLPKPRMR
DMFATPQYR	DMFATPQYR
TLYERIVSR	TLYERIVSR
YVKDLVVQR	YVKDLVVQR
NTQEMPWNVR	NTQEMPNVR
QPFLKKWYR	QPFLKKWYR
EYKDPENILHR	EYKDPEILH
TAASRPPVTLR	ASRPPVTLR
EVPSFLVER	EVPSFLVER
ELNRIPSSR	ELNRIPSSR
WYSGVNRPR	WYSGVNRPR
TSKPPVQYR	TSKPPVQYR
ETLPDGTKRSR	ETLPDGTKR
AYKQVDPSITR	QVDPS-ITR
YSSDVIQHR	YSSDVIQHR
ETVGSIFSR	ETVGSIFSR
ETIIRIFKR	ETIIRIFKR
DYRTPTLR	DYRTP-TLR
EWTSKLWHR	EWTSKLWHR
DYINGDSKYMR	YINGDSYMR
YYFEGGLRKVR	YFEGGLKVR
FLFVPPQFR	FLFVPPQFR
SFSPPRAGR	SFSPPRAGR
NFAELKIKRLR	NFAELKIKR
SAPSRATAL	SAPSRATAL
TYFDSEVVPR	TYFDSEVPR
EYIPLRHYY	EYIPLRHYY
SYVELSQYR	SYVELSQYR
ETIYQNYQR	ETIYQNYQR
FYVDADRRSSR	YVDADRSSR
SFYQFQHYR	SFYQFQHYR
DVQHFKVLR	DVQHFKVLR
FIRHQSDRYVK	FIRHQ-SDR
ESMIPITR	ESMIP-ITR
DYRKLSQER	DYRKLSQER
EALQPLINR	EALQPLINR
EAVKPTVGMKR	AVKPTVMKR
EVLDHKEFK	EVLDHKEFK
EVIKNRFHR	EVIKNRFHR
HAVVVGVYR	HAVVVGVYR
EFSEDKVRIPR	FSEDKVIPR
DYTNERALR	DYTNERALR
DYYEVLGVQR	DYYEVLVQR
NNLGNFINR	NNLGNFINR
AANGKLFSR	AANGKLFSR
SLRELGETQRR	SLRELGTQR
IVNHPKVGR	IVNHPKVGR
DYRYFDPKMLR	RYFDPKMLR
EVLKHLKER	EVLKHLKER
FYDTISKIRLR	DTISKIRLR
TTITAPPSR	TTITAPPSR
NYIVPDKQIFR	IVPDKQIFR
YIRAKYVER	YIRAKYVER
EVKPEVKISEK	EVKPEVSEK
EINNRSAANIR	NNRSAANIR
SNFGPEVTR	SNFGPEVTR
EAMRWFQQK	EAMRWFQQK
EVKQVESGTLR	EVKQVETLR
QNIVPASQR	QNIVPASQR
VFKEEGVLR	VFKEEGVLR
DIKPSNIFISR	DIKPSNISR
DFLHNKGIAHR	FLHNKGAHR
QFLERFKSSAR	QFLERFSAR
DYFEGATSQR	DYFEGASQR
QLYPRNFLR	QLYPRNFLR
EVLALPFKR	EVLALPFKR
EAQRFFAQK	EAQRFFAQK
YSTYVLHER	YSTYVLHER
EFAPETGKREK	EFAPETGKR
EYNARLFGL	EYNARLFGL
QSSNLIQHR	QSSNLIQHR
DYRDPPDGSGR	DYRDPPSGR
DSYVGDEAQSK	YVGDEAQSK
EVQQARDLQNR	EVQQARQNR
DIIQRMHLR	DIIQRMHLR
ETIAPKIAR	ETIAPKIAR
LAQGDSLAAR	LAQGDSAAR
QYKGQAGALER	QYKGQALER
DVNNIGKYR	DVNNIGKYR
DLQAHINHR	DLQAHINHR
EALGSGLVSR	EALGSGVSR
ETIHHLKNLR	ETIHHLNLR
EMMADMYNR	EMMADMYNR
LYYHRRQEELK	YYHRRQEEL
EFFDEERRAR	EFFDEERAR
EWRDKLRPR	EWRDKLRPR
EVINKLGPR	EVINKLGPR
EIASFDKAKLK	EIASFDKAK
ESLQQPLINR	ESLQQPINR
EVQYYNIKR	EVQYYNIKR
NYGPGPSLR	NYGPGPSLR
ELLIRPVQR	ELLIRPVQR
FYNLMPLSR	FYNLMPLSR
ESRFQLGGSAR	ESRFQLSAR
DSLIPPQSR	DSLIPPQSR
EVRPVETLR	EVRPVETLR
YTKIVVKGMTR	YTKIVVMTR
DYVPETVYR	DYVPETVYR
ETISKKEFQVR	ISKKEFQVR
EYEQIQAKR	EYEQIQAKR
DYVDIVQGR	DYVDIVQGR
SFDLTTPYR	SFDLTTPYR
RNLDHVYNR	RNLDHVYNR
EVRRLVIGR	EVRRLVIGR
EFINEKGVKR	EFINEKVKR
EFRDSSLPRSR	EFRDSSLPR
ETLNQMIAR	ETLNQMIAR
ETHGNLMTER	ETHGNLTER
LNSSPITTR	LNSSPITTR
NYYGYQGYR	NYYGYQGYR
AYNETFSNR	AYNETFSNR
NYTEYVATR	NYTEYVATR
SYKGSISYR	SYKGSISYR
DYRMKEWSR	DYRMKEWSR
EFKERLRKR	EFKERLRKR
SFFRREIKR	SFFRREIKR
EMGLRPLPR	EMGLRPLPR
DVKDPVSIEER	DVKDPVEER
NNKDLYVLR	NNKDLYVLR
DLFEKRTNR	DLFEKRTNR
DFARRLGLR	DFARRLGLR
ELQPGYIRSR	ELQPGYRSR
EFISSTTVR	EFISSTTVR
NIPEKTTAL	NIPEKTTAL
ETRAEFAER	ETRAEFAER
FTNERFPLR	FTNERFPLR
EVRGGGLTR	EVRGGGLTR
ELNTLRVTR	ELNTLRVTR
EVLSQKRMYR	EVLSQKMYR
EGLPEGVPFRR	EGLPEGPFR
EMAIPFFTGR	MAIPFFTGR
EYLHNYGIVHR	EYLHNYVHR
EAYNETFSNR	EAYNETSNR
DYKSALRFHKR	DYKSALHKR
MIKGKTPEEIR	KGKTPEEIR
FSNDVIRKR	FSNDVIRKR
DVNVISWSR	DVNVISWSR
EYAPLGTVYR	EYAPLGVYR
STLESIYQR	STLESIYQR
NSKESYELR	NSKESYELR
RVYIHPFHL	RVYIHPFHL
ELLHFLFGPLQ	ELLHFLGPL
STIDWNKLYRR	STIDWNLYR
TYVGSMPGR	TYVGSMPGR
EYAAKFIKKR	EYAAKFKKR
EYVIESARQR	YVIESARQR
FWRSFHTER	FWRSFHTER
EYHWRKHLR	EYHWRKHLR
EAAAPLRVR	EAAAPLRVR
ETVQDIVYR	ETVQDIVYR
DYIHHMGYVHR	DYIHHMVHR
EAVLWEALR	EAVLWEALR
NALEGSTFVSR	NALEGSVSR
DFQIEKKIGR	DFQIEKIGR
TYMDPTGKTR	TYMDPTKTR
EFVSIMKQR	EFVSIMKQR
DFPRPVHHR	DFPRPVHHR
SIMKWNRER	SIMKWNRER
LMQQQKSFR	LMQQQKSFR
IVKPVKVSAPR	IVKPVKVSA
EFKDKTWTR	EFKDKTWTR
DLKHLIYYR	DLKHLIYYR
ETFEHPNVVR	ETFEHPVVR
NPNVPAYR	NPNVP-AYR
EVYTLAEHR	EVYTLAEHR
ETNYGIPQR	ETNYGIPQR
ETYLHRIGRSG	ETYLHRIGR
EYLSNADERLR	EYLSNADER
NLAEKSTVHMR	LAEKSTHMR
QTQDNITVR	QTQDNITVR
SSNLIIHQR	SSNLIIHQR
TVFDAKRLIGR	DAKRL-IGR
QYKFPVVITR	QYKFPVITR
EARKQVEVFR	EARKQVVFR
ETFSGVYKK	ETFSGVYKK
ATLNVSTTR	ATLNVSTTR
EVLRHPRDWVR	EVLRH--PR
TTYNHPLAER	TYNHPLAER
EFQDFTVPR	EFQDFTVPR
YTRQTGIVLNR	YTRQTGIVL
DTRSEFYKH	DTRSEFYKH
EIQKRFREQER	EIQKRFQER
TIMPKDIQLAR	MPKDIQLAR
NFVGRLIGK	NFVGRLIGK
SAPVGVTAL	SAPVGVTAL
EIASVAYRYR	EIASVARYR
TYFQAKIRALK	YFQAKIALK
QVADVVVSR	QVADVVVSR
YTLQLDGHRTR	YTLQLDGHR
EYNGKIPRFR	EYNGKIRFR
SVNELIYKR	SVNELIYKR
EYVHSKNLIYR	YVHSKNIYR
EVAGIVAAR	EVAGIVAAR
HVLTEDIVHR	HVLTEDVHR
EAQKPYLVQR	EAQKPYVQR
VYIERLRHR	VYIERLRHR
EVVVSVPQR	EVVVSVPQR
EWIEPPKRER	EWIEPPRER
SYSSDVIQHR	YSSDVIQHR
QLKAPHANR	QLKAPHANR
EISAPVSER	EISAPVSER
EYIQKNVQLYK	EYIQKNVQL
EALNVLVNR	EALNVLVNR
LTKHTKFVR	LTKHTKFVR
EGLNILLNR	EGLNILLNR
TFRSPHGQTR	TFRSPHQTR
DFAGEEVRVTK	FAGEEVVTK
YLKEREEFR	YLKEREEFR
QVQQILTSR	QVQQILTSR
EYRDMRDGFR	EYRDMRGFR
EVPNKIINR	EVPNKIINR
TYRLGMAAR	TYRLGMAAR
TYNEHITKR	TYNEHITKR
VVKPDQLIKRR	VVKPDQIKR
EFSPTFSER	EFSPTFSER
EVREPPFHLTR	EVREPPFHL
HNMDVPNIKR	HNMDVPIKR
ESMEPKVFR	ESMEPKVFR
EFIERQHAK	EFIERQHAK
ETAAYKIMR	ETAAYKIMR
SSYFRIHER	SSYFRIHER
DYKDIEHLK	DYKDIEHLK
DFVGVHQER	DFVGVHQER
NYTFTVQAR	NYTFTVQAR
EAYLPETFR	EAYLPETFR
FSKNVHSTRF	FSKNVHSTR
YYKPWFFKH	YYKPWFFKH
ETAPRTIFQR	ETAPRTFQR
NYIEFTRILK	NYIEFTILK
EVLERGGRFTR	EVLER-GGR
EYNNFIDVHR	EYNNFIVHR
ETILGDIDRAR	ETILGDIDR
EYAAQDQKFQR	AAQDQKFQR
EYSTSIATR	EYSTSIATR
MAISSGAVVHR	ISSGAVVHR
NVIEAVYNR	NVIEAVYNR
LVREIRQYR	LVREIRQYR
IYKAISSNR	IYKAISSNR
EIFGTIGMR	EIFGTIGMR
EVKDRHLVAKR	EVKDRHVAK
EYREKIETELR	EYREKITEL
EYWDRQRNRHR	EYWDRQRNR
EVTDYAIAR	EVTDYAIAR
HNADQPLRVR	NADQPLRVR
ESQAAKDLLYR	QAAKDLLYR
EIRDKKTGLGR	EIRDKKTGL
TFKDYVRDR	TFKDYVRDR
NLKDRDFLVQR	NLKDRDVQR
STYLLSVYR	STYLLSVYR
EALPGLQRR	EALPGLQRR
VYIEKFVRR	VYIEKFVRR
EAQRITGLR	EAQRITGLR
TVFSPTLPAAR	FSPTLPAAR
TTKSLFVGH	TTKSLFVGH
TTTEHRFFR	TTTEHRFFR
DMKRRIHLELR	DMKRRIELR
NYAAPPSTR	NYAAPPSTR
IDISDIAEKR	DISDIAEKR
SFFGERRIPR	FFGERRIPR
LEEALQQAKED	EALQQAKED
EIYSESHRVHR	YSESHRVHR
EILELAGNAAR	EILELAAAR
EILSRSIVKR	EILSRSVKR
VTVDGPREPR	TVDGPREPR
LALLPPQAR	LALLPPQAR
MLLRLFLAM	MLLRLFLAM
DLRPATDYHVR	DLRPATHVR
FTSGYIPAR	FTSGYIPAR
ESIGRVLAQR	ESIGRVAQR
DFIASGRTGR	DFIASGTGR
EYLRLSRVK	EYLRLSRVK
NIMDPQHRAKL	NIMDP-QHR
ELARSLFNR	ELARSLFNR
EFLKLDRERAK	EFLKLDRER
EVAPPKAHEVR	EVAPPKEVR
EYAHTRYFR	EYAHTRYFR
TYKYFKDYR	TYKYFKDYR
EFTNAIRREK	EFTNAIREK
TSKSYLTVHER	SYLTV-HER
EWWHRTIQR	EWWHRTIQR
EYSGFAGVSR	EYSGFAVSR
FYETGEIPR	FYETGEIPR
EAIEKHARFR	EAIEKHRFR
FVRDKFTRR	FVRDKFTRR
EYVETVTSR	EYVETVTSR
TTRDSPVLR	TTRDSPVLR
EYLQPNPASR	EYLQPNASR
EFKAVQQVQR	EFKAVQVQR
ESSPSIVHR	ESSPSIVHR
DIRTPPLQSER	DIRTPPSER
DAFFNPATR	DAFFNPATR
LTKDHYIER	LTKDHYIER
NLKPKSWVR	NLKPKSWVR
NAKDVLRKR	NAKDVLRKR
DVRSDFQRR	DVRSDFQRR
DYLVFANNR	DYLVFANNR
EVLINNINR	EVLINNINR
EVGEKLFHAR	EVGEKLHAR
EYLESKQFLHR	EYLESKQFL
EAKAPILKR	EAKAPILKR
SFRKKYELR	SFRKKYELR
ENFDRFFTR	ENFDRFFTR
ELWNKTIDAMK	ELWNKTIDA
EISGTFTHR	EISGTFTHR
YVKEQFAWR	YVKEQFAWR
QTKPVYVYR	QTKPVYVYR
ELQRIKWHR	ELQRIKWHR
ISPSRTEAL	ISPSRTEAL
ELNPEIVAR	ELNPEIVAR
SAPYGRITL	SAPYGRITL
EYERAIIFR	EYERAIIFR
EVVGIIESR	EVVGIIESR
EYLDMKNTR	EYLDMKNTR
EAKQAFKELLK	EAKQAFKEL
EYNAIGGKYNR	NAIGGKYNR
AGKSVHVLR	AGKSVHVLR
ENFGNTTPR	ENFGNTTPR
NAKPVSILR	NAKPVSILR
ETLPEQLLAEK	ETLPEQAEK
ESQKEFVRR	ESQKEFVRR
EYMGNAGRKER	EYMGN-AGR
TTLPDDMITQR	TLPDDMTQR
EYAKLLAKRMK	EYAKLLAKR
EVLAEFERRKR	EVLAEFERR
MATGFIWSR	MATGFIWSR
ESMQRFHNR	ESMQRFHNR
EVQEQYTERL	EVQEQYTER
YFKPPDKKR	YFKPPDKKR
EYIKNWRPR	EYIKNWRPR
EILRHHVNR	EILRHHVNR
VANSAFVER	VANSAFVER
DYGRYDKTQLR	DYGRYDTQL
ELKAPGISYQR	ELKAPGYQR
EVHAVVTVR	EVHAVVTVR
ELQTFVANR	ELQTFVANR
HARYILTNR	HARYILTNR
VPIGYHVPR	VPIGYHVPR
QYIATIHSR	QYIATIHSR
DYLENIFVK	DYLENIFVK
DVNSGFAKR	DVNSGFAKR
EVKETWHERL	EVKETWHER
QGYSDFINR	QGYSDFINR
EVVTGVIGQR	EVVTGVGQR
EVQSQPPRVR	EVQSQPRVR
EVMRILISR	EVMRILISR
ETFQQKMLR	ETFQQKMLR
ENKEESLLEKR	ENKEESLEK
FPLMPVVGR	FPLMPVVGR
ETNIVAVER	ETNIVAVER
DYMGRGKISK	DYMGRGISK
TVMSVKIIRNR	MSVKIIRNR
EVLTDTRGLYR	EVLTDTRGL
ETNEIANANSR	ETNEIANSR
MVNVPKTR	MVNVP-KTR
EAMASIINR	EAMASIINR
HTNDTIGSVR	HTNDTISVR
DAAAVLVSR	DAAAVLVSR
ELFNRIEKR	ELFNRIEKR
FTQQNYHDR	FTQQNYHDR
YFQSPSRSR	YFQSPSRSR
EASRHAIMR	EASRHAIMR
EYMTPSSR	EYMTP-SSR
YVANVGTNR	YVANVGTNR
TVIDSQTHYR	TVIDSQHYR
EFRPDGKLR	EFRPDGKLR
ETISKAQAFER	ISKAQAFER
TSKPPVTLR	TSKPPVTLR
EVQEDFSVR	EVQEDFSVR
NFKSPVKTIR	NFKSPVTIR
ETAFAFHLR	ETAFAFHLR
EYVEDLAKIPR	YVEDLAIPR
EVRQPPPRVR	EVRQPPRVR
MVKPTPGLTPR	MVKPTPTPR
ETVQKETIHPR	TVQKETHPR
DVQERLVYR	DVQERLVYR
ESQDLHGLVSR	ESQDLHVSR
EYYDKAFDR	EYYDKAFDR
SYKDPATLR	SYKDPATLR
EVKESPFFR	EVKESPFFR
QLLKKEWLR	QLLKKEWLR
EYTAAVEAK	EYTAAVEAK
HAADPIITR	HAADPIITR
ELYEKVFSR	ELYEKVFSR
EVKNIIDKASR	EVKNIIASR
MTPPERLFLPR	TPPERLLPR
EAQGIHISR	EAQGIHISR
EAMASIINRL	EAMASIINR
KTKEGYYYR	KTKEGYYYR
ESLLVSVQR	ESLLVSVQR
EFVTTVQQR	EFVTTVQQR
EGGGRLQALR	EGGGRLALR
ESLPATHIR	ESLPATHIR
TYFDLPQSSR	TYFDLPSSR
STKGHLLIHSR	STKGHLHSR
FTNSKKSVTLR	NSKKSVTLR
ESYRPPKSR	ESYRPPKSR
ETEREYFNR	ETEREYFNR
LINNKIANR	LINNKIANR
DYRDTVVKR	DYRDTVVKR
DAGSVPHVNR	DAGSVPVNR
MVLAHVTNR	MVLAHVTNR
EALNQVTQR	EALNQVTQR
ETAIPFRSR	ETAIPFRSR
ESIESEIRRER	ESIESEIRR
EVIKPWITKR	EVIKPWTKR
EYIEEVRAK	EYIEEVRAK
ATLYLGWNR	ATLYLGWNR
NVKPLVTHR	NVKPLVTHR
TEELAYLK	TEELA-YLK
EEQLQQIRAE	EEQLQ-QIR
EIKDIHVPPR	EIKDIHPPR
DVLQWIVQR	DVLQWIVQR
EYIKGGTLR	EYIKGGTLR
ESKLVLFGR	ESKLVLFGR
EVQFLGRYK	EVQFLGRYK
DFRNPGPGRHR	DFRNPGPGR
YTLDFPESR	YTLDFPESR
NYFFYNKRLKR	FFYNKRLKR
SSKPLYLAR	SSKPLYLAR
EALSALTAR	EALSALTAR
EAQIIQRR	EAQII-QRR
EYKDPGKMIR	EYKDPGMIR
EVPPPPNLR	EVPPPPNLR
VSNKWLHER	VSNKWLHER
EVQKLKRYK	EVQKLKRYK
SGVQVFQQSSR	QVFQQ-SSR
EYIFLAVGR	EYIFLAVGR
ETFQRPYQYLR	TFQRPYYLR
IFKKHSGTLR	IFKKHSTLR
FVKDSIRLVKR	FVKDSIVKR
QTYEKFLHR	QTYEKFLHR
TVIPATVVTSR	IPATVVTSR
EAKKPPDVVR	EAKKPPVVR
HAQLLEQHR	HAQLLEQHR
ETLETIINR	ETLETIINR
MSIHLIHMR	MSIHLIHMR
SIPEKNRPL	SIPEKNRPL
EVRPVVVPK	EVRPVVVPK
HTKPSMLTQR	HTKPSMTQR
EMLQQIANR	EMLQQIANR
EYIEIITSSIK	EYIEIITSS
ETHSHFLARL	ETHSHFLAR
EAQGGDSILQR	QGGDSILQR
DYISRAESQSR	ISRAESQSR
DYQLVRKLGR	DYQLVRLGR
EYEEFKELTR	EYEEFKLTR
TEKPEVID	TEKPE-VID
NVARRIEFR	NVARRIEFR
EYRPYETER	EYRPYETER
STRPPSVTR	STRPPSVTR
TAYRPDWNR	TAYRPDWNR
VYRNPESFKEK	VYRNPESFK
ESWPVLVGR	ESWPVLVGR
ESIAAFIQR	ESIAAFIQR
ETLLLQAER	ETLLLQAER
EVKPSIRAR	EVKPSIRAR
EALNFLHSKR	EALNFLSKR
SANLVVHQR	SANLVVHQR
NSFRYNGLIHR	SFRYNGIHR
EFIIFNREKLR	EFIIFNREK
EALGLRKKR	EALGLRKKR
YYALVVRGR	YYALVVRGR
EYLQNVEQK	EYLQNVEQK
ESRPGEWLVR	ESRPGELVR
SFKKPPLRR	SFKKPPLRR
ITYLMEHKR	ITYLMEHKR
EVQGEIHLR	EVQGEIHLR
HVRDADLLKKR	DADLL-KKR
ISRDNWHKR	ISRDNWHKR
EVLVDPRSR	EVLVDPRSR
DFHSVSKLR	DFHSVSKLR
TYQNYKNFNSR	QNYKNFNSR
DLIDRGWRR	DLIDRGWRR
STYIRLYGR	STYIRLYGR
EYVDNTNLVPR	EYVDNTVPR
ESKGLGYVR	ESKGLGYVR
EMFTPILGR	EMFTPILGR
ALAPPDVHHER	LAPPDVHER
YIHIRIQQR	YIHIRIQQR
EYNAPWKER	EYNAPWKER
QYNPEPPPPR	QYNPEPPPR
DYIVKHTKR	DYIVKHTKR
EVLPKNIQR	EVLPKNIQR
DYLAHESRR	DYLAHESRR
EALGEVMVSR	EALGEVVSR
EYIQQLRSR	EYIQQLRSR
SYLHENQIIHR	YLHENQIHR
EYLQGLEARL	EYLQGLEAR
EAWRPLER	EAWRP-LER
NSLLRENSFR	SLLRENSFR
ETEARPSIMKR	EARPSIMKR
LYISEGLHPR	YISEGLHPR
VVMTPPRNR	VVMTPPRNR
DYIYHGTVKLR	IYHGTVKLR
FTGSIFIGR	FTGSIFIGR
EYLEKQRNR	EYLEKQRNR
DYIDSPSLKDR	DYIDSPSLK
EVQRKLGHVR	EVQRKLHVR
ETYLHRIGR	ETYLHRIGR
EVRDQGYLR	EVRDQGYLR
EIMSMGYERER	EIMSMGYER
SYGPGPSLR	SYGPGPSLR
DYLEQQVAR	DYLEQQVAR
QSNLIVHQR	QSNLIVHQR
ETMEKGFSK	ETMEKGFSK
DYFTPQGEFR	DYFTPQEFR
FAHKPAIRR	FAHKPAIRR
EAASYLDQISR	SYLDQ-ISR
EVLNRIQFR	EVLNRIQFR
LLSQLKGPR	LLSQLKGPR
EYVAIKTKKR	EYVAIKKKR
ESVLRTQIR	ESVLRTQIR
EYVEILGEQR	EYVEILEQR
HFKKPGLTGR	HFKKPGTGR
EYIDGALSGH	EYIDGASGH
EFAKKQPWWRK	EFAKKQWWR
EYMNNKEALPK	EYMNNKEAL
TYYGSFVTRA	TYYGSFVTR
FYKDGRIVQSR	FYKDGRQSR
DFLRRSSSR	DFLRRSSSR
EIPKRFGQR	EIPKRFGQR
YVQRYRYFR	YVQRYRYFR
EAISLLNSER	EAISLLSER
NMKSPPVER	NMKSPPVER
EAHAQSIGMNR	HAQSIGMNR
EIKDKDQLVLR	EIKDKDVLR
EFAKFEEERAR	EFAKFEEER
QVLNRVVTR	QVLNRVVTR
EYVDVVFANR	EYVDVVANR
EVIPITDSELR	EVIPITSEL
ELQLIIAQR	ELQLIIAQR
ELLPRLQAR	ELLPRLQAR
AHARIHLR	AHARI-HLR
AYKDPEKNWNR	AYKDPEWNR
TTKDIILPFR	TTKDIIPFR
EVAERLGVTR	EVAERLVTR
TLRDLIFKR	TLRDLIFKR
DYFDALYKR	DYFDALYKR
ETVERIFRR	ETVERIFRR
HFNAPSHIRR	HFNAPSIRR
EMKLQVTQR	EMKLQVTQR
ITQRELVSR	ITQRELVSR
TSRNITEAR	TSRNITEAR
NSQLIVHQR	NSQLIVHQR
ELAQWLIQR	ELAQWLIQR
DYLHSEKKIHR	YLHSEKIHR
EVLSQKKMHR	EVLSQKMHR
HNQGPVIKR	HNQGPVIKR
EYIKTWRPR	EYIKTWRPR
EIYEYIIFR	EIYEYIIFR
EAQAIETAR	EAQAIETAR
EYSHRMWGR	EYSHRMWGR
EVLAGPLAQR	EVLAGPAQR
EYLDYDDTRYH	EYLDYDDTR
EVRPDTQYTGR	EVRPDTTGR
DYRALVHER	DYRALVHER
EIMERDAERKR	EIMERDAER
EVYDIAFSR	EVYDIAFSR
FYRYYQVAR	FYRYYQVAR
FVRLKSETR	FVRLKSETR
EVANIPVAR	EVANIPVAR
HSKSSPEISLR	KSSPEISLR
FSQGIFSSR	FSQGIFSSR
EYLREKLQR	EYLREKLQR
ESFPGSFRGR	ESFPGSRGR
EFQQVLSNR	EFQQVLSNR
EAMEWVIHK	EAMEWVIHK
ENRKPVSFRQR	ENRKPVSFR
ETIHADSVAKR	TIHADSAKR
EFKPEISMR	EFKPEISMR
EAFDSTSRFAR	EAFDS-TSR
EYVETIIAK	EYVETIIAK
EYVKAGKRIPR	YVKAGKIPR
KFSETYYTR	KFSETYYTR
EIYKPGLSR	EIYKPGLSR
DSMLVDPKHHR	MLVDPKHHR
MANSFVGTR	MANSFVGTR
DIRNHIVQR	DIRNHIVQR
EIRQQIPVFR	EIRQQIVFR
EYAERPEVARR	EYAERPVAR
EYDPALSQPR	EYDPALQPR
FTHDQIMRR	FTHDQIMRR
EYQESNALLLR	EYQESNALL
YYMRRPYGR	YYMRRPYGR
ELLKKEKINIR	ELLKKENIR
EALVMPTLR	EALVMPTLR
EILGVLVPR	EILGVLVPR
ELAKIMRTR	ELAKIMRTR
FVFDRPVHR	FVFDRPVHR
LTMNEELKRAR	TMNEELRAR
IALTDNALIAR	LTDNALIAR
EVAPAKPPR	EVAPAKPPR
EVYRHFTGH	EVYRHFTGH
ETFPQRHMR	ETFPQRHMR
EVRADTGGLGR	EVRADTLGR
DYKVVSPALR	DYKVVSALR
TTLEVLRER	TTLEVLRER
HYYDGTIFHR	HYYDGTFHR
EVLATPLENR	EVLATPENR
EIKEKFKVETR	EIKEKFETR
MMMSYAAER	MMMSYAAER
LAKLNQVAR	LAKLNQVAR
DAKGGSFYR	DAKGGSFYR
QVRSIQQTMAR	RSIQQTMAR
ETIKSLLIRR	ETIKSLIRR
EFPQPPGAAR	EFPQPPAAR
QTKPVVVYR	QTKPVVVYR
ELMAGHLRNR	ELMAGHRNR
QTNLVPYPR	QTNLVPYPR
ESMKETLRIRR	ESMKETRIR
EQFDRKYTR	EQFDRKYTR
EAFDYIKQR	EAFDYIKQR
SVQGIIIYR	SVQGIIIYR
MPLTPNPVGR	MPLTPNVGR
EYIDFEKIRK	EYIDFEKIR
QTQSLHSLR	QTQSLHSLR
EVFEYIIFR	EVFEYIIFR
EFKEEISRR	EFKEEISRR
HSMDFVAYR	HSMDFVAYR
LYAEKVATR	LYAEKVATR
EALVGTLKAAK	EALVG-TLK
HIIEKDKITTR	IEKDKITTR
DTMRLQPIGR	DTMRLQIGR
ISSGAVVHR	ISSGAVVHR
EYWMALRNR	EYWMALRNR
EVQVLDDKNVR	QVLDDKNVR
VTQEIVTER	VTQEIVTER
ETSAPFKER	ETSAPFKER
EYFSPVGYNR	EYFSPVYNR
EQLERLYNR	EQLERLYNR
SALRPSTSR	SALRPSTSR
SYLDKFFSR	SYLDKFFSR
DIKSHYAFR	DIKSHYAFR
LTKEEDLAALR	LTKEEDALR
EGNQIFNNR	EGNQIFNNR
MVQPINLIFR	MVQPINIFR
FTLDINTAYAR	DINTA-YAR
TLRKPPAVGR	TLRKPPVGR
EYITKQGFTIR	ITKQGFTIR
EIKSLTKER	EIKSLTKER
ETILRTNKR	ETILRTNKR
EMQRVKGMTER	EMQRVKTER
HNQRPTFR	HNQRP-TFR
SSGPGPSLR	SSGPGPSLR
EAQVKIWRR	EAQVKIWRR
AGFAGDDAPR	FAGDD-APR
TYKQGILAR	TYKQGILAR
SSQQFSGIGR	SSQQFSIGR
HFNAPSHVRR	HFNAPSHVR
SALIPHAR	SALIP-HAR
DVKTTDGYLLR	KTTDGYLLR
EIKPDELAKKR	EIKPDEAKK
EILPDGLPSAR	EILPDGSAR
DYARLVKGR	DYARLVKGR
YYQDTPKQIR	YYQDTPQIR
DYYDDFLQR	DYYDDFLQR
QAYPEELIRQR	AYPEELRQR
ELAYLERRER	ELAYLERER
ETLETIINRL	ETLETIINR
ESRSSFSQHAR	ESRSSFSQH
EVLEKLIEK	EVLEKLIEK
EYIIKTDENVR	EYIIKTNVR
EIHQDWANR	EIHQDWANR
HNRSPVSFR	HNRSPVSFR
SVLEATRVNR	SVLEATVNR
IFKGVFVHR	IFKGVFVHR
EAAFATKDRLR	EAAFATKDR
QTKFAATVR	QTKFAATVR
EVQSYIRKR	EVQSYIRKR
DVNKKFSVR	DVNKKFSVR
DAADKPRGFAR	DAADKPFAR
LDLLSQSQRR	DLLSQSQRR
ETYLLEKSR	ETYLLEKSR
TNTVPKLYR	TNTVPKLYR
EALPGSGQAR	EALPGSQAR
HYIQLGTVYR	YIQLGTVYR
EVWKGIKKR	EVWKGIKKR
NLERDFFLR	NLERDFFLR
TFEALKRNR	TFEALKRNR
EAKVKFEER	EAKVKFEER
DIKSSETGAFR	KSSETGAFR
EILSRRPSYR	EILSRRSYR
MATFPVAPR	MATFPVAPR
ETLPPVGVNR	ETLPPVVNR
EYQTQLIQR	EYQTQLIQR
ETGVPIAGR	ETGVPIAGR
SAKGVSILR	SAKGVSILR
EFNPSSSGR	EFNPSSSGR
EYIIGLLQQR	EYIIGLQQR
ELWLVIHGR	ELWLVIHGR
EIIDKDSKTRR	EIIDKDKTR
TTYKLVINGKT	TYKLVINGK
HTNSYGIIR	HTNSYGIIR
EYQEKPLLR	EYQEKPLLR
DIHNIHVMR	DIHNIHVMR
TTNAKVALR	TTNAKVALR
VYNEYISHR	VYNEYISHR
FELDLVTLRSE	FELDLVTLR
EFGEPLPKRL	EFGEPLPKR
TYIYFKRLK	TYIYFKRLK
SIREPIANR	SIREPIANR
DYNPLYKER	DYNPLYKER
TSIRWSLGR	TSIRWSLGR
ESLVPTAR	ESLVP-TAR
EYIKPRLRFK	EYIKP-RLR
DYLKTVLHR	DYLKTVLHR
SAGGSFTVR	SAGGSFTVR
MLWERLSSTKR	ERLSS-TKR
STKNIHFSRL	STKNIHFSR
DFSQNTRVPR	FSQNTRVPR
HSQLVIHQR	HSQLVIHQR
ESLPATHIRGK	ESLPATHIR
TYTDLESLRNR	TYTDLESLR
ESDEGKLHVLR	EGKLH-VLR
EYFSDLPPRL	EYFSDLPPR
SQKPVMVKR	SQKPVMVKR
HNLHPDYIHGR	NLHPDYHGR
HTGYPGGFR	HTGYPGGFR
EFGEPLPKR	EFGEPLPKR
DILARAFSR	DILARAFSR
QNMGLPQNR	QNMGLPQNR
EYRSEQSVKLR	EYRSEQSVK
ESLNFLIGRL	ESLNFLIGR
FYNRPILSR	FYNRPILSR
EYVADPVYR	EYVADPVYR
ETISSKNIISR	ISSKNIISR
EAHNILSKR	EAHNILSKR
IYQDSFEQR	IYQDSFEQR
DYFSNPGNFER	FSNPGNFER
ETLFRMGVAR	ETLFRMVAR
EVLDKRYNV	EVLDKRYNV
EYLQADEANKR	EYLQADANK
LLQDFFNGK	LLQDFFNGK
DFREKGGYR	DFREKGGYR
SYRKFLNLR	SYRKFLNLR
ITTVPPNLR	ITTVPPNLR
DYFSPDNLKER	FSPDNLKER
NAKDTIFHR	NAKDTIFHR
TYAAFVQTHR	TYAAFVTHR
ELNDKMKGFYR	ELNDKMFYR
EYFQKYGYSPR	YFQKYGSPR
DTLVPYGNR	DTLVPYGNR
EVLREGELEKR	EVLREGLEK
EVAPPASGTR	EVAPPAGTR
FMNDPAMNR	FMNDPAMNR
EYLNHVSKRL	EYLNHVSKR
TAISKKFGDMR	ISKKFGDMR
DVFPGPSFR	DVFPGPSFR
EYLEGNNFVHR	EYLEGNVHR
EVMFPKNVR	EVMFPKNVR
DFLKVLNRAR	DFLKVLRAR
YSNSPEALR	YSNSPEALR
ETPTFAKVQR	ETPTFAVQR
EYMDKNNVRR	EYMDKNVRR
TALKVASTR	TALKVASTR
HVKFKSKADLR	KFKSKADLR
ETQKLQEMR	ETQKLQEMR
ETIPSFTGR	ETIPSFTGR
EVWPHSTER	EVWPHSTER
SIRDPVHNR	SIRDPVHNR
MFEYLAPPR	MFEYLAPPR
FYSQHFSGR	FYSQHFSGR
ELNVDSLITR	ELNVDSITR
STKPPGTFLLR	STKPPGTFL
HVYNLPKGR	HVYNLPKGR
DANGNSFATRI	DANGNSATR
EVHMLLEHR	EVHMLLEHR
ESMKRQIVSR	ESMKRQVSR
TSKEAVGVYR	TSKEAVVYR
ESIPVINGR	ESIPVINGR
EVFDFSQRRK	EVFDFSQRR
EFRDYPPVLR	EFRDYPVLR
LDIGEIKKR	LDIGEIKKR
ETVSEEKRIYR	TVSEEKIYR
LFKELHTGR	LFKELHTGR
EIMEVAKER	EIMEVAKER
TSRQFREDDFR	QFRED-DFR
SVEYIHRIGR	EYIHR-IGR
YFFYNKRLK	YFFYNKRLK
EVAIPHNR	EVAIP-HNR
ETVWRLEEFGR	TVWRLEFGR
ELAQVIVSR	ELAQVIVSR
NLHELRVLR	NLHELRVLR
YYKFDYKAHQR	DYKAH--QR
EFLQVPAVTR	EFLQVPVTR
FTSQRDNIFR	TSQRDNIFR
FATDRNDFR	FATDRNDFR
QVNKAPKMR	QVNKAPKMR
HLQDLSGRISR	DLSGR-ISR
EYLQSSGLAQR	EYLQSSAQR
EFIERQHAKNR	EFIERQHAK
SADKIHITR	SADKIHITR
SFTLKPRTI	SFTLKPRTI
NFMLIITHR	NFMLIITHR
EYITLNEPK	EYITLNEPK
MTILQTYFR	MTILQTYFR
DIYNHRFHR	DIYNHRFHR
EFKEMENRR	EFKEMENRR
EYLHHVNKR	EYLHHVNKR
QYLGLDGFVER	LGLDGFVER
SFASKNKKDLR	ASKNKKDLR
FTDLKHAAR	FTDLKHAAR
MDAKSLTAWSR	DAKSLTWSR
NVKVDPEIQ	NVKVDPEIQ
YFAERVTSL	YFAERVTSL
EAKARAEIRAR	EAKARAEIR
TYRNSMFHNR	TYRNSMHNR
NVRETHSLFFR	ETHSL-FFR
VGKDPGLAGR	VGKDPGAGR
EYLHKAVFR	EYLHKAVFR
EILDKKVEK	EILDKKVEK
EMKTSQESLLR	TSQES-LLR
ENYAGIAAR	ENYAGIAAR
ESLKEIQRAR	ESLKEIRAR
EYKPHDIPQR	EYKPHDPQR
QSNSLFNNR	QSNSLFNNR
LYQIITVER	LYQIITVER
DVKPENFLVGR	DVKPENVGR
ELFSRIQER	ELFSRIQER
NVNEVISNR	NVNEVISNR
EYIPEDILKNL	EYIPEDILK
EYLNSILQH	EYLNSILQH
STSKRHWLR	STSKRHWLR
DFDDRRVGR	DFDDRRVGR
HVHEPNPLR	HVHEPNPLR
ELMVPFTR	ELMVP-FTR
DILEKKVEK	DILEKKVEK
DFHFRTDER	DFHFRTDER
ESTATTFLR	ESTATTFLR
EIYFRAWKK	EIYFRAWKK
MYKDGDSVLQR	MYKDGDSVL
EAKLREELR	EAKLREELR
ESLAPLQER	ESLAPLQER
EYTGYAETYR	EYTGYATYR
ESLTKVFER	ESLTKVFER
SYIDIEARTR	SYIDIERTR
TTFTWNINHAR	FTWNINHAR
EVNNELANR	EVNNELANR
DAWEPKVLR	DAWEPKVLR
EYIELHRKR	EYIELHRKR
TYYGSFVTRAL	TYYGSFVTR
DYLPPEMIEGR	DYLPPEEGR
EYISSDGSYAR	ISSDGSYAR
MTLEKNVSVQR	TLEKNVVQR
AVKGYFTLR	AVKGYFTLR
ESMQRFHNRVR	ESMQRFHNR
NYIASVYVR	NYIASVYVR
QPLSPIRNRTP	QPLSPIRNR
HYWVPAKR	HYWVP-AKR
FYQEHPDLARR	FYQEHPLAR
EIAPGIIRKYR	EIAPGIIRK
ATSPALFNR	ATSPALFNR
MSQPIMVQR	MSQPIMVQR
MPWGDPNYR	MPWGDPNYR
EYSEAIPILR	EYSEAIILR
ETLPPFPTR	ETLPPFPTR
EALADEADRAR	EALADEADR
EYLKKVRGK	EYLKKVRGK
EALESLVNR	EALESLVNR
ENNRPLLTR	ENNRPLLTR
DYPPEFHQR	DYPPEFHQR
NVKNVSVKDVR	NVKNVSVKD
EYKDIFIRH	EYKDIFIRH
QARLRDDTELR	RLRDDTELR
EFLSTAPRSLR	EFLST-APR
EVVYRFTAR	EVVYRFTAR
QTMFHHFQR	QTMFHHFQR
TYSGHFTMR	TYSGHFTMR
DFRRAPFAGR	DFRRAPAGR
QYASYEFVQR	YASYEFVQR
ESNLNMYTR	ESNLNMYTR
MTKDNNLLGR	MTKDNNLGR
EIVSRVSKR	EIVSRVSKR
EVLLRAGVSR	EVLLRAVSR
HTRQWLKGLVR	HTRQWLKGL
HLVSRPSTSSR	VSRPSTSSR
FYFKEPSLR	FYFKEPSLR
EVPELYHQR	EVPELYHQR
EIFRPFYR	EIFRP-FYR
EINQITRSR	EINQITRSR
EDKGINVFR	EDKGINVFR
EVSAALQSR	EVSAALQSR
FTRGKSALLER	FTRGKSALL
YSLSPFEQR	YSLSPFEQR
ENLPRTVIR	ENLPRTVIR
ESSAGGSFTVR	SAGGSFTVR
MFMEPAKRMK	MFMEP-AKR
ENISDDVIVGR	ISDDVIVGR
EILRRLTGR	EILRRLTGR
ELSSADEKRYR	SSADEKRYR
TYKAIEKILR	TYKAIEILR
NYLNQHVNR	NYLNQHVNR
TVTEKPEVIDA	TVTEKPEVI
FKQYANDNGVD	QYANDNGVD
EYMEKIKQR	EYMEKIKQR
TVKDLRLVTNR	TVKDLRTNR
NTMMRKAIR	NTMMRKAIR
EAMTVAIRR	EAMTVAIRR
NSKSHLLVHQR	NSKSHLHQR
EFYINYVTR	EFYINYVTR
DTKVVSMVGR	DTKVVSVGR
EIYGVTHTR	EIYGVTHTR
DTKGHSLSVQR	DTKGHSVQR
YYIVLITKR	YYIVLITKR
EWQKRYASR	EWQKRYASR
DIKPLTSFRQR	DIKPLTSFR
FSMGNEVLQNR	MGNEVLQNR
TDTYKLILNGK	TYKLILNGK
DISNVKIPK	DISNVKIPK
EAMALPLYR	EAMALPLYR
LVQEKIQKR	LVQEKIQKR
ETMVIGNYR	ETMVIGNYR
ELLEPLNER	ELLEPLNER
YYMGDLIQHR	YYMGDLQHR
NIKNSSVPR	NIKNSSVPR
EFEAVLTER	EFEAVLTER
ETMNYAQIR	ETMNYAQIR
ETNMYEGVGR	ETNMYEVGR
EYDEKLARFR	EYDEKLRFR
QNSPIYISR	QNSPIYISR
EYAKVDLAKR	EYAKVDAKR
EYLILSDVQR	EYLILSVQR
EYVSSLSKK	EYVSSLSKK
EYVFKFIVR	EYVFKFIVR
ESLIPSVGR	ESLIPSVGR
ENDRPYNLR	ENDRPYNLR
SAKEVLSAR	SAKEVLSAR
EVLAELRKR	EVLAELRKR
LAAEPKVNR	LAAEPKVNR
EVINDYHFR	EVINDYHFR
EVFHVPEGR	EVFHVPEGR
ELFGRVTSR	ELFGRVTSR
SFETFINKR	SFETFINKR
EFFIPRVGR	EFFIPRVGR
EVKEELSAVER	EVKEELVER
TVTEKPEVID	TVTEKPEVI
EIYDRREYSR	EIYDRRYSR
YSLGSIYTR	YSLGSIYTR
HNLNIMIKR	HNLNIMIKR
DAVKPGVRYR	AVKPGVRYR
DSKPQDRHFVR	KPQDRHFVR
DYFHNGNPR	DYFHNGNPR
LNAESRVNR	LNAESRVNR
FSVHRIIGR	FSVHRIIGR
ETSSMASFR	ETSSMASFR
SSIRPISER	SSIRPISER
QALERVFER	QALERVFER
DLKRPFLSR	DLKRPFLSR
EVQRILHQR	EVQRILHQR
HNTMPSQFR	HNTMPSQFR
EVAELTRLR	EVAELTRLR
EFRDKRIAKR	EFRDKRAKR
YFKKKFAER	YFKKKFAER
STQLTIHQR	STQLTIHQR
EYNWNVKNK	EYNWNVKNK
EYKPHSIPLR	EYKPHSPLR
DAQEILHSR	DAQEILHSR
ETMPSPYGR	ETMPSPYGR
EYVGPRLSR	EYVGPRLSR
EAGGPLTPR	EAGGPLTPR
DYSKPSAKR	DYSKPSAKR
EVTRVKAVR	EVTRVKAVR
EVEEYKNFR	EVEEYKNFR
STYYGSFVTR	TYYGSFVTR
QYLVGDKRQPR	LVGDKRQPR
EILTNEESRAR	EILTNEESR
HAREIFDSR	HAREIFDSR
EYFPTKNRQR	EYFPTKRQR
ETHLPAQAR	ETHLPAQAR
EAMKLGAVKR	EAMKLGVKR
EAVAEKMLQYR	AVAEKMQYR
EFSALKTQR	EFSALKTQR
TMKDFVRRR	TMKDFVRRR
EVKPFITNPR	EVKPFINPR
TYYGSFVTR	TYYGSFVTR
EVHPSPVSR	EVHPSPVSR
MFRIEGLAPK	MFRIEGAPK
QYIRPVFVSR	QYIRPVVSR
EFRNFKIIYR	EFRNFKIYR
SFKDYIQER	SFKDYIQER
NSNLVIHQR	NSNLVIHQR
ESVPPGTTISR	SVPPGTISR
WYLGTIKKR	WYLGTIKKR
EVNIPTDLR	EVNIPTDLR
DIYLRMTGR	DIYLRMTGR
DFKKYVENR	DFKKYVENR
EALYIADRKAR	LYIADRKAR
EALPHVVPTLR	EALPHVTLR
EYAPVFKEK	EYAPVFKEK
ESLPPPTLR	ESLPPPTLR
NGRPLEMIEPR	EMIEP---R
TYISAIRER	TYISAIRER
EAIARYQGR	EAIARYQGR
EFISGTRMR	EFISGTRMR
SMISNMNASR	SMISNMASR
TSTVPLVGR	TSTVPLVGR
ETALPGAFKTR	ETALPGAFK
MTFTRPANHR	TFTRPANHR
EYESKSLEELR	ESKSLEELR
MTGLPHNR	MTGLP-HNR
DYFAKREQWKK	FAKREQWKK
QAWSLPTQR	QAWSLPTQR
MNYEGPGMAR	NYEGPGMAR
ETLIPHYSGR	ETLIPHSGR
FANLPNQVYR	FANLPNVYR
ESRAVFLQR	ESRAVFLQR
DIFQNLSKRQR	DIFQNLSKR
FTWNINHAR	FTWNINHAR
TTKPAIIFR	TTKPAIIFR
TVMRLIEKR	TVMRLIEKR
ELNSPLVRR	ELNSPLVRR
EVIAYILER	EVIAYILER
EFLNRFEEAKR	EFLNRFEAK
DLKKPIYQR	DLKKPIYQR
EAAAVLMAR	EAAAVLMAR
FSKDNESLISR	DNESL-ISR
YYNKYINVK	YYNKYINVK
SVRPGVVVPR	SVRPGVVPR
MAYVPVSR	MAYVP-VSR
EVFLHVVKR	EVFLHVVKR
EYEPEMGKVYR	EYEPEMVYR
SYAELLTHR	SYAELLTHR
EYATKTRIGIR	ATKTRIGIR
SIPGGYNAL	SIPGGYNAL
EYAALLTKHTR	EYAALLTKH
ETAGRTPKLAR	ETAGRTLAR
EYAEYIYQR	EYAEYIYQR
SYLAQFAAR	SYLAQFAAR
EVDYKKKYR	EVDYKKKYR
FVQNPNNNR	FVQNPNNNR
DYVPYVPLRQR	DYVPYVPLR
ESFPSVNSR	ESFPSVNSR
TVAAVFRGR	TVAAVFRGR
EPRSPVITR	EPRSPVITR
SLKDPSNNFR	SLKDPSNFR
FVKDNVTKR	FVKDNVTKR
DYIKVFKPK	DYIKVFKPK
ETLKHSGIGR	ETLKHSIGR
TFEVLRKVGK	EVLRK-VGK
LQIDNARLA	LQIDNARLA
DAQKPSLTR	DAQKPSLTR
YALDPSFPR	YALDPSFPR
EVRPGIVSK	EVRPGIVSK
EILHKIVKYR	EILHKIKYR
SGPSIVHR	SGPSI-VHR
DYIHIRIQQR	DYIHIRQQR
SVLDYFSER	SVLDYFSER
EALEMSRNR	EALEMSRNR
EINKLLAHR	EINKLLAHR
EYAKLLAKRM	EYAKLLAKR
EFLKLDRER	EFLKLDRER
ETAKPIPAR	ETAKPIPAR
EILKRNIQR	EILKRNIQR
EYSEYMNNK	EYSEYMNNK
EYLKNIIYR	EYLKNIIYR
EVRNLRKINR	EVRNLRINR
STLAQLKQR	STLAQLKQR
TYLTKFIAR	TYLTKFIAR
EARDIPVLRPR	EARDIPVLR
NYLHERGIIYR	YLHERGIYR
DYYARVEGR	DYYARVEGR
YFLGQSVLR	YFLGQSVLR
EVLKLLVAR	EVLKLLVAR
ESLQAILNR	ESLQAILNR
EIRNLTVKDFR	EIRNLTVKD
SFKDFAKSK	SFKDFAKSK
YYSLLTAPR	YYSLLTAPR
EAANRNNDALR	EAANRNALR
STKSISFTR	STKSISFTR
EYNVRVASR	EYNVRVASR
DSMPEPASR	DSMPEPASR
EAAVEDLHHYR	AVEDLHHYR
EFKEVPERGR	EFKEVPRGR
EALSSVIKELR	EALSSVELR
YYADNWKDHLR	YADNWKHLR
TVGGWVSTR	TVGGWVSTR
DTYLHRVAR	DTYLHRVAR
ETQLPVSFR	ETQLPVSFR
DYYSLLNVR	DYYSLLNVR
DSKGVYDVR	DSKGVYDVR
EVAQLIQGGR	EVAQLIGGR
DYNNIGKFLNR	NNIGKFLNR
SVMDQEMRVKR	MDQEMRVKR
SYTAAVANR	SYTAAVANR
EEQLQQIR	EEQLQ-QIR
FLNAPEANR	FLNAPEANR
EFQVIMGRKR	EFQVIMRKR
SNDIPHVVR	SNDIPHVVR
ETQVKTWFQNR	QVKTWFQNR
EALKLARQI	EALKLARQI
ENREAVTHIGR	EAVTH-IGR
EIYEKDEKIQK	YEKDEKIQK
EAFKPKIGK	EAFKPKIGK
EGRPTIEVRR	EGRPTIVRR
EVNSRPTYR	EVNSRPTYR
DFKNVLSNR	DFKNVLSNR
EVFKEFIYR	EVFKEFIYR
EVQGDRMHLR	EVQGDRHLR
TSWVPLVSR	TSWVPLVSR
ESLIPSANR	ESLIPSANR
DYHLMPERR	DYHLMPERR
EAVLKEKRSLR	VLKEKRSLR
EVRVANELNAR	RVANELNAR
LSNRPIMFR	LSNRPIMFR
DYREKVESELR	DYREKVSEL
EVRGSNGAFYK	EVRGSNAFY
ETAFLSWFR	ETAFLSWFR
ETIGKKFEKR	ETIGKKEKR
AQYEDIAQK	AQYEDIAQK
TVLGYFIGR	TVLGYFIGR
YTAMPLPIGR	TAMPLPIGR
EIRKPEVLR	EIRKPEVLR
NNQSFYSNR	NNQSFYSNR
EVNIPNRR	EVNIP-NRR
EYMKPHVR	EYMKP-HVR
QYQNITVHR	QYQNITVHR
EYVEHTVKER	EYVEHTKER
EYSYVKSTK	EYSYVKSTK
ETREVQNLR	ETREVQNLR
MVADVFSHR	MVADVFSHR
DFIAKVVQR	DFIAKVVQR
YYTPITPHLR	YYTPITHLR
EAIQKSVTR	EAIQKSVTR
FYSQEWYAR	FYSQEWYAR
EARPALLTSR	EARPALTSR
TYILRPVFQQR	YILRPVQQR
VAPVASAL	VAPVA-SAL
EVYDQLFKSR	EVYDQLKSR
DYVRYRLPLR	YVRYRLPLR
EYLQRYHIIHR	EYLQRYIHR
EVTGFGVTR	EVTGFGVTR
ESAQDFASR	ESAQDFASR
DYKDQLKTGER	DYKDQLGER
ESQSPDTTIQR	QSPDTTIQR
EYKKEQAINR	EYKKEQINR
SNFKRFHGR	SNFKRFHGR
SFEKVPVGR	SFEKVPVGR
EFMQRALQDLR	EFMQRADLR
EVMEKLVKR	EVMEKLVKR
EVYTRLKSR	EVYTRLKSR
TVATLPRGR	TVATLPRGR
DVYTPKSSR	DVYTPKSSR
MAHHPTFR	MAHHP-TFR
AGLQFPVGR	AGLQFPVGR
QAHAITVTR	QAHAITVTR
EYMEHVYLIHR	EYMEHVIHR
YSHESLYHR	YSHESLYHR
TFYSISQER	TFYSISQER
EIMPPPPKP	EIMPPPPKP
ETRSSFMSR	ETRSSFMSR
EGKDFSIHR	EGKDFSIHR
AAPGVDLT	AAPGV-DLT
EAIPILPAQQR	EAIPILQQR
EFIQEPAKNR	EFIQEPKNR
EYLEFRRER	EYLEFRRER
EYVHTKNFIHR	YVHTKNIHR
NAPWAVTSL	NAPWAVTSL
ESRLNLVQR	ESRLNLVQR
IVKPPASAR	IVKPPASAR
EMFVGVGASR	EMFVGVASR
DMHSLVRSR	DMHSLVRSR
NYVNKIKNR	NYVNKIKNR
MTMDEDYQQKR	TMDEDYQKR
EARAFGVTR	EARAFGVTR
SYQEQIIVGR	SYQEQIVGR
EYRKYIHSR	EYRKYIHSR
TYGEVFKAR	TYGEVFKAR
EAKGLDRINER	EAKGLDNER
EYLNHVSKR	EYLNHVSKR
MFSGTHVER	MFSGTHVER
LYQEVFGRLR	LYQEVFRLR
YYYDKNIIHK	YYYDKNIHK
EANIFTKQR	EANIFTKQR
DSLGQDLRRLR	DSLGQDLRR
EAFPRARLSER	EAFPRASER
EINAILQKR	EINAILQKR
YPYSPPTFR	YPYSPPTFR
EVNDKRYLR	EVNDKRYLR
HTKDNLQSVTR	DNLQS-VTR
EVLLPSGQR	EVLLPSGQR
ELQEIMRRR	ELQEIMRRR
ELKQLAAAR	ELKQLAAAR
NALNVPLHNR	NALNVPHNR
EVKRHPFFR	EVKRHPFFR
VRTTFTTEQLH	TTFTTEQLH
EYVDRLSKR	EYVDRLSKR
ETQNMAWSKPR	ETQNMAWSK
EVLYAPRRLR	EVLYAPRLR
EFLIKKKAN	EFLIKKKAN
MYRNEFTAWYR	EFTAW--YR
ETLPKAVKR	ETLPKAVKR
KADPPLPAR	KADPPLPAR
EYVDATNLTPR	EYVDATTPR
STLTASEIRQR	LTASEIRQR
EAVRPGVLRSR	EAVRPGVLR
ETQPPVALK	ETQPPVALK
YVQELKQER	YVQELKQER
EALSALTARL	EALSALTAR
TMLAYSLTYR	TMLAYSTYR
EVTPAMQIPR	EVTPAMIPR
MTNLPAVGR	MTNLPAVGR
NLKPPQAKR	NLKPPQAKR
EYAEFQYRRR	EYAEFQYRR
EYVPETVYR	EYVPETVYR
DTHGSFVVR	DTHGSFVVR
HTQDFLEWRRR	HTQDFLWRR
HNMGIVHR	HNMGI-VHR
EGNSFNSPR	EGNSFNSPR
DYLQFAYYR	DYLQFAYYR
EFLGHRIVR	EFLGHRIVR
SVNSHIYQR	SVNSHIYQR
DTRPHYITR	DTRPHYITR
NYGIPPVNR	NYGIPPVNR
ITNNIDPVGR	TNNIDPVGR
EVAIPLPAR	EVAIPLPAR
HYLGEFSITYK	YLGEFSTYK
DYFLNNKHVGR	FLNNKHVGR
QYLHENGIIHR	YLHENGIHR
EMKPVLKQR	EMKPVLKQR
SNKLHFAFR	SNKLHFAFR
DIRPEIHENYR	DIRPEINYR
EVDAAMAAR	EVDAAMAAR
VVKDITNAFR	VVKDITAFR
ELASIKNRQR	ELASIKRQR
DYVVGARTFR	DYVVGATFR
EFEERRSLR	EFEERRSLR
FYVGEIIGKR	YVGEIIGKR
IFYTAIVNR	IFYTAIVNR
DSFTGPRRR	DSFTGPRRR
QAFEREVGR	QAFEREVGR
EIKDFLLTAR	EIKDFLTAR
ETAGRYITYR	ETAGRYTYR
QVQQPSVAQLR	QVQQPSAQL
ELFADKVPK	ELFADKVPK
ETRQITWSR	ETRQITWSR
SVTPEGVIKQR	VTPEGVKQR
EAVQALRER	EAVQALRER
EYFTLQIRGR	EYFTLQRGR
EQNHLVVAR	EQNHLVVAR
NAKALSTLR	NAKALSTLR
EYIDFEKIR	EYIDFEKIR
EAQAKVDVFR	EAQAKVVFR
ELMDLGKVRR	ELMDLGVRR
EVLSKALSQR	EVLSKASQR
ELMPPPPPK	ELMPPPPPK
DIEERPKELVR	EERPKELVR
FSKDNNSIITR	DNNSI-ITR
DFSHPQMPK	DFSHPQMPK
EATGGKYVPR	EATGGKVPR
FEINPLDETV	EINPLDETV
LVKDSTGMLGR	DSTGM-LGR
EYYKHPISR	EYYKHPISR
SFELKIVRR	SFELKIVRR
DSRFPNQNQTR	DSRFPNQTR
NSADKIHITR	NSADKIITR
EANVPVYR	EANVP-VYR
DYSQNVAVR	DYSQNVAVR
HSTPYYYAR	HSTPYYYAR
TYKNSEELR	TYKNSEELR
TIIEVNGKRVR	EVNGK-RVR
EMATRAALQAR	ATRAALQAR
DTQIPTSR	DTQIP-TSR
ISKEVLAGR	ISKEVLAGR
ITKNNDLVRKR	KNNDLVRKR
DFLDRNTPVFR	DFLDRNVFR
EFFSINAQR	EFFSINAQR
ETQSRTITVTR	QSRTITVTR
DVKFGADAR	DVKFGADAR
NVLTESARIAR	LTESARIAR
EVAIPHNRR	EVAIPHNRR
EANEEFALR	EANEEFALR
AELGPASPRR	ELGPASPRR
MNFNPIISR	MNFNPIISR
YVRPSPAKR	YVRPSPAKR
FYQEEFYIR	FYQEEFYIR
AVLDLQLRSA	AVLDL-QLR
EYLEKIKQRL	EYLEKIKQR
EIKKPPVSER	EIKKPPSER
EIKSQFRTR	EIKSQFRTR
FFGERRIPR	FFGERRIPR
ENNRPLLTRF	ENNRPLLTR
EVFYFEVTR	EVFYFEVTR
TYRVFKTVNR	TYRVFKVNR
QNYLPRHR	QNYLP-RHR
IGGIGTVPVGR	GIGTVPVGR
ETILKHWTR	ETILKHWTR
HTKAVNVVRF	HTKAVNVVR
HTKAVNVVR	HTKAVNVVR
ELADHLVKR	ELADHLVKR
FIKKRVGTHIR	FIKKRVGTH
EYNPEHVSR	EYNPEHVSR
DTKELEKMTNR	DTKELETNR
DATSRNITEAR	TSRNITEAR
HLKEIISYR	HLKEIISYR
YYRPPRPPK	YYRPPRPPK
QHAALPPPPSP	HAALPPPPS
ETYMHRIGR	ETYMHRIGR
EIISHDTRRFR	EIISHDTRR
TAASEEARSLR	AASEEASLR
YNHSGFGQGR	YNHSGFQGR
TNYGIPQRALR	NYGIPQALR
ETLQNVKER	ETLQNVKER
ESSKPPILR	ESSKPPILR
EYLQNVEQKKR	EYLQNVEQK
ELQLLNTDYLR	QLLNTDYLR
TVKATGPALR	TVKATGALR
HSLPPIARR	HSLPPIARR
DTKNIAFER	DTKNIAFER
EYVGPRLSRR	EYVGPRLSR
EVTKLVHGR	EVTKLVHGR
ENYIHRIGR	ENYIHRIGR
MVQGPVITTR	MVQGPVTTR
EARPFRGSVGR	EARPFRVGR
TVQQLEGRWR	TVQQL-EGR
EATKYFRER	EATKYFRER
EYYPGFNPFR	EYYPGFPFR
TVQKETIHPR	TVQKETHPR
EVNERHQILR	EVNERHILR
TTEVPPPPR	TTEVPPPPR
EYIEEVRAKK	EYIEEVRAK
ETKSQFEKFVR	ETKSQFFVR
EFLAHARGR	EFLAHARGR
EYLIKTGSER	EYLIKTSER
DSSNFITHR	DSSNFITHR
EAMRRLQER	EAMRRLQER
EFLAKGKRFR	EFLAKGRFR
MTLNPSTKR	MTLNPSTKR
SFRYNGLIHR	SFRYNGIHR
ETFADGVPR	ETFADGVPR
ESLTALLKNR	ESLTALKNR
EGKDQELAKLR	EGKDQELAK
TLEKNLRQMGR	EKNLRQMGR
NALQRAVER	NALQRAVER
MSKDPTTQKLR	MSKDPTTQK
EMQAKVAVR	EMQAKVAVR
TSKLYSLLFRR	TSKLYSLFR
QTLTKQDTMLK	LTKQDTMLK
EFVEHLISR	EFVEHLISR
NIKDIKVNR	NIKDIKVNR
TFTVGLVFLK	FTVGLVFLK
EYLEKKNFIHR	EYLEKKIHR
SVKEVALGR	SVKEVALGR
EIKDFLLTARR	EIKDFLTAR
TYYEGGYFKAR	YYEGGYKAR
YALPHAILR	YALPHAILR
DIKPENILVDR	DIKPENVDR
FTLKPKKR	FTLKP-KKR
ENKISPYYR	ENKISPYYR
ETFDFQAMGR	ETFDFQMGR
EARTLQEPVAR	RTLQEPVAR
ELIDYKQKATR	DYKQK-ATR
EVARELVGR	EVARELVGR
ETLPPFPTRL	ETLPPFPTR
ESFGPQPISR	ESFGPQISR
EVGPGPGGITR	EVGPGPITR
ETIPLGDLQAR	ETIPLGQAR
TYKENFLKR	TYKENFLKR
EIEKFDKSKLK	EIEKFDKSK
ESLEWLASR	ESLEWLASR
DFTVADTRRYR	TVADTRRYR
ENTAITIGR	ENTAITIGR
SYIKLQTNR	SYIKLQTNR
EVAQVESLRYR	EVAQVESLR
YFIDKLALR	YFIDKLALR
EMRQMFVQR	EMRQMFVQR
MVQKPGFGVGR	MVQKPGVGR
ETFGHFGSLGR	ETFGHFGSL
EVITEAEKIAK	EVITE-AEK
ESQERIKAER	ESQERIAER
DYVPSTTKTPR	YVPSTTTPR
NVRNGYGFINR	NVRNGYINR
SYFSFSRNR	SYFSFSRNR
EVNSGFFYK	EVNSGFFYK
QYLDPAQRGVR	QYLDP-AQR
EFDDRRGVLR	EFDDRRVLR
MVVPAALKVVR	VVPAALVVR
QNSSIRVPR	QNSSIRVPR
ESRDMDLNYR	ESRDMDNYR
EVNGKLRMLMR	EVNGKLRML
VLYDRQGIGR	VLYDRQIGR
EVVRLLVTR	EVVRLLVTR
IVNENLVER	IVNENLVER
DTAAWTVGR	DTAAWTVGR
EYNDRNKLNTR	EYNDRNNTR
EILEVLRHPR	EILEVLHPR
QTALRNFQHRR	TALRNFQHR
EALLPQNR	EALLP-QNR
MTQDAQNALR	MTQDAQALR
ESKDTSLETRR	ESKDTSETR
EVAPPEYHRK	EVAPPEYHR
EYNEGLVKRL	EYNEGLVKR
EVRAVGQGVLR	EVRAVGVLR
EYWDRQRNR	EYWDRQRNR
EFLDIMKRNR	EFLDIMRNR
EVLQPLQQR	EVLQPLQQR
EFKPTYQDR	EFKPTYQDR
FSNLPPEQR	FSNLPPEQR
SSLDRLYSR	SSLDRLYSR
SYIDEQFER	SYIDEQFER
ETKRIFLDR	ETKRIFLDR
DMNEPSVFR	DMNEPSVFR
EVLRLPKQQLR	EVLRLPQQL
EALKDFEKR	EALKDFEKR
ETHFPFAIR	ETHFPFAIR
EAQFQKNVR	EAQFQKNVR
NYTDRIQVLR	NYTDRIVLR
TTRPTWMPR	TTRPTWMPR
HANGLTLVSR	HANGLTVSR
DVKPSNVLINK	DVKPSNVLI
EMKKKINLELR	EMKKKIELR
IYQYMEEIYHR	QYMEEIYHR
EIKERIAKR	EIKERIAKR
NFKEENMDTSR	ENMDT--SR
EVARLTQER	EVARLTQER
LYRHFDETVNR	HFDET-VNR
ETLMETHER	ETLMETHER
ESQDRKIFR	ESQDRKIFR
STNPFRPQK	STNPFRPQK
EVQPPRVDR	EVQPPRVDR
AYIHEKGMIHR	YIHEKGIHR
EYLAQLSNNVR	EYLAQLSNN
VFIYRGKEYER	IYRGKEYER
ETVPKDLRHLR	TVPKDLHLR
ESLNFLIGR	ESLNFLIGR
EMLHQIIQR	EMLHQIIQR
FTKKSNSGFLR	TKKSNSFLR
EYIHDFNRRH	EYIHDFNRR
DIKSYYTVR	DIKSYYTVR
EVLPDRVATSR	EVLPDRTSR
HTRTPPIIHR	HTRTPPIHR
NTMDADSLVSR	MDADSLVSR
EYNISPETR	EYNISPETR
DVKNAGDLR	DVKNAGDLR
EFQEVSKESKR	EFQEVSESK
LNYVPFAER	LNYVPFAER
EVKKFVKIGR	EVKKFVIGR
DNFPFDPPFVR	FPFDPPFVR
YSFHRGNSQR	SFHRGNSQR
EFKTLEGVITR	KTLEGVITR
DFNNRLNNR	DFNNRLNNR
YYTDYVATR	YYTDYVATR
NTILRHLGR	NTILRHLGR
EYIEEVRAKKK	EYIEEVRAK
QTFENQVNR	QTFENQVNR
EVEPQGVIVTR	EPQGVIVTR
IYLPPEASSQR	YLPPEASQR
EAMKHVYFR	EAMKHVYFR
TSKTYVISR	TSKTYVISR
EVKRLKVTELR	EVKRLKTEL
YAKDIGFIK	YAKDIGFIK
YSWDIVVQR	YSWDIVVQR
HAQSIGMNR	HAQSIGMNR
MVKFGGSGR	MVKFGGSGR
EYLKALRKK	EYLKALRKK
EFYEVVQSQR	EFYEVVSQR
EYTEGISQR	EYTEGISQR
EAWRRVWSR	EAWRRVWSR
DMFPGPYPR	DMFPGPYPR
EVAFPHHPR	EVAFPHHPR
EMIREGKIAGR	MIREGKAGR
EVKKIIKEDPR	EVKKIIKED
SVPEAQSAL	SVPEAQSAL
EVRSQLKLR	EVRSQLKLR
GGPGGVGGL	GGPGGVGGL
IVRPPESGLGR	IVRPPESGL
EFQQLPYHR	EFQQLPYHR
EFREEAYHSR	EFREEAHSR
SVKSITNPR	SVKSITNPR
EVVDMQKRLHR	EVVDM-QKR
EAVKLIIGR	EAVKLIIGR
EVKPNLTER	EVKPNLTER
HAAEYGAEALE	HAAEYGAEA
EYIKDEQKNLK	EYIKDEKNL
SMLEYFINR	SMLEYFINR
ETLNIVLVGR	ETLNIVVGR
DYPDYKYRPR	DYPDYKRPR
YYYYHRQYR	YYYYHRQYR
EVIKSMKPK	EVIKSMKPK
LVKPVTINVGR	LVKPVTVGR
EMLSSVALINR	MLSSVAINR
EFRAGMSNR	EFRAGMSNR
MAPERVASL	MAPERVASL
TSNMPVAAR	TSNMPVAAR
EFQPFLKKWYR	EFQPFLWYR
ETATTPIFANR	TATTPIANR
EIRDDHTLKIR	EIRDDHTLK
LPQGHFQER	LPQGHFQER
NTGNWMHIR	NTGNWMHIR
EYWRRREEEER	EYWRRREER
DYLHAKSIIHR	HAKSI-IHR
EALTQAFRR	EALTQAFRR
AYIERKNYIHR	YIERKNIHR
EVKDHKFIAR	EVKDHKIAR
TFRNPDDVFR	TFRNPDVFR
EVMPGPIGLPR	EVMPGPIGL
DYLMKILTER	DYLMKITER
ELHKMWENR	ELHKMWENR
EVQDLHLAQR	EVQDLHAQR
DVKPENFLIGR	DVKPENIGR
EVKEAIITR	EVKEAIITR
EYRASLQQR	EYRASLQQR
EIQQAGERLR	EIQQAGRLR
AYVPFGAGRHR	AYVPFGAGR
EAFEHPNVVR	EAFEHPVVR
HSFRPAYR	HSFRP-AYR
ETLGPKPAAR	ETLGPKAAR
QYGPQGNYSR	QYGPQGYSR
EILDLSNDYAR	EILDLSYAR
DFLQKRKER	DFLQKRKER
EFKSLIEGK	EFKSLIEGK
LAHVGPRLR	LAHVGPRLR
EFRKDFISR	EFRKDFISR
TYLDIPLVIR	TYLDIPVIR
DLKETDIKHLR	ETDIK-HLR
ETESLLVGR	ETESLLVGR
TTLDESLTNR	TTLDESTNR
ESLDFTDYASR	ESLDFTASR
ETVGTGIMGR	ETVGTGMGR
AYKNVIGAR	AYKNVIGAR
SNTIPVKTR	SNTIPVKTR
EVRLGGSLR	EVRLGGSLR
DAWRFWHKR	DAWRFWHKR
DYMTPEQRRSR	DYMTPEQRR
ELKKVVTGR	ELKKVVTGR
EVISWGSGR	EVISWGSGR
TTFGPKSQR	TTFGPKSQR
HVAESSLSRLR	HVAESSLSR
EYMEKIKQRL	EYMEKIKQR
TVKELKEKFLR	ELKEK-FLR
TYLATFHQR	TYLATFHQR
ETLVMPTLR	ETLVMPTLR
EALQKKFNK	EALQKKFNK
DYREPFFRK	DYREPFFRK
VTQAPISAR	VTQAPISAR
EYIGLDSGRIR	EYIGLDSGR
ESKMAFLTR	ESKMAFLTR
DVRPFAPKER	DVRPFAKER
TFGKVKVGK	TFGKVKVGK
EFFGEGKTR	EFFGEGKTR
ETRPEGSYFSK	ETRPEGSYF
TTLTKIALR	TTLTKIALR
TTKMSLNER	TTKMSLNER
EIMRKDLNDAR	IMRKDLDAR
EVKNYDAALR	EVKNYDALR
NYSQHVYYR	NYSQHVYYR
TAYRPPALR	TAYRPPALR
DVARHFIQR	DVARHFIQR
EFLEQHYDR	EFLEQHYDR
ESLVIPSTR	ESLVIPSTR
EYRIQGEVETR	RIQGEVETR
DYNLIVIER	DYNLIVIER
EAKRPPGFDR	EAKRPPFDR
DYKTIAKER	DYKTIAKER
DWVPYINGKFK	DWVPYINGK
NVQVHFTER	NVQVHFTER
EATAMAMGR	EATAMAMGR
VYKNVRPAEVR	NVRPA-EVR
EYVHRIGRTGR	EYVHR-IGR
ELISKAQSNR	ELISKASNR
EARPSIMKR	EARPSIMKR
AVREVLHGNQR	EVLHG-NQR
LYRKMEIYR	LYRKMEIYR
MAMLVTQAR	MAMLVTQAR
ELNAREDYVKR	NAREDYVKR
FTLSALYAR	FTLSALYAR
FTQQGPRLR	FTQQGPRLR
SYIDRLAPR	SYIDRLAPR
TNAENEFVTIK	NAENEFTIK
NYNFRGMYNQR	NFRGMYNQR
EALRGLYGR	EALRGLYGR
SAFVPSSGR	SAFVPSSGR
ELARLKVHR	ELARLKVHR
ETYKYLYGR	ETYKYLYGR
EFQDFTVPRKR	EFQDFTVPR
EFQTSVVSR	EFQTSVVSR
TAFDRDRAMQR	FDRDRAMQR
ELYSKVTPR	ELYSKVTPR
FSKLPEAER	FSKLPEAER
EVQKRKQLELR	EVQKRKELR
MTKSGYQPPR	MTKSGYPPR
EVRQIASIVQR	EVRQIAVQR
EFKKNTPEDLR	EFKKNTDLR
ETLSRHIGVTR	ETLSRHVTR
ETKKLLDIVAR	ETKKLLVAR
ESFPRGGTR	ESFPRGGTR
EYAAKFIKK	EYAAKFIKK
ETLLEISKRFR	ETLLEISKR
EYIWENSSSER	YIWENSSER
ELLPKEKFVSR	ELLPKEVSR
YYLDPSSQKR	YYLDPSQKR
EQQPSVTSR	EQQPSVTSR
ELMDKPLTFR	ELMDKPTFR
DIYDRKNMPR	DIYDRKMPR
EGLPEGIPFRR	EGLPEGPFR
ESIRAAVNR	ESIRAAVNR
ETMEPALR	ETMEP-ALR
EVSAEVRER	EVSAEVRER
EVLLVSSSR	EVLLVSSSR
EILDSQNLNSR	EILDSQNSR
EYNEGLVKR	EYNEGLVKR
YFDNLLSQR	YFDNLLSQR
EAYHRVFVNR	EAYHRVVNR
EMRNAQSIGR	EMRNAQIGR
EAQQRRLLGR	EAQQRRLGR
ETFKIINR	ETFKI-INR
ETYGPFQIR	ETYGPFQIR
DYLEFQKNR	DYLEFQKNR
LYKESVDTHQR	ESVDT-HQR
EFNPNFVAR	EFNPNFVAR
EVYDGPKNVR	EVYDGPNVR
DFAPEVAWVTR	FAPEVAVTR
DALGGLLNR	DALGGLLNR
SARELFAAR	SARELFAAR
QVMFRNYQR	QVMFRNYQR
NVKDKPTVER	NVKDKPVER
ESRAPQILR	ESRAPQILR
EYLEKIKQR	EYLEKIKQR
DYLNAESRVNR	YLNAESVNR
AYKNVVGAR	AYKNVVGAR
MFKTANKVTR	MFKTANVTR
MFRAAAPGQLR	RAAAPGQLR
DAQTLDAIRHR	QTLDAIRHR
EYVSRMKETQK	EYVSRMKET
ESLPRVVKR	ESLPRVVKR
EYFQNGGKR	EYFQNGGKR
TFKRPEGMHR	TFKRPEMHR
SVVAVPLPLHR	VAVPLPLHR
EALQKTRIELR	EALQKTIEL
DYLVPPALR	DYLVPPALR
EVNIPRKR	EVNIP-RKR
FVQYVNERNAR	QYVNERNAR
EVVNYVQKR	EVVNYVQKR
EFQIPGRTR	EFQIPGRTR
DYAKLGAAR	DYAKLGAAR
ETYQKLNQEK	ETYQKLQEK
YVSPRAPFYR	YVSPRAFYR
EVMQRMEVQR	EVMQRMVQR
EYIHSKNFIHR	EYIHSKIHR
DMQRIHLR	DMQRI-HLR
NYKSEVNSKPR	NYKSEVNSK
SFFSPSPARKR	SFFSPSPAR
EFNAEVHRK	EFNAEVHRK
MALGFAWKR	MALGFAWKR
EYLQKMVQR	EYLQKMVQR
SVKEISDIVQR	EISDI-VQR
TYYPPPRLR	TYYPPPRLR
HAKDGIFRR	HAKDGIFRR
HTAPQVLFSHR	TAPQVLSHR
HSVIPPAAR	HSVIPPAAR
FNLNITWA	FNLNI-TWA
EIKEVHIEK	EIKEVHIEK
QNPDITSSRYR	QNPDITSSR
ESKEFNAEVHR	EFNAE-VHR
SYKARLPLR	SYKARLPLR
FSDYPPLGR	FSDYPPLGR
ELNKIPTVR	ELNKIPTVR
ETKEWLKNR	ETKEWLKNR
DFKRYVTDR	DFKRYVTDR
DYYKILGVKR	DYYKILVKR
YTDKIKYPR	YTDKIKYPR
TFKPVSSVKER	TFKPVSSVK
YAAFVQTHR	YAAFVQTHR
HFIELDENRQR	HFIELDENR
EARAGVLAER	EARAGVAER
EVQDRVMLTGR	EVQDRVTGR
TTLGERAFMNR	TLGERAMNR
MSKPSIAKR	MSKPSIAKR
NVKGPGLQR	NVKGPGLQR
DFALIHKER	DFALIHKER
ETFNREKFR	ETFNREKFR
SVKELDSKTIR	ELDSK-TIR
ITKEPSFISKR	ITKEPSISK
NLYFHDVGR	NLYFHDVGR
SSNLIVHQR	SSNLIVHQR
VVAPPGVVVSR	VAPPGVVSR
TVRDHLVGR	TVRDHLVGR
STKPGSYIFR	STKPGSIFR
DAVARLVAR	DAVARLVAR
ETIKVWKQR	ETIKVWKQR
ITKPDGIVEER	TKPDGIEER
ESQPAIWNR	ESQPAIWNR
EVRTHYDPPR	EVRTHYPPR
EALVPVIHR	EALVPVIHR
DLKPQNLLINR	DLKPQNINR
EAQEVTIAR	EAQEVTIAR
EYVHTKSLIYR	YVHTKSIYR
DVLSHFAQR	DVLSHFAQR
EIQHTTALR	EIQHTTALR
QTQSIYIPR	QTQSIYIPR
DTFRPTAR	DTFRP-TAR
YVKEISEKTER	EISEK-TER
STVARIQFR	STVARIQFR
QVKALGTER	QVKALGTER
ETTSIATAR	ETTSIATAR
ETIKLLKGR	ETIKLLKGR
SMRDHIDYR	SMRDHIDYR
EVQGISEHYLR	EVQGISHYL
YYIYELQKR	YYIYELQKR
DVNSFVRSR	DVNSFVRSR
ESTLHLVLR	ESTLHLVLR
EYLHSQGVVHR	EYLHSQVHR
ETVPAFSER	ETVPAFSER
EYPNLVTIYR	EYPNLVIYR
EIIDKRRER	EIIDKRRER
YYIHRNKILHR	YIHRNKLHR
HANPRLWLR	HANPRLWLR
MTVEYVYER	MTVEYVYER
YYNGIGVKR	YYNGIGVKR
EIKSLLEER	EIKSLLEER
EYIQMSGRAGR	EYIQM-SGR
VPMRPGILVQR	PMRPGIVQR
EIMNRKEPVKR	MNRKEPVKR
ETASNEVVYR	ETASNEVYR
ESKQAGQSVFR	ESKQAGVFR
DSMASGTLHLR	MASGTLHLR
YARLIDYAR	YARLIDYAR
EAVTQSLLSSR	VTQSLLSSR
EYVAYSHTGR	EYVAYSTGR
EVGPRKGDFTR	EVGPRKFTR
FVYGSGVYR	FVYGSGVYR
IPRTPSSFR	IPRTPSSFR
EVARYMVQR	EVARYMVQR
DLASPLIGR	DLASPLIGR
ESFFGERRIPR	FFGERRIPR
EVFSHILKR	EVFSHILKR
SYGSLARFR	SYGSLARFR
DFIQEEFQHLK	FIQEEFHLK
EAQVVRVTR	EAQVVRVTR
ETLQNVRTR	ETLQNVRTR
NYLPYPIHQVR	YLPYPIQVR
YVRNQQTIGAR	RNQQTIGAR
YYPSIVANR	YYPSIVANR
DALRVEDMMKR	DALRVEMMK
QSYDNFSYR	QSYDNFSYR
EVREIPPQSR	EVREIPQSR
ENFAPGTTR	ENFAPGTTR
EAFGPEDGLQR	EAFGPELQR
ETEDYRQFR	ETEDYRQFR
DAISYRFPR	DAISYRFPR
AFFVRKKSSLR	FVRKKSSLR
EVHGEAQRVLR	EVHGE-AQR
EYGAEALER	EYGAEALER
EVLHIGSAHNR	EVLHIGSAH
EVAQREAETLR	EVAQRETLR
EYITKLQQER	EYITKLQER
EYPVPASKR	EYPVPASKR
HTGRLPAGR	HTGRLPAGR
DFFPGSDRFAR	DFFPG-SDR
EIRTITVVQR	EIRTITVQR
EFPHPPKRLR	EFPHPPRLR
MAYEPVQR	MAYEP-VQR
DAQRLISER	DAQRLISER
AYKSILQER	AYKSILQER
DIAGRDITR	DIAGRDITR
YVQRFHYSR	YVQRFHYSR
HAHGKLFTR	HAHGKLFTR
TYRDPLYEIVR	TYRDPLIVR
EMQNLVHRR	EMQNLVHRR
NTREPKLFR	NTREPKLFR
DARIPLSGR	DARIPLSGR
MYPDYFAKR	MYPDYFAKR
EVSLPKRGR	EVSLPKRGR
ESFDGSVRAR	ESFDGSRAR
VASTPISQR	VASTPISQR
DYYDSHNVNTR	YYDSHNNTR
YFESKFKGR	YFESKFKGR
DVSHPIIYR	DVSHPIIYR
AAPATRAAL	AAPATRAAL
EYAGLKVAR	EYAGLKVAR
FSKVTLIGR	FSKVTLIGR
EIKEKTGLSIR	EIKEKTSIR
EFKNGYNLR	EFKNGYNLR
ETQLVQEVR	ETQLVQEVR
ESLPANQQPR	ESLPANQPR
FYRPETQHR	FYRPETQHR
SAASGWPSAR	SAASGWSAR
EYLNFIRGV	EYLNFIRGV
EYMDKNNVR	EYMDKNNVR
EIKGFYDPPR	EIKGFYPPR
TIFKPQSKR	TIFKPQSKR
ETQIATILR	ETQIATILR
SVREVRQLTLR	EVRQL-TLR
ETYSPFFR	ETYSP-FFR
EAQAWEQARL	EAQAWEQAR
DASLLIVNR	DASLLIVNR
ETLGDKDHSIR	ETLGDKSIR
EFVDPSSLTAR	EFVDPSTAR
STIPFHYKR	STIPFHYKR
EYIPDLYNH	EYIPDLYNH
FAEEFYSFR	FAEEFYSFR
TYFPSFLSR	TYFPSFLSR
YYIIKTERDRK	YYIIK-TER
EVTYKYTYR	EVTYKYTYR
ESLPDQLVNR	ESLPDQVNR
EISAPSQQR	EISAPSQQR
EYHKFLIGK	EYHKFLIGK
HSMALIHNR	HSMALIHNR
EAQDAGYRMYR	EAQDA-GYR
ELRERPFYGR	ELRERPYGR
LTREHGRAYLR	LTREHGAYL
MTRGNQRELAR	MTRGNQREL
NSNLIVHQR	NSNLIVHQR
SYSLFTALR	SYSLFTALR
TTVEGLITR	TTVEGLITR
HSQDLSGRLR	HSQDLSRLR
EARGLDRINER	RGLDRINER
DAFAYVQER	DAFAYVQER
EYINQIAASR	EYINQIASR
EVLNEVNRR	EVLNEVNRR
DYISLAKTR	DYISLAKTR
DYIVKIFDR	DYIVKIFDR
ETLQKTSVLQR	ETLQKTSVL
EVLEQSAQTLR	EVLEQSTLR
EYLHAQGVVHR	EYLHAQVHR
EYVAEILPK	EYVAEILPK
EVRKLMHVR	EVRKLMHVR
EYKTVHEEL	EYKTVHEEL
NYFGAQPHYR	NYFGAQHYR
EVRKLIIRR	EVRKLIIRR
EVLHGLIGR	EVLHGLIGR
ADRQVLAQR	ADRQVLAQR
ELFRRKHVR	ELFRRKHVR
EVNRLTESTYR	EVNRLTTYR
YFIPATGHSLR	FIPATGSLR
ELQKILDRKR	ELQKILRKR
EFHKQITAR	EFHKQITAR
ETEAYIAQR	ETEAYIAQR
EVVIVSATR	EVVIVSATR
STKGLNLPR	STKGLNLPR
EVRFGGKKTQR	EVRFGGTQR
EVLYNGFTGR	EVLYNGTGR
GYKPKAYLR	GYKPKAYLR
DANPFLSKR	DANPFLSKR
MTHATKAIYR	MTHATKIYR
ELFSNIVPR	ELFSNIVPR
DIKNLVVKR	DIKNLVVKR
YFYSKVQQR	YFYSKVQQR
EFLHANQVIHR	HANQV-IHR
TNRTPEFLR	TNRTPEFLR
EYFADMKRHR	EYFADMRHR
ETLKDRLSR	ETLKDRLSR
EYQAREQLRAR	EYQAREQLR
EFREPRPPR	EFREPRPPR
TYLSESQIQSR	LSESQIQSR
EAAQKFLER	EAAQKFLER
IYQLIEISR	IYQLIEISR
EAWKLLKVGR	EAWKLLVGR
HTTKPILR	HTTKP-ILR
EGLPQLMEVVR	EGLPQLVVR
FTARRLLSQVR	TARRLLQVR
FSKMHTSQDFR	TSQDF---R
QVQEWNRQR	QVQEWNRQR
EYISTEFNR	EYISTEFNR
SVIPHQKLFTR	SVIPHQFTR
DFKRVVGKK	DFKRVVGKK
YYIEDHNGRQR	YYIEDHNGR
EAVFIAHKR	EAVFIAHKR
ETFLAQRQR	ETFLAQRQR
EVFNKFFKER	EVFNKFKER
EYENIKLER	EYENIKLER
EFYNLVRFR	EFYNLVRFR
EVASVWVER	EVASVWVER
ELYKRLKEFLK	ELYKRLEFL
SYNYEIVNR	SYNYEIVNR
HIKSFDKNLYR	KSFDKNLYR
EAGPSIVHR	EAGPSIVHR
HAMQFPAELTR	HAMQFPAEL
SVLNFATNR	SVLNFATNR
ELREYNLEQQR	EYNLE-QQR
SNNTPQLNR	SNNTPQLNR
YEEIAQRS	YEEIA-QRS
EAWLLPAVGR	EAWLLPVGR
YTQPGPGYR	YTQPGPGYR
SGYPPFVGR	SGYPPFVGR
DSRPPFLSR	DSRPPFLSR
NVKEKIYAVR	NVKEKIAVR
SYKGTPAMR	SYKGTPAMR
ESNPPSLMR	ESNPPSLMR
DLFVFPYR	DLFVF-PYR
DARGTVVLR	DARGTVVLR
EYFELPELVRR	EYFELPLVR
EVKRPGESLR	EVKRPGSLR
RYSSAFTNR	RYSSAFTNR
EAYSVGTGR	EAYSVGTGR
TTKSYPSKLAR	TTKSYPSKL
EVIPYTPAMQR	EVIPYTMQR
DFRDRGELR	DFRDRGELR
HTIAPMGTR	HTIAPMGTR
WTLDPTSLSTR	TLDPTSSTR
MAAAVPKRMR	MAAAVPRMR
EFKEDIHNR	EFKEDIHNR
DSFPERRAPR	SFPERRAPR
EALREISGR	EALREISGR
ETAIPSSTR	ETAIPSSTR
EYIDNRSSQR	EYIDNRSQR
EAKPPTVTMPR	EAKPPTVTM
EAYKVFSR	EAYKV-FSR
ETKADSIIRQK	ETKADSIIR
DVQGDDKRYFR	DVQGD-DKR
EAAESIAFR	EAAESIAFR
LVATHDYYR	LVATHDYYR
YYLPYYKRER	YYLPYYRER
EYVPVKKDLR	EYVPVKDLR
DFKDPPTAK	DFKDPPTAK
EVLKQLSSR	EVLKQLSSR
DIKHFVSER	DIKHFVSER
QNFGPEVTR	QNFGPEVTR
EVNQPKFNQR	EVNQPKNQR
STLSPIAPR	STLSPIAPR
DYLHAKNIIHR	HAKNI-IHR
EYMEVRERIHR	EVRER-IHR
DVKPSNFLYNR	DVKPSNYNR
TAMPPGTAR	TAMPPGTAR
EYIQFVPLL	EYIQFVPLL
DYIKLYVRR	DYIKLYVRR
TTLEHQKTFR	TTLEHQTFR
EILNAILNR	EILNAILNR
EVVTPNIFNSR	VTPNIFNSR
ELRGKLVAR	ELRGKLVAR
EVNLLVEEIHR	NLLVEEIHR
EFSVILNQR	EFSVILNQR
EVKYALGER	EVKYALGER
ETIKQENTRL	ETIKQENTR
SAIHIRVFR	SAIHIRVFR
EYLHSRDVVYR	HSRDV-VYR
HYMKFTKGR	HYMKFTKGR
YYKFSGFTQK	YYKFSGTQK
HSMQPKALIHR	SMQPKAIHR
DVFVVGTER	DVFVVGTER
