Data	Data aligned
QSMKIMHEI	QSMKIMHEI
ASFLARRL	ASF-LARRL
KSTVNKWTL	KSTVNKWTL
KTIKLWNTL	KTIKLWNTL
ISFHFTPVL	ISFHFTPVL
KVKPNLQTF	KVKPNLQTF
RSAPVYKRI	RSAPVYKRI
FSADPRHI	FSA-DPRHI
EEQLQQIR	EEQ-LQQIR
KSKPMTQIL	KSKPMTQIL
KSFGGSHVM	KSFGGSHVM
KSIKIVKKL	KSIKIVKKL
FTQPSRLL	FTQ-PSRLL
RTFPDPTSW	RTFPDPTSW
KAYKAYRLL	KAYKAYRLL
KTTVARLI	KTT-VARLI
AQYEDIAQKS	AQYEIAQKS
KSYYLRNTF	KSYYLRNTF
RSISVNQW	RSI-SVNQW
KTKDFQESSI	KTKDFQESS
RSKPLFHHF	RSKPLFHHF
KILYPSTLFLL	KIL-YPSTL
KSQHGSARLF	KSQHSARLF
RSLQAQLQRL	RSLQQLQRL
TSWREGGGRHI	REG-GGRHI
ISQIVSSI	ISQ-IVSSI
HSLTQQRLL	HSLTQQRLL
RSLGGTRLF	RSLGGTRLF
IAPTGHSL	IAP-TGHSL
KVKQFDFLF	KVKQFDFLF
KAKPVTTNL	KAKPVTTNL
KSIWNNRWL	KSIWNNRWL
ASLGARHI	ASL-GARHI
RALPHHRVI	RALPHHRVI
RVYEILRLL	RVYEILRLL
RAAPPPLFLL	RAAPPLFLL
YENEVALR	YEN-EVALR
KSKPDKALSLI	KSKPKALSL
HSMKPHPAI	HSMKPHPAI
LSQPILLEL	LSQPILLEL
KSFSEDRLI	KSFSEDRLI
KSYELPDGQVI	KSYEDGQVI
LSNKTPRSL	LSNKTPRSL
ISQVGRVY	ISQ-VGRVY
VTFSGQYNI	VTFSGQYNI
KILEIIRVI	KILEIIRVI
RTMLVRKI	RTM-LVRKI
KAEKARLL	KAE-KARLL
FSKRIQKSI	FSKRIQKSI
ISNPVTKEM	ISNPVTKEM
KSQEQVHLL	KSQEQVHLL
RARQLNYTI	RARQLNYTI
KSIEVRKF	KSI-EVRKF
KTFRIKRFL	KTFRIKRFL
RSLAANLQLL	RSLANLQLL
KSIELGTLTI	KSIEGTLTI
STITSREI	STI-TSREI
RTLVLRDRNL	RTLVRDRNL
RSIHIFDTL	RSIHIFDTL
RVDPNGSRYLL	RVDPGSRYL
KARPFADLL	KARPFADLL
KARPDLERI	KARPDLERI
KSYYTVHLL	KSYYTVHLL
KSFDFHFGF	KSFDFHFGF
RSLHLQKSL	RSLHLQKSL
ASSTTARVI	ASSTTARVI
YTVKVQREL	YTVKVQREL
LAAEARAI	LAA-EARAI
YENEVALRQ	YENEVALRQ
KSYSKAFTL	KSYSKAFTL
SPASSTTARVI	ASSTTARVI
ASQSARFY	ASQ-SARFY
QGPSSNKPRVI	SSN-KPRVI
LTKISFHLK	LTKISFHLK
YSKRIAVAL	YSKRIAVAL
KTPEEIRKTF	KTPEIRKTF
TSQLARHW	TSQ-LARHW
LSNAQARVI	LSNAQARVI
RSKDTDALI	RSKDTDALI
KVNKIVRTL	KVNKIVRTL
GGLPERSVSL	RSV----SL
KVQEFQRLL	KVQEFQRLL
IGKPAHLIVSL	KPAHLIVSL
RTLNADLMTL	RTLNDLMTL
KSFVKPPSL	KSFVKPPSL
PSSNKPRVI	PSSNKPRVI
KSFSQPGLRSL	FSQPGLRSL
KSQVDAQLL	KSQVDAQLL
VSDPQHAARLL	VSDPAARLL
AQYEDIAQK	AQYEDIAQK
KSFFEAKKL	KSFFEAKKL
KTLDSQTRTF	KTLDQTRTF
VSNAPRLI	VSN-APRLI
KTFVQKQTL	KTFVQKQTL
KSLLWTETF	KSLLWTETF
VSLLVQRTI	VSLLVQRTI
RTFLLTYVL	RTFLLTYVL
KSVYWENTL	KSVYWENTL
RGLIARKL	RGL-IARKL
IRLENEIQTY	RLENEIQTY
RSYPHLRRV	RSYPHLRRV
ISNSPRVI	ISN-SPRVI
HLPETKFSEL	HLPEKFSEL
KTADVTKVW	KTADVTKVW
KSYPGSQSQLF	KSYPSQSQL
KLKPEGLHQLL	KLKPGLHQL
KTKENILEEF	KTKEILEEF
KAFPHSSSLRY	KAFPHSSSL
KAVFTDRQL	KAVFTDRQL
RINLPRNI	RIN-LPRNI
KSKEISQFL	KSKEISQFL
KTLQEVHFL	KTLQEVHFL
ISVTARRL	ISV-TARRL
RSRPAVSVTI	RSRPVSVTI
HSSRSHAIFTI	RSH-AIFTI
RSFPSVREL	RSFPSVREL
LSWKAHRL	LSW-KAHRL
KSRDLSLLI	KSRDLSLLI
KSSQPKPVI	KSSQPKPVI
RSLEGGFKI	RSLEGGFKI
KTWRPRYF	KTW-RPRYF
ASLNLLRYL	ASLNLLRYL
FTIKSDVWSF	FTIKDVWSF
KSINSEVLKF	KSI-NSEVL
KSVDGRQI	KSV-DGRQI
KARLPLRL	KAR-LPLRL
SLYQSKYEEL	LYQSKYEEL
KSKYFESKF	KSKYFESKF
VSIVHSVFEF	VSI-VHSVF
YAKRIQQRL	YAKRIQQRL
KSVVGNLHRL	KSVVNLHRL
KTFPYQHRY	KTFPYQHRY
KSDKAQTKLLI	KSDKQTKLL
KALEYLRQI	KALEYLRQI
KVSKLHSKITL	KVSKLHSKI
KSKEDLVSQGF	KSKEDLVSQ
HTIQTEDRVW	HTIQEDRVW
KTKKPLLI	KTK-KPLLI
FAKRNVKLI	FAKRNVKLI
RARTIYERF	RARTIYERF
KSYAGYQTL	KSYAGYQTL
KSLFLIIKI	KSLFLIIKI
HSQSPRVI	HSQ-SPRVI
KTRMEERRL	KTRMEERRL
QSMPSREL	QSM-PSREL
RSKKLSVLI	RSKKLSVLI
SIPLALALS	SIPLALALS
RTALPRIF	RTA-LPRIF
LSSQSRQW	LSS-QSRQW
KSITNPRYL	KSITNPRYL
RSIPAITRYW	RSIPITRYW
RSIQVDGKTI	RSIQDGKTI
LSLPDIKVYL	LSLPIKVYL
HSAEPRLL	HSA-EPRLL
TTYKLVINGKT	TTYKLVING
KTKAIQAQKL	KAI-QAQKL
KAFPEHFTY	KAFPEHFTY
LAQEARNI	LAQ-EARNI
KTKGFDYLL	KTKGFDYLL
RSIPTHREI	RSIPTHREI
QAINPKLMQL	AINPKLMQL
RSLWGRLL	RSL-WGRLL
ISFPSGKKI	ISFPSGKKI
RSRPHTRLF	RSRPHTRLF
RSLPEIWTL	RSLPEIWTL
KSIHHARVL	KSIHHARVL
KAIEKNVLF	KAIEKNVLF
VSNPKSFEY	VSNPKSFEY
KTIHLTGRSL	KTIHTGRSL
KAQHISRFI	KAQHISRFI
KSVVSYWNL	KSVVSYWNL
RTFTLKHSL	RTFTLKHSL
FANNPREL	FAN-NPREL
RSFQGPVLI	RSFQGPVLI
RSLTHPPTI	RSLTHPPTI
KSYPETHII	KSYPETHII
TALAARTW	TAL-AARTW
RTLPFYFVQKI	RTLPFVQKI
LSVPDSGRLW	LSVPSGRLW
LSKPFTNTL	LSKPFTNTL
RTIVLQESI	RTIVLQESI
RVWSLMRFL	RVWSLMRFL
TSKPFNPLL	TSKPFNPLL
ITKTVVENI	ITKTVVENI
KAIDYIRFL	KAIDYIRFL
KSLKQNINL	KSLKQNINL
VSMDNRLMEL	VSM-DNRLM
KAMLAKLM	KAM-LAKLM
VSSKVQRLL	VSSKVQRLL
RSRTIVHTL	RSRTIVHTL
RTTYIKRVI	RTTYIKRVI
SLVNLGGSK	SLVNLGGSK
SFEDAKEAL	SFEDAKEAL
KSIVQVETL	KSIVQVETL
VAPGKDLTK	VAPGKDLTK
RSIPVWIKI	RSIPVWIKI
KAFDRPSLFQI	KAFDRPSLF
QSLRLVRKL	QSLRLVRKL
KSLEEIYLFSL	KSLEEIYLF
YTLRILRQL	YTLRILRQL
HTHVPRLI	HTH-VPRLI
TSLFIARSF	TSLFIARSF
AANIPRSI	AAN-IPRSI
RSRPEYFRI	RSRPEYFRI
KTLKEIRTL	KTLKEIRTL
AQYEEIAQR	AQYEEIAQR
KSLSDTAKPHI	KSLSAKPHI
VTTIARNW	VTT-IARNW
KSFQYSHNL	KSFQYSHNL
KVIPVTRSL	KVIPVTRSL
KTIDGILLLI	KTIDGILLL
KSIVIMVHI	KSIVIMVHI
KSRLFEFSL	KSRLFEFSL
KTRHLALNL	KTRHLALNL
KTKPLTPSI	KTKPLTPSI
RAKTVVLHI	RAKTVVLHI
RIHFPLATY	RIHFPLATY
KVAEVTKKF	KVAEVTKKF
KSSDIAKTF	KSSDIAKTF
RSALVNNTI	RSALVNNTI
KSYQSFQTF	KSYQSFQTF
KARPFFNEF	KARPFFNEF
ISMPDFDLHL	ISMPFDLHL
RTYRELRLL	RTYRELRLL
KSLEKSELI	KSLEKSELI
KARPNIPVY	KARPNIPVY
QSTDIIRYL	QSTDIIRYL
HSYLSRLI	HSY-LSRLI
KSKLDIWNI	KSKLDIWNI
RAADIRRKL	RAADIRRKL
LSIPYRLI	LSI-PYRLI
RSYTLIRKL	RSYTLIRKL
HTRELAFQI	HTRELAFQI
LSQPTPATL	LSQPTPATL
QALLARNI	QAL-LARNI
RYTRHLVSL	RYTRHLVSL
QSIRIQRML	QSIRIQRML
KASELHSVRKL	KASESVRKL
RSMHPELMKY	RSMHELMKY
ASFHRVQAL	ASFHRVQAL
HSTLPRTL	HST-LPRTL
KSFLHKQTL	KSFLHKQTL
LTNGSGRYI	LTNGSGRYI
KTFVHTVHL	KTFVHTVHL
RVNPALAELNL	RVNPALAEL
KAGLPRSI	KAG-LPRSI
GYSFTTTAER	YSFTTTAER
RTMQARGF	RTM-QARGF
QSLHARTL	QSL-HARTL
LTAAARLL	LTA-AARLL
KTLTGKTITL	KTLTKTITL
QAINPKLLQL	QAI-NPKLL
RTFSSRLI	RTF-SSRLI
NAPLVHATL	NAPLVHATL
LSGAIVSLS	LSGAIVSLS
KVILARQY	KVI-LARQY
KSILSRHL	KSI-LSRHL
KTYSLLHQW	KTYSLLHQW
LSSPVQRTL	LSSPVQRTL
QALEARLV	QAL-EARLV
ISNPVTKEMLF	ISNPVTKEM
KSFQKIQVRLV	KSFQIQVRL
VVNQIARQL	VVNQIARQL
ISKQFHHQL	ISKQFHHQL
AAQVARVL	AAQ-VARVL
RSFHEVREF	RSFHEVREF
YFAERVTSL	YFAERVTSL
KTFTGHREW	KTFTGHREW
RTGPPRLL	RTG-PPRLL
KAFAETHIKGF	KAFAETHIK
KSIEERVTI	KSIEERVTI
LSSSVIREL	LSSSVIREL
KSVTAFFTW	KSVTAFFTW
KAKITAYVI	KAKITAYVI
KTKFEQHTI	KTKFEQHTI
IQQTARSI	IQQ-TARSI
NVEIDPEIQ	NVEIDPEIQ
RSLSDLFRRY	RSLSLFRRY
KAIPDTRLTI	KAIPTRLTI
KAAPGWLKRF	KAAPWLKRF
LTIPVQRLL	LTIPVQRLL
RSKAIRYTW	RSKAIRYTW
VTIRLLETI	VTIRLLETI
RSTDSIRLL	RSTDSIRLL
KTLTPRKL	KTL-TPRKL
GSIQVRWFL	GSIQVRWFL
KASIEHEALYL	ASIEEALYL
KSFGWPSFITY	KSFGWPSFI
ISLAPIHKL	ISLAPIHKL
KSTAISLFY	KSTAISLFY
KVFNQKRYL	KVFNQKRYL
HPVLPARSI	HPVLPARSI
LARAILRKN	LARAILRKN
RSHVVQRVL	RSHVVQRVL
KTLERSYLL	KTLERSYLL
RTTNLIRHF	RTTNLIRHF
RSNPSVFVI	RSNPSVFVI
TSVHPDLMKI	TSVHDLMKI
KSIPVTQEL	KSIPVTQEL
KFQEARKL	KFQ-EARKL
RAKLREIEQQI	KLREIEQQI
VSLRRAVL	VSL-RRAVL
VSNPYHVVILF	VSNPYHVVI
YAIREVNINKF	REV-NINKF
ASELHSVRKL	SELHSVRKL
ASMPSRTI	ASM-PSRTI
AGNIARTI	AGN-IARTI
KSIKIAWAL	KSIKIAWAL
ISRVKSVRL	ISRVKSVRL
KSHIFFWTW	KSHIFFWTW
SIPEKNRPL	SIPEKNRPL
KSYVQGVTW	KSYVQGVTW
KSKAMTGVEQW	KAMTGVEQW
QTSKTQRLL	QTSKTQRLL
RSLKLAYTL	RSLKLAYTL
KSFSQQRSL	KSFSQQRSL
KTKEGVREVF	KTKEGVREV
ISKTARLL	ISK-TARLL
RSIDLTVKL	RSIDLTVKL
KSVFITRKL	KSVFITRKL
MSYEEKRQL	MSYEEKRQL
RSMNSRVF	RSM-NSRVF
ITKPASVFVQL	ITKPVFVQL
KGGTSIIMEL	GTS-IIMEL
RTLAIARNL	RTLAIARNL
LSADFNYRSF	LSADNYRSF
ISLPDDVRRRL	ISLPVRRRL
KATNVVRLL	KATNVVRLL
KTLSPREL	KTL-SPREL
RTVQSFRHL	RTVQSFRHL
KSFSQKTTL	KSFSQKTTL
GAGGGFGSR	GAGGGFGSR
KTNQLQRII	KTNQLQRII
ITFPGIKLI	ITFPGIKLI
LSNPDPRLL	LSNPDPRLL
KTKQVIQGL	KTKQVIQGL
KTRQIISTI	KTRQIISTI
RTIVIRRDY	RTIVIRRDY
KSTTTGHLI	KSTTTGHLI
KTLDQAIMKF	KTLDAIMKF
VVQKPRQI	VVQ-KPRQI
SAFLPARFY	SAFLPARFY
LSLPLNREL	LSLPLNREL
RVYPESIPRKF	RVYPIPRKF
ATIPVSQISTI	ATI-PVSQI
RSLWKDVTF	RSLWKDVTF
QSSRSHAIFTI	RSH-AIFTI
RAKATRISI	RAKATRISI
KSYELIRKI	KSYELIRKI
SSKVQRLL	SSK-VQRLL
HSYADMREL	HSYADMREL
KTMPAATYRLL	KTMPTYRLL
KSLQAIKI	KSL-QAIKI
KTNPDDRRII	KTNPDDRRI
KTFHPVPNL	KTFHPVPNL
GTYDKKVTI	GTYDKKVTI
KAFDRPSLF	KAFDRPSLF
NSGDVNVEIN	NSGDVNVEI
ITTDVLYTI	ITTDVLYTI
YAPSGNYV	YAP-SGNYV
KTRYIFDLF	KTRYIFDLF
KTLPADVQNYY	KTLPDVQNY
KTIHKYVHL	KTIHKYVHL
STTKARLF	STT-KARLF
RTLAEARRL	RTLAEARRL
ATIPNARQF	ATIPNARQF
VSKPLAHHI	VSKPLAHHI
RNKYEDEINKR	KYEDEINKR
KSYNQRVHL	KSYNQRVHL
VSFQHPHKY	VSFQHPHKY
KSKSFFDNI	KSKSFFDNI
LLSYPRLL	LLS-YPRLL
RLYPGQRHL	RLYPGQRHL
RSRIPMETL	RSRIPMETL
HSFPLQFTL	HSFPLQFTL
FTNRNPRNL	FTNRNPRNL
TSRHLEETI	TSRHLEETI
KSYGNEKRFF	KSYGEKRFF
KLNKESRLL	KLNKESRLL
KTYFKAAKL	KTYFKAAKL
LAKKPHII	LAK-KPHII
LSFFMARVF	LSFFMARVF
VSFLEYRTF	VSFLEYRTF
RSFIAKRL	RSF-IAKRL
GSTIVHAVQRI	STIVAVQRI
KVKDEKIRQAF	KVKDEKIRQ
ASVRSSPTL	ASVRSSPTL
KTWSSRLW	KTW-SSRLW
KSLDFGFTI	KSLDFGFTI
KSYYHVYKL	KSYYHVYKL
IAQLARQY	IAQ-LARQY
KSFNSVHLL	KSFNSVHLL
RTIREVRTL	RTIREVRTL
KSFPGIPLHHI	KSFPPLHHI
ATNPISRVL	ATNPISRVL
KTKDIVNGL	KTKDIVNGL
RTLIPRYF	RTL-IPRYF
KTYPLGRIL	KTYPLGRIL
KLKVSLQTL	KLKVSLQTL
KAYSEAHEI	KAYSEAHEI
LTNMSRTL	LTN-MSRTL
VSAQSRFL	VSA-QSRFL
RSLLARTV	RSL-LARTV
EENLLDFVRF	NLL-DFVRF
KTLFILRGL	KTLFILRGL
LSISPIVLYL	LSISIVLYL
SIKIVKKL	SIK-IVKKL
KSNLARVF	KSN-LARVF
RSLLGRSL	RSL-LGRSL
RALELTRRL	RALELTRRL
KSLEAFFLY	KSLEAFFLY
RSVFFGVFQSF	RSVFVFQSF
RSFHRTQDL	RSFHRTQDL
RSNPKLKDLYI	RSNPKLKDL
KSFSFVRVI	KSFSFVRVI
RAAVVIRTL	RAAVVIRTL
KSTDVAKTF	KSTDVAKTF
KSVDPRLI	KSV-DPRLI
ESSRSHAVFTI	RSH-AVFTI
KTIKAQIW	KTI-KAQIW
KSSTVLHTF	KSSTVLHTF
FSFKKSFKL	FSFKKSFKL
KVTELLRTF	KVTELLRTF
KTKPHLFYI	KTKPHLFYI
KSYYTVRQL	KSYYTVRQL
KSLILPPEHIL	KSLIPPEHI
KSFEETYDRKL	KSFEYDRKL
KVVDVVRNL	KVVDVVRNL
RTWAERRQF	RTWAERRQF
RSHLGRYL	RSH-LGRYL
RTIGFFYTL	RTIGFFYTL
KSRDYEREI	KSRDYEREI
ASLPAELINQI	ASL-PAELI
KSKDPSGLLI	KSKDSGLLI
RSIVPHVF	RSI-VPHVF
KTQGPRALW	KTQGPRALW
ISDKVLKKI	ISDKVLKKI
AANDARLL	AAN-DARLL
LSLTLLHLL	LSLTLLHLL
AEQNRKDAEAW	QNRKDAEAW
LSIHLQHKF	LSIHLQHKF
ASLKAKLL	ASL-KAKLL
KSFSKSDLVNW	KSFSKSDLV
KSSRSHSVFTL	RSH-SVFTL
KTFPFHFMF	KTFPFHFMF
KTKDHTLVQTI	KTKDLVQTI
KTNILLRYL	KTNILLRYL
FTQKGNLLRHI	KGN-LLRHI
KGLSARII	KGL-SARII
LSNLPRSF	LSN-LPRSF
KLQRARLL	KLQ-RARLL
RSLLLQKKL	RSLLLQKKL
KAINGKYHRFL	KAINKYHRF
VTNPYQATI	VTNPYQATI
ISSAEHAGLFL	SSAEHAGLF
ITPTGTHPL	ITPTGTHPL
RSLNPPLTI	RSLNPPLTI
HSITSDNHKW	HSITDNHKW
KSFPSIFKF	KSFPSIFKF
HSKDGSLQQL	HSKDSLQQL
KTYPAHAF	KTY-PAHAF
KSLTAHVI	KSL-TAHVI
KAFPKAYLL	KAFPKAYLL
GVMALQRKL	GVMALQRKL
KSYKGRQII	KSYKGRQII
ISFTVKYTY	ISFTVKYTY
KSIDLIQKW	KSIDLIQKW
KTWAGSQSRRL	KTWAQSRRL
LSQEGRSL	LSQ-EGRSL
KSFAKARNI	KSFAKARNI
KSIDSKSFISI	KSIDSKSFI
KSFYQFQHY	KSFYQFQHY
ISVNIFRTL	ISVNIFRTL
KSFQAIHQF	KSFQAIHQF
KISSEHARTYI	ISSEHARTY
KSVFIKQQRF	KSVFKQQRF
HSLFLDRLM	HSLFLDRLM
RSLQLQEHRLL	RSLQEHRLL
HSIFSIRIL	HSIFSIRIL
QTTAPRLL	QTT-APRLL
TSAYARLI	TSA-YARLI
KTKEIEQVY	KTKEIEQVY
KSFSGSYRL	KSFSGSYRL
RSITLHHRI	RSITLHHRI
VSNLLHSTLQL	VSNLLHSTL
RSLQGRAL	RSL-QGRAL
AGFAGDDAPR	AGFADDAPR
LTLKSHRLL	LTLKSHRLL
ASLPSELIVHI	ASL-PSELI
QSLQIFRKW	QSLQIFRKW
KTLELPHVF	KTLELPHVF
VSKPAESLPVI	VSK-PAESL
AAIKIIRQL	AAIKIIRQL
KVFPSPHILQI	KVFPSPHIL
KTFTIKRFL	KTFTIKRFL
RVIDLLRVI	RVIDLLRVI
KTKPIHTII	KTKPIHTII
KTRTNVPTF	KTRTNVPTF
LTRQPFAI	LTR-QPFAI
KSLPEEDVAEI	KSLPDVAEI
LESRIRDVHEL	RIR-DVHEL
FTSKFPRQI	FTSKFPRQI
TVTEKPEVID	TVTEKPEVI
RSLKADLQKL	RSLKDLQKL
RSISQGLTWTW	RSISQGLTW
LTYASPPLI	LTYASPPLI
RAWQERRLL	RAWQERRLL
KSANSTLRLL	KSANTLRLL
KGQSTPRLF	KGQSTPRLF
SSTTARVI	SST-TARVI
RAAQLQRKF	RAAQLQRKF
RSYANIKEKLF	RSYAIKEKL
RSTQLIRHL	RSTQLIRHL
STDVAKTF	STD-VAKTF
KSFNFDRVF	KSFNFDRVF
KIIIIHRNL	KIIIIHRNL
KAIVLQKTI	KAIVLQKTI
KSDPSIVRLL	KSDPIVRLL
ASAVVVWEW	ASAVVVWEW
KSIAKADLI	KSIAKADLI
LTADARLL	LTA-DARLL
KTLDQIRTI	KTLDQIRTI
RSFKAQVF	RSF-KAQVF
HSTLVPHEW	HSTLVPHEW
LSAPARLY	LSA-PARLY
ASFDGTFLW	ASFDGTFLW
KSKPVPLKL	KSKPVPLKL
KSTEFPRKI	KSTEFPRKI
RTLEDRGIRKI	RTL-EDRGI
RSLFLGRIL	RSLFLGRIL
KSKEFAQII	KSKEFAQII
IGTKGRLI	IGT-KGRLI
ISVPIFKQF	ISVPIFKQF
KAVFVARVL	KAVFVARVL
ISSTVQRQL	ISSTVQRQL
RSYVTTSTRTY	RSYVTTSTR
YTYRGPKAF	YTYRGPKAF
LSMIIIRTL	LSMIIIRTL
GTFRGTRYF	GTFRGTRYF
KSALVFITF	KSALVFITF
KAKGPVTI	KAK-GPVTI
KSKTLQEFL	KSKTLQEFL
RSIIFANYI	RSIIFANYI
RSIRLPETI	RSIRLPETI
KSLITTHHL	KSLITTHHL
RTTVVARKL	RTTVVARKL
LSTAPRSL	LST-APRSL
RALLARLL	RAL-LARLL
KSFFKRKTI	KSFFKRKTI
ASKTKEIEQVY	KTKEIEQVY
RTLEQARQL	RTLEQARQL
KAAPSRLF	KAA-PSRLF
GSFSGVRKL	GSFSGVRKL
RSREFLDFL	RSREFLDFL
KSALALRW	KSA-LALRW
RSFFHQHYL	RSFFHQHYL
KAKVAIKI	KAK-VAIKI
KSYAGEKIL	KSYAGEKIL
KSFEGLFYF	KSFEGLFYF
KSIKNIQKI	KSIKNIQKI
ALEEQLQQIR	ALEEQLQQI
KTNPKIQSI	KTNPKIQSI
RSAPARVI	RSA-PARVI
KLNPYRAKVLI	KLNPRAKVL
RTLDNQLFFFL	RTLDNQLFF
RTVRIWRQY	RTVRIWRQY
KSYVKYQVI	KSYVKYQVI
LSTTVKREL	LSTTVKREL
RSSKFAGTRFL	SSKFGTRFL
RSLGFNTQI	RSLGFNTQI
KSYDGRAYVI	KSYDRAYVI
KSKEIEAKI	KSKEIEAKI
KAVSLQRKL	KAVSLQRKL
ISPTGHSL	ISP-TGHSL
YLPDGTASL	YLPDGTASL
KSRQFLQFF	KSRQFLQFF
KSTSLTFHW	KSTSLTFHW
FSNAARVL	FSN-AARVL
KTIEDVREF	KTIEDVREF
VSAYPRQL	VSA-YPRQL
KNKYEDEINKR	KYEDEINKR
TEELAYLK	TEE-LAYLK
KSFINSETI	KSFINSETI
KSKPIIAEPEI	KSKPIIAEP
KSFPGGKEYL	KSFPGKEYL
KTTFVKRHL	KTTFVKRHL
ATLRTSRLL	ATLRTSRLL
KSYDRNYRL	KSYDRNYRL
KSKIVSEI	KSK-IVSEI
ARLDLERKI	ARLDLERKI
QSFTGSRTY	QSFTGSRTY
FAPYNKPSL	FAPYNKPSL
KTKALQTVI	KTKALQTVI
RTTVVHGDFRL	TVVHGDFRL
YAIRGVPSL	YAIRGVPSL
KSRPAHLAVFL	KSRPLAVFL
ATSGVVAVRLI	TSGVVAVRL
KTKGFHTTI	KTKGFHTTI
RSYSRLETL	RSYSRLETL
YAPSGNFV	YAP-SGNFV
RSYWKEVLL	RSYWKEVLL
RTLPSRVF	RTL-PSRVF
AELAARIL	AEL-AARIL
KSYEAKLRLL	KSYEKLRLL
KSNPKPLVL	KSNPKPLVL
KTFAEARLI	KTFAEARLI
RVQKLSRVI	RVQKLSRVI
HSVDQSWSW	HSVDQSWSW
AEFAEVSK	AEF-AEVSK
RTFEPRLL	RTF-EPRLL
KALEVFPEF	KALEVFPEF
RVYDVTRFL	RVYDVTRFL
KVTTVKKFF	KVTTVKKFF
FSQPARSF	FSQ-PARSF
TEELNREVATN	ELNREVATN
KVKELAETI	KVKELAETI
KAINFNFGY	KAINFNFGY
KSMISRKL	KSM-ISRKL
RAYPAAITI	RAYPAAITI
RSIALTQARYL	IALTQARYL
RTKDLIIEQRF	RTKDLIIEQ
KSFVKVYNY	KSFVKVYNY
KALKIKREL	KALKIKREL
RSLHLEASL	RSLHLEASL
KSKGWVNTL	KSKGWVNTL
KTLLFVRLL	KTLLFVRLL
RSSRSHAVLLV	SSRSHAVLL
LTTIARTI	LTT-IARTI
KSKILKQVI	KSKILKQVI
KGFLFLHTL	KGFLFLHTL
KTYQDIQNTI	KTYQIQNTI
KTKSFFDNI	KTKSFFDNI
YSRRFFPYY	YSRRFFPYY
ISRHQEQFI	ISRHQEQFI
TNAENEFVTIK	AEN-EFVTI
RSKSYELIRKI	KSYELIRKI
FSKRQQPKF	FSKRQQPKF
IAKQSVTI	IAK-QSVTI
FSFKKPFKL	FSFKKPFKL
VTYVPVTTF	VTYVPVTTF
KSQIPLSKI	KSQIPLSKI
KSFPAAIEHTI	KSFPIEHTI
KSKPDKALSL	KSKPKALSL
ATIKTKRTI	ATIKTKRTI
RTFHIFYYL	RTFHIFYYL
KSGEAKYFHL	KSGEKYFHL
KAFDYPSLFRI	KAFDYPSLF
GGASLGARHI	ASL-GARHI
TTYKLVINGK	TTYKLVING
KSFPGGKEY	KSFPGGKEY
RSSRSHSVFQL	RSH-SVFQL
KSKNILFVI	KSKNILFVI
SAPYGRITL	SAPYGRITL
ASLDISRKW	ASLDISRKW
KTKETIQVL	KTKETIQVL
KSFSYKRNL	KSFSYKRNL
ASVYIYRYF	ASVYIYRYF
KSFTHSSTF	KSFTHSSTF
TSSRSHAVFTI	RSH-AVFTI
ITTTVTRVL	ITTTVTRVL
RSLLADRLL	RSLLADRLL
SVPEAQSAL	SVPEAQSAL
RTVVRTVTL	RTVVRTVTL
KSMPTVTQI	KSMPTVTQI
RANVNARTF	RANVNARTF
RSRSFDYNY	RSRSFDYNY
KTRHVNILL	KTRHVNILL
RSLAYIHSF	RSLAYIHSF
ISLKENRHW	ISLKENRHW
RAREYNARL	RAREYNARL
KTVPQKVTI	KTVPQKVTI
TAQQPRLF	TAQ-QPRLF
KSLWKSSTI	KSLWKSSTI
SAVQAARKL	SAVQAARKL
NVPGEIVE	NVP-GEIVE
APRPVPKPR	APRPVPKPR
FTIKADVWSF	FTIKDVWSF
IIHEIAVLEL	HEI-AVLEL
KSIHIVVTM	KSIHIVVTM
KSKGSDKDFVI	KSKGKDFVI
KSRQELNTI	KSRQELNTI
LAFTARKM	LAF-TARKM
KSRVVLPYL	KSRVVLPYL
KAKTIQQTL	KAKTIQQTL
KTKDGVREVF	KTKDGVREV
RSLFIDRTI	RSLFIDRTI
KAARLVRSL	KAARLVRSL
SVRGYPTLLLF	RGYPTLLLF
ISANIFRTL	ISANIFRTL
HTNLSRKI	HTN-LSRKI
KSVKIYRLI	KSVKIYRLI
RSSQFARKL	RSSQFARKL
KSLPAKVEQIL	KSLPKVEQI
KSFPDTGSLNL	KSFPDTGSL
YSFRNVQQI	YSFRNVQQI
VSQEVTRSL	VSQEVTRSL
HALALAWTF	HALALAWTF
KTRSVEQTL	KTRSVEQTL
ISNTAISI	ISN-TAISI
LSAPSYLARSL	LSAPLARSL
KAKQLTPRI	KAKQLTPRI
SIPGGYNAL	SIPGGYNAL
KSKPESNEQVL	KSKPNEQVL
RTTEILHHL	RTTEILHHL
HTWNGIRHL	HTWNGIRHL
KTIDNQRVY	KTIDNQRVY
KSMSVERTF	KSMSVERTF
HTNLPRSI	HTN-LPRSI
KSALLERAL	KSALLERAL
KSSNVVRSF	KSSNVVRSF
RALKEIRKF	RALKEIRKF
KSAIPHPLI	KSAIPHPLI
KAMELIREL	KAMELIREL
SIPILASAL	SIPILASAL
RVSDILRYL	RVSDILRYL
QSLPSSVLHII	QSLPSVLHI
VSRVEKYTI	VSRVEKYTI
LTKQEFQTL	LTKQEFQTL
KSFENISKW	KSFENISKW
KSFQLQVSL	KSFQLQVSL
HTVHVLRYF	HTVHVLRYF
KLDPNKAYIQI	KLDPNKAYI
KSIQAAFKF	KSIQAAFKF
AVSLQRKL	AVS-LQRKL
KTWHKGTLI	KTWHKGTLI
ITQETARLL	ITQETARLL
RSWDQQIKLW	RSWDQQIKL
ITVVARQI	ITV-VARQI
IIFVPVPQL	IIFVPVPQL
KSKPIFWNL	KSKPIFWNL
KTFTTQETI	KTFTTQETI
LAPTDVKEL	LAPTDVKEL
EESNYELEGK	ESNYELEGK
KSKPDKQLI	KSKPDKQLI
LSSTPRVI	LSS-TPRVI
RALSIQRLW	RALSIQRLW
RTVEKPPKF	RTVEKPPKF
KSLPSVLVIHL	KSLPSVLVI
LSAEPRYL	LSA-EPRYL
LSLVARLI	LSL-VARLI
RTKQVLHTF	RTKQVLHTF
ISTPVIRTF	ISTPVIRTF
KSFRDKGIFL	KSFRKGIFL
QTTKARFL	QTT-KARFL
KSNPIIRTV	KSNPIIRTV
VALAARKI	VAL-AARKI
KSMDAIRSL	KSMDAIRSL
KSLGMERLL	KSLGMERLL
KTKEVIQEW	KTKEVIQEW
KSFYDARLL	KSFYDARLL
KAFPFHIIF	KAFPFHIIF
YAQVARLF	YAQ-VARLF
SAPVGVTAL	SAPVGVTAL
KANPTTRLW	KANPTTRLW
ITNHIHVRI	ITNHIHVRI
KSLAKTFHL	KSLAKTFHL
RVQKIRPSI	RVQKIRPSI
RSLSTTNVF	RSLSTTNVF
KSLPAEINRM	KSLPEINRM
RSMPLGARIL	RSMPGARIL
VQNIARQL	VQN-IARQL
LTSTPREI	LTS-TPREI
KTKPFQLQL	KTKPFQLQL
SSIKIVRHI	SSIKIVRHI
KSLENAIEW	KSLENAIEW
KAKTDSINI	KAKTDSINI
KSLLFVNTL	KSLLFVNTL
KSYRRKDGVFL	KSY---RRK
KSKDVIKTI	KSKDVIKTI
KLILNGKTL	KLILNGKTL
KVLELQRKL	KVLELQRKL
LSLKVLRKL	LSLKVLRKL
KVINAAHSF	KVINAAHSF
KMNPLWNTMVI	KMNPLWNTM
NVKVDPEIQ	NVKVDPEIQ
RSFAGNLNTY	RSFANLNTY
KVKTDTVLI	KVKTDTVLI
RSIILNHVI	RSIILNHVI
HANLARAL	HAN-LARAL
RALVGREL	RAL-VGREL
RSLNPRKL	RSL-NPRKL
KSLFLGQKL	KSLFLGQKL
RTVEKTWKL	RTVEKTWKL
LSKKPLRY	LSK-KPLRY
RSFSEGGERLL	RSFSGERLL
RSKQEFQFF	RSKQEFQFF
GSTDRQVTI	GSTDRQVTI
ISKPDVITL	ISKPDVITL
RSHLAALW	RSH-LAALW
KSNPYGEWQEI	KSNPEWQEI
KALELERKL	KALELERKL
LVNEVTEFAK	LVN-EVTEF
RSLLVNRSL	RSLLVNRSL
KINEKPQVI	KINEKPQVI
KSFDNIRNW	KSFDNIRNW
YAARARLL	YAA-RARLL
