Data	Data aligned
EIINEDIAKR	EIINDIAKR
EPFNDPALR	EPFNDPALR
HAGPPSTSR	HAGPPSTSR
SVAFSSDNR	SVAFSSDNR
EDFYTATER	EDFYTATER
EAKFPTMNR	EAKFPTMNR
ETQIATILR	ETQIATILR
EAIGADSARF	EAIGADSAR
EVFRDTVHM	EVFRDTVHM
EVAFPHHPR	EVAFPHHPR
EQAAPSGLR	EQAAPSGLR
EVVVSGKLR	EVVVSGKLR
ELSPVSFQYR	ELSPSFQYR
SAHFSPVLR	SAHFSPVLR
ETAPVGTVL	ETAPVGTVL
ELKDWPKKR	ELKDWPKKR
EVVDTTASTKR	EVVDASTKR
EPHLPHGVSQR	HLPHGVSQR
SAAPPTVGR	SAAPPTVGR
EVPEVTRSR	EVPEVTRSR
EGRDIPIVHR	EGRDPIVHR
ETVVGLAR	ETV-VGLAR
YVTTSTRTY	YVTTSTRTY
EAFGKIVAER	EAFGIVAER
ELIAKIPNF	ELIAKIPNF
FAMNVGKAR	FAMNVGKAR
YDAEISQIHQ	EIS------
IVFPETSQPR	IVFPTSQPR
EVAQPSEVL	EVAQPSEVL
EMIITKQGR	EMIITKQGR
EVAGTVTGQKR	EVAGVTGQK
EVNRVSQSM	EVNRVSQSM
ELAVTFIER	ELAVTFIER
EAAAVLMAR	EAAAVLMAR
SLVNLGGSK	SLVNLGGSK
EIKKPPVSER	EIKKPVSER
ETFEHPNVVR	ETFEPNVVR
EVGKKFSAR	EVGKKFSAR
DTITETDLR	DTITETDLR
ETYKPHLER	ETYKPHLER
TLAEVMRQR	TLAEVMRQR
DVTHPRMRR	DVTHPRMRR
IVIKGTSER	IVIKGTSER
HVIVDEVHER	VIVDEVHER
EPRVATVTR	EPRVATVTR
ELAKIMRTR	ELAKIMRTR
ESFPGSFRGR	ESFPSFRGR
AAAPGLGPR	AAAPGLGPR
ESYSVYVYK	ESYSVYVYK
ELADVTAKY	ELADVTAKY
EMLTFNPHKR	EMLTNPHKR
EAYGAVTQTVR	EAYGAVTQT
QVATVIQSR	QVATVIQSR
LAAPSGLER	LAAPSGLER
TIIFITGTTR	TIIFTGTTR
SISGPFGSR	SISGPFGSR
EALPGSGQAR	EALPSGQAR
AAVDSSVPR	AAVDSSVPR
EAELGTFPR	EAELGTFPR
LVFPSEIVGKR	FPSEIVGKR
EVVEGMDISTR	EVVEDISTR
DVFESKLSTR	DVFEKLSTR
EVVLYSGAR	EVVLYSGAR
EASPRILKK	EASPRILKK
EVSTGINR	EVS-TGINR
EVFEVGVTSHR	EVFEVTSHR
EAIGNEVTR	EAIGNEVTR
DVSDVGLGKGR	DVSDVGLGK
EVMEKLVKR	EVMEKLVKR
TVAQITQRF	TVAQITQRF
LTAVVQKR	LTA-VVQKR
EVHTGTTIM	EVHTGTTIM
EAATVTSYL	EAATVTSYL
EMTPAVRQR	EMTPAVRQR
ETTVGNMVR	ETTVGNMVR
DSIDPALRR	DSIDPALRR
EAMDVKLKR	EAMDVKLKR
NVKGPGLQRM	NVKGPGLQR
QVYFGTSHPR	QVYFTSHPR
TIIDTKGVTAL	TIIDKGVTA
EAQGIHISR	EAQGIHISR
EGGPTSVGR	EGGPTSVGR
EAVEAAINR	EAVEAAINR
ELPPGSTKR	ELPPGSTKR
ETFNSITKR	ETFNSITKR
EAVEQNNPRL	EAVEQNNPR
AVIDVDVMAR	AVIDDVMAR
EAQNPRPTRL	EAQNPRPTR
ELQGNLIVVGR	ELQGIVVGR
SLYGPGTNR	SLYGPGTNR
NVVSVDTAR	NVVSVDTAR
SAPKGSVL	SAP-KGSVL
ELSEVLKAR	ELSEVLKAR
ETIDTSRVSLR	ETIDRVSLR
EIIAWHKKTQ	EII-AWHKK
EGVNPSVGR	EGVNPSVGR
DVFWLRFSNR	DVFWRFSNR
ETNHTSRPRL	ETNHTSRPR
EVIGLLGGR	EVIGLLGGR
DLREGIER	DLR-EGIER
SIIGVTEPR	SIIGVTEPR
DVIKPGTVK	DVIKPGTVK
ELAQVIVSR	ELAQVIVSR
EVGPVLSK	EVG-PVLSK
EVSPPVTVR	EVSPPVTVR
SGPSIVHR	SGP-SIVHR
EAVDLMEPRL	EAVDLMEPR
SIIEHTRER	SIIEHTRER
ESLPATHIR	ESLPATHIR
EGASPLSER	EGASPLSER
EAIKITNRR	EAIKITNRR
DVRIGMTR	DVR-IGMTR
ETQGQQPPQRR	ETQGQPPQR
EVEPGVHLGR	EVEPVHLGR
AEVLGLILR	AEVLGLILR
EVFLAQGTLR	EVFLQGTLR
EIIIVDTSGR	EIIIDTSGR
ESALPRAGPR	ESALRAGPR
ETFDYIGSSR	ETFDIGSSR
EVGGEALGRL	EVGGEALGR
SPIVSGARR	SPIVSGARR
TAIEAQHLLKR	EAQ-HLLKR
EAGPGGALHR	EAGPGALHR
ELPSFLGKR	ELPSFLGKR
EVFFSEKIYK	EVFFEKIYK
EAFEAIPR	EAF-EAIPR
ELLEPLNER	ELLEPLNER
EVSSLISEK	EVSSLISEK
EVGDIVKVTR	EVGDVKVTR
VAAVAARR	VAA-VAARR
DVIKPGTVKR	DVIKGTVKR
VVMTPPRNR	VVMTPPRNR
ELKDPTDHY	ELKDPTDHY
EANEEFALR	EANEEFALR
IPVDPSTSR	IPVDPSTSR
EAIESYYQR	EAIESYYQR
GPGPRPLAR	GPGPRPLAR
DPAGVHPPR	DPAGVHPPR
DQMPQGAPR	DQMPQGAPR
EVVPRVTKK	EVVPRVTKK
MAGPGGLAR	MAGPGGLAR
EAQRITGLR	EAQRITGLR
SVSDIIRLR	SVSDIIRLR
ESFDGSVR	ESF-DGSVR
DVRQKVLER	DVRQKVLER
EIVHGDLSPR	EIVHDLSPR
YVIKPGNTK	YVIKPGNTK
EALKLARQI	EALKLARQI
ETVTSFRKR	ETVTSFRKR
DPAFGSSGR	DPAFGSSGR
EVASGAVLR	EVASGAVLR
LVAQHPPARR	LVAQPPARR
EVAASGSHL	EVAASGSHL
QVFLGGRNR	QVFLGGRNR
EAFSLDSSLR	EAFSDSSLR
ETSFVPTNM	ETSFVPTNM
EVYKELRLR	EVYKELRLR
EITGETALR	EITGETALR
DVAQWNIGSLR	DVAQIGSLR
VATDITSTR	VATDITSTR
EAVKKLIER	EAVKKLIER
ETFIKGKER	ETFIKGKER
FVTSMMTGR	FVTSMMTGR
EIASVAYRYR	EIASAYRYR
NVIEAVYNR	NVIEAVYNR
PRRASVTR	PRR-ASVTR
TPKKPGLRR	TPKKPGLRR
FVSLSTSGGK	FVSLTSGGK
ELIRKLQQR	ELIRKLQQR
EVHWATHQL	EVHWATHQL
LVIGGSSER	LVIGGSSER
EAVAGIVGR	EAVAGIVGR
EIFGTELTR	EIFGTELTR
EAAAVRALVAR	AAVRALVAR
ESAPMFSAK	ESAPMFSAK
DILFTEQER	DILFTEQER
TVYHSPVSR	TVYHSPVSR
DVHVAVVVR	DVHVAVVVR
EAFVIDAVR	EAFVIDAVR
EISKVAAER	EISKVAAER
LVVPPSRYR	LVVPPSRYR
EVNDKRYLR	EVNDKRYLR
WVIGSVVAR	WVIGSVVAR
ETYLHRIGR	ETYLHRIGR
AAGPPISEGK	AAGPISEGK
EIADVSTGL	EIADVSTGL
EVFRFAYY	EVF-RFAYY
EQSGPPHEPR	EQSGPHEPR
EVTGTGLGR	EVTGTGLGR
IVQAVSAHR	IVQAVSAHR
FVAQPGLSR	FVAQPGLSR
HTIAPMGTR	HTIAPMGTR
EIPDNVGDWLR	EIPDVGDWL
DVYLGRYR	DVY-LGRYR
SSPQPGSAL	SSPQPGSAL
EPALTRKGAR	EPALRKGAR
EAAAVLMARL	EAAAVLMAR
ETIGKKFEKR	ETIGKFEKR
EAFEHPNVVR	EAFEPNVVR
EIMQETGTRI	EIMQETGTR
EVIQGLLKK	EVIQGLLKK
FVIDVGYER	FVIDVGYER
EISSATKLR	EISSATKLR
SLRFSPTGR	SLRFSPTGR
EVWIPKNGTR	EVWIKNGTR
AAPEGKRSL	AAPEGKRSL
ELGLLDPAQR	ELGLDPAQR
EVARLWGVR	EVARLWGVR
AIIMFDVTSR	IIMFDVTSR
EVYDGPKNVR	EVYDPKNVR
EISAPVSER	EISAPVSER
ETAFQGMLR	ETAFQGMLR
EAHAQSIGM	EAHAQSIGM
SLNTPGSFR	SLNTPGSFR
SIENTSTLQR	SIENSTLQR
ESAPAWRLR	ESAPAWRLR
ELVPFESPR	ELVPFESPR
ESTNFATLR	ESTNFATLR
DPFGHHVAR	DPFGHHVAR
ESAKVGDQAQR	ESAKDQAQR
ETMDPFVDR	ETMDPFVDR
SVSEVVVNR	SVSEVVVNR
EVMEYTTILR	EVMETTILR
ETVNFSGVKR	ETVNSGVKR
EALNQVTQR	EALNQVTQR
EVTPVTGASLR	EVTPTGASL
ETVDMTLRR	ETVDMTLRR
ELYRATREF	ELYRATREF
EASGPGNFF	EASGPGNFF
EPAPALSSR	EPAPALSSR
LVSQPGLNR	LVSQPGLNR
EVADLKIKR	EVADLKIKR
EVAGFGESR	EVAGFGESR
TVFDAKRLIGR	DAK-RLIGR
ELSNVLAAMR	ELSNLAAMR
SVKEVALGR	SVKEVALGR
TVFITGASR	TVFITGASR
MAAAAFAEK	MAAAAFAEK
EAAKVFGLR	EAAKVFGLR
QAGPSGLQR	QAGPSGLQR
TVAHAISER	TVAHAISER
DVGKSTFNR	DVGKSTFNR
NIQKITKSM	NIQKITKSM
ELKLGSGNR	ELKLGSGNR
HVIQPRADR	HVIQPRADR
QVHPDTGISSK	HPDTGISSK
DIWLGAQR	DIW-LGAQR
ESIRAAVNR	ESIRAAVNR
ELIRDPKGR	ELIRDPKGR
EVIESTNLK	EVIESTNLK
EVKGYWAGL	EVKGYWAGL
EPASPISQR	EPASPISQR
EVQLESKVR	EVQLESKVR
WVYGPGGAR	WVYGPGGAR
MLHPSSRPR	MLHPSSRPR
EASPVKASR	EASPVKASR
EVSSIIKKK	EVSSIIKKK
ETAPKSEEF	ETAPKSEEF
EVSPITGR	EVS-PITGR
HVKEQLETLR	HVKELETLR
ESFFPYQVTER	ESFFQVTER
YFAERVTSL	YFAERVTSL
ETHEALARRL	ETHEALARR
DVAQSTHVL	DVAQSTHVL
EVIKPWITKR	EVIKWITKR
AVFPSIVGRPR	AVFPSIVGR
EAYLASLR	EAY-LASLR
EVSPIFTQF	EVSPIFTQF
SPASIGQPR	SPASIGQPR
ELKAPGISY	ELKAPGISY
LQQAKDEI	LQQ-AKDEI
EVTAALRER	EVTAALRER
ETLMETHER	ETLMETHER
MSISGSSAR	MSISGSSAR
IVKQAGLER	IVKQAGLER
EVLDHKEFKAR	EVLDHKEFK
LVWKPRPASAR	LVWKPASAR
FVQEAESRPR	FVQEESRPR
EVGPAGSQF	EVGPAGSQF
EVLKTRMALR	EVLKRMALR
EAVHDLLRPR	EAVHLLRPR
EVIKVIHGK	EVIKVIHGK
SVLEGMGFR	SVLEGMGFR
ETALNSKAYK	ETALNSKAY
TIIDIITHR	TIIDIITHR
EAMKHVYFR	EAMKHVYFR
ESFEGFIAR	ESFEGFIAR
EIKGTNGQVTR	EIKGTNGQV
EVAPVISSAY	EVAPISSAY
EAMDQYSIALR	EAMDYSIAL
DLYNGATR	DLY-NGATR
DIMAAVSGR	DIMAAVSGR
DTANDGFVR	DTANDGFVR
EIISERTKPR	EIISRTKPR
RNVSTGDVNVE	NVSTGDVNV
EVVDPLGKR	EVVDPLGKR
EAMASIINR	EAMASIINR
EMFTPILGR	EMFTPILGR
EAVLLLMQR	EAVLLLMQR
ELFAARSR	ELF-AARSR
DVFEAKAR	DVF-EAKAR
VPGPPGSSR	VPGPPGSSR
LSPRGPAPG	LSPRGPAPG
TVTMQVTAR	TVTMQVTAR
EAFSELSKR	EAFSELSKR
ETGLVTDAF	ETGLVTDAF
QGFFTGRGR	QGFFTGRGR
DVLQTGTQR	DVLQTGTQR
TVLFTGVRR	TVLFTGVRR
SIYEGDESFR	SIYEDESFR
EVQRILHQR	EVQRILHQR
NVNEVISNR	NVNEVISNR
SAPVGVTAL	SAPVGVTAL
ETIAPKIAR	ETIAPKIAR
ELARLKVHR	ELARLKVHR
DLHEHPLYR	DLHEHPLYR
DPFHKAIRR	DPFHKAIRR
NAPWAVTSL	NAPWAVTSL
EAAFFEGHFL	EAAFEGHFL
EVVTPNIFNSR	EVVTIFNSR
EIYRPPASR	EIYRPPASR
EIINIMQDR	EIINIMQDR
ETQVSDFLSGR	QVSDFLSGR
IVKPPASAR	IVKPPASAR
EVSYIVSSR	EVSYIVSSR
EVNYINTFR	EVNYINTFR
SVFGSGNTGR	SVFGGNTGR
QVIGPLTEGQR	QVIGPLTEG
EVAERLGVTR	EVAELGVTR
ETVSPTRAR	ETVSPTRAR
TLYERIVSR	TLYERIVSR
EVQGDRMHLR	EVQGRMHLR
SLVSPLSPR	SLVSPLSPR
SVLNFATNR	SVLNFATNR
LVNELTEFAK	LVNELTEFA
NAIGGKYNR	NAIGGKYNR
ELFHVEPGLQR	ELFHPGLQR
EVGPGAVGER	EVGPAVGER
HVLDLVSHPR	HVLDVSHPR
SVFPQNGAAR	SVFPNGAAR
EAFLHQQKR	EAFLHQQKR
DMAAQITQR	DMAAQITQR
EVAPPEYHRK	EVAPPEYHR
EQVPQALRR	EQVPQALRR
ESDFASTFR	ESDFASTFR
SVISSRNTGQR	SVISNTGQR
EIAGVKLLY	EIAGVKLLY
HIYAITDTAYR	YAITDTAYR
DLSSSSSLR	DLSSSSSLR
TVFRSTDFF	TVFRSTDFF
QAIKGMHIR	QAIKGMHIR
EAAPVVVGH	EAAPVVVGH
EAFENRLKGR	EAFERLKGR
EAAYGELR	EAA-YGELR
EAWFPGSGAFR	EAWFSGAFR
EAKGLDRINER	EAKGRINER
ETIGKKFEK	ETIGKKFEK
VVVSGKLR	VVV-SGKLR
EISRAAAER	EISRAAAER
EVIKPWITK	EVIKPWITK
TAMPPGTAR	TAMPPGTAR
AGPLRKSSL	AGPLRKSSL
EILGIANNR	EILGIANNR
ETSQAFAKK	ETSQAFAKK
EVWPHSTER	EVWPHSTER
EVLKHLKER	EVLKHLKER
YVNGSTYQR	YVNGSTYQR
EQILPTLVR	EQILPTLVR
LIIGPSKER	LIIGPSKER
EQLSGAGYR	EQLSGAGYR
APHWSKIGR	APHWSKIGR
EAFYTWQYR	EAFYTWQYR
EIGPVSSSRF	EIGPVSSSR
EVIAVKSAQNR	EVIASAQNR
ETSAPFKER	ETSAPFKER
QVVKPTAER	QVVKPTAER
SVASTPISQR	SVASPISQR
EAINITNNER	EAINTNNER
ETVQLRNPPR	ETVQRNPPR
QIGPVSSSR	QIGPVSSSR
YVAPELLKR	YVAPELLKR
EILNIRTKGR	EILNRTKGR
SPIDMTSKR	SPIDMTSKR
EVMQAVAR	EVM-QAVAR
ETAGSTSIPK	ETAGTSIPK
ESTGSIAKR	ESTGSIAKR
EVSAATGRF	EVSAATGRF
AVFFSRGSSFR	AVFFRGSSF
DSAPVETPR	DSAPVETPR
LADPTERF	LAD-PTERF
EVKSITKER	EVKSITKER
GVKVPGEYR	GVKVPGEYR
AVISRTMNR	AVISRTMNR
ESIGRVLAQR	ESIGVLAQR
EAMDDFMKR	EAMDDFMKR
ELYRVTREY	ELYRVTREY
ELRPPSRSR	ELRPPSRSR
ELIAASTQK	ELIAASTQK
EVFFSEKIY	EVFFSEKIY
FPVRPGSGR	FPVRPGSGR
EAGVGGRFR	EAGVGGRFR
SAFLSKRNPR	SAFLKRNPR
SAVAGRLER	SAVAGRLER
EASRAILQR	EASRAILQR
NAASPTSVR	NAASPTSVR
LVAQFPSSGR	LVAQPSSGR
EIIDLVLDR	EIIDLVLDR
ETHLPAQAR	ETHLPAQAR
EAIDSLRKSKR	EAIDLRKSK
EGIGSTVFR	EGIGSTVFR
ELAKDSELR	ELAKDSELR
TVVDAASLR	TVVDAASLR
DAAHPTNVQRL	DAAHTNVQR
AGLQFPVGR	AGLQFPVGR
EVSSMVLTK	EVSSMVLTK
EVANPDGDFRL	EVANDGDFR
ETFVSLHR	ETF-VSLHR
EANIFTKQR	EANIFTKQR
EAVKPTVGMKR	EAVKPTVGM
ETAQAIKGM	ETAQAIKGM
ESEEVRQFR	ESEEVRQFR
YVGEIIGKR	YVGEIIGKR
MVAHELSNR	MVAHELSNR
FVGTAGTVGR	FVGTGTVGR
SSALPTTGR	SSALPTTGR
ETAIPFRSR	ETAIPFRSR
QGYTQPGPGYR	YTQPGPGYR
EVFQNANFR	EVFQNANFR
ELVNPHRAR	ELVNPHRAR
VPDTIATLR	VPDTIATLR
TVVGDVGGR	TVVGDVGGR
EAAFIENLRR	EAAFIENLR
DVPSPFNHR	DVPSPFNHR
EVARYMVQR	EVARYMVQR
DPIEVVGQR	DPIEVVGQR
EAALGLER	EAA-LGLER
FVIKPKIQR	FVIKPKIQR
MAVEAGQSR	MAVEAGQSR
HVFGRSLLR	HVFGRSLLR
EAAVAFLFR	EAAVAFLFR
YVANVGTNR	YVANVGTNR
ELMDKPLTFR	ELMDPLTFR
EIYGGSDSRF	EIYGGSDSR
EAVTGITVSR	EAVTITVSR
AVISGVGTR	AVISGVGTR
EVRGGGLTR	EVRGGGLTR
EVEDTTLNR	EVEDTTLNR
EVAPPEYHR	EVAPPEYHR
ETFYVGAAK	ETFYVGAAK
EAVDISSKR	EAVDISSKR
VPAQPLGPR	VPAQPLGPR
QAAFFGSYR	QAAFFGSYR
DTIGYLLTR	DTIGYLLTR
EVQDLHLAQR	EVQDHLAQR
EVIRVTKKK	EVIRVTKKK
EFMIKTRRR	EFMIKTRRR
EIAVTGAGR	EIAVTGAGR
SAVGKLSSR	SAVGKLSSR
EIIPFPSTKM	EIIPPSTKM
EVVPEPVAR	EVVPEPVAR
GTYVSSVPR	GTYVSSVPR
EAHAPHYIAHR	HAPHYIAHR
EAFPSQGTKR	EAFPQGTKR
ETILRTNKR	ETILRTNKR
AVIDGMTDR	AVIDGMTDR
SVTDAVALR	SVTDAVALR
EVKRPGESL	EVKRPGESL
EVANSTANL	EVANSTANL
ELIKPPTILR	ELIKPTILR
IPVDASTSR	IPVDASTSR
EVAELGRGR	EVAELGRGR
EMVELAAQR	EMVELAAQR
DIYLTQILR	DIYLTQILR
SIIGKGGQR	SIIGKGGQR
MAAAGAAVARS	AAAGAAVAR
NVIHPFLSR	NVIHPFLSR
ESIEHPLAR	ESIEHPLAR
ELSDLHAHK	ELSDLHAHK
ELLQGGTSR	ELLQGGTSR
EVPSFTMGR	EVPSFTMGR
ETVDALRSR	ETVDALRSR
DLGAGSKKSPR	GAGSKKSPR
EAADAMSRL	EAADAMSRL
EAAVAIKAM	EAAVAIKAM
EILKAKPGLR	EILKKPGLR
EITSVGSSK	EITSVGSSK
EVVDKDSIR	EVVDKDSIR
ETIDVHSGY	ETIDVHSGY
EITKAFHVR	EITKAFHVR
LPYHTTDASLR	HTT-DASLR
EVTELAGYTAR	ELA-GYTAR
EVAETVFRDR	EVAEVFRDR
NVADLTSLR	NVADLTSLR
EVQGLGDGKR	EVQGGDGKR
EPHVSGVKR	EPHVSGVKR
TPAGGGFPR	TPAGGGFPR
DAQKPSLTR	DAQKPSLTR
EQYDLATKR	EQYDLATKR
ESIDKKISR	ESIDKKISR
EVLKDMGQR	EVLKDMGQR
DIIDPAILR	DIIDPAILR
ESAAELARR	ESAAELARR
ETAIPSSTRQA	ETAIPSSTR
SVVERNAR	SVV-ERNAR
VVMPPTRAR	VVMPPTRAR
EAVKLIIGR	EAVKLIIGR
EIADPTRFF	EIADPTRFF
TVFSPTLPAAR	TVFSPTLPA
SVMGVTVSR	SVMGVTVSR
EVAEHVQYM	EVAEHVQYM
ELISTTANYR	ELISTANYR
EFFLAGIGR	EFFLAGIGR
EVVTHKTFHR	EVVTKTFHR
VKGPGLQR	VKG-PGLQR
FIRDPSTSR	FIRDPSTSR
EVFPGRNR	EVF-PGRNR
FVAPPTAAV	FVAPPTAAV
EIGHIFGLR	EIGHIFGLR
EAAPPAEVHR	EAAPAEVHR
TVISRVIGR	TVISRVIGR
EAVTQSLLSSR	AVTQLLSSR
ELNDPMRQR	ELNDPMRQR
SVIDYQTHFR	SVIDQTHFR
DVYSGTPTK	DVYSGTPTK
EVGVIPSKR	EVGVIPSKR
SASHVSSFR	SASHVSSFR
EQVPGAREPR	EQVPAREPR
EISSPAVER	EISSPAVER
EVGGGVGGSSR	EVGGGGSSR
EIIAPSPQRSR	EIIAPSPQR
EVFESSVPQR	EVFESVPQR
ELVDPLTTVR	ELVDLTTVR
DSYSGLGR	DSY-SGLGR
TSSPSSIPR	TSSPSSIPR
DVRSVTSVR	DVRSVTSVR
TVIKQTMER	TVIKQTMER
ESSLPTGDR	ESSLPTGDR
LAAPASLRP	LAAPASLRP
YAAFVQTHR	YAAFVQTHR
ETGQVLGR	ETG-QVLGR
ESAEVPVAR	ESAEVPVAR
EYVGPRLSR	EYVGPRLSR
ESFDGSVRAR	ESFDSVRAR
EVAPVVTTEH	EVAPVTTEH
HVFLRTTGR	HVFLRTTGR
EVIEIMTDR	EVIEIMTDR
TPFGPLSSR	TPFGPLSSR
EVLPKPRMR	EVLPKPRMR
EVAVAGTEL	EVAVAGTEL
EVVSLLLDR	EVVSLLLDR
AEAALGLAR	AEAALGLAR
EIISKLQGR	EIISKLQGR
EIQTPENTPR	EIQTENTPR
SLVNFEPAAR	LVNFEPAAR
ETIEGMLLR	ETIEGMLLR
EIKDPSGLFY	EIKDPSGLF
EVNAATLLL	EVNAATLLL
DVQGALVNLR	DVQGLVNLR
TVSSATHYV	TVSSATHYV
EASQGFRFL	EASQGFRFL
EIAEAYLGK	EIAEAYLGK
ELVDRVLER	ELVDRVLER
EVAVESQRRL	EVAVESQRR
EVTTTVLVR	EVTTTVLVR
EVSNGSVVHR	EVSNSVVHR
EIIQAQLVNR	EIIQQLVNR
EQAELEKLKQR	EQAELEKLK
ESAWNLENR	ESAWNLENR
ETFSSATKRL	ETFSSATKR
ELKFKTGLR	ELKFKTGLR
ETRDGQVLGR	ETRDQVLGR
AVVAGGLGR	AVVAGGLGR
EVSETLVQR	EVSETLVQR
DVAHVNTVM	DVAHVNTVM
IILGPTKDR	IILGPTKDR
DLIAAVSTR	DLIAAVSTR
EVGLLFTNR	EVGLLFTNR
SVMGVTVSRL	SVMGVTVSR
DPLGAAANR	DPLGAAANR
SVAEERAGR	SVAEERAGR
SAPTETHSL	SAPTETHSL
EGIKVGHER	EGIKVGHER
EAHYSTKNPR	EAHYTKNPR
EAVQALRER	EAVQALRER
HSPGAVSSL	HSPGAVSSL
EPPPAPGAQR	EPPPPGAQR
EVGPGPGGITR	EVGPGGITR
ELMPPPPPK	ELMPPPPPK
EAAFANGKL	EAAFANGKL
TVTEKPEVID	TVTEKPEVI
EAFFHTQSSVR	EAFFQSSVR
FVTPVTNQR	FVTPVTNQR
EAFAIGARAR	EAFAGARAR
EVSFSVGGR	EVSFSVGGR
MVSSQTKTVR	MVSSTKTVR
HVAKIVTQR	HVAKIVTQR
TPAAGGFFR	TPAAGGFFR
EARAFGVTR	EARAFGVTR
SLADIMAKR	SLADIMAKR
ETSPFGAPR	ETSPFGAPR
SAAEVGFVR	SAAEVGFVR
ETSGFPSQR	ETSGFPSQR
VVGPPGATR	VVGPPGATR
VEHGPAAIR	VEHGPAAIR
EVVGIIESR	EVVGIIESR
EAQINTAKRL	EAQINTAKR
NLMGKTSER	NLMGKTSER
EAASMSQKRL	EAASMSQKR
EVRADTGGLGR	EVRADTGGL
ELIQDITQR	ELIQDITQR
EVGPKFRGV	EVGPKFRGV
EVVDVMVIGR	EVVDMVIGR
ESVGSMAKRL	ESVGSMAKR
DVSHPIIYR	DVSHPIIYR
DQGPTTKNL	DQGPTTKNL
ETYLNENLR	ETYLNENLR
DVVWETKPK	DVVWETKPK
EVLWNVWLE	EVLWNVWLE
YVIESARQR	YVIESARQR
APAAPAAPR	APAAPAAPR
DLSKSMSGR	DLSKSMSGR
GVAPVFKKR	GVAPVFKKR
EVLLVSSSR	EVLLVSSSR
EIPEHFGAVR	EIPEFGAVR
MVADVFSHRF	MVADVFSHR
EAASDSMKRL	EAASDSMKR
EGAFPNLAR	EGAFPNLAR
EVVGNMAVSR	EVVGMAVSR
HVVSEGVPR	HVVSEGVPR
EVYAGSHQY	EVYAGSHQY
EAYSVGTGR	EAYSVGTGR
SIPGGYNAL	SIPGGYNAL
DVFPGPSFR	DVFPGPSFR
LVGPDGVPLRR	LVGPGVPLR
EVFKDKPEAR	EVFKKPEAR
HVPVKEFNFR	VPVKEFNFR
SVIAKHLKGR	SVIAHLKGR
DVIDDASSR	DVIDDASSR
GAVDPSVQR	GAVDPSVQR
EVVDSLVGK	EVVDSLVGK
ELPVPTHRR	ELPVPTHRR
EVVEIQIDR	EVVEIQIDR
EIMEVAKER	EIMEVAKER
FTNKPTTFR	FTNKPTTFR
EVPPPGPAR	EVPPPGPAR
EVYVEVAYPR	EVYVVAYPR
EAFLTAQTK	EAFLTAQTK
QVSESGVHR	QVSESGVHR
QVAQFSTVR	QVAQFSTVR
DVFVVGTERGR	DVFVVGTER
EVLDPTAANR	EVLDTAANR
ELRQPPVKR	ELRQPPVKR
EQAFEVAER	EQAFEVAER
EAVQAKVLR	EAVQAKVLR
ETSSMASFR	ETSSMASFR
EVKVTIKR	EVK-VTIKR
EVTDVDSVVGR	EVTDSVVGR
DAIRGGLPK	DAIRGGLPK
KVVAARAPR	KVVAARAPR
QVYPIIAER	QVYPIIAER
VAPVTHVSV	VAPVTHVSV
EATLSVARR	EATLSVARR
HVMGFSVTGR	HVMGSVTGR
DIVLVGGSTR	DIVLGGSTR
EVHAVVTVR	EVHAVVTVR
EAVPKFEEM	EAVPKFEEM
EALGSGLVSR	EALGGLVSR
EAYIAMGQR	EAYIAMGQR
NVKVDPEIQ	NVKVDPEIQ
DVTNGGIKR	DVTNGGIKR
DNFFTGRKR	DNFFTGRKR
GVFEGIPTYR	GVFEIPTYR
EAMTVAIRR	EAMTVAIRR
EVALATGQF	EVALATGQF
EVFNKFFKER	EVFNFFKER
EVVDFIQSKI	EVVDFIQSK
NIINETTTR	NIINETTTR
IVGDPSTAK	IVGDPSTAK
FVISPPALR	FVISPPALR
EVGTASPMAR	EVGTSPMAR
DVYGGTNRY	DVYGGTNRY
HVAVPTHFF	HVAVPTHFF
FVFDRPVHRR	FVFDPVHRR
TVFGPTLLR	TVFGPTLLR
ELFAGKPVLR	ELFAKPVLR
ETSDFLGGLR	ETSDLGGLR
ETVEGLRKR	ETVEGLRKR
TVTPFTAQQR	TVTPTAQQR
DIFNQVVPR	DIFNQVVPR
ESYYQEIGR	ESYYQEIGR
EAADIIQKL	EAADIIQKL
ITPTGTHPL	ITPTGTHPL
HVIVDEIHER	VIVDEIHER
AVAPPAGPR	AVAPPAGPR
EVSFVIHNL	EVSFVIHNL
DPQGNTIYR	DPQGNTIYR
WVSADGFLR	WVSADGFLR
EVIFHVSTR	EVIFHVSTR
EVLPSPRGQR	EVLPPRGQR
ETAFLSWFR	ETAFLSWFR
EAGAIISTR	EAGAIISTR
ELVDRAVNR	ELVDRAVNR
YVYPDKTRPR	YVYPKTRPR
ELRENGINR	ELRENGINR
EFSPTFSER	EFSPTFSER
EIQHTTALR	EIQHTTALR
EAMTIFQNR	EAMTIFQNR
EIIQSTPYGR	EIIQTPYGR
DLYDAGVKR	DLYDAGVKR
ELAQWLIQR	ELAQWLIQR
EIYEFAATQR	EIYEAATQR
EPVSLGSLR	EPVSLGSLR
DIFKKSKPR	DIFKKSKPR
EVAELLLER	EVAELLLER
EAPPATQNF	EAPPATQNF
ETHFTGNEV	ETHFTGNEV
ELYNAPEGR	ELYNAPEGR
LPFGSSPHR	LPFGSSPHR
LQQAKEDL	LQQ-AKEDL
EVARLTQER	EVARLTQER
EPAEPLLVR	EPAEPLLVR
SAHFSRPTG	SAHFSRPTG
ELVNVLQER	ELVNVLQER
EIATVVKKR	EIATVVKKR
HVSLITPTKR	HVSLTPTKR
YSFFSPSPAR	SFFSPSPAR
EVAAPDVGR	EVAAPDVGR
EIYEYIIFR	EIYEYIIFR
EVFDFSQRR	EVFDFSQRR
EAVRTTLGPR	EAVRTLGPR
EAIDSEGHSYM	EAIDEGHSY
QVIKGVLFR	QVIKGVLFR
EVAPDVRLR	EVAPDVRLR
ELRDMSKNR	ELRDMSKNR
DVYTSLGQLR	DVYTLGQLR
TPFHGHVGR	TPFHGHVGR
DVKNAGDLR	DVKNAGDLR
PGPRPLAR	PGP-RPLAR
EVNDDILAR	EVNDDILAR
ELPEASAPK	ELPEASAPK
EMKGKVLTR	EMKGKVLTR
DVAEVDTVR	DVAEVDTVR
FVFGLPLER	FVFGLPLER
ETAGYLRGR	ETAGYLRGR
DLIAIVSNR	DLIAIVSNR
QAAQPTRWV	QAAQPTRWV
EVILATPYGR	EVILTPYGR
TVASKTQYF	TVASKTQYF
EAVEAAINRHR	EAVEAAINR
DTPGFIVNR	DTPGFIVNR
ENFLSRKR	ENF-LSRKR
AVAAVAARR	AVAAVAARR
SAISAAKTGVR	ISAAKTGVR
ETQLPVSFR	ETQLPVSFR
EVVQITWNR	EVVQITWNR
DVINPMALR	DVINPMALR
HVAQIYAIR	HVAQIYAIR
ELATAVKAR	ELATAVKAR
DVINSARTR	DVINSARTR
QIASVMKHR	QIASVMKHR
ESAPKASLR	ESAPKASLR
DVISNINITR	DVISINITR
DAAIVGAVR	DAAIVGAVR
TRLAAGSAVQR	LAAGSAVQR
VEADPGLR	VEA-DPGLR
ELASKSGLK	ELASKSGLK
EASAAGLIR	EASAAGLIR
DPVTSVGKR	DPVTSVGKR
ELQGHLGRR	ELQGHLGRR
EVFSIAGTVKR	EVFSAGTVK
EAVTDGLKR	EAVTDGLKR
DVFERPSAK	DVFERPSAK
EVAQVESLR	EVAQVESLR
ESVGGRVAER	ESVGRVAER
EAHFVPLVK	EAHFVPLVK
EIVNFSPIAR	EIVNSPIAR
EVQDRVMLTGR	EVQDMLTGR
ESFPSVNSR	ESFPSVNSR
ELYEKVFSR	ELYEKVFSR
DLFYNIATR	DLFYNIATR
DAGPPTHAF	DAGPPTHAF
NPIGQGAGR	NPIGQGAGR
SLSDFSWSQR	SLSDSWSQR
EVTRVKAVR	EVTRVKAVR
YTFYSISQER	YTFYISQER
DAASGSLLR	DAASGSLLR
FVVGTERGR	FVVGTERGR
VFDAKRLIGR	DAK-RLIGR
IAGDGSVFR	IAGDGSVFR
ETYPVSSPK	ETYPVSSPK
ETSHVTMVV	ETSHVTMVV
EAVGVDISGR	EAVGDISGR
ELRELGAAR	ELRELGAAR
ELAKVTIKK	ELAKVTIKK
TVVQNLMER	TVVQNLMER
EVIKQLKEK	EVIKQLKEK
VPFGAGRHR	VPFGAGRHR
HIDVITAEM	HIDVITAEM
EAAAIIAQR	EAAAIIAQR
ELNEVLQSR	ELNEVLQSR
EVVDFSSHY	EVVDFSSHY
YAPKGSSL	YAP-KGSSL
TVFHSLASR	TVFHSLASR
EVAPEIKASER	EVAPKASER
EFFGEGKTR	EFFGEGKTR
ETHAWFTSR	ETHAWFTSR
DVFVVGTER	DVFVVGTER
SVISGISSR	SVISGISSR
ELAAVINGR	ELAAVINGR
EAAAAALSVR	EAAAALSVR
EAAIGVTKR	EAAIGVTKR
EAVGVTSQR	EAVGVTSQR
DVYFPQISSVK	DVYFQISSV
DIFSEVVGR	DIFSEVVGR
EALRKMGLR	EALRKMGLR
EVGPEGALGK	EVGPGALGK
ETVNQMIAR	ETVNQMIAR
ELQDVGQSLR	ELQDGQSLR
ELFLAGRR	ELF-LAGRR
ETVERIFRR	ETVERIFRR
EVTEEGVRFR	EVTEGVRFR
EIINATTGR	EIINATTGR
DLREQTHSR	DLREQTHSR
ELSRLVSER	ELSRLVSER
EPVEVVAPR	EPVEVVAPR
EVIEGPQNAR	EVIEPQNAR
ELSPKVSER	ELSPKVSER
EPIAEPMRR	EPIAEPMRR
NIKNSSVPR	NIKNSSVPR
EVNQETIQR	EVNQETIQR
ELPTHPSKKR	ELPTPSKKR
EAAYIGSMR	EAAYIGSMR
EMVTISDASQR	VTISDASQR
EVAELTRLR	EVAELTRLR
EAFEFVKQR	EAFEFVKQR
SAITPGGLR	SAITPGGLR
EAIDSAENRF	EAIDSAENR
SIWDGSEVLR	SIWDSEVLR
IPSGVSGRR	IPSGVSGRR
EAHAQSIGMNR	EAHAQSIGM
ELWDSIMTR	ELWDSIMTR
LDIGEIKKR	LDIGEIKKR
TVIDVSTADR	TVIDSTADR
EVNQETIQRL	EVNQETIQR
EIISHDTRR	EIISHDTRR
SVLGPNAR	SVL-GPNAR
EVFDHMMKR	EVFDHMMKR
ELYNRMLKR	ELYNRMLKR
ETSQAGLFRLW	ETSQAGLFR
EVAASVIMR	EVAASVIMR
EMIGALKER	EMIGALKER
DTAAQITQR	DTAAQITQR
DPSGWWTGR	DPSGWWTGR
EVPPPPNLR	EVPPPPNLR
NVVTTPSTNR	NVVTPSTNR
ESFPRGGTR	ESFPRGGTR
EIVITGQHR	EIVITGQHR
EVAAVLLHF	EVAAVLLHF
ELIGSMKINGR	ELIGKINGR
QPAPPGSER	QPAPPGSER
TVAAVFRGR	TVAAVFRGR
ETTSIATAR	ETTSIATAR
EAFENLGKR	EAFENLGKR
YENEVALRQ	YENEVALRQ
ETTGTVTFR	ETTGTVTFR
EVFEYIIFR	EVFEYIIFR
DTHGSFVVR	DTHGSFVVR
EIFGTIGMR	EIFGTIGMR
EILHHLSER	EILHHLSER
EVISWGSGR	EVISWGSGR
EALTALMSR	EALTALMSR
EAGPGPRPLAR	EAGPGPRPL
EVEQLRMER	EVEQLRMER
EVVSGSGLTR	EVVSSGLTR
EVTPAMQIPR	EVTPMQIPR
QALKLVEGPD	QALKLVEGP
TLSPAFSTR	TLSPAFSTR
EIAMATVTALR	IAMAVTALR
EAVDILKTER	EAVDLKTER
TLIDPETLLPR	TLIDPETLL
LSDPSIPGR	LSDPSIPGR
EAVKSGIHR	EAVKSGIHR
SVHSPSTSM	SVHSPSTSM
EVAAMENVHR	EVAAENVHR
EQAELTGLR	EQAELTGLR
EIFQNEVAR	EIFQNEVAR
ELADFIRER	ELADFIRER
EIPKRFGQR	EIPKRFGQR
EAGPYGANM	EAGPYGANM
ETAFAFHLR	ETAFAFHLR
EVGSVVSFR	EVGSVVSFR
EVNDRPVRR	EVNDRPVRR
ETADITHAL	ETADITHAL
EVFTTLSVTKR	EVFTLSVTK
ELAIGGVLR	ELAIGGVLR
LPGPGSSLR	LPGPGSSLR
ESSDALLKR	ESSDALLKR
ELQSALLLR	ELQSALLLR
ESMEPKVFR	ESMEPKVFR
DAAKDSILR	DAAKDSILR
EVFTTTEGRTR	EVFTTTEGR
ELMGELQRR	ELMGELQRR
TSGLPSSVR	TSGLPSSVR
EAVASLATRI	EAVASLATR
EVYPEARKK	EVYPEARKK
EVFDNSMKR	EVFDNSMKR
AVIDVGINR	AVIDVGINR
IVQAPSGNR	IVQAPSGNR
EAALTYEASKR	EAALEASKR
MAIDGVAPR	MAIDGVAPR
LEADADPPLHR	EADAPPLHR
SVVEIASLR	SVVEIASLR
EVSSVSPLK	EVSSVSPLK
EAALGVAMR	EAALGVAMR
MVQQLGKA	MVQ-QLGKA
EVYESIYNR	EVYESIYNR
EATAMAMGR	EATAMAMGR
EVAPPRLVM	EVAPPRLVM
ELIKTVASR	ELIKTVASR
EAAMAFAYL	EAAMAFAYL
EVVEQGITR	EVVEQGITR
NVFVSANR	NVF-VSANR
EVASYQPLQR	EVASQPLQR
EVSFYNVTER	EVSFNVTER
QVAPPVLKR	QVAPPVLKR
ETVAIGGKR	ETVAIGGKR
GVIGQRMPR	GVIGQRMPR
SVPLAATSM	SVPLAATSM
EVTKLVHGR	EVTKLVHGR
EAQVVRVTR	EAQVVRVTR
EVSAEVRER	EVSAEVRER
VHAPSLRR	VHA-PSLRR
ELAQRLSNR	ELAQRLSNR
EVFHAGTSQR	EVFHGTSQR
VVGPVSLPR	VVGPVSLPR
ELADPTERFR	ELADTERFR
EAMQSLVTSSR	EAMQVTSSR
ESHTGILR	ESH-TGILR
EVAEESGRL	EVAEESGRL
SVASASTTR	SVASASTTR
EVAVETTTPK	EVAVTTTPK
ESTGVTTLR	ESTGVTTLR
EAGPSIVHR	EAGPSIVHR
EIYTGTSVAR	EIYTTSVAR
GVSPVITVR	GVSPVITVR
ELKQEGSLR	ELKQEGSLR
EQMGQMLTR	EQMGQMLTR
EIIEEHLANR	EIIEHLANR
EVSTVNVRR	EVSTVNVRR
ELSTGMPR	ELS-TGMPR
EAIGLLGGQK	EAIGLGGQK
ETFLAKSR	ETF-LAKSR
NVTGIAHRR	NVTGIAHRR
EVTGFGVTR	EVTGFGVTR
YVVGGSIPR	YVVGGSIPR
VLPEHVSVL	VLPEHVSVL
DVVKLTKNSKR	DVVKTKNSK
DSIEDRYPR	DSIEDRYPR
SVELVTQQM	SVELVTQQM
EVIKTRLQSSR	EVIKLQSSR
EAFKPILSTR	EAFKILSTR
ELMAGHLRNR	ELMAHLRNR
EIVPVLVSTR	EIVPLVSTR
TAAAPTLRR	TAAAPTLRR
EIGPVSSSR	EIGPVSSSR
DIIEKVMAR	DIIEKVMAR
ETIMSSSMGKR	TIMSSMGKR
EILEVATAR	EILEVATAR
DIQDPGVPR	DIQDPGVPR
ESVQITAER	ESVQITAER
EVKILGKER	EVKILGKER
DLIDNSFNR	DLIDNSFNR
DVLNPSGTQR	DVLNSGTQR
EVISRGGPR	EVISRGGPR
ELVGPLYAR	ELVGPLYAR
ELVSGGRSVR	ELVSGRSVR
EVGGEALGR	EVGGEALGR
EVFGVTDNPR	EVFGTDNPR
ESSPQYRLR	ESSPQYRLR
QDVDLSPIT	QDVDLSPIT
EAKPPTVTMPR	EAKPPTVTM
EVVEKKRARL	EVVEKKRAR
EIKHFVSER	EIKHFVSER
QAQKPSVPR	QAQKPSVPR
EPFGEISSR	EPFGEISSR
DIIQPSSTR	DIIQPSSTR
LIDIVSSQK	LIDIVSSQK
EAISVVAQRL	EAISVVAQR
ETWLSENQR	ETWLSENQR
EVLLGSAR	EVL-LGSAR
EIYKALSR	EIY-KALSR
ETIKGHSVR	ETIKGHSVR
EAARQKLALR	EAARKLALR
EVAGIINDAK	EVAGINDAK
TVKATGPALR	TVKAGPALR
SVAEISSHM	SVAEISSHM
EVAIPHNRR	EVAIPHNRR
EIFYTAIVNR	EIFYAIVNR
EMSGLPAAR	EMSGLPAAR
DIFLVRGGMR	DIFLRGGMR
DLFTSKGLFR	DLFTKGLFR
EIYGVTHTR	EIYGVTHTR
MVAPGSVTSR	MVAPSVTSR
EAVFIAHKR	EAVFIAHKR
AGSLLGSGQM	SLL-GSGQM
DTAGNDAFR	DTAGNDAFR
LVAQATATR	LVAQATATR
SVGGTSVTPR	SVGGSVTPR
TPSDINSPR	TPSDINSPR
ESGWRSALR	ESGWRSALR
ADAPVTQIGF	DAPVTQIGF
APRAPGLAR	APRAPGLAR
SVIQDMAVR	SVIQDMAVR
EAFREDLHNR	EAFRDLHNR
MVVDSSNTALR	VVDSNTALR
AEQRGEHALKD	EQRGEHALK
HVIRGYVGNR	HVIRYVGNR
EVKRPGESLR	EVKRGESLR
ETASNEVVYR	ETASEVVYR
EISGTFTHR	EISGTFTHR
DSFSAGEPR	DSFSAGEPR
TVALTAARGR	TVALAARGR
EAMDVTTTSTR	EAMDTTSTR
DVYRGLQER	DVYRGLQER
EVNEWFTKY	EVNEWFTKY
FVSSILPGNR	FVSSLPGNR
EAILPKGSAR	EAILKGSAR
HVVDIVALK	HVVDIVALK
EVTFVPGLYK	EVTFPGLYK
DVMPSGRSR	DVMPSGRSR
EIGNMITSR	EIGNMITSR
VATVSLPR	VAT-VSLPR
EPYPVSGAKR	EPYPSGAKR
EQPYKMAGR	EQPYKMAGR
EAFFSKTKR	EAFFSKTKR
EIKERIAKR	EIKERIAKR
HVYPQPGMQR	HVYPPGMQR
EAVRKLTAR	EAVRKLTAR
EVARAQAAL	EVARAQAAL
EVFSMAGVVVR	EVFSGVVVR
DLFFPGYSKGR	DLFFPGYSK
IIADSSTFR	IIADSSTFR
ELNVQISER	ELNVQISER
EAAPVSGYRA	EAAPVSGYR
EVFGTGAMR	EVFGTGAMR
EVFFSEKIYKL	EVFFEKIYK
EATSIKRVR	EATSIKRVR
TIIDAPGHR	TIIDAPGHR
EVQGPPAKK	EVQGPPAKK
EVVDRGAIR	EVVDRGAIR
ESVGDRELR	ESVGDRELR
SVINSVSTSR	SVINVSTSR
AADPGLPAR	AADPGLPAR
EAALRSHRRL	EAALRSHRR
DMFATPQYR	DMFATPQYR
TVIKVMTTR	TVIKVMTTR
EVSTGTVLR	EVSTGTVLR
VVAPRLNSR	VVAPRLNSR
MSSPPSAAR	MSSPPSAAR
EGAPATMTPKL	EGAPTMTPK
DTIDVSNLNR	DTIDSNLNR
EMIITKQGRR	EMIITKQGR
TPYAGGLFR	TPYAGGLFR
LVVHPGTAR	LVVHPGTAR
EVGPKTYIR	EVGPKTYIR
ETFQFILGK	ETFQFILGK
EATVLGQRR	EATVLGQRR
ESGPSIVHR	ESGPSIVHR
EAVGGLQTVR	EAVGLQTVR
EVKESPFFR	EVKESPFFR
TVRDAVVGR	TVRDAVVGR
DVNSGFAKR	DVNSGFAKR
EAAWAISNL	EAAWAISNL
SVVEPGRRR	SVVEPGRRR
EVFKEFIYR	EVFKEFIYR
EVISLSQVTPK	EVI-SLSQV
EAFKERVRGR	EAFKRVRGR
EMKLQVTQR	EMKLQVTQR
EVVAGEFGSR	EVVAEFGSR
EAYNETFSNR	EAYNTFSNR
EASNASSYL	EASNASSYL
EIIEAPMAWR	EIIEPMAWR
EVKQVESGTLR	EVKQSGTLR
ETREPPPAY	ETREPPPAY
TLWNSPSRNR	TLWNPSRNR
ESAPPSLRR	ESAPPSLRR
EVPETFLNRL	EVPETFLNR
MPHTSGMNRL	MPHTSGMNR
EAIGPSTIR	EAIGPSTIR
QTHFQLAYR	QTHFQLAYR
QIVPPGRQR	QIVPPGRQR
EVNQPKFNQR	EVNQKFNQR
AVVPFLPLQR	AVVPLPLQR
EAIEKHARFR	EAIEHARFR
EVASVWVER	EVASVWVER
EIAPMMERR	EIAPMMERR
EAVAALGNK	EAVAALGNK
EIYKPGLSR	EIYKPGLSR
EIASSLPAAQR	EIASPAAQR
YVMPSSSAR	YVMPSSSAR
AEGPEIPR	AEG-PEIPR
EAAAPPPGPR	EAAAPPGPR
HIMGEAMER	HIMGEAMER
DIIAKVTRR	DIIAKVTRR
EFIEITTER	EFIEITTER
ENFGNTTPR	ENFGNTTPR
IVRDQTELR	IVRDQTELR
EASKDGLFR	EASKDGLFR
VAPRSGLAA	VAPRSGLAA
DAILASSAR	DAILASSAR
EVPSFLVER	EVPSFLVER
EVLVTASR	EVL-VTASR
IAPTGHSL	IAP-TGHSL
EMFVGVGASR	EMFVVGASR
EGFFGLYR	EGF-FGLYR
LVGPVPAGR	LVGPVPAGR
EVVELLLAR	EVVELLLAR
EQISNLISR	EQISNLISR
EVGPKSTMV	EVGPKSTMV
EVFGTADLYR	EVFGADLYR
EIFHETGKR	EIFHETGKR
TTAPVVSTR	TTAPVVSTR
DLANVRVGR	DLANVRVGR
EVGPREAGLR	EVGPEAGLR
LAINGSANR	LAINGSANR
EPIAMTVPR	EPIAMTVPR
ELNPSTGNR	ELNPSTGNR
EQIDFSAAR	EQIDFSAAR
EVNIPTDLR	EVNIPTDLR
ELQGGFNGVSR	ELQGNGVSR
MVADVFSHR	MVADVFSHR
DIAVGTKR	DIA-VGTKR
ELRPQGSAR	ELRPQGSAR
HLPSGVKSL	HLPSGVKSL
EMRDGQVLGR	EMRDQVLGR
TYDDATKTF	TYDDATKTF
ELSFHSKGR	ELSFHSKGR
DVFISAAER	DVFISAAER
EAFSRPLSR	EAFSRPLSR
ESVDAFTFR	ESVDAFTFR
ETIELSPTGR	ETIESPTGR
EQGNRLFVGR	EQGNLFVGR
HVRDGSVVR	HVRDGSVVR
EQALIQYALR	EQALQYALR
LVVENSAQR	LVVENSAQR
EVAGQFVIK	EVAGQFVIK
EVAPTSTAV	EVAPTSTAV
DLAHITAR	DLA-HITAR
ELSPTGRPK	ELSPTGRPK
EPGPIRPSHR	EPGPRPSHR
ESYVGKLR	ESY-VGKLR
EVFPPTPVR	EVFPPTPVR
EVASFVTKR	EVASFVTKR
TVVGTSRLR	TVVGTSRLR
EAQYIRTER	EAQYIRTER
DVLGEGAHAR	DVLGGAHAR
EAIEGTYIDK	EAIETYIDK
EAAAIGALR	EAAAIGALR
EQVDTSVVSQR	EQVDVVSQR
GPREAGLR	GPR-EAGLR
QAVDVSPLR	QAVDVSPLR
EAAESIAFR	EAAESIAFR
EVIDDFMTRL	EVIDDFMTR
EAFDFVKQR	EAFDFVKQR
EAIEKLSKR	EAIEKLSKR
AGPSIVHR	AGP-SIVHR
DTAHTFSLR	DTAHTFSLR
EAQELFSVR	EAQELFSVR
EVKTPEFVSR	EVKTEFVSR
AIKGMHIR	AIK-GMHIR
DQNPDAALR	DQNPDAALR
TSGPIGGLR	TSGPIGGLR
EPIASRASRL	EPIASRASR
QIAEPSTSR	QIAEPSTSR
EAAAILMARL	EAAAILMAR
EMRDPALGR	EMRDPALGR
DVIRPGMRR	DVIRPGMRR
DLKGSTVAR	DLKGSTVAR
EIDVVSVEK	EIDVVSVEK
ETNTGEVYR	ETNTGEVYR
EPVSPSRER	EPVSPSRER
EAAEVLQNNR	EAAELQNNR
DVMASGTVKR	DVMAGTVKR
ITQIEHEVS	ITQIEHEVS
TTVGTLSQR	TTVGTLSQR
ETLKHSGIGR	ETLKSGIGR
MAVTALAAR	MAVTALAAR
EANSNAVRFR	EANSAVRFR
QVGGVTAYF	QVGGVTAYF
ETIYQNYQR	ETIYQNYQR
ETIKQLQER	ETIKQLQER
ELIQEITQR	ELIQEITQR
ETHGNLMTER	ETHGLMTER
NVHGGTILK	NVHGGTILK
LANDPTSLR	LANDPTSLR
EVVTGVIGQR	EVVTVIGQR
ELADPTERF	ELADPTERF
DVIGVTKGK	DVIGVTKGK
YIMPKPARR	YIMPKPARR
EAVLAMSSR	EAVLAMSSR
YVFPVSQKR	YVFPVSQKR
EAISLLNSER	EAISLNSER
ELFRPKDPQGR	ELFRDPQGR
EVAQTADARL	EVAQTADAR
AAAGPARPR	AAAGPARPR
EVFDKTYQF	EVFDKTYQF
ESIAAFIQR	ESIAAFIQR
EVTDYTTGR	EVTDYTTGR
SVQRPGLAR	SVQRPGLAR
QVVDKVTQR	QVVDKVTQR
EPVKELLRR	EPVKELLRR
HVHTMDFSPR	HVHTDFSPR
ELPGFVNYR	ELPGFVNYR
EVVYRFTAR	EVVYRFTAR
HIGKPSTIR	HIGKPSTIR
EAMGQLGSR	EAMGQLGSR
DTYVSSFPR	DTYVSSFPR
EAIRAMKVR	EAIRAMKVR
LPHGNVSAR	LPHGNVSAR
SVAPHETQTQR	APHETQTQR
ETVGTGIMGR	ETVGGIMGR
TAAFGHVQR	TAAFGHVQR
ELPIVTPALR	ELPITPALR
EATAAILSR	EATAAILSR
EAAFATKDRL	EAAFATKDR
ESAYNAFNR	ESAYNAFNR
EVLSDPQTR	EVLSDPQTR
EAFLASLSNR	EAFLSLSNR
EVYVWDVNSR	EVYVDVNSR
EVVDKSQVSR	EVVDSQVSR
DAFAYVQER	DAFAYVQER
EIVANVGKR	EIVANVGKR
EAHARIHLR	EAHARIHLR
ESFGVPKGR	ESFGVPKGR
AAAGLAGPR	AAAGLAGPR
AAVAAVAAR	AAVAAVAAR
EVLTDAAAR	EVLTDAAAR
EIGDASRVR	EIGDASRVR
EVAYDWSER	EVAYDWSER
IIHEIAVLEL	IIHEAVLEL
ETSQAGLFRL	ETSQAGLFR
EVVEDSLRQR	EVVESLRQR
EVVASAALR	EVVASAALR
EVGPPAFRI	EVGPPAFRI
EAIRTNYNDR	EAIRNYNDR
EASPGGLDR	EASPGGLDR
ETNYGIPQR	ETNYGIPQR
EAIQKKLSR	EAIQKKLSR
EASPVKRPRL	EASPVKRPR
SVISPVGNR	SVISPVGNR
AVAPGGATRL	AVAPGGATR
DTIDSLRSR	DTIDSLRSR
GGPGGVGGL	GGPGGVGGL
DITEPSIGR	DITEPSIGR
ELAVASFPK	ELAVASFPK
DLISPRQPRL	DLISPRQPR
ELLTSSKDR	ELLTSSKDR
EVFGQITER	EVFGQITER
ELIKNPAFK	ELIKNPAFK
EAALSPTFR	EAALSPTFR
DIFKSIDGNR	DIFKIDGNR
ELLNPTGTVR	ELLNTGTVR
WVSENFQER	WVSENFQER
SVAGLTAAAYR	SVAGLTAAA
EVIAVNTR	EVI-AVNTR
MAAPSWRGA	MAAPSWRGA
VELGSVWQRL	ELGSVWQRL
EPLPPTIGR	EPLPPTIGR
QVAPEATVR	QVAPEATVR
EVAKATSHI	EVAKATSHI
LSSKSGLSR	LSSKSGLSR
EQAFGGLTR	EQAFGGLTR
ELPSWILMR	ELPSWILMR
SLHNTPMGAR	SLHNPMGAR
DTAAWTVGR	DTAAWTVGR
ELFGRVTSR	ELFGRVTSR
EQAPIQSEPR	EQAPQSEPR
EAAWPHLQL	EAAWPHLQL
ELFPAPILR	ELFPAPILR
AAANPTLAF	AAANPTLAF
QPFGRGAMR	QPFGRGAMR
EVGPDAASLR	EVGPAASLR
EAVDISSKRM	EAVDISSKR
ETTSNITSR	ETTSNITSR
SFEDAKEAL	SFEDAKEAL
EAAGPQEALR	EAAGQEALR
ETGKITDFI	ETGKITDFI
ETMEPALR	ETM-EPALR
MVLAHVTNR	MVLAHVTNR
ELFHEARER	ELFHEARER
MPRQPSATR	MPRQPSATR
AEFVEVTK	AEF-VEVTK
HVPGSPFTAR	HVPGPFTAR
SVNASKPSER	SVNAKPSER
EATAGFTIGR	EATAFTIGR
ETNGEFGKR	ETNGEFGKR
EVAQPSEVLR	EVAQSEVLR
EAGPDAVLGR	EAGPAVLGR
DVKEGLQR	DVK-EGLQR
EAKAPILKR	EAKAPILKR
EATLGSGNLR	EATLSGNLR
EVGGGSGHRL	EVGGGSGHR
EGAGILLTR	EGAGILLTR
EVGNSGVFR	EVGNSGVFR
ELNKIFALR	ELNKIFALR
ETVEKWLKR	ETVEKWLKR
EAIQKSVTR	EAIQKSVTR
DTVATLSER	DTVATLSER
EFVDPSSLTAR	FVDPSLTAR
EVTDLLASF	EVTDLLASF
EVMGTGAVR	EVMGTGAVR
EVGGNTLGF	EVGGNTLGF
ELSAGLSKR	ELSAGLSKR
EAAEAGAEARL	EAAEGAEAR
EAVTSMGGK	EAVTSMGGK
SVIKEMLNRL	SVIKEMLNR
LPTAPRAAR	LPTAPRAAR
IVNRTIANM	IVNRTIANM
EAAPEYFRR	EAAPEYFRR
EAVNPTRFR	EAVNPTRFR
HLPETKFSEL	HLPEKFSEL
EIVKAIKER	EIVKAIKER
EVSSSLILR	EVSSSLILR
VVAPPGAPK	VVAPPGAPK
AAAEGTVGR	AAAEGTVGR
EANFTVSSM	EANFTVSSM
EAFQTTISK	EAFQTTISK
AAAPRGPR	AAA-PRGPR
DLNTGRMR	DLN-TGRMR
YVYDKNVLQR	YVYDNVLQR
ELSESLRNR	ELSESLRNR
FVTGNKILR	FVTGNKILR
EASWPHIQL	EASWPHIQL
EVRLGGSLR	EVRLGGSLR
TVIDIHTLR	TVIDIHTLR
EVTEIISQF	EVTEIISQF
NVIEKMLTDR	NVIEMLTDR
EAFVSHYR	EAF-VSHYR
HVYDGKFLAR	HVYDKFLAR
EAVMILRSR	EAVMILRSR
HVYPKNSVVR	HVYPNSVVR
EAAAPLRVR	EAAAPLRVR
EAAPPGELY	EAAPPGELY
TVSAAVAER	TVSAAVAER
EVYDIAFSR	EVYDIAFSR
EVHRPSHFL	EVHRPSHFL
DIYFNPKTR	DIYFNPKTR
EAIHQSQLRL	EAIHQSQLR
EVIALFDQTR	EVIAFDQTR
EAPKGMLAR	EAPKGMLAR
ELTDLHGLR	ELTDLHGLR
EILDSQNLNSR	EILDNLNSR
EVVNKRFVR	EVVNKRFVR
DVITALTHR	DVITALTHR
EAVKPTVGM	EAVKPTVGM
EVRKLIIRR	EVRKLIIRR
ELADHLVKR	ELADHLVKR
EVVHINRER	EVVHINRER
DMFTGRLR	DMF-TGRLR
ELSVVTSER	ELSVVTSER
EVNERHQILR	EVNEHQILR
EAIQTSHFQGR	EAIQHFQGR
DVMDSTTTQK	DVMDTTTQK
EVISTPGVVAR	EVISGVVAR
QAISPGMKR	QAISPGMKR
EGVPVRGAR	EGVPVRGAR
ELASGAPRPR	ELASAPRPR
EVMQAVQR	EVM-QAVQR
EVISKEILE	EVISKEILE
DAAPQLGKR	DAAPQLGKR
DAVEDRLDR	DAVEDRLDR
SVQGAGTSYR	SVQGGTSYR
EIIKKLIER	EIIKKLIER
EVAPAGASY	EVAPAGASY
EAFSVFGQVER	EAFSVFGQV
EILSDVASR	EILSDVASR
EVINDYHFR	EVINDYHFR
DAAIPSKSR	DAAIPSKSR
LVIKNSTSR	LVIKNSTSR
EVFAGVTTH	EVFAGVTTH
EVNEVSQNF	EVNEVSQNF
DIVKPGMRR	DIVKPGMRR
EAARSLPLGAR	EAARPLGAR
EVVIVSATR	EVVIVSATR
EVVRTIKER	EVVRTIKER
ETASAVATR	ETASAVATR
TVATQTQFF	TVATQTQFF
EVYTLAEHR	EVYTLAEHR
EIVSRVSKR	EIVSRVSKR
DIYEFLPSKR	DIYELPSKR
EVHGFSMGK	EVHGFSMGK
ELMGYIMGK	ELMGYIMGK
EVMGNPGTFK	EVMGPGTFK
KAPVTKVAA	KAPVTKVAA
ETIGEILKK	ETIGEILKK
DVNIKSTER	DVNIKSTER
DIMDSSLTR	DIMDSSLTR
EQFLTELTRL	EQFLTELTR
TLSSVTSAR	TLSSVTSAR
AAAGAFAGR	AAAGAFAGR
ELTAVVQKR	ELTAVVQKR
HVSGIGTRR	HVSGIGTRR
EAVFASEVK	EAVFASEVK
EVRFGGKKTQR	EVRFKKTQR
DVFRDPALK	DVFRDPALK
ELHLSTER	ELH-LSTER
ETFDFQAMGR	ETFDQAMGR
EAMEWVIHK	EAMEWVIHK
EQYGALGGTAR	YGALGGTAR
ETMGHSADRL	ETMGHSADR
EVIGLLGGRY	EVIGLLGGR
EVGPVLSKS	EVGPVLSKS
EIVDEKVRR	EIVDEKVRR
EANQQGTYRL	EANQQGTYR
ELAFYTPKLR	ELAFTPKLR
DAISYRFPR	DAISYRFPR
SVVEHRLRAR	SVVERLRAR
FVAELAAER	FVAELAAER
EAFDSTSRFAR	EAFDSTSRF
TVIDSQTHYR	TVIDQTHYR
SIPEKNRPL	SIPEKNRPL
EANATQLLR	EANATQLLR
EIGSTMSGR	EIGSTMSGR
KAPAPRPSL	KAPAPRPSL
ETFLAQRQR	ETFLAQRQR
EVLGPHLER	EVLGPHLER
EVVYDLSIR	EVVYDLSIR
SVFLYQSLR	SVFLYQSLR
ESAPSALEK	ESAPSALEK
EVYVGAVNR	EVYVGAVNR
EVYNEFVRKR	EVYNFVRKR
TVFESRNLR	TVFESRNLR
TSFFPTAGGFR	SFFPAGGFR
EVAQFLTGR	EVAQFLTGR
TIVNILTNR	TIVNILTNR
EIIDGTSEM	EIIDGTSEM
EAGEPTTLL	EAGEPTTLL
DVNLSHSER	DVNLSHSER
EISAPSQQR	EISAPSQQR
QVADVVVSR	QVADVVVSR
EAVTGVVGR	EAVTGVVGR
ELINFKRKR	ELINFKRKR
ETALNSKAY	ETALNSKAY
DTFFSNATR	DTFFSNATR
ETIDNGFGHSR	ETIDFGHSR
EVNNELANR	EVNNELANR
FVSPPTHGR	FVSPPTHGR
EVTNIITSK	EVTNIITSK
EIMELWSTR	EIMELWSTR
ETVGSIFSR	ETVGSIFSR
TVGGGEMAR	TVGGGEMAR
TVFFPLDTAR	TVFFLDTAR
EPAPGTNQR	EPAPGTNQR
IPGEESSLR	IPGEESSLR
TIFEEPRER	TIFEEPRER
ESAGAYAYK	ESAGAYAYK
EQVLPRDER	EQVLPRDER
EQINKLEAR	EQINKLEAR
AAIGPTTAR	AAIGPTTAR
DAWGPGAAK	DAWGPGAAK
TVQDPMTGR	TVQDPMTGR
DLASPLIGR	DLASPLIGR
DIWTTTANR	DIWTTTANR
SVAALTSKR	SVAALTSKR
EAQEVTIAR	EAQEVTIAR
MPIKLKIGLR	MPIKKIGLR
EQIRTLAAER	EQIRLAAER
ETAQAMAQL	ETAQAMAQL
IVVDPFDPR	IVVDPFDPR
TIIGVAAGR	TIIGVAAGR
EVFTPVFER	EVFTPVFER
EIVMETRQR	EIVMETRQR
EVHYHLPVAR	EVHYLPVAR
DIKEKSKFR	DIKEKSKFR
EVIPITDSELR	EVIPTDSEL
EVVVGTTR	EVV-VGTTR
EVNFTSELR	EVNFTSELR
DVYENLYAGR	DVYELYAGR
EVVGSVQGK	EVVGSVQGK
EVIKQRLTAR	EVIKRLTAR
EVIEALLKK	EVIEALLKK
EVGDIVVGR	EVGDIVVGR
DAAFIIGSGR	DAAFIGSGR
FMAEVGTNR	FMAEVGTNR
EVYPVGIFQKR	EVYPGIFQK
ELVNSGRLR	ELVNSGRLR
ELIDFKTRR	ELIDFKTRR
TVAGGAWTYK	TVAGAWTYK
EAGGSEIQR	EAGGSEIQR
TVIPPGLTR	TVIPPGLTR
EVQQARDLQNR	QQARDLQNR
EISHPDVGR	EISHPDVGR
ETAKATPRL	ETAKATPRL
TVFQFDVQR	TVFQFDVQR
EIGQAGSQR	EIGQAGSQR
EVFHSGHSR	EVFHSGHSR
EPVQLTFALR	EPVQTFALR
DVFGQATAVLR	DVFGATAVL
EVIPYTPAMQR	EVIPYTPAM
ETGDSSIFR	ETGDSSIFR
EVTGVLEGR	EVTGVLEGR
ETVGFGMLK	ETVGFGMLK
DVNNIGKYR	DVNNIGKYR
EIYDRREYSR	EIYDREYSR
EGIPPQQQR	EGIPPQQQR
TAVAALSGR	TAVAALSGR
IIVDIATKR	IIVDIATKR
EVAQETDGF	EVAQETDGF
EVLDRVFER	EVLDRVFER
DMNEPSVFR	DMNEPSVFR
DAVDVFETR	DAVDVFETR
EAHFVPLVKR	EAHFPLVKR
ELAQIYAQR	ELAQIYAQR
EAIQTRSRTR	EAIQRSRTR
EVVDKRNPM	EVVDKRNPM
EAIAKGIRR	EAIAKGIRR
EAVHAWRER	EAVHAWRER
EIVLVGGSTR	EIVLGGSTR
LTELRERRLGA	ELRERRLGA
IDAKLEKTSLN	DAKLEKTSL
EAFLAQAR	EAF-LAQAR
SINKPTSER	SINKPTSER
ETSPLTAEKL	ETSPLTAEK
PFGAGRHR	PFG-AGRHR
ELAPVFLLR	ELAPVFLLR
YVGRPSLNR	YVGRPSLNR
IDISDIAEKR	DISDIAEKR
ELFPGLIYR	ELFPGLIYR
ELVDRVFNR	ELVDRVFNR
LVTNQSQM	LVT-NQSQM
TVGGWVSTR	TVGGWVSTR
DAIKLWTNR	DAIKLWTNR
EVVELSSTR	EVVELSSTR
EAFFSKTKRF	EAFFSKTKR
VAQHPPARR	VAQHPPARR
TGNPTVVR	TGN-PTVVR
EAASPPALF	EAASPPALF
EVMQAVARL	EVMQAVARL
DPNKPSGFR	DPNKPSGFR
ESAGGLIQTAR	SAGGIQTAR
EVLLAEIGR	EVLLAEIGR
SAGPSTAKL	SAGPSTAKL
EIFVGKIPR	EIFVGKIPR
EIIEQPKQR	EIIEQPKQR
EIMEVAKERSR	EIMEVAKER
AVAFSASAR	AVAFSASAR
EVKPSIRAR	EVKPSIRAR
EAAERAIEKM	EAAERAIEK
QVFEKSPLR	QVFEKSPLR
ISPTGHSL	ISP-TGHSL
EVEYHPKFR	EVEYHPKFR
AVPEAIPTPR	AVPEIPTPR
ALPEIFTEL	ALPEIFTEL
EVTGVNVNMR	EVTGNVNMR
ELFSNIVPR	ELFSNIVPR
EAAKDLLYR	EAAKDLLYR
DITTPKAAR	DITTPKAAR
EVVDLLLAR	EVVDLLLAR
ESFLAWKKR	ESFLAWKKR
TVSGPGVAR	TVSGPGVAR
ELAVVREQR	ELAVVREQR
DVIDGPISQR	DVIDPISQR
ELFYSQHFSGR	ELFYHFSGR
EAGGRTLFR	EAGGRTLFR
EIFDHLVAHGR	EIFDVAHGR
EVVKAHPRF	EVVKAHPRF
TVFGATGFLGR	TVFGATGFL
DPGGGGLFR	DPGGGGLFR
EVGSIIGKK	EVGSIIGKK
DVYVPEASR	DVYVPEASR
AVIGIATKR	AVIGIATKR
SVHAPSLRR	SVHAPSLRR
ELRQATVAM	ELRQATVAM
EGAGAGSGFR	EGAGGSGFR
EAVLAAYWR	EAVLAAYWR
EANFPANVM	EANFPANVM
SVAPPGGSR	SVAPPGGSR
DVAAQQSLR	DVAAQQSLR
EVANIPVAR	EVANIPVAR
EIADSSMTR	EIADSSMTR
EIEVGGGR	EIE-VGGGR
DPFTGAGR	DPF-TGAGR
EVLLPSGQR	EVLLPSGQR
MVKFGGSGR	MVKFGGSGR
EAIGPVHQNR	EAIGVHQNR
EVFFLKATR	EVFFLKATR
EVYPFGIVGM	EVYPGIVGM
EVAEPSVLF	EVAEPSVLF
EVAAAVIQR	EVAAAVIQR
EIQAPTSSK	EIQAPTSSK
ETHFPFAIR	ETHFPFAIR
TASGIANLR	TASGIANLR
ESAGEGLGPR	ESAGGLGPR
EAFGLEGVFR	EAFGEGVFR
PAHVPGEAGPR	HVPGEAGPR
EAVQALRERL	EAVQALRER
DIINGDAIHKR	IINGAIHKR
EPADSHFVR	EPADSHFVR
EQMVLAHVTNR	MVLAHVTNR
EVLVTGAGR	EVLVTGAGR
FVAGLGKVR	FVAGLGKVR
ELALIYGTPR	ELALYGTPR
TAIKGVGRR	TAIKGVGRR
EISSNSLER	EISSNSLER
EVLHGLIGR	EVLHGLIGR
SVPEAQSAL	SVPEAQSAL
ELYAEKVATR	ELYAKVATR
DVAQSTHVLL	DVAQSTHVL
EIRSQPVPR	EIRSQPVPR
EAFGPEDGLQR	EAFGDGLQR
MIVRPSQPR	MIVRPSQPR
GVVGPQGAR	GVVGPQGAR
ELIKESEVK	ELIKESEVK
EVLQGGSQR	EVLQGGSQR
ETVPAFSER	ETVPAFSER
ELHFGEGVHR	ELHFEGVHR
EVAPHHLFLSH	EVAPHHLFL
EVTDYAIAR	EVTDYAIAR
ETNMYEGVGR	ETNMEGVGR
ETVAGALRR	ETVAGALRR
EVFSHILKR	EVFSHILKR
ETAEQGLLNR	ETAEGLLNR
EAGLPQGEAR	EAGLQGEAR
EVSLPKRGR	EVSLPKRGR
DVFEGSIIR	DVFEGSIIR
ETIIITGKR	ETIIITGKR
EVWIPKNGTRR	EVWIKNGTR
EAGLMALRER	EAGLALRER
EAAPEYFRRK	EAAPEYFRR
EVTGRSSVLR	EVTGSSVLR
DPKAPGLGAFR	KAPGLGAFR
ELSPGGQPR	ELSPGGQPR
SVSPSASFR	SVSPSASFR
DVFERPSAKK	DVFEPSAKK
EVAEGGLPRA	EVAEGGLPR
VPADAEALSER	ADAEALSER
EVRYQTEGF	EVRYQTEGF
SVENAPLAKR	SVENPLAKR
EAHNILSKR	EAHNILSKR
ESFGPQPISR	ESFGQPISR
AAADVGLTR	AAADVGLTR
EVLKETVSQR	EVLKTVSQR
EAAEKLKNR	EAAEKLKNR
ELFKELHTGR	ELFKLHTGR
DVFGTGASK	DVFGTGASK
GPIGPAGAR	GPIGPAGAR
ELAERLGLR	ELAERLGLR
EAYHRVFVNR	EAYHVFVNR
EVTDHNLHELR	EVTDNLHEL
EAAPEKDTVVR	EAAPDTVVR
FVYGSGVYR	FVYGSGVYR
ELIKVLIQR	ELIKVLIQR
ELVQTLLER	ELVQTLLER
EVAQPSREF	EVAQPSREF
ELIAIATGGR	ELIAATGGR
EIMPPPPKP	EIMPPPPKP
EVFYFEVTR	EVFYFEVTR
EVHYINDVER	EVHYNDVER
EVVTGVIGQRM	EVVTVIGQR
EIFYFEVTR	EIFYFEVTR
YVHTTVNEM	YVHTTVNEM
EVAAPDVGRM	EVAAPDVGR
EAHFHSLQHR	EAHFSLQHR
TIIEVNGKR	TIIEVNGKR
ETISTATGR	ETISTATGR
DLYLKPIQR	DLYLKPIQR
HVAESSLSRL	HVAESSLSR
QVHLGAAAQR	QVHLAAAQR
EMTGYVATR	EMTGYVATR
SSMFGTLPR	SSMFGTLPR
LPAEQGSPR	LPAEQGSPR
NVKGPGLQR	NVKGPGLQR
TAFYASRHSGR	YAS-RHSGR
ELFHQQGTPR	ELFHQGTPR
EILELAGNAAR	ELA-GNAAR
EINEISYPK	EINEISYPK
ELHGNLSQTQR	ELHGSQTQR
EVSGIKAAY	EVSGIKAAY
PFHKAIRR	PFH-KAIRR
AAAPGAHYR	AAAPGAHYR
EVVTSMGTQR	EVVTMGTQR
EAIGTLTAR	EAIGTLTAR
EVQVVNTER	EVQVVNTER
EQIKWSLLR	EQIKWSLLR
EVQVASQSSQR	QVASQSSQR
TIIEKPPAER	TIIEPPAER
EVFVGKIPR	EVFVGKIPR
ETAIPSSTR	ETAIPSSTR
ESTWPSRSR	ESTWPSRSR
DIQNPDITSSR	IQNPITSSR
EITIPMRSR	EITIPMRSR
EAAAALTRM	EAAAALTRM
YPYSPPTFR	YPYSPPTFR
DAYGSELVER	DAYGELVER
ESSAGGSFTVR	SAGGSFTVR
AAPEGVPL	AAP-EGVPL
TVLTHTPAPR	TVLTTPAPR
EVSDVEIITR	EVSDEIITR
HVKTGGKISLR	KTGGKISLR
ETYLMKHMR	ETYLMKHMR
SVVGFLSQR	SVVGFLSQR
NVAGSTLSR	NVAGSTLSR
ELWLVIHGR	ELWLVIHGR
EVFTPVVQR	EVFTPVVQR
ETSQAGLFR	ETSQAGLFR
EAILDIITSR	EAILIITSR
EPSEVFINR	EPSEVFINR
ELIQDAAAR	ELIQDAAAR
YSGPTSVSR	YSGPTSVSR
EVKEVAGIK	EVKEVAGIK
EASDPRIIR	EASDPRIIR
ETSGPTYIK	ETSGPTYIK
TADGVPVSSR	TADGPVSSR
EIHQDWANR	EIHQDWANR
QVAGITGAR	QVAGITGAR
ELSPQRNLR	ELSPQRNLR
SVIGAREER	SVIGAREER
DTFWKGTTR	DTFWKGTTR
EAAPVSGYR	EAAPVSGYR
EVDAAMAAR	EVDAAMAAR
ELFQSSFR	ELF-QSSFR
EVTAAQVAR	EVTAAQVAR
ELGFSKVFR	ELGFSKVFR
MVLQVSAAPR	MVLQSAAPR
ETVPAPSANK	ETVPPSANK
TVGKATGFL	TVGKATGFL
EVSPPNLRGR	EVSPNLRGR
EIKSLTKER	EIKSLTKER
PFDITVMIR	PFDITVMIR
ETSALPRPR	ETSALPRPR
FTYVGGPR	FTY-VGGPR
ELRELSGHR	ELRELSGHR
EQAFQTIAR	EQAFQTIAR
EAVLNVALR	EAVLNVALR
ETFISLVSIR	ETFILVSIR
ESNPPSLMR	ESNPPSLMR
SVSPVVHVR	SVSPVVHVR
SPFAGALR	SPF-AGALR
TAGIIGVNR	TAGIIGVNR
ELLDRPGAER	ELLDPGAER
EPSDPMLWR	EPSDPMLWR
EASPSSLHF	EASPSSLHF
EVNAWLVHR	EVNAWLVHR
EVSPVALQRL	EVSPVALQR
EAAAVHGARF	EAAAVHGAR
HVAESSLSRLR	HVAESSLSR
ELPGSSAVR	ELPGSSAVR
DVGPTSHNR	DVGPTSHNR
EVAQAGKAV	EVAQAGKAV
AVIGYLSTR	AVIGYLSTR
YPYSPPAFR	YPYSPPAFR
EPAGVQTLR	EPAGVQTLR
EVVVSVPQR	EVVVSVPQR
QLAQFHFTNR	QLAQHFTNR
EVRAVGQGVLR	EVRAQGVLR
EAEVASLNR	EAEVASLNR
TAAGGFQQR	TAAGGFQQR
TVVGSSKFR	TVVGSSKFR
ESIDPQFTIRR	ESIDQFTIR
SVVEIASLRF	SVVEIASLR
NVYGQITVR	NVYGQITVR
HAAEYGAEALE	HAAEGAEAL
ETFRSSDPATR	ETFRDPATR
EAMASIINRL	EAMASIINR
ELSNGSMVR	ELSNGSMVR
DSAQQGLYR	DSAQQGLYR
ELKQLAAAR	ELKQLAAAR
SAPYGRITL	SAPYGRITL
EAFVGAER	EAF-VGAER
EAAPPGELYR	EAAPGELYR
ETALIDRTGR	ETALDRTGR
EAAGASKAL	EAAGASKAL
EIAPMMERRM	EIAPMMERR
DVVSKFLNR	DVVSKFLNR
EVFIGESLSSR	FIGESLSSR
RPFRGSVGR	RPFRGSVGR
EAVFNPQSR	EAVFNPQSR
EPYANPTKR	EPYANPTKR
EVLVAGFGR	EVLVAGFGR
ELPDVSEFMTR	ELPDVSEFM
NAFVTGIAR	NAFVTGIAR
ESHVSGISR	ESHVSGISR
FVIDSDHLGHR	FVIDHLGHR
EQVDGVSYR	EQVDGVSYR
QVVPVSSHR	QVVPVSSHR
HVFHPKRAVFR	HVFHPKRAV
EIPENFTTR	EIPENFTTR
QAPQPQSSL	QAPQPQSSL
FVYGEPVTR	FVYGEPVTR
NTAPSLSSR	NTAPSLSSR
EVIGSKLNISR	EVIGSKLNI
QAKIPGLKR	QAKIPGLKR
ETIEGMLLRL	ETIEGMLLR
EVGPPLPPLL	EVGPPLPPL
VPTSLELQR	VPTSLELQR
ESIDALSNK	ESIDALSNK
DVVDSEALQVY	DVVDEALQV
DLAKPRLSR	DLAKPRLSR
DVYQAVSKR	DVYQAVSKR
EVRDPLVTY	EVRDPLVTY
SPISAQDLLSR	ISAQDLLSR
EVVNYVQKR	EVVNYVQKR
AAGPVAAPR	AAGPVAAPR
VPADYPAQSPL	ADYPAQSPL
ETIHADSVAKR	TIHASVAKR
LPNDRSSQR	LPNDRSSQR
EVAVAGTELFR	EVAVAGTEL
DLFVFPYR	DLF-VFPYR
EVAEFLAR	EVA-EFLAR
DLREQTHTR	DLREQTHTR
DVIELKGVSAR	ELK-GVSAR
DIYDRKNMPR	DIYDKNMPR
SVFTVEGGHR	SVFTEGGHR
DVVGRFNER	DVVGRFNER
ELAGHTGYL	ELAGHTGYL
ILADATAKM	ILADATAKM
EVAKQALNRL	EVAKQALNR
DPFFGGMTR	DPFFGGMTR
EINKLLAHR	EINKLLAHR
EGVGILLTR	EGVGILLTR
DTVAQITQR	DTVAQITQR
ELAEKALGK	ELAEKALGK
EVVQSSPVER	EVVQSPVER
VSPYTEIHL	VSPYTEIHL
EAIKNNAGFR	EAIKNAGFR
VGKDPGLAGR	VGKDGLAGR
YVISQMLSAR	YVISMLSAR
ESIDQYIER	ESIDQYIER
EVKGPGVGL	EVKGPGVGL
DIMDSSLTRR	DIMDSSLTR
QTVGPSHAR	QTVGPSHAR
EAIPGLAAR	EAIPGLAAR
ESTTVATRRL	ESTTVATRR
IVKGPRGTLR	IVKGRGTLR
AVTPPGLAR	AVTPPGLAR
ESAQDFASR	ESAQDFASR
TVVEDVTVGR	TVVEVTVGR
EVLQPLQQR	EVLQPLQQR
AEQRGENALKD	EQRGENALK
FIFEHIIKR	FIFEHIIKR
EAIKALEVR	EAIKALEVR
FIFQGNPYFR	FIFQNPYFR
QVPLVAGTVNR	LVA-GTVNR
SIVEFQPTLR	SIVEQPTLR
EVIKAMTKAR	EVIKMTKAR
EVHAVGLYGAR	HAVGLYGAR
EAVAPEFTNR	EAVAEFTNR
DAYWPEAKR	DAYWPEAKR
EIFFGKTR	EIF-FGKTR
EIYSFSESLR	EIYSSESLR
DVYTPKSSR	DVYTPKSSR
EAAFATKDRLR	EAAFATKDR
EAAFATKDR	EAAFATKDR
YVFSADPIAR	YVFSDPIAR
DTIEIITDR	DTIEIITDR
ETVEDIAAR	ETVEDIAAR
MVYQKAAMR	MVYQKAAMR
EAYLPETFR	EAYLPETFR
MAPERVASL	MAPERVASL
ETSGISIYRL	ETSGISIYR
LVHKPSEER	LVHKPSEER
ELFSHPVER	ELFSHPVER
LEAGGTGPVR	EAGGTGPVR
EVAIPLPAR	EVAIPLPAR
ELKLIGEYGLR	KLIGEYGLR
EQPEIHTGR	EQPEIHTGR
EIIDKRRER	EIIDKRRER
ELSQNISAR	ELSQNISAR
DVKFGADAR	DVKFGADAR
TVVTGTLER	TVVTGTLER
VVFGGGEAR	VVFGGGEAR
QVYTQNAEMR	QVYTQNAEM
AAPATRAAL	AAPATRAAL
EVIAYILER	EVIAYILER
EAFDSTSRF	EAFDSTSRF
DAFFNPATR	DAFFNPATR
ELVEPSSVALR	ELVESSVAL
EAYIGKMR	EAY-IGKMR
ETAGSTKYRL	ETAGSTKYR
EIMQETGTR	EIMQETGTR
SVAKTILKR	SVAKTILKR
VAVTPFSLR	VAVTPFSLR
ELGPASPR	ELG-PASPR
EVTGEAALR	EVTGEAALR
DIIQRMHLR	DIIQRMHLR
EAHESTGIF	EAHESTGIF
SVIQTAGYR	SVIQTAGYR
EPADSGLERL	EPADSGLER
EVIPPMKEF	EVIPPMKEF
DVRMGGSFR	DVRMGGSFR
ESHPGTLLR	ESHPGTLLR
MLVDPKHHR	MLVDPKHHR
SASLPSSGR	SASLPSSGR
QPSDPSLGR	QPSDPSLGR
SVHVPGMNR	SVHVPGMNR
EAFRELGR	EAF-RELGR
EVFRSYVFY	EVFRSYVFY
EVMFPKNVR	EVMFPKNVR
EIVDQIKTR	EIVDQIKTR
EVYDPLSKR	EVYDPLSKR
EPFKGEMNR	EPFKGEMNR
GVADALLYR	GVADALLYR
EAVFGTPR	EAV-FGTPR
EVNATGVAM	EVNATGVAM
ELRNASAVM	ELRNASAVM
EMREMLTHR	EMREMLTHR
FVHVAITNR	FVHVAITNR
EAASLRVLER	EAASRVLER
QVFPGLLER	QVFPGLLER
EVAQLIQGGR	EVAQIQGGR
SAGGSFTVR	SAGGSFTVR
EAADTIGQMR	EAADIGQMR
DPHSPSRFR	DPHSPSRFR
EAAAASAFL	EAAAASAFL
ETAEAYLGK	ETAEAYLGK
ELVNAARLR	ELVNAARLR
PQGAPTAMQR	QGAPTAMQR
EVSLPKTSR	EVSLPKTSR
EVYRSTKRL	EVYRSTKRL
EASEATLFY	EASEATLFY
NVREPTFVR	NVREPTFVR
EVGPREAGLRR	EVGPEAGLR
EAASDSMKRLQ	EAASDSMKR
ETSPLTAEK	ETSPLTAEK
ETIKSLLIR	ETIKSLLIR
ELVTKAGFR	ELVTKAGFR
DVYPEIIER	DVYPEIIER
EAQNLTRGR	EAQNLTRGR
ETALPSTKA	ETALPSTKA
EIIEQPRQR	EIIEQPRQR
EVPREKLASR	EVPRKLASR
EISESGMTVR	EISEGMTVR
ETSNLIIMR	ETSNLIIMR
EAGGPLTPR	EAGGPLTPR
TAMLPSSQR	TAMLPSSQR
EVAGIVAAR	EVAGIVAAR
LASQPSIPR	LASQPSIPR
EPIATFYGLR	EPIAFYGLR
DLIFKTGGR	DLIFKTGGR
ETVALDAKR	ETVALDAKR
FASQGGLAR	FASQGGLAR
EVAGFVLNRL	EVAGFVLNR
EVNEQTHFA	EVNEQTHFA
EIVGNLPSAMR	EIVGLPSAM
SVGRQSSAPA	SVGRSSAPA
DSAPPSSVAR	DSAPSSVAR
HVHDRKILHR	HVHDKILHR
EVVSGVVSK	EVVSGVVSK
EVAVVTTER	EVAVVTTER
EQIDNLSTR	EQIDNLSTR
EVYVPHPR	EVY-VPHPR
EAIISGKQR	EAIISGKQR
TAGPHTQFV	TAGPHTQFV
EAAPGKSEL	EAAPGKSEL
EVTYKYTYR	EVTYKYTYR
ESTPITAVK	ESTPITAVK
YVFGGVRSR	YVFGGVRSR
