Data	Data aligned
PKEKQPVA	PKEK-QPVA
RPRAPIIAV	RPRAPIIAV
RVQEALRVA	RVQEALRVA
VPVDTGVAA	VPVDTGVAA
MPTTLEGA	MPTT-LEGA
LGLPHNQLA	LGLPHNQLA
KPNPNQIISV	KPNPNIISV
KPKVPLKSA	KPKVPLKSA
LPAARAGPVA	LPAARGPVA
TPYVAKISA	TPYVAKISA
QPTPQVPQV	QPTPQVPQV
SPSPKLQNSA	SPSPKQNSA
IPYQDLPHL	IPYQDLPHL
KAKKPALVA	KAKKPALVA
APRGPGAELQA	APRGPGAEL
SPASRIPPP	SPASRIPPP
FPHLRVLEA	FPHLRVLEA
VPRPPSNPPA	VPRPPNPPA
SPHLPGTSSA	SPHLPTSSA
VPQAQPTKPA	VPQAQTKPA
APVLPHTAV	APVLPHTAV
LPRHRLDA	LPRH-RLDA
EPQPEPVA	EPQP-EPVA
RPVLPRTEA	RPVLPRTEA
TVYEGFISA	TVYEGFISA
SPLKHFVTA	SPLKHFVTA
LVVPSRPA	LVVP-SRPA
RPIPNQPPTA	RPIPNPPTA
IVKPVKVSA	IVKPVKVSA
TPKPPGTGPVP	TPKPPGTGP
LPHQLPEA	LPHQ-LPEA
RPFNLAERKA	RPFNLERKA
RAHLPTKEA	RAHLPTKEA
LPFSSMPTA	LPFSSMPTA
SPSSSSLAA	SPSSSSLAA
LPRTPTPA	LPRT-PTPA
VPSPRLAAA	VPSPRLAAA
TPYGYFLISA	TPYGYLISA
IPHSLPGA	IPHS-LPGA
APAPPKAEA	APAPPKAEA
IIKEVLLEA	IIKEVLLEA
SPISVAAA	SPIS-VAAA
TPFKGVRKA	TPFKGVRKA
AAGPVGMAA	AAGPVGMAA
SPLYLAHEV	SPLYLAHEV
SPYSSVSA	SPYS-SVSA
SAKTPGFSV	SAKTPGFSV
APRAAREAL	APRAAREAL
APSVGIKAA	APSVGIKAA
APVPTAPAA	APVPTAPAA
SPDEGALVRAA	SPDEGLVRA
SPMPFHPSQV	SPMPFPSQV
TPVRLPSI	TPVR-LPSI
VPSAVLIVA	VPSAVLIVA
APRAPRALAAA	APRAPALAA
RPRFVSLRA	RPRFVSLRA
SPVPIAPTA	SPVPIAPTA
IPTENSMTA	IPTENSMTA
QPWRGGAGA	QPWRGGAGA
HPAAFPLPVV	HPAAFLPVV
RPKSSDVYV	RPKSSDVYV
HPAPTRKIAV	HPAPTKIAV
HPYLFPVAAM	HPYLFPVAA
APKLGSNIA	APKLGSNIA
KPKIFIIQA	KPKIFIIQA
LPRPQGAAA	LPRPQGAAA
TPKPIPILA	TPKPIPILA
TPNTPRNLA	TPNTPRNLA
SPTPEPGV	SPTP-EPGV
IPFYGILGA	IPFYGILGA
QPYYATRVNAA	QPYYARVNA
APWRPPPP	APWR-PPPP
HPRLRPQSA	HPRLRPQSA
SIPEKNRPL	SIPEKNRPL
GPFPGKFNEV	GPFPGFNEV
RPKFLSKTV	RPKFLSKTV
KPLPPIQVA	KPLPPIQVA
RVRDVFEAKA	RVRDVEAKA
SPSPPSVAV	SPSPPSVAV
KPHSGFHVA	KPHSGFHVA
KPKVMEGTVAA	KVMEGTVAA
VPKEGKVVDA	VPKEGVVDA
RPNFNIKGIRF	RPNFNIKGI
KPLEKPLKL	KPLEKPLKL
SPYVHLLDA	SPYVHLLDA
IPFLVPGIRY	IPFL-VPGI
LPNQTVLKI	LPNQTVLKI
LPHHRVIEV	LPHHRVIEV
IPASDLPQVR	IPASDLPQV
RPKPPNVR	RPKP-PNVR
TPFTGPFISV	TPFTGFISV
RPWLRPAAL	RPWLRPAAL
VPYLVGQVV	VPYLVGQVV
SPLESWLTA	SPLESWLTA
TPHFSGLAA	TPHFSGLAA
RPYHTIIEI	RPYHTIIEI
APVGIALIA	APVGIALIA
RPVDPIRAA	RPVDPIRAA
RPRPGDSLPS	RPRPGSLPS
QPYAPPRDFAA	QPYAPRDFA
LPKPHGIRAL	LPKPHGIRA
VPRKLIVA	VPRK-LIVA
APITGQVSA	APITGQVSA
MPLSTIREV	MPLSTIREV
QPYPLPHV	QPYP-LPHV
KPMEGWIAV	KPMEGWIAV
VNLPINGNGKQ	LPINGNGKQ
LPHSAGRYAA	LPHSAGRYA
VPTKRPPV	VPTK-RPPV
HPARLTIEA	HPARLTIEA
KPKPVKPVTF	KPKPVKPVT
RPIDTSRLT	RPIDTSRLT
APRPPVSAA	APRPPVSAA
KPFAFGNSSA	KPFAFNSSA
SPREPGYKA	SPREPGYKA
MPNPQLNIKA	MPNPQNIKA
SPTVIVMV	SPTV-IVMV
SPTKKVAVA	SPTKKVAVA
TPLGGIQAA	TPLGGIQAA
IPNSIMTILEA	IPNSIILEA
RPRHQGVMV	RPRHQGVMV
SPRPALVRSA	SPRPAVRSA
LPRLDTGTA	LPRLDTGTA
RPLSGSGISA	RPLSGGISA
IPAGTVTVNAA	IPAG-TVTV
MPVRGGTRLA	MPVRGTRLA
NPKVQASLSA	NPKVQSLSA
SPFFPLVSA	SPFFPLVSA
SPLASGAVA	SPLASGAVA
SPGLHLGSA	SPGLHLGSA
VPYGTPLSVNF	VPYGTPLSV
VPLATAPMA	VPLATAPMA
PLKGARIA	PLKG-ARIA
VPYGTPLSV	VPYGTPLSV
KPLKGARIA	KPLKGARIA
MPNGDHIVSA	MPNGDIVSA
LAHAAFSAA	LAHAAFSAA
SPDGRWLISA	SPDGRLISA
SPAAPVITA	SPAAPVITA
KPHGPRTLYA	KPHGPTLYA
TPRPLTSARA	TPRP-LTSA
SPMSADRVVA	SPMSARVVA
IPKYPTNPP	IPKYPTNPP
RPKPPNVRTA	RPKPPVRTA
VPTDYSVSA	VPTDYSVSA
HPITAKAIA	HPITAKAIA
VPAPSVPSV	VPAPSVPSV
LLRGVGAAA	LLRGVGAAA
RPKIGLPGV	RPKIGLPGV
SPYGGGRPG	SPYGGGRPG
TPQGHVAVA	TPQGHVAVA
RPRPGTGLG	RPRPGTGLG
NPMVVANAV	NPMVVANAV
KPKPGHTPIF	KPKPGHTPI
KPIFSLNTV	KPIFSLNTV
RPAPVLVSA	RPAPVLVSA
KPKPAGVLGA	KPKPAVLGA
PHPATGKTV	PHPATGKTV
HPHPFLNSV	HPHPFLNSV
LPSKTPEG	LPSK-TPEG
SVRDPSPEA	SVRDPSPEA
YPQLLPGIR	YPQLLPGIR
IPYAHSPSVR	IPYAHSPSV
APREPVGWPA	APREPGWPA
RPITPPRNSA	RPITPRNSA
FPKQPGTSGA	FPKQPTSGA
MPPPVGMVA	MPPPVGMVA
IPLYLKGGVA	IPLYLGGVA
SPHQHGLLA	SPHQHGLLA
SPNENFKTV	SPNENFKTV
KPMEKLLGL	KPMEKLLGL
TPVYLGATA	TPVYLGATA
KPAPPFNVT	KPAPPFNVT
LVKDVFISAA	LVKDVFISA
KPLLIRGV	KPLL-IRGV
RPRPGRNPP	RPRPGRNPP
SPILVATAV	SPILVATAV
IPVKSSPQA	IPVKSSPQA
RPKPSRPTP	RPKPSRPTP
VPVSTINHA	VPVSTINHA
QPHDPLVPLSA	QPHDPPLSA
APMPTASTA	APMPTASTA
APHTWPHIVA	APHTWHIVA
KPKPPPVRA	KPKPPPVRA
RPKGLEGERPA	RPKGLERPA
RPRNLAAA	RPRN-LAAA
IPEEQPVA	IPEE-QPVA
TPTPVPVV	TPTP-VPVV
SPINRIVQI	SPINRIVQI
APFGKISDA	APFGKISDA
LARPPSGRA	LARPPSGRA
TPWFKIIAA	TPWFKIIAA
MPVENGLRA	MPVENGLRA
LPWQGLKAA	LPWQGLKAA
APYAKGFGVAA	APYAKFGVA
TTYKLVINGK	TTYKLINGK
APKIGSNGV	APKIGSNGV
KPMKSVLVVA	KPMKSLVVA
NPTQFVPAA	NPTQFVPAA
TPLSKLMKA	TPLSKLMKA
APAEPGWKA	APAEPGWKA
APKSPSQDVKA	APKSPSQDV
RVKIQTVAA	RVKIQTVAA
APKPPPPPP	APKPPPPPP
ISPTGHSL	ISPT-GHSL
IPKKMSHMA	IPKKMSHMA
RPKPPNVRT	RPKPPNVRT
LPRDRQVVA	LPRDRQVVA
VPRQPTVTSV	VPRQPVTSV
KPPAILPVA	KPPAILPVA
RPTPQLRA	RPTP-QLRA
QPILLELEA	QPILLELEA
MPHPATGKTVA	HPATGKTVA
KPKEVKPKIP	KPKEVKPKI
SPLPAHPSV	SPLPAHPSV
IPKSFMISA	IPKSFMISA
SPALPSSGA	SPALPSSGA
TPYRPPAAA	TPYRPPAAA
MPRLIAKV	MPRL-IAKV
KPFAYVSEA	KPFAYVSEA
LAAGPSAAA	LAAGPSAAA
HPTEDLVVSA	HPTEDVVSA
RPAPALAPAA	RPAPAAPAA
KPKEVTTVKV	KPKEVTVKV
SPVPGAPKA	SPVPGAPKA
YPKGLGSTV	YPKGLGSTV
MPHPATGKTV	MPHPAGKTV
HPFERIATP	HPFERIATP
APPEYHRKAV	APPEYHRKA
RPYDKNISP	RPYDKNISP
LPDATSSHRTV	LPDATSHRT
LPNAVITRI	LPNAVITRI
IPLPLEPQV	IPLPLEPQV
IPSKKPVA	IPSK-KPVA
RPIEGRVVNA	RPIEGVVNA
KPKSLWKSV	KPKSLWKSV
KPRPPQGLVR	KPRPPGLVR
TPYSGKLMSA	TPYSGLMSA
VPKPIGGVVV	VPKPIGVVV
HPLLRPPP	HPLL-RPPP
VPVGILSA	VPVG-ILSA
AVRIPGGPA	AVRIPGGPA
SPASLSQA	SPAS-LSQA
RPKSAFKVQ	RPKSAFKVQ
SPRPQAPKA	SPRPQAPKA
MPSSVPLRA	MPSSVPLRA
SPDELPSA	SPDE-LPSA
TPQQIAIA	TPQQ-IAIA
SPVPSHWMVA	SPVPSWMVA
APTSVPGARL	APTS-VPGA
SPKPAIKSISA	SPKPAIKSI
LPAPPAVSA	LPAPPAVSA
LPRKPVAGA	LPRKPVAGA
KPKPVPLR	KPKP-VPLR
APRPWSRNA	APRPWSRNA
LPHKIHYAA	LPHKIHYAA
SPAALKPPA	SPAALKPPA
GPLPMHPAA	GPLPMHPAA
MAPLKMLAL	MAPLKMLAL
VPMTPLRTV	VPMTPLRTV
TPYPGFKSHV	TPYPGKSHV
SPKQILDSA	SPKQILDSA
LIYGTPRAA	LIYGTPRAA
APAIGFPQA	APAIGFPQA
VPYRLLPGIF	VPYRLLPGI
PITPRAAPL	PITPRAAPL
KPANVFITA	KPANVFITA
VPRPVLRALSF	VPRPVLRAL
LPNQSFPHSV	LPNQSPHSV
TPAHVLPSAA	TPAHVLPSA
KPTHFTVNA	KPTHFTVNA
SPAYRDLAA	SPAYRDLAA
TVTEKPEVIDA	TVTE-KPEV
IPYHIVNIV	IPYHIVNIV
APASLTSA	APAS-LTSA
LAAARLAAA	LAAARLAAA
RPAPPPPTV	RPAPPPPTV
IPKDYKTMTA	IPKDYTMTA
RPRDSQLYAV	RPRDSQLYA
VPSPVAISA	VPSPVAISA
LPWRLLQA	LPWR-LLQA
RPKSAFKVQNA	RPKSAFKVQ
IPYGMRFIA	IPYGMRFIA
APRTVALTA	APRTVALTA
APRAPRALAA	APRAPALAA
MPFGNVISA	MPFGNVISA
KPIPIIPTAL	KPIPIIPTA
QVRDVIIAA	QVRDVIIAA
RPVLTSVA	RPVL-TSVA
YPSAPFLAA	YPSAPFLAA
APTLGLLPA	APTLGLLPA
FPMPLPRKA	FPMPLPRKA
VPKPSSVQSV	VPKPSVQSV
IPISPISPA	IPISPISPA
TPVGGLLMA	TPVGGLLMA
APNPIHLTV	APNPIHLTV
HPSTEHMVA	HPSTEHMVA
RPYSHALVA	RPYSHALVA
FGPGKPPPPP	GPGKPPPPP
LPQSYIHTSA	LPQSYHTSA
KPYPNSEAARA	KPYPNSEAA
EPGEDFPAA	EPGEDFPAA
SPSMAVRIA	SPSMAVRIA
RVYIHPFHL	RVYIHPFHL
SPKHVYSIA	SPKHVYSIA
LVASVRVPA	LVASVRVPA
VPQRPGPP	VPQR-PGPP
RPNWSKLVA	RPNWSKLVA
SPMATTAAA	SPMATTAAA
SPKGSEGYLAA	SPKGSGYLA
VPLSHLINA	VPLSHLINA
HPKKPGVGV	HPKKPGVGV
NVKVDPEIQ	NVKVDPEIQ
RPFQNQTHA	RPFQNQTHA
VPTKRPPVL	VPTKRPPVL
TPFKPILEA	TPFKPILEA
MPRRNFPIA	MPRRNFPIA
SPYAAMLAA	SPYAAMLAA
LPVGPGRRA	LPVGPGRRA
AARLVGAAA	AARLVGAAA
TPVQRTPLSA	TPVQRPLSA
LPLSLLKTA	LPLSLLKTA
LPQGPMQNA	LPQGPMQNA
EPSAGIPKV	EPSAGIPKV
EKPSYHPIAP	KPSYHPIAP
KVKDIVINEA	KVKDIINEA
TVKGVSLSS	TVKGVSLSS
IPKHINPVA	IPKHINPVA
TPASLLAA	TPAS-LLAA
SPKNTVISV	SPKNTVISV
LPRDVLTRA	LPRDVLTRA
SPAPEEPKA	SPAPEEPKA
GPWVGTGLAA	GPWVGGLAA
PHSAGRYA	PHSA-GRYA
VPSAEPQA	VPSA-EPQA
VPAGGAVAV	VPAGGAVAV
IPKKLMHQA	IPKKLMHQA
LPAEAVEAA	LPAEAVEAA
HPIDDLQSA	HPIDDLQSA
LIKPESKVA	LIKPESKVA
LPYEHGPKGA	LPYEHPKGA
YPKAEPMPSA	YPKAEMPSA
NQIKSGTPYR	QIKSGTPYR
HPYPPGPGVAL	HPYPPGPGV
TPFQGQGHGA	TPFQGGHGA
VPSSPPTKR	VPSSPPTKR
QPNRYTNRVV	QPNRYTNRV
NPYATLPRA	NPYATLPRA
KPKDVSLWAA	KPKDVLWAA
LPHGFTNMA	LPHGFTNMA
LPATSIPTP	LPATSIPTP
LPRRPLPPA	LPRRPLPPA
SPLWRGGGVA	SPLWRGGVA
IPADLRIISA	IPADLIISA
MPVPAQPKA	MPVPAQPKA
RPLHEFITA	RPLHEFITA
APFEPLASG	APFEPLASG
RPKPLSAVP	RPKPLSAVP
VPRTVSSTTA	VPRTVSTTA
KPAVPTVAS	KPAVPTVAS
VPVAGNPAV	VPVAGNPAV
HPWLFIEEA	HPWLFIEEA
QPHIAGVFSA	QPHIAVFSA
TPNKPSVAV	TPNKPSVAV
LVKDVFISA	LVKDVFISA
KPVAIFKTP	KPVAIFKTP
HPYKHSFRA	HPYKHSFRA
APVLLPSAA	APVLLPSAA
SPVQHLVAA	SPVQHLVAA
IIKHIGTSA	IIKHIGTSA
SPHPGLVA	SPHP-GLVA
TPRGTTKVV	TPRGTTKVV
TAKGPGLEA	TAKGPGLEA
KPKKPGKYI	KPKKPGKYI
APNPVVFVA	APNPVVFVA
RLRNHMAVA	RLRNHMAVA
VPAGGAVAVSA	VPAGGAVAV
RVAPRSGLAA	APRS-GLAA
SPYGRRIIP	SPYGRRIIP
HPVAKILHA	HPVAKILHA
RPVQRLPSVAL	RPVQRLPSV
SVPLAATSM	SVPLAATSM
WGKVGGHAA	WGKVGGHAA
RPHAPGTPA	RPHAPGTPA
TPLPAIVPAA	TPLPAVPAA
KPQNIREV	KPQN-IREV
RPSSLHGLAA	RPSSLGLAA
APTGDLPRA	APTGDLPRA
SPTNKISTA	SPTNKISTA
QPHVNGRLA	QPHVNGRLA
APHWAVWLLA	APHWAWLLA
TPYWMAPEV	TPYWMAPEV
VPRPASVSA	VPRPASVSA
KPKPVPLRK	KPKPVPLRK
VPNVHGALA	VPNVHGALA
APRPPPKPM	APRPPPKPM
SPIENIQRVAA	SPIENQRVA
WPKDVGIVAL	WPKDVGIVA
RPAPVAVAAA	RPAPVAVAA
FPRYVTGA	FPRY-VTGA
VPVPLLGA	VPVP-LLGA
SPILVATA	SPIL-VATA
APSDRMPSA	APSDRMPSA
HPRVPSLTTV	HPRVPLTTV
TPNSPRLAA	TPNSPRLAA
KPYESYIGA	KPYESYIGA
LPKPGFLGA	LPKPGFLGA
VPRPPDTVST	VPRPPTVST
SLVNLGGSK	SLVNLGGSK
SPSPPFGHSA	SPSPPGHSA
YPAAVPQA	YPAA-VPQA
RPVIRPNVGF	RPVI-RPNV
LPDGRIIKV	LPDGRIIKV
APKPPPASQP	APKPPASQP
VPQAKPVA	VPQA-KPVA
TPKGPGQVPT	TPKGPGQVP
SPYFRHSSV	SPYFRHSSV
VPFSIPAA	VPFS-IPAA
SPTFKKNFA	SPTFKKNFA
VPFAAPATA	VPFAAPATA
TPDPSTPSRLA	TPDPSTPSR
RPAPLPAAVV	RPAP-LPAA
VPNKFLVTA	VPNKFLVTA
RPKDDIKLTA	RPKDDKLTA
VPMQDPRAA	VPMQDPRAA
APLDSIHSLAA	APLDSIHSL
RPYPVMRKI	RPYPVMRKI
APPSAVGSSA	APPSAGSSA
APYGTLGAV	APYGTLGAV
LPWQGLKA	LPWQ-GLKA
APYTHFTQA	APYTHFTQA
APAPTPILA	APAPTPILA
IPLGFGVAA	IPLGFGVAA
IPFWRNTAV	IPFWRNTAV
LTKPAALAA	LTKPAALAA
TDTYKLILNGK	TYKLILNGK
MPAFPLPYA	MPAFPLPYA
KPAMPRSVV	KPAMPRSVV
TPAHVLPSA	TPAHVLPSA
AAKPGMVSA	AAKPGMVSA
TPKPPGTGP	TPKPPGTGP
APPRPPRAA	APPRPPRAA
RPYLLVHV	RPYL-LVHV
VPIPNSPFKVA	IPNSPFKVA
LPKEPQGIIA	LPKEPGIIA
KPGLRPRTA	KPGLRPRTA
SPNGKLTVA	SPNGKLTVA
APASVLPAA	APASVLPAA
LPHSAGRYA	LPHSAGRYA
VPFKDMPAT	VPFKDMPAT
MPYLIGVHA	MPYLIGVHA
APRQPGLMA	APRQPGLMA
LPYHHVIHA	LPYHHVIHA
APTAITEA	APTA-ITEA
SPKRPPSPIKF	SPKRPPSPI
TPYYVAPEV	TPYYVAPEV
MPPLPGRAA	MPPLPGRAA
APVNVTTEV	APVNVTTEV
KPLANRIKEA	KPLANIKEA
SPYSNVFHVV	SPYSNFHVV
VPAPSPLSA	VPAPSPLSA
HPMPVLPKA	HPMPVLPKA
RPLTLFHTV	RPLTLFHTV
IPYSPDVQIHA	IPYSPDVQI
RPLLLNSV	RPLL-LNSV
RPRPHSAPSL	RPRPHAPSL
SPALTISKV	SPALTISKV
VPVTLIGEA	VPVTLIGEA
MPQSGTGVSV	MPQSGGVSV
MPITGQLSA	MPITGQLSA
RPAEPAFLA	RPAEPAFLA
PKPIGKLA	PKPI-GKLA
VPVQPGSSV	VPVQPGSSV
TPVATSPTA	TPVATSPTA
TPVPASTSA	TPVPASTSA
MPYSGMTGA	MPYSGMTGA
VPYPPLLRA	VPYPPLLRA
APVLHLEA	APVL-HLEA
HPSQELLAS	HPSQELLAS
IPLDKRLAA	IPLDKRLAA
RPYERPPFA	RPYERPPFA
RPAPVAVAA	RPAPVAVAA
VPIRLIINA	VPIRLIINA
RPSPPVQSV	RPSPPVQSV
WPKDVGIVA	WPKDVGIVA
IPISPISPAF	IPISPISPA
APVAEVPTA	APVAEVPTA
VPALTGTTA	VPALTGTTA
YPKQSFTMV	YPKQSFTMV
RPAAPLIGA	RPAAPLIGA
LTKDRGVAA	LTKDRGVAA
VPHQPFSQA	VPHQPFSQA
SPHSQVLTA	SPHSQVLTA
VAKVTGGAA	VAKVTGGAA
MPRDILIVV	MPRDILIVV
RPKKPGQSF	RPKKPGQSF
SPHLQGEA	SPHL-QGEA
SPYHGFTIV	SPYHGFTIV
SPKQILDPA	SPKQILDPA
AVKKNPGIAA	AVKKNGIAA
RPPLNPVSA	RPPLNPVSA
APKAGPGVV	APKAGPGVV
SPLNAMPRA	SPLNAMPRA
RPVLPRTEAA	RPVLPRTEA
LPKSTVNGV	LPKSTVNGV
FPKPYPNSEA	KPYP-NSEA
KPYPNSEAA	KPYPNSEAA
NPAPPIDAV	NPAPPIDAV
QPYMPTVSA	QPYMPTVSA
SPGLLPVA	SPGL-LPVA
MPRWAERLFPA	RWAERLFPA
RPKLPDNEV	RPKLPDNEV
RPAPHFERTA	RPAPHERTA
VPIAGRHAV	VPIAGRHAV
EPKNPPPPINF	EPKNPPPPI
LPQHIREA	LPQH-IREA
GPRLSAEAA	GPRLSAEAA
QPYSKLPGVSL	QPYSKLPGV
SPAQSISSV	SPAQSISSV
RPKPESQGI	RPKPESQGI
SPRNLGFETSA	SPRNLETSA
SPRTAEGVLAA	SPRTAGVLA
LPYDIPHRA	LPYDIPHRA
TPVTTSPSA	TPVTTSPSA
SPLSSHPVV	SPLSSHPVV
KGYFFPTSA	KGYFFPTSA
SPKKPGREI	SPKKPGREI
MPQIPRDNKA	MPQIPDNKA
IPWGISATA	IPWGISATA
RPKPIITSV	RPKPIITSV
APNLVPGVGA	APNLVGVGA
IPVTQASA	IPVT-QASA
QPSEVLRTV	QPSEVLRTV
YPRVSSAVKA	YPRVSAVKA
SPFDQMKTA	SPFDQMKTA
RPSPAISVS	RPSPAISVS
YPNGHFVRV	YPNGHFVRV
PRLGELAVAA	RLGELAVAA
MPWYQRRIA	MPWYQRRIA
APQRVPVA	APQR-VPVA
APVAVEPGA	APVAVEPGA
LPKKSFEQISA	LPKKSFEQI
TPSPVIRSTA	TPSPVRSTA
FPYMTHPSV	FPYMTHPSV
APLQGQLVA	APLQGQLVA
RPKPAPLTA	RPKPAPLTA
FPRTPARSV	FPRTPARSV
APILNIPIVQF	APILNIPIV
VPFLNPYTV	VPFLNPYTV
AVKFPSKSA	AVKFPSKSA
APKMPVVTSV	APKMPVTSV
IPKPEQLSA	IPKPEQLSA
YPNKGVGQA	YPNKGVGQA
APAAATVAV	APAAATVAV
TPYNYPVPV	TPYNYPVPV
IVKPISRGA	IVKPISRGA
APHIVVGTPG	APHIVVGTP
VPFAATATA	VPFAATATA
LPKEDPTAVA	LPKEDTAVA
VPKNYKLVAA	VPKNYLVAA
IPNFPRSTV	IPNFPRSTV
MPAGSFITA	MPAGSFITA
TPMPPISSV	TPMPPISSV
VPKPFSGPVRL	VPKPFSGPV
TPADRSGWTSA	TPADRWTSA
TPYPKLKTA	TPYPKLKTA
RPKIGLPGVA	RPKIGLPGV
RPFHLAAV	RPFH-LAAV
KPKEPQPEV	KPKEPQPEV
RPKLGEREV	RPKLGEREV
SPQPVGQQA	SPQPVGQQA
TPIHLASA	TPIH-LASA
IPTPIVGVKR	IPTP-IVGV
RPDGKLRYA	RPDGKLRYA
LPPKDGKVA	LPPKDGKVA
FPVGKGLAA	FPVGKGLAA
LPLGRKKGA	LPLGRKKGA
SPFGSITSA	SPFGSITSA
SPRISRPTA	SPRISRPTA
GPALRVPVA	GPALRVPVA
RPIASGPVV	RPIASGPVV
LARPAALTA	LARPAALTA
APYVTFPVA	APYVTFPVA
KPFQEYLEA	KPFQEYLEA
TPQETYRKV	TPQETYRKV
TPQSIFIFA	TPQSIFIFA
SPHLPGTSS	SPHLPGTSS
TVKPPTSVA	TVKPPTSVA
LPKPRMRGLLA	KPRMRGLLA
SPFAEGTSA	SPFAEGTSA
RPAEKLSTA	RPAEKLSTA
LPSVIAGA	LPSV-IAGA
IPRSFLQEA	IPRSFLQEA
RPVQRLPSV	RPVQRLPSV
RPGPVLPAVAV	RPGPVLPAV
IPYPRPIHL	IPYPRPIHL
YPKNPHLRA	YPKNPHLRA
HPYGHQPTA	HPYGHQPTA
REAGAAALRNV	AGAAALRNV
RPAFVIPEV	RPAFVIPEV
LPVHYIPVAP	LPVHYIPVA
RPVTPPRTA	RPVTPPRTA
PVGPGRRA	PVGP-GRRA
RPPGARLTTT	RPPGARLTT
AAKDPSPSV	AAKDPSPSV
YPRPGTPAA	YPRPGTPAA
HPKPEGLAA	HPKPEGLAA
TAKSGTGIAA	TAKSGGIAA
KPEEGFRTA	KPEEGFRTA
LPKPVQKPP	LPKPVQKPP
APVYLAAV	APVY-LAAV
KPLGKSPQV	KPLGKSPQV
APYDPHFPAPA	APYDPFPAP
RPWHKTVTI	RPWHKTVTI
AAMPASTSA	AAMPASTSA
RPYAPINANAI	RPYAPNANA
APARPGPAA	APARPGPAA
IPFGITEEA	IPFGITEEA
MPIYVTGI	MPIY-VTGI
VPIMPYPPA	VPIMPYPPA
NPYNGGGRVA	NPYNGGRVA
SPMPGTLTA	SPMPGTLTA
IPVIRPRAF	IPVIRPRAF
VPYLFKKV	VPYL-FKKV
APFPHGDSA	APFPHGDSA
SPRTPVSPVKF	SPRTPVSPV
AEQRGENALKD	AEQRGENAL
APTAIKAA	APTA-IKAA
KPQNMPKA	KPQN-MPKA
MPRFTEQVEA	MPRFTQVEA
SPSVPKTSA	SPSVPKTSA
HPYQRIVTA	HPYQRIVTA
RPNPPPVSV	RPNPPPVSV
SPEVGMRQA	SPEVGMRQA
IPKKGFVEV	IPKKGFVEV
APANVGLTSA	APANVLTSA
TPFKLTTEA	TPFKLTTEA
MAKPPGSLA	MAKPPGSLA
TPKPATEAV	TPKPATEAV
IPKDPRQW	IPKD-PRQW
NPYFPGQAIA	NPYFPQAIA
KPIEMQLTSA	KPIEMLTSA
LNRLPGAAA	LNRLPGAAA
RPVSLREV	RPVS-LREV
KPVEAAVVA	KPVEAAVVA
SPFHFQPSA	SPFHFQPSA
RIKPPGPTA	RIKPPGPTA
KPLDAPAVNKA	KPLD-APAV
TPIRGLLMA	TPIRGLLMA
APDGTRNLTA	APDGTNLTA
TPMPPISSVLL	TPMPPISSV
SPHPSPLGA	SPHPSPLGA
SPKSPGLKA	SPKSPGLKA
APMPYLIGVHA	MPYLIGVHA
RPREFPTA	RPRE-FPTA
APARPSVPP	APARPSVPP
APTPAAPA	APTP-AAPA
KPQPSILQA	KPQPSILQA
APRGPPQVTS	APRG-PPQV
KPSSSLAVAA	KPSSSLAVA
RPWKAYLSA	RPWKAYLSA
IPQVMAIA	IPQV-MAIA
APIKVRLLA	APIKVRLLA
VPWGGAAA	VPWG-GAAA
APAPVIISS	APAPVIISS
SAKPPAKVEA	SAKPPKVEA
TPHPVLTPVAA	TPHPVTPVA
LPKPPKPVS	LPKPPKPVS
SPQDVTTHA	SPQDVTTHA
KAIDYYLKA	KAIDYYLKA
RPRVTEPISA	RPRVTPISA
RPKTVRDTLLA	RPKTVTLLA
IPSGTILKA	IPSGTILKA
IPLKEMPAV	IPLKEMPAV
IPHLVTHDA	IPHLVTHDA
RPFIGMSSA	RPFIGMSSA
SPALLRAE	SPAL-LRAE
RPYQPLGALVV	RPYQPGALV
TPRPNPRSA	TPRPNPRSA
QRPGAAAARP	RPGAAAARP
LPVFQPGVKL	LPVFQGVKL
PRGPAGPAAQ	PRGPAGPAA
KPQSINTVSA	KPQSITVSA
SPHQVTPQA	SPHQVTPQA
MPVQFKPKSA	MPVQFPKSA
APIRLLAA	APIR-LLAA
APNTPAWEA	APNTPAWEA
RPVHPALPFA	RPVHPLPFA
SPAKTLPGA	SPAKTLPGA
RPYVHKILV	RPYVHKILV
VPAGSGLSA	VPAGSGLSA
RPKAKGGLASL	RPKAKGGLA
EVKPSSVTAA	KPSS-VTAA
KPMEIARIV	KPMEIARIV
IPQKFHRSV	IPQKFHRSV
SPTSPNALPPA	SPNA-LPPA
HPKVNVPGSQA	KVNVPGSQA
LPFDHSRVI	LPFDHSRVI
VPRPAARVA	VPRPAARVA
RPNGVITGLAA	RPNGVGLAA
VKPVKVSA	VKPV-KVSA
PTKRPPVL	PTKR-PPVL
VPAKKITAA	VPAKKITAA
VPFPTPLEA	VPFPTPLEA
APMPPIIHA	APMPPIIHA
SPMAERSMMSA	SPMAEMMSA
RPHSSLRELLA	RPHSSLREL
RPKTGVRGL	RPKTGVRGL
RPKMQEVVA	RPKMQEVVA
RIFDRAVAA	RIFDRAVAA
QPHSSALTA	QPHSSALTA
KPKEPPKVP	KPKEPPKVP
KPYNVYITV	KPYNVYITV
LPASETPKA	LPASETPKA
TPFTAIREA	TPFTAIREA
RPHEGTRPV	RPHEGTRPV
KPKSSLPAV	KPKSSLPAV
LPKPHGIRA	LPKPHGIRA
KPAPKVSAA	KPAPKVSAA
APAGVFGVA	APAGVFGVA
FPRDHKSVTA	FPRDHSVTA
SPLLHNPSA	SPLLHNPSA
RPKSSQIGAVV	RPKSSQIGA
KPFKLSGLSF	KPFKLGLSF
QVMQGMGVSA	QVMQGGVSA
VEKPVGVAA	VEKPVGVAA
RPYTGKVGA	RPYTGKVGA
NPLSTTSSA	NPLSTTSSA
FPAPILRAV	FPAPILRAV
SPYYFLTSA	SPYYFLTSA
VPYPLPKI	VPYP-LPKI
RPMKVGHVT	RPMKVGHVT
VPLDHRVHA	VPLDHRVHA
TPATSVPFA	TPATSVPFA
VPKSAVQQVA	VPKSAQQVA
VPAPSPLSAA	VPAPSPLSA
HPHLVAEA	HPHL-VAEA
MPDLHPAA	MPDL-HPAA
SPFGTITSA	SPFGTITSA
SPARPVSPAP	SPARPVSPA
RPMGLRFKKA	RPMGLFKKA
KLKTITGNSA	KLKTIGNSA
GVAALYKFRVA	AALYKFRVA
KVKEPSVQEA	KVKEPVQEA
RPRPPPFLGP	RPRPPFLGP
VPDSSGPERIL	VPDSSGPER
MPQSIVEA	MPQS-IVEA
SPHLGPAPA	SPHLGPAPA
VPNNKITVV	VPNNKITVV
SPKLPSLEA	SPKLPSLEA
SPKQILDSAA	SPKQILDSA
RPRGPPPPP	RPRGPPPPP
QPFASLISKA	QPFASISKA
KPLRPLGKAA	KPLRPGKAA
HPWETVTTAA	HPWETVTTA
LPYLGVHGA	LPYLGVHGA
SPLGHSPTA	SPLGHSPTA
NPVTGLLSA	NPVTGLLSA
KPALKIPQT	KPALKIPQT
VPHQPDNLAA	VPHQPNLAA
TPRAATVKA	TPRAATVKA
QPYRFPQA	QPYR-FPQA
KPFLLPVEA	KPFLLPVEA
SPKDVILKV	SPKDVILKV
VPNAGILPLV	VPNAGLPLV
SPAKLQAA	SPAK-LQAA
IAPTGHSL	IAPT-GHSL
KPKPNGRTVEV	KPKPNGRTV
VPKKPGPPVL	VPKKPGPPV
SPVTDFREA	SPVTDFREA
APKSTSVFAVA	APKSTSVFA
SPSAGVPRA	SPSAGVPRA
VPKGNTAVSV	VPKGNAVSV
APYGGPIAL	APYGGPIAL
AVKPLGPTA	AVKPLGPTA
IPNRIPKI	IPNR-IPKI
RPVKIRKI	RPVK-IRKI
QPGASGMVA	QPGASGMVA
AAKPPPLSA	AAKPPPLSA
TPHTVTAISA	TPHTVAISA
RPVRLMKV	RPVR-LMKV
VPKNSDPWAA	VPKNSPWAA
IPQNQKAIA	IPQNQKAIA
LPKIPSNAT	LPKIPSNAT
MPRHRFMSA	MPRHRFMSA
TPKMPGQSV	TPKMPGQSV
RPKVGLGA	RPKV-GLGA
KPAKQQPKL	KPAKQQPKL
SPKTTITMA	SPKTTITMA
KPLEPVSTV	KPLEPVSTV
RPYLSAVRA	RPYLSAVRA
SAAPPGPPA	SAAPPGPPA
TPKPVSIAT	TPKPVSIAT
MPNPSLAQVKI	MPNPSLAQV
YPTQLFRTV	YPTQLFRTV
RPWAQVLKA	RPWAQVLKA
YPSEHLIQA	YPSEHLIQA
KPKITPVTV	KPKITPVTV
RPKIPGSREA	RPKIPSREA
APRSFHPPAA	APRSFPPAA
SPVDPGARQA	SPVDPARQA
VPTNIIAA	VPTN-IIAA
FPSSAFLRA	FPSSAFLRA
APYPGFLSV	APYPGFLSV
APKPSSRPSL	APKPSRPSL
QPIFAVTSA	QPIFAVTSA
SPHPPSEVTA	SPHPPEVTA
RPRPTTVTA	RPRPTTVTA
APAVHPQA	APAV-HPQA
HPFHVIRI	HPFH-VIRI
GPHAGKLVA	GPHAGKLVA
MPSRFPPVVFY	MPSRFPPVV
IPNNVKTAV	IPNNVKTAV
SPLFSQHTA	SPLFSQHTA
VPQERQPEA	VPQERQPEA
APGYSYTAA	APGYSYTAA
LVRPPTEQA	LVRPPTEQA
SPRPPLISV	SPRPPLISV
MPLLKSEVA	MPLLKSEVA
APKGSVLQEA	APKGSLQEA
EPMKGPIA	EPMK-GPIA
KPRTVATPLNQ	KPRTVATPL
SPHPGLVAA	SPHPGLVAA
VPQETPHA	VPQE-TPHA
APGLPTARA	APGLPTARA
GPYRAFRVA	GPYRAFRVA
KPREAFGFEQA	KPREAFEQA
VPYGVGKAA	VPYGVGKAA
SPNSILKAA	SPNSILKAA
TPYRPPAA	TPYR-PPAA
APGPGPASA	APGPGPASA
FPVRLLVAA	FPVRLLVAA
RPLPGALGVA	RPLPGLGVA
RVRLSTGREA	RVRLSGREA
IPKKHISQI	IPKKHISQI
KPLKEFVEA	KPLKEFVEA
KPPPPPPAP	KPPPPPPAP
IPYTGPFNLL	IPYTGFNLL
IVYKIRAA	IVYK-IRAA
HPRTSITVV	HPRTSITVV
APSRIPGV	APSR-IPGV
QPFAVPHSA	QPFAVPHSA
VPYPLPKIDLI	VPYP-LPKI
QPYSKLPGV	QPYSKLPGV
KPAMPMQQA	KPAMPMQQA
SPALASRVA	SPALASRVA
APAPAEKTPV	APAPAEKTP
IPQKPSQPA	IPQKPSQPA
NPYTIFHQA	NPYTIFHQA
RPKGFYVET	RPKGFYVET
SPQYRLRIA	SPQYRLRIA
IPKDYKTMAA	IPKDYTMAA
APQSLGSSA	APQSLGSSA
VVPEPGQPL	VVPEPGQPL
QPKYPRKSA	QPKYPRKSA
APRLQSEVA	APRLQSEVA
HPTWALKEA	HPTWALKEA
RPAPPRAPA	RPAPPRAPA
RPKQPGPVKL	RPKQPPVKL
SPSPPQAEA	SPSPPQAEA
RVKPFSENEA	KPFS-ENEA
KPHQIGGIRFL	KPHQIGIRF
RPRPPPAAP	RPRPPPAAP
VPSSQPSV	VPSS-QPSV
IPLPDEKSRVA	LPDEKSRVA
SPQGRVMTI	SPQGRVMTI
RPSQAAPAV	RPSQAAPAV
SPLRSPIRSA	SPLRSIRSA
VPQGLLKAA	VPQGLLKAA
RPQSETNVA	RPQSETNVA
HPFYTRAA	HPFY-TRAA
QPRPPSNRTV	QPRPPNRTV
HPAPVRGPP	HPAPVRGPP
HPNQQHVVA	HPNQQHVVA
RPKPKIIQT	RPKPKIIQT
VPAKWIHEA	VPAKWIHEA
KPHPVTVTT	KPHPVTVTT
APKWFDGQRA	APKWFGQRA
SPNLIGATGA	SPNLIATGA
NPFKGSSGA	NPFKGSSGA
RPEEGRPVV	RPEEGRPVV
QPYQPLREV	QPYQPLREV
SPKAALRYAA	SPKAALRYA
RPSPAPPAA	RPSPAPPAA
MPHSPTLRV	MPHSPTLRV
APTLPGSAA	APTLPGSAA
IPIAVSGV	IPIA-VSGV
SPIENIQRV	SPIENIQRV
VPKPIGGVV	VPKPIGGVV
AVAPPSTSA	AVAPPSTSA
KPFQPALPLVV	KPFQPLPLV
VPFKPQIPEA	VPFKPIPEA
LPMDYVQRV	LPMDYVQRV
SPKPALRYA	SPKPALRYA
HPFKGFLLEA	HPFKGLLEA
HPLGRPPT	HPLG-RPPT
VPAPGGPAA	VPAPGGPAA
APKSPSQDV	APKSPSQDV
RPLFPGSTV	RPLFPGSTV
KPLSSLTPLIA	KPLSSLTPL
EAIGKIPAA	EAIGKIPAA
SPIEFLENA	SPIEFLENA
AAPAPAAHVA	APAPAAHVA
SPRGFPLGLSA	SPRGFGLSA
VPAVTLVA	VPAV-TLVA
AAKLPGEGA	AAKLPGEGA
LPNGVPKA	LPNG-VPKA
APRFGGSRA	APRFGGSRA
APRIALHTA	APRIALHTA
RPSSEVIKDA	RPSSEIKDA
SPVSSLPTA	SPVSSLPTA
QPYNSRPAV	QPYNSRPAV
RPNDSRMLVA	RPNDSMLVA
NPYHNAVHA	NPYHNAVHA
LPMTDKRVA	LPMTDKRVA
QPSWSIRTA	QPSWSIRTA
LPSSLKRIA	LPSSLKRIA
RPDKRFRLA	RPDKRFRLA
KPHQIGGIRF	KPHQIGIRF
VPKPPPAKP	VPKPPPAKP
SPLEEFKRA	SPLEEFKRA
TPKMPGQSVR	TPKMPGQSV
TPLLSGKAA	TPLLSGKAA
RVRSFLRGLPA	RSFLRGLPA
KPRPPPPPP	KPRPPPPPP
HPYLPINSA	HPYLPINSA
YPYGDGNRSV	YPYGDNRSV
RPWPNPNSA	RPWPNPNSA
LPKPPKPVSK	LPKPPKPVS
SPNEKFLLA	SPNEKFLLA
IPATPGIGA	IPATPGIGA
HPVHRQYFITA	VHRQYFITA
APIWLEHAA	APIWLEHAA
APSNGLSVRSA	APSN-GLSV
IPYRVIHNA	IPYRVIHNA
APYDPRVLAA	APYDPVLAA
SPKKPGREIEL	SPKKPGREI
RPYSRKLEA	RPYSRKLEA
SPYHNFDSV	SPYHNFDSV
VAKPPGWSA	VAKPPGWSA
VPNYKLITPA	VPNYKITPA
APTPPTLVA	APTPPTLVA
KPIDFVLNKV	KPIDFLNKV
QPTPIQKA	QPTP-IQKA
MPYFLLTQA	MPYFLLTQA
IPVRFIEA	IPVR-FIEA
TPREPNRWAV	TPREPRWAV
APHPPLSVV	APHPPLSVV
FPHFDLSHGSA	FPHFDHGSA
TPKTVTPASSA	TPKTVTPAS
LPYHTTDA	LPYH-TTDA
KPLQPARPV	KPLQPARPV
VPVETPEA	VPVE-TPEA
SPLATSTTA	SPLATSTTA
QPAPAIHSA	QPAPAIHSA
IPKGLIRSA	IPKGLIRSA
TPYTGILYA	TPYTGILYA
SPRIATTTASA	SPRIATTTA
APSGGRLLSA	APSGGLLSA
KPRTPMPSSV	KPRTPPSSV
SPRQSDVMIVA	SPRQSVMIV
RPFSGRRLPV	RPFSGRLPV
APIQPTPVA	APIQPTPVA
LPRGFPPSA	LPRGFPPSA
MPFPNIRSA	MPFPNIRSA
IPKPLNPALW	IPKP-LNPA
MPAGLIAGA	MPAGLIAGA
QPNSGLLQA	QPNSGLLQA
IPYQPMPAS	IPYQPMPAS
IPTTIYKA	IPTT-IYKA
MPATLARA	MPAT-LARA
RPVKLFRV	RPVK-LFRV
IPQSVPGVQTL	IPQS-VPGV
VPAEGAPTA	VPAEGAPTA
YPFRVNSA	YPFR-VNSA
IPKPSKDGVTV	KPSKDGVTV
APTSAGKTLVA	APTSAGKTL
NPFGGASHA	NPFGGASHA
APTAIKAAA	APTAIKAAA
KPYTLMSMV	KPYTLMSMV
QPYYATRVNA	QPYYARVNA
AAKVPGNQA	AAKVPGNQA
PHLVTHDA	PHLV-THDA
HPLPIWTPA	HPLPIWTPA
RPRQLTRA	RPRQ-LTRA
PDGRIIKV	PDGR-IIKV
APSVTPQA	APSV-TPQA
SPLSAARAA	SPLSAARAA
MPKYAPKAA	MPKYAPKAA
QPKEKISKV	QPKEKISKV
RPRDSQLYA	RPRDSQLYA
LPTAVPTA	LPTA-VPTA
NPTRQPLA	NPTR-QPLA
IIHEIAVLEL	IIHEIVLEL
KPRPVSQLV	KPRPVSQLV
IPRSFMMEV	IPRSFMMEV
APVILPSA	APVI-LPSA
NAPWAVTSL	NAPWAVTSL
RPSLIPPVTF	RPSL-IPPV
IPRQLGEVA	IPRQLGEVA
SPHISSQTA	SPHISSQTA
RPFLLRRV	RPFL-LRRV
RPHAPHSPIKF	RPHAPHSPI
HPMAYQLQL	HPMAYQLQL
HPYLFPVAA	HPYLFPVAA
RPADVIFATV	RPADVFATV
RPRHQGVMVG	RPRHQGVMV
TTYKLVINGKT	TTYKLINGK
SPIRYIPQV	SPIRYIPQV
RPLQDEPAA	RPLQDEPAA
LPSGEVVKIA	LPSGEVKIA
MPVGLIAGA	MPVGLIAGA
VPKEPQNPP	VPKEPQNPP
TPNQNFSTA	TPNQNFSTA
APKQKIVKP	APKQKIVKP
SPAFKPAA	SPAF-KPAA
ITAPPGTAA	ITAPPGTAA
YPNFAGPHA	YPNFAGPHA
MPVERILEA	MPVERILEA
HPTDASMIEA	HPTDAMIEA
SPKPPTRSP	SPKPPTRSP
RPYDKHISP	RPYDKHISP
IPLEKADHPA	IPLEKDHPA
KPYPIAEV	KPYP-IAEV
PTGDLPRA	PTGD-LPRA
KPLYLARVT	KPLYLARVT
RPRPSWITT	RPRPSWITT
KPAPPFNVTV	KPAPPNVTV
HPLLRPPPSA	HPLLRPPSA
IPAALPVAA	IPAALPVAA
APYFKGTAVV	APYFKGTAV
APHPGLSEA	APHPGLSEA
LHPAPPNGL	LHPAPPNGL
RPQSGRVLSA	RPQSGVLSA
TPHPFPAV	TPHP-FPAV
IVKTAPKVSA	IVKTAKVSA
APYDAIHVGA	APYDAHVGA
TAPTGHTL	TAPT-GHTL
VPRPPSLLA	VPRPPSLLA
VPYGEFKSV	VPYGEFKSV
APGVLPSA	APGV-LPSA
LPRPVPLVA	LPRPVPLVA
RPSFVHPGA	RPSFVHPGA
APMLSTVHSA	APMLSVHSA
RPQELPRLA	RPQELPRLA
VPAPFFLPA	VPAPFFLPA
SPKTTISVA	SPKTTISVA
IPRGIPLDAA	IPRGILDAA
VPMPYTLKV	VPMPYTLKV
RPFEGFQRKA	RPFEGQRKA
LPFRVIPLV	LPFRVIPLV
SPFSGLQKA	SPFSGLQKA
TPTVKHLEA	TPTVKHLEA
IPVGKSPMV	IPVGKSPMV
VPIEQIPLVKL	VPIEQIPLV
IPKDYKTMA	IPKDYKTMA
ASAPPGPPA	ASAPPGPPA
KPFEQVKGITL	KPFEQVKGI
KPSPFTPVSA	KPSPFPVSA
APVRVGTQA	APVRVGTQA
HPLASFSFTSA	LASFSFTSA
APKIANGKAA	APKIAGKAA
IPFRIGNA	IPFR-IGNA
RPKLNEGVVEF	RPKLNEGVV
SPLATQIPQA	SPLATIPQA
SPSDIGIIA	SPSDIGIIA
QPSAPGHSV	QPSAPGHSV
IPGVTPAA	IPGV-TPAA
KPKIPKGVS	KPKIPKGVS
PAKKITAA	PAKK-ITAA
KPLRIIGV	KPLR-IIGV
APVAIGVA	APVA-IGVA
HVDPHQRLTA	HVDPHRLTA
SPNPHVRQA	SPNPHVRQA
IPVNGGLAA	IPVNGGLAA
LPVRLATA	LPVR-LATA
LPWPGGSAA	LPWPGGSAA
KPKAPPPSL	KPKAPPPSL
GPYKIILTA	GPYKIILTA
APKAGQLEA	APKAGQLEA
PRPASGPIRP	RPASGPIRP
APIDRVGQT	APIDRVGQT
TPGLLPTA	TPGL-LPTA
APRPGPRAV	APRPGPRAV
KPYEKVRIY	KPYEKVRIY
SPKPVSSTV	SPKPVSSTV
RPGPVLPAV	RPGPVLPAV
MPADSGYPA	MPADSGYPA
TPVSGTPQA	TPVSGTPQA
RPADVIFAT	RPADVIFAT
TVTEKPEVID	TVTE-KPEV
APFPKTQIA	APFPKTQIA
RPALFSSSA	RPALFSSSA
SPADRQLVA	SPADRQLVA
HPQPGSANSL	HPQPGANSL
TIRTPMAAA	TIRTPMAAA
RPLFPSTGAA	RPLFPSTGA
LPYSHPGVVF	LPYSHPGVV
KPGSVPLV	KPGS-VPLV
RPNAFGMAQA	RPNAFMAQA
SPHAHISEQA	SPHAHSEQA
TPMSVLQQA	TPMSVLQQA
SPASASLVA	SPASASLVA
HPSPVVLKV	HPSPVVLKV
KPQRGMPKV	KPQRGMPKV
KPIVQIAVI	KPIVQIAVI
APKPQGTKI	APKPQGTKI
FPTSISVN	FPTS-ISVN
NPIAQPLA	NPIA-QPLA
APKSTSVFA	APKSTSVFA
HPKPVPGFQVA	KPVPGFQVA
RPWKGVLMV	RPWKGVLMV
APAAGMNAA	APAAGMNAA
IAHTPGVAA	IAHTPGVAA
APSPEPAV	APSP-EPAV
RPNSLVGITSA	RPNSLITSA
QPRNSLPASPA	QPRNSLPAS
SPNPFSVHTA	SPNPFVHTA
MPVSPISQGA	MPVSPSQGA
QPVPPGRAA	QPVPPGRAA
HPREPLPPIQ	HPREPLPPI
IITKDSHAL	IITKDSHAL
LKGHPGLPGL	KGHPGLPGL
SPTVITSV	SPTV-ITSV
LPKINSHPT	LPKINSHPT
NPYYGGESA	NPYYGGESA
SPVVPQISA	SPVVPQISA
MPFGNVVSA	MPFGNVVSA
LPSSHALEA	LPSSHALEA
RPKPPSATSI	RPKPPATSI
HPSQELLASA	HPSQELASA
HPNNQKLMA	HPNNQKLMA
RPKPSSSPVIF	RPKPSSSPV
IPKDKSWKA	IPKDKSWKA
MPGYLPGA	MPGY-LPGA
IPMKIRNVSA	IPMKINVSA
APKGPSRESVV	APKGPRESV
RPNLIKPAA	RPNLIKPAA
RPFQSIIHA	RPFQSIIHA
HPYPPGPGV	HPYPPGPGV
RTKTPGPGA	RTKTPGPGA
SPYLPGRLA	SPYLPGRLA
APAGSLPKI	APAGSLPKI
RPKPIITSVPK	RPKPIITSV
RPFRLGTGA	RPFRLGTGA
SPSQSSMVA	SPSQSSMVA
SPALLREA	SPAL-LREA
RPLDKLPGL	RPLDKLPGL
SPLIQKSAA	SPLIQKSAA
RPYRHIGV	RPYR-HIGV
LPRRPLPPAA	LPRRPPPAA
SPAQIKAV	SPAQ-IKAV
VPYDPGLKA	VPYDPGLKA
RPAAAPPAGA	RPAAAPAGA
RPNQDGTLIA	RPNQDTLIA
APVNFISA	APVN-FISA
MPNGTPHPTA	MPNGTHPTA
SPYSGPKFNSA	SPYSGFNSA
GPYGGAQPSA	GPYGGQPSA
APVQQPRT	APVQ-QPRT
VPKLPAVHPA	VPKLPVHPA
NPSPSTSISA	NPSPSSISA
MPQPVPTA	MPQP-VPTA
KPKQPPKPP	KPKQPPKPP
APYGNPKNMA	APYGNKNMA
RPHAPGRPA	RPHAPGRPA
SPLNTHAA	SPLN-THAA
LPLGSRPAP	LPLGSRPAP
TPAKAIAAV	TPAKAIAAV
RPRTEVSLSA	RPRTESLSA
RPYEPINSI	RPYEPINSI
LPKDQQITA	LPKDQQITA
SPKAALRYA	SPKAALRYA
RPRPTEATV	RPRPTEATV
FVGKTPEA	FVGK-TPEA
RPVGGGPSA	RPVGGGPSA
HLPETKFSEL	LPETKFSEL
KPFPVSKA	KPFP-VSKA
TPKPIPILAA	TPKPIILAA
KPQANVPSA	KPQANVPSA
RPRPPPVEQV	RPRPPVEQV
APSKATLIEA	APSKALIEA
HPKKPGPSL	HPKKPGPSL
VPRLPATAA	VPRLPATAA
SPRVPNSSV	SPRVPNSSV
MPFQGSGKSA	MPFQGGKSA
IPRHPMPFAA	IPRHPMPFA
KPHKHLPPAAL	KPHKHPPAA
HNPGYPKYLGT	NPGYPYLGT
LPYSDFPRP	LPYSDFPRP
IPAFRGHFIAA	IPAFRFIAA
LAGPLRPAA	LAGPLRPAA
AGPARLSPAA	GPARLSPAA
RPFGGLIRDV	RPFGGIRDV
SPRIATTTA	SPRIATTTA
QPLPATHAA	QPLPATHAA
RPRDLEDFFSA	RPRDLFFSA
FPRPVTVEP	FPRPVTVEP
KPATLTTTSA	KPATLTTSA
SPLTPRPLSA	SPLTPPLSA
VPRPPSNPP	VPRPPSNPP
MAYGSSLAA	MAYGSSLAA
HTPAHVLPSA	TPAHVLPSA
PHSAGRYAA	PHSAGRYAA
QPSHLMRQV	QPSHLMRQV
VPKKPPPSP	VPKKPPPSP
SPNDRLIPAV	SPNDRIPAV
SPVLPLTSA	SPVLPLTSA
MPNGTPHPTAA	MPNGTHPTA
SPHSVPFLA	SPHSVPFLA
KPKAAKPKVV	KPKAAKPKV
KPQATVVSA	KPQATVVSA
SPITGEKIPA	SPITGKIPA
LVGPVLGAA	LVGPVLGAA
SPFPDIPKV	SPFPDIPKV
SPAQVIPLA	SPAQVIPLA
APFQGLLQA	APFQGLLQA
RPWLRPAA	RPWL-RPAA
APVPGIPTA	APVPGIPTA
APKAGPGVVR	APKAGPGVV
KPTGGLPET	KPTGGLPET
IPWKVPGL	IPWK-VPGL
IPHPLIMGV	IPHPLIMGV
LPLLARPAA	LPLLARPAA
TPKLTRNESVA	TPKLTNESV
VPREPGVHT	VPREPGVHT
LPHPYAIAV	LPHPYAIAV
RAKLVSKIA	RAKLVSKIA
SPKGHLTRL	SPKGHLTRL
LPTIRVPKA	LPTIRVPKA
SPKFPGMRT	SPKFPGMRT
YPFKNLPTA	YPFKNLPTA
MPSRFPPVVF	MPSRFPPVV
MVLPRKPVA	MVLPRKPVA
SPHVQVKAA	SPHVQVKAA
APRPASGPIRP	RPASGPIRP
TPQPPLLKA	TPQPPLLKA
SPLHLAVEA	SPLHLAVEA
HPYLFPVA	HPYL-FPVA
RPADYLFML	RPADYLFML
PGPRRSGA	PGPR-RSGA
RPSTLFSAA	RPSTLFSAA
YPALGPRLAA	YPALGRLAA
APHLLRLFV	APHLLRLFV
RPFHGISTV	RPFHGISTV
FPTKIPRG	FPTK-IPRG
KPVPLNSGVRF	KPVPLNSGV
APVNIAGSRTA	APVNISRTA
VPSYPSKSA	VPSYPSKSA
YPHGWVETA	YPHGWVETA
APIPNAPPA	APIPNAPPA
SPFHFQPSAA	SPFHFQPSA
RPAGALVALVV	RPAGALVAL
RPSELLAGVKA	RPSELLAGV
NPFRSKLAA	NPFRSKLAA
VPEKPRVPA	VPEKPRVPA
APHEILIQI	APHEILIQI
APYAVGREA	APYAVGREA
SVKDGSLAA	SVKDGSLAA
KPLQPLPNTA	KPLQPPNTA
LPKPPGRGV	LPKPPGRGV
RPYEKGRLII	RPYEKGRLI
APRGAAGRPL	APRGAGRPL
LPYNGVVLA	LPYNGVVLA
QPLLPYSAV	QPLLPYSAV
RPMSHYTTP	RPMSHYTTP
KPFKEFVEA	KPFKEFVEA
SPTHSAIPA	SPTHSAIPA
NPKDNNQFASA	NPKDNNQFA
RPLAQLREV	RPLAQLREV
APKFRLHSA	APKFRLHSA
VPHRATVYA	VPHRATVYA
RPAPPLRPSA	RPAPPRPSA
TPNTPRNLAA	TPNTPNLAA
IPHSLPGAVAA	IPHSLGAVA
KPLDIPDGRRA	KPLDIGRRA
KPMKSVLVV	KPMKSVLVV
HPTSIVKA	HPTS-IVKA
RPKPPIPAKP	RPKPPIPAK
LVAPPLPAA	LVAPPLPAA
MQPPVPGP	MQPP-VPGP
RPFKGEVV	RPFK-GEVV
QPTPVNIRA	QPTPVNIRA
KLKPGGVGA	KLKPGGVGA
TPVKAGRLV	TPVKAGRLV
KPKVIIIQA	KPKVIIIQA
RPRPPQKALP	RPRPPQKAL
APAPAAHVA	APAPAAHVA
RPALVGVVKEA	RPALVGVVK
KPVEVTESA	KPVEVTESA
LPHPGLKVA	LPHPGLKVA
KPKPIGKLA	KPKPIGKLA
IPYDQSPGPK	IPYDQSPGP
TPKPVEPAA	TPKPVEPAA
HPRSPNVLSV	HPRSPVLSV
APQETRGIPS	APQETGIPS
KPWKFSSV	KPWK-FSSV
APSPVQHQA	APSPVQHQA
