Data	Data aligned
SYIYRLMSE	SYIYRLMSE
FFPDKPITQY	FFPDPITQY
TTHNSAFEY	TTHNSAFEY
KFYVHNDIFRY	YVHNDIFRY
SFYSLPSGGY	SFYSPSGGY
FYFALRDTLV	FYFALRDTL
VVNIARYLY	VVNIARYLY
NNTALVSQFY	NTALVSQFY
LVYPGDPLRF	VYPGDPLRF
SLANPLPTNY	SLANLPTNY
QMNKFLYLY	QMNKFLYLY
KVANIILSY	KVANIILSY
TPFSVGLVY	TPFSVGLVY
DTNADKQLS	DTNADKQLS
YYDGDVGNYYY	YYDGDVGNY
MVLDLRAFY	MVLDLRAFY
ALYRSHLLY	ALYRSHLLY
YFRASSTMRY	YFRASTMRY
LFHPSNVEM	LFHPSNVEM
VTFPEFLRY	VTFPEFLRY
NTGESKVFYY	NTGEKVFYY
TRQALVIYY	TRQALVIYY
SNFNGRFYY	SNFNGRFYY
TMLDLFFHY	TMLDLFFHY
WLDKIDRRY	WLDKIDRRY
SFEQFCINY	SFEQFCINY
NFYLVPLHY	NFYLVPLHY
FLMKVNLEY	FLMKVNLEY
VSSNHVLIY	VSSNHVLIY
YSLKVLLSY	YSLKVLLSY
AGFAGDDAPR	GFAGDDAPR
LMWFDKTPLSY	WFDKTPLSY
HQDHSHLLY	HQDHSHLLY
QYPFPVTLY	QYPFPVTLY
SYHDPIMGNKY	YHDPMGNKY
SSSEITSLYY	SSSETSLYY
EVLNFLLRY	EVLNFLLRY
HYYDLALAFPY	HYYDLALAF
LSHILEVLY	LSHILEVLY
HLDLGILYY	HLDLGILYY
FFPVIYDVKY	FFPVYDVKY
KLLDAYLLY	KLLDAYLLY
GVIPRSFEY	GVIPRSFEY
VQFLERLFY	VQFLERLFY
SLWDTSPSY	SLWDTSPSY
MFTELAILY	MFTELAILY
SLFHAQLAY	SLFHAQLAY
HVGMEPLQFDY	GMEPLQFDY
AQLSSQLY	-AQLSSQLY
LFHTARLFY	LFHTARLFY
LINSSQLLY	LINSSQLLY
RKNNTDTLY	RKNNTDTLY
AFIHISTAY	AFIHISTAY
SVADIRNAY	SVADIRNAY
FILGSHLTY	FILGSHLTY
IQRTPKIQ	-IQRTPKIQ
NVFIQGFLY	NVFIQGFLY
SISKIHSLY	SISKIHSLY
SVYHPQLAY	SVYHPQLAY
AIAELPLDY	AIAELPLDY
KVVQVFSEY	KVVQVFSEY
FGLARIYSY	FGLARIYSY
YFTDKAASY	YFTDKAASY
HYFSDPFLKY	YFSDPFLKY
GMFRTVGQLY	MFRTVGQLY
QDRRRDITY	QDRRRDITY
AYTHLETFY	AYTHLETFY
VLNHHQLGY	VLNHHQLGY
GTAPPTLALHY	APPTLALHY
YVTPILMSY	YVTPILMSY
AVHHLMMKY	AVHHLMMKY
FLNDSYLKY	FLNDSYLKY
KVFDGIPPPY	VFDGIPPPY
FFIAGRYEF	FFIAGRYEF
RLAEVALAY	RLAEVALAY
GLSALLLRY	GLSALLLRY
LNEDFSFHY	LNEDFSFHY
FIMDRFPFY	FIMDRFPFY
FLGQHGFNF	FLGQHGFNF
IFIEDYLKY	IFIEDYLKY
HTSVGAYGLY	TSVGAYGLY
VFLPIHITY	VFLPIHITY
TLIEQQFTY	TLIEQQFTY
GYNHGQGSYSY	GYNHGQGSY
QTCRLLLSY	QTCRLLLSY
SMFNGQFLF	SMFNGQFLF
HIGDIVSLY	HIGDIVSLY
HGGPPELFY	HGGPPELFY
RGPSGLLLY	RGPSGLLLY
KILEVVGRY	KILEVVGRY
RMSSHHYDY	RMSSHHYDY
FVATGHGKY	FVATGHGKY
FIGIKIIYS	FIGIKIIYS
GLLPRPIFY	GLLPRPIFY
AEAVQRLLY	AEAVQRLLY
VELGTVTSAY	VELGVTSAY
IAFGFHQLY	IAFGFHQLY
ILATDLALY	ILATDLALY
VLWDQPLKF	VLWDQPLKF
ITKHIGLVY	ITKHIGLVY
ALAPAGFSY	ALAPAGFSY
SYKNLLLEY	SYKNLLLEY
LFEYLHESLY	FEYLHESLY
YLVRWEYSY	YLVRWEYSY
YLATIHLPY	YLATIHLPY
GNHGQALTY	GNHGQALTY
YLWHIPLSY	YLWHIPLSY
IFLFLDRTY	IFLFLDRTY
TNTDLLLAY	TNTDLLLAY
FFEIYNELLY	FEIYNELLY
YYINKISSTLY	YINKSSTLY
YLIAVTDLY	YLIAVTDLY
TFSAVLVTY	TFSAVLVTY
TVQTAVFLY	TVQTAVFLY
SLGGSFLYY	SLGGSFLYY
YFLGIKSLVY	YFLGKSLVY
YVYEYPSRY	YVYEYPSRY
GFAALQLEY	GFAALQLEY
ALLTLLLVY	ALLTLLLVY
MTGPFFRY	-MTGPFFRY
SYEQLMQLY	SYEQLMQLY
AVCEVALDY	AVCEVALDY
ALYSGPFPFY	LYSGPFPFY
TYPRPHEY	-TYPRPHEY
SSFFGAASQY	SFFGAASQY
YVFDKRLRY	YVFDKRLRY
YYFFTPYVY	YYFFTPYVY
SYEQLREKLLY	EQLREKLLY
SVAPVYSYY	SVAPVYSYY
IGYPMPTGY	IGYPMPTGY
QYADPVNAHY	YADPVNAHY
LVNSFQLLY	LVNSFQLLY
FVPDWAEILY	FVPDAEILY
PFPEIFSLKY	PFPEFSLKY
LVLSLPAAQY	LVLSPAAQY
FYEFFNEQKY	YEFFNEQKY
AFYHKYFNY	AFYHKYFNY
KVLNLALMF	KVLNLALMF
SVYGGGGIHEY	VYGGGIHEY
AVIENPEMLKY	IENPEMLKY
FFPFNPLDF	FFPFNPLDF
YMGHFDLLNY	YMGHDLLNY
IWHHTFYNELR	IWHHTFYNE
TLHGLAHIFSY	HGLAHIFSY
AMDATKLEY	AMDATKLEY
FFTGDVFGY	FFTGDVFGY
YMLKGDYKY	YMLKGDYKY
HNLSANLFY	HNLSANLFY
RFPNLRFAY	RFPNLRFAY
SLNKLALQY	SLNKLALQY
GLPSQAFEY	GLPSQAFEY
AVHGNMLHY	AVHGNMLHY
VVQTVKASY	VVQTVKASY
YYPAQMNANY	YYPAMNANY
SVFISAYYL	SVFISAYYL
VYSAAILEY	VYSAAILEY
LYIDKDLEY	LYIDKDLEY
KASNLLLNY	KASNLLLNY
VFYPYPQYF	VFYPYPQYF
EAQLRTQRY	EAQLRTQRY
VTHYLDKTFY	VTHYDKTFY
RLKESFENY	RLKESFENY
WNLDRAYDY	WNLDRAYDY
KFLQNFLLY	KFLQNFLLY
YFLPITPHY	YFLPITPHY
SYYSSGSRASM	YYSSSRASM
WFDKTPLSY	WFDKTPLSY
FFKEEELEY	FFKEEELEY
KIADRFLL	-KIADRFLL
YMWYNIIQY	YMWYNIIQY
SGLPLILHY	SGLPLILHY
LYLKSPLRY	LYLKSPLRY
VLREIAEEY	VLREIAEEY
NNYYDQGYGNY	YYDQGYGNY
YTDHGSDHHY	YTDHSDHHY
RLLEIQADY	RLLEIQADY
VLAEETFRY	VLAEETFRY
GFWGVARHFNY	GFWGVARHF
TYQNIAVY	-TYQNIAVY
AIFGPPNTYY	IFGPPNTYY
LFTNFISIY	LFTNFISIY
IIHDFPQFY	IIHDFPQFY
WLFAPHYRY	WLFAPHYRY
GTAAAVVGLLY	AAAVVGLLY
VTYNYPVHY	VTYNYPVHY
YYYDPLAGTYY	YYDPLAGTY
HGYHHPHSY	HGYHHPHSY
SFLPVHLGF	SFLPVHLGF
RMIDMHAHY	RMIDMHAHY
TLSDIFLLF	TLSDIFLLF
VIKEVQEFY	VIKEVQEFY
VMWSPTHPALF	WSPTHPALF
FYGKPMRIQY	FYGKMRIQY
SLLVSVLEY	SLLVSVLEY
RVDQSLLLY	RVDQSLLLY
NFAAVAAAAY	NFAAAAAAY
LFLVKAKIY	LFLVKAKIY
FRPLYTHEY	FRPLYTHEY
SFQRSKSLF	SFQRSKSLF
GISDADFVLY	GISDDFVLY
AFDIPRFVY	AFDIPRFVY
TVHKDSGLY	TVHKDSGLY
TVLSIPELLY	TVLSPELLY
SVFVATFLRY	VFVATFLRY
WVPPLIGELY	WVPPIGELY
YTVMEWGEDI	TVMEWGEDI
IFASLAVKY	IFASLAVKY
ATGDTALTY	ATGDTALTY
TFARVPVATY	TFARPVATY
GAAGVHFIY	GAAGVHFIY
SFFEVEALM	SFFEVEALM
SVYSDFLLY	SVYSDFLLY
YLNEKAFSY	YLNEKAFSY
SVLPAYLSY	SVLPAYLSY
MFPFFDIAHY	FPFFDIAHY
GNYEKVFEY	GNYEKVFEY
HWLIRGPLEY	WLIRGPLEY
FLQGMGYIAY	FLQGGYIAY
AASLRKVSM	AASLRKVSM
ATNASVFKY	ATNASVFKY
QINSSGHYQY	INSSGHYQY
AESLIAKKI	AESLIAKKI
YLGEFSITY	YLGEFSITY
GEDVETSKKW	GEDVETSKK
AAFPGASLY	AAFPGASLY
FLLPIVVRY	FLLPIVVRY
AITETHAFY	AITETHAFY
AINSKQLTY	AINSKQLTY
HFAFYAYHY	HFAFYAYHY
SLLHMSLLY	SLLHMSLLY
FIVQSRILY	FIVQSRILY
ATFDAISKTY	TFDAISKTY
VMLQLVLRY	VMLQLVLRY
YEGGYRNQLY	YEGGRNQLY
FVQSSGENGV	FVQSSGENG
KTSDSFLNY	KTSDSFLNY
VAYWRQAGLSY	AYWRAGLSY
AYWRQAGLSY	AYWRAGLSY
MIPLIMSVLY	IPLIMSVLY
YQTHFQLAY	YQTHFQLAY
FFSQIGELY	FFSQIGELY
TYFAVNANY	TYFAVNANY
LVGNSLVIY	LVGNSLVIY
YFQKARDTLY	YFQKRDTLY
HNGHVFASY	HNGHVFASY
FNSSSSFRY	FNSSSSFRY
GLNDETYGY	GLNDETYGY
FLTVHDAILY	LTVHDAILY
IFAIPLQIY	IFAIPLQIY
RLHGLPEQFLY	HGLPEQFLY
YVYSHFLQF	YVYSHFLQF
EQLHGYFEY	EQLHGYFEY
AVSNLALQF	AVSNLALQF
SFAYPAIRY	SFAYPAIRY
AFIEKHWTF	AFIEKHWTF
NTTKFMLLY	NTTKFMLLY
EEIAIIPSKKL	IAIIPSKKL
MTVAIVKALY	TVAIVKALY
KVLPQTILY	KVLPQTILY
GLLEKLLDY	GLLEKLLDY
LFGDVAMHY	LFGDVAMHY
IIIDKEYYY	IIIDKEYYY
FVNPTSFVY	FVNPTSFVY
LLNHIASLY	LLNHIASLY
YSQNQQSY	-YSQNQQSY
NFAFSGGLY	NFAFSGGLY
HTYQSPLLY	HTYQSPLLY
QLTTLILSY	QLTTLILSY
TPLGLSTVY	TPLGLSTVY
VFEHPETLY	VFEHPETLY
ALHTFGLFY	ALHTFGLFY
IGDIFLKY	-IGDIFLKY
RLLLLLLRY	RLLLLLLRY
FFRELQQFY	FFRELQQFY
RLFSVIFKY	RLFSVIFKY
NIISKTHQY	NIISKTHQY
MVAQEALKY	MVAQEALKY
SLYKDAMQY	SLYKDAMQY
GVSQMPLRY	GVSQMPLRY
VMTQPTLIY	VMTQPTLIY
SYWSTSLSY	SYWSTSLSY
FFISLLESY	FFISLLESY
HWIDLTFGY	HWIDLTFGY
RVAGISLAY	RVAGISLAY
RVRKPAEAERY	RKPAEAERY
YLYLRGLVY	YLYLRGLVY
TVDRNRLWY	TVDRNRLWY
SEFGNHYLY	SEFGNHYLY
DDLWPNPLQY	DLWPNPLQY
KTFPYQHRY	KTFPYQHRY
GTTKVVSIRY	GTTKVSIRY
ILVLNGGY	-ILVLNGGY
YYQTIGNHASY	QTIGNHASY
SFLTEFINY	SFLTEFINY
NFPPPLPALY	NFPPLPALY
GSIAVALGY	GSIAVALGY
KVMQQNLVY	KVMQQNLVY
FFPEAAQVAY	FFPEAQVAY
FIVGIHSSY	FIVGIHSSY
SMLPSDVSILY	LPSDVSILY
YYRYPTGESY	YRYPTGESY
YQSQHPHVY	YQSQHPHVY
VFTFGSRLY	VFTFGSRLY
RVVSNLLYY	RVVSNLLYY
FQKEALAEY	FQKEALAEY
LYSSYVIFY	LYSSYVIFY
IVTDVLLRF	IVTDVLLRF
KQLAVCLKY	KQLAVCLKY
LIMGLILRY	LIMGLILRY
IFHEVPLKF	IFHEVPLKF
YLMHWPYAF	YLMHWPYAF
EEAENTLQSFR	EAENTLQSF
SYVESILLY	SYVESILLY
FVPFLPLEY	FVPFLPLEY
YNFTLADILLY	FTLADILLY
GNIGALMGY	GNIGALMGY
EDQTEYLEER	---EDQTEY
GYPPPRDSY	GYPPPRDSY
KLIAEQLLY	KLIAEQLLY
TYNDLQVEY	TYNDLQVEY
FLWPKPVEY	FLWPKPVEY
YFAFRNFLY	YFAFRNFLY
GTVYEDLRY	GTVYEDLRY
FVPTNMAVNY	FVPTMAVNY
EELPTLLHF	EELPTLLHF
IYQTKLLHY	IYQTKLLHY
ALLDSQFSY	ALLDSQFSY
YDPDVGNFHY	YDPDGNFHY
YYMNQVEETRY	YMNQEETRY
YFYHVGKVY	YFYHVGKVY
MTHNLLLNY	MTHNLLLNY
YFLASILRY	YFLASILRY
FFVYEVTSTKY	FVYETSTKY
SIFHMSDSY	SIFHMSDSY
QALGGFFTY	QALGGFFTY
SFELIVVQNY	FELIVVQNY
FFRMKELFF	FFRMKELFF
GLIHLAIHY	GLIHLAIHY
AYVNHMMSF	AYVNHMMSF
GFHLNEHLY	GFHLNEHLY
YVAQPATAAAY	AQPATAAAY
FMNTLYLKY	FMNTLYLKY
FVDSSCALKY	FVDSCALKY
QEDLRTFSW	QEDLRTFSW
WLTDNTYKY	WLTDNTYKY
LALSHPYLY	LALSHPYLY
HVNDLFLQY	HVNDLFLQY
SFRSITRSYY	SFRSITRSY
VDTGRMKIY	VDTGRMKIY
TVNQQPFLY	TVNQQPFLY
VLLHEVFTY	VLLHEVFTY
FFNRVNLIY	FFNRVNLIY
GLASWTHSY	GLASWTHSY
FYEVFKVLY	FYEVFKVLY
STKPTNDSY	STKPTNDSY
YLFTEAYYY	YLFTEAYYY
FYQGHVEGY	FYQGHVEGY
AYLAETLYY	AYLAETLYY
ALSAMLAYL	ALSAMLAYL
AMMGSTHIY	AMMGSTHIY
HFLDRHLVF	HFLDRHLVF
GVLEMVKIFRY	LEMVKIFRY
YFGTAKARY	YFGTAKARY
IMLPGVLRY	IMLPGVLRY
RVLQQAFNY	RVLQQAFNY
VQSNARLLY	VQSNARLLY
SYATVYLIY	SYATVYLIY
QHITLFLKY	QHITLFLKY
AAFGSSFQY	AAFGSSFQY
FFKKADLTEY	FFKKDLTEY
STYPRPHEY	STYPRPHEY
SYFPRGLKY	SYFPRGLKY
ATADVVILY	ATADVVILY
FTDKKTHLY	FTDKKTHLY
FLLYAHLTY	FLLYAHLTY
GMAAMPQTVY	GMAAPQTVY
AILSKFLYY	AILSKFLYY
FLPLLKAQEY	FLPLKAQEY
TMVGKTFTY	TMVGKTFTY
NLFETSFPY	NLFETSFPY
KMLDNFYNF	KMLDNFYNF
SYYKDALRF	SYYKDALRF
FLVHESFLY	FLVHESFLY
GTSSGSYQF	GTSSGSYQF
ALLDTTEKYLY	ALLDTTEKY
AVKNVRGEYY	AVKNVRGEY
QFQDVSFAY	QFQDVSFAY
VMDKMQLTY	VMDKMQLTY
YYLGNPAEF	YYLGNPAEF
HLRDYFEEY	HLRDYFEEY
VMNSLQDRY	VMNSLQDRY
AFLESLELY	AFLESLELY
WLPGLEARY	WLPGLEARY
VFLDSHFVY	VFLDSHFVY
AYQSLRLEY	AYQSLRLEY
TEDGKVEKHY	TEDGVEKHY
FVASIDATY	FVASIDATY
FVNKFNVLY	FVNKFNVLY
TIFTARLYY	TIFTARLYY
FYDETYDY	-FYDETYDY
STGEKGFGY	STGEKGFGY
SFARLSLTY	SFARLSLTY
AVLLVFVRY	AVLLVFVRY
STLPTTINY	STLPTTINY
TVSDAILRY	TVSDAILRY
AVMNFVVRY	AVMNFVVRY
ALLQLGLKY	ALLQLGLKY
FLDDLGLKF	FLDDLGLKF
VYFSSYGHY	VYFSSYGHY
SLSGPRLLF	SLSGPRLLF
KIADRFLLY	KIADRFLLY
NFGSRPLRY	NFGSRPLRY
QMSNITVTY	QMSNITVTY
ILSGSTLLY	ILSGSTLLY
IVSILYLKY	IVSILYLKY
ILSDIGLEY	ILSDIGLEY
HNFMMDIQY	HNFMMDIQY
YQDLLQLQY	YQDLLQLQY
VLFGDVAMHY	LFGDVAMHY
GLTKQYLRY	GLTKQYLRY
MVYVPKEEQLF	YVPKEEQLF
KLKSTTESY	KLKSTTESY
ALDKDAPLRY	ALDKAPLRY
SFSQEVSHMY	SFSQVSHMY
AAAAVPLSY	AAAAVPLSY
AVYKEAQYY	AVYKEAQYY
AFKEMFLDY	AFKEMFLDY
READQPLRTY	READPLRTY
ATASDAAPLQY	TASDAPLQY
SMFNGQLLF	SMFNGQLLF
EMMKRALQY	EMMKRALQY
SLSNYAFLY	SLSNYAFLY
SINYALEY	-SINYALEY
FFAVLHAIY	FFAVLHAIY
EMMKETFKY	EMMKETFKY
FFVKIVGHY	FFVKIVGHY
DPGVLGIVY	DPGVLGIVY
WFKKFFDANY	WFKKFDANY
VMFLHALRY	VMFLHALRY
SIMKWLLFY	SIMKWLLFY
GAQACQIC	-GAQACQIC
LFLDSNGLFLF	LFLDSNGLF
WVILQPLFY	WVILQPLFY
GVCEISGRLY	GVCESGRLY
EFFDSNGNFLY	FFDSGNFLY
AVASEDSVLLY	ASEDSVLLY
KAFPEHFTY	KAFPEHFTY
GAMGIMLVY	GAMGIMLVY
VYNHFLLYY	VYNHFLLYY
SFLDKMSFY	SFLDKMSFY
YVLDFYDKY	YVLDFYDKY
YMAQLKCYY	YMAQLKCYY
YMIEPIDEY	YMIEPIDEY
IMSIPNLRY	IMSIPNLRY
GVHAVMYSY	GVHAVMYSY
SVSEVIEGY	SVSEVIEGY
FFESNSLDLY	FESNSLDLY
SSIALHHQY	SSIALHHQY
IFASPCGLY	IFASPCGLY
IANQVQLFY	IANQVQLFY
AQLLLRLDY	AQLLLRLDY
HTLAKRFYY	HTLAKRFYY
KVINDGLFY	KVINDGLFY
QINNIFLRF	QINNIFLRF
PLAEHRPDAY	LAEHRPDAY
FARAPKSIEVY	RAPKSIEVY
YYMTQTEELKY	MTQTEELKY
MVLTIFIKY	MVLTIFIKY
IQNGFLLRY	IQNGFLLRY
TYAGQFNQDY	YAGQFNQDY
NNYYGYGDY	NNYYGYGDY
YLEQLHQLY	YLEQLHQLY
LLTDIIAAY	LLTDIIAAY
FILDKFLRH	FILDKFLRH
IGLETSLRY	IGLETSLRY
KYNACILEY	KYNACILEY
LFQHFLDSY	LFQHFLDSY
LFIDIFHEY	LFIDIFHEY
KMYDAAKLLY	MYDAAKLLY
ALFPHPHIHEY	LFPHHIHEY
FMIQVNHEY	FMIQVNHEY
NTQPIPILY	NTQPIPILY
TFASSGLIYY	TFASSGLIY
VVLDDKDYFLF	VVLDDKDYF
ICSLPFWLQY	CSLPFWLQY
FVRSKADEY	FVRSKADEY
SLLSQMLHY	SLLSQMLHY
FLLHAALSY	FLLHAALSY
SQHYHQGYY	SQHYHQGYY
WLQQFDTEY	WLQQFDTEY
YTMTSTLEY	YTMTSTLEY
FLSFPTTKTY	LSFPTTKTY
QIYDVGYQY	QIYDVGYQY
IMLPFRFTY	IMLPFRFTY
SFLDDFESKY	SFLDFESKY
IIFDRPLLY	IIFDRPLLY
HFYELSLEY	HFYELSLEY
RLDDKKFLY	RLDDKKFLY
GSLALFLIY	GSLALFLIY
RIYAGGEHY	RIYAGGEHY
QEVIKAYGF	QEVIKAYGF
SEYDRGVNTF	SEYDGVNTF
HFPATPLLDY	HFPAPLLDY
SVLTASLSY	SVLTASLSY
YVSDHWAQY	YVSDHWAQY
YLWKSEKPLYY	LWKSKPLYY
ASLDVYAKY	ASLDVYAKY
FYNLIHPEY	FYNLIHPEY
WLHDIILGY	WLHDIILGY
SSASLAASY	SSASLAASY
TILNTLIY	-TILNTLIY
VMDRGYSY	-VMDRGYSY
SIYDEVHSY	SIYDEVHSY
IVKDSFLLY	IVKDSFLLY
MMLPNGYVY	MMLPNGYVY
SFRHWPTLF	SFRHWPTLF
STFFPFHEY	STFFPFHEY
FVLTDSSLKY	VLTDSSLKY
GYGTPYGY	-GYGTPYGY
FFSLPHVGY	FFSLPHVGY
HVSRVRALY	HVSRVRALY
KMTTLTPAY	KMTTLTPAY
SYFRPIDTTM	YFRPIDTTM
SYFRTLLMY	SYFRTLLMY
NVYCGVHRY	NVYCGVHRY
ITRPNGERY	ITRPNGERY
AALQRYLFY	AALQRYLFY
SFYSDESLQY	FYSDESLQY
SFATLFPKY	SFATLFPKY
SWIGYAIAY	SWIGYAIAY
ITNPKSLLY	ITNPKSLLY
AEFVGVSHL	AEFVGVSHL
YLKNLYDLY	YLKNLYDLY
FISHVLAFF	FISHVLAFF
KLHDETLTY	KLHDETLTY
YIQKNVQLY	YIQKNVQLY
FYQSLGIPY	FYQSLGIPY
SVSDQFYRY	SVSDQFYRY
SVFEKYFQF	SVFEKYFQF
QQFPEGLFY	QQFPEGLFY
KVYTHNLYY	KVYTHNLYY
RYSEAVFYY	RYSEAVFYY
GALETLLRY	GALETLLRY
TLSNPEVFNY	TLSNEVFNY
SLFVSNHAY	SLFVSNHAY
TIIDRSFRY	TIIDRSFRY
NIINMLWQL	NIINMLWQL
ILYNIKQEY	ILYNIKQEY
ALVSGKLALRY	LVSGLALRY
YFRSQIDDLY	YFRSIDDLY
STVSRFFLY	STVSRFFLY
VVKEIFFHY	VVKEIFFHY
KMVARVFYY	KMVARVFYY
AFDKHMNLIL	AFDKMNLIL
AVATGLFLY	AVATGLFLY
GFNDNSVKY	GFNDNSVKY
SFFGETSHNY	FFGETSHNY
FMLHIWGKY	FMLHIWGKY
SNLSLWIEY	SNLSLWIEY
YYYDPQTGLY	YYDPQTGLY
VVLAMYPKY	VVLAMYPKY
RNLQAHLLY	RNLQAHLLY
QFGGMLLAY	QFGGMLLAY
VINDGLFYY	VINDGLFYY
FVANLFNKY	FVANLFNKY
GYNYGNYGY	GYNYGNYGY
RIYNFAHRF	RIYNFAHRF
HFYSNPARY	HFYSNPARY
YVANEFLKY	YVANEFLKY
GVHGPEGFHY	GVHGEGFHY
AYIDPIAMEY	YIDPIAMEY
RVNDVPEEFLY	RVNDVPEEF
VMMDPNSTQRY	MMDPSTQRY
FFDSNGNFLY	FFDSGNFLY
FPGIKLIY	-FPGIKLIY
NFMTFPTGY	NFMTFPTGY
ALFYLTNSEY	LFYLTNSEY
FLLPTTALYY	FLLPTTALY
QNLSLQVLY	QNLSLQVLY
RTLNHQYDY	RTLNHQYDY
EVFPLAMNY	EVFPLAMNY
PYNHQHKY	-PYNHQHKY
SVSKSTQFEY	SVSKTQFEY
ALWSHLLHY	ALWSHLLHY
SLADVPREY	SLADVPREY
FVKPSFDQY	FVKPSFDQY
VLGLILRY	-VLGLILRY
LLAAVPLGY	LLAAVPLGY
KTPEVHLKY	KTPEVHLKY
AEALPKQSV	AEALPKQSV
FLDKTMSIEF	FLDKMSIEF
PSQIQEFY	-PSQIQEFY
IANTRTHTY	IANTRTHTY
DQIAHMKNY	DQIAHMKNY
AVIEDTWHY	AVIEDTWHY
DVLPFALRY	DVLPFALRY
YVANTNVFY	YVANTNVFY
FSIHIETKY	FSIHIETKY
VVSPSFEY	-VVSPSFEY
SAHWVTHTSY	SAHWTHTSY
SLFPHPHIHEY	LFPHHIHEY
YLDQISRYY	YLDQISRYY
VTFEKQWFY	VTFEKQWFY
SYSDLVLFF	SYSDLVLFF
SLLRMFLSY	SLLRMFLSY
YTTDFIYQLY	YTTDIYQLY
TGATGATLY	TGATGATLY
GLDDKLLHY	GLDDKLLHY
AIIDILTHY	AIIDILTHY
VLLGFLYRY	VLLGFLYRY
EKGASGVIIY	KGASGVIIY
YLPFPIIQQY	YLPFIIQQY
GVLKDGFTY	GVLKDGFTY
MAHSHLRY	-MAHSHLRY
RFYGRDYEY	RFYGRDYEY
HWIDLIFGY	HWIDLIFGY
AAAAAAALLY	AAAAAALLY
GTNTVILEY	GTNTVILEY
AESALQLLY	AESALQLLY
AAAPQRQAY	AAAPQRQAY
GVMDRGYSY	GVMDRGYSY
YLASTIQQLY	YLASIQQLY
TLTKIALRY	TLTKIALRY
FIDSFRPLY	FIDSFRPLY
VALPPGYYLY	ALPPGYYLY
ILTVGGTAY	ILTVGGTAY
SFWAYKIYY	SFWAYKIYY
RNITLWLKY	RNITLWLKY
NFDIVSGTRY	NFDISGTRY
SFGINSILY	SFGINSILY
QVCGKTFIY	QVCGKTFIY
DDTHYLLYIY	DTHYLLYIY
GTISEVWDY	GTISEVWDY
GVMGMRSYY	GVMGMRSYY
QSMAQWLAY	QSMAQWLAY
RVYSDLHAFYY	VYSDLHAFY
YNLRNTLKY	YNLRNTLKY
TLSNLILGY	TLSNLILGY
REEDAALFKAW	REEDAALFK
GGNFGFGDSR	GNFGFGDSR
AYLQSYLSY	AYLQSYLSY
DITSDTSGDFR	ITSDTSGDF
ITFGERFEY	ITFGERFEY
LGYGKGYKY	LGYGKGYKY
NYNQQPSNY	NYNQQPSNY
SVLRTALRY	SVLRTALRY
YYIFIPSKF	YYIFIPSKF
IFHDISLRF	IFHDISLRF
GTKGLSVNDFY	KGLSVNDFY
SAAPFAQRY	SAAPFAQRY
AETPDIKLF	AETPDIKLF
TTARVITNQY	TTARITNQY
IDVGTGYY	-IDVGTGYY
IIQKNSYRY	IIQKNSYRY
YFYHQEEY	-YFYHQEEY
VFIGTGATG	VFIGTGATG
ILAEESYLY	ILAEESYLY
SFALLPRLEY	FALLPRLEY
AVVEGLWLRY	VVEGLWLRY
SNSEITSLYY	SNSETSLYY
NFLHPVIYY	NFLHPVIYY
LYFDHSTGFYY	YFDHTGFYY
LVAQQVAQQY	LVAQVAQQY
IAINVKALY	IAINVKALY
STISLPFKY	STISLPFKY
LDTNADKQLS	DTNADKQLS
SAISSVRLY	SAISSVRLY
NVLLVTQHY	NVLLVTQHY
KLWNEELKY	KLWNEELKY
ATFSSSHRY	ATFSSSHRY
AFQFLQLYY	AFQFLQLYY
VLFEHAVGY	VLFEHAVGY
ATFPVAPRY	ATFPVAPRY
VSALAVISY	VSALAVISY
SSAKTILKY	SSAKTILKY
FLPFPLPLF	FLPFPLPLF
TFKVIEEAVY	TFKVEEAVY
KVCEEKLRY	KVCEEKLRY
AMTHLNLSY	AMTHLNLSY
MYNRPVEVY	MYNRPVEVY
GIADFVLKY	GIADFVLKY
IALPSLRILY	ALPSLRILY
GINISGNFY	GINISGNFY
VASAIYAKY	VASAIYAKY
YYYRPLYDAY	YYRPLYDAY
KLFPYALAF	KLFPYALAF
IIAEPGRYY	IIAEPGRYY
SWFMEAIEY	SWFMEAIEY
GIHYPPLHY	GIHYPPLHY
VAISEELVQKY	AISELVQKY
ATVDSYHLY	ATVDSYHLY
IFSDLNATY	IFSDLNATY
VYHRAFLLY	VYHRAFLLY
HFISEPYRY	HFISEPYRY
STLSLVNKY	STLSLVNKY
KVYENYPTY	KVYENYPTY
FYVETVVTY	FYVETVVTY
MLLPLIIAY	MLLPLIIAY
SLWEQALSY	SLWEQALSY
LLFTAPEYY	LLFTAPEYY
VASSLGLFS	VASSLGLFS
VFEYINNTDF	FEYINNTDF
VVHEIAYQY	VVHEIAYQY
SEEFNGYLY	SEEFNGYLY
ILYKKTLWY	ILYKKTLWY
SIFYKGVYY	SIFYKGVYY
FVGGLSVLY	FVGGLSVLY
MLYGLPPFY	MLYGLPPFY
GQPSIALEY	GQPSIALEY
AVLGEVVLY	AVLGEVVLY
FYVHNDIFRY	YVHNDIFRY
FFGDVVLRF	FFGDVVLRF
QFGSALAHFY	FGSALAHFY
SFDFLELNY	SFDFLELNY
AEDAMRLYY	AEDAMRLYY
LVSRHLLSY	LVSRHLLSY
IVLDMGFALY	IVLDGFALY
TLLDAKELLKY	LLDAELLKY
VLTIFIKY	-VLTIFIKY
SVFTEPNRHFY	VFTENRHFY
YVYWLHMLY	YVYWLHMLY
TMVESTFMY	TMVESTFMY
GVISNFVSY	GVISNFVSY
AFSQSSHLY	AFSQSSHLY
YYYTVTPSY	YYYTVTPSY
LILHLISTVY	LILHISTVY
SVAGIFNYY	SVAGIFNYY
GTAIDCYKY	GTAIDCYKY
LALHYLLTY	LALHYLLTY
IYSPLLFKY	IYSPLLFKY
QYHLQQLFY	QYHLQQLFY
FFESMPYKL	FFESMPYKL
TNLGHHLQY	TNLGHHLQY
VKPVEILNY	VKPVEILNY
HMEGNLQLLY	MEGNLQLLY
AAAQIPAFY	AAAQIPAFY
KVLDIPSKY	KVLDIPSKY
AEINNIIKI	AEINNIIKI
FMITFPYGY	FMITFPYGY
LVAAIHPSY	LVAAIHPSY
LMESRTYAY	LMESRTYAY
YYDPNSQYY	YYDPNSQYY
GYIPELEYGY	YIPELEYGY
LYELWLLY	-LYELWLLY
TGIGKGFGY	TGIGKGFGY
AFLNDSYLKY	FLNDSYLKY
KLDELKLKY	KLDELKLKY
SFNQSSHLY	SFNQSSHLY
YLYGNQLDE	YLYGNQLDE
RVLEKHFGY	RVLEKHFGY
NFLHPVIYYY	FLHPVIYYY
SNISLVFDF	SNISLVFDF
YVMTLNLMY	YVMTLNLMY
SFLTANGALY	FLTANGALY
WFEAQVVRV	WFEAQVVRV
QIQATTIY	-QIQATTIY
YVLVGVDGRY	VLVGVDGRY
FFNRINLIY	FFNRINLIY
AVPTELALLY	AVPTLALLY
KSLALLLGY	KSLALLLGY
KTLSIFMEY	KTLSIFMEY
STSSGIYSY	STSSGIYSY
YTAQTSQPTNY	AQTSQPTNY
LFLPTAAAY	LFLPTAAAY
YIFESKGD	-YIFESKGD
FSNGTVLYA	FSNGTVLYA
HTDVGLLEY	HTDVGLLEY
YNLTQDMKYLY	LTQDMKYLY
RLFGISLSY	RLFGISLSY
WLESVRLEY	WLESVRLEY
ENGWTTFYEY	NGWTTFYEY
SYEDMRGILY	SYEDRGILY
SSPVSSYQY	SSPVSSYQY
FYLLISQAMRY	LLISQAMRY
IDEPLEGSEDR	EPLEGSEDR
RTIQMFLVY	RTIQMFLVY
TTHSKIFQY	TTHSKIFQY
LFPDPVVQWLY	FPDPVQWLY
DNQAYPEY	-DNQAYPEY
VLNNVAHTF	VLNNVAHTF
YMDYRGYSY	YMDYRGYSY
GVYDKTSRY	GVYDKTSRY
FLPYNVMLY	FLPYNVMLY
YAGQFNQDY	YAGQFNQDY
GNQHFGYLY	GNQHFGYLY
AQEENWKFE	AQEENWKFE
VGLPVHLLF	VGLPVHLLF
GLHGVTFGY	GLHGVTFGY
EEEKNFKAF	EEEKNFKAF
YIIERCEE	-YIIERCEE
FNEFLSLPY	FNEFLSLPY
KMWEVQTGY	KMWEVQTGY
LLLVSHLY	-LLLVSHLY
GMLREDAVLEY	MLREAVLEY
YVYPLQLKY	YVYPLQLKY
AVADAIAQKY	AVADIAQKY
YFDHSTGFYY	YFDHTGFYY
RILNQILYY	RILNQILYY
TAADIFKQY	TAADIFKQY
ALYDKALGY	ALYDKALGY
FFFAPASSY	FFFAPASSY
SFEQFHLFY	SFEQFHLFY
YFVKVVPTVY	YFVKVPTVY
QTRFPLDYY	QTRFPLDYY
VLLEYHIAY	VLLEYHIAY
GILELMMRY	GILELMMRY
TVCGKAFSY	TVCGKAFSY
YGLEKFWAY	YGLEKFWAY
AVLGKGHQY	AVLGKGHQY
YLTKFIARY	YLTKFIARY
QSSSLVLHY	QSSSLVLHY
HMTKAFLFY	HMTKAFLFY
MFLHINQTY	MFLHINQTY
TYTEIHQEY	TYTEIHQEY
GNGFGGFGSY	NGFGGFGSY
LLHDRSFSY	LLHDRSFSY
HVLKKAHKY	HVLKKAHKY
FISRIWLTY	FISRIWLTY
LAYPNGHYF	LAYPNGHYF
SGLPALYYV	SGLPALYYV
KHGDLLFLF	KHGDLLFLF
EENKLVKKI	EENKLVKKI
VYLYYKLAY	VYLYYKLAY
LVYNGVYQY	LVYNGVYQY
FFRNIKFNY	FFRNIKFNY
SSRRGSLQAY	SSRRSLQAY
STPNNGYLY	STPNNGYLY
GFYFAKLYY	GFYFAKLYY
FITSVTALY	FITSVTALY
VVVPSGQEQRY	VVPSQEQRY
GAYGGGYGGY	AYGGGYGGY
FFPVWNHLY	FFPVWNHLY
IFIHLNDIY	IFIHLNDIY
LMTHHVHTY	LMTHHVHTY
VVFDKSDLAKY	VFDKDLAKY
SWHQKTYAF	SWHQKTYAF
KFFFIPLSY	KFFFIPLSY
TNPHNHLY	-TNPHNHLY
YLVIFPEGTRY	VIFPEGTRY
KSTAISLFY	KSTAISLFY
FTGNFFYNY	FTGNFFYNY
QFTAEGYLY	QFTAEGYLY
MYYGLSNFY	MYYGLSNFY
AVQHFSLLY	AVQHFSLLY
YLFAAPYYY	YLFAAPYYY
TYAPVAFRY	TYAPVAFRY
HFPSPIRLEF	HFPSIRLEF
FNMLFVFRY	FNMLFVFRY
VYCGVHRY	-VYCGVHRY
RLYELWLLY	RLYELWLLY
LVAFIRAEY	LVAFIRAEY
FYVEDLKARY	YVEDLKARY
QITPLLLNY	QITPLLLNY
WIPFMQEKY	WIPFMQEKY
FIRHQSDRY	FIRHQSDRY
KMHDKVFAY	KMHDKVFAY
FQDNRQLYY	FQDNRQLYY
RVIGSELVQKY	IGSELVQKY
LFLWPEAFLY	FLWPEAFLY
DSVHQLHY	-DSVHQLHY
FFHSLSEKY	FFHSLSEKY
QVDPLSALKY	QVDPSALKY
YIYPKHLKY	YIYPKHLKY
STKDRYEEY	STKDRYEEY
NFPFLVRLEY	NFPFVRLEY
GVYGKVHLY	GVYGKVHLY
FYPKANIVAY	FYPKNIVAY
YLPYNHQHEY	YLPYHQHEY
LAGHGHLY	-LAGHGHLY
YFINWDLDM	YFINWDLDM
LLLKVLLRY	LLLKVLLRY
HYYSITINY	HYYSITINY
YTIATILHY	YTIATILHY
RILEKPFEY	RILEKPFEY
LPRTDYSF	-LPRTDYSF
TFEDLLLKY	TFEDLLLKY
SLFPGTHLTPY	LFPGHLTPY
QYEAFKDMLY	YEAFKDMLY
LPYNMPLAY	LPYNMPLAY
TTSVVTAALY	TTSVTAALY
VLLDEGAMLLY	LLDEAMLLY
LYINFRHLY	LYINFRHLY
AFFEGPPFKF	FFEGPPFKF
LFNAIIHKY	LFNAIIHKY
FTSLSLVLY	FTSLSLVLY
VFLQLRPEY	VFLQLRPEY
KVLQKFLTY	KVLQKFLTY
TFHFLLGSIY	TFHFLGSIY
VMGMRSYYY	VMGMRSYYY
YVHKPYLY	-YVHKPYLY
VAVGRALYY	VAVGRALYY
ILKEDPANTVY	KEDPANTVY
FYQQWQLKY	FYQQWQLKY
HYPPPVPFGY	HYPPVPFGY
SFFAGSQKY	SFFAGSQKY
LPYNHQHEYF	LPYNHQHEY
FFGPVGFNF	FFGPVGFNF
AQVQVLLYY	AQVQVLLYY
KFSPLPLKY	KFSPLPLKY
QQHINSLTY	QQHINSLTY
YIMAPGLLH	YIMAPGLLH
GTVIEHPEY	GTVIEHPEY
KQCGKTFSY	KQCGKTFSY
AEDPLGAIHL	AEDPGAIHL
HYQPLLLLY	HYQPLLLLY
AVGGGLLYY	AVGGGLLYY
HFQVAERALY	FQVAERALY
FFITYIPFY	FFITYIPFY
SFYVPSGNYY	FYVPSGNYY
KYIDFTSDY	KYIDFTSDY
FTAVPILGY	FTAVPILGY
LTSDLTFAY	LTSDLTFAY
RFQTILLYY	RFQTILLYY
KMKETAENY	KMKETAENY
FFRAEELEY	FFRAEELEY
LFIILTVGHY	FIILTVGHY
YVIVRAYQY	YVIVRAYQY
QEHQGHQTF	QEHQGHQTF
AFSHWTYEY	AFSHWTYEY
NNNPITVQTVY	NPITVQTVY
HYSQELSLLY	YSQELSLLY
ASYEVKELY	ASYEVKELY
YFGSNIAHMY	YFGSIAHMY
LGLAVRLEY	LGLAVRLEY
SVHVIMYLY	SVHVIMYLY
QWWKKSLTY	QWWKKSLTY
YLYLQSCSD	YLYLQSCSD
ATLRNYDYY	ATLRNYDYY
FILSVRLDY	FILSVRLDY
AFYKISTLYY	AFYKISTLY
SFPHPLPSL	SFPHPLPSL
ILLDEALKY	ILLDEALKY
LPYNQQHLY	LPYNQQHLY
HILGFELKY	HILGFELKY
AASPVVAEY	AASPVVAEY
LFGILCVGLY	LFGICVGLY
IVFENTDLHSY	FENTDLHSY
HNLLLNYGLY	NLLLNYGLY
ITSSNFLHY	ITSSNFLHY
QMLHTNLVY	QMLHTNLVY
SLKGDADLY	SLKGDADLY
YTYPYAYYM	YTYPYAYYM
VQSKVNLKY	VQSKVNLKY
TFAHEVGHNF	FAHEVGHNF
ALATLALNY	ALATLALNY
RVLPKYLGY	RVLPKYLGY
HNSPAYLAY	HNSPAYLAY
LALNFSVFY	LALNFSVFY
GFMGQLLQY	GFMGQLLQY
YIDSKFEDY	YIDSKFEDY
RFKEPLPEY	RFKEPLPEY
FFWGLRSYY	FFWGLRSYY
SALPLAIKY	SALPLAIKY
SSFFAKIPYYY	FFAKIPYYY
FTPDIPTMLY	FTPDPTMLY
VAVSHPLHY	VAVSHPLHY
GVLKIQVHY	GVLKIQVHY
RVLETELHY	RVLETELHY
YYIPGALY	-YYIPGALY
KQFDDVLIY	KQFDDVLIY
GNLKEGLQY	GNLKEGLQY
SSFKNIYRY	SSFKNIYRY
TYFEEIKQFYY	YFEEIKQFY
YIRHTHQLY	YIRHTHQLY
FYLPIAAAM	FYLPIAAAM
GQLVKMLLY	GQLVKMLLY
SFTDVIGHY	SFTDVIGHY
SLLHLGALY	SLLHLGALY
KNFERALKY	KNFERALKY
YYYDPTTGLY	YYDPTTGLY
AVNWLGYAY	AVNWLGYAY
QVLEPQLTY	QVLEPQLTY
YNYPKPIEY	YNYPKPIEY
VYLQKLDTAY	YLQKLDTAY
GTSPFAYDY	GTSPFAYDY
HPSDIHLLY	HPSDIHLLY
SFTHEALTLKY	FTHELTLKY
KIDENQLMY	KIDENQLMY
GFMTTAFQY	GFMTTAFQY
LFQHITALF	LFQHITALF
IIAKVFLAY	IIAKVFLAY
TFMALPEEY	TFMALPEEY
TLLEKQLEY	TLLEKQLEY
SVLPFQIYY	SVLPFQIYY
LTADGLYLY	LTADGLYLY
LYITGAALY	LYITGAALY
NVCGKVFNY	NVCGKVFNY
ALSDLALHF	ALSDLALHF
LTWDGFPLHY	LTWDFPLHY
SFFEIYNEY	SFFEIYNEY
SSADIRKAY	SSADIRKAY
KYYARHYLY	KYYARHYLY
ILLSPALSY	ILLSPALSY
FMVTFPYGY	FMVTFPYGY
DIWPNPLQY	DIWPNPLQY
YYYNGKTVY	YYYNGKTVY
IYLYVAPAY	IYLYVAPAY
TLADILLYY	TLADILLYY
YVIQKFFEF	YVIQKFFEF
QQHPQAAASY	QQHPAAASY
LLLRNYLHY	LLLRNYLHY
YGFQYPLAM	YGFQYPLAM
SVFDADTLLY	SVFDDTLLY
TLLSHVALY	TLLSHVALY
IFFEVDGPY	IFFEVDGPY
TYLNDFFSY	TYLNDFFSY
NEIEDTFRQF	EIEDTFRQF
RFWDIKSKY	RFWDIKSKY
VSGKLALRY	VSGKLALRY
AVLEMDAERMG	AVLEMDAER
YANKMAFRY	YANKMAFRY
ATLPRNFHY	ATLPRNFHY
YYPKTNALYF	YYPKTNALY
YFPELIANF	YFPELIANF
IFIEVFSHF	IFIEVFSHF
GYNQRPPYGYY	YNQRPPYGY
GNYSGAAEY	GNYSGAAEY
IISEFALEY	IISEFALEY
VVFVTKFLY	VVFVTKFLY
LNLERDVED	LNLERDVED
ALWTGQYRY	ALWTGQYRY
HLLNEALKY	HLLNEALKY
AVLGETLIPHY	VLGELIPHY
AIITTHLQY	AIITTHLQY
EEFGRFASF	EEFGRFASF
IVANLKETGY	IVANKETGY
HSLDMKFSY	HSLDMKFSY
RVADTFQDY	RVADTFQDY
QTLEHNFEY	QTLEHNFEY
ITSSPHPEY	ITSSPHPEY
AFLEPLGLAY	AFLELGLAY
TIMEDYFAY	TIMEDYFAY
VFMHVSTAY	VFMHVSTAY
IFDCKYRNY	IFDCKYRNY
GTLLGKFTY	GTLLGKFTY
SLEHLPANLFY	EHLPANLFY
TYHWQELSY	TYHWQELSY
TFVWPAHFKY	FVWPAHFKY
ESPLYPINTP	----ESPLY
GSHSMRYF	-GSHSMRYF
AYFPYFITY	AYFPYFITY
NILTDHFQY	NILTDHFQY
FINDQYEKY	FINDQYEKY
FFYFEGTFY	FFYFEGTFY
DEHEGPALYY	DEHEGPALY
LLLVPAMY	-LLLVPAMY
VYTSVQAQY	VYTSVQAQY
TFAKMWILY	TFAKMWILY
GQLTGMYRY	GQLTGMYRY
WVFEHPETLY	VFEHPETLY
PFLGIGLLY	PFLGIGLLY
YILAQNFFY	YILAQNFFY
KMKETAEAY	KMKETAEAY
LYPPKHWRY	LYPPKHWRY
ALINTVLKY	ALINTVLKY
SVLALVAYY	SVLALVAYY
MVSSVVGFY	MVSSVVGFY
KQCGKSFSY	KQCGKSFSY
LLAQLHARY	LLAQLHARY
GSLSTTSHF	GSLSTTSHF
NFIYIAATY	NFIYIAATY
YYLEQLILKY	YYLELILKY
SFYQGEKNFY	SFYQEKNFY
KVVEGSFVY	KVVEGSFVY
LLWDRILGY	LLWDRILGY
MFNALIHRY	MFNALIHRY
KILETSFGY	KILETSFGY
FPVLFQDVIY	PVLFQDVIY
RFFGVYLLY	RFFGVYLLY
GQIRLRALY	GQIRLRALY
QLDDLKVEL	QLDDLKVEL
VVTVIVLQY	VVTVIVLQY
NLVHLDLSY	NLVHLDLSY
ALGNTVLHY	ALGNTVLHY
YTGGIGFKY	YTGGIGFKY
QRATAILAY	QRATAILAY
EELEQKYTY	EELEQKYTY
SVLPHTGYIY	SVLPTGYIY
LTKIALRY	-LTKIALRY
YVHNDIFRY	YVHNDIFRY
AVITVPAYF	AVITVPAYF
WVQEHYLEY	WVQEHYLEY
SWHEALLYY	SWHEALLYY
RVYLGALKY	RVYLGALKY
SFFTPLLLF	SFFTPLLLF
SLYASSPGGVY	YASSPGGVY
YYNEATGGKY	YYNETGGKY
HNGMIDLKY	HNGMIDLKY
GVNPHVNHLY	GVNPVNHLY
GGYNQPSLGY	GYNQPSLGY
LAYLRTECY	LAYLRTECY
KDLLVLFGG	KDLLVLFGG
KEMESIDQY	KEMESIDQY
IYAKPLHSY	IYAKPLHSY
FVLSLGVAALY	LSLGVAALY
KFYAKGALQY	FYAKGALQY
HVFGDELSL	HVFGDELSL
FIATYQANY	FIATYQANY
VVGPSSVLTY	VVGPSVLTY
ANATVLLDY	ANATVLLDY
AMSQETYLY	AMSQETYLY
SLLFVMLRY	SLLFVMLRY
SFVEFILEPLY	FVEFLEPLY
KVCDKAFAY	KVCDKAFAY
FFIDRPSTY	FFIDRPSTY
GNHDIGFHY	GNHDIGFHY
FIGYPITLY	FIGYPITLY
SVLDSFLKY	SVLDSFLKY
TSTHLTALHY	STHLTALHY
GELGNGNIKL	ELGNGNIKL
YFPFMDLKL	YFPFMDLKL
QYSHQTHRY	QYSHQTHRY
AAFKIFLKY	AAFKIFLKY
SVVDISQQY	SVVDISQQY
FLFVSHAY	-FLFVSHAY
RAAPFSLEY	RAAPFSLEY
LFKEMCYRY	LFKEMCYRY
YFTHHSVKY	YFTHHSVKY
NDEELNKLLGK	EELNKLLGK
SFLDFAPHY	SFLDFAPHY
EVYAGSHQY	EVYAGSHQY
YLYCMIYTL	YLYCMIYTL
VTAGNRLFY	VTAGNRLFY
LNLPYFLRY	LNLPYFLRY
AVYTIALRY	AVYTIALRY
GQIAYSLLY	GQIAYSLLY
NLPNLAAAY	NLPNLAAAY
RVQGFQVEY	RVQGFQVEY
NYSHLVSVGY	NYSHVSVGY
DLPKDCFIIY	LPKDCFIIY
IAIRIPLRY	IAIRIPLRY
IVYPQKAYY	IVYPQKAYY
TADGKTYYY	TADGKTYYY
AFLGPKDIFPY	FLGPDIFPY
QVHNLLLTY	QVHNLLLTY
IYESGGHLY	IYESGGHLY
HFQHGGYQY	HFQHGGYQY
SVLQHAYSY	SVLQHAYSY
SSLPTQMDY	SSLPTQMDY
KYFDEHYEY	KYFDEHYEY
QTNYLYLTY	QTNYLYLTY
VYKAFVDNY	VYKAFVDNY
KVILKNFLY	KVILKNFLY
PDNNFHSLY	PDNNFHSLY
GWFDGTQQEY	WFDGTQQEY
SQDLGFSYY	SQDLGFSYY
IYFEAYLY	-IYFEAYLY
LLAALGYRY	LLAALGYRY
IMKFINDQY	IMKFINDQY
SILGLLLLY	SILGLLLLY
RMFARLLHY	RMFARLLHY
GLSSSILLY	GLSSSILLY
LFYHKQTHY	LFYHKQTHY
KVADMALH	-KVADMALH
IADMGHLKY	IADMGHLKY
AVFTGALIY	AVFTGALIY
SFSNIISDM	SFSNIISDM
LEMRLSWIY	LEMRLSWIY
MIGYPMPTGY	IGYPMPTGY
LTHSLVLHY	LTHSLVLHY
FMKMDLLNY	FMKMDLLNY
VVAALRASY	VVAALRASY
YGLEPAHPLLY	GLEPHPLLY
YYAPGYTQTSY	YAPGTQTSY
STSSHCLLY	STSSHCLLY
ATLSLFNTY	ATLSLFNTY
YWGEIISQQY	YWGEISQQY
SVFKYMALY	SVFKYMALY
VFEYEPTIFY	FEYEPTIFY
VILDIPLLF	VILDIPLLF
MVTEIRLKY	MVTEIRLKY
HLDEAQRLLY	HLDEQRLLY
NAFDVFAAY	NAFDVFAAY
TIAPRTHPY	TIAPRTHPY
RLPDAHSDY	RLPDAHSDY
SFSNTPNSGY	SFSNPNSGY
SFVDPGERLY	FVDPGERLY
SVGKWQDRY	SVGKWQDRY
FVCRMCGKKY	FVCRCGKKY
ISTEVIPSLPI	ISTEVIPSL
GVGNLRLGY	GVGNLRLGY
FLKSTQEMY	FLKSTQEMY
VGGESIYYD	VGGESIYYD
TVGAAAWWFLY	GAAAWWFLY
MILDQAFKY	MILDQAFKY
FVVAVGAEY	FVVAVGAEY
DQVANSAFVER	QVANSAFVE
KYLALNMHY	KYLALNMHY
SEIESNRSF	SEIESNRSF
YHPNFRGFDY	HPNFRGFDY
YYVHLGGQKY	YVHLGGQKY
YVLHIGTIY	YVLHIGTIY
LIDASWSA	-LIDASWSA
ANVSLLALY	ANVSLLALY
YLVALGHAY	YLVALGHAY
LYLPSFFTY	LYLPSFFTY
VMINKATPY	VMINKATPY
LVTEVIPNY	LVTEVIPNY
DFQMEQYIY	DFQMEQYIY
YLGDFPYYY	YLGDFPYYY
IFLILTTTGHY	LILTTTGHY
YSSPYPQEY	YSSPYPQEY
TVLELVTQY	TVLELVTQY
MVQALELLY	MVQALELLY
GLGAFRTLY	GLGAFRTLY
SVKEMRERY	SVKEMRERY
YVTGGHLFY	YVTGGHLFY
YFHSITLLY	YFHSITLLY
LENTRWLEY	LENTRWLEY
SLFFVPLSY	SLFFVPLSY
GLIDLVFLY	GLIDLVFLY
RLIEMTAEY	RLIEMTAEY
LVSHIQLHY	LVSHIQLHY
LYTSVVVKY	LYTSVVVKY
ELWPNPLQY	ELWPNPLQY
ALYKKILKY	ALYKKILKY
AEHDRIARQW	AEHDRIARQ
GWSITPLMY	GWSITPLMY
GVLEEHHHY	GVLEEHHHY
SSLGGRDLY	SSLGGRDLY
VQTHYYNY	-VQTHYYNY
KSLALLLNY	KSLALLLNY
ETNADVYYY	ETNADVYYY
GGVADALLY	GGVADALLY
TALETTYQY	TALETTYQY
SVVDIYVNY	SVVDIYVNY
YYIKVILDY	YYIKVILDY
LFKKYAEKY	LFKKYAEKY
FILWRHLEY	FILWRHLEY
VMFEKIAKY	VMFEKIAKY
SFYANSSTLYY	YANSSTLYY
RIYGLGSLALY	YGLGSLALY
IWFEKRLAY	IWFEKRLAY
SFVWHALDY	SFVWHALDY
GVSDLSPEY	GVSDLSPEY
LLGQPLQY	-LLGQPLQY
VISARTYFY	VISARTYFY
SDVGGHHY	-SDVGGHHY
SFNRHNLKY	SFNRHNLKY
MMNGGHYTY	MMNGGHYTY
PHFVNTVEM	PHFVNTVEM
KDLVTILFY	KDLVTILFY
YYDPTTGLY	YYDPTTGLY
LLQTVHAEY	LLQTVHAEY
LLYDEYMYY	LLYDEYMYY
FIANLFNRY	FIANLFNRY
LGSALYFSF	LGSALYFSF
RVIELVQKY	RVIELVQKY
NTTGISEKY	NTTGISEKY
ILNKAVYLF	ILNKAVYLF
NFSHGTHEY	NFSHGTHEY
QFHPNLDYY	QFHPNLDYY
FLANVHKAYY	FLANVHKAY
IMNDKLTEY	IMNDKLTEY
KLADQIFAYY	KLADQIFAY
VALQKALLY	VALQKALLY
RVNDVPEEFMY	RVNDVPEEF
FFERSGLAY	FFERSGLAY
TLSVSMLLRY	LSVSMLLRY
KVNTLALKY	KVNTLALKY
WYSEQASLEM	YSEQASLEM
TEIPDTQEM	TEIPDTQEM
YINLVAYPY	YINLVAYPY
HIISFTVKY	HIISFTVKY
ILAQITGTEH	ILAQITGTE
HAANQSYQY	HAANQSYQY
IVVPFMFKY	IVVPFMFKY
VVGSEFVQKY	VVGSFVQKY
IVVKLNSGDY	VVKLNSGDY
YFENTDILIY	FENTDILIY
ILLGLIIAY	ILLGLIIAY
LQHRVQLKY	LQHRVQLKY
GSVDILLEY	GSVDILLEY
LFLDHKTLY	LFLDHKTLY
VMHQIISKY	VMHQIISKY
RQLLCLIDY	RQLLCLIDY
VYAKLLHRY	VYAKLLHRY
RNADVFLKY	RNADVFLKY
YIEFVKGYY	YIEFVKGYY
STTNSGFAY	STTNSGFAY
IVFGKRFHY	IVFGKRFHY
NNFSDTGNFGF	NFSDGNFGF
HAISRYWYY	HAISRYWYY
LVTTVLPLY	LVTTVLPLY
VLFLKFLEY	VLFLKFLEY
SFASDPILY	SFASDPILY
GYTQPGPGY	GYTQPGPGY
MLAGMGLHY	MLAGMGLHY
VTTVVNPKY	VTTVVNPKY
LWLQHSLQY	LWLQHSLQY
SFKDNSNLY	SFKDNSNLY
SLLERLLTY	SLLERLLTY
GLAEIKMLY	GLAEIKMLY
RYPDLELKY	RYPDLELKY
YFQTYFLTPS	YFQTYFLTP
QTSFLHLGY	QTSFLHLGY
QFIHAADMLY	FIHAADMLY
SLLGQPLQY	SLLGQPLQY
YLLRILHTYY	YLLRILHTY
SSSRYFEFY	SSSRYFEFY
TVYDKPASF	TVYDKPASF
SFRTGNPTGTY	RTGNPTGTY
ITQGTPLKY	ITQGTPLKY
ALLSLHFLF	ALLSLHFLF
HNDFQALKY	HNDFQALKY
MIAAQLLAY	MIAAQLLAY
MIASHLLAY	MIASHLLAY
VVLSNGILYQY	VVLSNGILY
VANALAHKY	VANALAHKY
LYSHLVPVY	LYSHLVPVY
YYQTAPKAGY	YQTAPKAGY
IYIKHPHLF	IYIKHPHLF
IAPEILQGLKY	PEILQGLKY
SLISQVFYY	SLISQVFYY
FGVTANLVLY	GVTANLVLY
SYLAPTPSY	SYLAPTPSY
RREEELQY	-RREEELQY
VVLTVKASY	VVLTVKASY
TLITQFLVY	TLITQFLVY
YLWHIPLTY	YLWHIPLTY
IEQEGPEY	-IEQEGPEY
TELDLHKRL	TELDLHKRL
SFMGQLLQF	SFMGQLLQF
PVVFSLYNP	PVVFSLYNP
QEFGVPHQY	QEFGVPHQY
IFTAFDTYY	IFTAFDTYY
SFHVIFVLY	SFHVIFVLY
YYIRFFITY	YYIRFFITY
QFFDQHLKF	QFFDQHLKF
YTFEKSYEF	YTFEKSYEF
GTDSASGMDY	GTDSSGMDY
GSYSQQPSY	GSYSQQPSY
FFGREVDAEY	FFGRVDAEY
TVLLFHFDY	TVLLFHFDY
RAYAKALHY	RAYAKALHY
YYSHLEGARF	YYSHEGARF
NQFQALLQY	NQFQALLQY
SLSLENVLYY	LSLENVLYY
IILPRGLEY	IILPRGLEY
YLNNSVMEY	YLNNSVMEY
YYPDGHGDYAY	YYPDGHGDY
VMLGTQLLYKF	VMLGTQLLY
WFAGKMITAAY	FAGKITAAY
AILDHTYKM	AILDHTYKM
GNVSLSLLY	GNVSLSLLY
TSHRQQFYQ	TSHRQQFYQ
SFVAGVVTFY	FVAGVVTFY
IFIEDAIKY	IFIEDAIKY
IFSIKPLQF	IFSIKPLQF
RLQDLLLHY	RLQDLLLHY
SYSQHQSSY	SYSQHQSSY
REATGKITF	REATGKITF
TIYSGADRY	TIYSGADRY
SASDVHGNF	SASDVHGNF
MWAPHSYLY	MWAPHSYLY
LSLGLVLSY	LSLGLVLSY
TVIKLAILY	TVIKLAILY
RQINWTVLY	RQINWTVLY
MISHIVTYY	MISHIVTYY
LLRSFCQSY	LLRSFCQSY
LVMAERLRY	LVMAERLRY
FFTPPASKGNY	FTPPSKGNY
MINIWNVKY	MINIWNVKY
VFSKFYLTY	VFSKFYLTY
VMATFTEFY	VMATFTEFY
SVMDKMQLTY	SVMDMQLTY
NTASYSGAYY	TASYSGAYY
NTISTGLLY	NTISTGLLY
NYSHLVSLGY	NYSHVSLGY
SENSRVSHY	SENSRVSHY
SPYWVSPAY	SPYWVSPAY
HTKKDYEEY	HTKKDYEEY
LNFHVFLEY	LNFHVFLEY
IVLPGNFLY	IVLPGNFLY
AVGEIIQHY	AVGEIIQHY
IIFDNVNFMY	IFDNVNFMY
VFSEVSPLY	VFSEVSPLY
KYFFGEGYTY	YFFGEGYTY
FTEEQAVLY	FTEEQAVLY
GLPGVFVLY	GLPGVFVLY
GLMGKPSILTY	LMGKSILTY
RMLTLWLDY	RMLTLWLDY
LVYDIAKHLTY	YDIAKHLTY
HVYKVLELY	HVYKVLELY
GTAKIHELY	GTAKIHELY
SNRASTETY	SNRASTETY
EFIRFHPQY	EFIRFHPQY
LCTLVECLY	LCTLVECLY
SAYKRGYLY	SAYKRGYLY
TTLRWALLY	TTLRWALLY
YFWDPDYQEAL	YFWDPDYQE
SVFEVFVLY	SVFEVFVLY
KQQASHYLY	KQQASHYLY
IVGPDGLVY	IVGPDGLVY
PQPCCLHLY	PQPCCLHLY
EVNAVVLLY	EVNAVVLLY
LHLQLIRNY	LHLQLIRNY
YGGRFESSY	YGGRFESSY
QYHALGLLY	QYHALGLLY
NTVTRQWLY	NTVTRQWLY
GVYVAAVREFY	YVAAVREFY
SLYDRPASY	SLYDRPASY
LIDKNLIDY	LIDKNLIDY
VFKEDGQEY	VFKEDGQEY
VLFPTQILY	VLFPTQILY
SVTAITVLY	SVTAITVLY
SMGKTLLVY	SMGKTLLVY
YGLGVMAQY	YGLGVMAQY
DSYVGDEAQSK	YVGDEAQSK
PAGGGDPILY	AGGGDPILY
FFAAITNKY	FFAAITNKY
RNLATIFL	-RNLATIFL
FMWQYQLRY	FMWQYQLRY
IYLDIIHTY	IYLDIIHTY
SLNEPVPGY	SLNEPVPGY
VYFPIRTLY	VYFPIRTLY
WHIAYVLLY	WHIAYVLLY
ALYQKVLLY	ALYQKVLLY
KVSMEGHLY	KVSMEGHLY
GVAERSWLY	GVAERSWLY
IYGYVDATY	IYGYVDATY
SEASVFDAY	SEASVFDAY
YLLSLLRPQIY	LLSLRPQIY
HYGNLGRLY	HYGNLGRLY
RFNDAAYYY	RFNDAAYYY
VVISPPQFY	VVISPPQFY
GLWENGLSY	GLWENGLSY
VGHMDYKY	-VGHMDYKY
RQAELFALY	RQAELFALY
SEVSTVLKL	SEVSTVLKL
STDHIPILY	STDHIPILY
VLLDVAYAY	VLLDVAYAY
NQVGQVILY	NQVGQVILY
TPLAFQLIY	TPLAFQLIY
GVYDVRQAY	GVYDVRQAY
TTLAIASSY	TTLAIASSY
YWKSVILEY	YWKSVILEY
TLADLQLEY	TLADLQLEY
LFPVVAYAY	LFPVVAYAY
HISKETLFY	HISKETLFY
EYFLLKAKY	EYFLLKAKY
GLFAHELFY	GLFAHELFY
IYGRNGYDY	IYGRNGYDY
YFAYRGFKY	YFAYRGFKY
STNAYMLI	-STNAYMLI
GTLGLTVTY	GTLGLTVTY
LFFGNNSISF	FFGNNSISF
MVLNSQSLY	MVLNSQSLY
AAIGLVIYY	AAIGLVIYY
LSKEDIER	-LSKEDIER
GYGSQGYKY	GYGSQGYKY
TFADFDGVLY	TFADDGVLY
TVGEGYGY	-TVGEGYGY
YLHDQFWSY	YLHDQFWSY
HYKPSPERY	HYKPSPERY
HLFDIITQY	HLFDIITQY
EVFDKTYQF	EVFDKTYQF
SLRRSVEKY	SLRRSVEKY
RLNDELLHY	RLNDELLHY
YFPYYPYNY	YFPYYPYNY
SNNSLFLEY	SNNSLFLEY
TMILTVGGTAY	ILTVGGTAY
YVIDTSLLY	YVIDTSLLY
MYDAAKLLY	MYDAAKLLY
SVIEQILHY	SVIEQILHY
FLLNHSLEY	FLLNHSLEY
ANFSLPEKCDY	FSLPEKCDY
QVLFQRFFY	QVLFQRFFY
SMLDIALLM	SMLDIALLM
TALSFYDGY	TALSFYDGY
NFPSLTHLY	NFPSLTHLY
FFLHLKEFY	FFLHLKEFY
NFTEVHPDY	NFTEVHPDY
SMESFPPLAY	SMESPPLAY
MVPKVRLLY	MVPKVRLLY
IFHKNVFHY	IFHKNVFHY
FYSKLGLQY	FYSKLGLQY
FIDHDITSQLY	IDHDTSQLY
YLMDNLFKY	YLMDNLFKY
MVQPINLIFRY	QPINLIFRY
SVNHINLFF	SVNHINLFF
YFLRGYRY	-YFLRGYRY
IYFQPPSFY	IYFQPPSFY
YIYFGPVYY	YIYFGPVYY
FSFGYALVY	FSFGYALVY
VYLGAVNALY	YLGAVNALY
FFNIPQIQ	-FFNIPQIQ
FTSFISLYN	FTSFISLYN
STNAYMLIY	STNAYMLIY
SFPILGHSY	SFPILGHSY
YHIGIPLTY	YHIGIPLTY
NFAHVTSLGY	NFAHTSLGY
VILKLLLKY	VILKLLLKY
MTAPLKLTY	MTAPLKLTY
ALIGIYPEY	ALIGIYPEY
CKMSVEYDKF	KMSVEYDKF
GVTTVGVAY	GVTTVGVAY
VLAFIILNY	VLAFIILNY
IMDELKYYY	IMDELKYYY
YFGEIALLL	YFGEIALLL
LFWDQTQQHSY	FWDQQQHSY
KIGYHLLYY	KIGYHLLYY
GTYGQPTDVSY	TYGQTDVSY
FYLPIAAAMY	FYLPAAAMY
FLPHMAYTY	FLPHMAYTY
LMHSIVGSY	LMHSIVGSY
AFQERLNSY	AFQERLNSY
YFLGHSLEF	YFLGHSLEF
NSIYFHGNE	NSIYFHGNE
RVVGSELIQKY	VVGSLIQKY
VYLEDGFAY	VYLEDGFAY
KMLRDTLYY	KMLRDTLYY
NTAVPLPGY	NTAVPLPGY
KSSAISLHY	KSSAISLHY
FYPKLKSGGY	FYPKKSGGY
IFSGLHNLQY	IFSGHNLQY
WLEEGIHWQY	LEEGIHWQY
INSSGHYQY	INSSGHYQY
FLPPLVLNF	FLPPLVLNF
LYTKHGTLKY	YTKHGTLKY
YVWRNIILM	YVWRNIILM
SFVDKPVAY	SFVDKPVAY
NTNRSAFKY	NTNRSAFKY
KFYNGLLFY	KFYNGLLFY
SFHETLLNY	SFHETLLNY
SEAEHQRAY	SEAEHQRAY
SFHDLSKRY	SFHDLSKRY
YAFGKYLGY	YAFGKYLGY
TLGSLALLY	TLGSLALLY
YFVKFLDAY	YFVKFLDAY
TFMQLRLIY	TFMQLRLIY
LWIDRQWQY	LWIDRQWQY
ILNDMVWKY	ILNDMVWKY
YFQDLIKGIEY	FQDLKGIEY
GQYDQALKY	GQYDQALKY
VLNDQHWHY	VLNDQHWHY
VNIAVIKYL	VNIAVIKYL
LFGGEPLSY	LFGGEPLSY
GLATQAFHY	GLATQAFHY
QVISRSFLY	QVISRSFLY
SFLSIGARY	SFLSIGARY
MMGHPGMHY	MMGHPGMHY
SLGDSTDSY	SLGDSTDSY
IYIKHPHLFKY	YIKHHLFKY
YVPEEIYRY	YVPEEIYRY
LDIDSPPITAR	IDSPPITAR
SYFRASSTMRY	YFRASTMRY
LFGTVILKY	LFGTVILKY
TLQGIALKY	TLQGIALKY
ISKIHSLY	-ISKIHSLY
TLPRNFHY	-TLPRNFHY
YMWKTTDRY	YMWKTTDRY
TSLPTSHTY	TSLPTSHTY
LLDEALKYL	LLDEALKYL
SVLHVAATY	SVLHVAATY
GFSGLFAAY	GFSGLFAAY
VAQYRPEEY	VAQYRPEEY
TWNPLKLHY	TWNPLKLHY
YTGPSHHSY	YTGPSHHSY
AVIEDTWHYF	AVIEDTWHY
KLLGLPEDYLY	KLLGLPEDY
LGDLNYLIY	LGDLNYLIY
FYLNPDQSGEF	YLNPQSGEF
WLPALFTDLY	WLPAFTDLY
TVFSQAIHY	TVFSQAIHY
MMYTAPGHHGY	YTAPGHHGY
GYLHDFLKY	GYLHDFLKY
SIADLVFTY	SIADLVFTY
VFLSIKGIYY	VFLSKGIYY
YTDTGLWGLY	YTDTLWGLY
STLEVTSLKY	STLETSLKY
FFNYIEKLKY	FFNYEKLKY
VYLPPEAFTF	YLPPEAFTF
IINDRIYPY	IINDRIYPY
FYTATESQY	FYTATESQY
SNFRGGSDGY	NFRGGSDGY
IIPAIWFRY	IIPAIWFRY
RVLQQTLNY	RVLQQTLNY
RVFPYSVFY	RVFPYSVFY
NASPEMRQRY	ASPEMRQRY
IFWKVNYNF	IFWKVNYNF
HLPTQPHLY	HLPTQPHLY
VVNPFIYAY	VVNPFIYAY
APFLKMYSEY	PFLKMYSEY
KFQALCNLY	KFQALCNLY
NVMDTHLLF	NVMDTHLLF
HYGGPGPKY	HYGGPGPKY
YFGTSHPRY	YFGTSHPRY
VYSDLHAFYY	VYSDLHAFY
NTYPIKLFY	NTYPIKLFY
SFLERFNTHY	SFLEFNTHY
LSFPTTKTY	LSFPTTKTY
ILAHLTGTEF	ILAHTGTEF
VIKETQERY	VIKETQERY
SISGVTAAY	SISGVTAAY
SEIRHTADRW	SEIRHTADR
VYQAVQALY	VYQAVQALY
TTIDIGVKY	TTIDIGVKY
DFLDKLLRY	DFLDKLLRY
FYRVTTEQY	FYRVTTEQY
HLVIIKGTEY	LVIIKGTEY
LFAPFIVYY	LFAPFIVYY
NFIAPNKYEY	FIAPNKYEY
STLPDKLSY	STLPDKLSY
AFSSLMGYQY	AFSSMGYQY
YLKHFTKEL	YLKHFTKEL
FYDDKKYTY	FYDDKKYTY
LSADVFARY	LSADVFARY
HVLPDPGLRY	VLPDPGLRY
IMFVIDSGY	IMFVIDSGY
VYIDIDPLLY	VYIDDPLLY
YYYDGDIGNYY	YYDGIGNYY
YLTEPVDEY	YLTEPVDEY
NYLHDFLKY	NYLHDFLKY
YYYDGDIGNY	YYDGDIGNY
RQIDFVLSY	RQIDFVLSY
IMDQYANRLAY	DQYANRLAY
HFEVVKLLV	HFEVVKLLV
IFIRFPKTLF	IFIRPKTLF
GTMGLSARY	GTMGLSARY
STVLVEGGY	STVLVEGGY
FFFTARTSF	FFFTARTSF
HLYYGTSSGSY	YYGTSSGSY
KTFDHYCEY	KTFDHYCEY
AVLDHTIPY	AVLDHTIPY
SLKEITEKY	SLKEITEKY
TFSHIKLTY	TFSHIKLTY
KFVEGVDSDY	FVEGVDSDY
AAAGFHLEY	AAAGFHLEY
YYSKVTPSY	YYSKVTPSY
IFWTLPHEY	IFWTLPHEY
TVTTTQASY	TVTTTQASY
AFRQPSLFY	AFRQPSLFY
FTDVNSILRY	FTDVSILRY
RNTEEEGLKY	NTEEEGLKY
GNVQVLLEY	GNVQVLLEY
RTFPFSLQY	RTFPFSLQY
FISDFSISY	FISDFSISY
LILEEILAY	LILEEILAY
WVTRYMLLY	WVTRYMLLY
FFTATEGQY	FFTATEGQY
TAGSAEAPLQY	GSAEAPLQY
PDVGNFHY	-PDVGNFHY
AMLGVPQLY	AMLGVPQLY
HTNRLAVAY	HTNRLAVAY
KLFPGSPAIY	LFPGSPAIY
SYGPFYLEY	SYGPFYLEY
AFGDLALFF	AFGDLALFF
QLPSRFHQY	QLPSRFHQY
WLMDHIFKY	WLMDHIFKY
LMFNNAWLY	LMFNNAWLY
TVLSDSLYI	TVLSDSLYI
NYLEENLLY	NYLEENLLY
AYPTQPGQGY	AYPTPGQGY
QYLLVTALY	QYLLVTALY
KLKNVFLAY	KLKNVFLAY
ALLKHLLSY	ALLKHLLSY
YFLTSFYTKY	FLTSFYTKY
GMPGVNIAY	GMPGVNIAY
SLMKDCFEY	SLMKDCFEY
HLASLRLHY	HLASLRLHY
GMMKELLYF	GMMKELLYF
AAAVVGLLY	AAAVVGLLY
IQYLSNLQY	IQYLSNLQY
AYPSIHAAY	AYPSIHAAY
NWGRVVALFY	NWGRVALFY
KLIENPLLRY	LIENPLLRY
LTAAKKARAG	LTAAKKARA
NFAAVAAAAYY	AAVAAAAYY
RNFARFLNY	RNFARFLNY
RVFGFPVHY	RVFGFPVHY
SFGLYGLLY	SFGLYGLLY
KQLQVLLAY	KQLQVLLAY
NFDKLSFLY	NFDKLSFLY
FWIHMQDAVY	FWIHQDAVY
NFEYLRGNY	NFEYLRGNY
SFGELALIY	SFGELALIY
SYPNVFLVF	SYPNVFLVF
YFEGLYPTYY	YFEGLYPTY
FTQHVYHKY	FTQHVYHKY
TTSPLMLQY	TTSPLMLQY
VLLHFAMAY	VLLHFAMAY
GMETKMALNY	METKMALNY
KLKEFVDYY	KLKEFVDYY
SLIDILLAY	SLIDILLAY
TAFGGFLKY	TAFGGFLKY
LVIFPEGTRY	VIFPEGTRY
ALLPVVHEY	ALLPVVHEY
KASLRELAL	KASLRELAL
LMMGHPGMHY	MMGHPGMHY
RLMDRPIFY	RLMDRPIFY
FFPLPLTPTLY	FPLPTPTLY
YYDTHTNTY	YYDTHTNTY
RLSDTLLFY	RLSDTLLFY
YGYDQGQYGNY	GYDQQYGNY
YFLSVSGNY	YFLSVSGNY
FLSSIGGTLY	FLSSGGTLY
THSLVLHY	-THSLVLHY
YTNRAAAQYY	YTNRAAAQY
HSMDIFTHY	HSMDIFTHY
VALNTAYAY	VALNTAYAY
GAAAIILTY	GAAAIILTY
KLDDLHTLY	KLDDLHTLY
LHDRSFSY	-LHDRSFSY
SWLPWVHRY	SWLPWVHRY
AMQNIILKY	AMQNIILKY
STSRVRLFY	STSRVRLFY
GTISQPRILLY	TISQRILLY
HVASYGVNLY	VASYGVNLY
LIMGRGYHY	LIMGRGYHY
VSQSQPGSRS	SQSQPGSRS
AHLGVFLRY	AHLGVFLRY
LIAHMVLGY	LIAHMVLGY
SVKSMYLKY	SVKSMYLKY
FFPTQGHDY	FFPTQGHDY
FVAGVVTFY	FVAGVVTFY
GQIFRPDNFVF	IFRPDNFVF
LYAKLIFL	-LYAKLIFL
GYGAGVGGGY	YGAGVGGGY
HFPEELSLAF	HFPELSLAF
HTIGKTVEY	HTIGKTVEY
HFYEVSLEY	HFYEVSLEY
TFLIPGFYSY	FLIPGFYSY
YVLQDWQQY	YVLQDWQQY
FVVSPSFEY	FVVSPSFEY
GNYSGQQQSNY	NYSGQQSNY
FVCERTLKY	FVCERTLKY
NALSAMLAY	NALSAMLAY
VYVLEEIEY	VYVLEEIEY
VVLELTHLY	VVLELTHLY
LLHAAWDHY	LLHAAWDHY
FFSQIGQLY	FFSQIGQLY
SRGDFVVEY	SRGDFVVEY
HNYHHSFPYDY	HNYHHSFPY
SYLENPTSY	SYLENPTSY
HFTVVGDDY	HFTVVGDDY
RLEKLQLEY	RLEKLQLEY
VETEKLLKY	VETEKLLKY
KVCEKAFSY	KVCEKAFSY
ALYNIGLTY	ALYNIGLTY
MVMEIRNAY	MVMEIRNAY
SFAARSFYY	SFAARSFYY
WVPKVGLKY	WVPKVGLKY
VVTPDGYLY	VVTPDGYLY
AVLERQESY	AVLERQESY
YLADYGLSY	YLADYGLSY
YVLAYTQSY	YVLAYTQSY
TLAFQQARY	TLAFQQARY
IFLHNNYNY	IFLHNNYNY
LMERNNLSY	LMERNNLSY
EVLGLILRY	EVLGLILRY
EEDEDAYKKQF	EEDEDAYKK
LVGLAVGLY	LVGLAVGLY
VEVTEFEDIK	VEVTEFEDI
IFHLKRFDI	IFHLKRFDI
YFVTGNHEYY	YFVTGNHEY
QVAERALYY	QVAERALYY
LANRMSLFY	LANRMSLFY
YLPALKVEY	YLPALKVEY
HFGLFPANY	HFGLFPANY
MTSGHWQHY	MTSGHWQHY
FFIDRDGFLF	FIDRDGFLF
GLERNPQSYLY	GLERNPQSY
RMFDMGFEY	RMFDMGFEY
NLICGRLVCTY	LICGLVCTY
FVTDLLLHF	FVTDLLLHF
YFLSNLKQLY	FLSNLKQLY
YLTHFFLRY	YLTHFFLRY
VVSNILLAY	VVSNILLAY
FAHQGNPAVY	FAHQNPAVY
VVPLTAEPFL	VVPLTAEPF
FLLDRLLQY	FLLDRLLQY
IFLETELFY	IFLETELFY
GNVYCGVHRY	NVYCGVHRY
SVYLLTGLELY	YLLTGLELY
AVHDITVAY	AVHDITVAY
AVLELFDRY	AVLELFDRY
LFGIRPDDYLY	GIRPDDYLY
VLHVSEILY	VLHVSEILY
FFLPKGAYIY	FLPKGAYIY
LTYQLCHTY	LTYQLCHTY
QFYPKANIVAY	FYPKNIVAY
VFMHENLYF	VFMHENLYF
KIYPLPHMY	KIYPLPHMY
NFEVFTETTY	FEVFTETTY
VEDELVKKY	VEDELVKKY
HNVQGFHPY	HNVQGFHPY
SADKGGFLY	SADKGGFLY
LYQMQHLQY	LYQMQHLQY
RFQFLPHAYY	RFQFLPHAY
AQNSVRLNY	AQNSVRLNY
VWGEEFEKLY	VWGEFEKLY
DVYNHFLLY	DVYNHFLLY
LFDRKHYFY	LFDRKHYFY
YVPAEPKLAF	YVPAPKLAF
YFDSGDYNM	YFDSGDYNM
YFGGVLEYF	YFGGVLEYF
ITLWHNLNY	ITLWHNLNY
GFASFSDYYY	GFASFSDYY
VVMAVAQLY	VVMAVAQLY
NLFGGEPLSY	LFGGEPLSY
GTHTVSVKY	GTHTVSVKY
VTHIGRVY	-VTHIGRVY
ALELEQER	-ALELEQER
LLANINAYY	LLANINAYY
ILIGPTFSY	ILIGPTFSY
DEELVWAY	-DEELVWAY
YTSSVNRLNY	YTSSNRLNY
SGFGKKFYY	SGFGKKFYY
RLLALNSLY	RLLALNSLY
TILDIPNQLYY	TILDPNQLY
GQKPWSQHY	GQKPWSQHY
FLRDITLRY	FLRDITLRY
NNVYLVMEY	NNVYLVMEY
FLSTPQFLY	FLSTPQFLY
QTSRYKLHY	QTSRYKLHY
FFASGGGKFNY	FASGGKFNY
NFKIQPLRY	NFKIQPLRY
YFGETIALY	YFGETIALY
YIKHPHLFKY	YIKHHLFKY
TEDDKAYAY	TEDDKAYAY
ATLQQGFQY	ATLQQGFQY
SESAQSKML	SESAQSKML
SQWREQLLY	SQWREQLLY
WYTEPIAEY	WYTEPIAEY
FFAKIPYYY	FFAKIPYYY
YTSPVVLPY	YTSPVVLPY
GSHGLFLRY	GSHGLFLRY
SLRFVTLLY	SLRFVTLLY
YASSPGGVY	YASSPGGVY
TAAAVVGLLY	AAAVVGLLY
EEIFGTIGM	EEIFGTIGM
YNYPVSDYY	YNYPVSDYY
SAYGTQPAY	SAYGTQPAY
PLLFFITLL	PLLFFITLL
RILPHTVLY	RILPHTVLY
FLPRTDYSF	FLPRTDYSF
FISSTSFRY	FISSTSFRY
ALFTQGLGY	ALFTQGLGY
LFKPFVESY	LFKPFVESY
AFAHFPELY	AFAHFPELY
YMKEEVDRY	YMKEEVDRY
QALKENLYY	QALKENLYY
LGDLFSISAY	GDLFSISAY
YYDGDIGNYYY	YYDGIGNYY
LLDTNRYLY	LLDTNRYLY
ELLRLYLNY	ELLRLYLNY
FYNSDGYGGNY	YNSDYGGNY
ALLNFVVKY	ALLNFVVKY
KMMNGGHYTY	MMNGGHYTY
TFSEISALRF	TFSESALRF
SACGKTFRY	SACGKTFRY
YATSFLDLY	YATSFLDLY
VSYNVTHLY	VSYNVTHLY
KFYNAGLAY	KFYNAGLAY
LFWFGDLNY	LFWFGDLNY
HLLPEAWAY	HLLPEAWAY
HTFHRFYQY	HTFHRFYQY
LFGKLNIIY	LFGKLNIIY
QVAQMQLKY	QVAQMQLKY
VIFHNHLDY	VIFHNHLDY
GIMTGPFFRY	IMTGPFFRY
AVISTILKY	AVISTILKY
QNYSGPPSSY	NYSGPPSSY
FYYAIWKRY	FYYAIWKRY
NFMKPSHQGY	FMKPSHQGY
VFDKLNHEY	VFDKLNHEY
WLPGAVAQVY	LPGAVAQVY
TINPILLYF	TINPILLYF
RLSSMNLGY	RLSSMNLGY
HVFEIILEY	HVFEIILEY
FFLHIKEALL	FFLHIKEAL
IQRTPKIQV	IQRTPKIQV
FYVHNDMFRY	YVHNDMFRY
YLSSEITLHPY	LSSETLHPY
TMLSEVLQY	TMLSEVLQY
STAKHLLLY	STAKHLLLY
TLARAGFLY	TLARAGFLY
FISGLPQGY	FISGLPQGY
FLAPLVTEY	FLAPLVTEY
AMADTFLEH	AMADTFLEH
HVSGVRFLY	HVSGVRFLY
FFHDILHTKY	FFHDLHTKY
FASPTQVFF	FASPTQVFF
AELLPTIKY	AELLPTIKY
KVEDLFLTF	KVEDLFLTF
STVFVANLDY	TVFVANLDY
LYPAVSAVY	LYPAVSAVY
STYLVAFAY	STYLVAFAY
KILDIGLAY	KILDIGLAY
LFSRVIPEY	LFSRVIPEY
RVKETGDLY	RVKETGDLY
FFVNRPDSY	FFVNRPDSY
MFLKLMATY	MFLKLMATY
AYSSYVHQY	AYSSYVHQY
MSNRDSYFY	MSNRDSYFY
VYIGVHVPF	VYIGVHVPF
QHFQHGGYQY	HFQHGGYQY
VAFKKTFSY	VAFKKTFSY
IFSEAYLLY	IFSEAYLLY
KQCEESFHY	KQCEESFHY
SISNLVFTY	SISNLVFTY
FINHNAVLY	FINHNAVLY
GFFEISIKY	GFFEISIKY
NKQELTQDKG	KQELTQDKG
AAAATADVTLY	AATADVTLY
IFSGAASLGY	IFSGASLGY
VWKIPAILY	VWKIPAILY
FVRSFKYFY	FVRSFKYFY
VMAPRTLLL	VMAPRTLLL
VYSLKYDY	-VYSLKYDY
VFRFNLDLY	VFRFNLDLY
YFKNVHPQY	YFKNVHPQY
GAAGILLRY	GAAGILLRY
TLLRHLLNY	TLLRHLLNY
SYLDKEDTFFY	YLDKDTFFY
FINTESGRYVY	FINTESGRY
MFLSKPSVY	MFLSKPSVY
AFNSKQLLY	AFNSKQLLY
QLYDKGLVY	QLYDKGLVY
LTLDQAYSY	LTLDQAYSY
TVLSDVHLY	TVLSDVHLY
GYYPWPYNY	GYYPWPYNY
IVADHVASY	IVADHVASY
FILNVRLDY	FILNVRLDY
FFHHINLQY	FFHHINLQY
FYGRKMAQVF	FYGRMAQVF
FFQAKAMAEIL	FFQAKAMAE
AAMPRPVSY	AAMPRPVSY
SILTQPHLY	SILTQPHLY
VVVGGLNTHY	VVGGLNTHY
LARNNAEVY	LARNNAEVY
NWNEVVTQQY	NWNEVTQQY
YLVDYGLAY	YLVDYGLAY
YGYGPGYDY	YGYGPGYDY
TTFTVTKYWFY	FTVTKYWFY
FLPKGAYIY	FLPKGAYIY
FNLMKYDSY	FNLMKYDSY
QTNNDPGLFVY	NNDPGLFVY
FYQKYSSRTQ	FYQKYSSRT
LFIALITDSY	FIALITDSY
TFEGWPALLY	FEGWPALLY
SFINSNLKF	SFINSNLKF
GSWDKTLKF	GSWDKTLKF
HYALLQYHY	HYALLQYHY
LTSDIYLEY	LTSDIYLEY
FFTEQNLSY	FFTEQNLSY
YFQRGMLYY	YFQRGMLYY
KAANLLLGY	KAANLLLGY
TWKDFVNNY	TWKDFVNNY
NLFENAGEFKY	FENAGEFKY
FFLIVKTLY	FFLIVKTLY
RENTQTTIKLF	NTQTTIKLF
HIAALIAEY	HIAALIAEY
NFLPLHYDY	NFLPLHYDY
SEADARIFKAW	SEADRIFKA
HLPTQPHLYTY	HLPTQPHLY
LLYESPERY	LLYESPERY
NLGTALYYA	NLGTALYYA
GVFKSGWLY	GVFKSGWLY
LPWVGKELY	LPWVGKELY
NVEWAKPSTN	VEWAKPSTN
QMYDKGLVY	QMYDKGLVY
VFFSRGSSFRY	FFSRSSFRY
EEFGQAFSF	EEFGQAFSF
FTREEADEY	FTREEADEY
FFQQTEDLY	FFQQTEDLY
LALETALMY	LALETALMY
MVKGSVENY	MVKGSVENY
FLYDKALTF	FLYDKALTF
KSFVKVYNY	KSFVKVYNY
VYPQKAYYY	VYPQKAYYY
VINNLILKY	VINNLILKY
FYAFQDDRYLY	AFQDDRYLY
FFKVLPGDY	FFKVLPGDY
AYPHRLNLFY	AYPHLNLFY
STAKSATWTY	STAKATWTY
LMLDKNNLVKY	MLDKNLVKY
IQLVEEELDR	QLVEEELDR
IASNIWAAY	IASNIWAAY
VTMDVHSRY	VTMDVHSRY
GVLDGRFHY	GVLDGRFHY
GVMDYYLKY	GVMDYYLKY
HLRELDLYH	HLRELDLYH
IFDDSYLGY	IFDDSYLGY
SLLGVPIAY	SLLGVPIAY
VADKVHLMY	VADKVHLMY
IVMDRPYQFY	IVMDRPYQF
FVWPAHFKY	FVWPAHFKY
TTAALTTE	-TTAALTTE
GLTVTLIKY	GLTVTLIKY
IFHIVENDLY	IFHIENDLY
LVNSAAHLFGY	LVNSAAHLF
VTREGNELY	VTREGNELY
MLYPLSHGF	MLYPLSHGF
NMLKETLEY	NMLKETLEY
FYADPGVSFY	FYADGVSFY
NFVRLLMLY	NFVRLLMLY
MPYNHQHKY	MPYNHQHKY
ALFHAQLAY	ALFHAQLAY
AMSHLNLAY	AMSHLNLAY
IFVSPLTTSY	FVSPLTTSY
NCTQECLIY	NCTQECLIY
VTSAVMMQY	VTSAVMMQY
VIRELKEQY	VIRELKEQY
YGFQEQLLY	YGFQEQLLY
MLLPEKLISKY	LLPELISKY
GLNYTPLLY	GLNYTPLLY
DRGKFCLTY	DRGKFCLTY
TNETILRY	-TNETILRY
LVGPTQSFF	LVGPTQSFF
SEVILHHEY	SEVILHHEY
TVKTLYLSY	TVKTLYLSY
SQVGLHPEY	SQVGLHPEY
MAFGKPAKY	MAFGKPAKY
YSYAGGRGSY	SYAGGRGSY
GFAAWMAYY	GFAAWMAYY
VLFSYSFSY	VLFSYSFSY
GIVNILLKY	GIVNILLKY
TLYGRSLRY	TLYGRSLRY
YYYYIREA	-YYYYIREA
GTIKDIVTRY	TIKDIVTRY
AFLAIAKELKY	LAIAKELKY
YVTVVSLQY	YVTVVSLQY
FYHKQFLEY	FYHKQFLEY
VLLPVALEF	VLLPVALEF
SLLGKPLSY	SLLGKPLSY
ILGPPGSVY	ILGPPGSVY
LAIIKSIGY	LAIIKSIGY
ALPKAAFQY	ALPKAAFQY
EEPTVIKKY	EEPTVIKKY
FVLEEGHDY	FVLEEGHDY
SLESLTLSY	SLESLTLSY
FIGKIITNLKY	GKIITNLKY
FRGQSALIY	FRGQSALIY
GFSGHNLEY	GFSGHNLEY
FFGNGPPVNY	FFGNPPVNY
SFYAARDLYKY	SFYAARDLY
FFSHVGWLL	FFSHVGWLL
YVSSGSYSY	YVSSGSYSY
KLFGFLLEY	KLFGFLLEY
LLANMVYQY	LLANMVYQY
YFGRQSQADY	YFGRSQADY
VLFSLTTHY	VLFSLTTHY
SLASVPSSLPP	SLASVPSSL
LFLDLLQSY	LFLDLLQSY
GMNELAIAY	GMNELAIAY
TTTQMELLY	TTTQMELLY
GFYHLRIAYY	GFYHLRIAY
FYVPFAKALY	YVPFAKALY
YYPQQYGHYGY	YYPQQYGHY
YFQAPSDYRY	FQAPSDYRY
ALNALILAY	ALNALILAY
GGVDAALLY	GGVDAALLY
IMNQVSNAYLY	NQVSNAYLY
IFLDSKGLEY	FLDSKGLEY
SLFGIPLWY	SLFGIPLWY
QEERTLACL	QEERTLACL
FYPLFVHMY	FYPLFVHMY
AVLRDLLRY	AVLRDLLRY
KLYEAGLAY	KLYEAGLAY
GNMAIHMVY	GNMAIHMVY
QMSSVFQRY	QMSSVFQRY
TYVAQFLQY	TYVAQFLQY
GMMPPPPMGM	MMPPPPMGM
DLATEEVSQMQ	LATEEVSQM
VAYQHAFLY	VAYQHAFLY
GFYEVFKVLY	GFYEFKVLY
IFSEQVAMGY	IFSEVAMGY
KNWEQSFEY	KNWEQSFEY
TELGRPDAEYW	ELGRPDAEY
GSLPLHLGY	GSLPLHLGY
VLLQLVLRY	VLLQLVLRY
PFLDNPDAFY	FLDNPDAFY
YFSRNGYNY	YFSRNGYNY
TFSNMTKFLY	TFSNTKFLY
GFTAIVLTY	GFTAIVLTY
YFLIQKMFY	YFLIQKMFY
SEIGQKQKL	SEIGQKQKL
LLLKDFLKY	LLLKDFLKY
SAITMALQY	SAITMALQY
AILSFPLDY	AILSFPLDY
HITDQVHLY	HITDQVHLY
IQANSAYRY	IQANSAYRY
HVIDVKFL	-HVIDVKFL
VVLQDLLAY	VVLQDLLAY
AIDQLHLEY	AIDQLHLEY
TRNDYVMMY	TRNDYVMMY
SLKDMVFLDY	SLKDVFLDY
LVCAHSLAY	LVCAHSLAY
YYDSRPGGYGY	YYDSRPGGY
YLHYLPSYY	YLHYLPSYY
RYHNQTLRY	RYHNQTLRY
YLFHPLAY	-YLFHPLAY
ATSKVALVY	ATSKVALVY
TFHSQQALEY	TFHSQALEY
FLSNLKQLY	FLSNLKQLY
FQFDTSFMY	FQFDTSFMY
FFDKVIEKRY	FFDKIEKRY
RTFGHLLRY	RTFGHLLRY
TLNNLAVLY	TLNNLAVLY
FTWPDGHVTKY	TWPDHVTKY
TVWEDQLSY	TVWEDQLSY
LMAHSHLRY	LMAHSHLRY
ISPALLSYL	ISPALLSYL
WFVDTAERY	WFVDTAERY
FLMKNSDLY	FLMKNSDLY
TEVTGHRW	-TEVTGHRW
SVQTDINLPY	VQTDINLPY
KKNTHTYFY	KKNTHTYFY
VVLRDPTLFSF	VVLRDPTLF
WMLRVKWLY	WMLRVKWLY
IVLSDVEGLF	VLSDVEGLF
AASISLAQYL	AASISLAQY
SFMDPASALY	SFMDASALY
QELNFLLRY	QELNFLLRY
MTSPLNLSY	MTSPLNLSY
IPFLGIGLLY	PFLGIGLLY
HYLYIQMEY	HYLYIQMEY
FVITKPDVY	FVITKPDVY
SYWFQKLRY	SYWFQKLRY
VVAPITTGY	VVAPITTGY
TVMNIAEHY	TVMNIAEHY
YVAPEILSY	YVAPEILSY
YGANGMMNY	YGANGMMNY
FHHQDGYRY	FHHQDGYRY
LDREKKDHY	LDREKKDHY
YTAVVPLVY	YTAVVPLVY
HVPHFEKMLY	HVPHEKMLY
YMIDPSGVSY	YMIDSGVSY
SGYNVSLLY	SGYNVSLLY
TLSESTHKY	TLSESTHKY
YIYIRGEFY	YIYIRGEFY
STLKTLLFF	STLKTLLFF
SVSGMTLKY	SVSGMTLKY
FFAPSRDMY	FFAPSRDMY
SFTAFANSHY	FTAFANSHY
FIQEVHAHY	FIQEVHAHY
YPLPRGEKY	YPLPRGEKY
FQLETNLLY	FQLETNLLY
NTYGQPSSY	NTYGQPSSY
VYIVLDKAEY	YIVLDKAEY
RFIDSKLIYTY	RFIDSKLIY
YTYPWVYNY	YTYPWVYNY
VFKGIIEGERY	KGIIEGERY
DLSLEEIQK	DLSLEEIQK
FLQVLETDLY	FLQVETDLY
GMYDSSLAAKY	YDSSLAAKY
LVVPGHLVFLY	VVPGLVFLY
YTTPTAPQAY	TTPTAPQAY
EVVEEAENGR	VVEEAENGR
VFFFYPLDF	VFFFYPLDF
YFEGEKRYL	YFEGEKRYL
LYATVHQSY	LYATVHQSY
LLHSNGYNY	LLHSNGYNY
SIVPLRLIY	SIVPLRLIY
HFAALEKTYY	HFAAEKTYY
GLSALILRY	GLSALILRY
QMLEFAFRY	QMLEFAFRY
AVSAVVHEY	AVSAVVHEY
SVLPGELMRGY	VLPGLMRGY
LILPGKFSLP	LILPGKFSL
LLCATAAVLY	LLCAAAVLY
ALAGTFHYY	ALAGTFHYY
TVTSTVFLY	TVTSTVFLY
YFIGRIYLY	YFIGRIYLY
EELDGLFRRY	ELDGLFRRY
TSCTIFLGY	TSCTIFLGY
FPTMPRHNY	FPTMPRHNY
HHQHQHLAY	HHQHQHLAY
HVAGAAYYY	HVAGAAYYY
AIAEIWPKY	AIAEIWPKY
NTLGSLALLY	TLGSLALLY
YYYDGDVGNY	YYDGDVGNY
RGLDVLLEY	RGLDVLLEY
AVNGVQLHY	AVNGVQLHY
ALLDTTQKYLY	ALLDTTQKY
GVLPQLLAY	GVLPQLLAY
SINQVVQLRY	SINQVQLRY
FAYDPSNYEY	AYDPSNYEY
AVADKVHLMY	AVADVHLMY
GNFGGGGGNF	NFGGGGGNF
SSLKTCYKY	SSLKTCYKY
KMADIYLKH	KMADIYLKH
FLNAENAQKF	LNAENAQKF
AFYAYHYRF	AFYAYHYRF
ILKEEQELY	ILKEEQELY
KSFNQSSHLY	SFNQSSHLY
TALHIYANY	TALHIYANY
KVKAIANLY	KVKAIANLY
FYMDTSHLF	FYMDTSHLF
SQFGGGSQYAY	SQFGGGSQY
LAYSGVHLY	LAYSGVHLY
RNFDRAFSY	RNFDRAFSY
ATVGESYQY	ATVGESYQY
VFPLKVFGY	VFPLKVFGY
FVPSQHYVY	FVPSQHYVY
LQNRVILQ	-LQNRVILQ
IKVQGILSY	IKVQGILSY
VAAVRCVQY	VAAVRCVQY
HTLDNPYEY	HTLDNPYEY
FYYGGVSSASY	YYGGSSASY
YFKRFYARY	YFKRFYARY
NFTDTSLMY	NFTDTSLMY
VTEIRLKY	-VTEIRLKY
FFTLSPTVY	FFTLSPTVY
KAVSLFLCY	KAVSLFLCY
AFKALIAAQY	AFKAIAAQY
LVIQDKNKY	LVIQDKNKY
TEAPGNLRLY	TEAPNLRLY
ALMATQTFY	ALMATQTFY
FLDAFRTFY	FLDAFRTFY
FLMPFPVNY	FLMPFPVNY
VVLPARYFY	VVLPARYFY
FIAPNKYEY	FIAPNKYEY
KLDSLLLFY	KLDSLLLFY
QTSKVAFKY	QTSKVAFKY
HVPSHLGSYY	HVPSHLGSY
AMDSPLLKY	AMDSPLLKY
GYFDEEMAVKY	YFDEMAVKY
REEDGHTHQW	REEDGHTHQ
VGDRGLFALY	VGDRLFALY
QLYEKGLYY	QLYEKGLYY
YMWKKSERY	YMWKKSERY
LSLPLRIYY	LSLPLRIYY
MIDLKYFPY	MIDLKYFPY
KTPEIYLAY	KTPEIYLAY
SYNAQPSASY	YNAQPSASY
IFEAYWFL	-IFEAYWFL
KILDAAFRY	KILDAAFRY
QALLSQLY	-QALLSQLY
ATAPPAPAY	ATAPPAPAY
SNNSLFLSY	SNNSLFLSY
RLQDQHMFY	RLQDQHMFY
SILEECLQY	SILEECLQY
YYYHPPPRM	YYYHPPPRM
YALPSFSYY	YALPSFSYY
IFDLPQQLY	IFDLPQQLY
MWSVGIITY	MWSVGIITY
ITDKNSLAY	ITDKNSLAY
YWKNAAFLY	YWKNAAFLY
SFVDPLVTNY	FVDPLVTNY
NTLDIIAEY	NTLDIIAEY
SLVYQHLLY	SLVYQHLLY
FYVIGSSY	-FYVIGSSY
AFDKIQQLKF	AFDKQQLKF
VLMEEMILY	VLMEEMILY
YSTIRKQEY	YSTIRKQEY
ALRDNSTMGY	ALRDSTMGY
GVILFHETLY	VILFHETLY
YLPNVTLEY	YLPNVTLEY
AFVVAVGAEY	FVVAVGAEY
FIPSAYPYY	FIPSAYPYY
IYADLSLKY	IYADLSLKY
TTLDIITRY	TTLDIITRY
IIDRSFRY	-IIDRSFRY
VSTTAHFPY	VSTTAHFPY
KLFDKLLEY	KLFDKLLEY
YYMTPRDFLF	YMTPRDFLF
YFEDQPLLY	YFEDQPLLY
ILLHGSALLY	LLHGSALLY
VLTEEPLLY	VLTEEPLLY
ATADLHAQY	ATADLHAQY
LTNHRVWDY	LTNHRVWDY
GMLEKAVFY	GMLEKAVFY
FVSRLWLTY	FVSRLWLTY
HFTDTVVLY	HFTDTVVLY
NEFPEPIKL	NEFPEPIKL
FMGLFKSSRY	FMGLKSSRY
HNGMNQQAY	HNGMNQQAY
YLENLEKLMY	YLENEKLMY
FVNQPYLLY	FVNQPYLLY
FALVFPLMY	FALVFPLMY
LNHPVCKEY	LNHPVCKEY
GAYGQAVRY	GAYGQAVRY
YIYTRLEMY	YIYTRLEMY
FIPFLPLEY	FIPFLPLEY
NYQMKYYFY	NYQMKYYFY
FVAKFMALY	FVAKFMALY
SFHPQQFQY	SFHPQQFQY
YFDEHYEY	-YFDEHYEY
DENNFLDYY	DENNFLDYY
GNYSGAAEYLY	GNYSGAAEY
MMFGSVAMSY	MFGSVAMSY
MFEVQDLKY	MFEVQDLKY
AMGKTALFY	AMGKTALFY
NAWAFVLFY	NAWAFVLFY
HLTAVTLFY	HLTAVTLFY
KLWDNELQY	KLWDNELQY
GQPPPTWQQGY	QPPPWQQGY
RIFSEAYLLY	IFSEAYLLY
ALFTSVFLY	ALFTSVFLY
VTEEIFLEY	VTEEIFLEY
VTYPRGYPY	VTYPRGYPY
GTADGGHYY	GTADGGHYY
KQCGKAFKY	KQCGKAFKY
GTFHSQQALEY	TFHSQALEY
YMTEPIDEY	YMTEPIDEY
GHEFIPTLY	GHEFIPTLY
SLHGFEHLY	SLHGFEHLY
TTTTLCLHY	TTTTLCLHY
FYSYIRTNY	FYSYIRTNY
FLDASGAKLDY	DASGAKLDY
TVHTSERTY	TVHTSERTY
AVLGIFLKV	AVLGIFLKV
RMMEAFAQRY	MMEAFAQRY
SVLQFLGLY	SVLQFLGLY
LFPLLATAY	LFPLLATAY
LPYAEGFAY	LPYAEGFAY
YAIDNPLHY	YAIDNPLHY
IFMDVLFVY	IFMDVLFVY
HFEGHYQY	-HFEGHYQY
NQHGIILKY	NQHGIILKY
RTAHVILRY	RTAHVILRY
VFMFPVGLYY	FMFPVGLYY
HNLLVSELY	HNLLVSELY
LYYQPGLLY	LYYQPGLLY
AVLAIYTIY	AVLAIYTIY
NVCGKVFSY	NVCGKVFSY
SVDKIVIQKY	SVDKVIQKY
LHSYLALSY	LHSYLALSY
NYSNLVAVGY	NYSNVAVGY
SSLPLAARY	SSLPLAARY
IIYDRDFSY	IIYDRDFSY
YDDDENSIFY	YDDDNSIFY
FIHTDPSRFMY	HTDPSRFMY
IMFDVTSRVTY	FDVTSRVTY
VIFNNTYIY	VIFNNTYIY
ILASFREMVY	ILASREMVY
SYLTVHARM	SYLTVHARM
QVKNVADYY	QVKNVADYY
FTMGGPAISM	TMGGPAISM
AVLKAVQQY	AVLKAVQQY
SWPHLQLVY	SWPHLQLVY
SFMGLLAMY	SFMGLLAMY
VYQPVRYYY	VYQPVRYYY
SFNKMSIEY	SFNKMSIEY
TLSKIYLSY	TLSKIYLSY
NLLEKQLEY	NLLEKQLEY
QYMGFHPRY	QYMGFHPRY
QFADIAYNY	QFADIAYNY
YIAAISARF	YIAAISARF
GNIKTVTEY	GNIKTVTEY
ILSPLLLLF	ILSPLLLLF
FLPGMAIGY	FLPGMAIGY
LLADIEAHY	LLADIEAHY
LFFKPGSQFLY	FFKPSQFLY
QNFHMEQLKY	NFHMEQLKY
AFGQSMDLHY	AFGQMDLHY
AIGAGIILGY	AIGAIILGY
FLHPSYYLY	FLHPSYYLY
GVFLLPQLFLF	FLLPQLFLF
AVASDFYLRY	VASDFYLRY
FLEHEGYKY	FLEHEGYKY
NQTGTTLYY	NQTGTTLYY
LYIDRPLPY	LYIDRPLPY
LFGRIPLRY	LFGRIPLRY
WLAEQAAQRY	LAEQAAQRY
IQRTPKIQVYS	IQRTKIQVY
AFFYFEGTFY	FFYFEGTFY
DHFSRALQYEY	HFSRLQYEY
LIAFQQAQY	LIAFQQAQY
FVNDYILYY	FVNDYILYY
TEFTPTEKDEY	FTPTEKDEY
KNFGIWLRY	KNFGIWLRY
FMSQVMVQY	FMSQVMVQY
SLPHVGYLY	SLPHVGYLY
GLYDKILLF	GLYDKILLF
AVNSLVNLY	AVNSLVNLY
ETPLALAYIV	-ETPLALAY
FQNALIVRY	FQNALIVRY
NIAAHENCLLY	AAHENCLLY
SILKEFNSY	SILKEFNSY
YYMNASAQY	YYMNASAQY
AVVGIGLVY	AVVGIGLVY
YTLKVHYKY	YTLKVHYKY
LVFSSSIVY	LVFSSSIVY
MNFEAVLHY	MNFEAVLHY
YNQRPPYGY	YNQRPPYGY
YNYESKFNY	YNYESKFNY
GTLGRMHYY	GTLGRMHYY
MFGSVAMSY	MFGSVAMSY
VIADVNPKY	VIADVNPKY
SIAWFTVFY	SIAWFTVFY
NIFAITFRY	NIFAITFRY
SNFRSNFGY	SNFRSNFGY
FVYPGNPLRH	FVYPNPLRH
LQYFYPEEL	LQYFYPEEL
GIHTGQFVY	GIHTGQFVY
YWKEVLLRY	YWKEVLLRY
GYFRQSLSY	GYFRQSLSY
SAFGRALRY	SAFGRALRY
ILAPYTDFHY	ILAPTDFHY
LQFHLSNLEY	QFHLSNLEY
QDLGELEL	-QDLGELEL
VYVYPPWGY	VYVYPPWGY
SVMKTYHMY	SVMKTYHMY
FFQETNIPY	FFQETNIPY
TILDKAHKY	TILDKAHKY
RVYIGRLSY	RVYIGRLSY
FYRSSNLQY	FYRSSNLQY
SFEDLASISTY	FEDLSISTY
FQMAILLQY	FQMAILLQY
SAMYSRKAMY	AMYSRKAMY
MLYRVALLY	MLYRVALLY
AFSNVFEHY	AFSNVFEHY
SALDHFLGF	SALDHFLGF
ATALFSFL	-ATALFSFL
QVLAVDARY	QVLAVDARY
ALLEYHLSY	ALLEYHLSY
SATAVAQLY	SATAVAQLY
KLYEQHHVV	KLYEQHHVV
YFEYFGPDFKL	YFEYFGPDF
RLLDFPTLLVY	LLDFTLLVY
ILMSLVLSY	ILMSLVLSY
VVALSRTY	-VVALSRTY
SISAVVMSY	SISAVVMSY
NFGPKGFGY	NFGPKGFGY
SWNNHSYLY	SWNNHSYLY
GFYYQQAAYY	FYYQQAAYY
NFYRNKLKY	NFYRNKLKY
YFLEAALQSAY	LEAALQSAY
FNISITPNY	FNISITPNY
LPYNHQHEY	LPYNHQHEY
KTIANTYFY	KTIANTYFY
RVMDVPGLY	RVMDVPGLY
TYGQFAQLY	TYGQFAQLY
WFWSIVEKM	WFWSIVEKM
QTWAGSHSMRY	WAGSHSMRY
GYLALGLTY	GYLALGLTY
YVSAYRILY	YVSAYRILY
NKADVILKY	NKADVILKY
VALANGFLY	VALANGFLY
GYNQPSLGY	GYNQPSLGY
YINKISSTLY	YINKSSTLY
LIGGSHLILY	LIGGHLILY
IYQTLSWKY	IYQTLSWKY
TMDPKPLAY	TMDPKPLAY
TLPTSTLQY	TLPTSTLQY
RYIQRYLVY	RYIQRYLVY
FNSHVHVEY	FNSHVHVEY
STIPKVLQY	STIPKVLQY
NFGAKPFKY	NFGAKPFKY
YYPSTPGRY	YYPSTPGRY
NAFEHGGEFTY	FEHGGEFTY
KWISYTYLY	KWISYTYLY
SYINFELRY	SYINFELRY
YNMPQGGGQHY	NMPQGGQHY
HFEVPFIAF	HFEVPFIAF
QVAGTTFTY	QVAGTTFTY
SEPDFVAKF	SEPDFVAKF
YNYAYPYSY	YNYAYPYSY
NEITIPVTF	NEITIPVTF
ALNHKVLHY	ALNHKVLHY
YTSTGYQHQ	YTSTGYQHQ
MANIPLPEY	MANIPLPEY
SSYGQPQSGSY	SYGQQSGSY
TVLTVSHKFRY	LTVSHKFRY
VQLWLVLRY	VQLWLVLRY
SFIGAFLTF	SFIGAFLTF
MFDQSQIQEF	MFDQQIQEF
NFVSAGIQTSF	FVSAIQTSF
IAQAESLRY	IAQAESLRY
SAANKTIIY	SAANKTIIY
VVDNLQHLY	VVDNLQHLY
KVMELHKSY	KVMELHKSY
FFFPLLQRF	FFFPLLQRF
VLPAVGISY	VLPAVGISY
GYDIKLLRY	GYDIKLLRY
LQNNFREQQY	QNNFREQQY
RLWAVAASY	RLWAVAASY
GFSEEVLYY	GFSEEVLYY
ETRPEKEGP	ETRPEKEGP
VTLTSEEEAR	VTLTSEEEA
SYMPSGAYVY	YMPSGAYVY
YYDDLKYRY	YYDDLKYRY
HLSPVHFYY	HLSPVHFYY
FFHFLDQLNY	FFHFDQLNY
SVNESCYKY	SVNESCYKY
ASNPAMLLY	ASNPAMLLY
KQLETRLAY	KQLETRLAY
LGSKVLRQY	LGSKVLRQY
NSYWVGEDSTY	YWVGEDSTY
STNHKDIGTLY	NHKDIGTLY
SVDNQEKLLY	SVDNEKLLY
WVGDVYPVY	WVGDVYPVY
EKYFDIYY	-EKYFDIYY
AVLKDYIAY	AVLKDYIAY
RVFQECLTY	RVFQECLTY
LLCSICLSIY	LLCSCLSIY
IDGKTLKY	-IDGKTLKY
YAYPYSYYY	YAYPYSYYY
NVIGICTHY	NVIGICTHY
GMYPCPPGY	GMYPCPPGY
YFLNRKLVY	YFLNRKLVY
VSPENIILY	VSPENIILY
ILFKGDLNY	ILFKGDLNY
FLAEQNHLY	FLAEQNHLY
GYGGGGPGY	GYGGGGPGY
AYLDQYLWY	AYLDQYLWY
VLYLHNHSY	VLYLHNHSY
AVDLEHHSY	AVDLEHHSY
GVAPESFEY	GVAPESFEY
LNHKVLHY	-LNHKVLHY
IHSFLYIYY	IHSFLYIYY
ALHEALLEY	ALHEALLEY
RNAEVFLKY	RNAEVFLKY
YYTHPFQGY	YYTHPFQGY
IMSPTSFVY	IMSPTSFVY
REKQLSHSL	REKQLSHSL
FLHDKGFPY	FLHDKGFPY
SYGGQQQSY	SYGGQQQSY
GMSGGGWRGMY	SGGGWRGMY
GILSSHPKY	GILSSHPKY
VYLFTEAYY	VYLFTEAYY
YIRDLALEY	YIRDLALEY
SFQNMKNQY	SFQNMKNQY
VQLTFALRY	VQLTFALRY
QVLGRFFLY	QVLGRFFLY
TVVGPSSVLTY	VVGPSVLTY
FYHPFPTPY	FYHPFPTPY
NNLKECGLY	NNLKECGLY
LLSKLHLSY	LLSKLHLSY
SSMSLQMGY	SSMSLQMGY
LVFPFRTFY	LVFPFRTFY
YYYDPTTGL	YYYDPTTGL
ALPRVTPFY	ALPRVTPFY
GMSIQTFRY	GMSIQTFRY
SVGNFYLL	-SVGNFYLL
VLFFHTMRY	VLFFHTMRY
LARLNLELY	LARLNLELY
YMENLSKEY	YMENLSKEY
VVRVHEHY	-VVRVHEHY
YIGDIVSLY	YIGDIVSLY
GGYDYTGYNY	GYDYTGYNY
SSPFWTFEY	SSPFWTFEY
YQTFLQLLY	YQTFLQLLY
YWKDLAMTY	YWKDLAMTY
YTFPNGAKY	YTFPNGAKY
YFDEEMAVKY	YFDEMAVKY
VGETKNIAY	VGETKNIAY
LPLDIQIFY	LPLDIQIFY
AFSPESLFY	AFSPESLFY
YYDPNSQYYY	YYDPNSQYY
PSGVSYGY	-PSGVSYGY
AFFAERLYY	AFFAERLYY
WLLEVAPHY	WLLEVAPHY
GLLTNTLTM	GLLTNTLTM
FVLPAVLNPRY	VLPALNPRY
VFKTIADYY	VFKTIADYY
SEEAEIIRKY	EEAEIIRKY
TALAAALHY	TALAAALHY
IVLSSSHSY	IVLSSSHSY
GTLQRYQSY	GTLQRYQSY
AFQKIVVLFY	AFQKVVLFY
AYVHKPYLY	AYVHKPYLY
VYFHTLTSEY	YFHTLTSEY
ASFLQLKNY	ASFLQLKNY
HLPSDFTPAVH	LPSDFTPAV
KEYERFSKY	KEYERFSKY
FAMKVLASY	FAMKVLASY
TMIGEPMNFVH	TMIGEPMNF
KIYPSREEY	KIYPSREEY
HVYVTAALMEY	YVTAALMEY
ITTPGVRFY	ITTPGVRFY
YLDHNSFDY	YLDHNSFDY
QLTSVQLLY	QLTSVQLLY
YLEQFQYWE	YLEQFQYWE
MASDSIVLFY	ASDSIVLFY
HTHTYIYTY	HTHTYIYTY
HFDSPYLLY	HFDSPYLLY
NTIPLFVQLLY	IPLFVQLLY
QFGIKTLKY	QFGIKTLKY
SVVGLAELY	SVVGLAELY
ILHSIFSSY	ILHSIFSSY
VYLRTLAPGLF	YLRTAPGLF
KVSAVTLAY	KVSAVTLAY
LYVGHPLHLHY	YVGHLHLHY
ADMGHLKY	-ADMGHLKY
GTYYTQPLY	GTYYTQPLY
ALVHVKAEY	ALVHVKAEY
ISKTNTQTY	ISKTNTQTY
KIYCADMYL	KIYCADMYL
YFEHLQILH	YFEHLQILH
FFAERLYY	-FFAERLYY
GVHTVSVKY	GVHTVSVKY
ATVAQVLLY	ATVAQVLLY
SLYRLAFLY	SLYRLAFLY
EIGRFRDQQY	EIGRRDQQY
VLAASALLY	VLAASALLY
VYSEAVASHY	VYSEVASHY
FFEAVGVTY	FFEAVGVTY
EEVAQKKKL	EEVAQKKKL
IYPKHLKY	-IYPKHLKY
YFSEKAYAY	YFSEKAYAY
RVYPEVTVY	RVYPEVTVY
GVTHICPVY	GVTHICPVY
YMPDLTPQY	YMPDLTPQY
LWALIQAKY	LWALIQAKY
YYGEQTLHY	YYGEQTLHY
YIYPEQFSY	YIYPEQFSY
GVLDTELRY	GVLDTELRY
RLLQKVLAY	RLLQKVLAY
SETLKHLVL	SETLKHLVL
FSAYSSLIY	FSAYSSLIY
HYEKVSGDY	HYEKVSGDY
RLLDFPTL	-RLLDFPTL
FFFLAAFTW	FFFLAAFTW
MYEAAKLLY	MYEAAKLLY
WFFGHPEVY	WFFGHPEVY
NFEHFLLQY	NFEHFLLQY
LLIGAPLFY	LLIGAPLFY
HFNSMVALAY	HFNSVALAY
FFPSIYDVKY	FFPSYDVKY
FYYGGQVNY	FYYGGQVNY
VIAYEDNSLYQ	IAYEDNSLY
TSFTSVRSGY	SFTSVRSGY
VFIYPSLIY	VFIYPSLIY
EVMDVFLRF	EVMDVFLRF
LVLGKAYSY	LVLGKAYSY
TTSPLLLQY	TTSPLLLQY
SVIATIQEY	SVIATIQEY
GFVWLDAKY	GFVWLDAKY
HVTDTALAY	HVTDTALAY
GTQSTPQGY	GTQSTPQGY
LYTSIALKY	LYTSIALKY
HVLIDVGTGYY	VLIDVGTGY
AFAASVAHLY	FAASVAHLY
YFDAHALAMDY	YFDAHALAM
GVLDQMNKYLY	GVLDQMNKY
GTVEKAYKY	GTVEKAYKY
DGDVGNYYY	DGDVGNYYY
FYSEVHPHY	FYSEVHPHY
LPSARKLIY	LPSARKLIY
KESTLHLVL	KESTLHLVL
FLFAPTLIY	FLFAPTLIY
FLDNPDAFYY	FLDNDAFYY
TMVENAYYY	TMVENAYYY
FFSKHVPWSY	FFSKVPWSY
LVLSPNHQYLY	LVLSPNHQY
STNDTNAKY	STNDTNAKY
HFAIYLLKY	HFAIYLLKY
VVKDSFLLY	VVKDSFLLY
FVVNLHSKY	FVVNLHSKY
QLYDLTLEY	QLYDLTLEY
VMTSLQQEY	VMTSLQQEY
YFVETPYGY	YFVETPYGY
LVCPVTSMY	LVCPVTSMY
AVSQIVTVY	AVSQIVTVY
GTVTEVLLKY	TVTEVLLKY
IALNPTGTFLY	ALNPGTFLY
SWWYRSIRY	SWWYRSIRY
VLFETSVGY	VLFETSVGY
KFKEVAEAY	KFKEVAEAY
HIKQGSDAY	HIKQGSDAY
KIMSLYYQY	KIMSLYYQY
IAYNLSLIY	IAYNLSLIY
SMFDLTSEY	SMFDLTSEY
LFLLVFPAY	LFLLVFPAY
YAFQDDRYLY	AFQDDRYLY
LTTDLHYYY	LTTDLHYYY
MFAPAVMRAF	FAPAVMRAF
VVMGLHPDY	VVMGLHPDY
YFTKLVEQY	YFTKLVEQY
FLEAQIYEY	FLEAQIYEY
LLLPGELAK	LLLPGELAK
KSGYPLVY	-KSGYPLVY
FFKPGFEKY	FFKPGFEKY
IPQWENDWN	IPQWENDWN
RMDKSAVGHEY	DKSAVGHEY
KEVDVSKQL	KEVDVSKQL
YVSPRAPFY	YVSPRAPFY
LWPNPLQY	-LWPNPLQY
EESGARINI	EESGARINI
ELLRLPLRY	ELLRLPLRY
FFNRVNLI	-FFNRVNLI
YTMDDAWKY	YTMDDAWKY
LCCWKGFEF	LCCWKGFEF
TVLGEPLIY	TVLGEPLIY
MANYCHGEC	MANYCHGEC
YAVPYQYPY	YAVPYQYPY
VYTPTSPKY	VYTPTSPKY
PIPEDEKKE	PIPEDEKKE
FVADVRLIF	FVADVRLIF
QSLPVGLTLRY	SLPVLTLRY
QAYAVPYQY	QAYAVPYQY
VTQDSLFYS	VTQDSLFYS
YVYPKYLKY	YVYPKYLKY
HNFTIMTKY	HNFTIMTKY
LIESHSTTLY	IESHSTTLY
EEVQKQKEL	EEVQKQKEL
HVIDKFLLL	HVIDKFLLL
TKNGHVYKY	TKNGHVYKY
YISDNVNKY	YISDNVNKY
FYYLEQLILKY	YYLELILKY
RMDENSPLMY	RMDESPLMY
VFHETPLGY	VFHETPLGY
ALRPSTSRSLY	RPSTSRSLY
QFIQDYGMRY	FIQDYGMRY
SIMDEFQEY	SIMDEFQEY
TMFTNCYIY	TMFTNCYIY
QTFYVTLRY	QTFYVTLRY
SVATKLLLY	SVATKLLLY
ALDVVNLVY	ALDVVNLVY
FHSLPLLRY	FHSLPLLRY
ALMPAQLFF	ALMPAQLFF
LALGSKFRY	LALGSKFRY
SNTQPIPILY	NTQPIPILY
GLSSDGYLY	GLSSDGYLY
HSQGLGGHY	HSQGLGGHY
LRYSRFFY	-LRYSRFFY
SAAAATGSY	SAAAATGSY
HVLFIKLLY	HVLFIKLLY
VLLPFIAYY	VLLPFIAYY
RLQHQQLYY	RLQHQQLYY
NISHETSLYY	ISHETSLYY
IIYGARGTRY	IYGARGTRY
WFGHELSTRF	FGHELSTRF
SVLSGDILQYY	SVLSDILQY
SVITVYTMY	SVITVYTMY
SYGALNASY	SYGALNASY
YYNALNLYM	YYNALNLYM
GGYGGGGPGY	GYGGGGPGY
YYYDPQTGLYY	YYDPTGLYY
YLASETFNY	YLASETFNY
NVADLHLYLY	NVADHLYLY
KVYNIQIRY	KVYNIQIRY
ALKNRQELY	ALKNRQELY
NFVRLLML	-NFVRLLML
SNSQLMAVQY	SNSQMAVQY
EFYQDPLLY	EFYQDPLLY
RVLDLSENFLY	LDLSENFLY
YATHRDSY	-YATHRDSY
YASPVVAFY	YASPVVAFY
GNYSRPPAY	GNYSRPPAY
YFINSKGIPRY	INSKGIPRY
TMTGLAIQY	TMTGLAIQY
LALDWKCNC	LALDWKCNC
GMGIVTTLY	GMGIVTTLY
ALEYHQSIY	ALEYHQSIY
GNYNQQPSNY	NYNQQPSNY
FLSPVVPNY	FLSPVVPNY
LQMRRSSLPA	LQMRRSSLP
TNVGAYILY	TNVGAYILY
WFQTPSQVFY	FQTPSQVFY
SSYGGAGGY	SSYGGAGGY
FSLQGLKIY	FSLQGLKIY
RTMPIYPTY	RTMPIYPTY
RHFDSPYLLY	HFDSPYLLY
KGADSLEDFLY	GADSEDFLY
AAYASQPAAY	AYASQPAAY
VTSSPHKCL	VTSSPHKCL
VVQPVPFMY	VVQPVPFMY
AMNPIIYSY	AMNPIIYSY
AFHYGLYFY	AFHYGLYFY
SNGDVILVY	SNGDVILVY
GMNNRAWFY	GMNNRAWFY
YYYDPTTGLYY	YYDPTGLYY
QVQTVLQF	-QVQTVLQF
YVTTSTRTY	YVTTSTRTY
QVLFHRFFY	QVLFHRFFY
AVCDTRAKY	AVCDTRAKY
KQLDTTLKY	KQLDTTLKY
ILAQLNAKY	ILAQLNAKY
RTIATALEY	RTIATALEY
MVSDKGNLMY	VSDKGNLMY
FFSSQGQEY	FFSSQGQEY
QVSPLAARLLY	SPLAARLLY
HVYGYSMAY	HVYGYSMAY
SFLEESYPY	SFLEESYPY
LFAHNHLFY	LFAHNHLFY
YTMKEVLFY	YTMKEVLFY
YYAATKTKY	YYAATKTKY
GTADITLRF	GTADITLRF
SIEMPNISY	SIEMPNISY
HFFHSLMLY	HFFHSLMLY
IYYGTQHKMKY	YYGTHKMKY
RNFHVFLEY	RNFHVFLEY
NTAAIQAILY	NTAAQAILY
HYATVALQY	HYATVALQY
DFIYLHLSY	DFIYLHLSY
YDGDVGNYYY	YDGDVGNYY
LLADITSKY	LLADITSKY
SVLGFFIQY	SVLGFFIQY
NVTQVRAFY	NVTQVRAFY
VVSTISKGGY	VVSTSKGGY
GVKESDWLQY	GVKEDWLQY
YFAKPRNQGGY	FAKPNQGGY
HTNSGAFVY	HTNSGAFVY
QMIDQASLYQY	QMIDQASLY
SFLHPSYYLY	SFLHSYYLY
AVKTFNSELY	AVKTNSELY
SYYPPSIGFPY	YYPPIGFPY
IVLGRAYSY	IVLGRAYSY
GVNDTSLLY	GVNDTSLLY
SSASLAVEY	SSASLAVEY
HLSDVVLRF	HLSDVVLRF
GVIKRNWEY	GVIKRNWEY
YFICKALEKD	YFICKALEK
FIDSIIAKY	FIDSIIAKY
ALAQARLLY	ALAQARLLY
QTLQRSWAY	QTLQRSWAY
NWKVPAILY	NWKVPAILY
SYRGQPGNAY	SYRGPGNAY
NLNYLHLDY	NLNYLHLDY
FYLKEQTFY	FYLKEQTFY
FARYGSDFY	FARYGSDFY
MALGLALRY	MALGLALRY
RAASVFVLY	RAASVFVLY
NMDTFSNLLY	NMDTSNLLY
KVMEIHSKY	KVMEIHSKY
SIAKIYNANY	SIAKYNANY
FLITDDEEY	FLITDDEEY
EVYDDFLHY	EVYDDFLHY
NYHWQETAY	NYHWQETAY
IEHGIITNW	IEHGIITNW
EAVASVIIY	EAVASVIIY
GLSEKLLAY	GLSEKLLAY
NLIESHSTTLY	IESHSTTLY
RTLPVLLLY	RTLPVLLLY
YLESHGLAY	YLESHGLAY
HTMNVPSLF	HTMNVPSLF
TEITDDLHFY	EITDDLHFY
YHPSHQAHRY	HPSHQAHRY
TAQVIILNHPG	TAQVIILNH
SLNEVPLHY	SLNEVPLHY
ATALFSFLY	ATALFSFLY
DEARNLHSKW	EARNLHSKW
RTYGLTPHY	RTYGLTPHY
YFEVTHDITKY	EVTHDITKY
VFINEAAYY	VFINEAAYY
HVNNSNLNY	HVNNSNLNY
SVYGVFVSY	SVYGVFVSY
FIALITDSY	FIALITDSY
HILGSKLFY	HILGSKLFY
IYIYPKHLKY	YIYPKHLKY
FLKHSNLLY	FLKHSNLLY
ILHKYVALY	ILHKYVALY
LLFGHQHFY	LLFGHQHFY
LYSHLFAVGY	LYSHFAVGY
RSFTLMLRY	RSFTLMLRY
ADKVHLMY	-ADKVHLMY
YYSPSIGFSY	YYSPIGFSY
IFILPSIFY	IFILPSIFY
NICHIDLRY	NICHIDLRY
LFLKSNFEY	LFLKSNFEY
QLSEIEKYY	QLSEIEKYY
SNLPSPFAY	SNLPSPFAY
TALAAFLSY	TALAAFLSY
SSLGLGLAY	SSLGLGLAY
YNSDGYGGNY	YNSDYGGNY
VFELVNQLQY	FELVNQLQY
HFPHASNITLY	FPHANITLY
NMSKVVDSLY	NMSKVDSLY
VFQELNKLY	VFQELNKLY
YFLGKEIFY	YFLGKEIFY
SAALIIQKY	SAALIIQKY
RVVDTFQDY	RVVDTFQDY
FFLHLSPSHY	FFLHSPSHY
FHATGHHY	-FHATGHHY
MFGGYSLYY	MFGGYSLYY
LFHAMDTLY	LFHAMDTLY
ALHMLFLLY	ALHMLFLLY
FTLHTLLTY	FTLHTLLTY
DLATFILLY	DLATFILLY
FTHRGFLLY	FTHRGFLLY
VLRDLLRY	-VLRDLLRY
MSYFPRGLKY	SYFPRGLKY
LFYTEDEIY	LFYTEDEIY
GYPPIAPFY	GYPPIAPFY
YYPMVPGTY	YYPMVPGTY
SVTRPAFLY	SVTRPAFLY
SYRDSYDSY	SYRDSYDSY
ATFLVISHY	ATFLVISHY
SLLWALILY	SLLWALILY
GDLGIEIPAEK	LGIEIPAEK
AEHDRMARQW	AEHDRMARQ
FLHELAIMD	FLHELAIMD
AQNAVRLHY	AQNAVRLHY
TYWHAQGMGY	YWHAQGMGY
GLLEEALFY	GLLEEALFY
AEDKENYKKF	AEDKNYKKF
QNLAKYQHY	QNLAKYQHY
WISDKTRFAY	ISDKTRFAY
HYYTGTQGLIF	YTGTQGLIF
YALRAITRY	YALRAITRY
LLDEGAKLLY	LLDEAKLLY
YLAKNGYEY	YLAKNGYEY
VFYLQPECSS	FYLQPECSS
GSHSMRYFTTS	GSHSMRYFT
TSFDKFYKY	TSFDKFYKY
MFQRTTYKY	MFQRTTYKY
GFIDSFRPLY	FIDSFRPLY
YDGDIGNYYY	YDGDIGNYY
YINGGELFY	YINGGELFY
ILFSGVHFY	ILFSGVHFY
QIFIGPTYY	QIFIGPTYY
RFQTIPLYY	RFQTIPLYY
GTDGHVHLY	GTDGHVHLY
GVMEKSFLEY	VMEKSFLEY
YAPDDVYDY	YAPDDVYDY
VILPPLSPY	VILPPLSPY
AQQAADKYL	AQQAADKYL
AYSQPVQGY	AYSQPVQGY
RVYDIPPKFFY	RVYDIPPKF
IAKHIDAEY	IAKHIDAEY
LFFYPLDFTF	FFYPLDFTF
RNLDKAFSY	RNLDKAFSY
SQVEALFSY	SQVEALFSY
SLGVAALY	-SLGVAALY
DFFELRLKY	DFFELRLKY
MTNQNTPEY	MTNQNTPEY
TLGDFAAEY	TLGDFAAEY
SYGQGGYLY	SYGQGGYLY
KMDDLNLHY	KMDDLNLHY
SYDPNHPSY	SYDPNHPSY
LLDEHHISY	LLDEHHISY
SIAGLEFAY	SIAGLEFAY
FVQENYLE	-FVQENYLE
SYVYLSMSYY	SYVYLSMSY
LVIPGHLIFLY	VIPGLIFLY
RVCGTLLEY	RVCGTLLEY
HFLREMGQFY	FLREMGQFY
RTLQHGLYY	RTLQHGLYY
FFVESKVTY	FFVESKVTY
HYFITTLLY	HYFITTLLY
TFEHFYQHY	TFEHFYQHY
ILADMLLYY	ILADMLLYY
FYTAEQLVY	FYTAEQLVY
SVLIMGRGYHY	LIMGRGYHY
TVAGGAWTY	TVAGGAWTY
GYLRDFLRY	GYLRDFLRY
YMSMLLFRL	YMSMLLFRL
KVINDGLFYY	KVINDGLFY
RVIGLGLLY	RVIGLGLLY
LTPEEEEILNK	LTPEEEEIL
LFYDWLFFS	LFYDWLFFS
KWTDLALQY	KWTDLALQY
TFFYAGYSY	TFFYAGYSY
HAVYRDDLKKL	AVYRDDLKK
HVWPMYLKY	HVWPMYLKY
SFKTKSNLY	SFKTKSNLY
FYFKLTDLY	FYFKLTDLY
LFSIAPLIY	LFSIAPLIY
GFFGAGGAGY	FFGAGGAGY
KCSELNGRY	KCSELNGRY
YYYNNTDGLY	YYNNTDGLY
RLPVFTLDY	RLPVFTLDY
FMNALVNAY	FMNALVNAY
FLERFNTHY	FLERFNTHY
AEIEIVKDL	AEIEIVKDL
FLGYPITLY	FLGYPITLY
FYAPELLYY	FYAPELLYY
RFMDPEMETRY	FMDPMETRY
SVDSQILYY	SVDSQILYY
GLYQRSYNY	GLYQRSYNY
TTKSADRVTY	TTKSDRVTY
YFSKLWLLY	YFSKLWLLY
IPLDPVAGY	IPLDPVAGY
HTLQVKAIY	HTLQVKAIY
ILDKKVEKV	ILDKKVEKV
QEHIDLGIKY	EHIDLGIKY
YYGPLTFKY	YYGPLTFKY
YNQRPPYGYY	YNQRPPYGY
YFGYIKQGLY	YFGYKQGLY
SYSRVYLLY	SYSRVYLLY
EELNDLIQRF	ELNDLIQRF
SVFWWKQLY	SVFWWKQLY
FQTNQLLFY	FQTNQLLFY
GISDLAQHY	GISDLAQHY
NILEENLFY	NILEENLFY
TVNTELLGY	TVNTELLGY
FLIDLKTRY	FLIDLKTRY
YYGHTNYIY	YYGHTNYIY
PSHGYTLIY	PSHGYTLIY
ALPAAGFLY	ALPAAGFLY
TLAGLALKY	TLAGLALKY
MYHRYWEEY	MYHRYWEEY
FLINPTKTFY	LINPTKTFY
KVNVAKLRY	KVNVAKLRY
SESPIVVVL	SESPIVVVL
MFMAPAQMAY	FMAPAQMAY
YNSDLVQKY	YNSDLVQKY
TELPKAEKW	TELPKAEKW
ALDSSSILY	ALDSSSILY
SFVALSTHY	SFVALSTHY
SQMDVLLTY	SQMDVLLTY
LFLEQHYPY	LFLEQHYPY
NFHMEQLKY	NFHMEQLKY
SINENGYKFLY	NENGYKFLY
AYEDLSQKY	AYEDLSQKY
HFASQFLGY	HFASQFLGY
MNYGPGHGY	MNYGPGHGY
MTVSDAILRY	TVSDAILRY
HTFSEVEVFEY	TFSEEVFEY
GYFAGKLSY	GYFAGKLSY
NYFEVPLPY	NYFEVPLPY
LALLFPLRY	LALLFPLRY
RNFDKAMSY	RNFDKAMSY
SFTSIMGYLY	SFTSMGYLY
QTMGFPLLTY	TMGFPLLTY
LITDIGLMY	LITDIGLMY
YEHAQTYYY	YEHAQTYYY
ILNRYIYFY	ILNRYIYFY
LSYTHFAEKY	SYTHFAEKY
FTTAQKRVY	FTTAQKRVY
AIQAVLTLY	AIQAVLTLY
VFVPYGYLY	VFVPYGYLY
IMIQPILY	-IMIQPILY
SFPPVSLHY	SFPPVSLHY
TTLHNLLLY	TTLHNLLLY
TVYPVAIKY	TVYPVAIKY
SFTNFSQLY	SFTNFSQLY
YNLPSYEYLY	NLPSYEYLY
ATMYNLLAY	ATMYNLLAY
YVYPNSFFRY	VYPNSFFRY
LLFADQLSY	LLFADQLSY
VTSPIRASY	VTSPIRASY
YTYLRINFY	YTYLRINFY
WTARLAFSY	WTARLAFSY
VVREMTEGY	VVREMTEGY
YFNGQKTFLY	YFNGKTFLY
FVAVWDPKQA	FVAVWDPKQ
LFSNYFSLPYV	LFSNFSLPY
EEIPVHEEF	EEIPVHEEF
YRNLVSLEY	YRNLVSLEY
SYYEKHPLY	SYYEKHPLY
VVFNQSNIHEY	VFNQNIHEY
KVFERAVQY	KVFERAVQY
FYFAHHNLF	FYFAHHNLF
RMGIFQETLY	MGIFQETLY
EVLLRTGY	-EVLLRTGY
IFIRNVLLF	IFIRNVLLF
LYWKDPEYAKY	YWKDEYAKY
ALTDAYLLY	ALTDAYLLY
FVSDQHSLY	FVSDQHSLY
FFDPAGGGD	FFDPAGGGD
GYPQPPSQSY	GYPQPSQSY
LVNEVYHMY	LVNEVYHMY
WLIHVGESLY	LIHVGESLY
SMTERQALSY	MTERQALSY
RMYELVHRM	RMYELVHRM
FYAGGFAIVY	FYAGFAIVY
YLPRIVLLM	YLPRIVLLM
GYPEVALHF	GYPEVALHF
SYPDIHFDM	SYPDIHFDM
LFYCKFTEY	LFYCKFTEY
ATAAFQARY	ATAAFQARY
NTCADTLRY	NTCADTLRY
YVVEPYRKY	YVVEPYRKY
GYPAGFPMGY	GYPAFPMGY
AILHHLYFY	AILHHLYFY
STFVFNQKY	STFVFNQKY
VTLPVFEHY	VTLPVFEHY
AFISIGFSY	AFISIGFSY
VVYEKQMLY	VVYEKQMLY
KEELGFFQY	KEELGFFQY
FMYPVKEHY	FMYPVKEHY
LFPLFAQLDY	LFPLAQLDY
NIWDETPLY	NIWDETPLY
GVDVTGPHLY	GVDVGPHLY
GYDYTGYNY	GYDYTGYNY
LERELKQLY	LERELKQLY
VLFHNTIYY	VLFHNTIYY
LLTQQRLYY	LLTQQRLYY
RMLSGGFGY	RMLSGGFGY
EEWLPRELW	EEWLPRELW
HFPTAVFMY	HFPTAVFMY
FLAAIAHHY	FLAAIAHHY
YFATLDHYLY	YFATDHYLY
QLHGRFYLY	QLHGRFYLY
MPVGPDAILRY	VGPDAILRY
TFSSTPYRY	TFSSTPYRY
FTSTCHFTYP	FTSTCHFTY
KLKDATERY	KLKDATERY
YAISQAYSY	YAISQAYSY
VLGGEFLKY	VLGGEFLKY
IVSQIAVAY	IVSQIAVAY
SNFGGGGSY	SNFGGGGSY
SFFDLNPKY	SFFDLNPKY
KVADMALHY	KVADMALHY
VVLDKTCFY	VVLDKTCFY
VVHQLAALY	VVHQLAALY
GMYDQAVKY	GMYDQAVKY
EDLIRKLAY	EDLIRKLAY
KALEQILEY	KALEQILEY
HFEDTSYGY	HFEDTSYGY
YFEEIALKF	YFEEIALKF
RVLPCAHAY	RVLPCAHAY
VFHSPVGVGGW	VFHSVGVGG
TVDKIVVQKY	TVDKVVQKY
STMLVTHDY	STMLVTHDY
NEDNGIIKAF	NEDNIIKAF
YFIPFLPLEY	YFIPLPLEY
GLLDEAQRLLY	LLDEQRLLY
HWDPVNGYFF	HWDPVNGYF
SNLSNYHQY	SNLSNYHQY
VSGNLIDLY	VSGNLIDLY
WVQGHYLEY	WVQGHYLEY
YTLADGLEY	YTLADGLEY
ALGDGALFY	ALGDGALFY
SVLQYGYEY	SVLQYGYEY
IMGRGYHY	-IMGRGYHY
RILPVAASY	RILPVAASY
YFTHHHQRY	YFTHHHQRY
HIDVGGHMY	HIDVGGHMY
FPTISLEF	-FPTISLEF
FYLFHPLAY	FYLFHPLAY
SIFSGAASLGY	IFSGASLGY
QSAASSLAY	QSAASSLAY
NFEELNFFF	NFEELNFFF
NVADLHEKY	NVADLHEKY
HVDLDSGLRY	VDLDSGLRY
VINDGLYYY	VINDGLYYY
SFEGNVFMY	SFEGNVFMY
STHPEGYLF	STHPEGYLF
AVAALQDLRY	AVAAQDLRY
WSQHYHQGYY	SQHYHQGYY
NMSKIGYFY	NMSKIGYFY
AVSLQQLTY	AVSLQQLTY
IVAPLSVLY	IVAPLSVLY
HNDRVQALSY	HNDRQALSY
IQRTPKIQVY	IQRTKIQVY
YVQPVCPSY	YVQPVCPSY
YGGYDYTGYNY	GYDYTGYNY
GSYSLSHVY	GSYSLSHVY
LLFNKQFQY	LLFNKQFQY
SFIIPLEHY	SFIIPLEHY
YFARHKGTY	YFARHKGTY
NNYPYMHQY	NNYPYMHQY
FFYPKLKSGGY	FYPKKSGGY
HVSSAELNY	HVSSAELNY
RVVGSEFVQKY	VVGSFVQKY
FFYPLDFTF	FFYPLDFTF
SFARLARRY	SFARLARRY
YMIRMTLGY	YMIRMTLGY
SMSSLPLSY	SMSSLPLSY
QVAIAALYY	QVAIAALYY
MTLEESAMLRY	TLEEAMLRY
QLLDSTQKYLY	QLLDSTQKY
VQSIRPPY	-VQSIRPPY
SYLPVLPGDY	SYLPLPGDY
MMSSNVYYY	MMSSNVYYY
GFGGGGYGGFY	GGGGYGGFY
HIGNMHLKY	HIGNMHLKY
LFQEAEEFLY	LFQEEEFLY
QASSAAFRY	QASSAAFRY
IWKSMTLSY	IWKSMTLSY
NIIPRFVQVSE	NIIPRFVQV
AAAAAAAALY	AAAAAAALY
LLTAVQLLY	LLTAVQLLY
KVADLLVKY	KVADLLVKY
SVQETNSITVY	QETNSITVY
NLSQRVVSY	NLSQRVVSY
YFYGKEHQNFF	FYGKEHQNF
GMYTVAMAY	GMYTVAMAY
IMFGVPYVY	IMFGVPYVY
VELQELNDR	VELQELNDR
VLYDMTHYY	VLYDMTHYY
FLGNFKTKF	FLGNFKTKF
NYAAIRAEY	NYAAIRAEY
SYAALHGEFY	SYAAHGEFY
NFDKYHPGY	NFDKYHPGY
RLLETVLGY	RLLETVLGY
GLWSRAHFP	GLWSRAHFP
YLETVAAYY	YLETVAAYY
IFSYLFPKY	IFSYLFPKY
TFVEPYFDEY	FVEPYFDEY
NALNKNWRY	NALNKNWRY
SLASAAHLY	SLASAAHLY
YYLDPYAPY	YYLDPYAPY
ASTTRAELAY	STTRAELAY
GGYGGRSRY	GGYGGRSRY
HFEETQHTY	HFEETQHTY
YYDGDVGNYY	YYDGDVGNY
MALHLAARY	MALHLAARY
AVFRSNLSH	AVFRSNLSH
AFYGDAETVLY	FYGDETVLY
NVTDDTYYY	NVTDDTYYY
YIWDVTILEY	YIWDTILEY
ALLLTDQHLY	LLLTDQHLY
KVCDIYINY	KVCDIYINY
TDPVYEALLY	DPVYEALLY
YFGEIALLM	YFGEIALLM
YLRAQQEEY	YLRAQQEEY
FVHFLSLVY	FVHFLSLVY
VTLNVHSEY	VTLNVHSEY
DQLKEYLFY	DQLKEYLFY
TEIEGTQKL	TEIEGTQKL
IVYENLDIMRY	YENLDIMRY
TFFHHINLQY	FFHHINLQY
YYVGFAYLM	YYVGFAYLM
IFHATGHHY	IFHATGHHY
YLFHEHQLY	YLFHEHQLY
YLTTLRALY	YLTTLRALY
GYMDQIIEY	GYMDQIIEY
EEAHLNTSF	EEAHLNTSF
KLAGDHIEY	KLAGDHIEY
SFISGLFNFY	FISGLFNFY
IEKFDKSKL	IEKFDKSKL
GYYGQSARY	GYYGQSARY
RYVEFNLLY	RYVEFNLLY
GVFGQNEYLRY	VFGQEYLRY
GSIVAIAYL	GSIVAIAYL
VFVESVLRY	VFVESVLRY
VILGGAYLYKY	VILGGAYLY
MSKWEEIIY	MSKWEEIIY
SVQSHSHSF	SVQSHSHSF
YYDPQTGLYY	YYDPTGLYY
YIWSGRDGY	YIWSGRDGY
KLADQIFAY	KLADQIFAY
SFAEIIMGY	SFAEIIMGY
KYFDEHYE	-KYFDEHYE
SYDIENLYF	SYDIENLYF
ITTDVNPYY	ITTDVNPYY
KIIGNLLYY	KIIGNLLYY
GAQAGQYTY	GAQAGQYTY
FLVEEVAQEY	LVEEVAQEY
SMIGEPTNFVH	SMIGEPTNF
FLHHTLALY	FLHHTLALY
IFRPDNFVF	IFRPDNFVF
MLNFVQNIQY	LNFVQNIQY
SLARFSDTQY	SLARSDTQY
ALNPTGTFLY	ALNPGTFLY
DYDNLVLDY	DYDNLVLDY
FSGMSDHRY	FSGMSDHRY
FVGGIDLAY	FVGGIDLAY
IYNAAVWYY	IYNAAVWYY
ILHNVFLLY	ILHNVFLLY
LLSPFSLLLY	LLSPSLLLY
YILPFQKGY	YILPFQKGY
FIDASRLVY	FIDASRLVY
HVSDHSGFHY	HVSDSGFHY
VFNPSVLHY	VFNPSVLHY
AVVTVPAYF	AVVTVPAYF
FVFDERYALSY	VFDEYALSY
QVFEGHTHY	QVFEGHTHY
KMFMDSESFYY	FMDSESFYY
NFYYQSMRY	NFYYQSMRY
GYSFTTTAER	YSFTTTAER
NHYSIVTGLY	HYSIVTGLY
FYYQQAAYY	FYYQQAAYY
VVATESHQY	VVATESHQY
STVSRFFL	-STVSRFFL
TFERLMSINY	TFERMSINY
SSSAYLLFY	SSSAYLLFY
QYSKVLALY	QYSKVLALY
NFSNQTAYLY	FSNQTAYLY
LLLKDFLRY	LLLKDFLRY
SALFLGVAY	SALFLGVAY
NLLSQSHAY	NLLSQSHAY
SMLDILMDY	SMLDILMDY
ATAVHAYRY	ATAVHAYRY
SYGVVKLAY	SYGVVKLAY
YSTSLTFTY	YSTSLTFTY
VLLDYHLNY	VLLDYHLNY
TICNDLYIY	TICNDLYIY
VLWNLYHYY	VLWNLYHYY
SYFAERLYY	SYFAERLYY
VLLSSSFVY	VLLSSSFVY
HVSTVNPNY	HVSTVNPNY
FSLEQLRQYD	FSLEQLRQY
FTDPRAYLKY	FTDPAYLKY
FYKRLLLYF	FYKRLLLYF
LHDQNPVL	-LHDQNPVL
FYGPRIGALY	FYGPIGALY
FFTSLVKQEM	FFTSVKQEM
QVNHTILQY	QVNHTILQY
MWSEGRYEY	MWSEGRYEY
SLPKVHPRY	SLPKVHPRY
NTLLYILHY	NTLLYILHY
VYLHYLPSYY	YLHYLPSYY
VVLRFAAAY	VVLRFAAAY
KSLEAFFLY	KSLEAFFLY
AVAFGSFFQGY	AFGSFFQGY
IYAASKLSY	IYAASKLSY
KVADPWGGSY	KVADWGGSY
YYDPLAGTYY	YYDPLAGTY
HVNARHLLY	HVNARHLLY
TTSGIQVRY	TTSGIQVRY
SGYHSNHGY	SGYHSNHGY
AFYEHAQTYY	AFYEHAQTY
SIYSNYYLY	SIYSNYYLY
YFGNYFTYY	YFGNYFTYY
NVANVTCYY	NVANVTCYY
YIFDYDYY	-YIFDYDYY
KYTEIHPEM	KYTEIHPEM
KDRQQLLAY	KDRQQLLAY
GLKNTAEKY	GLKNTAEKY
LLSEMLLHY	LLSEMLLHY
TYTETVNHHY	YTETVNHHY
NFSDTGNFGF	NFSDGNFGF
FAARRSNTY	FAARRSNTY
QVMPQLLNY	QVMPQLLNY
IIQEGRILY	IIQEGRILY
ATGGFVLLY	ATGGFVLLY
FVADLHLNY	FVADLHLNY
TFYEFRTYY	TFYEFRTYY
AFDHDSSRLLY	FDHDSRLLY
KWTAISALEY	WTAISALEY
ILKQEQEEY	ILKQEQEEY
KIADMGHLKY	KIADGHLKY
FFANSLLHY	FFANSLLHY
HIADLRAYY	HIADLRAYY
LFNDEHHSY	LFNDEHHSY
FVPHIPFDFY	FVPHPFDFY
YYPEYKLLF	YYPEYKLLF
LYAIPGLDY	LYAIPGLDY
YQFIHAADMLY	FIHAADMLY
YYDIPDAPY	YYDIPDAPY
QICEKAFSY	QICEKAFSY
TLHKKTFYY	TLHKKTFYY
ALLSIFSRY	ALLSIFSRY
TTLPHVQKY	TTLPHVQKY
SMILNVLEY	SMILNVLEY
NYTGVQILLY	YTGVQILLY
FGGGSQYAY	FGGGSQYAY
GQQSSYPGY	GQQSSYPGY
IFQNIKQEY	IFQNIKQEY
EHGTSLKTLY	HGTSLKTLY
ITTRLFLYY	ITTRLFLYY
TSRVRLFY	-TSRVRLFY
GVVAIRDGAY	VVAIRDGAY
SLFPYPYTY	SLFPYPYTY
HQALEQLHY	HQALEQLHY
LFFWNSKSTY	FFWNSKSTY
GQLGLLARY	GQLGLLARY
RTLKHVLYY	RTLKHVLYY
MYEPAGLMF	MYEPAGLMF
RTFQEVLAY	RTFQEVLAY
LMVADMLEY	LMVADMLEY
KLYSLFLKY	KLYSLFLKY
ALSKTVFYY	ALSKTVFYY
QPPEVIQLY	QPPEVIQLY
LYWKGPLFY	LYWKGPLFY
HTAPNVPHY	HTAPNVPHY
FFQGKHFFLY	FQGKHFFLY
LQNDGFFLY	LQNDGFFLY
FSAGLQLTY	FSAGLQLTY
VAHSSGNMYLY	HSSGNMYLY
YFQYLSKTY	YFQYLSKTY
SYWKEGRWGY	YWKEGRWGY
LFLSLLPVAY	LFLSLPVAY
RTEEGPTLSY	TEEGPTLSY
HLLSSLLLY	HLLSSLLLY
FYLGKRCAY	FYLGKRCAY
SVQSQALHY	SVQSQALHY
GVKSVGQGY	GVKSVGQGY
HTAWLVMEY	HTAWLVMEY
YIPGVILSY	YIPGVILSY
VIYPGDSDTRY	YPGDSDTRY
YFFDNPRRY	YFFDNPRRY
YLNKMDLPY	YLNKMDLPY
ILPSLKGKTY	ILPSKGKTY
RFSGLLLGY	RFSGLLLGY
AVSSVAEAY	AVSSVAEAY
YRNMVLLVY	YRNMVLLVY
PSLLHLLY	-PSLLHLLY
SFTIVSLMY	SFTIVSLMY
IMSELEILY	IMSELEILY
SFPEVFTTY	SFPEVFTTY
YGYEQGQYGNY	YEQGQYGNY
YFGSLVQDY	YFGSLVQDY
FIGEFTTSY	FIGEFTTSY
SYYSPSIGFSY	YYSPIGFSY
KQYGEGLSY	KQYGEGLSY
ALMETLLDY	ALMETLLDY
YAAAALPTLY	AAAALPTLY
GSNFGGGGSY	SNFGGGGSY
KLMAMFLEY	KLMAMFLEY
LSKLHLSY	-LSKLHLSY
KMDLLNYQY	KMDLLNYQY
WVQENYLEY	WVQENYLEY
HTLGNSLRY	HTLGNSLRY
YVLELGHPY	YVLELGHPY
NTATIFHELVY	ATIFHELVY
ALAIFHLAY	ALAIFHLAY
YFPTVPGVY	YFPTVPGVY
YIPYMHGYSY	YIPYHGYSY
SFAEIKHKY	SFAEIKHKY
YIASLKQRY	YIASLKQRY
VFVATFLRY	VFVATFLRY
KFHSRALYY	KFHSRALYY
LFWEQHDLVY	LFWEHDLVY
VVFENSPLY	VVFENSPLY
HGLQMRLKY	HGLQMRLKY
GFLTSAYHY	GFLTSAYHY
GNSRLVLFY	GNSRLVLFY
IVATIAVKY	IVATIAVKY
YLAQSPQLY	YLAQSPQLY
VLTSIQLLM	VLTSIQLLM
EQVANSAFVER	QVANSAFVE
SWIDLRATY	SWIDLRATY
QINELHLAY	QINELHLAY
MEAPAQLLF	MEAPAQLLF
MMNGGHYTYSE	MMNGGHYTY
SISKHMSLSY	SISKMSLSY
RFAKVHILY	RFAKVHILY
GAQSAASSLAY	QSAASSLAY
VYENLDIMRY	YENLDIMRY
RMVEMFLEY	RMVEMFLEY
LLSSYTDYLL	LLSSYTDYL
VMASTVVKY	VMASTVVKY
ATAHIFATY	ATAHIFATY
QVYGGVTYY	QVYGGVTYY
LLSPILARY	LLSPILARY
IFYEFRSYY	IFYEFRSYY
EEVKLIKKM	EEVKLIKKM
FMKAITDRY	FMKAITDRY
MMTDLLTEY	MMTDLLTEY
VYPGAKLFY	VYPGAKLFY
NVYKEDYNN	NVYKEDYNN
VANSVALLY	VANSVALLY
AEVDKVTGRF	EVDKVTGRF
GIFASRLYY	GIFASRLYY
ALARQLLLY	ALARQLLLY
SGLGMAYLY	SGLGMAYLY
SFENLMATKY	SFENMATKY
FYFEGTFY	-FYFEGTFY
KSTDVAKTF	KSTDVAKTF
YGYIGTHEY	YGYIGTHEY
KQFSKRYLKY	QFSKRYLKY
GFPEIAFGRY	GFPEAFGRY
NFPEMMNRY	NFPEMMNRY
AIFPSPMLY	AIFPSPMLY
ILMPNIGY	-ILMPNIGY
AQSPLIFLY	AQSPLIFLY
FYTATEGQY	FYTATEGQY
SNLFGGEPLSY	LFGGEPLSY
YAEVERQKY	YAEVERQKY
AMFDQSQIQEF	MFDQQIQEF
IYSGYIFDY	IYSGYIFDY
YYRPLHDEY	YYRPLHDEY
QTLPLSFVF	QTLPLSFVF
IFSDTAVLLF	IFSDAVLLF
YWKELSLKY	YWKELSLKY
YFARHKGTYF	YFARHKGTY
VLSYIFPTY	VLSYIFPTY
KVYGYMPLLY	VYGYMPLLY
AFTNTYLFY	AFTNTYLFY
YLLDHFLSM	YLLDHFLSM
YVAPAYGVY	YVAPAYGVY
HYHHESLAQY	YHHESLAQY
GQNAQTMAY	GQNAQTMAY
DYLKRFYLY	DYLKRFYLY
QTLRFLGLY	QTLRFLGLY
HTGHILALY	HTGHILALY
HFHAESFLY	HFHAESFLY
GLWRSTLSY	GLWRSTLSY
NMYSESSQLLY	YSESSQLLY
GENLPPLTY	GENLPPLTY
HISEVITQDY	HISEITQDY
YLPKEQYLY	YLPKEQYLY
HAAGFAYTY	HAAGFAYTY
VFLKNEKGQY	FLKNEKGQY
SSSDINILY	SSSDINILY
AVAEKMLQY	AVAEKMLQY
TELLIRKL	-TELLIRKL
LLRIGEHY	-LLRIGEHY
LFETPILARY	FETPILARY
NLLEKLGY	-NLLEKLGY
KTDVTMLLY	KTDVTMLLY
NYNHLMPTRY	NYNHMPTRY
GVAYGATRYNY	GVAYGATRY
GTLDSVLRY	GTLDSVLRY
TIYTGLWSY	TIYTGLWSY
LENYQILQY	LENYQILQY
NILPKVFHY	NILPKVFHY
YMPSGAYVY	YMPSGAYVY
FVFSHGLIY	FVFSHGLIY
YLLESAKMFNY	LESAKMFNY
VAAAVQAFY	VAAAVQAFY
MMMFAALQY	MMMFAALQY
IYDDSYLGY	IYDDSYLGY
SALHIIVQY	SALHIIVQY
HFLVTRLLY	HFLVTRLLY
MYLHRPEEY	MYLHRPEEY
VPFPLTLRF	VPFPLTLRF
ATAPYNYSY	ATAPYNYSY
LLAKECRLYY	LLAKCRLYY
SYEMQQLFY	SYEMQQLFY
VLYNIAFMY	VLYNIAFMY
SENELKKAY	SENELKKAY
TVLPFAGLLY	TVLPAGLLY
GIPDLRHFLY	GIPDRHFLY
IQNDRQLQY	IQNDRQLQY
FYAKGALQY	FYAKGALQY
LFYSEVHPHY	FYSEVHPHY
LMMRKAYKY	LMMRKAYKY
KQCGKSFTY	KQCGKSFTY
FLNFHYLTY	FLNFHYLTY
SLNPRPHRY	SLNPRPHRY
VVFSVTTQY	VVFSVTTQY
AGISIALYL	AGISIALYL
NIYDSMPLRY	IYDSMPLRY
YTFNPKGQYY	TFNPKGQYY
RFVIFPIEY	RFVIFPIEY
SFSTFDTPY	SFSTFDTPY
HWDVVFATY	HWDVVFATY
FLPGWNLIY	FLPGWNLIY
YVPDVTGRY	YVPDVTGRY
VVLPHQPLATY	VLPHPLATY
FVQENYLEY	FVQENYLEY
NHFEGHYQY	NHFEGHYQY
MTKYHSDEY	MTKYHSDEY
THTDVGLLEY	HTDVGLLEY
KLFEDGEMAKY	LFEDEMAKY
KLREQSEHY	KLREQSEHY
NFEAAPYLY	NFEAAPYLY
AFSKVNLNY	AFSKVNLNY
YFFPGTGDMY	FFPGTGDMY
RWNDKPYLC	RWNDKPYLC
LAAREVIAY	LAAREVIAY
NLGDTMLHY	NLGDTMLHY
IVDKNGRLVY	IVDKGRLVY
TQFTGRYHY	TQFTGRYHY
AWLKRFLEY	AWLKRFLEY
EEDLIQYY	-EEDLIQYY
YVAEILPKY	YVAEILPKY
YATDRKETY	YATDRKETY
SMMAFDTRY	SMMAFDTRY
ATYAGQFNQDY	YAGQFNQDY
TTFQLNLNY	TTFQLNLNY
VVFHQADIGEY	VFHQDIGEY
VWLKEMLFY	VWLKEMLFY
GLYKNHPLY	GLYKNHPLY
KELDLFLAY	KELDLFLAY
GFYRIIAQY	GFYRIIAQY
YIRMTKEKY	YIRMTKEKY
YGLDDKLLHY	GLDDKLLHY
SYYAATKTKY	YYAATKTKY
FPMADGHTDSY	MADGHTDSY
GGWDGLLSY	GGWDGLLSY
TVANEVYKY	TVANEVYKY
FYDKFTIRY	FYDKFTIRY
YFSDPFLKY	YFSDPFLKY
NAVSLYLLY	NAVSLYLLY
ENLRTALRY	ENLRTALRY
AMNKRIHYY	AMNKRIHYY
YANSSTLYY	YANSSTLYY
TDVTFLLIF	TDVTFLLIF
RIASTLLLY	RIASTLLLY
FIMINPLEY	FIMINPLEY
TEVSYLEIY	TEVSYLEIY
AVDPTSGQLY	AVDPSGQLY
FYLFDLKAFF	YLFDLKAFF
MPAVHTFSL	MPAVHTFSL
NACGKSFSY	NACGKSFSY
LYKESCEAY	LYKESCEAY
KVLPVGVLY	KVLPVGVLY
HFMTQRALY	HFMTQRALY
FFKPHWDEKF	FFKPWDEKF
GSFHGDFAY	GSFHGDFAY
SVLPNALRF	SVLPNALRF
MYYYNGKTVY	YYYNGKTVY
GVGRMGELY	GVGRMGELY
VLLAAKQVLLY	LAAKQVLLY
FILPLMHTY	FILPLMHTY
STADVYLEY	STADVYLEY
IFQAHSLHY	IFQAHSLHY
ILLDQGQLNKY	LLDQQLNKY
RLKELCEQY	RLKELCEQY
SLAEGNLLY	SLAEGNLLY
GYSPYSYGY	GYSPYSYGY
ATTKAAALQY	TTKAAALQY
LQKKEIHLY	LQKKEIHLY
EPVTYFITY	EPVTYFITY
SSHSNAYFY	SSHSNAYFY
YLSNRCCILY	YLSNCCILY
TMSSSHLFY	TMSSSHLFY
SIKETVEAY	SIKETVEAY
YYRAWQEYY	YYRAWQEYY
SLPDLPYDY	SLPDLPYDY
ALSMVMHNY	ALSMVMHNY
AVMNNMESFQY	VMNNESFQY
VVNSYPLAH	VVNSYPLAH
YLLPHILVY	YLLPHILVY
FGIRPDDYLY	GIRPDDYLY
AMYPGTFYF	AMYPGTFYF
KIWNEAVSY	KIWNEAVSY
FLAQMEAKY	FLAQMEAKY
FIPRLVYQY	FIPRLVYQY
TTAGAVTQCY	TTAGVTQCY
VYDDFLHY	-VYDDFLHY
TWDQLLLHY	TWDQLLLHY
GQNASVLAY	GQNASVLAY
YLYGQTTTY	YLYGQTTTY
ANSEVTVYY	ANSEVTVYY
CCYGDLLNY	CCYGDLLNY
TDCQGCNILY	TDCQCNILY
KIVKWDRDM	KIVKWDRDM
GFFPSSLAY	GFFPSSLAY
AFDEIVALGY	AFDEVALGY
TLNAIALQY	TLNAIALQY
KEKYIDQEEL	KEKYDQEEL
DYLGIPLFY	DYLGIPLFY
KEYEKALKY	KEYEKALKY
DLWPNPLQY	DLWPNPLQY
YYPQQYGHY	YYPQQYGHY
VTLHELLTY	VTLHELLTY
YINFELRY	-YINFELRY
GQVGLALSY	GQVGLALSY
SLADAINTEF	SLADINTEF
LLLSTQLYY	LLLSTQLYY
SLENGAHAY	SLENGAHAY
GVNSDPFLM	GVNSDPFLM
VFLIIKLLY	VFLIIKLLY
IEANGSILY	IEANGSILY
MYVHAYTLY	MYVHAYTLY
YFNSFIDEY	YFNSFIDEY
YLDKGILKY	YLDKGILKY
AEIDARNDSF	AEIDRNDSF
YYKNIGLGF	YYKNIGLGF
MTLNERFTSY	TLNERFTSY
EVFEDAAEIR	EVFEDAAEI
VSIGSSYNY	VSIGSSYNY
AALEVTARY	AALEVTARY
SFIRLLLNY	SFIRLLLNY
VLLSETGIY	VLLSETGIY
FYHSSGGLELY	HSSGGLELY
LIFSVPIVY	LIFSVPIVY
MWSIGVLTY	MWSIGVLTY
SSLKDEYQY	SSLKDEYQY
TVFGTALNY	TVFGTALNY
LLNQMILTY	LLNQMILTY
SLSHLGESSSY	SHLGESSSY
RTAPLLLSY	RTAPLLLSY
VMGGPQQLY	VMGGPQQLY
SLENVLYY	-SLENVLYY
RMIYLVTEY	RMIYLVTEY
HIFVSRYLY	HIFVSRYLY
VFSDLGQLY	VFSDLGQLY
SVFHAQLAY	SVFHAQLAY
YLPLNTALY	YLPLNTALY
FIETHKLMY	FIETHKLMY
GARDGPHGDY	GARDPHGDY
LFNCESTEEA	FNCESTEEA
KITDIHIKY	KITDIHIKY
ALIEELLLY	ALIEELLLY
ILHLSYLLY	ILHLSYLLY
TFSHITGLTY	TFSHTGLTY
TISAARLYY	TISAARLYY
NYKPPNAEEFY	NYKPNAEEF
IPFPPLSY	-IPFPPLSY
SVNNVVVRY	SVNNVVVRY
IATGVQTLY	IATGVQTLY
GEVDVEQHTL	GEVDEQHTL
KYFGGVLEY	KYFGGVLEY
FFETSAAYRY	FETSAAYRY
KASGTLREY	KASGTLREY
NTMESALQY	NTMESALQY
FLEHAQLYY	FLEHAQLYY
VLADQSLRY	VLADQSLRY
REIAQDFKTDL	IAQDFKTDL
YARDETEFY	YARDETEFY
TQILPFTCAY	QILPFTCAY
NLVKIMSLYY	LVKIMSLYY
IINECYNYL	IINECYNYL
YYNVVLLRY	YYNVVLLRY
SLWKPLNY	-SLWKPLNY
LFSETSWHY	LFSETSWHY
VQAYVSALQY	QAYVSALQY
YLGQWLLIY	YLGQWLLIY
SRNAYMLVY	SRNAYMLVY
TDSFDSRAE	TDSFDSRAE
SDLQLQLTY	SDLQLQLTY
KVSASPLLY	KVSASPLLY
YFISGRHLY	YFISGRHLY
GNFGGSPGY	GNFGGSPGY
SFAILMAHY	SFAILMAHY
AGSSVLLYY	AGSSVLLYY
TLLCSAAIIY	LLCSAAIIY
HYLHLAFLM	HYLHLAFLM
LQVCSLVLY	LQVCSLVLY
TMLGKFYHF	TMLGKFYHF
GVVTSIQDRY	VVTSIQDRY
FILDGKLATMY	ILDGLATMY
QALDIRLSY	QALDIRLSY
SLRSQDIQY	SLRSQDIQY
HVFKLVALY	HVFKLVALY
NFFPGVFEY	NFFPGVFEY
YILNKEIQY	YILNKEIQY
HYNNIMALY	HYNNIMALY
ALKSSVEVY	ALKSSVEVY
QLIALFVHY	QLIALFVHY
GIKNFFTDVY	GIKNFTDVY
DFGHVRLWY	DFGHVRLWY
ISVERVIEY	ISVERVIEY
FYYLEGERY	FYYLEGERY
IDTIEIITDR	DTIEIITDR
MMDPNSTQRY	MMDPSTQRY
LYPNTPYAY	LYPNTPYAY
QVGTALQVF	QVGTALQVF
NFAKEVSHEM	FAKEVSHEM
KYINLSLHY	KYINLSLHY
NLGIPTLLY	NLGIPTLLY
VLAQSIVFS	VLAQSIVFS
HSLPDLPYDY	SLPDLPYDY
KTFPLPLLY	KTFPLPLLY
LFSSSRLRY	LFSSSRLRY
ILVTHQLQY	ILVTHQLQY
SLARAGFYY	SLARAGFYY
QVLDRYHRF	QVLDRYHRF
GLWEKCQEY	GLWEKCQEY
LLSDHFLPY	LLSDHFLPY
FMDHVLRY	-FMDHVLRY
NFGSELSLVY	FGSELSLVY
MNFRVFLQY	MNFRVFLQY
GLARIIDSEY	GLARIDSEY
YSSSRSDLY	YSSSRSDLY
YGLISLELY	YGLISLELY
SFEGNVFMYY	SFEGNVFMY
YYPELAFQF	YYPELAFQF
FFDIPVDNLY	FFDIVDNLY
FFDFFKYKY	FFDFFKYKY
ALGTGFLYL	ALGTGFLYL
GVWENGLSY	GVWENGLSY
KMLDKYSHY	KMLDKYSHY
NIQYLFLEY	NIQYLFLEY
TIEQEKQAGES	IEQEKQAGE
VASMRLAY	-VASMRLAY
REIQTAVRL	REIQTAVRL
YVSSLLAHY	YVSSLLAHY
GIATFTYFY	GIATFTYFY
MVQNVSFKY	MVQNVSFKY
FVLKGDQLYY	FVLKDQLYY
KEFEDGIINW	EFEDGIINW
WTIRSTFLY	WTIRSTFLY
TLFDSRHLLY	LFDSRHLLY
FMGDFVDRGYY	FMGDVDRGY
HYIYIENQFF	YIYIENQFF
RTGAFALLY	RTGAFALLY
LFPFEAEAY	LFPFEAEAY
GVISNKAHQSY	ISNKAHQSY
YWYSLKAYY	YWYSLKAYY
SYLPRSFEY	SYLPRSFEY
NLATLALGY	NLATLALGY
FLEQVHQLY	FLEQVHQLY
HFYSASAIY	HFYSASAIY
GTAPKLLIY	GTAPKLLIY
YFVPLHHFY	YFVPLHHFY
ITPGLPSMHY	ITPGPSMHY
AFDELLASKY	AFDELASKY
LMIPHPHLHQY	IPHPHLHQY
SYGQSQNTGY	SYGQQNTGY
WFSVSNDLKY	FSVSNDLKY
FSSNLDLRY	FSSNLDLRY
WFENTRNGLF	FENTRNGLF
IKRQSEHSI	IKRQSEHSI
NNMPFFYDY	NNMPFFYDY
ALWDSGLDY	ALWDSGLDY
MILTVGGTAY	ILTVGGTAY
KVLDKLLLY	KVLDKLLLY
GWSDTPPLAY	GWSDPPLAY
LASLSALIY	LASLSALIY
GFISKHELY	GFISKHELY
GNYGGGGNY	GNYGGGGNY
STSFLDTRF	STSFLDTRF
LFPPSRLRY	LFPPSRLRY
GTSSYTAQEY	TSSYTAQEY
ATNLSALYY	ATNLSALYY
YIYTTKTLY	YIYTTKTLY
YVHSKNLIY	YVHSKNLIY
TTSDLVSRNY	TTSDVSRNY
AVFQSPAHY	AVFQSPAHY
RVGALYLLY	RVGALYLLY
YFHHQDGYRY	YFHHDGYRY
HTLEDQALY	HTLEDQALY
SFPRMQLKY	SFPRMQLKY
MPLSVFPYY	MPLSVFPYY
FLAPPGAYY	FLAPPGAYY
GVGRFKTNY	GVGRFKTNY
VFFPLIAHY	VFFPLIAHY
TNHKDIGTLY	NHKDIGTLY
TQIYQHHEI	TQIYQHHEI
HLALFTDTGY	LALFTDTGY
GSVHFALHY	GSVHFALHY
LVNSAAHMY	LVNSAAHMY
FRSQAYIFY	FRSQAYIFY
WFAYIQNRY	WFAYIQNRY
HLPGKTFVY	HLPGKTFVY
YYAAASHSYY	YYAAASHSY
KYANMWLEY	KYANMWLEY
YVLSNVLDY	YVLSNVLDY
HYLNLNLFF	HYLNLNLFF
KAYNQTHLY	KAYNQTHLY
LQAQFSLLY	LQAQFSLLY
AMYSRKAMY	AMYSRKAMY
KVLSRALMY	KVLSRALMY
LPFTPLSY	-LPFTPLSY
MTLKQFLDY	MTLKQFLDY
NLNYAVLLY	NLNYAVLLY
IMATPEQVGKM	ATPEQVGKM
TMLKSLLRY	TMLKSLLRY
VFFNIPQIQY	FFNIPQIQY
IIMGNIELTRY	IMGNELTRY
SFYSNREQY	SFYSNREQY
AVLAVLGHY	AVLAVLGHY
TFVSIFSLY	TFVSIFSLY
GVYGSGGERY	VYGSGGERY
TVLGLSQFAHY	LGLSQFAHY
APPQFSFGY	APPQFSFGY
KLYEKFLEF	KLYEKFLEF
SFHGDFAYGTY	HGDFAYGTY
KLIDIFQKY	KLIDIFQKY
ALLKYRFFY	ALLKYRFFY
YYDSRVVGKY	YYDSVVGKY
FMLSVKMFY	FMLSVKMFY
AMMGLAQLY	AMMGLAQLY
HNPQETYHY	HNPQETYHY
NFEDLQQHY	NFEDLQQHY
YFIFNSQTVY	FIFNSQTVY
NTIPFIIRY	NTIPFIIRY
HLRDYFEQY	HLRDYFEQY
SSYGQSQNTGY	SYGQQNTGY
QEHPIPLSY	QEHPIPLSY
SFKSFEGLFY	SFKSEGLFY
FQANPSPYHLY	ANPSPYHLY
SALGLALYL	SALGLALYL
AVGSVTVYY	AVGSVTVYY
RALELAVKY	RALELAVKY
VQLVPGRLY	VQLVPGRLY
FVWQRYLDY	FVWQRYLDY
GLPDLVAKY	GLPDLVAKY
SIWSHQMYY	SIWSHQMYY
KSYSNSHEY	KSYSNSHEY
NVDTESALLY	NVDTSALLY
GTIFPVAGY	GTIFPVAGY
FLKYFGTFF	FLKYFGTFF
AVGEGFHNY	AVGEGFHNY
RVIELAVKY	RVIELAVKY
HMYYNRDWY	HMYYNRDWY
FYLKMKGDYY	FYLKMKGDY
NFWMTRQEY	NFWMTRQEY
LWGIDPVSY	LWGIDPVSY
AYTDAALNY	AYTDAALNY
FMSEVIQAY	FMSEVIQAY
AIDSVHQLHY	AIDSHQLHY
YVDPQFLTY	YVDPQFLTY
SVFVGNLPY	SVFVGNLPY
LVHAQHFPY	LVHAQHFPY
IIPRLVYYY	IIPRLVYYY
LFYQPDLKY	LFYQPDLKY
FTIQQNLILHY	IQQNLILHY
HFDPTISL	-HFDPTISL
FWEQHDLVY	FWEQHDLVY
NYIAPSGHY	NYIAPSGHY
FISLRLIAY	FISLRLIAY
VTRHPINEYY	VTRHINEYY
FMDSESFYY	FMDSESFYY
SLDIVLHDTYY	SLDILHDTY
YYSGLIYTY	YYSGLIYTY
YVIPAFLVY	YVIPAFLVY
FFNQINMLY	FFNQINMLY
SYSTEVPSTY	YSTEVPSTY
ISTPVIRTF	ISTPVIRTF
ILSQDRFY	-ILSQDRFY
KFLEETNCLY	FLEETNCLY
NYGDNFLNY	NYGDNFLNY
KQNLEAYRY	KQNLEAYRY
QSYEDMRGILY	SYEDRGILY
STPSRWPSP	STPSRWPSP
FFFSVPSTAY	FFSVPSTAY
YFQYVGTDF	YFQYVGTDF
YVNSMLQEY	YVNSMLQEY
KALEVKLAY	KALEVKLAY
HVLKSLLEY	HVLKSLLEY
GVFFPVFAY	GVFFPVFAY
FLLDGAPFRY	FLLDAPFRY
NVSGKFFEY	NVSGKFFEY
TLGILLKNY	TLGILLKNY
RIRGESELY	RIRGESELY
LPDKVFIKY	LPDKVFIKY
GALDVTIMY	GALDVTIMY
FSLFSRFI	-FSLFSRFI
WFLVQQLRY	WFLVQQLRY
SYGPRPEEY	SYGPRPEEY
PLSALPPP	-PLSALPPP
HFIHNSHTAY	FIHNSHTAY
YFEYIEENKY	YFEYEENKY
VVNNDHFLY	VVNNDHFLY
PQGETEREY	PQGETEREY
IVHGIMHLY	IVHGIMHLY
VVFHDRRLQY	VFHDRRLQY
SFEQFHLF	-SFEQFHLF
RTTYMAYHY	RTTYMAYHY
SIFGLGLAY	SIFGLGLAY
FYPELKLAY	FYPELKLAY
KVAEANQKY	KVAEANQKY
GFLRLKMAY	GFLRLKMAY
SASTTTLRY	SASTTTLRY
YFFDAAKLMF	FFDAAKLMF
YYDGDIGNYY	YYDGIGNYY
MFSQSVAHLY	FSQSVAHLY
GLNKESFRY	GLNKESFRY
YYLPKLLSY	YYLPKLLSY
GGYGGGGGY	GGYGGGGGY
YKLGVRLYY	YKLGVRLYY
NIPENPLKY	NIPENPLKY
EEILKVEQKY	EILKVEQKY
NSLPGNFFY	NSLPGNFFY
PPQQQRLIY	PPQQQRLIY
FMRHPRREMY	FMRHRREMY
NAMRTFLNY	NAMRTFLNY
IPLFVQLLY	IPLFVQLLY
FLPFPLPLFAY	LPFPPLFAY
FIANHPFLF	FIANHPFLF
KLNEYLLQY	KLNEYLLQY
YGGGGIHEY	YGGGGIHEY
VADMALHY	-VADMALHY
VVLQGANLYGY	VVLQGANLY
YTNKEMLKY	YTNKEMLKY
FFLQVPLRY	FFLQVPLRY
GMLEEDLIQYY	LEEDLIQYY
STNLKTHF	-STNLKTHF
GASLGGIIY	GASLGGIIY
YNFDSWREFSY	NFDSREFSY
YFKPTVETY	YFKPTVETY
HLPSQAHLY	HLPSQAHLY
MAYGGKLKY	MAYGGKLKY
GFIDSIIAKY	FIDSIIAKY
ILAQPTLLY	ILAQPTLLY
FFFTARTSFF	FFFTARTSF
GLHEMHIKY	GLHEMHIKY
TVLELVINY	TVLELVINY
VLAGHGHLY	VLAGHGHLY
NVNAVHSHY	NVNAVHSHY
LLQIYFFHS	LLQIYFFHS
FIAPDKHEY	FIAPDKHEY
AATSRTYLY	AATSRTYLY
AVTVSLIGAY	VTVSLIGAY
FSQNFSLIY	FSQNFSLIY
FLDFHALPY	FLDFHALPY
AYNSIAYIY	AYNSIAYIY
YQDDYPRDY	YQDDYPRDY
AVAALDGAKY	AVAADGAKY
SLLAPALAY	SLLAPALAY
FIPPIVARY	FIPPIVARY
QLASAGFYY	QLASAGFYY
ELVSARILY	ELVSARILY
IKETQERY	-IKETQERY
STLHLVLRL	STLHLVLRL
YVSDIQELY	YVSDIQELY
FLYGMVHVY	FLYGMVHVY
SRSAVYPLLY	RSAVYPLLY
NVADYYPEY	NVADYYPEY
SLMSQGLLY	SLMSQGLLY
SLSVEIVYE	SLSVEIVYE
VLLDEAQRLLY	LLDEQRLLY
EHPILFLYY	EHPILFLYY
SWTGKVLYL	SWTGKVLYL
GEYLEEVEY	GEYLEEVEY
GNLANVIRY	GNLANVIRY
GMYTLTMKY	GMYTLTMKY
YFRQGHEAY	YFRQGHEAY
HLTTFSLQY	HLTTFSLQY
KNYQEALRY	KNYQEALRY
RMLDILAEY	RMLDILAEY
SYPYYPYLY	SYPYYPYLY
STCEKAFHY	STCEKAFHY
FYLEAAAKY	FYLEAAAKY
TFKEQGNAYY	TFKEQGNAY
SEAPSGESRKF	APSGESRKF
VTSEHTYDF	VTSEHTYDF
YFMNEPTFY	YFMNEPTFY
LFSKALNLRY	LFSKLNLRY
AEIEKLGQKY	AEIELGQKY
TISNVLLQY	TISNVLLQY
ELATGYKVY	ELATGYKVY
HFYSGSPTSY	FYSGSPTSY
KVLGTEDLYDY	KVLGTEDLY
ITAKFTALY	ITAKFTALY
HTAHIACKF	HTAHIACKF
SYTAVFGAY	SYTAVFGAY
LVAAKCYYY	LVAAKCYYY
HNVFHPLTY	HNVFHPLTY
NAAERRGPL	NAAERRGPL
VALAGTFHY	VALAGTFHY
WYRLGEHLY	WYRLGEHLY
FLQRLMALY	FLQRLMALY
FVAPATGAHNY	APATGAHNY
FLTTSFYTY	FLTTSFYTY
QAQKLRLAY	QAQKLRLAY
YFDTRSERY	YFDTRSERY
ASSGVMEKLQY	SGVMEKLQY
GEVDYKKKY	GEVDYKKKY
SVLTKTYKM	SVLTKTYKM
WFPLKALQY	WFPLKALQY
DILSNTFYS	DILSNTFYS
AYPFQSLLY	AYPFQSLLY
LYAKLIFLY	LYAKLIFLY
GFSAVMNRKF	GFSAMNRKF
KFLEQVHQLY	KFLEVHQLY
QAVSALVGFA	AVSALVGFA
FVPRHWWHY	FVPRHWWHY
VVVHDWLYY	VVVHDWLYY
VLNRIQFRY	VLNRIQFRY
GTSVAMRTLY	TSVAMRTLY
ASYRGQPGNAY	SYRGPGNAY
ALLEEKLRY	ALLEEKLRY
SVSDAVATYY	SVSDVATYY
SYLSHQLDF	SYLSHQLDF
KFTNFNLFY	KFTNFNLFY
KQTSEYLRY	KQTSEYLRY
STMEGGTLKY	STMEGTLKY
SAYEALEKY	SAYEALEKY
YTSDYFISY	YTSDYFISY
VVFENSPLYQY	VVFENSPLY
GWNDPPQFSY	GWNDPQFSY
NVLRLETLY	NVLRLETLY
FYHLAKETGY	YHLAKETGY
HFGGKRLSLLY	GGKRLSLLY
ASGSIVLFY	ASGSIVLFY
KLKFIKGTDY	KLKFKGTDY
SYGRLTFKY	SYGRLTFKY
IFRHLGLEY	IFRHLGLEY
DRPHEGTRPVR	RPHETRPVR
VLFYPTLLY	VLFYPTLLY
HLKSQLDHGTY	KSQLDHGTY
LFDISMAISY	FDISMAISY
VVQALRLLY	VVQALRLLY
NAAQIFAIY	NAAQIFAIY
VVYPWTQRF	VVYPWTQRF
EEAEIIRKY	EEAEIIRKY
TTSPLTLQY	TTSPLTLQY
SLELLPPP	-SLELLPPP
SNLSLALKY	SNLSLALKY
SELVRVNIT	SELVRVNIT
ALNFSVFYY	ALNFSVFYY
SFFPDKPITQY	FFPDPITQY
YYDYYGYDY	YYDYYGYDY
YVREQQDAY	YVREQQDAY
FYFEIPRTFQY	FEIPRTFQY
EHSPDNNIIY	HSPDNNIIY
HVYEIPVEY	HVYEIPVEY
LFPQLQVHY	LFPQLQVHY
LFYDVKLQY	LFYDVKLQY
RFEVLGWDY	RFEVLGWDY
SAYAQNYRY	SAYAQNYRY
YILDQTNVY	YILDQTNVY
RIAEFAFEY	RIAEFAFEY
ALVDAQLDY	ALVDAQLDY
KEVVEEAENGR	VVEEAENGR
SFHKPVTSY	SFHKPVTSY
YATFIVTNY	YATFIVTNY
QIVDVFMEY	QIVDVFMEY
NTDPHSQEY	NTDPHSQEY
SEIPQTERM	SEIPQTERM
TTISHYPDY	TTISHYPDY
MWFDKTPLSY	WFDKTPLSY
IPFGNNPIFRY	FGNNPIFRY
ATSNVFAMF	ATSNVFAMF
PLPSQFGHY	PLPSQFGHY
FVIKRLPLFY	VIKRLPLFY
TALHLALQY	TALHLALQY
NGFGGFGSY	NGFGGFGSY
AMTGTFPAY	AMTGTFPAY
FMYEREHQY	FMYEREHQY
GVIEKLLTSY	VIEKLLTSY
STEERTFQY	STEERTFQY
YLLDMPLWY	YLLDMPLWY
HLHGKTFDY	HLHGKTFDY
LNDQHWHY	-LNDQHWHY
GLQTRNFLY	GLQTRNFLY
MIIFIHSYY	MIIFIHSYY
ALPSLRILY	ALPSLRILY
TVFDQPQEY	TVFDQPQEY
IFRAFPGLRY	IFRAPGLRY
VFMHVSTAYAY	VFMHVSTAY
YTAQPTQGY	YTAQPTQGY
HWEKTMSRRY	WEKTMSRRY
TFVDSAWYY	TFVDSAWYY
AQAEVYKEL	AQAEVYKEL
FAHASGMQY	FAHASGMQY
FIFPQFLYQF	IFPQFLYQF
ALAPKFPEY	ALAPKFPEY
DVNAAIATIK	VNAAIATIK
FLGKEMKLYF	FLGKEMKLY
SILEKPFEY	SILEKPFEY
YFNVASAIY	YFNVASAIY
NFAIRGLHY	NFAIRGLHY
VAYDSKQYY	VAYDSKQYY
YYDQGYGNY	YYDQGYGNY
KMKEIAEAY	KMKEIAEAY
TFFDPAGGGD	FFDPAGGGD
LSTALSLLY	LSTALSLLY
AINRQTALY	AINRQTALY
YVEKFALNY	YVEKFALNY
STYEKALGY	STYEKALGY
GTYDQTLEF	GTYDQTLEF
LEESTFFAEY	EESTFFAEY
KLALYVYEY	KLALYVYEY
YFVTFPYPYM	YFVTFPYPY
GEFAKVLEL	GEFAKVLEL
SLSDRTNLY	SLSDRTNLY
SWDNNVYFY	SWDNNVYFY
VDDERWHY	-VDDERWHY
WFVADLHLNY	FVADLHLNY
FVGEPVWTAY	FVGEVWTAY
AFLSQELLY	AFLSQELLY
RVFSIVIPFLY	VFSIIPFLY
YFGSAFATPF	YFGSFATPF
TVLQTQALY	TVLQTQALY
LLPAAAWHY	LLPAAAWHY
YFYEAFEGY	YFYEAFEGY
GTDELRLLY	GTDELRLLY
VMNNMESFQY	VMNNESFQY
YLIPIVVRY	YLIPIVVRY
YMSGYHTGY	YMSGYHTGY
YFETLRQGY	YFETLRQGY
VYPNSFFRY	VYPNSFFRY
AFEVYDDFLHY	EVYDDFLHY
LYIEFVKGYY	LYIEFVKGY
TVMDVKPVDY	TVMDKPVDY
GFKQSANLY	GFKQSANLY
TILSQPLMY	TILSQPLMY
FFEVPATTIY	FEVPATTIY
ANVVRNISY	ANVVRNISY
FTLPMMSTLY	FTLPMSTLY
YAFLMVDRY	YAFLMVDRY
KWKDQNIKDHY	KDQNIKDHY
KITYIDYY	-KITYIDYY
YMNNITYYF	YMNNITYYF
FTASLAMKY	FTASLAMKY
MTNPHNHLY	MTNPHNHLY
VAYGATRYNY	AYGATRYNY
ARDFILKLY	ARDFILKLY
KAKQDPSYY	KAKQDPSYY
YNMPITMAY	YNMPITMAY
TFYSWIPYH	TFYSWIPYH
YFKHGIDRY	YFKHGIDRY
LFHRQGFSY	LFHRQGFSY
FFSHFDGQDSY	SHFDGQDSY
SVVGALLLY	SVVGALLLY
EESRIKKLH	EESRIKKLH
GTLRSAFEY	GTLRSAFEY
YLAVVHAVY	YLAVVHAVY
GLYYGSFLY	GLYYGSFLY
VFAVSRLFY	VFAVSRLFY
RLLDDAQRLLY	LLDDQRLLY
YYSGLIYT	-YYSGLIYT
HIGKGVHLYY	HIGKVHLYY
HLSSLQLFY	HLSSLQLFY
RELEGKTGF	RELEGKTGF
FYPNIGGIIRY	PNIGGIIRY
ATLKDQLIY	ATLKDQLIY
LIWGKFVLY	LIWGKFVLY
RMYRDTFSY	RMYRDTFSY
RLNEIVLDY	RLNEIVLDY
SYSQHMNHRY	SYSQMNHRY
LYEYLGEEY	LYEYLGEEY
LAHEVGWKY	LAHEVGWKY
EVYEGALLY	EVYEGALLY
GYFIIGGSRY	YFIIGGSRY
HTFRDYLHY	HTFRDYLHY
HTSEKPYEY	HTSEKPYEY
FFKNVTGHY	FFKNVTGHY
YLEELSQRY	YLEELSQRY
GSRGSSLNDTY	RGSSLNDTY
SFSRKSSLQY	SFSRSSLQY
VVSRGLFYY	VVSRGLFYY
SLPDLTNLHY	SLPDTNLHY
ITKPQNLNDAY	KPQNLNDAY
YYGYGPGYDY	YGYGPGYDY
YVLEGKELEFY	YVLEKELEF
RMQEGSEVY	RMQEGSEVY
EEDSSGHTRAY	DSSGHTRAY
SELDLISRL	SELDLISRL
IFVGRALGY	IFVGRALGY
IFLRNRLKY	IFLRNRLKY
SYVDSHHEY	SYVDSHHEY
SEDEIKKAY	SEDEIKKAY
EFMKHFLLY	EFMKHFLLY
VMLGTQLLY	VMLGTQLLY
MAHHFRDAY	MAHHFRDAY
GYPSAISTTY	GYPSISTTY
YVVKNYFYY	YVVKNYFYY
SFNTLHMMY	SFNTLHMMY
PSTGIYYY	-PSTGIYYY
VISDIMALHF	VISDMALHF
TTAASAYSY	TTAASAYSY
QFWEKAIQY	QFWEKAIQY
RYVEFNLL	-RYVEFNLL
SFINRNYRY	SFINRNYRY
AILDTAHQY	AILDTAHQY
NFIPPIVARY	FIPPIVARY
VTGPVAQLY	VTGPVAQLY
TAVHAYRY	-TAVHAYRY
GTYFAVNANY	TYFAVNANY
RWTNMNALHY	WTNMNALHY
LSLPSSWDY	LSLPSSWDY
VAALQDLRY	VAALQDLRY
YYYGQGHPM	YYYGQGHPM
QIFRPDNFVF	IFRPDNFVF
YLFHIAGAY	YLFHIAGAY
LIYDFYYL	-LIYDFYYL
AFKAIGTAY	AFKAIGTAY
MLLEFAAMY	MLLEFAAMY
YAAAQLRQY	YAAAQLRQY
SIGMPSLMY	SIGMPSLMY
ITYHNGDKY	ITYHNGDKY
RLYQHAVEY	RLYQHAVEY
FIHAADMLY	FIHAADMLY
FETVLKEIF	FETVLKEIF
LIFYIENMQY	IFYIENMQY
NQFGISLLY	NQFGISLLY
GLPFLALIY	GLPFLALIY
SVLEAGFLY	SVLEAGFLY
STLEHGTSLKT	STLEHGTSL
TMIGEPMNF	TMIGEPMNF
HIYHSELEKY	IYHSELEKY
TYRLSPNEY	TYRLSPNEY
LMKEVMEHY	LMKEVMEHY
STVDVNLTY	STVDVNLTY
AQWLVYLYY	AQWLVYLYY
GLAPEHFHY	GLAPEHFHY
IYDSMPLRY	IYDSMPLRY
STFKETENTAY	TFKEENTAY
VFLSIKGIY	VFLSIKGIY
SVAVVNLQY	SVAVVNLQY
SFLHHAYRF	SFLHHAYRF
GQHSQGLGGHY	HSQGLGGHY
TWNAVLLRY	TWNAVLLRY
ASLDKELYY	ASLDKELYY
SMSVVQTLY	SMSVVQTLY
SLPDFGISY	SLPDFGISY
SATETCYTY	SATETCYTY
LLQIVYGNY	LLQIVYGNY
SLSPSLLGY	SLSPSLLGY
GTLSNPEVFNY	TLSNEVFNY
SFNHSSALY	SFNHSSALY
KVWAEAVHY	KVWAEAVHY
GHPSCTFLY	GHPSCTFLY
GNNKTVLKY	GNNKTVLKY
RQFDLAWQY	RQFDLAWQY
FELVNQLQY	FELVNQLQY
AWSREFLKY	AWSREFLKY
SLNDEYFYY	SLNDEYFYY
KEIKDILIQY	EIKDILIQY
SATYIAEEY	SATYIAEEY
WIGDKSFEY	WIGDKSFEY
GWKTTREYY	GWKTTREYY
YFRDQKDGY	YFRDQKDGY
QFHAFGLRY	QFHAFGLRY
IYHHVTGRY	IYHHVTGRY
FYKISTLYY	FYKISTLYY
GIFRNIAQHY	IFRNIAQHY
FTVTKYWFY	FTVTKYWFY
HLGVFPSYY	HLGVFPSYY
VFQADLEHMA	VFQADLEHM
YVFDGTNPPY	YVFDTNPPY
QFFHLVNSEM	FFHLVNSEM
SFFGAASQY	SFFGAASQY
RYPDIQASY	RYPDIQASY
ALEKIDLKF	ALEKIDLKF
TMDVHSRY	-TMDVHSRY
FFTRLGQIY	FFTRLGQIY
RVVDTFQYY	RVVDTFQYY
SNAKLALFY	SNAKLALFY
YFKDKEPLTAY	KDKEPLTAY
NYFHLAVAF	NYFHLAVAF
IMAPGLLH	-IMAPGLLH
FLDLVNYVY	FLDLVNYVY
SYVSIHSSGF	YVSIHSSGF
FLELMQLKY	FLELMQLKY
GYHGGHSSGGY	HGGHSSGGY
HGLPEQFLY	HGLPEQFLY
YLLPAIVHI	YLLPAIVHI
YFVTGNHEY	YFVTGNHEY
IFIDKIYSIY	FIDKIYSIY
FYQGAAFPF	FYQGAAFPF
QLDEETQY	-QLDEETQY
FSYGVTEMY	FSYGVTEMY
FFLAETVKY	FFLAETVKY
SFYLPIAAAMY	FYLPAAAMY
SFDLLPREF	SFDLLPREF
MFMKPGTLYVY	MFMKPGTLY
VASCGRLY	-VASCGRLY
YYSNKAYQY	YYSNKAYQY
GSWHEALLY	GSWHEALLY
LYFFIAGRY	LYFFIAGRY
LLLGLHASY	LLLGLHASY
GSYQRGYEY	GSYQRGYEY
LLHGSALLY	LLHGSALLY
STSGRPFLLY	STSGPFLLY
HSFGLPLLY	HSFGLPLLY
NLARFVFTY	NLARFVFTY
HILNPAFLY	HILNPAFLY
MYEHFKGYEY	YEHFKGYEY
GTNHTHLLY	GTNHTHLLY
LYQDTHQEY	LYQDTHQEY
GLLNLSLLY	GLLNLSLLY
NSATAVAQLY	SATAVAQLY
SFFSAALEY	SFFSAALEY
CTIQTAFRQY	TIQTAFRQY
YADPVNAHY	YADPVNAHY
TMLAYSLTY	TMLAYSLTY
GISQILGQF	GISQILGQF
VLKGDQLYY	VLKGDQLYY
EYPPFSHRY	EYPPFSHRY
GVLLQQHMY	GVLLQQHMY
MNFRVHLQY	MNFRVHLQY
YSHFQHLLY	YSHFQHLLY
TPIKDGILY	TPIKDGILY
EEVEAKFKRY	EVEAKFKRY
IFSTVHGLY	IFSTVHGLY
LTWGGHWLY	LTWGGHWLY
LYASSPGGVY	YASSPGGVY
STANAGLLY	STANAGLLY
YYQYMETYM	YYQYMETYM
VFMVWYEFC	VFMVWYEFC
WIESQDWAY	WIESQDWAY
FIMPEKFEF	FIMPEKFEF
LLDEKTSKLY	LLDETSKLY
VFKKFNWRY	VFKKFNWRY
VLGNFSFGY	VLGNFSFGY
STWGGALRY	STWGGALRY
HTVGLIVQY	HTVGLIVQY
LVNGFQLLY	LVNGFQLLY
KVLQAMLHY	KVLQAMLHY
YVHNKLLLY	YVHNKLLLY
STTTGHLIY	STTTGHLIY
SFRDHTFLY	SFRDHTFLY
QVENQVQGIY	VENQVQGIY
HWEVVTHGY	HWEVVTHGY
ILLDLNISY	ILLDLNISY
KFVETHPEF	KFVETHPEF
YLYQNSALEF	LYQNSALEF
IPFYMGFIP	IPFYMGFIP
KFYHLAKETGY	YHLAKETGY
VAYFQRGMLY	AYFQRGMLY
SYYRTIKGF	SYYRTIKGF
FILDVITYY	FILDVITYY
LFSSSLQPY	LFSSSLQPY
KVVKLLLRY	KVVKLLLRY
LFLWGQALY	LFLWGQALY
ALFMPPTYY	ALFMPPTYY
RVASVMQEY	RVASVMQEY
RQEKPLALY	RQEKPLALY
EEVDSSVKKI	EVDSSVKKI
VSNPKSFEY	VSNPKSFEY
KIKDDVEYY	KIKDDVEYY
SLLRGIYAY	SLLRGIYAY
SYQDAAFTY	SYQDAAFTY
LVFHLPVNY	LVFHLPVNY
STASLAFPY	STASLAFPY
GYVPEHWEY	GYVPEHWEY
TENDIYNFF	TENDIYNFF
ILMTSFLQY	ILMTSFLQY
YNHPKPNLLY	YNHPPNLLY
IGLAMRLYY	IGLAMRLYY
GLAQIFMQY	GLAQIFMQY
KYFDSGDYNM	YFDSGDYNM
HPIDLHLLF	HPIDLHLLF
NNLTTGKIYQY	LTTGKIYQY
FYQKEHWNY	FYQKEHWNY
YISDTLGQVY	YISDLGQVY
SVMHEALHNHY	VMHELHNHY
RRKDGVFLY	RRKDGVFLY
YVSDINSVY	YVSDINSVY
VFLREHLNY	VFLREHLNY
GSYAALHGEFY	SYAAHGEFY
AFYEHAQTYYY	AFYEHAQTY
ECGKAFHHFSY	GKAFHHFSY
NLDQPDLYY	NLDQPDLYY
HTTSISDLEF	TTSISDLEF
KTLTIFMEY	KTLTIFMEY
YGPAELGLVY	GPAELGLVY
QAMEAMLLY	QAMEAMLLY
FLPQNFLVY	FLPQNFLVY
HYSRRISQAY	YSRRISQAY
SFIDSKFYS	SFIDSKFYS
SAVAVALMY	SAVAVALMY
YIVSQIAVAY	IVSQIAVAY
QMYDDYYYY	QMYDDYYYY
AFHMEQLKY	AFHMEQLKY
WYEKLINMTY	YEKLINMTY
ILYFIPLRY	ILYFIPLRY
EEVQRKLGF	EEVQRKLGF
FFMTPPRLHY	FMTPPRLHY
KVQYECATGY	VQYECATGY
YVLAAANLY	YVLAAANLY
STYQGERAY	STYQGERAY
YVLYASALY	YVLYASALY
GFSMEQAQAY	FSMEQAQAY
AGLQFPVGR	AGLQFPVGR
TFLKRTYEY	TFLKRTYEY
HVLVAHFHY	HVLVAHFHY
SAYGSSYTY	SAYGSSYTY
SLNAEALQY	SLNAEALQY
GYRAPSRQDVY	RAPSRQDVY
TLFGNNKLTTF	LFGNKLTTF
LFLHIGRGLYY	LFLHGRGLY
HFARFVAMKY	HFARVAMKY
HVDLGAYYY	HVDLGAYYY
VATAQGRYY	VATAQGRYY
YNFLNQKMNY	NFLNQKMNY
YIPLKVALFY	IPLKVALFY
FASGANFEY	FASGANFEY
FLTQALNHMY	LTQALNHMY
KVADWTGATY	KVADTGATY
VFHDRRLQY	VFHDRRLQY
RSRGFAFVY	RSRGFAFVY
KMIHILLYY	KMIHILLYY
VLLQKVLLY	VLLQKVLLY
VVVPSGEEQRY	VVPSEEQRY
VEELFERKY	VEELFERKY
TVSDQALLF	TVSDQALLF
FLSPAQYLY	FLSPAQYLY
FFRGATELY	FFRGATELY
GVNPRVNHLY	GVNPVNHLY
RIQDLSLLY	RIQDLSLLY
HLHGKTFD	-HLHGKTFD
HLYGSLLYY	HLYGSLLYY
AEEKQTKSF	AEEKQTKSF
LYPTPLPQY	LYPTPLPQY
IMINPLEYKY	MINPLEYKY
STYGNPGSQGY	YGNPGSQGY
TVIPRVYTY	TVIPRVYTY
HNMKLSISY	HNMKLSISY
AFEHIVTQF	AFEHIVTQF
HIYDYPHKY	HIYDYPHKY
NFQNVKQLY	NFQNVKQLY
FILGSQLTY	FILGSQLTY
KLLDVLQQY	KLLDVLQQY
MTAKLQTPY	MTAKLQTPY
LFHISRLFY	LFHISRLFY
MTTLYTAKKY	TTLYTAKKY
AEAKKIERL	AEAKKIERL
FFIHRRLLY	FFIHRRLLY
RPFGVSLLY	RPFGVSLLY
HAYNQPEDLVY	AYNQEDLVY
FFKGFKWGF	FFKGFKWGF
GAYPTQPGQGY	AYPTPGQGY
SYLNQSYGM	SYLNQSYGM
RIKETKEVY	RIKETKEVY
SFTSVRSGY	SFTSVRSGY
SLDKFLANV	SLDKFLANV
TISFLSYLF	TISFLSYLF
DKHIEEVR	-DKHIEEVR
RLLSLVLVY	RLLSLVLVY
RVFEGPYKEY	VFEGPYKEY
YYDTDPFLFY	YYDTPFLFY
TYRMPVMEY	TYRMPVMEY
STSDVVRQY	STSDVVRQY
LVDRYNLYY	LVDRYNLYY
RYPNIELSY	RYPNIELSY
AIIYNNNED	AIIYNNNED
HVRPVTQGDVY	RPVTQGDVY
SLPWVHLAY	SLPWVHLAY
NYAAMVFHY	NYAAMVFHY
SFLKVAGMQY	SFLKAGMQY
YFHDRVASFY	YFHDVASFY
AGLDSFYEY	AGLDSFYEY
QVLDAMNYVLY	VLDANYVLY
SYYEKHSLY	SYYEKHSLY
STLPDYLLY	STLPDYLLY
MSYGDSLYY	MSYGDSLYY
HEIYTVGKRF	EIYTVGKRF
TAIREVYQY	TAIREVYQY
YFISHVLAF	YFISHVLAF
YFISHILAF	YFISHILAF
RTMVKTLEY	RTMVKTLEY
YLPLTTARY	YLPLTTARY
VVLKTGFDF	VVLKTGFDF
YVPGLLLSY	YVPGLLLSY
IQNNIALKY	IQNNIALKY
IVAAIQHNY	IVAAIQHNY
AYIHLVADY	AYIHLVADY
TTTGVHNLY	TTTGVHNLY
QFKSILLKY	QFKSILLKY
YYVEGVHQQY	YVEGVHQQY
GVSDSHRVY	GVSDSHRVY
ALHSLELHY	ALHSLELHY
VFIVNSEDYMY	IVNSEDYMY
HFQSLLWTY	HFQSLLWTY
ATYDKGYQF	ATYDKGYQF
TTLSDSYNY	TTLSDSYNY
SLYRGDIARY	SLYRDIARY
GSFHIRASY	GSFHIRASY
NWQNVRALY	NWQNVRALY
EEIHATGFNY	EIHATGFNY
SLHNPYNLYGY	SLHNPYNLY
MAFKLGLSY	MAFKLGLSY
LLPTIAFGSL	LLPTIAFGS
AVLAGRWNY	AVLAGRWNY
NYYDQGYGNY	YYDQGYGNY
GYYGYGPGYDY	GYYGYGPGY
LWFHSNFLY	LWFHSNFLY
VEIIANDQGNR	IIANDQGNR
ASLSRPLNY	ASLSRPLNY
SMIGMTFAY	SMIGMTFAY
FYGKQGIQFY	FYGKGIQFY
NFKAWTARY	NFKAWTARY
GSHFVEATY	GSHFVEATY
IFAKIINLY	IFAKIINLY
LMLPEKLRPLY	MLPELRPLY
GEVEQQRTY	GEVEQQRTY
MVLSATHRY	MVLSATHRY
MVASMRLAY	MVASMRLAY
EDTEEHHLR	EDTEEHHLR
FTSMTRLYY	FTSMTRLYY
YFLRPMLQY	YFLRPMLQY
IVRIGEKY	-IVRIGEKY
EITSEAPFLHY	ITSEPFLHY
SVISLQASY	SVISLQASY
LFVHGHFYY	LFVHGHFYY
TWIEDHFPY	TWIEDHFPY
QTNDVLLTF	QTNDVLLTF
FAYHMIETY	FAYHMIETY
NFESGKHKY	NFESGKHKY
NYGMQPLMY	NYGMQPLMY
AEIVEGENHTY	IVEGENHTY
LFYLQNHRY	LFYLQNHRY
VFTFIPGVLY	FTFIPGVLY
VLLRVRMLY	VLLRVRMLY
YMANLATETLF	ANLATETLF
RFLESNHIYTY	RFLESNHIY
QTYPQPSYNQY	TYPQSYNQY
RWNPLPLSY	RWNPLPLSY
GFFEPGTWMRY	FFEPTWMRY
SVGHFELRY	SVGHFELRY
FFQATDLPY	FFQATDLPY
SLASVLAQY	SLASVLAQY
GFKEQIYDVY	GFKEIYDVY
FMPHVTEAY	FMPHVTEAY
VFLATNSDYKY	VFLATNSDY
IMNADILAY	IMNADILAY
HSTSAMSLLY	STSAMSLLY
HTYGGSFLY	HTYGGSFLY
KTNPEVHNY	KTNPEVHNY
NNMSKFFQY	NNMSKFFQY
LLNDILLTY	LLNDILLTY
YYDTHTNTYY	YYDTHTNTY
SEAGSHTLQW	SEAGHTLQW
SQDPSGDSKLY	DPSGDSKLY
ISAEEALQHPY	AEEALQHPY
VVAQPVHMQ	VVAQPVHMQ
YTAPGHHGY	YTAPGHHGY
HYMSINDSFY	YMSINDSFY
KIIEPDNSY	KIIEPDNSY
VYDDGKYVY	VYDDGKYVY
ALLSHFLQF	ALLSHFLQF
GNYNDFGNY	GNYNDFGNY
TISPIILYF	TISPIILYF
YSPSIGFSY	YSPSIGFSY
NAIKESYDY	NAIKESYDY
VYIEHRLMM	VYIEHRLMM
ILSSLEPLHR	ILSSEPLHR
FILASFLTY	FILASFLTY
NYSNLVSVGY	NYSNVSVGY
AVWDTCLEY	AVWDTCLEY
GAAEKVFSY	GAAEKVFSY
HYGQQGQGY	HYGQQGQGY
LVPDLWIRY	LVPDLWIRY
YFPTQALNF	YFPTQALNF
AFTHASYHY	AFTHASYHY
NELVSTHGY	NELVSTHGY
QVLQHSVDVTE	QVLQHSVDV
YHADINLLY	YHADINLLY
SIHLQLSSF	SIHLQLSSF
NLFQEAEEFLY	LFQEEEFLY
TASAVIGLLY	ASAVIGLLY
MYMEFPQLY	MYMEFPQLY
IMYSIQAQY	IMYSIQAQY
HFWTVAAHY	HFWTVAAHY
AEASHVSRY	AEASHVSRY
ATPSVYLLY	ATPSVYLLY
KDDLWPNPLQY	DLWPNPLQY
NVFFPHFKY	NVFFPHFKY
PDFCWLSIY	PDFCWLSIY
AASFINLLY	AASFINLLY
TGYGGYEEY	TGYGGYEEY
CEDRNLPYVY	EDRNLPYVY
AFLPVHCRY	AFLPVHCRY
YWHDPIKEDVY	HDPIKEDVY
TLADIICEY	TLADIICEY
SFHLIRLLY	SFHLIRLLY
FIKHMENEY	FIKHMENEY
SVHGFQMLY	SVHGFQMLY
IAFSDPLSY	IAFSDPLSY
VTTSTRTY	-VTTSTRTY
DELRNLHKLLY	ELRNHKLLY
ALLDTTQKY	ALLDTTQKY
HILGAAYKY	HILGAAYKY
FFDAAKLMF	FFDAAKLMF
IAYGVIELY	IAYGVIELY
VITFPRAY	-VITFPRAY
NKTQTILFY	NKTQTILFY
TELLIRKLPF	ELLIRKLPF
TFSEELAQLY	TFSELAQLY
STTAVSARY	STTAVSARY
NVDPVQHTY	NVDPVQHTY
YANAKGIGY	YANAKGIGY
MLPDFKLYY	MLPDFKLYY
FFLAETLKY	FFLAETLKY
EENPIVLEF	EENPIVLEF
ATMEDTVEY	ATMEDTVEY
YVFSEFNRY	YVFSEFNRY
TSLELVKGTY	SLELVKGTY
IADRFLLY	-IADRFLLY
YWDRETQKY	YWDRETQKY
LLANINAFY	LLANINAFY
IFPLIYSEM	IFPLIYSEM
RNLGSILAY	RNLGSILAY
KETEIVKKL	KETEIVKKL
NWSKILLHY	NWSKILLHY
IMYKVFLKY	IMYKVFLKY
KLLQSHNLY	KLLQSHNLY
FIERSNLVY	FIERSNLVY
QYSDQGIDY	QYSDQGIDY
YFEVTRSSSY	FEVTRSSSY
TVMKFVPRY	TVMKFVPRY
RTLETFLTY	RTLETFLTY
SFLAPLVTEY	FLAPLVTEY
MFTPLTVKY	MFTPLTVKY
GSHSMRYFT	GSHSMRYFT
YVFKMVNNY	YVFKMVNNY
YFNFGNQLY	YFNFGNQLY
QLNDIHQQY	QLNDIHQQY
LNNSLLLHY	LNNSLLLHY
YGQPQPGFGY	GQPQPGFGY
GSHGAFYRY	GSHGAFYRY
LISRQMIQQY	LISRMIQQY
NVCGKAFSY	NVCGKAFSY
FSLPSSWDY	FSLPSSWDY
SAAGPGFSLKF	AAGPFSLKF
SYTGQSQLY	SYTGQSQLY
LSEHNLKY	-LSEHNLKY
VAVCQPLHY	VAVCQPLHY
SLYDGFLSY	SLYDGFLSY
SSMSAQLLY	SSMSAQLLY
YGGYNNYGY	YGGYNNYGY
RVFREVEMLY	VFREVEMLY
HNYHHSFPY	HNYHHSFPY
YYPPSIGFPY	YYPPIGFPY
KVLDKVVQY	KVLDKVVQY
LASIIKINY	LASIIKINY
LYPGYNFRY	LYPGYNFRY
TVMDLLLEY	TVMDLLLEY
KMHVLHLEY	KMHVLHLEY
APDIRKFSY	APDIRKFSY
KASDTAMYY	KASDTAMYY
HIMEIFSTY	HIMEIFSTY
RLASLMNLGM	RLASMNLGM
AYLESFYKF	AYLESFYKF
SFVQLRADY	SFVQLRADY
SFNRPNLYY	SFNRPNLYY
IYVTGGYSY	IYVTGGYSY
ATLNVSTTRY	ATLNSTTRY
GTTTLAFKF	GTTTLAFKF
LFKNTLEMY	LFKNTLEMY
HVSNVTVNY	HVSNVTVNY
FYSDESLQY	FYSDESLQY
LFDSRHLLY	LFDSRHLLY
RNRGYNLIY	RNRGYNLIY
GSHSMRYFTT	GSHSMRYFT
QLKETVEKY	QLKETVEKY
ATATYMFHL	ATATYMFHL
LLYYYDIY	-LLYYYDIY
RLLSLPLEY	RLLSLPLEY
SASSLARAY	SASSLARAY
FFWNSKSTY	FFWNSKSTY
VVLTDPEAAKY	VLTDEAAKY
ATTALYFTY	ATTALYFTY
SVSDVLLNF	SVSDVLLNF
GVAALHGLLY	GVAAHGLLY
HTHSNTYNF	HTHSNTYNF
DWYPNHHTY	DWYPNHHTY
AFQRLNFLY	AFQRLNFLY
LLFDQAYLM	LLFDQAYLM
YFYVIGSSY	YFYVIGSSY
WYTRFALKY	WYTRFALKY
YYDPTTGLYY	YYDPTGLYY
HTAAMVQQY	HTAAMVQQY
RPLPARLFY	RPLPARLFY
RVYNNTLTY	RVYNNTLTY
FLSPQVFVY	FLSPQVFVY
HNGMNQQAYAY	GMNQQAYAY
LVQENYLEY	LVQENYLEY
QTLDHNFEY	QTLDHNFEY
SFMDTMLQM	SFMDTMLQM
QVYGNPQQY	QVYGNPQQY
IREEYPDR	-IREEYPDR
HAGGVAEY	-HAGGVAEY
YPYQGKDGY	YPYQGKDGY
RTNNIELHY	RTNNIELHY
FSAVLYPHE	FSAVLYPHE
LYYDPNSQYYY	YYDPNSQYY
LSRLGLRY	-LSRLGLRY
YVDDTLFVRF	YVDDLFVRF
SISPALLSY	SISPALLSY
FLLPLSLIF	FLLPLSLIF
NYPPPNPGY	NYPPPNPGY
KLFGSTFAF	KLFGSTFAF
LFLERAYYY	LFLERAYYY
RPPGFSPFR	RPPGFSPFR
ACPGYLHCNEY	PGYLHCNEY
MFFGREVDAEY	FFGRVDAEY
YNSAMNPLIY	YNSANPLIY
YIPRFVYEY	YIPRFVYEY
SLYIANHAY	SLYIANHAY
RLMELHFKY	RLMELHFKY
PAHYETLRY	PAHYETLRY
SFPPQRYHY	SFPPQRYHY
ISMLDTLLY	ISMLDTLLY
LYSYVISKP	LYSYVISKP
SEHAVNKQL	SEHAVNKQL
KISSIHIRY	KISSIHIRY
KTAEAQLAY	KTAEAQLAY
STNPNSHGF	STNPNSHGF
VVGSELIQKY	VVGSLIQKY
NTIYYNLLY	NTIYYNLLY
AVMSHTLIY	AVMSHTLIY
ELDLFLAYY	ELDLFLAYY
SFSNTASLKY	SFSNASLKY
NFTIPDNSRY	FTIPDNSRY
KLLGSKLFY	KLLGSKLFY
IFSDIHLLA	IFSDIHLLA
KLMENILLY	KLMENILLY
TLGAAFVYL	TLGAAFVYL
FINPETPGY	FINPETPGY
YTQAQTTATY	TQAQTTATY
YAMKPIDYY	YAMKPIDYY
QILANSWRY	QILANSWRY
VVLNVYDMY	VVLNVYDMY
TTAAQTLLY	TTAAQTLLY
AYPEIVAVY	AYPEIVAVY
KVARVKALY	KVARVKALY
YYASLGTALY	YYASGTALY
FFLAAKELY	FFLAAKELY
IHLRNFYII	IHLRNFYII
IYGNTALHY	IYGNTALHY
AEQELANLEKW	AEQELANLE
GLTHQGLLY	GLTHQGLLY
VIHEKGFYY	VIHEKGFYY
AVNGLGWYY	AVNGLGWYY
GVNDKMAEY	GVNDKMAEY
MVPAISLAY	MVPAISLAY
IPSYSELIY	IPSYSELIY
SYSPTSPSY	SYSPTSPSY
AIFPSPMMY	AIFPSPMMY
LFSSSNFIY	LFSSSNFIY
YYPLVAQHY	YYPLVAQHY
SFHDGLLLY	SFHDGLLLY
VYSDLHAFY	VYSDLHAFY
HFSHGEYFY	HFSHGEYFY
TMYGQMTAGSY	MYGQTAGSY
FYDDREFIY	FYDDREFIY
AVARGFFNY	AVARGFFNY
HIYHGRNLDY	IYHGRNLDY
SIYEASSLY	SIYEASSLY
NVTGIVQVY	NVTGIVQVY
GFYADPYLY	GFYADPYLY
YYAAASHSY	YYAAASHSY
MSMVANLLY	MSMVANLLY
GSYNDFGNY	GSYNDFGNY
FFVKWQGMSY	FVKWQGMSY
SLSRLGLRY	SLSRLGLRY
FYEHAQTYY	FYEHAQTYY
YNHGQGSYSY	YNHGGSYSY
EEARRLLGY	EEARRLLGY
YITRMAQKY	YITRMAQKY
HYYGTGETFLY	YYGTETFLY
LFSFFPMRY	LFSFFPMRY
ALCDIKQAY	ALCDIKQAY
YYFEGIKQTF	YFEGIKQTF
VLMPKVMHY	VLMPKVMHY
FAEHNDLQY	FAEHNDLQY
KGSFPDIIIY	GSFPDIIIY
YFKRQGFSY	YFKRQGFSY
YADYHTHFLY	ADYHTHFLY
FTLDINTAY	FTLDINTAY
SYNAVGFTY	SYNAVGFTY
IFNKTSHGY	IFNKTSHGY
PPLPVRVFS	PPLPVRVFS
SSVGTQHSY	SSVGTQHSY
FFDDNGYPY	FFDDNGYPY
TWADVEARY	TWADVEARY
STNRENFHY	STNRENFHY
TYMAMYLTY	TYMAMYLTY
RALQFYLDY	RALQFYLDY
YFLEERMQQKY	FLEEMQQKY
ATDYHFHFY	ATDYHFHFY
YLFHQHQLY	YLFHQHQLY
YQHNTPLHY	YQHNTPLHY
LAKKIFLKY	LAKKIFLKY
LSLGVAALY	LSLGVAALY
VVTFPRAY	-VVTFPRAY
LYRYPGGESY	YRYPGGESY
QQNDQQLVY	QQNDQQLVY
YLDEGRLRY	YLDEGRLRY
CMVGSVIVY	CMVGSVIVY
STAGASGGAY	STAGSGGAY
VFYDGNPKY	VFYDGNPKY
GAVPTELALLY	AVPTLALLY
YNAQPSASY	YNAQPSASY
FNHVAVAARY	NHVAVAARY
IFFENHPYF	IFFENHPYF
LSRKNTDLY	LSRKNTDLY
GNLDRAYEF	GNLDRAYEF
IFYFSVEDN	IFYFSVEDN
FVLKANYEY	FVLKANYEY
NTSRYAAALY	NTSRAAALY
HTMSSSHLFY	TMSSSHLFY
HYLEDVGSFEY	YLEDGSFEY
MIHSGDPVNY	IHSGDPVNY
AMGGAMVLLY	AMGGMVLLY
MESLELLYL	MESLELLYL
VMYNSSDHDVY	YNSSDHDVY
YNLHPGVTDY	NLHPGVTDY
AFKKTFSY	-AFKKTFSY
RHRNPPLHY	RHRNPPLHY
TATHFPRVY	TATHFPRVY
SVMRLTISY	SVMRLTISY
TALGSFYLY	TALGSFYLY
IYIRLLGAY	IYIRLLGAY
HFSKTMLLFF	HFSKTMLLF
PKKLLTQY	-PKKLLTQY
RYHSLAPMYY	RYHSLAPMY
FLNDQAMLY	FLNDQAMLY
SMFHNRHLF	SMFHNRHLF
MYHYLQFAYY	MYHYLQFAY
LVHFLLLKY	LVHFLLLKY
YVFPKPFNR	YVFPKPFNR
NVLEHFHKY	NVLEHFHKY
FFKPTPKRY	FFKPTPKRY
NLTRVLALY	NLTRVLALY
GNLADQLYY	GNLADQLYY
QLLETVHRY	QLLETVHRY
YLEKFQNLTY	YLEKQNLTY
NEDEIKKAY	NEDEIKKAY
FYDAAKLKY	FYDAAKLKY
TYLRIKKNEY	TYLRKKNEY
QNSPSTFHY	QNSPSTFHY
KLYTKHGTLKY	YTKHGTLKY
GEASRLAHY	GEASRLAHY
LLLTDQHLY	LLLTDQHLY
TLNERFTSY	TLNERFTSY
GLMDMKIFY	GLMDMKIFY
STLDRFIPY	STLDRFIPY
TYKFLPLMY	TYKFLPLMY
FECTHYQSF	FECTHYQSF
VYLADYGLSY	YLADYGLSY
YSQHMNHRY	YSQHMNHRY
SFVALVDGY	SFVALVDGY
MMEAFATRY	MMEAFATRY
YTDENQHQY	YTDENQHQY
VVDLFRAYD	VVDLFRAYD
IFWRLLTKY	IFWRLLTKY
AVAAGEFLY	AVAAGEFLY
EFRNLAEKY	EFRNLAEKY
LILSKRLWY	LILSKRLWY
AVAEPVVSY	AVAEPVVSY
TTTGQVLLY	TTTGQVLLY
TWMGSPSIFVY	MGSPSIFVY
YVKTFNMDEY	YVKTNMDEY
MFYDGNHTY	MFYDGNHTY
TYYYVGFAY	TYYYVGFAY
PQLVQLVLY	PQLVQLVLY
GSNPFTGFFY	SNPFTGFFY
QLNAGVFEY	QLNAGVFEY
HAIRNSFQY	HAIRNSFQY
NNAAVCLLY	NNAAVCLLY
HFSSTTGLFY	FSSTTGLFY
KLTELTQLY	KLTELTQLY
TAFGHPQAY	TAFGHPQAY
VNESQLFLY	VNESQLFLY
SWMHHWLLF	SWMHHWLLF
FLNKASAVY	FLNKASAVY
KIYDREQTRY	IYDREQTRY
NAPWAVTSL	NAPWAVTSL
WTHDGKGMFY	WTHDKGMFY
FLSGDNQHY	FLSGDNQHY
VYIGSTLSY	VYIGSTLSY
AMNGEGYLY	AMNGEGYLY
YNYPVIQNY	YNYPVIQNY
LFLGRKGY	-LFLGRKGY
SVKHDDVYF	SVKHDDVYF
PHPHIHEY	-PHPHIHEY
AESIVVHTY	AESIVVHTY
QVHPDTGISSK	QVHPTGISS
GASGLLALY	GASGLLALY
MSSYFVNPLYS	SSYFVNPLY
SALTLQFMY	SALTLQFMY
YYPYTITEY	YYPYTITEY
NPHVNHLY	-NPHVNHLY
HQAPRQLFY	HQAPRQLFY
IFSMVGLYY	IFSMVGLYY
ILKHGAKDKDD	ILKHAKDKD
NFYGANGMMNY	YGANGMMNY
IIIGKSYDY	IIIGKSYDY
LSYTEQYLEY	SYTEQYLEY
TYLSIHQVY	TYLSIHQVY
GLSKIRLNY	GLSKIRLNY
TMCPHILRY	TMCPHILRY
QISRQMIQQY	QISRMIQQY
VKDRSQGTMY	KDRSQGTMY
KEIGDVENW	KEIGDVENW
IFTDLSSRF	IFTDLSSRF
AQTLRHYGY	AQTLRHYGY
VLCSTLANIY	VLCSLANIY
VLGKGHQY	-VLGKGHQY
IYAAMMIMEY	YAAMMIMEY
HSINITRVY	HSINITRVY
LYYQIDSHI	LYYQIDSHI
LYMHFSHSY	LYMHFSHSY
RLFKDQLVY	RLFKDQLVY
KLERLQELY	KLERLQELY
SSSGVSPLY	SSSGVSPLY
HIKVTQEQY	HIKVTQEQY
RMSNLTVHY	RMSNLTVHY
NQALQVFYI	NQALQVFYI
HLPFVGFTY	HLPFVGFTY
FDKSDLAKY	FDKSDLAKY
PSVISHLF	-PSVISHLF
RASPFLLQY	RASPFLLQY
TFINDFFTY	TFINDFFTY
VYVYPNSFFRY	VYPNSFFRY
RFTSMTRLYY	FTSMTRLYY
EHETQQYEY	EHETQQYEY
GLLGSPYYY	GLLGSPYYY
FFKDIEEQY	FFKDIEEQY
NISQMNLSY	NISQMNLSY
YDIAQVNLKY	DIAQVNLKY
YFVTFPYPY	YFVTFPYPY
QFIQSPLSY	QFIQSPLSY
ILGAAYKY	-ILGAAYKY
KTLYFHIYY	KTLYFHIYY
ALMGEHIHY	ALMGEHIHY
GMNQQAYAY	GMNQQAYAY
FFIDQANYF	FFIDQANYF
VLAEVAQHY	VLAEVAQHY
LFLHIGRGLY	LFLHGRGLY
RFPNFSILY	RFPNFSILY
LLLWLLSY	-LLLWLLSY
FFYHPETQQY	FYHPETQQY
HAYPYPQMY	HAYPYPQMY
VLLDSSLEY	VLLDSSLEY
WSYPYEHSY	WSYPYEHSY
HVIDVKFLY	HVIDVKFLY
LMIHGAWNY	LMIHGAWNY
AQLTGVLLY	AQLTGVLLY
KLPPFSYAY	KLPPFSYAY
NLFQEAEEF	NLFQEAEEF
GGYGGYDDY	GGYGGYDDY
SFTTVWLIY	SFTTVWLIY
YILSHVAKY	YILSHVAKY
NYWNQGYGY	NYWNQGYGY
FINPKPITY	FINPKPITY
LVAAQSYLY	LVAAQSYLY
TGLHTFLLY	TGLHTFLLY
FNLDKTLYF	FNLDKTLYF
EEGPDVLRW	EEGPDVLRW
YFYDPDVGNFH	YFYDDVGNF
FLTDSYLKY	FLTDSYLKY
RFDLRPFLY	RFDLRPFLY
YFNNMRMKY	YFNNMRMKY
GNYGGGPGY	GNYGGGPGY
SYFKGGLKY	SYFKGGLKY
TVCDFRLSY	TVCDFRLSY
QVINSAAKTYY	VINSAAKTY
SLLGYRAVY	SLLGYRAVY
IENAHVLLY	IENAHVLLY
TFVPMLHRF	TFVPMLHRF
GTYRSSFAY	GTYRSSFAY
LVDQHHWRY	LVDQHHWRY
KVANVSLLALY	ANVSLLALY
RLLQEQLRY	RLLQEQLRY
RLKDGVLAY	RLKDGVLAY
RYLEMLLEY	RYLEMLLEY
AIYGRGIAY	AIYGRGIAY
TNSELALMY	TNSELALMY
VYKSPASDTY	VYKSASDTY
SYYGEQTLHY	YYGEQTLHY
YGIPFYLQY	YGIPFYLQY
NNLPNLLEY	NNLPNLLEY
SFQSFNTSY	SFQSFNTSY
AVVEKALTY	AVVEKALTY
LQMQLILHY	LQMQLILHY
AYHAVVLSY	AYHAVVLSY
HFHYLINSYF	HFHYLINSY
FIKPIFTDESY	KPIFTDESY
FVADVKNLY	FVADVKNLY
AFDVLVLRY	AFDVLVLRY
RILKARLEY	RILKARLEY
GYNQRPPYGY	YNQRPPYGY
QESNVRLKL	QESNVRLKL
YNYTDMDGNL	NYTDMDGNL
YYYDTHTNTYY	YYDTHTNTY
YFELVQHEY	YFELVQHEY
FVGHMDYKY	FVGHMDYKY
HVNGIVQKY	HVNGIVQKY
QVLDLFMLY	QVLDLFMLY
NMYKGGQYY	NMYKGGQYY
IAQKILALY	IAQKILALY
GFIMINPLEY	FIMINPLEY
GEVNDIKTRSW	EVNDIKTRS
FVATAAAVHY	FVATAAVHY
LWEDLILY	-LWEDLILY
GYNHGQGSY	GYNHGQGSY
QVLEHQVKY	QVLEHQVKY
AVLAPLIALVY	VLAPIALVY
RIKAIQLEY	RIKAIQLEY
TAAAPMIGY	TAAAPMIGY
QAGKILLYY	QAGKILLYY
FFYNLIHPEY	FFYNIHPEY
VQTDINLPY	VQTDINLPY
VFANILLY	-VFANILLY
ALESLNLYY	ALESLNLYY
QMLQTRFPLDY	LQTRFPLDY
FINSKCAKY	FINSKCAKY
DALGHFFQY	DALGHFFQY
STSKVTVLGY	STSKTVLGY
LLSQVQFLY	LLSQVQFLY
KGVNIGGAGSY	VNIGGAGSY
QLAQQLLHY	QLAQQLLHY
TAADTAVYY	TAADTAVYY
VFRAFLRTEY	VFRALRTEY
TVAIVKALY	TVAIVKALY
GLMTLQALY	GLMTLQALY
VFEHVNNTDF	VFEHNNTDF
MPFPAHLTY	MPFPAHLTY
KNSREFLYY	KNSREFLYY
LYYDPSTGIYY	YYDPTGIYY
AVSNSFLAY	AVSNSFLAY
KVKLAVLKY	KVKLAVLKY
WVRGRHETY	WVRGRHETY
DESDINTFIY	DESDNTFIY
RYGRFNLNDP	RYGRFNLND
TTLYIVMEY	TTLYIVMEY
HATTHNAY	-HATTHNAY
RLSESQLSF	RLSESQLSF
WTPGAIGLY	WTPGAIGLY
AQAAQQLQY	AQAAQQLQY
TTFTATRPGVY	FTATRPGVY
IYEHITLAY	IYEHITLAY
SFGELALMY	SFGELALMY
LAINHAYFY	LAINHAYFY
RVTQEFLEY	RVTQEFLEY
KVLGTEELYGY	KVLGTEELY
SVTHIVPLF	SVTHIVPLF
KLLELHVNY	KLLELHVNY
SFGQMLLKY	SFGQMLLKY
LLPKMKPLLY	LLPKKPLLY
YLPNIAYSY	YLPNIAYSY
GQLSDKFYY	GQLSDKFYY
VFVGTGQTY	VFVGTGQTY
LLWLLYIF	-LLWLLYIF
LITFVDVP	-LITFVDVP
STDPQHHAY	STDPQHHAY
GWDKHSYGY	GWDKHSYGY
FVSAGIQTSF	FVSAIQTSF
SWLIKGLMY	SWLIKGLMY
RFIPSAYPY	RFIPSAYPY
IMAKEGQLY	IMAKEGQLY
FFESMPYKV	FFESMPYKV
LFSNNLSTIY	LFSNLSTIY
ASYGNQPSSY	SYGNQPSSY
MTFDVASLY	MTFDVASLY
WATDDVAQIY	ATDDVAQIY
FFLGQEIRTVY	FLGQIRTVY
GVPGLPSTFQY	GVPGLPSTF
SFGLVGQSF	SFGLVGQSF
VAAPVFLSY	VAAPVFLSY
YLILPLPHY	YLILPLPHY
LYQSVKLLY	LYQSVKLLY
TSSDILLCY	TSSDILLCY
MVLSANWAY	MVLSANWAY
YVEDLKARY	YVEDLKARY
IFSEQMLVY	IFSEQMLVY
RMNKRQLYY	RMNKRQLYY
FVKGQFHEY	FVKGQFHEY
ILHTTGLQY	ILHTTGLQY
AVISSVAHY	AVISSVAHY
EEAWFEDPA	EEAWFEDPA
GLGPSMGFY	GLGPSMGFY
FHLSQSALY	FHLSQSALY
ATGNTALTY	ATGNTALTY
AFYEHAQTY	AFYEHAQTY
VLVEHPFEY	VLVEHPFEY
VLSDRLVYL	VLSDRLVYL
RTGDIALAY	RTGDIALAY
TETETIAKY	TETETIAKY
GIYGSTFLY	GIYGSTFLY
FNLSSSFRY	FNLSSSFRY
VFSALGAAY	VFSALGAAY
HSSNLTLHY	HSSNLTLHY
HYNYLQFAYY	HYNYLQFAY
AVNGKHTLLY	AVNGHTLLY
NLPLFAFEY	NLPLFAFEY
LFYDVLSPY	LFYDVLSPY
VYRADTQTY	VYRADTQTY
ILMEHIHKL	ILMEHIHKL
WFKKFYDANY	WFKKYDANY
EALAQCVLA	EALAQCVLA
REEGAVDKSY	EEGAVDKSY
VFLQRLMALY	FLQRLMALY
YMFGKGIYF	YMFGKGIYF
KMPRLWLDY	KMPRLWLDY
LFMSSFQSY	LFMSSFQSY
FVCLGKIFY	FVCLGKIFY
SFAEGVGAVY	SFAEVGAVY
LIYKGGDEY	LIYKGGDEY
AEGDLIEHF	AEGDLIEHF
FLDNPDAFY	FLDNPDAFY
FAASGGFLH	FAASGGFLH
SLADCNFSY	SLADCNFSY
AFSLTPLEY	AFSLTPLEY
AETEPIVKM	AETEPIVKM
GTLPIGARY	GTLPIGARY
SNLGSAYHY	SNLGSAYHY
KFPELKFKY	KFPELKFKY
GVSAAQATY	GVSAAQATY
YLGLLQAEY	YLGLLQAEY
QSLGDPLYY	QSLGDPLYY
STSSSILEY	STSSSILEY
TALSHPLLY	TALSHPLLY
LLLQPKIPY	LLLQPKIPY
TVLSMYVVY	TVLSMYVVY
FIYHLPQEF	FIYHLPQEF
EEERTRQGW	EEERTRQGW
IAFDPRSAYY	AFDPRSAYY
LSLPKGWDY	LSLPKGWDY
LYTALQQYF	LYTALQQYF
SYRDSYESY	SYRDSYESY
VFRSMQEFY	VFRSMQEFY
GLLAGLVLLY	LLAGLVLLY
RLPPGIIGGEY	LPPGIGGEY
WVVDQTHFY	WVVDQTHFY
HYEHTSVGAY	YEHTSVGAY
VAMPYQWEY	VAMPYQWEY
AFISSSLLY	AFISSSLLY
YYYDGDVGN	YYYDGDVGN
FFVNRGGL	-FFVNRGGL
KVRDQQLVY	KVRDQQLVY
FVKDAQEQY	FVKDAQEQY
VLDNGMLKY	VLDNGMLKY
SIKDVLDSEGY	KDVLDSEGY
YVNPDHLNY	YVNPDHLNY
SMGGMLLLNY	SMGGLLLNY
STSRSLALMY	STSRLALMY
LFSNKQLPF	LFSNKQLPF
NFFPEAFDY	NFFPEAFDY
QSLYIANHAY	SLYIANHAY
HISEKSFEY	HISEKSFEY
GQWNHMLGY	GQWNHMLGY
AVTKVTAAY	AVTKVTAAY
LAFGVPFLY	LAFGVPFLY
VILDNSPGAY	ILDNSPGAY
YYNGKIHAY	YYNGKIHAY
TTSSSISRHY	TSSSISRHY
MTYNRPDTVYY	TYNRDTVYY
GVTSLQLGY	GVTSLQLGY
WSDAKLAAY	WSDAKLAAY
AAGLGLVAIY	AGLGLVAIY
ATAASFVGY	ATAASFVGY
FFKYACGGWL	FFKYACGGW
FFGAGGAGY	FFGAGGAGY
RFHYINGSLF	RFHYNGSLF
FVASVAVLY	FVASVAVLY
AQAEKHFHY	AQAEKHFHY
KLMKVHLKF	KLMKVHLKF
KAVGLQLYY	KAVGLQLYY
LFRTIALFY	LFRTIALFY
APFLKMYGEY	PFLKMYGEY
GSHSMRYFY	GSHSMRYFY
LFEHMATNY	LFEHMATNY
IILHDRLYY	IILHDRLYY
ESVSILLDY	ESVSILLDY
ALWNEGYIMGF	ALWNEGYIM
LMMANVFIY	LMMANVFIY
RGLGMTLSY	RGLGMTLSY
IFLHRTLTY	IFLHRTLTY
IFSPEGRLY	IFSPEGRLY
TYAPLAFRY	TYAPLAFRY
FYVAHNQFY	FYVAHNQFY
STAEYALLY	STAEYALLY
IWRPSSDLY	IWRPSSDLY
VYYNEATGGKY	YYNETGGKY
LLWQVAYSY	LLWQVAYSY
IFSNWGHPEY	IFSNGHPEY
DLSENFLY	-DLSENFLY
VLKQEQEEY	VLKQEQEEY
EGLYPTYY	-EGLYPTYY
TALHLAARY	TALHLAARY
GMDVDTRAY	GMDVDTRAY
RLDAVTLLY	RLDAVTLLY
GLNEQVPHY	GLNEQVPHY
QIYEEARKFSY	YEEARKFSY
LFYGKSYYHVY	FYGKYYHVY
RIMDPDVITGY	IMDPVITGY
ACTGIALGY	ACTGIALGY
VILNMFFKY	VILNMFFKY
MALHVAARY	MALHVAARY
FTSIMGYLY	FTSIMGYLY
FFSKVMGILI	FFSKVMGIL
SLERLLLGY	SLERLLLGY
VFWLPHNMDF	FWLPHNMDF
SYITLAPLY	SYITLAPLY
YFEDSNYVY	YFEDSNYVY
HVSQDKQMLY	VSQDKQMLY
QVAGVYAAY	QVAGVYAAY
DYIQYRLEY	DYIQYRLEY
QLYEPLHY	-QLYEPLHY
ALSEHNLKY	ALSEHNLKY
TTFTHSYPF	TTFTHSYPF
FISSNSFLY	FISSNSFLY
HLKNSQEKY	HLKNSQEKY
VYCPVQWEY	VYCPVQWEY
IYYGTQHKM	IYYGTQHKM
FAVTEYPTLKF	AVTEPTLKF
RTNGDNYLY	RTNGDNYLY
VFEGNHYFY	VFEGNHYFY
AYASQPAAY	AYASQPAAY
ALNYSVFYY	ALNYSVFYY
MMYTGPSHHSY	YTGPSHHSY
LVNSAAHLF	LVNSAAHLF
IEEELGSK	-IEEELGSK
RFEALNLSF	RFEALNLSF
VLHFKSEGY	VLHFKSEGY
GMMAENFLY	GMMAENFLY
FIPDNSQLEY	FIPDSQLEY
FFLRDITLRY	FLRDITLRY
FFGYPSFKY	FFGYPSFKY
LLLKEFFEY	LLLKEFFEY
HINGRVLYY	HINGRVLYY
VPFSKRYLKY	PFSKRYLKY
YFETTYDTSY	FETTYDTSY
LLYFVWYVF	LLYFVWYVF
NTCGKFFRY	NTCGKFFRY
IFDTQAIFY	IFDTQAIFY
SYIWIGEEY	SYIWIGEEY
PYNHQHEY	-PYNHQHEY
KWSIPAFLY	KWSIPAFLY
AVDAARLHY	AVDAARLHY
FAASVAHLY	FAASVAHLY
VYFEGSDFKF	YFEGSDFKF
SSYGIPYSY	SSYGIPYSY
IYTNRALCY	IYTNRALCY
THNLLLNY	-THNLLLNY
AFIRVVGSEF	AFIRVGSEF
KGVTQIINY	KGVTQIINY
FYSGSPTSY	FYSGSPTSY
EVMPLLLAY	EVMPLLLAY
MVVSGAVLVY	VVSGAVLVY
AVIKSNHSY	AVIKSNHSY
GYLPNQLFRTF	GYLPNQLFR
AESVGAKHY	AESVGAKHY
HLMSQPLAY	HLMSQPLAY
FVLTKSMLTYY	VLTKSMLTY
YIYQLDHRY	YIYQLDHRY
MTFQMKFFY	MTFQMKFFY
REIQDEELKKF	IQDEELKKF
YFPHTAIRY	YFPHTAIRY
LLIENVASL	LLIENVASL
AFGEMGLDY	AFGEMGLDY
SFVGGLSVLY	FVGGLSVLY
HLPSQAHLYTY	HLPSQAHLY
NLTHLSLKY	NLTHLSLKY
LPIHLSKYI	LPIHLSKYI
GVTRLTFEY	GVTRLTFEY
GGYGGFDDY	GGYGGFDDY
GVYGSWHNY	GVYGSWHNY
VFDADTLLY	VFDADTLLY
GLFAPLPTY	GLFAPLPTY
VVARLLALY	VVARLLALY
LMMTNPHNHLY	MTNPHNHLY
LGWDTYLSY	LGWDTYLSY
YMVLLKMRY	YMVLLKMRY
YFATESSHFY	FATESSHFY
SVMETFLLY	SVMETFLLY
GALAVSLYY	GALAVSLYY
KIYHISLEY	KIYHISLEY
ACLDKAVEY	ACLDKAVEY
FYYRLWDLY	FYYRLWDLY
AEGTEEGARW	AEGTEGARW
TLKAEQEEY	TLKAEQEEY
HEAEVLKQL	HEAEVLKQL
SPLPAQLVY	SPLPAQLVY
FFEVFDNSM	FFEVFDNSM
SQYGSLLYY	SQYGSLLYY
HIPRFYLFY	HIPRFYLFY
SYRSMSESY	SYRSMSESY
HFVKLISWY	HFVKLISWY
HTAHIHATEY	HTAHHATEY
NFRGGSDGY	NFRGGSDGY
KFDLLKELY	KFDLLKELY
TLYYQPGLLY	LYYQPGLLY
IRDILLNPD	IRDILLNPD
RLLEAHALY	RLLEAHALY
SAAPMTLLY	SAAPMTLLY
EEIAFLKKL	EEIAFLKKL
YAKGFGGQY	YAKGFGGQY
RVLEAANLFQF	RVLEAANLF
FNSMVALAY	FNSMVALAY
VFYALSNKY	VFYALSNKY
AVTEYPTLKF	AVTEPTLKF
VLMKALEY	-VLMKALEY
FLQESNVLY	FLQESNVLY
RMADDLNAQY	MADDLNAQY
LWNSSAALY	LWNSSAALY
WLPLHEAAYY	LPLHEAAYY
FFGMHVQEY	FFGMHVQEY
YFVSVNTSYY	YFVSVNTSY
GLWGHALLL	GLWGHALLL
GTATKHLTY	GTATKHLTY
SYGSVLQHAY	SYGSLQHAY
SFQVIESLY	SFQVIESLY
LFSAGTFLY	LFSAGTFLY
PLSISIFTY	PLSISIFTY
IFYDTEHLKY	FYDTEHLKY
TEEPQRLFY	TEEPQRLFY
YYLPLKVMY	YYLPLKVMY
SYGQPQSGSY	SYGQQSGSY
TVQSVMLHY	TVQSVMLHY
HFVSPMAHY	HFVSPMAHY
YFFNKEGDF	YFFNKEGDF
FLYDKYEEY	FLYDKYEEY
LLSKEQLRS	LLSKEQLRS
FYQYLEQSKY	YQYLEQSKY
VMSEDGFFY	VMSEDGFFY
AVSERLFYY	AVSERLFYY
YVTHLHAEY	YVTHLHAEY
YVYTDSLFY	YVYTDSLFY
QVLEAYARY	QVLEAYARY
YFWSGRDGY	YFWSGRDGY
EEVHDLERKY	EVHDLERKY
VVLPVRYFY	VVLPVRYFY
YYAKKILYY	YYAKKILYY
RLHQSFFLY	RLHQSFFLY
FLAKQQNKY	FLAKQQNKY
SNCGKFLRY	SNCGKFLRY
QTWAGSHSLKY	WAGSHSLKY
MVLNSHDLY	MVLNSHDLY
LLHGRHFTY	LLHGRHFTY
ALHQMQALY	ALHQMQALY
KVLNWLLSY	KVLNWLLSY
NVLDDVYEY	NVLDDVYEY
NIMTKTLLY	NIMTKTLLY
LFEEAAKLY	LFEEAAKLY
LISRLPEIY	LISRLPEIY
TVMKTYHMY	TVMKTYHMY
HYERLVLPY	HYERLVLPY
SMIGVITLY	SMIGVITLY
WFESGSMPY	WFESGSMPY
LLPFLDAQY	LLPFLDAQY
FFGEEYLEY	FFGEEYLEY
YYFATLDHY	YYFATLDHY
YNLAKGFNY	YNLAKGFNY
GNYGYGQGY	GNYGYGQGY
SFLLNPEKY	SFLLNPEKY
YVMYPPHLY	YVMYPPHLY
ALNENVSSF	ALNENVSSF
IVLGTPAYY	IVLGTPAYY
NMNDLVSEY	NMNDLVSEY
SFHKFHYLTF	SFHKHYLTF
FSNQTAYLY	FSNQTAYLY
VYIYGRHLY	VYIYGRHLY
KMNKRQLYY	KMNKRQLYY
HFIAEHYMF	HFIAEHYMF
RLATHHYLY	RLATHHYLY
YILTNVAYY	YILTNVAYY
KPLHPFTEY	KPLHPFTEY
VYDDGKHVY	VYDDGKHVY
NTLHLASTY	NTLHLASTY
NYETAILRY	NYETAILRY
RFSSTTGLFY	FSSTTGLFY
YMLHQFLQY	YMLHQFLQY
SVTEVQLRF	SVTEVQLRF
ILGRFINAEY	ILGRINAEY
HQWAKTLKY	HQWAKTLKY
SGSNGFYSY	SGSNGFYSY
VFNTGIFQY	VFNTGIFQY
VFDDGRYVY	VFDDGRYVY
YYKPDSPEY	YYKPDSPEY
FIAEHGYLY	FIAEHGYLY
VFIGTGATGAT	VFIGTGATG
IIDGKTLKY	IIDGKTLKY
SFASIVAQY	SFASIVAQY
FTLADILLY	FTLADILLY
LGIPLHLAY	LGIPLHLAY
KVYDDMAFRY	VYDDMAFRY
GSNNVALGY	GSNNVALGY
HLVDYFPEY	HLVDYFPEY
MVFMGSLKY	MVFMGSLKY
RFADSTHRY	RFADSTHRY
LVYVPEEIYRY	YVPEEIYRY
SNISLRLFY	SNISLRLFY
YIDPIAMEY	YIDPIAMEY
WTAYQKYLY	WTAYQKYLY
HLIQTTHHY	HLIQTTHHY
YQLSQHQRF	YQLSQHQRF
TMQDIHFHY	TMQDIHFHY
FFKQMEQRY	FFKQMEQRY
YFYDDVTTLY	FYDDVTTLY
TMAPPVMAY	TMAPPVMAY
AYPQVPSSGY	AYPQPSSGY
SFHNIHNTF	SFHNIHNTF
SFIFHEDLLG	SFIFHEDLL
FNLTFHLSY	FNLTFHLSY
YMGQTAYQY	YMGQTAYQY
SAVAATYKY	SAVAATYKY
ARWQCDAVLY	RWQCDAVLY
GNYGSGNYND	NYGSGNYND
YLNEKAVSY	YLNEKAVSY
NTFSPNGLLLY	TFSPGLLLY
VFQYRLVEY	VFQYRLVEY
SLSRHAALLY	SLSRAALLY
VVQTQLNSY	VVQTQLNSY
YLPPDFPYY	YLPPDFPYY
YYVVAHFHY	YYVVAHFHY
TYFAVDASY	TYFAVDASY
AAKREFEEY	AAKREFEEY
FVYEVTSTKY	FVYETSTKY
IMWQKHYVY	IMWQKHYVY
IAKFVDGEWY	IAKFDGEWY
VLNRHHWMY	VLNRHHWMY
TFLDTFHYY	TFLDTFHYY
AFGEFHLWY	AFGEFHLWY
RLTKEMLLY	RLTKEMLLY
LGNGRENGLA	GNGRENGLA
YVIPKTGFY	YVIPKTGFY
VFFKNAFQY	VFFKNAFQY
SVNNRAELYQH	SVNNRAELY
STPSDSLIY	STPSDSLIY
TVLDVHKKY	TVLDVHKKY
REAVQKKTF	REAVQKKTF
YFGVLQRSLY	YFGVQRSLY
AMQSASHLY	AMQSASHLY
LMTSFLQYI	LMTSFLQYI
IYFAGEHTAY	YFAGEHTAY
FLDHKTLYY	FLDHKTLYY
VFLKYILDY	VFLKYILDY
YFVSVNTSY	YFVSVNTSY
QVQQVAAEY	QVQQVAAEY
QSTKVNLLY	QSTKVNLLY
LLAALSWQY	LLAALSWQY
YYGYPPLTY	YYGYPPLTY
AIEKQKLVY	AIEKQKLVY
GMYEAAKLLY	GMYEAKLLY
YFSPFPEDY	YFSPFPEDY
NVAEFVCKY	NVAEFVCKY
HFGRLLLFY	HFGRLLLFY
HFGIVEGLM	HFGIVEGLM
KLAPSEYRY	KLAPSEYRY
SVLMKALEY	SVLMKALEY
EELQQKVSY	EELQQKVSY
TFYKQPMFY	TFYKQPMFY
YYSEKTQLY	YYSEKTQLY
YFSDLQSYY	YFSDLQSYY
LYGLIHARY	LYGLIHARY
SLYEGIDFY	SLYEGIDFY
IYYYPSFHY	IYYYPSFHY
ASLPRNLLFKY	SLPRLLFKY
KLAPISIMY	KLAPISIMY
QCKNFYFNY	QCKNFYFNY
FIAATNIRY	FIAATNIRY
AFPALQLKY	AFPALQLKY
IFVPLVVRY	IFVPLVVRY
HFVSLENLNLY	VSLENLNLY
IFKRPSRQFQY	KRPSRQFQY
TVSQSFLSY	TVSQSFLSY
TNCFELSIY	TNCFELSIY
VFKYLAEKY	VFKYLAEKY
SMLYLVTEY	SMLYLVTEY
NISQVNVDY	NISQVNVDY
TTSAQVACLY	TSAQVACLY
EFDEDEMFY	EFDEDEMFY
YVHNDMFRY	YVHNDMFRY
TFPGIKLIY	TFPGIKLIY
HFQVSKDRY	HFQVSKDRY
VLNPRGLRY	VLNPRGLRY
TLLHFAAKY	TLLHFAAKY
QLDRISVYY	QLDRISVYY
NVMRKFHGY	NVMRKFHGY
ISSDTHLLY	ISSDTHLLY
VYWNVGFLKY	YWNVGFLKY
YLLKNHLDY	YLLKNHLDY
FAFEHSEEY	FAFEHSEEY
FLFDGSPTY	FLFDGSPTY
SVTEIHLYF	SVTEIHLYF
LMHSIGLGY	LMHSIGLGY
KLRSMPLIY	KLRSMPLIY
