Data	Data aligned
SPSPVSMGRSL	SPVSMGRSL
VPKDVNAAI	VPKDVNAAI
LPYGFIQEL	LPYGFIQEL
MPNSPRFLL	MPNSPRFLL
APARASVIL	APARASVIL
SPVYQISEL	SPVYQISEL
RPPPIGAEV	RPPPIGAEV
APADGFSDLAM	APADGFSDL
SPGSSSLSL	SPGSSSLSL
RPKYQFLSL	RPKYQFLSL
LPVTPILEGF	LPVTILEGF
HPRDPNLLL	HPRDPNLLL
SPKFSELVM	SPKFSELVM
LPSQVSRVV	LPSQVSRVV
RPAGKGSITI	RPAGGSITI
MIRYPSSQL	MIRYPSSQL
IPLKPTVKM	IPLKPTVKM
KPIAVGSMSML	KPIAGSMSM
SPDLPTGSL	SPDLPTGSL
SPTTVTQMSL	SPTTTQMSL
SPFGSITSA	SPFGSITSA
SPGVGKTSL	SPGVGKTSL
SPTSYFTSGL	SPTSFTSGL
LPKVQSIQL	LPKVQSIQL
RPRDYTVNL	RPRDYTVNL
APNPIHLTV	APNPIHLTV
IPAASAAAM	IPAASAAAM
GVRPSPMQL	GVRPSPMQL
SPMAQSTSSL	SPMASTSSL
SPRSPVPTTL	SPRSVPTTL
SRAKAVRAL	SRAKAVRAL
SPSPLSGSAL	SPSPSGSAL
SPPSPYPTTV	SPPSYPTTV
RPPPPGMRGLL	RPPPGMRGL
SPVSGGVNLF	SPVSGGVNL
APGYLPTSL	APGYLPTSL
RPREAEVRFL	RPREEVRFL
RPWLEGRHTL	RPWLGRHTL
APAAFGLVS	APAAFGLVS
APRVPVQAL	APRVPVQAL
APSQPITAV	APSQPITAV
APALARTLQSL	APA-LARTL
NPTQVGTAL	NPTQVGTAL
QPLPVTPDSQL	LPVTPDSQL
QPTGGKARL	QPTGGKARL
APSLFHLNLL	APSLFHLNL
APPPQFSGPEL	PPQFSGPEL
VMAPRTVL	VMA-PRTVL
QPMQPHPQHL	QPMQHPQHL
RPRTEVSLSA	RPR-TEVSL
SPSGGSTVSF	SPSGSTVSF
LPAAPASSL	LPAAPASSL
APMMVSNIL	APMMVSNIL
APVYMAAVI	APVYMAAVI
APAPTPPLL	APAPTPPLL
TPLGGMTGF	TPLGGMTGF
VPIMVKSKL	VPIMVKSKL
APKIPSVSW	APKIPSVSW
FPRSPGQPSSL	SPG-QPSSL
VPNQKRLTLL	VPNQKRLTL
QAEPFRPAL	QAEPFRPAL
SPSSDSLLF	SPSSDSLLF
VVAPAGVTL	VVAPAGVTL
APAPGPPRQL	APAPPPRQL
SPSVKPNEL	SPSVKPNEL
TPALGSLLF	TPALGSLLF
KPQDYKKRLSV	KPQDYKKRL
FPFVSKTL	FPF-VSKTL
LPPPVFQML	LPPPVFQML
SPREAARVL	SPREAARVL
HPFPGPGLAI	HPFPPGLAI
RPISPGLSY	RPISPGLSY
SPWSGLMAL	SPWSGLMAL
MPGPGTLSV	MPGPGTLSV
SPTWPPKVL	SPTWPPKVL
APRPALGRPPV	RPALGRPPV
MPSQFRDIL	MPSQFRDIL
LPSPPAVAV	LPSPPAVAV
VPDSVKKEL	VPDSVKKEL
LPGPTRPVL	LPGPTRPVL
DALREPGKAL	ALREPGKAL
APAPSPQI	APA-PSPQI
KPYGPMSVGL	KPYGMSVGL
YPKPALLHST	YPKPLLHST
VPNQKRLTL	VPNQKRLTL
SPANPAHILSL	SPANPAHIL
SPVVHSVL	SPV-VHSVL
RPPKPPTFGEF	RPP-KPPTF
SPISHLPGSL	SPISLPGSL
SPSELMLTL	SPSELMLTL
NPSSWPVSL	NPSSWPVSL
RPWIRELIL	RPWIRELIL
VPSAAGYAL	VPSAAGYAL
IPRALAENSGV	IPRAAENSG
APKPSSRPSL	APKPSRPSL
PRPVLRAL	PRP-VLRAL
RPFGSISRIYL	RPFGSISRI
FPSPPAVSI	FPSPPAVSI
QPRGPLRWL	QPRGPLRWL
MPPMGGPPM	MPPMGGPPM
QPRLMEPIYL	QPRLEPIYL
SVDFSRPQL	SVDFSRPQL
MPDVGRSMQQL	MPD-VGRSM
RVKTSLPRAL	RVKTLPRAL
TPSAGKAML	TPSAGKAML
RPRPSTDVRAL	RPSTDVRAL
LPFDKTTIM	LPFDKTTIM
SPSNTRYLFL	SPSNRYLFL
TPLSSTVTLSM	TPLSSTVTL
LASLIRSVVAL	SLIRSVVAL
YPASTVQIL	YPASTVQIL
SPYPTKTQTM	SPYPKTQTM
IPRYIVSQL	IPRYIVSQL
NPEVRRAVL	NPEVRRAVL
SPSAYVLEI	SPSAYVLEI
DPSSRSLQTL	DPSSSLQTL
SPGDFSISV	SPGDFSISV
APSSPRPALP	APSSPRPAL
APRLQSEVA	APRLQSEVA
RPVPPPPSL	RPVPPPPSL
SIREAGGAF	SIREAGGAF
YPQVPGSYPM	YPQVGSYPM
SPWLHAPSL	SPWLHAPSL
YPSIAHLVQKL	SIAHLVQKL
APGSWSQVL	APGSWSQVL
AASKERSGVSL	ASKESGVSL
KPWEKSPIL	KPWEKSPIL
LPALPLAEL	LPALPLAEL
RPVKPELAL	RPVKPELAL
SPVSGGVNL	SPVSGGVNL
TPADGFTVL	TPADGFTVL
LPSMPEPAL	LPSMPEPAL
QPYVGVFL	QPY-VGVFL
RPQGLSFLGL	RPQGSFLGL
LPRLAFPLL	LPRLAFPLL
RPSQNLLQL	RPSQNLLQL
APSYPMASL	APSYPMASL
VVREPSGTL	VVREPSGTL
GPTPIPEL	GPT-PIPEL
LPAPKGPAL	LPAPKGPAL
YIALNQDLRSW	YIA-LNQDL
KPHNILISM	KPHNILISM
IPYTGPFNLL	IPYTPFNLL
NPPIGTVTPAL	PPIGVTPAL
SPMEGTGISL	SPMETGISL
SPHTPNEKF	SPHTPNEKF
LAAPVISVL	LAAPVISVL
TPLARIVAF	TPLARIVAF
RPKYPGIKF	RPKYPGIKF
SPASIRTTDF	SPASRTTDF
QLLPVSKAL	QLLPVSKAL
APPQIPSRPV	APPQPSRPV
TPSQQGVAF	TPSQQGVAF
RPPLEEKKAL	RPPLEKKAL
VPAPGPSPSL	VPAPPSPSL
APGQPGTIL	APGQPGTIL
VPRPPSNPP	VPRPPSNPP
QPAVRALGQL	QPAVALGQL
LPSRKLVAL	LPSRKLVAL
SPQQPPLLL	SPQQPPLLL
GPAIERMGL	GPAIERMGL
APGDYGRQAL	APGDGRQAL
IARTPESAL	IARTPESAL
SPKPPSSFKM	SPK-PPSSF
YPNFAGPHAAL	YPNFPHAAL
RPMNENVQM	RPMNENVQM
NPAPPIDAV	NPAPPIDAV
NPASKVIAL	NPASKVIAL
GPITRTQNPM	GPITTQNPM
IPLKPSNEL	IPLKPSNEL
YPAYLGARL	YPAYLGARL
APNIISQL	APN-IISQL
SPQEARNML	SPQEARNML
APHLLRLFV	APHLLRLFV
SPLSPQSSI	SPLSPQSSI
APAPVQPPM	APAPVQPPM
LPRGSIPRSL	LPRGIPRSL
GPPSQMGSPM	GPPSMGSPM
SPMADRSMM	SPMADRSMM
QPRLMEPIY	QPRLMEPIY
DPVMAETLQM	DPV-MAETL
AARAIISEL	AARAIISEL
SPAAKSPSAQL	SPAAKSPSA
IARLPSSTL	IARLPSSTL
RPYSNVSNL	RPYSNVSNL
NIMRTIIEF	NIMRTIIEF
LPGPPATSM	LPGPPATSM
FPALQGAQTKM	FPALQGAQT
QASDHRPVL	QASDHRPVL
SPRPQDLIRL	SPRPDLIRL
APAVPTVSL	APAVPTVSL
LPFLRITSL	LPFLRITSL
SPPILTKPTL	SPPITKPTL
SPSSILSTL	SPSSILSTL
QPEGLRKAASL	QPEGLRKAA
TPSLTVFLL	TPSLTVFLL
GPMSVGLDF	GPMSVGLDF
SPIEKSGVL	SPIEKSGVL
SPNSYVVIM	SPNSYVVIM
VPSPYLSSL	VPSPYLSSL
QPHLSRQDL	QPHLSRQDL
SPILAGEGGAM	SPILGEGGA
APRPIPSWYM	APRPPSWYM
IPKSAVGTL	IPKSAVGTL
SPTGGRMSVF	SPTGGRMSV
APSPVIPRL	APSPVIPRL
LIRIPTMAL	LIRIPTMAL
APAAGAGRLL	APAAAGRLL
SPPTGPSPSL	SPPTPSPSL
RPAYRKVFL	RPAYRKVFL
SPSGAMSNL	SPSGAMSNL
QPQHPGWPG	QPQHPGWPG
SPQTGTLAL	SPQTGTLAL
SPSPATDGKVF	SPATDGKVF
VPRAVFVDL	VPRAVFVDL
LPSKPSSTL	LPSKPSSTL
SLKTPGTSL	SLKTPGTSL
TPAAGPAVL	TPAAGPAVL
APNLKILNL	APNLKILNL
APASGYLTF	APASGYLTF
APHPFPHPAF	APHPPHPAF
IPTSARSML	IPTSARSML
QPMKPTYAI	QPMKPTYAI
MPAVGFLLL	MPAVGFLLL
YPYYGEKSAAM	YPYYEKSAA
HPSSVAGEVVF	HPSSAGEVV
SPAITATL	SPA-ITATL
APAPRPSLL	APAPRPSLL
QLRQPPAVPA	QLRQPAVPA
LPHGGEGWQQL	LPHGGWQQL
APAPPPLSQ	APAPPPLSQ
SPSRNRSLQL	SPSRRSLQL
SPKVEPRAL	SPKVEPRAL
APGPVIGL	APG-PVIGL
RPMGAGEAL	RPMGAGEAL
FPMEIRQYL	FPMEIRQYL
APSAPAAAV	APSAPAAAV
RPNGVITGL	RPNGVITGL
KPKDPLKISL	KPKDLKISL
LPSSDSMSL	LPSSDSMSL
RTRPPSVQV	RTRPPSVQV
SPSPAHPQL	SPSPAHPQL
GPPGTGKTAL	GPPGGKTAL
QPYPFTSSL	QPYPFTSSL
APYPTPAQV	APYPTPAQV
APRTVLLLLS	APRTVLLLL
AAVRIGSVL	AAVRIGSVL
GPNGGIVTSL	GPNGIVTSL
YIDQEELNK	YIDQEELNK
APPSLPHSASL	PPSLHSASL
SPFFERSGL	SPFFERSGL
RPLKGIQSRL	RPLKIQSRL
HPTDERVAL	HPTDERVAL
SPQAPTHFL	SPQAPTHFL
SPNSSILW	SPN-SSILW
VPKAPGLGL	VPKAPGLGL
VPVAKTAEL	VPVAKTAEL
VPAPTSQLL	VPAPTSQLL
APIAKVGVL	APIAKVGVL
NAAERRGPL	NAAERRGPL
APVVGILVL	APVVGILVL
APHALLQAVL	APHALQAVL
VPAVPTVGF	VPAVPTVGF
LPSLPTAEL	LPSLPTAEL
IPVAPIGTL	IPVAPIGTL
SPVVRVAV	SPV-VRVAV
SPEQSRNVL	SPEQSRNVL
YPRISVNNVL	YPRIVNNVL
YPGQPHPAL	YPGQPHPAL
LPRPQGITV	LPRPQGITV
TPEPAGLSL	TPEPAGLSL
SPDELRYLPL	SPDERYLPL
SPQPGKLRSPF	QPGKLRSPF
SPHGGALVM	SPHGGALVM
IPRVVQEGDVL	RVVQEGDVL
VVAPPGVVV	VVAPPGVVV
APRAASTESL	APRASTESL
KPNQISGTVF	KPNQSGTVF
SPFGDSPL	SPF-GDSPL
AVDAYFREAL	AVDAFREAL
SPRPDRALVQL	SPRPDRALV
TPRPKFSVC	TPRPKFSVC
KPSLTPSGEF	KPSLPSGEF
SPGLRDVAL	SPGLRDVAL
YPRQPNYNAL	YPRQNYNAL
TPRDLAVPAAL	TPRDAVPAA
NPLLRVINL	NPLLRVINL
VPRPVLRALSF	VPRPVLRAL
VPENKGISL	VPENKGISL
RPRDALPRLL	RPRDLPRLL
EPAFPHTDL	EPAFPHTDL
SPPSVQSLAM	SPPSQSLAM
LPAFSKIGGIL	LPAFKIGGI
LPHAPGVQM	LPHAPGVQM
QVMRAMASL	QVMRAMASL
RPFGGLIRDV	RPFGLIRDV
LVRDVVSSL	LVRDVVSSL
TPLVTIGHIAL	LVTIGHIAL
SPTPPLFSL	SPTPPLFSL
VPAGMGAGL	VPAGMGAGL
APQTSTPSL	APQTSTPSL
RPKPIITSV	RPKPIITSV
RPANHRQLTF	RPANRQLTF
APISAASATSL	APISSATSL
APASAFGSSL	APASFGSSL
APSATMSSF	APSATMSSF
FPMELRQFL	FPMELRQFL
SPAGPVLSI	SPAGPVLSI
RPHYSLRTL	RPHYSLRTL
QPPPPPPPL	QPPPPPPPL
APVRVSMQL	APVRVSMQL
TPADARIQIL	TPADRIQIL
GPFPGKFNEV	GPFPKFNEV
RPIQPIAGL	RPIQPIAGL
TPLLPSTTGL	TPLLSTTGL
SPLSSETTQL	SPLSETTQL
APYGGPIAL	APYGGPIAL
APFEPLASGIL	APFELASGI
FPAKPGSLTL	FPAKGSLTL
GPNPKSSRTTL	NPKSSRTTL
SPFSRKLDL	SPFSRKLDL
APIQGNREEL	APIQNREEL
MPQSGTGVSV	MPQSTGVSV
MPAITGTGL	MPAITGTGL
LPKSPPYTAF	LPKSPYTAF
SPYGSDRLVQL	SPYGSDRLV
SPVFRLETL	SPVFRLETL
SPNGNLIRML	SPNGLIRML
LPTPPGVSL	LPTPPGVSL
GPRLGDAKL	GPRLGDAKL
RPSGLHGDVSL	RPSGLHGDV
RPYAPINANAI	RPYAINANA
FPGPPPAPF	FPGPPPAPF
APSPPLRAL	APSPPLRAL
VPKPPSIEEF	VPKPSIEEF
FPNAIEHTL	FPNAIEHTL
NPSALRETVV	NPSALRETV
YPRNPTVRW	YPRNPTVRW
YVSKPGAQL	YVSKPGAQL
SPVPIPVSL	SPVPIPVSL
KVRDPRPWL	KVRDPRPWL
IVAPGKGIL	IVAPGKGIL
APRTIFQRVL	APRTFQRVL
APSPRPLSL	APSPRPLSL
SPMGRYVMV	SPMGRYVMV
FPGLSPSAL	FPGLSPSAL
APPVTDLGEL	APPVDLGEL
LPPLRIPELL	LPPLRIPEL
RPALQHVVKVL	RPALHVVKV
IPRAALLPLLL	IPRAALLPL
APSADAPMF	APSADAPMF
SPQGLKPVV	SPQGLKPVV
TPATPIGQAI	TPATIGQAI
GPRISPYVL	GPRISPYVL
IPDHFRPPL	IPDHFRPPL
LPADFGRLVNL	LPADFGRLV
SPEAPKPQL	SPEAPKPQL
LPRALQRPSAA	LPRAQRPSA
YVQALRTVL	YVQALRTVL
SPGSPLVSM	SPGSPLVSM
LPWGGGTAL	LPWGGGTAL
SPLVSRLTL	SPLVSRLTL
VPVLRGPPA	VPVLRGPPA
SPRPALPALLV	SPRPALPAL
YPFFRGVTI	YPFFRGVTI
APRTVALTA	APRTVALTA
SPNQSLRLGL	SPNQLRLGL
YPSEFSTYL	YPSEFSTYL
RPDDKRILEF	RPDDRILEF
APVSSGPLL	APVSSGPLL
RPARDMWVM	RPARDMWVM
APGVPGHTV	APGVPGHTV
APFSKVITF	APFSKVITF
SPADHMGFL	SPADHMGFL
KPRDVSSVEL	KPRDSSVEL
KPKPVKPVTF	KPKPKPVTF
APIYPGFPK	APIYPGFPK
QPLGTLPQAVM	QPLGLPQAV
LPQKAGGFL	LPQKAGGFL
SPYPNPSFL	SPYPNPSFL
SPIYGGLV	SPI-YGGLV
SPHFQHAEV	SPHFQHAEV
APLPAPSTSAL	LPAPSTSAL
RPMYSKPSIM	RPMYSKPSI
VPKPLPPAL	VPKPLPPAL
NTVLSGGTTM	TVLSGGTTM
LPRIPDPRAL	LPRIDPRAL
QLLSPGTAL	QLLSPGTAL
KPASVFVQL	KPASVFVQL
YPALVVEKM	YPALVVEKM
KPVNPSPLSQL	NPS-PLSQL
SPKPNGPVL	SPKPNGPVL
RPAAPGQTPL	RPAAGQTPL
SPNWLQALKL	SPN-WLQAL
APSEERVYMVG	APSEERVYM
RPLSKTVRF	RPLSKTVRF
APAPSVPAW	APAPSVPAW
RPYPSPGAV	RPYPSPGAV
LPITVPKSPA	LPITPKSPA
SPKPWIPVL	SPKPWIPVL
VPMFRNVSL	VPMFRNVSL
MPVLKVVL	MPV-LKVVL
FPAPPPEGL	FPAPPPEGL
VPGPLTPEM	VPGPLTPEM
SPDVWIKSL	SPDVWIKSL
LPTVHPQVTY	LPTVHPQVT
QPVAGRPSL	QPVAGRPSL
APSSYDPLA	APSSYDPLA
AVAKHFVAL	AVAKHFVAL
SPLQSVVV	SPL-QSVVV
APAPAPAL	APA-PAPAL
YPVQPGAPG	YPVQPGAPG
APQRPLSTF	APQRPLSTF
YLRPPNTSL	YLRPPNTSL
APSIQTPSL	APSIQTPSL
RPRATVMVM	RPRATVMVM
RPDKRFRLAL	RPDKFRLAL
RPKLNRENF	RPKLNRENF
SPRLPEAQV	SPRLPEAQV
LPFEKSTIM	LPFEKSTIM
APALPGPQF	APALPGPQF
APLGVGLGL	APLGVGLGL
SPNAEIHIL	SPNAEIHIL
GPLFRNSQL	GPLFRNSQL
APMPVPSGM	APMPVPSGM
RPAANFDAI	RPAANFDAI
TPQAKKIKL	TPQAKKIKL
KPAPPFNVTV	KPAPFNVTV
IPYLPITNF	IPYLPITNF
TPWGVYPASL	TPWGYPASL
YPNPKPEVL	YPNPKPEVL
SPRGDDYFNY	SPR-GDDYF
RPILIIVTL	RPILIIVTL
FPAPILRAV	FPAPILRAV
APSEQLLHL	APSEQLLHL
GTHLGGTNL	GTHLGGTNL
LPPEIVPASL	LPPEVPASL
WPKDVGIVAL	WPKDGIVAL
APDAKLITL	APDAKLITL
SPRAPFYRPL	SPRAFYRPL
FPMGDRLYIGL	FPMGDRLYI
NPRFPGNLQM	NPRFGNLQM
APGNPVLAV	APGNPVLAV
GPHVPFTVF	GPHVPFTVF
FPAKGKLFL	FPAKGKLFL
RVKLPSKAL	RVKLPSKAL
LPSCGVIPF	LPSCGVIPF
SPVPKPSPPL	SPVPPSPPL
SPRNLAMEA	SPRNLAMEA
SIRPVSEVTL	SIRPSEVTL
APPIDRSILPT	APPIDRSIL
IPYMFEAREF	IPYMEAREF
YPTQSGKPPL	YPTQGKPPL
APFLRNVEL	APFLRNVEL
TPRPVIVEPM	TPRPIVEPM
VPRFLMSSTM	VPRFMSSTM
EPRPPHGEL	EPRPPHGEL
LPAWPHRGL	LPAWPHRGL
SPGLRWALPL	SPGLWALPL
QPESIRSDL	QPESIRSDL
APAGSIISL	APAGSIISL
SPVADWSEL	SPVADWSEL
APPVPWGTV	APPVPWGTV
TPFDFTPENY	TPFDTPENY
KPSPKTIAF	KPSPKTIAF
RPWQSSETRSI	RPWQSSETR
QPLGQAKSL	QPLGQAKSL
APYFLGSSF	APYFLGSSF
APATVGLAF	APATVGLAF
NPTERVAAL	NPTERVAAL
GPSNVPGAL	GPSNVPGAL
VPVPHTTAL	VPVPHTTAL
RPRGFAYVQF	RPRGAYVQF
IPANWKTEL	IPANWKTEL
APVYLAAVL	APVYLAAVL
IPALRDISI	IPALRDISI
TPVLGSGAAA	TPVLSGAAA
IPYPRPIHL	IPYPRPIHL
LPLPNFSSL	LPLPNFSSL
RPFEDQTSL	RPFEDQTSL
RPAPLPAAVV	RPAPPAAVV
APIASIHSF	APIASIHSF
SPRPPAEGF	SPRPPAEGF
RPFERTITM	RPFERTITM
ITAPPSRVL	ITAPPSRVL
YPAEITLT	YPA-EITLT
SPYSNYGPPQ	SPYSYGPPQ
HPIEGSTTVF	HPIEGSTTV
SPVPGSIGV	SPVPGSIGV
SPNQNLSEAKL	SPNQNLSEA
RPPASVGEL	RPPASVGEL
QPAPTPLKM	QPAPTPLKM
TVARPSVPA	TVARPSVPA
APLPAQAVF	APLPAQAVF
QPRLFSTGL	QPRLFSTGL
APRSPAVPSGL	SPA-VPSGL
QPGTILRTVPM	QPGTILRTV
GPALGRSFL	GPALGRSFL
LPAPKWTEL	LPAPKWTEL
QPKNGVVVL	QPKNGVVVL
LPRPVPQNL	LPRPVPQNL
QPFQVAEVF	QPFQVAEVF
APSLAQPL	APS-LAQPL
FPEEPHVPL	FPEEPHVPL
GPPPPGPIL	GPPPPGPIL
SPVVRAENL	SPVVRAENL
LPQLPQSSQL	LPQLQSSQL
APTALGITL	APTALGITL
LPLAVGIAF	LPLAVGIAF
YPFKSPSIGF	YPFKPSIGF
HPMYGNIL	HPM-YGNIL
SVQSGNLAL	SVQSGNLAL
APASPFRQL	APASPFRQL
YPKRPLLGL	YPKRPLLGL
MSPMADRSMM	SPMADRSMM
IPRVPSLSV	IPRVPSLSV
RPKLPEDPL	RPKLPEDPL
SPWADNTAL	SPWADNTAL
SPPPPAIAV	SPPPPAIAV
SASPPGPTL	SASPPGPTL
HPLSNPAEL	HPLSNPAEL
SPTDRSMSSSL	SPTDMSSSL
LPVLPWSEV	LPVLPWSEV
SPRDSPAVSL	SPRDPAVSL
MPDSAAAL	MPD-SAAAL
SPNSYFMDV	SPNSYFMDV
RPQGGQDIL	RPQGGQDIL
GPAATSGAVL	GPAASGAVL
TVMGAELRHVL	MGAELRHVL
GPPPVGVPM	GPPPVGVPM
RPWSNSRGL	RPWSNSRGL
QVSEFRQQVL	QVSERQQVL
SPDKLPGF	SPD-KLPGF
VPREPPVSL	VPREPPVSL
QVFPRLLSM	QVFPRLLSM
HPESERISM	HPESERISM
SPGPSTSSVL	SPGPTSSVL
FPYSENKEKY	FPYSENKEK
VPLAATSML	VPLAATSML
NPRAMQALL	NPRAMQALL
RPALPVSYL	RPALPVSYL
NPQLPRLYL	NPQLPRLYL
LPAPPAPLL	LPAPPAPLL
KPSGVSAAL	KPSGVSAAL
TPVINGQSL	TPVINGQSL
VPRFYIRIL	VPRFYIRIL
GPKPGGGPGL	GPKPGGPGL
LPQGIVREL	LPQGIVREL
SPRPLGRLL	SPRPLGRLL
SPRPNHSYIF	SPRPNHSYI
TPAWVRQVL	TPAWVRQVL
AAIPAAPSL	AAIPAAPSL
APALALPAPAL	APALPAPAL
KPNDVSVFTTL	KPNDVFTTL
HPSLSAPAL	HPSLSAPAL
APLDSIHSL	APLDSIHSL
SPQAPTLQV	SPQAPTLQV
GPGLSRTGVEL	GPGLSRTGV
VPPISLSTTF	VPPILSTTF
APALTSRQF	APALTSRQF
QPEWFRNIL	QPEWFRNIL
SPPPEGPVL	SPPPEGPVL
APVPTTTLVL	APVPTTLVL
SPDIAHLASL	SPDIHLASL
SPAKNPSSLF	SPAKNPSSL
SPQPLATTPL	SPQPATTPL
SPSLPTASL	SPSLPTASL
NPNHRTPTL	NPNHRTPTL
LPHLPSLEI	LPHLPSLEI
RPRGLPPLLV	RPRGLPPLL
SPYPVILSF	SPYPVILSF
RPADPEKNQSL	RPADKNQSL
IPASNRLLL	IPASNRLLL
KPIFSKIVSL	KPIFKIVSL
RAAPHRISL	RAAPHRISL
APVSPRPGL	APVSPRPGL
SPVSAQPVIM	SPVSAQPVI
VPKQPPKTL	VPKQPPKTL
DPYRLGHDAY	DPYRLGHDA
VPGGRFISM	VPGGRFISM
RPRTEVSLSAF	RPR-TEVSL
SPSSKYVKL	SPSSKYVKL
LPRAVGTQTL	LPRAGTQTL
VPNKLGGVL	VPNKLGGVL
RPPAIPKTTF	RPPAPKTTF
GLMAPREVL	GLMAPREVL
QPEWFRNVL	QPEWFRNVL
APAPTAVVL	APAPTAVVL
SPVTPKFTPV	SPVTKFTPV
APYGGPIALL	APYGGPIAL
TPATPTSQF	TPATPTSQF
APPPAPTQAL	APPPPTQAL
APALVSKKL	APALVSKKL
LPRLPIPKL	LPRLPIPKL
LPGPPHSAL	LPGPPHSAL
SPQEDGVEL	SPQEDGVEL
RVMIIRTML	RVMIIRTML
APPASRAPQM	APPARAPQM
KPVYPGQTL	KPVYPGQTL
QPIDNVSRNLL	QPIDVSRNL
IPDVFPHLPL	IPDVPHLPL
VPAEPKLA	VPA-EPKLA
MPTMRLLSF	MPTMRLLSF
YPGEASRVSV	YPGESRVSV
LPDVPRIFL	LPDVPRIFL
VPSKVPTSM	VPSKVPTSM
VPTPSPLGPL	VPTPPLGPL
APRHGSLGFL	APRHGSLGF
APAALPNRSL	APAAPNRSL
RLRPPIMIM	RLRPPIMIM
RPTLEGREL	RPTLEGREL
IPWTPPGTAL	IPWTPGTAL
TPTQGSVL	TPT-QGSVL
SPAAPIATF	SPAAPIATF
APLTKVDEI	APLTKVDEI
HPLGGSGSRI	HPLGSGSRI
LDPVLQNPL	LDPVLQNPL
APGPGLGL	APG-PGLGL
SPQPAQQKL	SPQPAQQKL
TPDPSRSVF	TPDPSRSVF
MPTIQITAL	MPTIQITAL
SPLGHRMQL	SPLGHRMQL
GPREAFRQL	GPREAFRQL
APELLRALL	APELLRALL
SPGPRPVLL	SPGPRPVLL
TPLLMQALPM	TPL-LMQAL
IPFSGALEL	IPFSGALEL
VPEFRGLGPLF	VPEFGLGPL
NPKNPGLWL	NPKNPGLWL
YPDVASPTL	YPDVASPTL
IPPPPPPAM	IPPPPPPAM
SPKKPVIVF	SPKKPVIVF
LPAKPSLLV	LPAKPSLLV
GPVPGMPPM	GPVPGMPPM
MPSLKHIVEL	MPSLHIVEL
APTWLVHL	APT-WLVHL
YPYPYPHTL	YPYPYPHTL
SPRLPISAS	SPRLPISAS
SPLKKEQPL	SPLKKEQPL
APVSPSSQKL	APVSSSQKL
KPPAPPSPV	KPPAPPSPV
LPYSIRVLL	LPYSIRVLL
HPRMPLQRL	HPRMPLQRL
AAVFKLSL	AAV-FKLSL
MIRAAPPPL	MIRAAPPPL
VPHFPTPSI	VPHFPTPSI
APSASVVLL	APSASVVLL
GPPQRPKLNL	GPPQPKLNL
QPLGRSLGL	QPLGRSLGL
QPPGAAKPAL	QPPGAKPAL
SPSSLFSAL	SPSSLFSAL
RPVASQLPRIF	RPVAQLPRI
LPFLTKPAGF	LPFLKPAGF
SPYYRTKL	SPY-YRTKL
SPVDPGARQAL	SPVDARQAL
SPGTANVL	SPG-TANVL
QPLLREVL	QPL-LREVL
GPSLKMPSL	GPSLKMPSL
APRLETKSL	APRLETKSL
FPAGPPSHSL	FPAGPSHSL
TPWQPPTVL	TPWQPPTVL
YPTSIASL	YPT-SIASL
LPHVPLGVI	LPHVPLGVI
GPRPITQSEL	GPRPTQSEL
HPRIITEGF	HPRIITEGF
SPAGAAVGIPL	SPAGAAVGI
TPDTGRILSKL	TPD-TGRIL
APPPPPPPV	APPPPPPPV
IPIVGIIA	IPI-VGIIA
TPTPAGPTI	TPTPAGPTI
VPNVHGAL	VPN-VHGAL
QVLHDISSL	QVLHDISSL
RPSHFLNFAL	RPSHLNFAL
LPDSGHLHPL	LPDSHLHPL
IPLAKRVAL	IPLAKRVAL
APFEPLASG	APFEPLASG
SPFQSSPLSL	SPFQSPLSL
APTPIQALTL	APTPQALTL
RPPAVTSNGTL	PPAVSNGTL
VPDAKIRIF	VPDAKIRIF
IPAGGVLT	IPA-GGVLT
STFDAGAGIAL	FDAGAGIAL
QPADLLKVL	QPADLLKVL
FPTGVAPAPV	FPTGAPAPV
LPPPPPHAL	LPPPPPHAL
TPALGSLL	TPA-LGSLL
TPLSTGGTL	TPLSTGGTL
GPVRMPTKTL	GPVRPTKTL
LPKPHGIRAL	LPKPGIRAL
LPHSATVTL	LPHSATVTL
ITAPPGTAA	ITAPPGTAA
APAPVPTPAM	APAPPTPAM
SPLSGGNVAF	SPLSGNVAF
VPDTSRIYVAL	VPDTSRIYV
IPQKQREITL	IPQKREITL
APRHGSLGF	APRHGSLGF
TVRAVIATL	TVRAVIATL
GPTHMGPLAL	GPTHGPLAL
HPISDHEATL	HPISHEATL
SPEPGRLGP	SPEPGRLGP
YPRSLFPSL	YPRSLFPSL
TPHAVGVLL	TPHAVGVLL
HPRDPNLLLSV	HPRDPNLLL
TPARKEISL	TPARKEISL
IPITETGTM	IPITETGTM
RVKEIGSTM	RVKEIGSTM
APSSPGSSW	APSSPGSSW
RPYTNKVITL	RPYTKVITL
SPLQAPTPL	SPLQAPTPL
VPPAVTGITF	VPPATGITF
IPNERTMQL	IPNERTMQL
SPAVERLISSL	AVERLISSL
SPSPALAL	SPS-PALAL
YPPPPGPFA	YPPPPGPFA
GPPIAATPPA	GPPIATPPA
SPAGGGAEAL	SPAGGAEAL
IPRAALLPL	IPRAALLPL
NPRTGQLFL	NPRTGQLFL
TPAVIRISV	TPAVIRISV
SPAEFVTRF	SPAEFVTRF
APRPIPSWY	APRPIPSWY
AVRLITSSL	AVRLITSSL
APRWLEEEAAL	APRWLEEEA
IPANPPMAF	IPANPPMAF
AGAAVRIGSVL	AVR-IGSVL
KPAPQTLTGL	KPAPTLTGL
SPTQPGPVL	SPTQPGPVL
APAQGLLRPIL	APAQLLRPI
GPAIERMGLSM	GPAIERMGL
MPLPGTKAL	MPLPGTKAL
HPIQVQPGRIL	QVQ-PGRIL
SPQMSGMAAL	SPQMGMAAL
QPSLLGRKIL	QPSLGRKIL
KPRNVQILNM	KPR-NVQIL
LPSGFRKFL	LPSGFRKFL
QPRIFGGVL	QPRIFGGVL
GPDENIRANL	GPDEIRANL
SPYIRALGF	SPYIRALGF
QPASFAVSL	QPASFAVSL
PEAKKPRL	PEA-KKPRL
APAGGSPRML	APAGSPRML
SAAMPGASL	SAAMPGASL
IPLEYLEKL	IPLEYLEKL
SPRYIFTML	SPRYIFTML
SPDLGKNLQTL	SPD-LGKNL
KPKPTNPVEI	KPKPNPVEI
TVIGAGVTL	TVIGAGVTL
TPKLPALAA	TPKLPALAA
NPRPTAQDL	NPRPTAQDL
APHMGGPPM	APHMGGPPM
APALRESPL	APALRESPL
SPLIGRISF	SPLIGRISF
HPINPRVAL	HPINPRVAL
PHLVGPHL	PHL-VGPHL
APRPVPKPRGL	RPVPKPRGL
NPAAAAAAV	NPAAAAAAV
NPAAGSVIL	NPAAGSVIL
QVHPPGLAL	QVHPPGLAL
IPPPGGTSL	IPPPGGTSL
SPSLKPSAV	SPSLKPSAV
APIPTFSTF	APIPTFSTF
KPPAPPSPVQ	KPPAPPSPV
SPAAPSPLAL	SPAASPLAL
SPIKVTLATL	SPIKTLATL
APGPPSVVV	APGPPSVVV
VPNWHRDLV	VPNWHRDLV
GPSPVSPNAL	GPSPSPNAL
MPAFSKIGGIL	MPAFKIGGI
MPMSNVGTTRL	MPMSNVGTT
LPYLPSGESL	LPYLSGESL
QPAKPTKVTL	QPAKTKVTL
YPASAGTSL	YPASAGTSL
SPLPSPSAM	SPLPSPSAM
APALAPTL	APA-LAPTL
SPSPVAAVT	SPSPVAAVT
APSLVAPAL	APSLVAPAL
SPAGVSATL	SPAGVSATL
SPPSLPGGTA	SPPSPGGTA
RPVHLDQAAF	RPVHDQAAF
IPAPDFSGL	IPAPDFSGL
YPAQGVQQF	YPAQGVQQF
TPYKGGNLY	TPYKGGNLY
YPHAVGKNTL	YPHAGKNTL
RPNQHNTVKL	RPNQNTVKL
KPGKFVTTL	KPGKFVTTL
TPLLPSTTGLL	TPLLSTTGL
SPGEAWPFESV	SPGEPFESV
APQGGLAEF	APQGGLAEF
VPRPPPLYSH	VPRPPLYSH
APAVSVLQL	APAVSVLQL
QPSFPTPQL	QPSFPTPQL
YPVTGPKKTY	YPVTPKKTY
LPRGFPPSASL	LPRGFPPSA
RPSGEAFVEL	RPSGAFVEL
SPNGGIPGAGL	SPNGGIPGA
RPHKPGLYL	RPHKPGLYL
KPVISPLEL	KPVISPLEL
IPLLGKSSL	IPLLGKSSL
APDVGRMGIEI	APDVGRMGI
APRTVLLLL	APRTVLLLL
TPPASLPGSL	TPPALPGSL
APLPGSTGL	APLPGSTGL
NPRQPLPASGL	QPL-PASGL
SPLPAGNAL	SPLPAGNAL
HAIPPTLAM	HAIPPTLAM
KPPSPGTVL	KPPSPGTVL
APSSLGGAM	APSSLGGAM
SPPPLPPPPPM	SPPPPPPPP
YPYSVTPPSL	YPYSTPPSL
VVKPPGSSL	VVKPPGSSL
TPITPSSGF	TPITPSSGF
APTPVPAL	APT-PVPAL
PSRTLFPSL	PSRTLFPSL
VPAPVPLMS	VPAPVPLMS
LPVPAFNVI	LPVPAFNVI
IIREPLTEL	IIREPLTEL
QPMNPTQNMDM	QPMNPTQNM
AAERRGPL	AAE-RRGPL
KPGGLFGTSSF	KPGGFGTSS
APVYFPEEL	APVYFPEEL
VPQSGVPAL	VPQSGVPAL
APDIPTPVL	APDIPTPVL
SPLPAHLQQAF	LPAHLQQAF
APLALVTSL	APLALVTSL
SPMALFLKM	SPMALFLKM
SPISVPGGSAL	SPISPGGSA
IPAPGSGVSF	IPAPSGVSF
MPVSGPGL	MPV-SGPGL
AVRLIMDSL	AVRLIMDSL
VPAENKSVL	VPAENKSVL
RPSSQYIVAL	RPSSYIVAL
MPYSHPSSY	MPYSHPSSY
AVDPNRAVPL	AVDPRAVPL
LPSVPSTHL	LPSVPSTHL
KPGDFIHTL	KPGDFIHTL
TPEQLAAPI	TPEQLAAPI
NPGFGMGGPM	NPGFMGGPM
APMALFYPATF	APMAFYPAT
SPAGPGLSL	SPAGPGLSL
SPRTAVAPSAV	SPRTVAPSA
SPVNGKLSV	SPVNGKLSV
NPNGRFVVV	NPNGRFVVV
IPMSDPQVL	IPMSDPQVL
RPKNLMQTL	RPKNLMQTL
MPAFLRSAL	MPAFLRSAL
QPLFSEKFPTL	QPLFKFPTL
VPRPGPDTL	VPRPGPDTL
SPGSPIHSL	SPGSPIHSL
LPQPVPLSV	LPQPVPLSV
GPVTPQPTAL	GPVTQPTAL
APPRGPLPTL	APPRPLPTL
TPQSNRPVM	TPQSNRPVM
APPPPPTSM	APPPPPTSM
QPVATGALEL	QPVAGALEL
TPSPARPAL	TPSPARPAL
VPAEPKLAF	VPAEPKLAF
VPLGAGIAL	VPLGAGIAL
APTIVGKSSL	APTIGKSSL
SPAPPPPQL	SPAPPPPQL
SPLQASSAL	SPLQASSAL
APREALAQTVL	APRELAQTV
VPAVTTPVL	VPAVTTPVL
YPMDLGGRNFL	YPMDGGRNF
LPRPPPPVKV	LPRPPPVKV
SPASLSSL	SPA-SLSSL
KPALVAKSSIL	KPALAKSSI
SPNTGGGLF	SPNTGGGLF
KPRGLDPVEI	KPRGDPVEI
NVRPPNTAL	NVRPPNTAL
MPGSGPVSM	MPGSGPVSM
SPAPRTAL	SPA-PRTAL
QPSSFRSVI	QPSSFRSVI
SPRFPAQYLKL	SPRFPAQYL
LPAAAQDVY	LPAAAQDVY
MPMMPGPPM	MPMMPGPPM
SPFHRNLFL	SPFHRNLFL
RPPPPSTLL	RPPPPSTLL
RPPNYSGTIAL	PPNYGTIAL
TPQEMKQVL	TPQEMKQVL
RPDQLTGL	RPD-QLTGL
SPILNGGSL	SPILNGGSL
RPQAPATVGL	RPQAATVGL
RPVPWNALL	RPVPWNALL
APALLGLAL	APALLGLAL
KLFIGGLSF	KLFIGGLSF
SPMIPSIVV	SPMIPSIVV
YPGAERNLL	YPGAERNLL
APPTPLTPT	APPTPLTPT
LPSGDRVAVSV	LPSGDRVAV
LPRPPPSAV	LPRPPPSAV
SPTPPNPVV	SPTPPNPVV
PPAPPPPPV	PPAPPPPPV
LPDQDQRSQL	LPDQQRSQL
RPSPWRPLV	RPSPWRPLV
APYSLPTSF	APYSLPTSF
LPRLTPPVL	LPRLTPPVL
APLGQFVSL	APLGQFVSL
MPSEQIRNQL	MPSEIRNQL
APFKFDMEL	APFKFDMEL
IPIPIYAPL	IPIPIYAPL
RPKIQQQFSDL	RPK-IQQQF
PSAARHSL	PSA-ARHSL
SPMLLVAL	SPM-LLVAL
IPAPPSSPL	IPAPPSSPL
TPAALAAL	TPA-ALAAL
SPGSPRPAL	SPGSPRPAL
SPAIQRNTF	SPAIQRNTF
YPHGPPGPL	YPHGPPGPL
SPYGGGHAL	SPYGGGHAL
AVKLPGGQL	AVKLPGGQL
IPPLFPQKPL	IPPLPQKPL
IPKSAVGEL	IPKSAVGEL
RPASPPVVKL	RPASPVVKL
YPAPPNVTI	YPAPPNVTI
KPNPNQIISV	KPNPQIISV
HPRIASGLGL	HPRISGLGL
YPPGPGVAL	YPPGPGVAL
SPSAAHFITRL	SAAHFITRL
SPSDLHISPL	SPSDHISPL
KPAFGTPL	KPA-FGTPL
APRDPIPYL	APRDPIPYL
RPKAISPYHL	RPKASPYHL
LPFSIRVLL	LPFSIRVLL
HPRVPSLTTV	HPRVSLTTV
MPARWLTHL	MPARWLTHL
RPRPEYVAIF	RPRPEYVAI
VPRDLPSWM	VPRDLPSWM
IPTGEGPPL	IPTGEGPPL
MPTSPGVDL	MPTSPGVDL
NPRDPPSWSVL	NPRDPSWSV
APRPPPKPM	APRPPPKPM
YPAYGQQPA	YPAYGQQPA
APNELLWTVTL	APNELLWTV
VPYRLLPGIF	VPYRLLPGI
YPGPPSGPG	YPGPPSGPG
APAPGLGAA	APAPGLGAA
APVLPVGTEL	APVLVGTEL
KPYFPPRIL	KPYFPPRIL
SPIIDVINM	SPIIDVINM
SASVQRADTSL	SVQRADTSL
APVISVLL	APV-ISVLL
VPRPVLRAL	VPRPVLRAL
PPEYHRKAV	PPEYHRKAV
APEFRRLGL	APEFRRLGL
QPSVQPPL	QPS-VQPPL
QPADVIKTHM	QPADIKTHM
SPQWLKEL	SPQ-WLKEL
LPAAAMARAM	LPAAMARAM
LPSHIRILGL	LPSHRILGL
APGQPSPVL	APGQPSPVL
RPIPQWIRM	RPIPQWIRM
NPRDPPSWSV	NPRDPSWSV
LPAQPASTF	LPAQPASTF
TPFGAYGGLL	TPFGYGGLL
AAALPAAAL	AAALPAAAL
TPVIVGSAL	TPVIVGSAL
SPFEFGFT	SPF-EFGFT
APNERPYSL	APNERPYSL
SPASPLKEL	SPASPLKEL
SPLYRDEL	SPL-YRDEL
IPATPVVIPM	IPATVVIPM
APSAAKLLVQL	APSAAKLLV
RIVPRFSEL	RIVPRFSEL
QPYSGSPANF	QPYSSPANF
GPNERIGMV	GPNERIGMV
SPSAGFSSL	SPSAGFSSL
VPVASGSGF	VPVASGSGF
SPGQRSISL	SPGQRSISL
APASPPTSL	APASPPTSL
YPHAFNVKF	YPHAFNVKF
APPVLKRPIL	APPVKRPIL
YASSPGMSL	YASSPGMSL
SPFYPGKTTY	SPFYPGKTT
SPSGLHSKL	SPSGLHSKL
SPSATASIL	SPSATASIL
RPKQPGPVKL	RPKQGPVKL
SIRQPSLHM	SIRQPSLHM
LPKQPPLAL	LPKQPPLAL
LPSASHFSQL	LPSAHFSQL
GPGLRPSTM	GPGLRPSTM
RPQITINEI	RPQITINEI
APWKAVNTL	APWKAVNTL
TPLYKKKEL	TPLYKKKEL
SPRPSWAPRSL	RPSWAPRSL
SPPTLPGNFL	SPPTPGNFL
FPRKPSAPK	FPRKPSAPK
SPRSSTVHI	SPRSSTVHI
APQLTASRL	APQLTASRL
KPGAKVLYL	KPGAKVLYL
APSGGRLLSA	APSGRLLSA
LPKTGTVSL	LPKTGTVSL
SPPIRKGWSM	SPPIKGWSM
PRPPPKPM	PRP-PPKPM
SPPPGMGL	SPP-PGMGL
QPQHAFNAL	QPQHAFNAL
MPANSGLAL	MPANSGLAL
KPKGAFKAF	KPKGAFKAF
LPRTIFPTSTI	LPRTFPTST
HPKYPDGKTF	HPKYDGKTF
APFSWPAGAL	APFSPAGAL
GPAGGYQTL	GPAGGYQTL
TPMPKDVRQSL	MPKDVRQSL
SPSIKDLPA	SPSIKDLPA
SPKMPLKTL	SPKMPLKTL
GPPPAPSPGL	GPPPPSPGL
RPYEKGRLI	RPYEKGRLI
LPAPTIQSL	LPAPTIQSL
RPIASGPVV	RPIASGPVV
YPSAPFLAA	YPSAPFLAA
VPAAVFGSL	VPAAVFGSL
LPAGGAPTV	LPAGGAPTV
SPNTAGLRSL	SPNTGLRSL
AANPNRFITL	AANPRFITL
MPRQPSATRL	MPRQSATRL
RPAPLSAEL	RPAPLSAEL
APRPASGPIRP	APRPASGPI
FPKEPVEL	FPK-EPVEL
YPHLHNAEL	YPHLHNAEL
APTQEKIFAVL	APTQKIFAV
APAPPPAASF	APAPPAASF
VPQQIKVATL	VPQQKVATL
QVMLMRQDL	QVMLMRQDL
RPDDRSQGAII	RPDDRSQGA
VPRVLGSSV	VPRVLGSSV
SPGARLITI	SPGARLITI
YPAPGLKTFL	YPAPGLKTF
TPSERITSL	TPSERITSL
KPSDVMLVHF	KPSDMLVHF
RPKDWYKTMF	RPKDWYKTM
SPAGEWRALL	SPAGEWRAL
VPRPPQTSL	VPRPPQTSL
SPAVGSIL	SPA-VGSIL
SPDEQKVFALW	SPDEKVFAL
LPQQPPPSL	LPQQPPPSL
SPVSTELGHVL	SPVSELGHV
VPRQPTVTSV	VPRQTVTSV
TPSPVRLHAL	TPSPRLHAL
APQRVRVTL	APQRVRVTL
FPDEFHLQTL	FPDEHLQTL
MPSASRVILL	MPSASRVIL
GPPPFPGVPL	GPPPPGVPL
RPYEPINSI	RPYEPINSI
KPTRKFAYL	KPTRKFAYL
APFQSMQTVF	APFQSMQTV
GPRLPWTRL	GPRLPWTRL
MPKFSMPSL	MPKFSMPSL
LPSQKTASL	LPSQKTASL
TPSIASTHSEL	SIASTHSEL
SPPAPGLQPM	SPPAGLQPM
SPAFKVREF	SPAFKVREF
APGVFGQTTF	APGVGQTTF
FPHLPGKTF	FPHLPGKTF
SPSQIGAF	SPS-QIGAF
MPFQSGEFKAL	MPF-QSGEF
GPILDNSTL	GPILDNSTL
SPRPPIRQW	SPRPPIRQW
FIGYPITL	FIG-YPITL
VPRASVPDGFL	VPRAVPDGF
APAAAVPTL	APAAAVPTL
SPSQIGAFVL	SPSQGAFVL
TPHQTFVRL	TPHQTFVRL
LPSGAILSL	LPSGAILSL
KPYTLMSMV	KPYTLMSMV
KPQTKLLIL	KPQTKLLIL
APGPGLLL	APG-PGLLL
SPWLAGNEL	SPWLAGNEL
APGAPAAVAL	APGAAAVAL
KPSSTTPRL	KPSSTTPRL
QPVYPMSQL	QPVYPMSQL
RPTDKPLRL	RPTDKPLRL
SPLPGLASV	SPLPGLASV
LPGPVTLVM	LPGPVTLVM
SPRPYYPQTPN	SPRPYYPQT
APALQGLSSL	APALGLSSL
APAELKSPF	APAELKSPF
QPGPAPLPL	QPGPAPLPL
KPFLGIGL	KPF-LGIGL
SPDQKKIISL	SPDQKIISL
APPAALPAEL	APPALPAEL
MPKRLPPGF	MPKRLPPGF
RPKLIGEEL	RPKLIGEEL
SVRQPSLHM	SVRQPSLHM
APQPAQVAL	APQPAQVAL
QPATTTARL	QPATTTARL
AVADAIRTSL	AVADIRTSL
GPLPSGPSL	GPLPSGPSL
SPMSIPTNTM	SPMSPTNTM
VPRMPMIWL	VPRMPMIWL
IPRSILMTTF	IPRSLMTTF
APRTLVLLL	APRTLVLLL
RIKQLQNISL	RIKQQNISL
APRLPLPYGFS	APRLLPYGF
LPKPPPGVGL	LPKPPGVGL
QPQPKPQVQL	QPQPPQVQL
GPPLLPKAEL	GPPLPKAEL
YPSLPTPLL	YPSLPTPLL
APAPASISL	APAPASISL
RPSPWRPLVL	RPSPRPLVL
APAGVFGVAF	APAGFGVAF
GPPLQVTSDL	GPPLVTSDL
APWQVVPEL	APWQVVPEL
MPRSQVDEEFL	MPRSVDEEF
APFLRQEFI	APFLRQEFI
QPTNPFLEM	QPTNPFLEM
TAMGLRSWL	TAMGLRSWL
RPDPGRPVGL	RPDPRPVGL
SPIPGQGYL	SPIPGQGYL
QPKSPAHLSL	QPKSAHLSL
SPQLGRAVQL	SPQLRAVQL
RPFLSRESL	RPFLSRESL
QPAEMAAEL	QPAEMAAEL
SPRSSDLVKL	SPRSDLVKL
QPHYRVQLL	QPHYRVQLL
APYPVIKEL	APYPVIKEL
APEEHPVL	APE-EHPVL
VPAGSGPSL	VPAGSGPSL
APTPARPVL	APTPARPVL
IPIGGGTSV	IPIGGGTSV
APPPVTYQGNL	APPPVTYQG
SPAPTITSL	SPAPTITSL
FPVFKAVSF	FPVFKAVSF
SPEPSKIML	SPEPSKIML
SPAPASSPGF	SPAPSSPGF
QPLQVTKDL	QPLQVTKDL
YPNSYFTGL	YPNSYFTGL
APHARNGLSL	APHANGLSL
NVKVDPEIQ	NVKVDPEIQ
FPALQGAQT	FPALQGAQT
KPMEGNFEEI	KPMENFEEI
YPIRVQPARIL	RVQ-PARIL
SPKRDLIAL	SPKRDLIAL
RPAWMRTL	RPA-WMRTL
QPGLPGLVL	QPGLPGLVL
SPRLPVGGFR	SPRLPVGGF
IPYGERITL	IPYGERITL
TPAAVRELVL	TPAARELVL
APPLPPPPVL	APPLPPPVL
APALPPPAF	APALPPPAF
IVDGNHRLTL	IVDGHRLTL
YPAAKRVKL	YPAAKRVKL
KINKKRIAL	KINKKRIAL
SPALASYEF	SPALASYEF
RPMPPEARRL	RPMPEARRL
HPTSHVSLL	HPTSHVSLL
SPREEPRAPW	SPREPRAPW
SPQDFNVAV	SPQDFNVAV
SPLSPTVEL	SPLSPTVEL
YPQASAVTSQL	QASAVTSQL
RPDPAGHLTL	RPDPGHLTL
FPIANGPNL	FPIANGPNL
LPFGPFSTL	LPFGPFSTL
FPSGIIKVF	FPSGIIKVF
TPQGFRSTL	TPQGFRSTL
TPMYGSQTPM	TPMYSQTPM
NPRHPLIRDML	NPRHLIRDM
SPSLGNSSIL	SPSLNSSIL
SPDGSRLLFTV	SPDGSRLLF
LPRVWTDANL	LPRVTDANL
RPKVPVLQL	RPKVPVLQL
HLPETKFSEL	LPETKFSEL
SPHTKPWIGL	SPHTPWIGL
APSFVKGFL	APSFVKGFL
RPSVGVQSL	RPSVGVQSL
KPAFNLSAF	KPAFNLSAF
GPIRVVLVL	GPIRVVLVL
YPRPGTPAA	YPRPGTPAA
QPDQTRIVAL	QPDQRIVAL
RIPSIVSSPL	IPSIVSSPL
APELKIESL	APELKIESL
APRLPITGL	APRLPITGL
LPSTRLGTL	LPSTRLGTL
GPSLAAPAL	GPSLAAPAL
SPSDPSSSL	SPSDPSSSL
LPRPLSPTKL	LPRPSPTKL
RPLPGALGV	RPLPGALGV
FPEKKPRL	FPE-KKPRL
SPTTAFTVL	SPTTAFTVL
VPSVPIQQF	VPSVPIQQF
SPRSPSTTYL	SPRSSTTYL
SPIGPPSLL	SPIGPPSLL
HPVVHPLDL	HPVVHPLDL
APPTQNMPM	APPTQNMPM
RPAERLDYL	RPAERLDYL
LPPFPGPSL	LPPFPGPSL
IPRDPSQQEL	IPRDSQQEL
SPEVPKPAL	SPEVPKPAL
SPQSPGDAL	SPQSPGDAL
TPAGDIMEL	TPAGDIMEL
APLQHRHVL	APLQHRHVL
TARPPGYEF	TARPPGYEF
MPLAEAGAL	MPLAEAGAL
APNRPPAAL	APNRPPAAL
NPMVVANAV	NPMVVANAV
APTPVSPVL	APTPVSPVL
YPAAVPQAL	YPAAVPQAL
VPSEPGGVL	VPSEPGGVL
APAPAEKTPV	APAPEKTPV
SPNEKFLLAV	SPNEFLLAV
NPILASPPTL	NPILSPPTL
GPMGGGLTL	GPMGGGLTL
LPAQSAATL	LPAQSAATL
APHLVGPHL	APHLVGPHL
LPWPPPASV	LPWPPPASV
TPIEGMLSH	TPIEGMLSH
YVASVHQDL	YVASVHQDL
LPKQPAPTTI	LPKQAPTTI
LPSNTKFVAL	LPSNKFVAL
YPAPQVSTAV	YPAPVSTAV
RPSQNNTIGL	RPSQNTIGL
NPIASLGAL	NPIASLGAL
GPPPPGMMPV	GPPPGMMPV
APAGVPALA	APAGVPALA
HPFFGRVVL	HPFFGRVVL
SPFLTITSM	SPFLTITSM
VPMQDPRAAM	VPMQPRAAM
LPYSVGRVL	LPYSVGRVL
NVRIATTAL	NVRIATTAL
LPWPARPAL	LPWPARPAL
SPGLPSTTF	SPGLPSTTF
NPRNFSDNQL	NPRNSDNQL
VPYLRDLGL	VPYLRDLGL
FPKVPGGFSL	FPKVGGFSL
SPMMPRITSVF	SPMMRITSV
VPQLTGGTL	VPQLTGGTL
LPVEPHSDL	LPVEPHSDL
QPITRSTL	QPI-TRSTL
IINAARESL	IINAARESL
RPAPPMKGQL	RPAPMKGQL
SPSPPPGTSL	SPSPPGTSL
VPYPLPKIDL	VPYPPKIDL
APSMDRAAVA	APSMDRAAV
KPFAEVRIL	KPFAEVRIL
RPWLRPAAL	RPWLRPAAL
QPHVNGGPL	QPHVNGGPL
APNFRPTFSL	APNFPTFSL
APLPFGPFSTL	LPFGPFSTL
SPRVPVSPLKF	SPRVPVSPL
SPAGNSPAPL	SPAGSPAPL
LPNPVAVKPL	LPNPAVKPL
GAAPRPPPKPM	APRPPPKPM
QPRPQSTSLL	QPRPQSTSL
SPSDSFSVL	SPSDSFSVL
QPASFAIRL	QPASFAIRL
SPGVMPLSL	SPGVMPLSL
VPAKAKLTKL	VPAKKLTKL
RPQPTAMNSI	RPQPAMNSI
QPMPASSPVI	QPMPASSPV
HPGPVNSEL	HPGPVNSEL
APVASPAAL	APVASPAAL
QPSVLMQL	QPS-VLMQL
APVIRPGGTL	APVIPGGTL
GPSSPWTQL	GPSSPWTQL
HPREPALGP	HPREPALGP
TPAFLPSSL	TPAFLPSSL
LPVPVYLRPL	LPVPYLRPL
SPEVKGYWASL	SPEVKGYWA
RPIWQLSHF	RPIWQLSHF
AARPATSTL	AARPATSTL
YLPDGTASL	YLPDGTASL
LPNVPSIAL	LPNVPSIAL
SPGGAHGML	SPGGAHGML
RPHPWGLLI	RPHPWGLLI
APAPQGVRL	APAPQGVRL
APGLIKTSF	APGLIKTSF
YPQSIFSTF	YPQSIFSTF
LPAAGVGDM	LPAAGVGDM
SPRPNIILGL	SPRPIILGL
MPSRFPPVVF	MPSRPPVVF
APSPPLSGL	APSPPLSGL
SPYAGAAGF	SPYAGAAGF
KPNDSRALQL	KPNDRALQL
SPMFDGKVPH	SPMFDGKVP
TPAPPGPATM	TPAPGPATM
VPQVSTPTL	VPQVSTPTL
LPSPFLRAL	LPSPFLRAL
APAPPPEEVL	APAPPEEVL
YPNPYSKHVL	YPNPSKHVL
SPIIRPLL	SPI-IRPLL
VPAARSILAL	VPAASILAL
MPYGQPRPPIL	MPYGPRPPI
IAAPTSSAL	IAAPTSSAL
LPMGALPQGPM	LPMGALPQG
HPNSNLLDL	HPNSNLLDL
APAGPALGL	APAGPALGL
MPYDSNRVVL	MPYDNRVVL
SPALKTTRL	SPALKTTRL
RLQAQRNEL	RLQAQRNEL
TPTPGHIM	TPT-PGHIM
APASVHSEI	APASVHSEI
VPHGAGYEL	VPHGAGYEL
RPSQAAPAV	RPSQAAPAV
APALRPLVI	APALRPLVI
QPHDRIMGL	QPHDRIMGL
MPRWAERLFPA	MPRWAERLF
RPEDRMFHIRA	RPEDRMFHI
IVDGHERAML	IVDGERAML
QPAKATFAF	QPAKATFAF
APLAVFQML	APLAVFQML
APELQRHEL	APELQRHEL
VPLAQAQAL	VPLAQAQAL
SPSLGNSSI	SPSLGNSSI
AVRDISEASVF	AVRDSEASV
TPRVPSVIRI	TPR-VPSVI
KAASVRPVL	KAASVRPVL
IPSEWHIEL	IPSEWHIEL
TPQQPPTSTF	TPQQPTSTF
FPRPVTVEPM	FPRPTVEPM
SPVFKTVL	SPV-FKTVL
NPAENFRVL	NPAENFRVL
LPALFRDISM	LPALRDISM
TPMPPISSV	TPMPPISSV
RVREIIINAV	RVREIINAV
SPRMPSSGF	SPRMPSSGF
RPRKAFLLLL	RPRKAFLLL
LPAGWKPLF	LPAGWKPLF
SPLSAARAAL	SPLSARAAL
MPHVPITTL	MPHVPITTL
SPAPSKTLM	SPAPSKTLM
SPPLKTSPQL	SPPLTSPQL
APYQFLTAF	APYQFLTAF
YPAFMMEM	YPA-FMMEM
APRAPPGPAGL	APRAPGPAG
KPDSDRFVFL	KPDSRFVFL
QPTGFLAQPM	QPTGLAQPM
MPRMPSRPELL	MPRMSRPEL
APSYLARSL	APSYLARSL
GPDEAKIKALL	GPDEKIKAL
NPHEPWNRL	NPHEPWNRL
QPALKTQFL	QPALKTQFL
FPNKQGYVL	FPNKQGYVL
TANGERWEL	TANGERWEL
LPRPTPQASFL	LPRPPQASF
QVRVVDLEGSL	RVVDLEGSL
AVAPVASAL	AVAPVASAL
VPAPVPLMSL	VPAPPLMSL
VPVAPPTPA	VPVAPPTPA
AAGPVGPAL	AAGPVGPAL
SPYGSSLDL	SPYGSSLDL
APPQEQKQML	APPQQKQML
HPNSNIYNTL	HPNSIYNTL
SPRITFPSL	SPRITFPSL
QPSSPSSLL	QPSSPSSLL
FPKPVTAL	FPK-PVTAL
APVLPHTAV	APVLPHTAV
APPLWELGSL	APPLELGSL
QPTGSVRISF	QPTGVRISF
APSDNRVTSF	APSDRVTSF
NPLFRMEEL	NPLFRMEEL
TPMKPGSATF	TPMKGSATF
LPPLPKRPAL	LPPLKRPAL
GPDNVHVAL	GPDNVHVAL
SPTGGAQLL	SPTGGAQLL
SPMSDVVSREL	SPMSVSREL
QPATPGLGM	QPATPGLGM
KPHSGFHVAF	KPHSFHVAF
LPVLPGDYSIL	LPVLGDYSI
RPTMAFVRL	RPTMAFVRL
RPRPSEDTFL	RPRPEDTFL
SPYPGIDL	SPY-PGIDL
YIDEGRLVL	YIDEGRLVL
RPIGIGVQGL	RPIGGVQGL
RPSPPVQSV	RPSPPVQSV
GPWDPPDNL	GPWDPPDNL
RPLLLNSV	RPL-LLNSV
IPFAAPTAL	IPFAAPTAL
VPYSTSASL	VPYSTSASL
RPRIDLIVF	RPRIDLIVF
APTPIQAL	APT-PIQAL
APLPGFSAV	APLPGFSAV
APGASPGNPL	APGAPGNPL
QPAPPREAHF	QPAPPREAH
LPAFKRKTL	LPAFKRKTL
LPRALGSGF	LPRALGSGF
QIRQFQRSL	QIRQFQRSL
APGEVGSVL	APGEVGSVL
KPVFHVGFL	KPVFHVGFL
TPTPGGLAL	TPTPGGLAL
RPAPHPLFL	RPAPHPLFL
VPEEARPAL	VPEEARPAL
APSLAQPLVF	APSLQPLVF
AAAYPHTSL	AAAYPHTSL
GPRPVLGGSFL	RPVLGGSFL
APAARFNNSQF	APAARFNNS
SPRAAEPVQL	SPRAEPVQL
APIGPHLQSM	APIGHLQSM
TPAPGFSSM	TPAPGFSSM
SPAIGRTSI	SPAIGRTSI
APASLSRSAF	APASSRSAF
DPSGERLAVL	DPSGRLAVL
VPPPPPVAL	VPPPPPVAL
QPNGAGFAAF	QPNGGFAAF
KPSLPFTSL	KPSLPFTSL
QPQQRMSQF	QPQQRMSQF
QPNNVIRQPL	QPNNIRQPL
RPTNPAMQAL	RPTNAMQAL
QPMEVQEGYGF	QPMEVQEGY
SPLPLTAL	SPL-PLTAL
HPQPGAVEL	HPQPGAVEL
NPPAAVKLAL	NPPAVKLAL
SVRQSPGPAL	SVRQPGPAL
IPRILGPGL	IPRILGPGL
SPPVNGQPPL	SPPVGQPPL
KPRPDVTNEL	KPRPVTNEL
IPAKPPVSFF	IPAKPPVSF
SPHGPSAKF	SPHGPSAKF
APGQRVGML	APGQRVGML
YARPSSEVI	YARPSSEVI
QARQPTPPF	QARQPTPPF
SPNYDHVVL	SPNYDHVVL
IPYKPNYSL	IPYKPNYSL
APRTVLLL	APR-TVLLL
APWHPPTLL	APWHPPTLL
LPSAHRVSGL	LPSARVSGL
GIRPPTRTA	GIRPPTRTA
APAGLAGPV	APAGLAGPV
YPTEKGLSF	YPTEKGLSF
VPMNSLRFL	VPMNSLRFL
QPNGGASVI	QPNGGASVI
GPVSPSVSF	GPVSPSVSF
APYPSPVL	APY-PSPVL
VPPPVATPF	VPPPVATPF
FVNDDRHVM	FVNDDRHVM
RPSTPHTITL	RPSTHTITL
TPINKRPVL	TPINKRPVL
LPFGGVPTVL	LPFGVPTVL
FPAYERVVL	FPAYERVVL
RPAFFAERL	RPAFFAERL
APQPYPFTSSL	QPYPFTSSL
QPPHLPAGPH	QPPHPAGPH
SPNAANTIL	SPNAANTIL
TVRQIISKL	TVRQIISKL
SPFLQKQL	SPF-LQKQL
QPYLYKISF	QPYLYKISF
VPVGPHLSL	VPVGPHLSL
APPQISLPPF	APPQSLPPF
TPMFDPSLL	TPMFDPSLL
YPLESRPSL	YPLESRPSL
KPSDLGTKL	KPSDLGTKL
FPRLPPASV	FPRLPPASV
SPAALKPPA	SPAALKPPA
APAVVHIEL	APAVVHIEL
APSPLRLMDL	APSPRLMDL
SPRVYWLGL	SPRVYWLGL
RPAAGFVAGL	RPAAFVAGL
GPHISYPPL	GPHISYPPL
SPDEMELDEL	SPDEELDEL
NPNQNKNVAL	NPNQKNVAL
APAPAPAPAM	APAPPAPAM
YVASYLLAAL	YVASLLAAL
APYSRPKQL	APYSRPKQL
SPEQVVRPKV	SPEQVRPKV
APAPPSSGL	APAPPSSGL
VPATGRTLVL	VPATRTLVL
RPRPPITLL	RPRPPITLL
PVAASLPL	PVA-ASLPL
APRLPLPYGF	APRLLPYGF
SPVLSLSSL	SPVLSLSSL
DPMKARVVL	DPMKARVVL
ALRLPPTSL	ALRLPPTSL
SPGVPGSVF	SPGVPGSVF
IAWPPPTEL	IAWPPPTEL
IPRGPPSPP	IPRGPPSPP
LPETEPPEML	LPETPPEML
LPDLQRSKQAL	LPDLRSKQA
GPYGGGGQYF	GPYGGGQYF
SPSPSGSVL	SPSPSGSVL
RPTFRQMQL	RPTFRQMQL
SPSDRPLSL	SPSDRPLSL
RPVTVFLQL	RPVTVFLQL
TPADVFIV	TPA-DVFIV
TPSKPPAQL	TPSKPPAQL
QPMDIHVEL	QPMDIHVEL
IPRGPASQF	IPRGPASQF
RPSLRLQLL	RPSLRLQLL
SPGLAAPSL	SPGLAAPSL
APAAATVAV	APAAATVAV
YPTSPGPI	YPT-SPGPI
TPELGLIL	TPE-LGLIL
YVVESTGVF	YVVESTGVF
APTVQELAAL	APTVELAAL
APDDPSGFAVL	APDDSGFAV
LPQANRDTL	LPQANRDTL
APPVRPQNSL	APPVPQNSL
FPESERPEM	FPESERPEM
SPIGRDGKL	SPIGRDGKL
RIRMTDGRTL	RIRMDGRTL
APRAALVFAL	APRALVFAL
LPSEHQTIL	LPSEHQTIL
APDVGRMGI	APDVGRMGI
SVRPLVTEL	SVRPLVTEL
IPAIATTTAA	IPAIATTTA
GPAPSRPAL	GPAPSRPAL
RPSFRNLDF	RPSFRNLDF
SPWLLRVEL	SPWLLRVEL
PASKRPPL	PAS-KRPPL
AAAAPSPVM	AAAAPSPVM
SPDLDRIAASM	SPDLDRIAA
LPPPPTSAL	LPPPPTSAL
APINFTSRL	APINFTSRL
LARPAALTAL	RPA-ALTAL
QPSSLLPLAL	QPSSLPLAL
KPAGPPGILAL	KPAGPPGIL
KLAPPSSTL	KLAPPSSTL
APAPVPVLA	APAPVPVLA
APHPPLSVV	APHPPLSVV
APYPTSQM	APY-PTSQM
LPSKPKSPL	LPSKPKSPL
SPYFQRPLAL	SPYFRPLAL
FVRIGAML	FVR-IGAML
APPMGPWGQL	APPMPWGQL
LPIAPSHVIEM	LPIAPSHVI
KPANDITSQL	KPANITSQL
RLQQPRLSL	RLQQPRLSL
RPRPSGEEVL	RPRPGEEVL
YPDFNFVGRIL	YPDFFVGRI
APAAPGLSL	APAAPGLSL
LPAAGVGDMVM	LPAAGVGDM
VPAESAAVL	VPAESAAVL
SPPVQPHTPV	SPPVPHTPV
APSPTHVAEL	APSPHVAEL
APAPPPVAV	APAPPPVAV
APRTIFQRV	APRTIFQRV
NIRNIGKTL	NIRNIGKTL
SPTDPFNRQTL	SPTDNRQTL
MPKVSGPDL	MPKVSGPDL
EPRFVLRAL	EPRFVLRAL
RTPMYGSQTPM	TPMYSQTPM
LPRFQPRVL	LPRFQPRVL
SPAQYQVVL	SPAQYQVVL
LPRLPVPAV	LPRLPVPAV
FPVLGGSSM	FPVLGGSSM
APINKAGSFL	APINKAGSF
APSGLRSQVQF	APSGLRSQV
AAFLSPLLPL	AAFLPLLPL
PSSAPAVST	PSSAPAVST
SVKSPNQSL	SVKSPNQSL
IPRTPLSPSPM	IPRTLSPSP
IPGEPGFPL	IPGEPGFPL
HPYGLGPPSL	HPYGGPPSL
RPSSLPVGPVL	RPSSPVGPV
TPSQIGVIL	TPSQIGVIL
RVAEFHTEL	RVAEFHTEL
SPALPGLKL	SPALPGLKL
APRPAGSYL	APRPAGSYL
RPSGPGPEL	RPSGPGPEL
APDKHHITPLL	APDKHITPL
APTAQKSLSSL	APT-AQKSL
LPSHPLEL	LPS-HPLEL
SPRPDPREAL	SPRPPREAL
SPSRLPATSL	SPSRPATSL
SPMPFHPSQV	SPMPHPSQV
KPIDVSRLDL	KPIDSRLDL
RIPLSGRNPL	IPLSGRNPL
APKIGPLGL	APKIGPLGL
FPMGDRLYI	FPMGDRLYI
MPRWAERL	MPR-WAERL
KPVAPSNVL	KPVAPSNVL
AARPVPWNAL	AARPPWNAL
APSAAPEAL	APSAAPEAL
VARPLSTAL	VARPLSTAL
FPRDPGGLDEV	FPR-DPGGL
APVGVHPSL	APVGVHPSL
VPFPGGSIL	VPFPGGSIL
HPYFYAPEL	HPYFYAPEL
YPEELKPVL	YPEELKPVL
QPMQPHPQHLA	QPMQHPQHL
IPPYPASSL	IPPYPASSL
QPYSGSPANL	QPYSSPANL
GPSSPGLTL	GPSSPGLTL
APMTEIKEL	APMTEIKEL
GPMPQTREHL	GPMPTREHL
VPIRTPARKL	VPIRPARKL
ITDSNRSIATL	SNR-SIATL
TPYPSSASL	TPYPSSASL
VPAPGKLFAL	VPAPKLFAL
QTAPLRAEL	QTAPLRAEL
LVSLGHISM	LVSLGHISM
APFTAGTSL	APFTAGTSL
GVRPVSGDL	GVRPVSGDL
SPRLMSNAL	SPRLMSNAL
APGAPIGNTF	APGAIGNTF
HPIYLATGTSA	HPIYLATGT
APRPLQAGPAM	RPLQAGPAM
TPENLPQIL	TPENLPQIL
SPALPAFLL	SPALPAFLL
RPGLSPYRAL	RPGLPYRAL
RPAFPGYGV	RPAFPGYGV
FPNIPGKSL	FPNIPGKSL
GPLLPGQSF	GPLLPGQSF
SPRLPVGGF	SPRLPVGGF
SPYNVSKTAL	SPYNSKTAL
TPAEVRQVL	TPAEVRQVL
QPKVSTPVV	QPKVSTPVV
LPRIAVNPASL	RIAVNPASL
YPAPGLKTF	YPAPGLKTF
LPASWRPVTL	LPASRPVTL
RPVAPSGTAL	RPVASGTAL
APGEFRAIM	APGEFRAIM
SPISSSSSQL	SPISSSSQL
IPAAPVPSL	IPAAPVPSL
KPMLPPAAF	KPMLPPAAF
APTPAGLSL	APTPAGLSL
YPAQITPKM	YPAQITPKM
KPFGLKVSQL	KPFGKVSQL
APRTVALTALL	APRTALTAL
FPRFSPVL	FPR-FSPVL
LPRMPWAM	LPR-MPWAM
SPLLPGLSF	SPLLPGLSF
RPLEMIEPRTL	RPLEEPRTL
SPIVPDLGL	SPIVPDLGL
QPYGRSPSAV	QPYGSPSAV
RPTGGVGAVAL	RPTGGVGAV
TPFGGRLLVL	TPFGRLLVL
APRPLQPYLRL	APRPLQPYL
GPMNLRAAF	GPMNLRAAF
AAFRIVVM	AAF-RIVVM
TPRPPPVGHSF	RPPPVGHSF
RPADYLFML	RPADYLFML
APRPPFSTM	APRPPFSTM
HPYPPGPGVAL	YPPGPGVAL
APGGTGIVSA	APGGGIVSA
SPPQLPKAMF	SPPQLPKAM
HPRSPTPTL	HPRSPTPTL
RPYLSAVRATL	RPYLVRATL
RPQIHGYDL	RPQIHGYDL
SPAAATTVL	SPAAATTVL
APRTVLLLLSA	APRTVLLLL
YPMAVGLNKGH	YPMAVGLNK
RPAPPPEAL	RPAPPPEAL
APRQVLDLEDL	APR-QVLDL
VPSKPPMSL	VPSKPPMSL
GPRSSLRVL	GPRSSLRVL
SPHIPYKLL	SPHIPYKLL
LPEAKKPRL	LPEAKKPRL
SPFSFHHVL	SPFSFHHVL
LPAEGVKEL	LPAEGVKEL
APTFTGSFL	APTFTGSFL
LPLPYGFSAM	LPLPGFSAM
LPAGSGNAL	LPAGSGNAL
SPLTKSISL	SPLTKSISL
APPSKPTVL	APPSKPTVL
APGIRDHESL	APGIDHESL
LPSLRILYM	LPSLRILYM
GPSAPFSTL	GPSAPFSTL
SPRNEVEAL	SPRNEVEAL
KPKDKVSLI	KPKDKVSLI
APSQQQPML	APSQQQPML
YPFKPPKVTF	YPFKPKVTF
SPTHPGEGL	SPTHPGEGL
APHGPGSLTTL	APH-GPGSL
APTPVLAP	APT-PVLAP
SPIKLTPTSVL	SPIKTPTSV
TPYGGVKL	TPY-GGVKL
HPRYFGPNL	HPRYFGPNL
HPRVGDLIL	HPRVGDLIL
YPMPADQRRHV	MPADQRRHV
EPIPKGPVL	EPIPKGPVL
SPLPGDGITF	SPLPDGITF
QPQPGIGL	QPQ-PGIGL
HPARPTVESF	HPARTVESF
LPATATMSL	LPATATMSL
SPASPKISL	SPASPKISL
MPKKNRIAI	MPKKNRIAI
TPITHISQL	TPITHISQL
APSSVPSGL	APSSVPSGL
TPRPGSAESAL	RPGSAESAL
VPASFRLQM	VPASFRLQM
RAQRPRLQL	RAQRPRLQL
RPFHGWTSL	RPFHGWTSL
APSVIGSNL	APSVIGSNL
QPPVSPGTAL	QPPVPGTAL
QPMESNPSIVL	QPMESNPSI
YPSLPTMTV	YPSLPTMTV
QPFLHETL	QPF-LHETL
APSSGVQPTL	APSSVQPTL
SPPTPIRSVL	SPPTIRSVL
SPAGTRGGFVL	SPAGTRGGF
GPESRPTEL	GPESRPTEL
NPQERTLTL	NPQERTLTL
HPVAASLPL	HPVAASLPL
PPGMRPPM	PPG-MRPPM
SPPSQPAVAL	SPPSPAVAL
YPREQINQL	YPREQINQL
APALPGPAL	APALPGPAL
APRKPDWDL	APRKPDWDL
APTAGLAAL	APTAGLAAL
QPMNPTQNM	QPMNPTQNM
LPSLRILY	LPS-LRILY
LPRSLGKLTKL	LPR-SLGKL
HPALKGLGL	HPALKGLGL
NPFLFRQVL	NPFLFRQVL
SPATPFQSV	SPATPFQSV
VPQVPGPVT	VPQVPGPVT
TPVTGASL	TPV-TGASL
APVPMPDL	APV-PMPDL
SPPRWPRLLL	SPPRPRLLL
EPMTMFLWTL	EPMTFLWTL
NPRLNILDTL	NPRLILDTL
IPSGSVTAL	IPSGSVTAL
IPSSHPVSL	IPSSHPVSL
IVAQSGPAL	IVAQSGPAL
GPESRTISL	GPESRTISL
TPYGGVKLEDL	TPY-GGVKL
SPRTPPPLTV	SPRTPPLTV
NVRPVPLEL	NVRPVPLEL
APAGGTLLL	APAGGTLLL
MPKMDQDSL	MPKMDQDSL
SPEIRPSQL	SPEIRPSQL
TPAPVPTSL	TPAPVPTSL
LPRREGYEF	LPRREGYEF
NPDIPNPAL	NPDIPNPAL
RPWALSVTM	RPWALSVTM
APRTVSVQTL	APRTSVQTL
SPPYSSPQEF	SPPYSPQEF
KPRNVVFVDM	KPRNVFVDM
SPTGSLPLVM	SPTGLPLVM
SPTQVVSQL	SPTQVVSQL
TPAVHASL	TPA-VHASL
RPKLPEDPLL	RPKLEDPLL
APMSPSTAL	APMSPSTAL
APLLRWVL	APL-LRWVL
RPRIPSPIGF	RPRISPIGF
MPLLNGPAL	MPLLNGPAL
APDAAPAPASI	APDAAPAPA
RPRLSAILF	RPRLSAILF
VIRELSRAL	VIRELSRAL
NPASPPLSL	NPASPPLSL
LPGSGKSTL	LPGSGKSTL
RPKGLGVFF	RPKGLGVFF
GPWKPTPSV	GPWKPTPSV
SPFSYKNVL	SPFSYKNVL
SPGSPSLGL	SPGSPSLGL
QPWNSDSTL	QPWNSDSTL
RPIKPSPPY	RPIKPSPPY
LLRTVVSVL	LLRTVVSVL
LPVVLPQSTL	LPVVPQSTL
RPVSSTGINF	RPVSTGINF
SPSLPNITL	SPSLPNITL
VPAGGAVAV	VPAGGAVAV
SAAFPGASL	SAAFPGASL
SPMSADRVVAF	SPMSDRVVA
QLMSNPEM	QLM-SNPEM
KPFLLGTVF	KPFLLGTVF
SPTIALPML	SPTIALPML
MPTIPALAL	MPTIPALAL
LPTSPGPAL	LPTSPGPAL
KPIPSNIDKSL	IPSNIDKSL
RPFNALKTKNM	RPFNALKTK
APAPSKGQTL	APAPKGQTL
LVRPPTEQA	LVRPPTEQA
TPNSGYTQSQF	TPNSYTQSQ
SPGLGGPL	SPG-LGGPL
IPAKVVREVL	IPAKVREVL
SPYLRPLTL	SPYLRPLTL
RPLYKNIVL	RPLYKNIVL
IPMPPPPLGL	IPMPPPLGL
RPHHKILDM	RPHHKILDM
LPSDLRTISL	LPSDRTISL
LPRPPPPEM	LPRPPPPEM
GPRTPTQPLL	GPRTPTQPL
TPRLPARLI	TPRLPARLI
VPRNPTIGDKF	VPRNPTIGD
QIQHPTASL	QIQHPTASL
RPPLPPKPQF	RPPLPKPQF
VISLEGKPL	VISLEGKPL
SPALKQIEI	SPALKQIEI
SPANLPAVL	SPANLPAVL
RPSLPLPHF	RPSLPLPHF
RPIAPAPPSTL	APA-PPSTL
SPMSQRPVLKV	SPMSQRPVL
APSPLSSSL	APSPLSSSL
SVDPYERPAL	SVDPERPAL
APRPTPRPVPM	APRPTPRPV
APRQPGLMAQM	APRQPGLMA
RPDITHQSL	RPDITHQSL
LPASVHPQL	LPASVHPQL
SPYQNIKIL	SPYQNIKIL
APGGAPTPAL	APGGPTPAL
SPDTAIRSGL	SPDTIRSGL
SPGPEKMAL	SPGPEKMAL
SPFFRNLL	SPF-FRNLL
GPLSVLTQSV	GPLSLTQSV
APDRGWMAL	APDRGWMAL
RPRFPLFGGW	RPRFLFGGW
APAAAGAAL	APAAAGAAL
SPAGPILSI	SPAGPILSI
RPGPWRPLV	RPGPWRPLV
SPYLPNGSL	SPYLPNGSL
KPVIPAAVL	KPVIPAAVL
NPNSGVLSL	NPNSGVLSL
APRGTWSTGL	APRGWSTGL
QPGTVGNTL	QPGTVGNTL
RPNDSRMLV	RPNDSRMLV
IPSPGLMV	IPS-PGLMV
GAAVRIGSVL	AVR-IGSVL
QPAPPSGYF	QPAPPSGYF
APVYMAAVL	APVYMAAVL
RPASYQSVSV	RPASQSVSV
SPMDGTSSAL	SPMDTSSAL
RLPVVLPQSTL	LPVVPQSTL
RPIAPKWKVM	RPIAKWKVM
APSEYRYTL	APSEYRYTL
RPAEVGGMQL	RPAEGGMQL
TVGPISVAM	TVGPISVAM
SPIQKPQGL	SPIQKPQGL
KPVHGLIFL	KPVHGLIFL
FPWEVPKKL	FPWEVPKKL
YPSLPTMT	YPS-LPTMT
LPRKPPGLAA	LPRKPGLAA
FPSIVGRPR	FPSIVGRPR
APRVLQQTL	APRVLQQTL
TPHVVGSRF	TPHVVGSRF
TAAPVPTTL	TAAPVPTTL
APRSFHPPAAM	APRSHPPAA
IPVMGGLAL	IPVMGGLAL
TPGPAGSRL	TPGPAGSRL
APGAWSQVAV	APGASQVAV
APAAPSATAL	APAASATAL
VPSAVALVL	VPSAVALVL
TANVPQTVPM	TANVQTVPM
LPSTPGLGM	LPSTPGLGM
RPIRQILYL	RPIRQILYL
SPVRLPLNSSL	SPVRLNSSL
RLPSKPKSPL	LPSKPKSPL
APASRLLAL	APASRLLAL
GPIYEGLIL	GPIYEGLIL
SPQGSPEPLVL	SPQGSPEPL
SPITGEKIPA	SPITEKIPA
APAPESITL	APAPESITL
APYPLYPAEL	APYPYPAEL
SPVLISQL	SPV-LISQL
HPISSEELLSL	HPISSEELL
KPAPLLESPF	KPAPLESPF
APRAGTPGF	APRAGTPGF
APMFSWPRL	APMFSWPRL
SPAAPSPLA	SPAAPSPLA
APKKPTGVDL	APKKTGVDL
IPHMDIEAL	IPHMDIEAL
RPFPVPSSL	RPFPVPSSL
SPSTNRGPIQM	SPSTNRGPI
LPTVPGSSI	LPTVPGSSI
APTPAPSTI	APTPAPSTI
APAPVGPLVGL	APVGPLVGL
IPRPIQKSL	IPRPIQKSL
SPPLVGSSAL	SPPLGSSAL
QPSSFRSVIGL	QPSSFRSVI
HPNGNITEL	HPNGNITEL
GPNVTKITL	GPNVTKITL
LPTPLPGF	LPT-PLPGF
RPFGLSTENF	RPFGSTENF
SPRENILVSL	SPREILVSL
KPTDEKLREL	KPTDKLREL
SPNNPFSRVAL	NPF-SRVAL
IPNFPRSTV	IPNFPRSTV
APAPGAPLL	APAPGAPLL
TPIAVGTVI	TPIAVGTVI
APIDLLYEL	APIDLLYEL
VPKLVSEYM	VPKLVSEYM
VPDDDRSLINL	VPDDDRSLI
SPEPPPPPML	SPEPPPPML
APFSLEYRVFL	APFSEYRVF
RPGIRLLSV	RPGIRLLSV
APAPPSSGLG	APAPPSSGL
VPVLPKISL	VPVLPKISL
SPLLTGQIL	SPLLTGQIL
TPAPSRTASF	TPAPRTASF
HPIGMSGARIV	HPIGSGARI
SPVVKGNAL	SPVVKGNAL
APGPSGQSV	APGPSGQSV
SPQQVMGSL	SPQQVMGSL
TPGPVFVEL	TPGPVFVEL
RVRFLEQQTL	RVRFEQQTL
SPRDITTIKL	SPRDTTIKL
APAYLPRSL	APAYLPRSL
SPALQIRTVL	SPALIRTVL
QVDPKKRISM	QVDPKRISM
TPAVGPPL	TPA-VGPPL
LPRSIGNLTQL	LPR-SIGNL
APAVVHIELF	APAVVHIEL
APAAFGLVSF	APAAGLVSF
NPPGLTGVSF	NPPGTGVSF
LPFDRTTVM	LPFDRTTVM
NPYFPGQAIAM	NPYFPGQAI
TPFPLPTEL	TPFPLPTEL
TPGPVGLAL	TPGPVGLAL
APRLMITHI	APRLMITHI
SPPTFGGSPG	SPPTFGGSP
KPDQQKLQAL	KPDQKLQAL
APVGIRHRL	APVGIRHRL
VPDERRYSL	VPDERRYSL
LPSRPPSQL	LPSRPPSQL
PPVSPGTAL	PPVSPGTAL
APAQLPLVL	APAQLPLVL
KPVSLGQAL	KPVSLGQAL
APEEHPVLL	APEEHPVLL
SPSPVPLLF	SPSPVPLLF
MPKFSVSGL	MPKFSVSGL
RPVNLMGTSL	RPVNMGTSL
IPQGGRGAIQF	IPQGGRGAI
KPRSPPRAL	KPRSPPRAL
FLPRQPPMSL	LPRQPPMSL
APGLAWGPL	APGLAWGPL
LIRPVSASF	LIRPVSASF
APRPDRLVNRL	RPDRLVNRL
FPAEDWAGL	FPAEDWAGL
VPNAGRGLVRL	VPNAGRGLV
GPPGLPPRPPL	PPGLPRPPL
APSPLPKM	APS-PLPKM
VPNNKITVV	VPNNKITVV
APALPLSAI	APALPLSAI
VPIQSSVVL	VPIQSSVVL
FPHEPWLRL	FPHEPWLRL
KPMPPRPPLP	KPMPPRPPL
LPRQGFPIIF	LPRQFPIIF
HPPMILPLPL	HPPMLPLPL
SPGPPAPHM	SPGPPAPHM
GPASATPAL	GPASATPAL
APREGISQEAL	APREISQEA
VPTLTGAF	VPT-LTGAF
SPQGRLSDVL	SPQGLSDVL
GPVYPHPVL	GPVYPHPVL
LPTWRPTSM	LPTWRPTSM
QPIDVTVT	QPI-DVTVT
APGLFGTPL	APGLFGTPL
LPLHKVKSL	LPLHKVKSL
NPREWTPEI	NPREWTPEI
LIHEVTKVL	LIHEVTKVL
SPFLPGFSQSL	SPFLFSQSL
APALALPAPA	APALLPAPA
APGAFIASL	APGAFIASL
KPVIPAAAL	KPVIPAAAL
VPYGKGPSF	VPYGKGPSF
RPPVDIRENL	RPPVIRENL
TPALKYQQL	TPALKYQQL
VVKMPSGEF	VVKMPSGEF
SPMPWKGVTV	SPMPKGVTV
SPNKLYTL	SPN-KLYTL
NPIVPSFDM	NPIVPSFDM
RPRDDGLMDL	RPRDGLMDL
SPGAPGPLT	SPGAPGPLT
SPAIGAYL	SPA-IGAYL
SPNLRLLDL	SPNLRLLDL
SPAPPLPSVM	SPAPPLPSV
SPPQPVVPA	SPPQPVVPA
LPAPLPGL	LPA-PLPGL
LVNEVTEFAK	LVN-EVTEF
KPNTSVQFL	KPNTSVQFL
SPVPVSDTQKL	VPVSDTQKL
IVRFGSSKI	IVRFGSSKI
FLYPFPLAL	FLYPFPLAL
LPQLPITNF	LPQLPITNF
SPAFSTRVL	SPAFSTRVL
KPIPIIPTAL	KPIPIPTAL
QPQRFKDEL	QPQRFKDEL
LPPPPPPAM	LPPPPPPAM
QPSAKVSVM	QPSAKVSVM
SPFPTSTPL	SPFPTSTPL
LVRPVFGEL	LVRPVFGEL
AAAAPSPVL	AAAAPSPVL
SPYGPYTGQVL	SPYGYTGQV
KAMPYRLLL	KAMPYRLLL
YPKGAGEML	YPKGAGEML
SPGLPMSDL	SPGLPMSDL
YPAGSQVM	YPA-GSQVM
APAPAPLSV	APAPAPLSV
SPKGKFSLF	SPKGKFSLF
IPLAKDFYVAF	LAKDFYVAF
APYFSGSSTF	APYFGSSTF
YAYDGKDYIAL	YDGKDYIAL
KPRPIIPML	KPRPIIPML
LPQPDVFPLF	LPQPDVFPL
SPLPVGQNSL	SPLPGQNSL
SPNQKLLAVSL	SPNQKLLAV
SPYPWPLNHIL	YPWPLNHIL
QLQDARQSL	QLQDARQSL
NTALSRALSQL	ALSRALSQL
RPHPQRFTY	RPHPQRFTY
LPSSSGPGL	LPSSSGPGL
SPWSISSTM	SPWSISSTM
SPNAIFKAL	SPNAIFKAL
HPADSVVSVL	HPADVVSVL
TPRLPQRNL	TPRLPQRNL
YPHNGMIDL	YPHNGMIDL
APFLRIAF	APF-LRIAF
IPAVGSSL	IPA-VGSSL
RPAQPQEHPF	RPAQQEHPF
APKRPPSAF	APKRPPSAF
QPPRTQTPPL	QPPRQTPPL
KVRAVFDNL	KVRAVFDNL
KPKAPPPSL	KPKAPPPSL
NPRYFPMSL	NPRYFPMSL
APVAVWAAL	APVAVWAAL
LPALRVLDL	LPALRVLDL
APYRDLPASL	APYRLPASL
LPRQPPMSL	LPRQPPMSL
RPKDFLSKF	RPKDFLSKF
LPPGLAVKEL	LPPGAVKEL
FPHPLPSL	FPH-PLPSL
RPGAHPLSF	RPGAHPLSF
SPIGKSPYTL	SPIGSPYTL
KPSPIYGGL	KPSPIYGGL
GPDELRPML	GPDELRPML
SPSLPKKSL	SPSLPKKSL
APLLDVFSSM	APLLVFSSM
IPQPPILQL	IPQPPILQL
RPNDSRMLVAL	RPNDSRMLV
QPDVNLKTL	QPDVNLKTL
APKAFIISF	APKAFIISF
NPKQPTNPF	NPKQPTNPF
RPALFANLF	RPALFANLF
SPLEHGTPF	SPLEHGTPF
RPPYYTPNQL	RPPYTPNQL
FPAEPLEL	FPA-EPLEL
NPRDLPLMAL	NPRDPLMAL
SPSPVLRLVL	SPSPLRLVL
APAPAPASAL	APAPPASAL
APALGRLSV	APALGRLSV
APAPVPVL	APA-PVPVL
NPGVPPATM	NPGVPPATM
VPRAAFLSPLL	VPRAFLSPL
TPISQAQKL	TPISQAQKL
VPGQAKDEL	VPGQAKDEL
KPSESIYSAL	KPSEIYSAL
LVRIPTMTL	LVRIPTMTL
RIFSRFNAL	RIFSRFNAL
RPSHFLNFALL	RPSHLNFAL
SPRPPLGSSL	SPRPLGSSL
SPFFRALL	SPF-FRALL
APRLQSEVAEL	APRLQSEVA
APRLLQFPEL	APRLQFPEL
GPAVGPRGNL	GPAVPRGNL
SPWKPPTYL	SPWKPPTYL
IPASKVFSL	IPASKVFSL
SPRVGGFGF	SPRVGGFGF
SPKQIGEHL	SPKQIGEHL
SPIGASGVA	SPIGASGVA
GPLPALRVL	GPLPALRVL
SPTQLPIL	SPT-QLPIL
LPVGTGTSL	LPVGTGTSL
SPSWRSTTVL	SPSWSTTVL
SPNPSLLHL	SPNPSLLHL
APPDTTLLGI	APP-DTTLL
RPMPGMQQQM	RPMPMQQQM
YPQFSGQSF	YPQFSGQSF
SPHPGLLLDL	SPHPLLLDL
SPIVPSFDM	SPIVPSFDM
KPLSNMKIL	KPLSNMKIL
SPQGPGALF	SPQGPGALF
SPRMEKALSQL	SPR-MEKAL
SPSAYVLE	SPS-AYVLE
APVPAAAAV	APVPAAAAV
SPILPITEF	SPILPITEF
RPRPSWITTM	RPRPWITTM
IPSIQSRGL	IPSIQSRGL
SPSSVTGNAL	SPSSTGNAL
SPNSKVNTL	SPNSKVNTL
LPYDVTPEQAL	LPYDTPEQA
VPRPPSLLATL	RPPSLLATL
NPRIPYTEL	NPRIPYTEL
QPFFQKRSEL	QPFFKRSEL
APRPVAVAV	APRPVAVAV
APMSAAHQL	APMSAAHQL
APIGSGLSDL	APIGGLSDL
AVRDLMANL	AVRDLMANL
FPAVGMHSL	FPAVGMHSL
SPRQPRLDF	SPRQPRLDF
AVAEVRPSL	AVAEVRPSL
IPQPTPASL	IPQPTPASL
RPYYSGLMRRL	RPY-YSGLM
LPPEIVPATL	LPPEVPATL
SPHLPPSSYF	SPHLPSSYF
RPAEYDPKAL	RPAEDPKAL
VPIGTPPKQM	VPIGPPKQM
IPRPLSPTKL	IPRPSPTKL
SPHDVSSVL	SPHDVSSVL
GPNERIGMVV	GPNEIGMVV
MPDGQFKDISL	MPDGQFKDI
SPSEVFTKIRL	SPSEVFTKI
SPSISPNTSF	SPSIPNTSF
GPRLTVKAL	GPRLTVKAL
SPTSVRQMAL	SPTSRQMAL
IPRGPPSPPA	IPRGPSPPA
QPANKGFRAL	QPANGFRAL
LPAVPAVTL	LPAVPAVTL
RVREITENL	RVREITENL
APKPPFQSHF	APKPPFQSH
IPRPKPAPL	IPRPKPAPL
MPFYNPAQL	MPFYNPAQL
SPQFQQAL	SPQ-FQQAL
QPFAWKKKAL	QPFAKKKAL
FPAIPSALGF	FPA-IPSAL
SPSWRLTGF	SPSWRLTGF
GPTQPPLSL	GPTQPPLSL
APRDWKATL	APRDWKATL
SPMFGDKDSL	SPMFDKDSL
QPIHPSGSL	QPIHPSGSL
KPKFSGFTF	KPKFSGFTF
HPRTSITVVL	HPRTITVVL
NPDLMRQLIM	NPDLMRQLI
KPISIAGGF	KPISIAGGF
RPAQLHIGF	RPAQLHIGF
APAPKAYVL	APAPKAYVL
QPRYPVNSVNI	QPRYPVNSV
SPMGSTEDL	SPMGSTEDL
SPGSPLHSL	SPGSPLHSL
SPQEFIHEL	SPQEFIHEL
SPDATIRIW	SPDATIRIW
SPVKSTTSI	SPVKSTTSI
LPNQLFRTF	LPNQLFRTF
APAPTPIL	APA-PTPIL
LPSPTATSQL	LPSPATSQL
APKANGTSAL	APKAGTSAL
SPNSQALIL	SPNSQALIL
FPYYPSPGVLF	FPYYSPGVL
NPISTVTEL	NPISTVTEL
VPSEPKLSL	VPSEPKLSL
SPIKVTLAT	SPIKVTLAT
RPSGLIRTYL	RPSGIRTYL
APASGYLT	APA-SGYLT
APAGLGGAL	APAGLGGAL
RPASPSLQLL	RPASPSLQL
SPQGRVMTI	SPQGRVMTI
TPSEPHPVL	TPSEPHPVL
QPHMVLSSF	QPHMVLSSF
SPTNFPAVL	SPTNFPAVL
RPAPLVSGDL	RPAPVSGDL
SPAESLLLAL	SPAELLLAL
RPHSSLREL	RPHSSLREL
RPSMSPTPL	RPSMSPTPL
HPRPPIPLSL	HPRPIPLSL
TPRVPDNSL	TPRVPDNSL
APAAVALVL	APAAVALVL
RPVQKLLRL	RPVQKLLRL
MPAVGFLL	MPA-VGFLL
SPSPVPLL	SPS-PVPLL
APGEFRAIMEM	APGEFRAIM
LPVPDPILL	LPVPDPILL
YPLGGQTNL	YPLGGQTNL
SPASKAARESL	SPASARESL
TPRDQQGPGTL	TPRDQGPGT
VPVHPPPPL	VPVHPPPPL
IPQERGLSSL	IPQEGLSSL
QPKQPIKTTM	QPKQIKTTM
SPTQPIQL	SPT-QPIQL
TPIQGTSEL	TPIQGTSEL
RPIDTSRLTKI	RPI-DTSRL
IPQLQGYL	IPQ-LQGYL
APSESFVVL	APSESFVVL
APSIPTPAY	APSIPTPAY
SPIYGGLVL	SPIYGGLVL
GPTEGRPQL	GPTEGRPQL
IPYEGFASL	IPYEGFASL
SPANPAHIL	SPANPAHIL
PVSPGTAL	PVS-PGTAL
APPANPPSGL	APPAPPSGL
APPSQGPPGPL	PPSQPPGPL
RPKPSSSPVIF	RPKPSSSPV
QPPSIRNGL	QPPSIRNGL
MPKPPNLIM	MPKPPNLIM
SPVPLPPV	SPV-PLPPV
INAKSRAEAAL	NAKSAEAAL
VLMTQQPRPVL	MTQQPRPVL
SPAIFGVL	SPA-IFGVL
MPVILTPL	MPV-ILTPL
QPAPPSGYFM	QPAPPSGYF
GPIYPGHGM	GPIYPGHGM
KPSSWLRTL	KPSSWLRTL
APGPSVSL	APG-PSVSL
APSSYDPLAL	APSSDPLAL
NPDIMRQTLEL	NPDIMRQTL
APLSGPVL	APL-SGPVL
SPRSSTVHIL	SPRSTVHIL
LPRPHASIMF	LPRPHASIM
LPEENREAAY	LPEENREAA
NPNMRLSQL	NPNMRLSQL
VVAPAGITL	VVAPAGITL
LPRMPWAMI	LPRMPWAMI
KPGYHAPVAL	KPGYAPVAL
SPDGPFINL	SPDGPFINL
APKVEADVSL	APKVADVSL
RPSSHPLIF	RPSSHPLIF
APMIKKIAF	APMIKKIAF
LPSEGQPAL	LPSEGQPAL
SSAPPGPTL	SSAPPGPTL
YPTMAKVAEL	YPTMKVAEL
TPTPLGGMTGF	TPLGGMTGF
APSDLRTIQTF	APSDRTIQT
IPKDLAGSII	IPKDLAGSI
RPILPANQKL	RPILANQKL
SPISHFLDL	SPISHFLDL
GPPSPPAPVM	GPPSPAPVM
APLPIPSNL	APLPIPSNL
LPRLLPAL	LPR-LLPAL
APSSVLRIIVL	APSSLRIIV
QPRSPVPSAF	QPRSVPSAF
QPAGFREGI	QPAGFREGI
RPAAIPIEI	RPAAIPIEI
SPRLPAREL	SPRLPAREL
RPAPLVQQL	RPAPLVQQL
APDSQRLKLL	APDSQRLKL
QPINFSVSL	QPINFSVSL
VPTANVSV	VPT-ANVSV
LPAGAASTL	LPAGAASTL
SPLLSVTSF	SPLLSVTSF
APKPKWTQL	APKPKWTQL
APAFRDYVAV	APAFDYVAV
SPTYKGLLM	SPTYKGLLM
SPHPLLQL	SPH-PLLQL
SPVPSSPF	SPV-PSSPF
LPRPVPLVA	LPRPVPLVA
RPDSPAHVL	RPDSPAHVL
SPDKIPWSAL	SPDKPWSAL
GPRFTLKLRSL	GPR-FTLKL
APVSGVVL	APV-SGVVL
LPLAHVLEL	LPLAHVLEL
RPFGAESNWSL	RPFGAESNW
SPVPTTPFL	SPVPTTPFL
RPVTPITNF	RPVTPITNF
STDPFRPAL	STDPFRPAL
QPGLERAQQEL	QPGLERAQQ
APPNTPVVM	APPNTPVVM
SPYPEAVEL	SPYPEAVEL
APRQPGLMA	APRQPGLMA
YPFKPPKITF	YPFKPKITF
FPASAALAPA	FPASALAPA
SPFFSPIHL	SPFFSPIHL
YPIGTNAIV	YPIGTNAIV
QPPPLPGQTL	QPPPPGQTL
LVVYPWTQRF	VVYPWTQRF
IPNFWVTTF	IPNFWVTTF
SPITGRSKL	SPITGRSKL
IPIAVGGAL	IPIAVGGAL
HPAAFPLPV	HPAAFPLPV
IPYHSEVPVSL	YHSEVPVSL
LPAEFFEVL	LPAEFFEVL
HPMGGLNAM	HPMGGLNAM
APRPFGSVF	APRPFGSVF
NPLGDPQSQM	NPLGPQSQM
GARPPRLPL	GARPPRLPL
TPAEVRQVLAL	TPAEVRQVL
KPPADYKPPA	KPPAYKPPA
YPQGQAPPL	YPQGQAPPL
SPHATAQGL	SPHATAQGL
YPRLKVLAF	YPRLKVLAF
VPRAPSGAVL	VPRASGAVL
APAVVPGSL	APAVVPGSL
GPLPEPRPL	GPLPEPRPL
APAPRPSLLGL	APAPRPSLL
LPPDITEEEM	LPPDTEEEM
APIQQPVKSM	APIQPVKSM
MPRGVVVTL	MPRGVVVTL
LPWASTHSL	LPWASTHSL
IPHIHKSL	IPH-IHKSL
LPRPTPQASF	LPRPPQASF
SPTPSPSPVL	SPTPPSPVL
LPRKPVAGAL	LPRKVAGAL
FPNKPPLTF	FPNKPPLTF
SPGWVRLAL	SPGWVRLAL
QPQGHLLLI	QPQGHLLLI
QPHVGDYRQL	QPHVDYRQL
LPNDVISSL	LPNDVISSL
SPALTLAQPL	SPALLAQPL
APIMSGQGL	APIMSGQGL
APREPLEPQVL	APRELEPQV
IREAGGAF	IRE-AGGAF
SPEAIKQLL	SPEAIKQLL
AVRIPGGPA	AVRIPGGPA
APAPSTVHF	APAPSTVHF
APVPPPTSL	APVPPPTSL
KPGPVGPEL	KPGPVGPEL
GPLGPWGSM	GPLGPWGSM
SVDGTRTNVYL	SVDGTRTNV
VPAPSPLSA	VPAPSPLSA
RPVYEGPSM	RPVYEGPSM
SPFSGTMTV	SPFSGTMTV
APDSALRQLL	APDSLRQLL
YPRFPPIQSI	YPRFPIQSI
HPRDFFSRL	HPRDFFSRL
FPRAPSTSDSV	FPRAPSTSD
NPVSWVQTF	NPVSWVQTF
NPDIMRQTLEI	NPDIMRQTL
NPRSVTLLI	NPRSVTLLI
RVADFGSATF	RVADGSATF
SPNPASAHL	SPNPASAHL
QPSGGQIHTGM	QPSGGQIHT
SPASRSISL	SPASRSISL
RPAFFSPSL	RPAFFSPSL
MPDSLRSGEYL	MPDSRSGEY
FPRAPSTSDS	FPRAPSTSD
MPRLVPQTAF	MPRLPQTAF
TPAPPTHAL	TPAPPTHAL
LPRLAFPL	LPR-LAFPL
APQPAKPRL	APQPAKPRL
TPMGPGRTV	TPMGPGRTV
LPAPPAPPV	LPAPPAPPV
SPNQKLLAV	SPNQKLLAV
HPPGPAVQL	HPPGPAVQL
SINAQRNAL	SINAQRNAL
VPASGLTVM	VPASGLTVM
RPSASTQAL	RPSASTQAL
LPVPTGGPA	LPVPTGGPA
YPQAVPQGL	YPQAVPQGL
SPLNRAGLL	SPLNRAGLL
QPLATTPL	QPL-ATTPL
IPMPFSSSSL	IPMPSSSSL
RPINALDEL	RPINALDEL
LPSDSHFKITF	LPSDSHFKI
HPRLPMAQF	HPRLPMAQF
SADGMRLAL	SADGMRLAL
SVKPASSSF	SVKPASSSF
YPFGTGGSAM	YPFGGGSAM
KPLDNASKL	KPLDNASKL
SPPAELPSL	SPPAELPSL
APNLGRSFHIL	APN-LGRSF
RPAEYDPKALM	RPAEDPKAL
VPRGQGSQF	VPRGQGSQF
APSPAALGAF	APSPALGAF
TVFSFGSSSL	TVFSGSSSL
RTIAKRLVL	RTIAKRLVL
YPPALGSPGAL	PPALSPGAL
RPKTFGMDM	RPKTFGMDM
TPFGGASSSF	TPFGASSSF
LPSVAFPTAM	LPSVFPTAM
KPKIQHVGL	KPKIQHVGL
VPRVPTHTL	VPRVPTHTL
MVRRFLVTL	MVRRFLVTL
AARWVAKSL	AARWVAKSL
SPGVMGTSV	SPGVMGTSV
APSADAPMFVM	APSADAPMF
SPALQTPSL	SPALQTPSL
APATSPSVAL	APATPSVAL
APSRNGMVL	APSRNGMVL
QPASAPPMM	QPASAPPMM
APPAATAQVL	APPATAQVL
SPIKLTPTSV	SPIKTPTSV
APDSQRLKL	APDSQRLKL
YPSINPPTL	YPSINPPTL
TPSPPGTVL	TPSPPGTVL
IPAISSGVF	IPAISSGVF
TPRPVIVEPLE	TPRPIVEPL
SAMPSRLMM	SAMPSRLMM
SPNSAHAVSL	SPNSHAVSL
YPRQLESLIRL	YPR-QLESL
KPWIGLAEAL	KPWILAEAL
APDEAAEAL	APDEAAEAL
LPAPPHIDV	LPAPPHIDV
SPSPINSSQAL	SPINSSQAL
NPAKVWTDL	NPAKVWTDL
SPLPQSPQAL	SPLPSPQAL
APSQQRLVVV	APSQQRLVV
APKPGGLSL	APKPGGLSL
APVGNQPPVL	APVGQPPVL
SPLVSGTTV	SPLVSGTTV
SPRHSFNNL	SPRHSFNNL
LPPASQTTPL	LPPAQTTPL
LPPAAPLSEL	LPPAPLSEL
RPRTPPEAIAL	RPRTPPEAI
SPQWWWARADL	SPQWWWARA
VPAEPSSLL	VPAEPSSLL
KPPYEHPKDL	KPPYHPKDL
LPRGPQAGL	LPRGPQAGL
TPDGAVRVL	TPDGAVRVL
QPLQAIMEM	QPLQAIMEM
GAMAVRRVL	GAMAVRRVL
SPPNLTPKPL	SPPNTPKPL
SPREALIRL	SPREALIRL
SPDTKSVVL	SPDTKSVVL
APPAAPLAGL	APPAPLAGL
APSIFGGTDM	APSIGGTDM
SPAFLLRLPL	SPAFLRLPL
VPKPSPPLSST	KPSPPLSST
RPIFPGKHYL	RPIFGKHYL
RPALRALGSL	RPALALGSL
SPDPHKGLVLL	SPDPKGLVL
TPASAGHVW	TPASAGHVW
SPHLPGTSSA	SPHLGTSSA
IPMTGKPSL	IPMTGKPSL
TVRAPPTSL	TVRAPPTSL
SPIITLVAL	SPIITLVAL
YPHGLVLL	YPH-GLVLL
VPVSVGPSL	VPVSVGPSL
VPATLPEL	VPA-TLPEL
VPRSPFKVKVL	VPRSFKVKV
HPRWIEPTVM	HPRWEPTVM
LPYKAGLSL	LPYKAGLSL
APQPSVTGL	APQPSVTGL
SPSKMPEI	SPS-KMPEI
RPREAEVRF	RPREAEVRF
IPSQSRAFQTV	IPS-QSRAF
HPQPGSANSL	HPQPSANSL
QVLRPGLVV	QVLRPGLVV
FPEISTRPPL	FPEITRPPL
GPAWVGSHGVL	GPAWGSHGV
TAAAVGAVF	TAAAVGAVF
IPRRQEHDISL	IPRRQEHDI
APAPPQVL	APA-PPQVL
RPAVERLEL	RPAVERLEL
SPQDFGLV	SPQ-DFGLV
SPRGFPLGL	SPRGFPLGL
IPISLHTSL	IPISLHTSL
FPTLKFFPA	FPTLKFFPA
APSPSTPSF	APSPSTPSF
LPAPSSPPA	LPAPSSPPA
FPVFCRVEDF	FPVFRVEDF
KPNANRIALDF	KPNANRIAL
NPMVTGTSVL	NPMVGTSVL
KPFKLSGLSF	KPFKSGLSF
VPEVTKPSL	VPEVTKPSL
VPIGVTAPSL	VPIGTAPSL
SPQYRLRIAM	SPQYLRIAM
DPNFVPAAF	DPNFVPAAF
LPRQPPMSLA	LPRQPPMSL
APHWKRHQL	APHWKRHQL
APSITNTSRPM	APSITNTSR
FPYKGYIWNY	FPY-KGYIW
LPRTPSYSI	LPRTPSYSI
RPGPPQRALL	RPGPPQRAL
IPMNIGTGL	IPMNIGTGL
FPQVGRTAL	FPQVGRTAL
SPQNVPEKL	SPQNVPEKL
SPRPNHSYI	SPRPNHSYI
NPRGLLEESSF	NPRGLLEES
RPFTVAASF	RPFTVAASF
NPRQINWTVL	NPRQNWTVL
APQPVRTDVAV	APQPVRTDV
SPDVPLTIM	SPDVPLTIM
APYSVDQSL	APYSVDQSL
SPSPLRAGVDI	SPSPLRAGV
VPRPIFSQL	VPRPIFSQL
APVPTPAM	APV-PTPAM
GPRAPGPSLL	GPRAPGPSL
APRPASGPIR	APRPASGPI
APHMGGPPMM	APHMGGPPM
LPFGKVTNL	LPFGKVTNL
SPPLTAPPTM	SPPLAPPTM
VPQVSTPT	VPQ-VSTPT
LPKPPFGML	LPKPPFGML
DPILYRPVAV	DPILRPVAV
GPPVVISPSL	GPPVISPSL
APVNAGPSSL	APVNGPSSL
DPLGGASSL	DPLGGASSL
LPARFYQAL	LPARFYQAL
VPTAKFQEL	VPTAKFQEL
SPQAPTHFLVI	SPQAPTHFL
RPASSQVPRVM	RPASQVPRV
VPRLPATAA	VPRLPATAA
YPNGVVVHY	YPNGVVVHY
YPFFRGVT	YPF-FRGVT
SPDGSRLLF	SPDGSRLLF
SPQLGRAVQLL	SPQLRAVQL
RPQPVLPLL	RPQPVLPLL
SPQPQNVVF	SPQPQNVVF
IPAKPPVSF	IPAKPPVSF
APRQRPIPLSM	APRQRPIPL
LVRALMTAV	LVRALMTAV
DSYVGDEAQSK	YVGDEAQSK
APGPPGRSML	APGPGRSML
KPKTPSLTVF	KPKTPSLTV
APSKPAASI	APSKPAASI
QPLARPNTL	QPLARPNTL
VPAEHQVAM	VPAEHQVAM
TPRDLVLRSL	TPRDVLRSL
HPIQGHRVEV	HPIQHRVEV
YPMAVGLNK	YPMAVGLNK
RPNPGFSML	RPNPGFSML
SPMPGTLTAL	SPMPTLTAL
SPALGLRGL	SPALGLRGL
APQTQHVSPM	APQTHVSPM
LPVLGQPII	LPVLGQPII
APQVHIFSL	APQVHIFSL
APAPSPTAL	APAPSPTAL
VPKPIGGVV	VPKPIGGVV
LPQKAGGFLM	LPQKAGGFL
SPPPPNPVV	SPPPPNPVV
APPAPRPLAL	APPARPLAL
EPSPPTPSF	EPSPPTPSF
RPIPLSMIF	RPIPLSMIF
LPAASQPQVF	LPAAQPQVF
MPPGLRPTL	MPPGLRPTL
GAFLRHAAL	GAFLRHAAL
APALSGANL	APALSGANL
APGSPIASV	APGSPIASV
MPQDLRSPA	MPQDLRSPA
AALSPSSGQRL	SPS-SGQRL
VPVPPNVAF	VPVPPNVAF
APAPEVGRTL	APAPVGRTL
QPAPAWTTF	QPAPAWTTF
APRPSPAISV	APRPPAISV
IPYLPPLEKL	IPYLPLEKL
VPVEAYGLAM	VPVEYGLAM
IPSFERYMAQL	IPSFERYMA
SPSKPNPVF	SPSKPNPVF
LPQLPLAAL	LPQLPLAAL
VPAPGKLF	VPA-PGKLF
FPELPKSAL	FPELPKSAL
QVMAQRQQV	QVMAQRQQV
SPQGAGLVI	SPQGAGLVI
RVQKIRPSI	RVQKIRPSI
LPAPPTQNM	LPAPPTQNM
SPIRPLGL	SPI-RPLGL
APSLKQFSL	APSLKQFSL
SPAGPGRAASL	SPAGPGRAA
LPRAGGPLGL	LPRAGPLGL
SPNGTIRNIL	SPNGIRNIL
TPQSILRSTL	TPQSLRSTL
TPIEGMLSHQL	TPIEGMLSH
IPGPLSPVA	IPGPLSPVA
APKPMPPRPPL	KPMPPRPPL
VPKTTGEGTSL	VPKTEGTSL
RPTGSQGLSSL	RPT-GSQGL
VPPTAPLTPL	VPPTPLTPL
YPAEITLTW	YPAEITLTW
GPVGLLSVL	GPVGLLSVL
GPAGPGASL	GPAGPGASL
RPSYVLSGSAM	RPSYLSGSA
APVGSGSAL	APVGSGSAL
QPANLGSTL	QPANLGSTL
QPQQLVLRL	QPQQLVLRL
QPGLPGLV	QPG-LPGLV
TPLASTSNSL	TPLATSNSL
SPFARGNVF	SPFARGNVF
GPLDKWRAL	GPLDKWRAL
TPSPYDHDSL	TPSPDHDSL
GPLKGIEL	GPL-KGIEL
KPKFILSVL	KPKFILSVL
LPAPSWNVL	LPAPSWNVL
IPAYDQGLLL	IPAYQGLLL
APARLFALL	APARLFALL
KIALPHGQL	KIALPHGQL
QPQPPQPQL	QPQPPQPQL
SPVSYLRVSM	SPVSLRVSM
VPVPSTGLM	VPVPSTGLM
SPRGNLPLRKL	SPR-GNLPL
SPASRSISLL	SPASRSISL
APRELGLGL	APRELGLGL
IPFPTPTTPL	IPFPPTTPL
YPFKPPKVAF	YPFKPKVAF
QPGKLRSPF	QPGKLRSPF
IPSSWRLLF	IPSSWRLLF
APFQGDQRSL	APFQDQRSL
GPAMPGINM	GPAMPGINM
APSPAYSSSSL	SPAYSSSSL
IPAPNWQGL	IPAPNWQGL
SPHSAAYVL	SPHSAAYVL
GPILPIVPV	GPILPIVPV
LPRGSSPSVL	LPRGSPSVL
APIDRVGQTI	APIDVGQTI
APGPGPSTF	APGPGPSTF
TPTSAPRSVM	TPTSPRSVM
HPIYNIKSL	HPIYNIKSL
APAPASISLF	APAPASISL
IPYEAGTYSL	IPYEGTYSL
VPAGQGLIV	VPAGQGLIV
SPAQPSLQAL	SPAQSLQAL
SASLSRVNTTL	SLSRVNTTL
VPAKDLVLL	VPAKDLVLL
KPKETVPTL	KPKETVPTL
IPRRPGALDGL	IPR-RPGAL
QPMPGYLDM	QPMPGYLDM
DPFNPFELTNH	DPF-NPFEL
VPNATIRNVL	VPNAIRNVL
SPKSYLEIL	SPKSYLEIL
SPDTKKIAL	SPDTKKIAL
VPFSANGRPL	VPFSNGRPL
HPHAVNEIAL	HPHANEIAL
SPSPERSLLL	SPSPERSLL
IPRITIEM	IPR-ITIEM
AAMAGRLMI	AAMAGRLMI
SPGLRALEA	SPGLRALEA
YPATTPTGM	YPATTPTGM
SPPGGAPPIF	SPPGAPPIF
SPSIPITFL	SPSIPITFL
AAEAMEVA	AAE-AMEVA
IPIRPPIVPV	IPIRPIVPV
QPKLPMRTL	QPKLPMRTL
LPSNLPQL	LPS-NLPQL
YPYGDGNRSV	YPYGGNRSV
SPERPFLAI	SPERPFLAI
MPRGIYHSAL	MPRGYHSAL
RPSTRIQQQL	RPSTIQQQL
HPPTPMPPM	HPPTPMPPM
TPNTVLSTPF	TPNTLSTPF
KPTPPAPAL	KPTPPAPAL
LPAPADFLSL	LPAPDFLSL
LPLGGSGLM	LPLGGSGLM
RPHTVLTVI	RPHTVLTVI
SPGSSPTVL	SPGSSPTVL
SPVGPPQLPIM	SPVGPQLPI
KPHVNVGTI	KPHVNVGTI
VPAESMPTL	VPAESMPTL
APSADAPMFV	APSADAPMF
APNYRLKSL	APNYRLKSL
NPNLRKNVL	NPNLRKNVL
SPLYSPVSF	SPLYSPVSF
FPLSQPFSL	FPLSQPFSL
QVKGPTQEF	QVKGPTQEF
SPTSAHLLQL	SPTSHLLQL
APAWFHGF	APA-WFHGF
MPSFPVSTL	MPSFPVSTL
APRPPPEFV	APRPPPEFV
RVSPPHLTL	RVSPPHLTL
LPDERTISL	LPDERTISL
HPYPPGPGV	HPYPPGPGV
SPRGYFHTF	SPRGYFHTF
QPYMPTVSA	QPYMPTVSA
NPDIMRQTL	NPDIMRQTL
VPPPPGISL	VPPPPGISL
SPHDISNVL	SPHDISNVL
APSFTARIQL	APSFARIQL
TPRPVIVEPL	TPRPIVEPL
SPYEPLNFHAM	SPY-EPLNF
APSPAPAGL	APSPAPAGL
TPQLTSTIM	TPQLTSTIM
QPITPGPSI	QPITPGPSI
YPAAPLPGF	YPAAPLPGF
SPDLYSLEL	SPDLYSLEL
RPVQRLPSVAL	RPVQRLPSV
YPLLKNISM	YPLLKNISM
SPEASLRAVL	SPEALRAVL
SPETRENAL	SPETRENAL
SPAQNHPIYL	SPAQHPIYL
EPWDIRNLL	EPWDIRNLL
LPRELSKQV	LPRELSKQV
GPEADRHLL	GPEADRHLL
QPAAYVAQPA	QPAAVAQPA
APSASIPKL	APSASIPKL
SPDDIAALRDL	SPD-DIAAL
LPAASPAALLP	LPAASPAAL
FPMSPVTSV	FPMSPVTSV
APPLAPLPVL	APPLPLPVL
APLAAGIIAL	APLAGIIAL
LPRLPHDSAQL	LPRLPHDSA
TPTPLGGM	TPT-PLGGM
FPRPVTVEP	FPRPVTVEP
SPSVFSSL	SPS-VFSSL
AAAAVGLAL	AAAAVGLAL
LPDMLKNAPM	LPDMKNAPM
SPAFRILSV	SPAFRILSV
RPSQFPHSL	RPSQFPHSL
RPPPSPSGTL	RPPPPSGTL
VPAPAVRIL	VPAPAVRIL
SPGIWMGL	SPG-IWMGL
MPPLPGLDL	MPPLPGLDL
TPETVRMVL	TPETVRMVL
APAIGRYIRTL	APA-IGRYI
YPALGLLKF	YPALGLLKF
KPAGPPGIL	KPAGPPGIL
GPPGLVPMEL	GPPGVPMEL
RPRPGNILLQL	RPRPGNILL
TPLSSTVTL	TPLSSTVTL
IPTARFYPL	IPTARFYPL
TVMGAEIRHVL	MGAEIRHVL
RPQDKFLVL	RPQDKFLVL
PPRWAEDQNSL	RWAEDQNSL
LPASIPHVI	LPASIPHVI
TPDIKVSL	TPD-IKVSL
SPRAIHSWL	SPRAIHSWL
LPKIPSNATL	LPKISNATL
SPQDSRLYL	SPQDSRLYL
SPVYDIREL	SPVYDIREL
APSMKELQVL	APSMELQVL
APRPTIINA	APRPTIINA
LPRYLMGETQL	LPRYLMGET
IPGIVGAVV	IPGIVGAVV
LPKPGGAHSL	LPKPGAHSL
SPELHEQLL	SPELHEQLL
QPTPVYTQPV	QPTPYTQPV
SPDGSKILAT	SPDGKILAT
LPQLVGVSTPL	LPQLVGVST
SPHGTFLGF	SPHGTFLGF
RPDVGRYLREL	RPD-VGRYL
KPFPGGPLQV	KPFPGPLQV
HPMAYQLQL	HPMAYQLQL
SPSPPKPTVF	SPSPKPTVF
SPDGSRLLFT	SPDGSRLLF
SPRDPVLTL	SPRDPVLTL
LPTGSTPL	LPT-GSTPL
RPNNAYTAM	RPNNAYTAM
RPQDQTVVF	RPQDQTVVF
SPNDFSVSL	SPNDFSVSL
RPPMGPPM	RPP-MGPPM
NPMVTGTSV	NPMVTGTSV
RPRPDEERPL	RPRPEERPL
KPKPSLEPISF	KPSLEPISF
SVAQGYGSL	SVAQGYGSL
YPAPPPPQA	YPAPPPPQA
SPTENSFTL	SPTENSFTL
RPAFPVKKL	RPAFPVKKL
SPGLGSTPL	SPGLGSTPL
APSPVIPRLTL	SPVIPRLTL
APRELGLGLGL	APRELGLGL
LPAPPPSQL	LPAPPPSQL
MPPPPGPAL	MPPPPGPAL
TPIGTPAM	TPI-GTPAM
TVTRPTGVSF	VTRPTGVSF
SPDLRLTWL	SPDLRLTWL
TPQTPDIKVSL	TPD-IKVSL
SPMSFPTADL	SPMSPTADL
TPIPGTIEM	TPIPGTIEM
GPRLPSGGQSV	LPS-GGQSV
SPSATLAAL	SPSATLAAL
RPFISEGTTL	RPFIEGTTL
GPSPNPLIL	GPSPNPLIL
AAYLRALSL	AAYLRALSL
SPLEKINSF	SPLEKINSF
TPFPYNPLIM	TPFPNPLIM
LVMAPRTVL	LVMAPRTVL
LPNHAIREL	LPNHAIREL
QVRVGGSSV	QVRVGGSSV
RPSLLPLH	RPS-LLPLH
IPVVGSVL	IPV-VGSVL
VPSVSSSAL	VPSVSSSAL
APSPTPAVV	APSPTPAVV
APKPFTDVSI	APKPTDVSI
SPAQVKTSV	SPAQVKTSV
SPSLNREEVM	SPSLNREEV
FPVIYDVKY	FPVIYDVKY
SPPVDPFTTL	SPPVPFTTL
GPPVSGPPL	GPPVSGPPL
RPRFPQVVSA	RPRFQVVSA
YPLFRGINL	YPLFRGINL
MPYSNGRPAL	MPYSGRPAL
TPMPSRPSTTP	TPMPSRPST
APRAGPDPRL	APRAPDPRL
SPFGSSFRTF	SPFGSFRTF
LPVGSSQVL	LPVGSSQVL
TPRPASPGPSL	RPASPGPSL
SPTIGKQL	SPT-IGKQL
SPTSSPATSF	SPTSPATSF
SPRPALPALL	SPRPALPAL
QPFGGGSHM	QPFGGGSHM
TPADVFIVF	TPADVFIVF
LPFRGSGTAI	LPFRSGTAI
SPPDPARRE	SPPDPARRE
KPLPPNVGF	KPLPPNVGF
SPAVIVGLL	SPAVIVGLL
RPSGSWNGAL	RPSGWNGAL
NPLYRESVL	NPLYRESVL
TPDPQRVPL	TPDPQRVPL
GPAPVGRFF	GPAPVGRFF
VPFPAPPL	VPF-PAPPL
QPHSVSGAQL	QPHSSGAQL
SPNPEIPAL	SPNPEIPAL
IPNEIIHAL	IPNEIIHAL
HPSLPASSL	HPSLPASSL
IPALGGISL	IPALGGISL
LPRMISHSEL	LPRMSHSEL
SPRKPIDSL	SPRKPIDSL
SPHGHILVL	SPHGHILVL
APPWPGGVSV	APPWGGVSV
IPAGGVLTL	IPAGGVLTL
APPAPGPGQL	APPAGPGQL
VPYPRIHFPL	VPYPIHFPL
SPLPAPASL	SPLPAPASL
APIALLKSL	APIALLKSL
SPTGTAVSTL	SPTGAVSTL
SPMPGTLTA	SPMPGTLTA
SPRPTGSDL	SPRPTGSDL
VPYAGVLAV	VPYAGVLAV
YPDVLTRPSL	YPDVTRPSL
TPAAPSSSGFM	TPAASSSGF
SPSIPVGISL	SPSIVGISL
HPQIIIRAF	HPQIIIRAF
VVESTGVF	VVE-STGVF
IPLVPSKVSV	IPLVSKVSV
IPIVGIVAGL	IPIVIVAGL
QPKIGGPL	QPK-IGGPL
SPSLNREEV	SPSLNREEV
SPMGVDHMSGL	SPMGHMSGL
QILDSAASL	QILDSAASL
SPYPWPLNHI	SPYPPLNHI
APVYLAAVI	APVYLAAVI
MPFPNIRSAEL	FPNIRSAEL
APLSEDQRTAL	APLSQRTAL
LPAAPGKGL	LPAAPGKGL
APAPPSVPT	APAPPSVPT
APGGGPGTL	APGGGPGTL
SPSPLGTSV	SPSPLGTSV
APATQVAQVTL	APATQVAQV
RPRPTEATVSL	RPTEATVSL
APSAARELSL	APSARELSL
TPHLRNLAV	TPHLRNLAV
IPSIRNGIL	IPSIRNGIL
SPIVTSGLIM	SPI-VTSGL
QPVTPLQL	QPV-TPLQL
IVRKIGTNL	IVRKIGTNL
APRLNSADRPM	APRLNSADR
SPSLPNISL	SPSLPNISL
NVAVRITPL	NVAVRITPL
FPRPLVTLPG	FPR-PLVTL
RPGLGMTSV	RPGLGMTSV
SPYQGGVFF	SPYQGGVFF
SIPGGYNAL	SIPGGYNAL
APWKPTWPA	APWKPTWPA
APSPPAVDL	APSPPAVDL
APAQTPAPAL	APAQPAPAL
GPPPVASAL	GPPPVASAL
YPIEHGIIT	YPIEHGIIT
APASAVSGL	APASAVSGL
VPIRLTGSQL	VPIRTGSQL
LPNGMIVTL	LPNGMIVTL
TPVAGSQSL	TPVAGSQSL
APGASIRTL	APGASIRTL
ESGPSIVH	ESG-PSIVH
SPATTGTFL	SPATTGTFL
LTRPGSSSL	LTRPGSSSL
VPQAKPVAV	VPQAKPVAV
IISAPSADAPM	APS-ADAPM
APDVWRIVSL	APDVRIVSL
RPHAPHSPIKF	RPHAPHSPI
APLGGTPTL	APLGGTPTL
VPPPPHRPL	VPPPPHRPL
MPVTPQASV	MPVTPQASV
SPLPDTSLL	SPLPDTSLL
VPPLPGKAL	VPPLPGKAL
LPIAASSSL	LPIAASSSL
QPAVRALGQLF	QPAVALGQL
FPAAPLLTV	FPAAPLLTV
LPIPTPNPL	LPIPTPNPL
RIERMLRLSL	IERMLRLSL
GPLARAGLL	GPLARAGLL
VPAFYRETV	VPAFYRETV
MPTMRLLS	MPT-MRLLS
VNLPINGNGKQ	LPINGNGKQ
QPQQLLQVL	QPQQLLQVL
QPWASSSTSL	QPWASSTSL
LPSPEGLSL	LPSPEGLSL
LPRVGVGTSF	LPRVVGTSF
SPGQRAVLL	SPGQRAVLL
SPYPQELTTL	SPYPELTTL
APSPRPGPGPL	SPRPGPGPL
VPKAPGFAQM	VPKAGFAQM
APSPTGPAL	APSPTGPAL
PPPPLQPASSI	PPLQPASSI
APAGGFGGF	APAGGFGGF
APNGLPNHIM	APNGPNHIM
RPAGLQGAL	RPAGLQGAL
IPSPGLMVF	IPSPGLMVF
SPRSPISPEL	SPRSISPEL
SPYSYSTTA	SPYSYSTTA
APWDRVVDL	APWDRVVDL
RPLPVSRLVSL	LPVSRLVSL
MPKLKPVEL	MPKLKPVEL
GPRLSLRFL	GPRLSLRFL
APSYSGLSM	APSYSGLSM
SPMPPSEVKL	SPMPSEVKL
APAAAPSSL	APAAAPSSL
HPRAYFMQL	HPRAYFMQL
ASPKSPTAAL	SPKSPTAAL
NAPWAVTSL	NAPWAVTSL
MPFSPYEPLNF	MPFSPYEPL
YGLGPPSL	YGL-GPPSL
LPKSPPYT	LPK-SPPYT
RPSGPSKAL	RPSGPSKAL
SPPADPPRVL	SPPAPPRVL
VPTANVSVV	VPTANVSVV
SPAEGQVKL	SPAEGQVKL
FPVLPGSHL	FPVLPGSHL
VPHKIITHL	VPHKIITHL
RPIAAGDISTF	RPIAGDIST
APVAPHSPFL	APVAPHSPF
SPFSFHHVLSL	SPFSFHHVL
RPRSWRELPL	RPRSRELPL
SPLSAAAAT	SPLSAAAAT
YPENWRAFKAL	YPE-NWRAF
GPREALSRL	GPREALSRL
EVAPSFGTL	EVAPSFGTL
QPLAPSGLTL	QPLASGLTL
TPLPTALGL	TPLPTALGL
APRIGYPKPAL	APRIPKPAL
VPRAAFLSPL	VPRAFLSPL
LKNDLLENLQ	LKNDLLENL
GPRSWIQKV	GPRSWIQKV
HPAGPRTVF	HPAGPRTVF
SPRLAAQKL	SPRLAAQKL
AHSPAKQPL	AHSPAKQPL
TPSAPRPAL	TPSAPRPAL
IPLDPLPGHPL	IPLDPGHPL
LPQKVAEKL	LPQKVAEKL
NPYDRGSAF	NPYDRGSAF
LPFKYPAVL	LPFKYPAVL
SPDPRYLSV	SPDPRYLSV
APFGPIKSIDM	APFGPIKSI
KPAAPSFGVL	KPAASFGVL
APAGAPGGPAL	APAGGGPAL
SPNPFITGL	SPNPFITGL
QPNPLPLRL	QPNPLPLRL
RPQKPSLEF	RPQKPSLEF
SPIKDQPVM	SPIKDQPVM
RPYPVMRKI	RPYPVMRKI
MPSSAVRVL	MPSSAVRVL
SPFFREAL	SPF-FREAL
SPAGAANFL	SPAGAANFL
IPRPVDGVEV	IPRPDGVEV
SPIGGMAGV	SPIGGMAGV
AIRLIGEAL	AIRLIGEAL
QPNPASRAKL	QPNPSRAKL
QPEGLKKTL	QPEGLKKTL
NPYFPGQAI	NPYFPGQAI
QPTVSGNTSL	QPTVGNTSL
QPAFTPSGIL	QPAFPSGIL
LPRIFGPGSM	LPRIGPGSM
SPRLPISASH	SPRLPISAS
TPDTNHTPVAL	TPDTNHTPV
SPSVVHLGV	SPSVVHLGV
APSEKFLNM	APSEKFLNM
QPIIRSIPQ	QPIIRSIPQ
YPRELSNSV	YPRELSNSV
APLPAPLYSF	APLPPLYSF
SPVDSGTIL	SPVDSGTIL
APFDRRATSL	APFDRATSL
SPHPPSEVTA	SPHPPSEVT
HPWEVMPDLY	HPWEVMPDL
MPALRSINL	MPALRSINL
SPTLNVSAL	SPTLNVSAL
GPSPTFGEL	GPSPTFGEL
LPNFGSHVL	LPNFGSHVL
KPMEKLLGL	KPMEKLLGL
APGIRSWSL	APGIRSWSL
SPQKFLSNL	SPQKFLSNL
RPEEGRPVV	RPEEGRPVV
SPISLTKPF	SPISLTKPF
IPAGWMGL	IPA-GWMGL
SPPSPPVSL	SPPSPPVSL
HPRSPNVLSV	HPRSNVLSV
GPRHYTIAALL	GPRHTIAAL
VPAPVPLM	VPA-PVPLM
SPTPRIKAEL	SPTPIKAEL
FPIHVQTSL	FPIHVQTSL
APLPRPGAVL	APLPPGAVL
LPQLTGPVL	LPQLTGPVL
APIGVMDQSLM	APIGMDQSL
NPNLRSGFL	NPNLRSGFL
APLLMSTDL	APLLMSTDL
SPSSSATSL	SPSSSATSL
RPQLPAYESL	RPQLAYESL
TPTVPWQEI	TPTVPWQEI
SPIQVGGHVL	SPIQGGHVL
RPFLLRRI	RPF-LLRRI
RPSPAISVSV	RPSPISVSV
KPISWEEL	KPI-SWEEL
LPQYVSNEL	LPQYVSNEL
APQLPVLEV	APQLPVLEV
MPMMPGPPMM	MPMMPGPPM
SVRVQMEEL	SVRVQMEEL
SPQPRLIYL	SPQPRLIYL
HPSGATPTL	HPSGATPTL
LPDSGHLHPLL	LPDSHLHPL
APMSDLTDL	APMSDLTDL
APRHPSTNSL	APRHSTNSL
APYGRITL	APY-GRITL
LPYAGDVSM	LPYAGDVSM
SPSSWLIVV	SPSSWLIVV
SPHSVPFLASL	SPHSFLASL
SPGAPSPSSF	SPGASPSSF
VPDSSGPERIL	VPDSGPERI
IPLLLTSL	IPL-LLTSL
APAAAAGLL	APAAAAGLL
SPAPTPTSL	SPAPTPTSL
APAGTTSSRVL	APAGTSSRV
IVVLRNPL	IVV-LRNPL
KPRPPQGLVR	KPRPPQGLV
SPALYRNVNTL	SPALRNVNT
TPSKPTSESF	TPSKTSESF
SPRQSLETQYL	SPRQSLETQ
KPKMNYEKL	KPKMNYEKL
SPESLRSKV	SPESLRSKV
NVSRAKAVRAL	SRAKAVRAL
GPRPGAERL	GPRPGAERL
APSSETGTSL	APSSTGTSL
YAAQATTPM	YAAQATTPM
APSKSRLLATL	APSKSRLLA
RPPEITGQVSL	RPPEITGQV
SPSQGSPAL	SPSQGSPAL
TPSLVKSTSQL	TPSLKSTSQ
TPSPSGVPL	TPSPSGVPL
RPSAAGINL	RPSAAGINL
MPSPVSPKL	MPSPVSPKL
MQRQLLSNPEM	QRQLSNPEM
SPKASSKLAIM	SPKASKLAI
TTMVPTAAL	TTMVPTAAL
SPSSLIGQAL	SPSSIGQAL
RPQQIPVL	RPQ-QIPVL
FPREPRPKL	FPREPRPKL
SPWGVTPISF	SPWGTPISF
QPPGGPQAAL	QPPGPQAAL
TPKPVSIAT	TPKPVSIAT
SPSEILQEL	SPSEILQEL
APIIRVGGAL	APIIVGGAL
FPIGSSGFSL	FPIGSGFSL
IPSQISYPA	IPSQISYPA
SPSAQVIGL	SPSAQVIGL
TPAEVGVLV	TPAEVGVLV
RVAEHHVATL	RVAEHVATL
APAPPSKVI	APAPPSKVI
APREPPPVEL	APREPPVEL
APSVPTVSL	APSVPTVSL
RIHVPWTKL	RIHVPWTKL
SPALPGVYL	SPALPGVYL
SPMAERSMMSA	SPMAERSMM
RPTKPYGTKF	RPTKYGTKF
RPRATVMVMV	RPRATVMVM
YPIEKFISL	YPIEKFISL
RLYGPSSVSF	RLYGSSVSF
RPRAPIIAVT	RPRAPIIAV
IPAKKYVKL	IPAKKYVKL
SPAYRDLAA	SPAYRDLAA
SPNYRVINI	SPNYRVINI
SPQSGNFRQL	SPQSNFRQL
FPAEKGQLF	FPAEKGQLF
IPNPQERTLTL	NPQERTLTL
APRIALHTAL	APRILHTAL
SPDGPFINI	SPDGPFINI
FPAAPAPKM	FPAAPAPKM
SPPIPHVPH	SPPIPHVPH
APIKVGDAIPA	APIKVGDAI
LPSSVISAI	LPSSVISAI
IPMALSENSGM	IPMASENSG
SPYPRVKVDF	SPYPVKVDF
APMRSLVQEM	APMRLVQEM
LPASPAHQL	LPASPAHQL
YPYLGPSTL	YPYLGPSTL
FPAIGVGSF	FPAIGVGSF
QPAHLHELL	QPAHLHELL
APKRPPLAF	APKRPPLAF
VPRPPQTSLV	VPRPPQTSL
SPSPPKPTVFI	SPSPKPTVF
QPMAVVQSV	QPMAVVQSV
YPFKPPKIAF	YPFKPKIAF
LPEKNRQML	LPEKNRQML
LPPAPGTEL	LPPAPGTEL
APDPMPAAL	APDPMPAAL
GPLPPHLAL	GPLPPHLAL
RPSTYFRPIL	RPSTFRPIL
IPRSPWKPGTL	SPW-KPGTL
TPRPVTEPLL	TPRPVTEPL
HPGVNGPPL	HPGVNGPPL
SPIDTLREIL	SPIDLREIL
LPALPISITF	LPALISITF
RPPEEDFRRPL	PPEEFRRPL
SPSPLPVSL	SPSPLPVSL
SPALPTQPA	SPALPTQPA
QPHHAGEVTF	QPHHGEVTF
VPNPLPKVL	VPNPLPKVL
APADYFRIL	APADYFRIL
APILRAAGLL	APILRAAGL
APAPIHNQF	APAPIHNQF
SPTGTGLSF	SPTGTGLSF
VPKPSPPL	VPK-PSPPL
APDLAGFTL	APDLAGFTL
HPFPGPGL	HPF-PGPGL
GPPGPVGTPL	GPPGVGTPL
YPSEQEKLSL	YPSEEKLSL
RPGNIYSTL	RPGNIYSTL
SPQSTVTVF	SPQSTVTVF
RPVPWNAL	RPV-PWNAL
KPISPKLLSHF	KPI-SPKLL
GPRAVFVLL	GPRAVFVLL
HPLSDHEATL	HPLSHEATL
RPSYWKFLL	RPSYWKFLL
APAPAPAPAL	APAPPAPAL
FPRDKLAEL	FPRDKLAEL
IPELHRPVV	IPELHRPVV
KPAEYGYVSL	KPAEGYVSL
FPRVGSLPG	FPRVGSLPG
APLPGMTSL	APLPGMTSL
NPRNTEAVTL	NPRNEAVTL
APPSYPPTSY	APPSPPTSY
MPQGNPLLL	MPQGNPLLL
QVRLPDGTSL	QVRLDGTSL
SPSVLRPIVL	SPSVRPIVL
GPLSGGLEL	GPLSGGLEL
VPVGNSPAL	VPVGNSPAL
VPFSVPKIPL	VPFSPKIPL
LPSWGRAEL	LPSWGRAEL
NPSEHTVIL	NPSEHTVIL
APKRPPSAFF	APKRPPSAF
RPWSETIKL	RPWSETIKL
VPHPNWPNHTL	HPNWPNHTL
LPGQMRPPL	LPGQMRPPL
VPYGTPLSV	VPYGTPLSV
SPFSDQSTTL	SPFSQSTTL
RPAPARPTM	RPAPARPTM
SPNTDREVL	SPNTDREVL
APAYQRFHAL	APAYRFHAL
EPSSTRIYAIA	EPSSRIYAI
SPAHAVDAV	SPAHAVDAV
IPREQGLRLL	IPREQGLRL
LPWGTLSSL	LPWGTLSSL
SPVKLFSGL	SPVKLFSGL
SPNPEIPALL	SPNPEIPAL
APGPGRKEL	APGPGRKEL
APGQLALF	APG-QLALF
GPGPGPTTPL	GPGPPTTPL
APASFGKSF	APASFGKSF
IPRLVPGWT	IPRLVPGWT
AIRNAMGSL	AIRNAMGSL
APQGGMAAL	APQGGMAAL
QPRAPGPHAM	QPRAGPHAM
LPPSGSWQDL	LPPSSWQDL
SPLGSPEL	SPL-GSPEL
SPLPGVPKPV	SPLPVPKPV
KPAASPLTSL	KPAAPLTSL
APSPPLPLL	APSPPLPLL
SPAPTHNSL	SPAPTHNSL
AFANLRKVL	AFANLRKVL
GPSTPHVNF	GPSTPHVNF
FPRAPSTSD	FPRAPSTSD
TPRSYVGVTL	TPRSVGVTL
SPQDFGLVL	SPQDFGLVL
VPNQKELTEL	VPNQELTEL
SIRPQVVTTF	SIRPVVTTF
IPMGQAVNSQL	IPMGVNSQL
SPMAERSMM	SPMAERSMM
SPNGHRPQL	SPNGHRPQL
GPNASIISL	GPNASIISL
TPQQPPVNSL	TPQQPVNSL
LPREPSNPERL	LPREPSNPE
RVEPLRNEL	RVEPLRNEL
VPLPAGWEM	VPLPAGWEM
QIPFPSGTPL	IPFPSGTPL
SPYTSAPPL	SPYTSAPPL
RPHMFPKML	RPHMFPKML
RVMEYISRL	RVMEYISRL
QPAQAPGTL	QPAQAPGTL
RPMDGTYGPPA	RPMDGTYGP
YPVEIHEYL	YPVEIHEYL
YVNYRHLAL	YVNYRHLAL
GPAYAFTAL	GPAYAFTAL
APAPLGASPA	APAPGASPA
RPREVLFGVT	RPREVLFGV
QPTPVNIRASM	TPVNIRASM
SPGSRQIQL	SPGSRQIQL
APRYSAPVI	APRYSAPVI
SPPVPGPSAAL	SPPVPGPSA
QPSATFSLAKL	QPS-ATFSL
APASWWNHM	APASWWNHM
SPAPAASITSM	APAASITSM
SPRVPSIEL	SPRVPSIEL
SPLMGAQSF	SPLMGAQSF
YLRNLTWTL	YLRNLTWTL
RPRAPIIAV	RPRAPIIAV
KVRYPDRITL	KVRYDRITL
SPMGRYVMVGL	SPMGRYVMV
APVANSYRGTL	VANSYRGTL
SPKPPSQQL	SPKPPSQQL
SPALAAMEL	SPALAAMEL
IAPTGHSL	IAP-TGHSL
APRWGNPRAL	APRWNPRAL
APGIIPRISV	APGIPRISV
KPEWPAAEL	KPEWPAAEL
SPRFPAQYL	SPRFPAQYL
VPARPYRVL	VPARPYRVL
YPVPASKRPPL	VPASKRPPL
YPHNGMID	YPH-NGMID
TPAEVGVL	TPA-EVGVL
WVRPDLGEL	WVRPDLGEL
SVQRWREAL	SVQRWREAL
IPSSVPATF	IPSSVPATF
AASEKRLHAL	AASERLHAL
APSHLMALLTL	APSHLMALL
QPHRPSPASSL	RPS-PASSL
VPRSPQELYEL	VPR-SPQEL
APSRSLNEL	APSRSLNEL
TPEEKLAAL	TPEEKLAAL
KPSQITGTVF	KPSQTGTVF
SPLNSSSAL	SPLNSSSAL
GPWKPIPSV	GPWKPIPSV
LPAGVRVPL	LPAGVRVPL
IPRLIVSQL	IPRLIVSQL
RPRDALPRLLP	RPRDLPRLL
APMDVRQWV	APMDVRQWV
MPAPHMGGPPM	APHMGGPPM
APGEPGSAF	APGEPGSAF
SPFNLLHEM	SPFNLLHEM
TPSKPSGLSL	TPSKSGLSL
APSLKNAAF	APSLKNAAF
RPNGRVALRTL	RPN-GRVAL
IPRLPERMTTL	LPE-RMTTL
FPHLPLIAI	FPHLPLIAI
IPLVPSKVSVI	IPLVSKVSV
SPQAEQPSL	SPQAEQPSL
RPYSFFTKL	RPYSFFTKL
QVQGPRPVL	QVQGPRPVL
NPDAALRAL	NPDAALRAL
YPIEPSGVL	YPIEPSGVL
SPTPFIIGV	SPTPFIIGV
RPEDRILVL	RPEDRILVL
SPDGSKILATT	SPDGKILAT
LPRPAPGQL	LPRPAPGQL
APSDLRTIQT	APSDRTIQT
RPKALTQVL	RPKALTQVL
FPALRFVEV	FPALRFVEV
TPYAFTSSSML	TPYATSSSM
TPSFPVSPA	TPSFPVSPA
TPVASRQSL	TPVASRQSL
RPAANPIQF	RPAANPIQF
SPREVFFRV	SPREVFFRV
APNLRGSGV	APNLRGSGV
QPQFQRQGL	QPQFQRQGL
FAAAKLLAL	FAAAKLLAL
SPRGPAGLNTI	SPR-GPAGL
TPRSKGQESF	TPRSGQESF
RPERVKPFM	RPERVKPFM
VPVSGTQGL	VPVSGTQGL
VPSWSKVNQGL	SWSKVNQGL
SPPSIAPLAL	SPPSAPLAL
VPQGGPVL	VPQ-GGPVL
SPASPAPDL	SPASPAPDL
QPAAGNQPF	QPAAGNQPF
APRPPVSAA	APRPPVSAA
KPINFSVIL	KPINFSVIL
VPQDTGFSSL	VPQDGFSSL
APPALPGPPG	APPAPGPPG
VPASLMVSL	VPASLMVSL
NPYSRLMAL	NPYSRLMAL
GPMLRLEEL	GPMLRLEEL
SPTKLDVTL	SPTKLDVTL
GPLYKNGSL	GPLYKNGSL
APYMRSMMQSL	APY-MRSMM
VPPPPLMPM	VPPPPLMPM
TPFRYLLTPSM	TPFRYLLTP
VPSPIAAL	VPS-PIAAL
HPFFKDMSL	HPFFKDMSL
RPASGPIRPIV	RPASPIRPI
AVMGRTLSM	AVMGRTLSM
SPTATPRTL	SPTATPRTL
VPLPRLLEV	VPLPRLLEV
APFFLPASL	APFFLPASL
LPALPTQAL	LPALPTQAL
SPSLPSPPS	SPSLPSPPS
NPMSEGFKF	NPMSEGFKF
TPYNYPVPV	TPYNYPVPV
PAWPHRGL	PAW-PHRGL
VPQPHPQTL	VPQPHPQTL
VPTSPKGRLL	VPTSKGRLL
SPALPNSMV	SPALPNSMV
SPADRMLTV	SPADRMLTV
AARWASAKL	AARWASAKL
RVSQEHPVVL	RVSQHPVVL
RPRAPIIAVTR	RPRAPIIAV
GPLKGILGY	GPLKGILGY
RPLPSIRIL	RPLPSIRIL
TPTPSATSF	TPTPSATSF
APSQQRQQI	APSQQRQQI
SPRTPVSPVKF	SPRTPVSPV
KPTHVVVTL	KPTHVVVTL
QPYMPTVSATI	QPYMPTVSA
TPFGGGTGGF	TPFGGTGGF
APAPPPEEV	APAPPPEEV
TPIGSFLGSLS	TPIGFLGSL
APQIGGSIT	APQIGGSIT
FPTRPSGLGVW	FPTRSGLGV
LPQKPHLKL	LPQKPHLKL
RPRPGNILL	RPRPGNILL
TPRGTTKVVSI	TPRGTTKVV
FPNTNRWFL	FPNTNRWFL
GPSPNPLI	GPS-PNPLI
QPRYPVNSV	QPRYPVNSV
VPWKEVLL	VPW-KEVLL
APKPERLPPSM	KPERLPPSM
VVRIITSEL	VVRIITSEL
YPHEPTAVF	YPHEPTAVF
NASPVISSV	NASPVISSV
KPASFMTSI	KPASFMTSI
APTAPGTPW	APTAPGTPW
KPMEGWIAV	KPMEGWIAV
APFQGRVL	APF-QGRVL
KPANVFITA	KPANVFITA
SPSLPQPGL	SPSLPQPGL
QPAVKKFVL	QPAVKKFVL
SPISSDQSL	SPISSDQSL
SPSPQDWRDTL	SPQDWRDTL
APALPPPAFTY	APALPPPAF
APHPSSWETL	APHPSWETL
SPIPFPPL	SPI-PFPPL
RVREITENLM	RVREITENL
APAPFTLPL	APAPFTLPL
TPHYVTQVI	TPHYVTQVI
RPPPPNSVI	RPPPPNSVI
YPQDLPRPL	YPQDLPRPL
APAAPALYV	APAAPALYV
SPAPPLLHV	SPAPPLLHV
APVGGSPGL	APVGGSPGL
APWPIGVTM	APWPIGVTM
IPQPPPGMSF	IPQPPGMSF
APSVKGVSF	APSVKGVSF
QPRLSGSDL	QPRLSGSDL
NPKRQTLVF	NPKRQTLVF
APPHYPTLL	APPHYPTLL
RPFPKLRIL	RPFPKLRIL
RPKTGVRGL	RPKTGVRGL
VPDEHFSTL	VPDEHFSTL
TPDPERWLPM	TPDPRWLPM
LPQPEAVVAL	LPQPAVVAL
APWEKRVDL	APWEKRVDL
SPAEWGQRL	SPAEWGQRL
APRGELYKEL	APRGLYKEL
GPHQRHIAL	GPHQRHIAL
RPSDEVIREL	RPSDVIREL
ALGPVWAAL	ALGPVWAAL
APYMRSMMQTL	APY-MRSMM
KVSPPGPAL	KVSPPGPAL
RPYLGPALL	RPYLGPALL
APGVRAVEL	APGVRAVEL
APMPYLIGI	APMPYLIGI
RPAALRGALLG	RPAALRGAL
FVRKAVRAI	FVRKAVRAI
IPNTQIKAL	IPNTQIKAL
GPAPVPTNL	GPAPVPTNL
QPQFRAVL	QPQ-FRAVL
HAAAYRNAL	HAAAYRNAL
FPRPGGLL	FPR-PGGLL
TPIGSFLGSL	TPIGFLGSL
SPHLPHNSL	SPHLPHNSL
KPRMDQYFNQM	KPR-MDQYF
SPRPVVVET	SPRPVVVET
SPFAGNSPA	SPFAGNSPA
GPDYPRQSI	GPDYPRQSI
SVRVPARVL	SVRVPARVL
SPVGPPSGL	SPVGPPSGL
MPSTPASTI	MPSTPASTI
TPAIPTAVNL	TPAITAVNL
SPAPVPLPLL	SPAPPLPLL
RPIMFRGEV	RPIMFRGEV
VPASKRPPL	VPASKRPPL
QAAAAVGPTVL	AAAAGPTVL
SPAELSPTTL	SPAESPTTL
VPASQKLRQL	VPASKLRQL
APPLLLAAVL	APPLLAAVL
APYTPFLTEL	APYTFLTEL
TPMHPPSSL	TPMHPPSSL
SPQQVSAQL	SPQQVSAQL
FPKGFSVEL	FPKGFSVEL
HPAAKMIVM	HPAAKMIVM
SPGAPGPLTL	SPGAGPLTL
SPKSPTAAL	SPKSPTAAL
DPVKPPGSSL	DPVKPGSSL
LPKPINSDF	LPKPINSDF
YPRKVTAAMGK	YPRKVTAAM
SPAATLLGSL	SPAALLGSL
QPILRFLQL	QPILRFLQL
TPKMPGQSV	TPKMPGQSV
SPANTRYLFL	SPANRYLFL
RPQELPRLAF	RPQEPRLAF
TPAPGLLSL	TPAPGLLSL
SPSGAVPTSL	SPSGVPTSL
QPAPAWTT	QPA-PAWTT
LPNHRVLIM	LPNHRVLIM
LPPPPGSPL	LPPPPGSPL
LPQQPPLSL	LPQQPPLSL
IPKAKPLTL	IPKAKPLTL
KPATSYVRTTI	KPATYVRTT
APALPGPALP	APALPGPAL
QPQEKSLIGL	QPQESLIGL
MPPAFPRLEL	MPPAPRLEL
TPVLGSGAA	TPVLGSGAA
SPVAAVTPPL	SPVAVTPPL
LPSAPGVVL	LPSAPGVVL
APNELLWTVT	APNELLWTV
LPGPTGSVV	LPGPTGSVV
RPYPSPGAVL	RPYPPGAVL
NPSYPGFSV	NPSYPGFSV
SPSVKSLAV	SPSVKSLAV
IPLHKFTSI	IPLHKFTSI
TPTPSTNSVL	TPTPTNSVL
TVLSGGTTM	TVLSGGTTM
SPTFLRAL	SPT-FLRAL
VPFPRVGSLP	VPFPRVGSL
RPWPRWLGV	RPWPRWLGV
FPKIPPHSL	FPKIPPHSL
LPAHPGAEV	LPAHPGAEV
EPRYPPHSL	EPRYPPHSL
SPNQARAQAAL	SPNQRAQAA
SPYPLPEEI	SPYPLPEEI
SNRPPIASL	SNRPPIASL
VPSQWRAVQGI	VPS-QWRAV
IPRAALLPLL	IPRAALLPL
YPASKMFPF	YPASKMFPF
SPQASIIAM	SPQASIIAM
SPFGLSFVRF	SPFGSFVRF
VPDQPHPEI	VPDQPHPEI
APPPPPKAL	APPPPPKAL
SPSNGVGSL	SPSNGVGSL
GPALPGPLV	GPALPGPLV
APAERQIDL	APAERQIDL
VPGTYRKVV	VPGTYRKVV
RPAVSLTL	RPA-VSLTL
APVIRPII	APV-IRPII
APQPGKYVI	APQPGKYVI
IPIALSGRDIL	IPIASGRDI
QPWPQPVPAL	QPWPPVPAL
SPQAISRASEL	SPQARASEL
YPARYRPTAL	YPARRPTAL
RPENRSFYL	RPENRSFYL
APPRAPGPL	APPRAPGPL
SPIIGSPPV	SPIIGSPPV
RPAQKHWVL	RPAQKHWVL
RPWDPAVGVL	RPWDAVGVL
VPDGFLSEL	VPDGFLSEL
SPEKGRWTEL	SPEKRWTEL
TPAVVSERL	TPAVVSERL
EPSSTRIYAI	EPSSRIYAI
NPAQDFSTL	NPAQDFSTL
FPHPVNQVTF	FPHPNQVTF
NPIQTMTEV	NPIQTMTEV
MPMTPGAAL	MPMTPGAAL
IPSIVSSPL	IPSIVSSPL
SPVGSEISM	SPVGSEISM
SPRPGPSML	SPRPGPSML
NPEINKAVL	NPEINKAVL
APAPTMTSL	APAPTMTSL
YPNERFELL	YPNERFELL
SPAKNPSSL	SPAKNPSSL
VPHGHITSL	VPHGHITSL
SPIENIQRV	SPIENIQRV
FPAPGKTVTL	FPAPKTVTL
LPSTVKQAV	LPSTVKQAV
NPPPPGFIM	NPPPPGFIM
APAPVGPL	APA-PVGPL
APRQSSSFRLL	APRQSSFRL
QTAAAAAL	QTA-AAAAL
APRQPGLMAQ	APRQPGLMA
APEPGLTL	APE-PGLTL
ILYRPVAVAL	LYRPVAVAL
LTRPAGTTAM	RPA-GTTAM
HPFLLGPPL	HPFLLGPPL
QPPTGYTTPT	QPPTYTTPT
QIRFSNISA	QIRFSNISA
FPYPVGVHAPL	YPVGVHAPL
GPALSRHLL	GPALSRHLL
RPYSLVRPLL	RPYSVRPLL
RPRDPTPSF	RPRDPTPSF
APAPAAHVA	APAPAAHVA
QPKGIGSTV	QPKGIGSTV
TPSLPTPPT	TPSLPTPPT
SPIGASGVAH	SPIGASGVA
APAQPPSQTF	APAQPSQTF
IPQGSIDSL	IPQGSIDSL
SPMSVNAVM	SPMSVNAVM
RPYSQVNVL	RPYSQVNVL
RIGYPKPAL	RIGYPKPAL
APRQPGPSQW	APRQPGPSQ
TPSGILTPHAL	TPSGILTPH
MPNAMPVSEL	MPNAPVSEL
VPRNSYVRL	VPRNSYVRL
APRAPLRLL	APRAPLRLL
FPFPLPKSL	FPFPLPKSL
RPAALGRLGL	RPAAGRLGL
LPKQPPLM	LPK-QPPLM
GPQSPGQLL	GPQSPGQLL
TVTEKPEVID	TVTEKPEVI
QPRVPSAKAV	QPRVSAKAV
APYERRAMEL	APYERAMEL
YVNLPTIAL	YVNLPTIAL
QPSFHGVDL	QPSFHGVDL
APQLLIVL	APQ-LLIVL
KPFEVPFLKF	KPFEPFLKF
SPPGVPPVSL	SPPGPPVSL
LPDDKVTAL	LPDDKVTAL
VPKYWGSGL	VPKYWGSGL
RPKPPSATSI	RPKPSATSI
GPAEAHYAF	GPAEAHYAF
APRPGLLSL	APRPGLLSL
KPYQGVGSSSM	KPYQVGSSS
SPPLPFLSL	SPPLPFLSL
SPSLSGLKL	SPSLSGLKL
SPFSSGSSV	SPFSSGSSV
SPPTLLEGPL	SPPTLEGPL
AVRKPAISL	AVRKPAISL
NPVAPIKTPM	NPVAIKTPM
LPRLLVQAL	LPRLLVQAL
KPMKSVLVV	KPMKSVLVV
SPRVPLSAY	SPRVPLSAY
APSPLQPAL	APSPLQPAL
SPNSLVTIL	SPNSLVTIL
RPYPQVQML	RPYPQVQML
HPYFYAPELL	HPYFYAPEL
GPRPWAEQL	GPRPWAEQL
GPGLGNVAM	GPGLGNVAM
SPSEFERFSL	SPSEERFSL
GPSIQATQKSL	SIQATQKSL
GPPAPAPPAPI	APA-PPAPI
SPSGSHVVSV	SPSGHVVSV
HPREPLPPIQ	HPREPLPPI
ALALPAPAL	ALALPAPAL
FPHVQTDVL	FPHVQTDVL
TVKPLTLEL	TVKPLTLEL
APLLRKTYF	APLLRKTYF
QPAPAPLLF	QPAPAPLLF
YPKPALLHSTF	KPALLHSTF
GPRTAALGLL	GPRTAALGL
APSGSLAVPL	APSGLAVPL
QPAGQVAVL	QPAGQVAVL
APQSFRAEL	APQSFRAEL
QPSSVISIM	QPSSVISIM
VPKVVGSAV	VPKVVGSAV
QPANTSLGF	QPANTSLGF
QPAASHLTV	QPAASHLTV
NPRIGTFDL	NPRIGTFDL
GPIYEGLI	GPI-YEGLI
QLSLRTVSL	QLSLRTVSL
RPRGLPPLLVV	RPRGLPPLL
KPMTLKLIM	KPMTLKLIM
VPLGTGTSIL	VPLGGTSIL
LPAGGAPTVF	LPAGAPTVF
APGPGQLTL	APGPGQLTL
IPRGTPGPPPA	IPRGPGPPP
APNSPMALL	APNSPMALL
SPAEVRDLDF	SPAERDLDF
GPLPGPGPAL	GPLPPGPAL
RPDQLTGLSL	RPDQTGLSL
SPQKVTLYL	SPQKVTLYL
LPNLRELWL	LPNLRELWL
RPMYSKPSI	RPMYSKPSI
GPGPGPTL	GPG-PGPTL
IPKNNPPTL	IPKNNPPTL
KPLEKPLKL	KPLEKPLKL
RPPPSPSGTI	RPPPPSGTI
APAAFHLQVL	APAAHLQVL
NPDLMRQLIMA	NPDLMRQLI
RPALFANL	RPA-LFANL
VPFERPAVI	VPFERPAVI
APKYGSYNVF	APKYSYNVF
SPGQHYFSSL	SPGQYFSSL
APSPITFTSL	APSPTFTSL
QPKLPITVL	QPKLPITVL
SPNPFSVHTAT	SPNPSVHTA
RPRLIIAGTSA	RPRLIIAGT
SPDGPLPQL	SPDGPLPQL
APASALVRIPL	APASALVRI
SPSASALTL	SPSASALTL
APKHFLPEML	APKHFLPEM
NPIGSLQEL	NPIGSLQEL
SPRVPNSSV	SPRVPNSSV
RPDERRFAVF	RPDERRFAV
APGAFGQSPF	APGAGQSPF
IPSPGGAM	IPS-PGGAM
NPEKRYNVL	NPEKRYNVL
KPVVPSVPM	KPVVPSVPM
APAPVGPLV	APAPVGPLV
IPMKPPTPL	IPMKPPTPL
SPWPGTTL	SPW-PGTTL
GPIAKFLDM	GPIAKFLDM
LPAPALRESPL	APALRESPL
LPFGRLNYL	LPFGRLNYL
APEGFSRTDL	APEGSRTDL
QAQADRVSL	QAQADRVSL
QPAANLSEL	QPAANLSEL
SPTPATALAV	SPT-PATAL
WPHDTIGSL	WPHDTIGSL
IPSSVIHPAM	IPSSIHPAM
SPHPAATAL	SPHPAATAL
NPRGQPVGGL	NPRGPVGGL
LPSGGSLGL	LPSGGSLGL
TPSPATTTF	TPSPATTTF
SPLSSHPVV	SPLSSHPVV
SPLSVATAL	SPLSVATAL
FPTILEEAKEL	TILEEAKEL
APPGHPLPLGL	APPGHPLPL
APARLFAL	APA-RLFAL
APSNPWGGL	APSNPWGGL
APVGPLVGL	APVGPLVGL
TPMAPGVFL	TPMAPGVFL
APAPAPAI	APA-PAPAI
APHLTHHTL	APHLTHHTL
RPPSPGNIRPV	RPPSPGNIR
SSPRLSSSL	SSPRLSSSL
SPSGSKMQL	SPSGSKMQL
QPMAHYPSQPV	QPMAHYPSQ
LPTMIGLL	LPT-MIGLL
SPYLPRGDPVL	SPYLRGDPV
TPYEYPYTL	TPYEYPYTL
SPGLLVRALL	SPGLLVRAL
KPNEFASQINL	KPNEFASQI
SPYSGPKFNSA	SPY-SGPKF
IPELNGKL	IPE-LNGKL
TPAGNFVTL	TPAGNFVTL
MPNIGFQNLPL	MPNIGFQNL
QPRPPQGPLAL	RPPQGPLAL
APPEYHRKAV	APPEHRKAV
VPSFRPYLL	VPSFRPYLL
YPPYPPQPM	YPPYPPQPM
APAPSRGSVQV	APAPSRGSV
SPISVPGGSA	SPISPGGSA
RPDLRMAAI	RPDLRMAAI
KPMPPRPPLPN	KPMPPRPPL
LPHNRLVSL	LPHNRLVSL
LPGPISRQPL	LPGPSRQPL
AVEPGRPPL	AVEPGRPPL
APDGSQRAVL	APDGQRAVL
RVELRPTTL	RVELRPTTL
APVNVTTEV	APVNVTTEV
RPMYGAVTSF	RPMYAVTSF
APAPVPTPA	APAPVPTPA
MPRPSVPPLV	MPRPSVPPL
APSPAPKQSF	APSPPKQSF
QPAGHAIHV	QPAGHAIHV
APAAIPAL	APA-AIPAL
VPSEQRQML	VPSEQRQML
SPNVGHLVL	SPNVGHLVL
SPAKDSLSF	SPAKDSLSF
LPAGAVRTPL	LPAGVRTPL
APAAGLFLL	APAAGLFLL
SPRPFSSPSM	SPRPSSPSM
RPPYERPEL	RPPYERPEL
ALAPQAAL	ALA-PQAAL
KPSEERVREI	KPSERVREI
MPSSHRILHKL	MPS-SHRIL
IPDASKLQFIL	IPDASKLQF
YPDPSKQKPM	YPDPKQKPM
HPAVHAGIL	HPAVHAGIL
AGTPSPIQL	AGTPSPIQL
APYGKNQVQAL	APY-GKNQV
APSSAAWVQTL	APSSAWVQT
SPALPTQAP	SPALPTQAP
SPEGPSKPSL	SPEGSKPSL
NPNLRIISL	NPNLRIISL
IPFPSGTPL	IPFPSGTPL
SPVASAAQL	SPVASAAQL
IPRYGFTAL	IPRYGFTAL
MPRTGNGPMSV	MPRTGNGPM
QPDLLHQLVTL	QPDLLHQLV
SPWKSPPQL	SPWKSPPQL
APRTVALTAL	APRTALTAL
GPPMGPGPAM	GPPMPGPAM
APSLINSSSTL	APSLNSSST
KPFFMKEV	KPF-FMKEV
APLPSAGDL	APLPSAGDL
LPRRPNDIYV	LPR-RPNDI
SPILVATAV	SPILVATAV
APDVPSMGL	APDVPSMGL
VLRPPGTAL	VLRPPGTAL
IPKPLNPAL	IPKPLNPAL
SPQETTVLL	SPQETTVLL
RPSVPAALPL	RPSVAALPL
MPDLPNVGL	MPDLPNVGL
SPNSSILWL	SPNSSILWL
IPIVGIVA	IPI-VGIVA
SPDYERIINL	SPDYRIINL
GPMPKHIAF	GPMPKHIAF
SPVVVASSL	SPVVVASSL
APAGGAGAL	APAGGAGAL
QPNSQIRQNI	QPNSIRQNI
APHEPDGVAL	APHEDGVAL
APFPHPLWL	APFPHPLWL
LPMVPIVAL	LPMVPIVAL
APSSPRPAL	APSSPRPAL
TPMMPDNGAVH	TPMMDNGAV
LPMNPRNMM	LPMNPRNMM
APFPHGDSAL	APFPGDSAL
SPSPPSVAV	SPSPPSVAV
RPIYIDGRPVL	RPIYDGRPV
GPRLPPEDL	GPRLPPEDL
YPYNAPTVKF	YPYNPTVKF
SPNSSNPII	SPNSSNPII
MPAETIKEL	MPAETIKEL
YVADPGGSL	YVADPGGSL
SVRTVMRVPL	SVRTMRVPL
KPRPPLHLL	KPRPPLHLL
SPYGTLKPEEM	SPYGTLKPE
APITDPQQL	APITDPQQL
LPPAPGLAL	LPPAPGLAL
TPKPVINSTPG	TPKPVINST
HPARKLLSL	HPARKLLSL
KPIEQLLGF	KPIEQLLGF
KPFEQVKGITL	KPFEKGITL
QPLLVSVSAL	QPLLSVSAL
LPAGWKPLFV	LPAGWKPLF
ALRAATMEV	ALRAATMEV
APRPSLLGLDL	APRPSLLGL
RPAANPIQFTL	RPAANPIQF
APSGGWNGV	APSGGWNGV
FPGPGLAI	FPG-PGLAI
GPLPLGGSGLM	GPLPGGSGL
MPQVLTTL	MPQ-VLTTL
APEVLPKPRM	APEVPKPRM
APPWPGGVS	APPWPGGVS
IPAQPQLL	IPA-QPQLL
QPSKLMRLL	QPSKLMRLL
TPRIQGLTV	TPRIQGLTV
SPHSPSPIAT	SPHSPSPIA
QPTPGKAL	QPT-PGKAL
SPRVPLSAYER	SPRVPLSAY
SPMSVNAV	SPM-SVNAV
APPLPSLAL	APPLPSLAL
SPDLDRIAA	SPDLDRIAA
RPQLKGVVL	RPQLKGVVL
SPAPNPDWL	SPAPNPDWL
SPRGFPLGLSA	SPRGFPLGL
FPIGSSGF	FPI-GSSGF
YPQEVIPTF	YPQEVIPTF
YPRIHFPLAT	YPRIHFPLA
VPTLTGAFGIL	VPT-LTGAF
YPAGSQVMM	YPAGSQVMM
QPMPTSPGVDL	MPTSPGVDL
QVITQGTSL	QVITQGTSL
SVATALSAL	SVATALSAL
RPHAFQVIL	RPHAFQVIL
SPKLPVSSL	SPKLPVSSL
VPNVHGALAPL	VPN-VHGAL
RLNSADRPM	RLNSADRPM
KPTDKLRAL	KPTDKLRAL
TVRKILSRL	TVRKILSRL
SPVQPSKQL	SPVQPSKQL
APFSKVLTF	APFSKVLTF
VPILVSKPPVF	VPILSKPPV
SPIKLSPATPS	SPIKLSPAT
YPLRPGPQL	YPLRPGPQL
IPRDLLPTIF	IPRDLLPTI
SPYIPSPGGAM	IPS-PGGAM
QPRNPLEEL	QPRNPLEEL
VPQTVPMRL	VPQTVPMRL
