Data	Data aligned
ILQDGRIFI	ILQDGRIFI
TLQDIVYKL	TLQDIVYKL
ILLAELEQL	ILLAELEQL
RLLEEGVLRQI	RLLEELRQI
VLFYAITTL	VLFYAITTL
VLAPLIALV	VLAPLIALV
GLGRIIEL	GLGR-IIEL
TLLTAIVKL	TLLTAIVKL
ILQKELSQL	ILQKELSQL
AVLAVLPRL	AVLAVLPRL
YVQDFLNHL	YVQDFLNHL
YVSPKQFSV	YVSPKQFSV
ALNEVGIYKL	ALNEVIYKL
RLQQELMTL	RLQQELMTL
FIQSIISTV	FIQSIISTV
GLIEILKKV	GLIEILKKV
FLNDEVWNL	FLNDEVWNL
YTFSEPFHL	YTFSEPFHL
ALLLPTGVFQV	LLLPTVFQV
TIIDLPGITRV	TIIDLITRV
NLFEWHFTV	NLFEWHFTV
VLIETLVTL	VLIETLVTL
LLTEQIHSL	LLTEQIHSL
RLNDFASTVRI	RLNDFASTV
YLLSYIQSI	YLLSYIQSI
ALAQRLLEV	ALAQRLLEV
QLQDIVYKL	QLQDIVYKL
AIMDLLLRL	AIMDLLLRL
RLQEDPPVGV	RLQEDPVGV
YTWEEVFRV	YTWEEVFRV
ALSEKLARL	ALSEKLARL
ATFARIWYL	ATFARIWYL
VLMEQIKLL	VLMEQIKLL
RQFLFHWTV	RQFLFHWTV
LLQNNLPAV	LLQNNLPAV
KLLAVIHEL	KLLAVIHEL
HLNEHLYNM	HLNEHLYNM
FLWDVPSNWTL	FLWDVNWTL
KLAEFIDFL	KLAEFIDFL
GLSLEIGENRL	SLEIGENRL
LRLLHIEEL	LRLLHIEEL
LLMEHIQEI	LLMEHIQEI
NLAPVILQL	NLAPVILQL
SLAEMIATL	SLAEMIATL
LLNQAPDML	LLNQAPDML
ALSEKIVSV	ALSEKIVSV
KLNVAPLAV	KLNVAPLAV
SVIEALKD	SVIE-ALKD
ALQDFLLSV	ALQDFLLSV
SLAQYNPKL	SLAQYNPKL
YLLEEKIASL	YLLEEIASL
LINPNIATV	LINPNIATV
KIYQWINEL	KIYQWINEL
FLLEQEKTQAL	FLLEQTQAL
LASALAGLIA	LASA-LAGL
GLKEGIPAL	GLKEGIPAL
IVLDRLIEL	IVLDRLIEL
SIFKAWAV	SIFK-AWAV
LLQDHPWLL	LLQDHPWLL
ARFEELLLQL	ARFEELLQL
VVWGTVIRV	VVWGTVIRV
KLSDLQTQL	KLSDLQTQL
TLLHFLAEL	TLLHFLAEL
EIGQVPALL	EIGQVPALL
ALHWFLNQV	ALHWFLNQV
SLMLLIRQL	SLMLLIRQL
LQLPGLWSV	LQLPGLWSV
VLAWGLLNV	VLAWGLLNV
RVSDINFTL	RVSDINFTL
SLSEKQYFL	SLSEKQYFL
SIIDWLNSV	SIIDWLNSV
ILQDLVKNL	ILQDLVKNL
KLFDIFSQQV	KLFDISQQV
VLISVLQAI	VLISVLQAI
AIMNVLAEL	AIMNVLAEL
RLLDEEISRV	RLLDEISRV
LLQRIIVEL	LLQRIIVEL
VLQKLLEKL	VLQKLLEKL
AVSNHVFHL	AVSNHVFHL
SIAAFIQRL	SIAAFIQRL
SLLDTLVLL	SLLDTLVLL
ILGIQPPSV	ILGIQPPSV
VLSDIIQNL	VLSDIIQNL
VLNDYKWFA	VLNDYKWFA
GLTPFVFRL	GLTPFVFRL
ALWDKLFNL	ALWDKLFNL
TIDDIVLTI	TIDDIVLTI
GQIEVVPEV	GQIEVVPEV
FLLPHPGLKV	FLLPHGLKV
FLNSVTDIHQL	FLNSVIHQL
NLSNFLIHL	NLSNFLIHL
STLHLVLRL	STLHLVLRL
FLWERPTLL	FLWERPTLL
ALMNLIQYI	ALMNLIQYI
AVAPQVPAL	AVAPQVPAL
FLLDPYKYMTL	FLLDPYKYM
SLKETIEEL	SLKETIEEL
IVLPAGALHQV	IVLPALHQV
VLAFLVHEL	VLAFLVHEL
TLQEFLERI	TLQEFLERI
KLREDLERL	KLREDLERL
AILKYIETL	AILKYIETL
SLSTVFVVL	SLSTVFVVL
ISLQHLKQL	ISLQHLKQL
ELSEKNFQL	ELSEKNFQL
GLVPFLVSV	GLVPFLVSV
AGLYWGYTV	AGLYWGYTV
KSLDWQIDV	KSLDWQIDV
ALANQIPTV	ALANQIPTV
YLFQLLQGL	YLFQLLQGL
GLLERPVLL	GLLERPVLL
RSNPKIWNV	RSNPKIWNV
HVNPFLPYI	HVNPFLPYI
ALAAALAHI	ALAAALAHI
YLITGNLEKL	YLITGLEKL
LIMELINNV	LIMELINNV
ALTEYTLYL	ALTEYTLYL
TINSIIYGL	TINSIIYGL
FLAPWATIA	FLAPWATIA
SLLASLHTL	SLLASLHTL
ALTDYITRL	ALTDYITRL
SILNELIGL	SILNELIGL
ALNEQIARL	ALNEQIARL
YANAKIYKL	YANAKIYKL
ELIERIPEL	ELIERIPEL
KLLDLMPRL	KLLDLMPRL
TLADLVHHV	TLADLVHHV
RMLPHAPGV	RMLPHAPGV
TLNKFIEEL	TLNKFIEEL
VFEKYPETLVR	VFEKYPETL
GLIDFAIQL	GLIDFAIQL
VLLSPVPEL	VLLSPVPEL
RLIEESVTV	RLIEESVTV
SLQSTIQGL	SLQSTIQGL
ILSESLHSL	ILSESLHSL
RLLDRLPSF	RLLDRLPSF
YQILVVTRL	YQILVVTRL
ALKPDLVNV	ALKPDLVNV
GLLDPSVFHV	GLLDPVFHV
SLAEVAGLQV	SLAEVGLQV
VLSELLWQV	VLSELLWQV
SLAPIIVHV	SLAPIIVHV
AVLEEIYLL	AVLEEIYLL
ALFPHLLQPVL	ALFPHLLQP
VLQDFYLEL	VLQDFYLEL
VQIEHISSL	VQIEHISSL
SVAHWEAQI	SVAHWEAQI
VLLPKLPQF	VLLPKLPQF
TLKEYLESL	TLKEYLESL
RLFEVPHEL	RLFEVPHEL
SLLDILKRL	SLLDILKRL
SINDKIIEL	SINDKIIEL
SLIEKPPIL	SLIEKPPIL
ILQNEPLPERL	ILQNELPER
QLITDIPLL	QLITDIPLL
SILEDPPSI	SILEDPPSI
ILAPTVQEL	ILAPTVQEL
SLLNLHLHAL	SLLNLLHAL
LIYPWVHVVI	LIYPWVHVV
NMVDIIHSV	NMVDIIHSV
GLLPKLTAL	GLLPKLTAL
ALSNFISQL	ALSNFISQL
ALNDEIRQL	ALNDEIRQL
KILQELPSV	KILQELPSV
VLASLIIRL	VLASLIIRL
FLSSVIQNL	FLSSVIQNL
IVIGVLHQL	IVIGVLHQL
AIIPYIPTL	AIIPYIPTL
KLIDLSQVMYL	KLID-LSQV
LLLTLLPQL	LLLTLLPQL
GLQNDLFSL	GLQNDLFSL
RLIDIFIINL	RLIDIIINL
ALSLYLFKL	ALSLYLFKL
SLHSVIIQL	SLHSVIIQL
ALFDAQAQV	ALFDAQAQV
GLLPDVPSL	GLLPDVPSL
SQAPFIVAL	SQAPFIVAL
LLNKSIIRV	LLNKSIIRV
KVLNLVLPNL	VLNLVLPNL
FVLDKVPFL	FVLDKVPFL
FQRPTIYYV	FQRPTIYYV
ALITRIFGV	ALITRIFGV
MLLDFIQHI	MLLDFIQHI
TVQEILPAL	TVQEILPAL
TVRIWVPNV	TVRIWVPNV
RLAQHITYV	RLAQHITYV
SLHEWQDINL	SLHEWDINL
RLQDEIQRL	RLQDEIQRL
GLLRELRYL	GLLRELRYL
SLNLAPPTV	SLNLAPPTV
LLFHHPNILEL	LLFHHPNIL
GLQEAQYRL	GLQEAQYRL
SLMGTLSKL	SLMGTLSKL
TVTGFIPLL	TVTGFIPLL
ILLDRLLYL	ILLDRLLYL
GLLRIIPYL	GLLRIIPYL
ALMPTLEAL	ALMPTLEAL
VINDVRDIFL	VINDVDIFL
HLQGQLQTL	HLQGQLQTL
SLKKFIYAL	SLKKFIYAL
SLVEIILHV	SLVEIILHV
LLNKAPEYL	LLNKAPEYL
SLAEVLQQL	SLAEVLQQL
AVLHAIYSL	AVLHAIYSL
ALWAGLLTL	ALWAGLLTL
YVTEELPQL	YVTEELPQL
ELIPTLPQL	ELIPTLPQL
FLASESLIKQI	FLAS--ESL
LLAEVIENL	LLAEVIENL
VIQELINTV	VIQELINTV
LLWDYVYQL	LLWDYVYQL
SAMEVVPAL	SAMEVVPAL
ALQSLLHLL	ALQSLLHLL
IQVTKVTQV	IQVTKVTQV
SLQEFINWL	SLQEFINWL
ILGVLVPRL	ILGVLVPRL
AALPNVYEV	AALPNVYEV
ALLPELSVL	ALLPELSVL
SLKEIVINV	SLKEIVINV
RLWGIPDQARV	RLWGIPDQA
VLHDVIYVI	VLHDVIYVI
YSVDRLYEL	YSVDRLYEL
GLLAKIFEL	GLLAKIFEL
FLGDPPPGL	FLGDPPPGL
SLLKDLNFL	SLLKDLNFL
GLAPQIHDL	GLAPQIHDL
LQALLPEPL	LQALLPEPL
SLFKIWLV	SLFK-IWLV
TLFPSKIGV	TLFPSKIGV
ALNGKLYIV	ALNGKLYIV
NLFEWHFTVR	NLFEWHFTV
ALLENMEGLFL	ALLENMEGL
FVDDYTVRV	FVDDYTVRV
SAMELIWNL	SAMELIWNL
YLRLFQENL	YLRLFQENL
YVYEYLLHV	YVYEYLLHV
SLLGDDALVQV	LLGDDLVQV
AVANIVNSV	AVANIVNSV
TLNDVLAQL	TLNDVLAQL
KLLEIDIDGV	KLLEIIDGV
YLAEKYEWDV	YLAEKEWDV
LEAILLQEL	LEAILLQEL
MFTAMPPLTLG	FTAMPPLTL
RLAHYIDRV	RLAHYIDRV
KIIDEDGLLNL	KIIDELLNL
FLFRPWDV	FLFR-PWDV
GLFPWTPKL	GLFPWTPKL
ILLKDILSV	ILLKDILSV
FQLPIRFNL	FQLPIRFNL
MLFDYKDQL	MLFDYKDQL
QLLDLMHTL	QLLDLMHTL
TLLGKVVAL	TLLGKVVAL
AMIELVERL	AMIELVERL
HLINYIIFL	HLINYIIFL
ALFEGKVQL	ALFEGKVQL
SLLTHIQNL	SLLTHIQNL
LQVEEVHQL	LQVEEVHQL
FLGAIFQL	FLGA-IFQL
ALMEALVLI	ALMEALVLI
VLQNVAFSV	VLQNVAFSV
KLSLVAAMLLL	SLVAAMLLL
TLLTKPVEI	TLLTKPVEI
RLPDLIIFL	RLPDLIIFL
TLQEVLTLL	TLQEVLTLL
AALSWQYLT	AALSWQYLT
TLASSLHTL	TLASSLHTL
VLLGHIFYV	VLLGHIFYV
RLLEGYEIYV	RLLEGEIYV
SLLGGDVVSV	SLLGGVVSV
TLADYLHLL	TLADYLHLL
SLVNVVPKL	SLVNVVPKL
ALFASGLIHRV	FASGLIHRV
SLMDPNKFLLL	SLMDPNKFL
KLTAFVNTL	KLTAFVNTL
VLIPKMPQL	VLIPKMPQL
GLLEIVTSV	GLLEIVTSV
SMLNRILAV	SMLNRILAV
YLISQVEGHQV	LISQVGHQV
VLWDRTFSLF	VLWDRTFSL
AALSKIFAV	AALSKIFAV
LVLTQEQLHQL	LTQEQLHQL
QLQDTLIHL	QLQDTLIHL
VQTDYVPLL	VQTDYVPLL
SILTQPWRL	SILTQPWRL
VLLTWKYLL	VLLTWKYLL
GLVGYYIFRV	GLVGYIFRV
SLLEKPSEL	SLLEKPSEL
ILQRVIDYI	ILQRVIDYI
SLFDWNVKL	SLFDWNVKL
YLTDLQVSL	YLTDLQVSL
ALLSDLHAF	ALLSDLHAF
ALTVNLHLL	ALTVNLHLL
ILLPLINQL	ILLPLINQL
KINEWLTLV	KINEWLTLV
ALMHALTDL	ALMHALTDL
FLVDIMEHL	FLVDIMEHL
ALGNIVHGL	ALGNIVHGL
KLVNILVQL	KLVNILVQL
TLFDYEVRL	TLFDYEVRL
LQLHEIPSL	LQLHEIPSL
GLAPKPVQV	GLAPKPVQV
VFGVIISIHG	VIIS----I
GLIDIENPNRV	GLIDIPNRV
GLKEILPNL	GLKEILPNL
TIQEILPAL	TIQEILPAL
AMLTVLHEI	AMLTVLHEI
KLFVALGPI	KLFVALGPI
FVNDIFERI	FVNDIFERI
VLQPQVQSL	VLQPQVQSL
YLSPKLWAL	YLSPKLWAL
ALFPGVALL	ALFPGVALL
LVFICFYIKKI	FICFYIKKI
FLREWVESM	FLREWVESM
TLFSVLPEL	TLFSVLPEL
ILQTLIQRV	ILQTLIQRV
LGLYRSIFR	LGLYRSIFR
QILDGVHYL	QILDGVHYL
SIQSIVPAL	SIQSIVPAL
SLTSEIHFL	SLTSEIHFL
GLAKLIADV	GLAKLIADV
SMLDDLRNV	SMLDDLRNV
GLFIPFSV	GLFI-PFSV
RLFSSIVTV	RLFSSIVTV
SLLRSIFTV	SLLRSIFTV
RLNKVISEL	RLNKVISEL
ALKDFVASI	ALKDFVASI
GLLQNLQHL	GLLQNLQHL
SLYDWHVKL	SLYDWHVKL
TVIDQIPFL	TVIDQIPFL
SLYDWNVKLL	SLYDWNVKL
FVLPILQKL	FVLPILQKL
RLLSIKEAFRL	LLSIKAFRL
IMKEVIPFL	IMKEVIPFL
RLLEVTNTIRV	RLLEVTNTI
QLIDKVWQL	QLIDKVWQL
FILTHVDQL	FILTHVDQL
VLNLVLPNL	VLNLVLPNL
SLQDVVKGLFV	SLQDVVKGL
FLTEFINYI	FLTEFINYI
RLIESLFTI	RLIESLFTI
RLGPVPPGL	RLGPVPPGL
ILADLLPSL	ILADLLPSL
ALADFLPVM	ALADFLPVM
ILYNGLIEEL	ILYNGIEEL
ALFEEVPEL	ALFEEVPEL
NLLEEVFHL	NLLEEVFHL
YLLDYPNNL	YLLDYPNNL
QILDGIHYL	QILDGIHYL
YIITEIPSL	YIITEIPSL
ALADFAELI	ALADFAELI
YQNIWNINL	YQNIWNINL
TLLDAGLPQKV	TLLDALPQK
FMFDEKLVTV	FMFDELVTV
ILYGEVEKL	ILYGEVEKL
FLFDGSPTYVL	FLFDGPTYV
NLLKLIAEV	NLLKLIAEV
FLDDVVHSL	FLDDVVHSL
GLNEEIARV	GLNEEIARV
LLAELLTHL	LLAELLTHL
SLIKQIPRI	SLIKQIPRI
ALADGVPVAL	ALADGPVAL
KLIEVDDERKL	KLIEVERKL
SLLDSVVGL	SLLDSVVGL
NLIDLDDLYV	NLIDLDLYV
RLLEQLQEI	RLLEQLQEI
ILYDLQQNL	ILYDLQQNL
FLKLSLGLP	FLKLSLGLP
YLGIVELLV	YLGIVELLV
TLQKLLRQL	TLQKLLRQL
KLQNILSQL	KLQNILSQL
YGDIIAFPL	YGDIIAFPL
VLWDRTFSL	VLWDRTFSL
QLLEKVIEL	QLLEKVIEL
GLLERVKEL	GLLERVKEL
PPRRSLERL	PPRRSLERL
ATLSVVPQL	ATLSVVPQL
ALSEELVQL	ALSEELVQL
ALFQRPPLI	ALFQRPPLI
TLHSIIISL	TLHSIIISL
SLMMTIINL	SLMMTIINL
VLLEPFVHQV	VLLEPVHQV
GLLDRIMQL	GLLDRIMQL
YLINEIDRI	YLINEIDRI
ALHSWFQTL	ALHSWFQTL
SAFYWIDRV	SAFYWIDRV
AQQLQIFNL	AQQLQIFNL
ILNYVLVRV	ILNYVLVRV
KLNPGIAYV	KLNPGIAYV
NIIPIIISL	NIIPIIISL
YLQEVPILTL	YLQEVILTL
VLQRSLVTV	VLQRSLVTV
LLQVVLPAL	LLQVVLPAL
LLLAHIIAL	LLLAHIIAL
LLSEHVIAI	LLSEHVIAI
ILLNIIERL	ILLNIIERL
RLWTPPEDYRL	WTPPEDYRL
TLLPELHLL	TLLPELHLL
ALVDQLWKL	ALVDQLWKL
TLIDLPGITKV	TLIDLITKV
GLSEQIREL	GLSEQIREL
GYLAVAVVR	GYLAVAVVR
GLMEDLLKL	GLMEDLLKL
QLLPSIPQL	QLLPSIPQL
LLQKVISNL	LLQKVISNL
YLLQEPPRTV	LLQEPPRTV
NLASFIEQV	NLASFIEQV
LLGPPPVGV	LLGPPPVGV
FLAELPGSLSL	FLAELPGSL
SIIGRLLEV	SIIGRLLEV
ALAPAPPQV	ALAPAPPQV
GLFSNDIPHV	GLFSNIPHV
QLYDLTLEYL	QLYDLLEYL
SQAERLFNL	SQAERLFNL
GLYGAIFRL	GLYGAIFRL
ALPEAIAAL	ALPEAIAAL
RLYPEGLAQL	RLYPELAQL
LLSHVIVAL	LLSHVIVAL
LLSPHNPAL	LLSPHNPAL
RLTDYISKV	RLTDYISKV
SALFWADKV	SALFWADKV
HLAELIAEL	HLAELIAEL
ALLETNPYLL	ALLETNPYL
ILEENIPVL	ILEENIPVL
NLLSDYGYHL	LLSDYGYHL
AMASIINRL	AMASIINRL
SLLDRFLATV	SLLDRLATV
LVLESLLHL	LVLESLLHL
AVNPHLFSL	AVNPHLFSL
SLIEKLWQT	SLIEKLWQT
SIQALIHGL	SIQALIHGL
YLHLDYNFNL	YLHLDNFNL
ALLDQLHTL	ALLDQLHTL
GVIATIAFL	GVIATIAFL
MLIGEIFEL	MLIGEIFEL
GLIENPALL	GLIENPALL
ATMPDLYHL	ATMPDLYHL
MMLDDLLQL	MMLDDLLQL
LLASEVPQL	LLASEVPQL
LLNSEVHML	LLNSEVHML
SLINVGLISV	SLINVLISV
LLTGYLEYL	LLTGYLEYL
SLLGKLVSM	SLLGKLVSM
WLAEKLPTL	WLAEKLPTL
RVLKELWKL	RVLKELWKL
LLNPHLRQL	LLNPHLRQL
SLWPMTFGL	SLWPMTFGL
KLNAKLAEL	KLNAKLAEL
SLFRVITEV	SLFRVITEV
GLLQQPPAL	GLLQQPPAL
SVLEALSGV	SVLEALSGV
RLLEELQRL	RLLEELQRL
ALADLLLAL	ALADLLLAL
SLIHGLWNL	SLIHGLWNL
ILDEVIFKL	ILDEVIFKL
AVAPGIPAL	AVAPGIPAL
GLFDQHFRL	GLFDQHFRL
GLWEIENNPTV	GLWEINPTV
AALSKFIAV	AALSKFIAV
FLHEATVRL	FLHEATVRL
TGFPWAFKV	TGFPWAFKV
GLQKMVALL	GLQKMVALL
RIFKAWAV	RIFK-AWAV
QQVQRLPFL	QQVQRLPFL
YLFPGIPEL	YLFPGIPEL
QLLPLLEKV	QLLPLLEKV
SLSEELAKL	SLSEELAKL
ALHDQLFYL	ALHDQLFYL
SLLQAPARL	SLLQAPARL
RLAEQIATL	RLAEQIATL
RLNEVIRTL	RLNEVIRTL
KLHGVNINV	KLHGVNINV
HLISTINTV	HLISTINTV
FVNFRLYQL	FVNFRLYQL
GLWEEAYRV	GLWEEAYRV
GTIGLIHAV	GTIGLIHAV
TVNPIIYAL	TVNPIIYAL
RLLDWFRSL	RLLDWFRSL
NLQAVINEV	NLQAVINEV
KILSELFTV	KILSELFTV
ILNSDLANL	ILNSDLANL
LLLDVTPLSL	LLLDVPLSL
LLAENLPGL	LLAENLPGL
FQIRNLPSL	FQIRNLPSL
LLGPGLLATV	LLGPGLATV
GLLEKLTAI	GLLEKLTAI
VIQTEVPPL	VIQTEVPPL
ALQWVVVEV	ALQWVVVEV
SLLQTLYKV	SLLQTLYKV
FAIDPHLLLSV	AIDPHLLSV
HLSSLIAQL	HLSSLIAQL
VLFELKLLL	VLFELKLLL
QLLETLNQL	QLLETLNQL
YLDFTNPKV	YLDFTNPKV
ILSQYITFV	ILSQYITFV
KLLDQMPSL	KLLDQMPSL
GLAATLYSL	GLAATLYSL
ALLETSLLHHF	ALLE-TSLL
VLLQVLHVL	VLLQVLHVL
SLGLIFAL	SLGL-IFAL
SLLGHLMIV	SLLGHLMIV
SLNIITVTL	SLNIITVTL
SVIDHIHLI	SVIDHIHLI
ILTDITKGV	ILTDITKGV
YLADLYHFV	YLADLYHFV
ALSDLEITL	ALSDLEITL
KLLPDTILEKL	LLPDTLEKL
MLLPGPLHSL	MLLPGLHSL
TLIGLSIKV	TLIGLSIKV
TLEEIIFKL	TLEEIIFKL
SLLRGLSQL	SLLRGLSQL
ALSNLEVKL	ALSNLEVKL
AVIEHLERL	AVIEHLERL
YMIAHITGL	YMIAHITGL
GQSELASRLTL	GQSELASRL
SIMDYVVFV	SIMDYVVFV
YLLPSVVLL	YLLPSVVLL
FLQEYGLSV	FLQEYGLSV
ETVLWVVHV	ETVLWVVHV
LIGEIFEL	LIGE-IFEL
ALLSWVNSL	ALLSWVNSL
ITQERIVFL	ITQERIVFL
LLFLQLPLL	LLFLQLPLL
SLLPSVPAL	SLLPSVPAL
TLAETIQGL	TLAETIQGL
TLIEDILGV	TLIEDILGV
GLFAHPSLWQL	FAHPSLWQL
SLLLALPAL	SLLLALPAL
QLNEQLVTL	QLNEQLVTL
YGLDKIEFL	YGLDKIEFL
RILDYVINL	RILDYVINL
YLIPDIDLKL	YLIPDDLKL
GLAQTLEKL	GLAQTLEKL
HLLPDLHAL	HLLPDLHAL
SLQEFLRQL	SLQEFLRQL
ALLESRVNL	ALLESRVNL
ILAPVVKEI	ILAPVVKEI
AMLLEIPYM	AMLLEIPYM
ALVNELYSL	ALVNELYSL
ALGLVVGSHLL	GLVVGSHLL
RLLEGVNQL	RLLEGVNQL
VLQEEPPLL	VLQEEPPLL
LLLAAPAQA	LLLAAPAQA
KLYPWIHQF	KLYPWIHQF
ILQKNVPIL	ILQKNVPIL
GIGLALAAAV	IGLALAAAV
SLLHLGALYGI	SLLHLLYGI
SLYDELRNL	SLYDELRNL
TLNSFIHVL	TLNSFIHVL
YLKEILEQL	YLKEILEQL
KLLFWVTEV	KLLFWVTEV
ADASLLKKV	ADASLLKKV
GLIDKVNEL	GLIDKVNEL
LLTEIRAVV	LLTEIRAVV
KLLDILSYL	KLLDILSYL
FLNELIKVL	FLNELIKVL
QLYRGLGGQL	GLGG---QL
YLFTIINSL	YLFTIINSL
ALSPHNILL	ALSPHNILL
KLVELPYTV	KLVELPYTV
FLLFINHRL	FLLFINHRL
RLLELLTKL	RLLELLTKL
TLLPTLYEI	TLLPTLYEI
ILNPVTTKL	ILNPVTTKL
ILIHDVPLL	ILIHDVPLL
SLFPGKLEV	SLFPGKLEV
FLNEDLNQL	FLNEDLNQL
IILDALPQL	IILDALPQL
AGLSWYHGV	AGLSWYHGV
VLGKIWKL	VLGK-IWKL
TLLRALQAL	TLLRALQAL
SLAELIQAL	SLAELIQAL
SLAPLFFKL	SLAPLFFKL
VLQEWLSHL	VLQEWLSHL
ALATHILSL	ALATHILSL
QLLFSLPKL	QLLFSLPKL
ALYPGQLVQL	ALYPGLVQL
RLLEFELAQL	RLLEFLAQL
TLGHILPTL	TLGHILPTL
HLFDTLHAL	HLFDTLHAL
YLSKIIPAL	YLSKIIPAL
HLSIINEYL	HLSIINEYL
SLLDPVPEV	SLLDPVPEV
RLNGVTLNL	RLNGVTLNL
FISEFEHRV	FISEFEHRV
SLLSQQPFL	SLLSQQPFL
GLLQQPSAL	GLLQQPSAL
ALMEEILKL	ALMEEILKL
QLQNWFTIV	QLQNWFTIV
GLIDVKPLGV	GLIDVPLGV
SVFAGVVGV	SVFAGVVGV
YLVYILNEL	YLVYILNEL
LVELALPQL	LVELALPQL
YLLDLLRLP	YLLDLLRLP
AIMDIVIKV	AIMDIVIKV
TLSGLLWEL	TLSGLLWEL
SLFERLVVL	SLFERLVVL
LLIDDKGTIKL	LLIDDTIKL
AVMAPRTLVLL	VMAPRLVLL
SLLRVGWSV	SLLRVGWSV
LLWGNLPEI	LLWGNLPEI
YLNETFSELRL	YLNETFSEL
FLQDYTLLI	FLQDYTLLI
ILGLIWTI	ILGL-IWTI
YLNDLHEVL	YLNDLHEVL
QMISRIEYI	QMISRIEYI
SLYDWNVKL	SLYDWNVKL
RTMPRIPTL	RTMPRIPTL
SLSAFTPAL	SLSAFTPAL
ILHGLVAAV	ILHGLVAAV
AVFDKTLAEL	AVFDKLAEL
TLFPGKVHSL	TLFPGVHSL
HLSDMLQQL	HLSDMLQQL
QQYQWLEKV	QQYQWLEKV
HLYDIHVTV	HLYDIHVTV
TAMDVVYAL	TAMDVVYAL
KLGSVPVTV	KLGSVPVTV
TLLPQGLPGL	TLLPQLPGL
HVNPYIGLFFF	HVNPYIGLF
ALHDILTEI	ALHDILTEI
SLSDSLFVL	SLSDSLFVL
YLHDFLKYL	YLHDFLKYL
AIASGIYLL	AIASGIYLL
ALQAQITAL	ALQAQITAL
LINELLQVT	LINELLQVT
KLIPFLEKL	KLIPFLEKL
ALLSAVTRL	ALLSAVTRL
AASDFIFLV	AASDFIFLV
LLIENVASL	LLIENVASL
SLADDSVLERL	SLADDLERL
GLAAFRAFL	GLAAFRAFL
SLFQGVEFHYV	SLFQGVEFH
IVAPGTFEV	IVAPGTFEV
QLRNVIERL	QLRNVIERL
NVFDWGAKA	NVFDWGAKA
ILNSLYNENL	ILNSLNENL
LLNPSLQKV	LLNPSLQKV
GLADASLLKKV	GLAD-ASLL
YVQALIFRL	YVQALIFRL
TLSDVVVGL	TLSDVVVGL
GLYEGLTWL	GLYEGLTWL
YLQNWSHVL	YLQNWSHVL
FLLKDLSSL	FLLKDLSSL
ALADKELLPSV	ALADKLPSV
VLQYVVPEV	VLQYVVPEV
VLAPLGFTL	VLAPLGFTL
QLLDVLARL	QLLDVLARL
ALYSELLAV	ALYSELLAV
ALLDSAHLL	ALLDSAHLL
KLLDAYLLYI	KLLDALLYI
ALLDKLYALGL	ALLDKLYAL
TLAAIIEHL	TLAAIIEHL
YLLDLHSYL	YLLDLHSYL
GLSDLRLEL	GLSDLRLEL
KTLGKLWRL	KTLGKLWRL
ALFQHITAL	ALFQHITAL
RVMELFFTV	RVMELFFTV
ALLDWVTSV	ALLDWVTSV
MQISFIHQL	MQISFIHQL
TVFEHTFHV	TVFEHTFHV
FVLPELPSV	FVLPELPSV
SLYEMVSRV	SLYEMVSRV
NIVEKLREV	NIVEKLREV
GLKDGVALL	GLKDGVALL
VLYDWKERL	VLYDWKERL
SLLEAVSFL	SLLEAVSFL
ILQAELPSL	ILQAELPSL
ALVDHVAEL	ALVDHVAEL
LLNDRIWLA	LLNDRIWLA
SVLPESTLFRL	VLPESLFRL
ALAPLLSSL	ALAPLLSSL
ALIEAEKVAQV	ALIEAVAQV
SLQKEILYL	SLQKEILYL
LLAETHYQL	LLAETHYQL
GLWSGPLPRV	GLWSGLPRV
LLSRVLFAL	LLSRVLFAL
ALQEKLWNV	ALQEKLWNV
HLTEVLTLV	HLTEVLTLV
HLQEYTSTLLL	HLQEYTSTL
TVLDFGVLASI	TVLDFGVLA
GLWGPVHEL	GLWGPVHEL
LLSDVRFVL	LLSDVRFVL
LLIGHLERV	LLIGHLERV
LLVSSWDTSV	LVSSWDTSV
FLRNINEYL	FLRNINEYL
NLFHYLTEV	NLFHYLTEV
SLLSPGLLPHL	LLSPGLPHL
ILNEIVNFV	ILNEIVNFV
GLIDENPGL	GLIDENPGL
FINIVVHSV	FINIVVHSV
RLLHEVQEL	RLLHEVQEL
YLLPAIVHI	YLLPAIVHI
RLNPLVLLL	RLNPLVLLL
RVAQLEQVYI	RVAQ-LEQV
ILAAHVPTL	ILAAHVPTL
FLETNVPLL	FLETNVPLL
TLNNLVEKL	TLNNLVEKL
SLLSDYDILSL	LLSDYILSL
QLLIWIPRL	QLLIWIPRL
RLFESINNL	RLFESINNL
ALQAAIQQL	ALQAAIQQL
FVIDLQTRL	FVIDLQTRL
SVLNVLHSL	SVLNVLHSL
ALLRSLVGL	ALLRSLVGL
ALNEKLVNL	ALNEKLVNL
SLASVIFLL	SLASVIFLL
RLFRDLVSL	RLFRDLVSL
LLQDIILQV	LLQDIILQV
LLEPEVFHL	LLEPEVFHL
TLMEEVLLL	TLMEEVLLL
FLGIHVFLV	FLGIHVFLV
SLTDLLNQL	SLTDLLNQL
IIHEIAVLEL	IIHEIVLEL
YVMEYRELFL	YVMEYELFL
RLLFQLAQL	RLLFQLAQL
GSLNWGYRV	GSLNWGYRV
VLSFTIPSL	VLSFTIPSL
KLLNLISKL	KLLNLISKL
HLGDFLVFL	HLGDFLVFL
FLLDKKIGV	FLLDKKIGV
LISKIFPGL	LISKIFPGL
ALLQALMEL	ALLQALMEL
SLQYFIPAL	SLQYFIPAL
SVMSILPKI	SVMSILPKI
GLNEFVVKF	GLNEFVVKF
ALAPYLDLL	ALAPYLDLL
RLLAEIGAVTL	LLAEIAVTL
RLYPWGVVEV	RLYPWVVEV
LLNSGVVHL	LLNSGVVHL
TLVDEVFRI	TLVDEVFRI
RFTEWLHEV	RFTEWLHEV
ILLGKVQQL	ILLGKVQQL
SLLSEIQAL	SLLSEIQAL
HLQAAVAFV	HLQAAVAFV
ALLDQLHTLL	ALLDQLHTL
VLQGAVPTV	VLQGAVPTV
LTMEVIRQV	LTMEVIRQV
YLLQRAVEV	YLLQRAVEV
SVLGKIWKL	SVLGKIWKL
SLASFIPAV	SLASFIPAV
KLFDRPQELKL	KLFDRPQEL
LLSPVVPQI	LLSPVVPQI
RLFSKGFLV	RLFSKGFLV
FLLPVINEM	FLLPVINEM
NIFRWETTI	NIFRWETTI
ILAAIVNHL	ILAAIVNHL
FLINFIHTL	FLINFIHTL
VAAKKIIIQR	AAKKIIIQR
GLADKVYFL	GLADKVYFL
YALNHTLSV	YALNHTLSV
VLADQVWTL	VLADQVWTL
ALQRIISTL	ALQRIISTL
GLGPTFKL	GLGP-TFKL
QLMEQVAQL	QLMEQVAQL
RVFENIVAV	RVFENIVAV
LVLRALDTL	LVLRALDTL
ALNEEAGRLLL	ALNEEAGRL
ALSSLIHAL	ALSSLIHAL
YTTDFIFNL	YTTDFIFNL
QLLDQIWRT	QLLDQIWRT
RLLAYISQV	RLLAYISQV
KLGDFGLLVEL	KLGDFLVEL
FLWDEGFHQL	FLWDEFHQL
KILEDVVGV	KILEDVVGV
TLSERLWGL	TLSERLWGL
TLVLTLPTV	TLVLTLPTV
SLALGLPHL	SLALGLPHL
TLSDIMVSL	TLSDIMVSL
GLADNTVIAKV	GLADNIAKV
SVNPYIVKL	SVNPYIVKL
GLSEPIFQL	GLSEPIFQL
ALLSALHWL	ALLSALHWL
VLLSEILHL	VLLSEILHL
ILLKALTNL	ILLKALTNL
GLLSILRKL	GLLSILRKL
LTNDWEDHL	LTNDWEDHL
ALIVLIHLL	ALIVLIHLL
GVLENIFGV	GVLENIFGV
KLFIGGLNV	KLFIGGLNV
ALYPNVVQV	ALYPNVVQV
ALLETVNRL	ALLETVNRL
YTFDPVTKV	YTFDPVTKV
RLLGYVATL	RLLGYVATL
GLSQVAVTV	GLSQVAVTV
YLTNEGIQYL	YLTNEIQYL
GLHSYFITV	GLHSYFITV
YQFDKVGILTL	YQFDKILTL
AQFGYYFRV	AQFGYYFRV
RLQTWWHGV	RLQTWWHGV
LLRDTINGL	LLRDTINGL
ILKETIEIL	ILKETIEIL
LSFSWLFHT	LSFSWLFHT
ILAETQPEL	ILAETQPEL
FMLPDPQNISL	FMLPDPQNI
FLPEAPAEL	FLPEAPAEL
YQEEAIPAL	YQEEAIPAL
SMLTYPFLL	SMLTYPFLL
KLQEFLQTL	KLQEFLQTL
KINEAIVAV	KINEAIVAV
FLNKLIPVL	FLNKLIPVL
ALQGSAWQV	ALQGSAWQV
FLFELPSRL	FLFELPSRL
SVVSWKTGV	SVVSWKTGV
QLPNFAFSV	QLPNFAFSV
TMLDILQTL	TMLDILQTL
NLYPFVKTV	NLYPFVKTV
RLVPFLVEL	RLVPFLVEL
SLSEKTVLL	SLSEKTVLL
ALIPVINKL	ALIPVINKL
SLNQAALYRL	SLNQALYRL
SLHVWKIVV	SLHVWKIVV
LLRLQVEEL	LLRLQVEEL
SLQDEIQRV	SLQDEIQRV
QLQDYIQLL	QLQDYIQLL
ALNNLLHSL	ALNNLLHSL
RVSELLQGL	RVSELLQGL
FLQEAQVPFL	FLQEAVPFL
GLLEARGILGL	GLLEAILGL
LLATVLQAV	LLATVLQAV
LLFEGEKITI	LLFEGKITI
LLHDGIPVV	LLHDGIPVV
FLAERLYAEV	FLAERYAEV
LLFTWEELI	LLFTWEELI
ALYHLAIKL	ALYHLAIKL
HLFDAFVSV	HLFDAFVSV
TLWYRAPEVLL	TLWYRAPEV
KLGEFAKVLEL	KLGEFAKVL
YLNHLIQGL	YLNHLIQGL
SVAVWSGVNV	SVAVWGVNV
KMQETLVGL	KMQETLVGL
ILSVFIPSL	ILSVFIPSL
RLFDEPQLASL	RLFDELASL
NLANVVLLL	NLANVVLLL
IMLEALERV	IMLEALERV
AQLDPEALGNI	AQLD-PEAL
SIYGGFLLGV	SIYGGLLGV
SVAFKIFEL	SVAFKIFEL
VLFNKLTYL	VLFNKLTYL
AQIFAIYQL	AQIFAIYQL
YQILDGIHYL	QILDGIHYL
TLWNEIERL	TLWNEIERL
KLQDQIFNL	KLQDQIFNL
FLGADLPNL	FLGADLPNL
ILQSLLETL	ILQSLLETL
YLLDQHILI	YLLDQHILI
SLLPPDALVGL	SLLPPDALV
ALYNWLIQV	ALYNWLIQV
TLLDWQDSL	TLLDWQDSL
SIHDVTFQV	SIHDVTFQV
LLPDNVHYV	LLPDNVHYV
VLLSTIHEL	VLLSTIHEL
ALLSKNLSV	ALLSKNLSV
NLLSNIQKL	NLLSNIQKL
LLNPAYDVYL	LLNPADVYL
KTIDYIQFL	KTIDYIQFL
YAITTLHNL	YAITTLHNL
ALLELLERL	ALLELLERL
HLWNSIHGL	HLWNSIHGL
ALQPSIKFV	ALQPSIKFV
ILQDLTFVHL	ILQDLFVHL
TLTSKLYSL	TLTSKLYSL
ALSDLALHFL	ALSDLLHFL
SLFEWFHPL	SLFEWFHPL
SLADIAQKL	SLADIAQKL
LLIDELNKL	LLIDELNKL
KLLPGIEVL	KLLPGIEVL
FLYDTHQNL	FLYDTHQNL
YLSSLQPRL	YLSSLQPRL
FLLPKVQSI	FLLPKVQSI
FLFVDPELVSA	FLFVDPELV
QLLQYVYNL	QLLQYVYNL
RLLDYVVNI	RLLDYVVNI
TLLAAEFLKQV	LLAAELKQV
KLLKQVDFL	KLLKQVDFL
FVIPVVQAL	FVIPVVQAL
LLSEILHLL	LLSEILHLL
VLFHQLQEI	VLFHQLQEI
GLSAFLHAI	GLSAFLHAI
YLHNQGIGV	YLHNQGIGV
LLLDVPTAAV	LLLDVTAAV
FLIPKFFEL	FLIPKFFEL
ILAELLLRV	ILAELLLRV
YILGKFFAL	YILGKFFAL
QLTNVILHL	QLTNVILHL
RIAEYAFKL	RIAEYAFKL
GLLDLPFRV	GLLDLPFRV
SLLDQLRKL	SLLDQLRKL
KLLKDLPEL	KLLKDLPEL
FVFPGELLL	FVFPGELLL
ALLPDLPAL	ALLPDLPAL
ALLAYTLGV	ALLAYTLGV
RVADILTQL	RVADILTQL
KIQEILTQV	KIQEILTQV
YLGPHIASV	YLGPHIASV
ILSPTVVSI	ILSPTVVSI
ALYQSLPTL	ALYQSLPTL
QLSPVLLYL	QLSPVLLYL
GLLTRLLQV	GLLTRLLQV
TLQEKIHRL	TLQEKIHRL
TLSEALLQL	TLSEALLQL
VLNGKFANL	VLNGKFANL
YLASLIRSV	YLASLIRSV
TLWYRPPEL	TLWYRPPEL
GLIDEIYGI	GLIDEIYGI
SLSSEFKNITV	SLSSEFKNI
ILLGYLDQL	ILLGYLDQL
ILVSWLPRL	ILVSWLPRL
ALASVIKEL	ALASVIKEL
KLIEELETL	KLIEELETL
NLNSIVPSV	NLNSIVPSV
SLAEFVQSL	SLAEFVQSL
QILEGVHFL	QILEGVHFL
GLLTEIRAV	GLLTEIRAV
SIAEVVHQL	SIAEVVHQL
SVITQVFHV	SVITQVFHV
ALLDRIVSV	ALLDRIVSV
SLWFKPEEL	SLWFKPEEL
LLLEILHEI	LLLEILHEI
GIAPQIQDL	GIAPQIQDL
FLLPDGLVRL	FLLPDLVRL
KLFPKGTIFTA	KLFPKIFTA
SLVNEIFRL	SLVNEIFRL
RIAEFTTNL	RIAEFTTNL
ALSDHHIYL	ALSDHHIYL
YLNSILQVL	YLNSILQVL
VLNNVVIHL	VLNNVVIHL
TMLELINQL	TMLELINQL
RVIDYILDL	RVIDYILDL
SLHEFLVNL	SLHEFLVNL
GLEEKLPSL	GLEEKLPSL
AIIEYMPLL	AIIEYMPLL
YLHSQVVSV	YLHSQVVSV
ALYTGFSILV	ALYTGFSIL
AILLEIPRL	AILLEIPRL
RIIDVVYNA	RIIDVVYNA
NLIRWSDQV	NLIRWSDQV
ILQVGLREL	ILQVGLREL
AVAEQIPLL	AVAEQIPLL
SLKGTLDNL	SLKGTLDNL
ALSPNYDHVVL	ALSPNYDHV
ATIGELAQV	ATIGELAQV
SILASLHAL	SILASLHAL
SLNHLLNYV	SLNHLLNYV
LLAEPVPGI	LLAEPVPGI
GLSIFIYRL	GLSIFIYRL
TIGKEIIDPVL	IGKEIIDPV
YLRIDLERL	YLRIDLERL
GLYPNLIQV	GLYPNLIQV
IIMETVPQL	IIMETVPQL
GLLNVLSQL	GLLNVLSQL
ALFEAAREVTL	ALFEAAREV
ALYDNVEKL	ALYDNVEKL
GLIEDYEALL	GLIEDYEAL
ILASLLRNL	ILASLLRNL
VLPRLHQL	VLPR-LHQL
YLVVKIEKV	YLVVKIEKV
SVLELIPEL	SVLELIPEL
VLLPGLQKL	VLLPGLQKL
ALNFIISYL	ALNFIISYL
TLLERAFSL	TLLERAFSL
FLFDGSPTYV	FLFDGPTYV
VLLSHLSYL	VLLSHLSYL
GLAPHLEQI	GLAPHLEQI
FILEKIEYL	FILEKIEYL
ILNNNLNTL	ILNNNLNTL
TLLQNIPSF	TLLQNIPSF
TLLEDGTFKV	TLLEDTFKV
ALLAELEKI	ALLAELEKI
ELNPSIPLL	ELNPSIPLL
GLTSTDLLFHL	TSTDLLFHL
ALLTYLEQV	ALLTYLEQV
GLSNHIAAL	GLSNHIAAL
LVLDKLFQL	LVLDKLFQL
LLWHWDTTQSL	LLWHWTQSL
ILSEVQQAV	ILSEVQQAV
ILYGKIIHL	ILYGKIIHL
ELNNQNFYL	ELNNQNFYL
ILFEEYQFQA	ILFEEQFQA
QMREFLEQL	QMREFLEQL
SVMNSVVSL	SVMNSVVSL
NLFDLGGQYL	NLFDLGQYL
IIEENIPEL	IIEENIPEL
ALNIATHVL	ALNIATHVL
FVNEIISRI	FVNEIISRI
LLLPTGVFQV	LLLPTVFQV
SLLNWRTKL	SLLNWRTKL
HIIENIVAV	HIIENIVAV
QLQEIIARL	QLQEIIARL
FTLGDIAQL	FTLGDIAQL
TILPGLPEL	TILPGLPEL
KLLDIPGLEV	KLLD-IPGL
SLAEKIQAL	SLAEKIQAL
HLLPKIENL	HLLPKIENL
SLYPQFMFHL	SLYPQMFHL
YLFREPATI	YLFREPATI
ALTRVIYNL	ALTRVIYNL
GVVDGIYRL	GVVDGIYRL
ALQERLDGL	ALQERLDGL
RLAPTLSQL	RLAPTLSQL
ITLLWDREV	ITLLWDREV
ALFIRPFML	ALFIRPFML
ALASVIMGL	ALASVIMGL
INDQLRCTTWL	QLRC-TTWL
TLQEQIEAI	TLQEQIEAI
ALFETLIQL	ALFETLIQL
AAMPRIYEL	AAMPRIYEL
LLQAFISQL	LLQAFISQL
RLQEFIDEV	RLQEFIDEV
RTLPKLYSL	RTLPKLYSL
TLFHDPWKLLI	TLFHDPWKL
IILDEIHLL	IILDEIHLL
QLFDQIPEL	QLFDQIPEL
WLTPVIPAL	WLTPVIPAL
TLAYDKGWRV	LAYDKGWRV
VLAQQIATL	VLAQQIATL
YLQARFPQL	YLQARFPQL
ILRAELEAL	ILRAELEAL
KLQEQIFHL	KLQEQIFHL
YLKDLIEEV	YLKDLIEEV
SVLGAITSV	SVLGAITSV
TLWVDPYEV	TLWVDPYEV
KVFGWVHRL	KVFGWVHRL
YLKDFFSNV	YLKDFFSNV
RLQTQVFKL	RLQTQVFKL
SLIEDLILL	SLIEDLILL
WLIEDGKVVTV	LIEDGVVTV
RLQSIVAGL	RLQSIVAGL
ALLAKILQI	ALLAKILQI
VILPTVHEV	VILPTVHEV
RLVSWVNLI	RLVSWVNLI
SALPWNITV	SALPWNITV
IIQDIDDTHVF	IIQDIDTHV
YQYPVIIHL	YQYPVIIHL
ALTSVVVTL	ALTSVVVTL
HLSVVSVTV	HLSVVSVTV
ALMELFPKL	ALMELFPKL
VMQDIVYKL	VMQDIVYKL
YLAELVTPIL	YLAELVTPI
TLQQQTFKI	TLQQQTFKI
SLQSLIISV	SLQSLIISV
FLAEHPNVTL	FLAEHNVTL
RLLPVIFLV	RLLPVIFLV
NLNQFLPEL	NLNQFLPEL
TLTGKTITL	TLTGKTITL
RIADGLPVAV	RIADGPVAV
LLKEYLVTL	LLKEYLVTL
SLATSLPRL	SLATSLPRL
IQQDKIYLL	IQQDKIYLL
YMAELIERL	YMAELIERL
KLLDLIEDL	KLLDLIEDL
FQTDLIYNL	FQTDLIYNL
AVLPRLHQL	AVLPRLHQL
SINGVIFGL	SINGVIFGL
ALLQRLEAL	ALLQRLEAL
QLLQILQSL	QLLQILQSL
FINARNWTL	FINARNWTL
AIMPTIFNL	AIMPTIFNL
TLWEIAKAEV	TLWEIKAEV
ILLAEGRLVNL	LLAEGLVNL
TLGQIYYL	TLGQ-IYYL
SLSFLVPSL	SLSFLVPSL
RLLEFLVAL	RLLEFLVAL
SLSDLLVSL	SLSDLLVSL
RLLPRLLLL	RLLPRLLLL
QMLELITRL	QMLELITRL
VVLEEIPKL	VVLEEIPKL
FLMDFIHQV	FLMDFIHQV
ALSYILPYL	ALSYILPYL
GLQDLLFSL	GLQDLLFSL
SILEHQIQV	SILEHQIQV
ALSIQNYHL	ALSIQNYHL
ALTPVWVLI	ALTPVWVLI
FLLDKALLI	FLLDKALLI
YITRYIASL	YITRYIASL
ALKSLIPTL	ALKSLIPTL
HLFEDAYLLTL	HLFEDAYLL
ALTPVVVTL	ALTPVVVTL
TLVYHVVGV	TLVYHVVGV
GILGIQPPSV	ILGIQPPSV
KLFDTQQFL	KLFDTQQFL
ALSPQLQQL	ALSPQLQQL
SIIEYLPTL	SIIEYLPTL
FLLPIKTVGV	FLLPITVGV
ALSHILTAL	ALSHILTAL
ALVSSLHLL	ALVSSLHLL
YLITLLEHL	YLITLLEHL
ALMPVLNQV	ALMPVLNQV
SLIGHLQTL	SLIGHLQTL
QLLTQIHLL	QLLTQIHLL
SLHFLILYV	SLHFLILYV
HLLLFLQQL	HLLLFLQQL
KIVNTPEVIRV	IVNTPVIRV
FVHDLVLYL	FVHDLVLYL
SLIRNLEQL	SLIRNLEQL
MTLPNLPRL	MTLPNLPRL
SLSGYINYL	SLSGYINYL
FVMETFVHL	FVMETFVHL
LLINQLWQL	LLINQLWQL
SLHPSLPLL	SLHPSLPLL
AMLERLLSL	AMLERLLSL
SLIFKLEEL	SLIFKLEEL
FINELITEL	FINELITEL
KLAAVVNNL	KLAAVVNNL
LLLNELPSV	LLLNELPSV
FLLDGKVLSL	FLLDGVLSL
KLNDLIQRL	KLNDLIQRL
KVPEWVDTV	KVPEWVDTV
LKLDDTERRIK	KLDDTERRI
SQPGPRLPFI	QPGPRLPFI
FLSTLHEVYL	FLST-LHEV
LLQDKQFEL	LLQDKQFEL
SISCCIDPLI	SISCCIDPL
SLQLRIQEL	SLQLRIQEL
ALGEQVIAL	ALGEQVIAL
LLYQGPHNTL	LLYQGHNTL
VVLPAPPAV	VVLPAPPAV
TLIELLLPKL	TLIELLPKL
LLLPDYYLVTV	LLLPDLVTV
YLHSYLTYI	YLHSYLTYI
SLRSVLFGL	SLRSVLFGL
SPSLKLPLS	SPSLKLPLS
LLFPHPVNQV	LLFPHVNQV
QLQGYLRSV	QLQGYLRSV
TLVSWVALT	TLVSWVALT
ALSGLAVRL	ALSGLAVRL
TTVGWDHQV	TTVGWDHQV
LSLENLEKI	LSLENLEKI
TLLEEIRDLAL	TLLEEIRDL
KLQELNYNL	KLQELNYNL
ILVDWLVQV	ILVDWLVQV
GLSPEIHTL	GLSPEIHTL
STLRVLYNL	STLRVLYNL
SVMDRLSYL	SVMDRLSYL
KLFGMIITI	KLFGMIITI
VLQQRLIAL	VLQQRLIAL
QLEQWEFRV	QLEQWEFRV
YLAPFLRNV	YLAPFLRNV
AIMKIISAL	AIMKIISAL
SLSQVFLHL	SLSQVFLHL
YLTAEVLEL	YLTAEVLEL
KLISELQKL	KLISELQKL
QLVDIIEKV	QLVDIIEKV
SLAFADLLVSV	AFADLLVSV
GLPEAPPFL	GLPEAPPFL
ILLDDTGLAYI	ILLDDLAYI
SLLELPHPL	SLLELPHPL
KLLDFGSLSNL	KLLDFLSNL
SLSSFLERL	SLSSFLERL
AVADILFLL	AVADILFLL
YLADVTNAL	YLADVTNAL
KLQDAEIARL	KLQDAIARL
SLLDEVLNV	SLLDEVLNV
LINVPPPFL	LINVPPPFL
GLNEEITKL	GLNEEITKL
GLAAKLMEL	GLAAKLMEL
IQIMKVEEI	IQIMKVEEI
ALATLIHQV	ALATLIHQV
TLTSFITSL	TLTSFITSL
ILWSEAIFL	ILWSEAIFL
RLYHELVGL	RLYHELVGL
YLYDRLLRI	YLYDRLLRI
HLLFWGVLA	HLLFWGVLA
ALFEESGLIRI	ALFEELIRI
YLNVQVKEL	YLNVQVKEL
QLLQILQAL	QLLQILQAL
GLGEDIIHQL	GLGEDIHQL
RLLEVPVML	RLLEVPVML
ALWGFFPVL	ALWGFFPVL
LLSELLEHL	LLSELLEHL
ALTELLAKI	ALTELLAKI
KLLDPEDISV	LLDPEDISV
YLYKYLWRL	YLYKYLWRL
SLSFMNPRL	SLSFMNPRL
RLLEESLLSLI	RLLEELLSL
KLLPQLTYL	KLLPQLTYL
AMQEFLTRL	AMQEFLTRL
AILPHLRSL	AILPHLRSL
TLLDFINAV	TLLDFINAV
SVSSVVHYL	SVSSVVHYL
SLRDLIQGL	SLRDLIQGL
ALQALVVTL	ALQALVVTL
TLTNIIHNL	TLTNIIHNL
FTLSHITQL	FTLSHITQL
TLLAGITGV	TLLAGITGV
YLLPYENLL	YLLPYENLL
WLQEHVADL	WLQEHVADL
ALLARFPNL	ALLARFPNL
ALLDIIRSL	ALLDIIRSL
VLFDVTGQVRL	VLFDVTGQV
ALLELLHEL	ALLELLHEL
YLYEEYLQAF	YLYEELQAF
SLLPPTALVGL	SLLPPTALV
AALFKAWAL	AALFKAWAL
ALYVAVVNV	ALYVAVVNV
FLRDNLEWL	FLRDNLEWL
RLPEIYIQL	RLPEIYIQL
RLAVYIDRV	RLAVYIDRV
LIQELIHNL	LIQELIHNL
RLNELMSQI	RLNELMSQI
AVLESIERL	AVLESIERL
KVADYIPQL	KVADYIPQL
HLLHEPPAL	HLLHEPPAL
FLSDGTIISV	FLSDGIISV
SLLSDIIAL	SLLSDIIAL
IIFVPVPQL	IIFVPVPQL
LLLDMQNRL	LLLDMQNRL
LVVDWLESI	LVVDWLESI
ALLDKLYAL	ALLDKLYAL
KLWDIINVNI	KLWD-IINV
ALEEYGPELHV	ALEEYGPEL
RVVDYLTKL	RVVDYLTKL
SLSEYVSRM	SLSEYVSRM
GVLPNIQAV	GVLPNIQAV
ALILEPSLYTV	ILEPSLYTV
QLLDTIRSL	QLLDTIRSL
YLFTFLNHL	YLFTFLNHL
SVVESVFKL	SVVESVFKL
YQNQEIHNL	YQNQEIHNL
ALGKSPFQL	ALGKSPFQL
ILQNKIDLV	ILQNKIDLV
ALFARPDLLLL	ALFARPDLL
RLQEEINEV	RLQEEINEV
RLNPINTTL	RLNPINTTL
TQLATIWTL	TQLATIWTL
ILLPYVSKV	ILLPYVSKV
LLATEIERL	LLATEIERL
SLIDKPTNL	SLIDKPTNL
TLQEFLERIHL	TLQEFLERI
QLLSYIDRL	QLLSYIDRL
YILPWESEL	YILPWESEL
ALIEKLVEL	ALIEKLVEL
HILDILPRL	HILDILPRL
RMNQEIVNL	RMNQEIVNL
SLSDTVEKL	SLSDTVEKL
LLWWLQPRL	LLWWLQPRL
FQLEHIMDL	FQLEHIMDL
KGFKWGFAA	KGFKWGFAA
SLLPEGPPAI	SLLPEPPAI
KLQQELEFL	KLQQELEFL
FLFDHLLTL	FLFDHLLTL
VLFGLLREV	VLFGLLREV
LMEHIHKL	LMEH-IHKL
KLLEYIEEI	KLLEYIEEI
KIAPNTPQL	KIAPNTPQL
KLLNAINTL	KLLNAINTL
SLSHLVPAL	SLSHLVPAL
ALGPGVPHI	ALGPGVPHI
QLIPNVQQL	QLIPNVQQL
GLLQINDKIAL	GLLQINDKI
VIWEHDYTSV	VIWEHYTSV
VLKVFLENV	VLKVFLENV
ALLSGQLNTL	ALLSGLNTL
AVQEKVFEL	AVQEKVFEL
ALNSKILSV	ALNSKILSV
VLQQHINSL	VLQQHINSL
LLKDSIVQL	LLKDSIVQL
KLLEPVLLL	KLLEPVLLL
LLLEAVWHL	LLLEAVWHL
ALQASIVKL	ALQASIVKL
SLAQYLINV	SLAQYLINV
ISNIVFTSL	ISNIVFTSL
YLLDMPLWYL	YLLDMLWYL
IVMEHVVFL	IVMEHVVFL
KLLGELHTL	KLLGELHTL
KLLNIIDLQFL	LLNIILQFL
GMSEFLRAL	GMSEFLRAL
NLINNIFEL	NLINNIFEL
TLIEELKTL	TLIEELKTL
YLLESVNKL	YLLESVNKL
NLLEIAPHL	NLLEIAPHL
FMIDASVHPTL	IDASVHPTL
KLADIQIEQL	KLADIIEQL
TLLAYLEGL	TLLAYLEGL
SLVTGITAL	SLVTGITAL
SLLPFLKAV	SLLPFLKAV
PLSKPLPEL	PLSKPLPEL
SIYPSPTGV	SIYPSPTGV
SLLALLHSL	SLLALLHSL
LLAGVVPLL	LLAGVVPLL
ILQDDIESL	ILQDDIESL
LLASIPAAV	LLASIPAAV
SAIDRIFTL	SAIDRIFTL
ILSPWGAEV	ILSPWGAEV
YLTAEILEL	YLTAEILEL
YLYPDITRL	YLYPDITRL
FLVEHVLTL	FLVEHVLTL
LLVGFVHYL	LLVGFVHYL
ALQDQLLKL	ALQDQLLKL
SLNQDIPAF	SLNQDIPAF
GLIRYISGI	GLIRYISGI
SLASLLVSV	SLASLLVSV
TLMSLPTKI	TLMSLPTKI
RLLSQVRAL	RLLSQVRAL
GMYIFLHTV	GMYIFLHTV
TLADYLHLLQA	TLADYLHLL
IIAAWTVRV	IIAAWTVRV
NILELLHRL	NILELLHRL
QLLSEITRV	QLLSEITRV
KVQEVIFGL	KVQEVIFGL
YTTDFIYQL	YTTDFIYQL
ELSDVLIYL	ELSDVLIYL
ALARLVLRL	ALARLVLRL
QLIPKLIFL	QLIPKLIFL
VLLGHILPGL	LLGHILPGL
ALSDIFQAV	ALSDIFQAV
ILLPDNVHYV	ILLPDVHYV
SVLSKLSQL	SVLSKLSQL
LFLGGLDAL	LFLGGLDAL
NLLESLSGL	NLLESLSGL
LLQEPPRTV	LLQEPPRTV
LLREKVEFL	LLREKVEFL
YIFEEPFTIR	YIFEEPFTI
LLYDLADQLHA	LLYDLADQL
ALLGILQHV	ALLGILQHV
YLNDGLWHM	YLNDGLWHM
GLSPVTNLTV	GLSPVNLTV
GLIDTKELEPL	GLID-TKEL
RLFDWLVSV	RLFDWLVSV
WIQNKIPYL	WIQNKIPYL
FLIEEQKIVV	FLIEEQKIV
SLIKQIPRIL	SLIKQIPRI
FLSNDTVQL	FLSNDTVQL
YIWDRHYNI	YIWDRHYNI
KLWSETFDV	KLWSETFDV
YIMEPSIFNTL	SIFN---TL
VLQYQLQHL	VLQYQLQHL
ALVEDIINL	ALVEDIINL
QLLEFLDRL	QLLEFLDRL
HVQDIVFQL	HVQDIVFQL
HLLDIYIQL	HLLDIYIQL
YLRNLTWTL	YLRNLTWTL
HLFSGHLSTL	HLFSGLSTL
IIADNIIFL	IIADNIIFL
GLTEALHFV	GLTEALHFV
FLRELVITI	FLRELVITI
YLRELLTTM	YLRELLTTM
TLINKINNL	TLINKINNL
TLYEAVREV	TLYEAVREV
RLINQVLEL	RLINQVLEL
LLKEIKDILK	LLKEIKDIL
TQILSVPKV	TQILSVPKV
ALSSVIKEL	ALSSVIKEL
TLADVLYHV	TLADVLYHV
SMADIPLGFGV	SMADIPLGF
IQLPSVNTV	IQLPSVNTV
KIVDFSYSV	KIVDFSYSV
HVLSVIWQL	HVLSVIWQL
YLTDRVMTV	YLTDRVMTV
ALNAVRLLV	ALNAVRLLV
NLHHWIDLI	NLHHWIDLI
NLNEKINHL	NLNEKINHL
LLQMGLHVL	LLQMGLHVL
YLTEVFLHV	YLTEVFLHV
ILNDNINLL	ILNDNINLL
SLQEEIAKL	SLQEEIAKL
LSEKLARL	LSEK-LARL
FLLEGIRSL	FLLEGIRSL
ALAEALKEVSL	ALAEALKEV
ILVSQLEQL	ILVSQLEQL
SLIEKYFSV	SLIEKYFSV
VLQDPIWLL	VLQDPIWLL
SVIEQLFFV	SVIEQLFFV
QLLPLIVNL	QLLPLIVNL
KIQAKIPGL	KIQAKIPGL
SLLSHVEQL	SLLSHVEQL
LLTNVLETL	LLTNVLETL
ALQAEIAAL	ALQAEIAAL
KIGSIIFQV	KIGSIIFQV
GLFRLWAL	GLFR-LWAL
FLVTVIHTL	FLVTVIHTL
KLYDIDVAKV	KLYDIVAKV
GVISGLFEL	GVISGLFEL
ALNPVANFHL	ALNPVNFHL
YLQIHPQEL	YLQIHPQEL
KVINTPEVLRV	KVINTPEVL
VLFPWQARL	VLFPWQARL
YIFEEPFTI	YIFEEPFTI
RVNQAIWLL	RVNQAIWLL
ATLGVALLF	ATLGVALLF
ISERYGPVFTI	ERYGPVFTI
YLQEIQTQL	YLQEIQTQL
VLQQHLETL	VLQQHLETL
VLGELVPRL	VLGELVPRL
NVQVVIPFL	NVQVVIPFL
ALLRLLPGL	ALLRLLPGL
SLQELLIQV	SLQELLIQV
ELVEYLPQL	ELVEYLPQL
GVIDGHIYAV	GVIDGIYAV
SISDVIAQV	SISDVIAQV
TLNNLEIFL	TLNNLEIFL
LLFDRPMHV	LLFDRPMHV
FLSHIPITL	FLSHIPITL
RVMEYINRL	RVMEYINRL
LLAEKVEQL	LLAEKVEQL
ILHSVTTNL	ILHSVTTNL
GLYELVWRV	GLYELVWRV
LLGDLLFHI	LLGDLLFHI
ILWEHLEIL	ILWEHLEIL
SLLEDLSHI	SLLEDLSHI
TLLVVVPKL	TLLVVVPKL
ALRDQVPTL	ALRDQVPTL
SLPDIKVYL	SLPDIKVYL
TLLPVIQFL	TLLPVIQFL
VLFSSPPQM	VLFSSPPQM
SLWEDYPHVHL	SLWEDYPHV
SVYPNGHFV	SVYPNGHFV
DQILKLLSL	DQILKLLSL
KVLGALLFV	KVLGALLFV
LLYHYWIAV	LLYHYWIAV
VLNEAAQILRL	VLNEAAQIL
SLADIAQKLQL	SLADIAQKL
VLIDYQRNV	VLIDYQRNV
LLFSFAQAV	LLFSFAQAV
LILDEVHLL	LILDEVHLL
AQVEEIWSL	AQVEEIWSL
SLQQRTWLI	SLQQRTWLI
RLQQVLTGL	RLQQVLTGL
FLQPELVKL	FLQPELVKL
IDVNMGEVLLV	VNMGEVLLV
YLFDVQRNNIA	YLFDVRNNI
YLVPELDGV	YLVPELDGV
RLALVISEL	RLALVISEL
QLLPGGLQGL	QLLPGLQGL
AVASFVTQL	AVASFVTQL
VLIPKLPQL	VLIPKLPQL
FVLQRLVFL	FVLQRLVFL
ILLSEPGLVKL	LLSEPLVKL
RLLEEIHAM	RLLEEIHAM
ALLFYLEQL	ALLFYLEQL
ALIRYLETM	ALIRYLETM
ILLSGIYNV	ILLSGIYNV
YLITSVELL	YLITSVELL
VQIGDIVTV	VQIGDIVTV
YLLDLHSYLL	YLLDLHSYL
YLGNINPQM	YLGNINPQM
ALSSLAVVV	ALSSLAVVV
ALSPINIQL	ALSPINIQL
FLLPHPGLQV	FLLPHGLQV
QLRDFYFSV	QLRDFYFSV
LLQLPEPLP	LLQLPEPLP
YLQPFLAKL	YLQPFLAKL
NLITYDDRFNL	ITYDDRFNL
HLSDHLSEL	HLSDHLSEL
KQVEEIFNL	KQVEEIFNL
ILLAEVPTM	ILLAEVPTM
KLFSLQDLLLL	SLQD-LLLL
LQWDKVLRL	LQWDKVLRL
LTQEQLHQL	LTQEQLHQL
ALLAGSEYLKL	ALLAGSEYL
LLAAWTARA	LLAAWTARA
GLGIVFSL	GLGI-VFSL
FLITILDHL	FLITILDHL
FIFSYITAV	FIFSYITAV
SVYSWDIVV	SVYSWDIVV
YLSVKIWDL	YLSVKIWDL
FLFGYPKRL	FLFGYPKRL
AQIPVVFRL	AQIPVVFRL
RLLEPAQVQQL	LLEPAVQQL
FLLDGFPRTV	FLLDGPRTV
ILNERVELL	ILNERVELL
GLNDFIQKI	GLNDFIQKI
FLFNAIETM	FLFNAIETM
VLQGLTFTL	VLQGLTFTL
AQAQEVFFL	AQAQEVFFL
TLSDLRVYL	TLSDLRVYL
LLAPIVFVL	LLAPIVFVL
WLVDHVYAI	WLVDHVYAI
TLLEISDLNEL	TLLEILNEL
FLVPVLEAL	FLVPVLEAL
SLLPTSPRL	SLLPTSPRL
ILSPNLFQL	ILSPNLFQL
ALFISPALI	ALFISPALI
TLNSFISVL	TLNSFISVL
RLFENLRML	RLFENLRML
FLMNEVIKL	FLMNEVIKL
VLGKVIFQV	VLGKVIFQV
STSPWIPQL	STSPWIPQL
NLIGKIEKL	NLIGKIEKL
FLREYFERL	FLREYFERL
GLYQEILAQL	GLYQELAQL
EVGLSLEPV	EVGLSLEPV
HIHLWISYI	HIHLWISYI
ALGSVVAV	ALGS-VVAV
ILNPEVVTV	ILNPEVVTV
TLYDIAHTPGV	TLYDIAHTP
FLYAGHIFL	FLYAGHIFL
WIQNKLPQL	WIQNKLPQL
SLFEGTWYL	SLFEGTWYL
ALNPAALTAL	ALNPALTAL
FLPPYTFQI	FLPPYTFQI
SLASHIQSL	SLASHIQSL
FLFQEPRSI	FLFQEPRSI
RISDVHFSV	RISDVHFSV
ALFSFLYHL	ALFSFLYHL
KLLDLQVRV	KLLDLQVRV
KLSQYLIQL	KLSQYLIQL
SLLNFLQHL	SLLNFLQHL
HLTDITLKV	HLTDITLKV
FLNGEVIRL	FLNGEVIRL
AISGVPVLGF	AISG-VPVL
SVIEQIVYV	SVIEQIVYV
SIIENLAIF	SIIENLAIF
ALTSEIALL	ALTSEIALL
RLLDALEFL	RLLDALEFL
GLTEGIWQL	GLTEGIWQL
FLIQNVLRL	FLIQNVLRL
VLQVHLNGL	VLQVHLNGL
IEVIVILML	IEVIVILML
TLYFSYTHMV	TLYFSTHMV
RTLETLIRL	RTLETLIRL
TLIEELKAL	TLIEELKAL
GLTWGFGVA	GLTWGFGVA
RLLEALQGL	RLLEALQGL
AVLEKRVEL	AVLEKRVEL
GILLRLPQV	GILLRLPQV
RLQDILWFL	RLQDILWFL
YLINFEIRSL	YLINFIRSL
ALLSRLEQI	ALLSRLEQI
VLNALLPTL	VLNALLPTL
SLLHMPFTI	SLLHMPFTI
YVAELIQQL	YVAELIQQL
SLAELKGFEV	SLAELGFEV
RLLLHLEEL	RLLLHLEEL
KLTNGIWVL	KLTNGIWVL
PPYTVVYFPVR	YTVVYFPVR
FLGTFILKV	FLGTFILKV
SIATWGIVV	SIATWGIVV
YLIKDIRFL	YLIKDIRFL
VLWGETVHL	VLWGETVHL
TLAELLVLL	TLAELLVLL
AILHLLVSL	AILHLLVSL
SILETITSL	SILETITSL
RLAPAQWFL	RLAPAQWFL
FLFDNDFPAL	FLFDNFPAL
TLSDIVVTL	TLSDIVVTL
NLAAYVPLL	NLAAYVPLL
ALIPETTTLTV	ALIPETTTL
AQRDIIFEL	AQRDIIFEL
ALFPAPLAQI	ALFPALAQI
FLFASTILHL	FLFASILHL
FLNNQIKEL	FLNNQIKEL
FLYPFPLAL	FLYPFPLAL
GLAERISVL	GLAERISVL
VILKILPTL	VILKILPTL
GLLDLPFRVGV	GLLDLPFRV
ILDQKINEV	ILDQKINEV
QLFEDLVYL	QLFEDLVYL
ILNPIFRQNL	ILNPIRQNL
GLSGIIPTL	GLSGIIPTL
KVFDPVPVGV	KVFDPPVGV
VIQDFINAL	VIQDFINAL
KLLEVQILEV	KLLEVILEV
RILDIDIPMSV	RILDIPMSV
VLYDRPLKI	VLYDRPLKI
YQVGVHYEL	YQVGVHYEL
YLYFFRVLV	YLYFFRVLV
GMQIRIHQI	GMQIRIHQI
QLMNLIRSV	QLMNLIRSV
VLQDIQVML	VLQDIQVML
KIISALPQL	KIISALPQL
GLSPSIQTL	GLSPSIQTL
FLADPSAFVAA	FLADPSAFV
SLLEALNGL	SLLEALNGL
VLQELINVL	VLQELINVL
SLLPAIVEL	SLLPAIVEL
IVIEVIPFL	IVIEVIPFL
GLKDAVYFL	GLKDAVYFL
ALLSAPWYL	ALLSAPWYL
IQHDLIFSL	IQHDLIFSL
PIRLLAAAA	PIRLLAAAA
ALINNIVEI	ALINNIVEI
ALLPLLERV	ALLPLLERV
FLLEPGNLEV	FLLEPNLEV
LLPDQPPYHL	LLPDQPYHL
ILIKGLAKL	ILIKGLAKL
TVLPFVSTV	TVLPFVSTV
ALQELISEL	ALQELISEL
FLYDDNQRV	FLYDDNQRV
LLQLDVPLL	LLQLDVPLL
VLSEKVSQL	VLSEKVSQL
VLIANLEKL	VLIANLEKL
KLIQNVFEI	KLIQNVFEI
YVLEGLKSV	YVLEGLKSV
VLREWLVAV	VLREWLVAV
IRQQELENL	IRQQELENL
RLLDLENIQI	RLLDLNIQI
SLLTVIEKL	SLLTVIEKL
IIQEFLSKV	IIQEFLSKV
VVNDVLFAV	VVNDVLFAV
VLNEYFHNV	VLNEYFHNV
TLHGLQQYYV	TLHGLQYYV
GLYGLIVAL	GLYGLIVAL
SLITRLLEV	SLITRLLEV
TVLGKIWKL	TVLGKIWKL
FLLPTGLSSL	FLLPTLSSL
TLSEVTNQL	TLSEVTNQL
SLAADIPRL	SLAADIPRL
SLLSSVFKL	SLLSSVFKL
TLWYRAPEV	TLWYRAPEV
SLLTLLTQL	SLLTLLTQL
ALTGIPLPLI	ALTGILPLI
SLLDIIEKV	SLLDIIEKV
VLAHTILGV	VLAHTILGV
VLLGKVYVV	VLLGKVYVV
NQNPEVFFL	NQNPEVFFL
KLNPQQFEV	KLNPQQFEV
ALVDLIYNM	ALVDLIYNM
AIQEQITRV	AIQEQITRV
YLLNDASLISV	LLNDALISV
IAQEILKVV	IAQEILKVV
YLQILIEQL	YLQILIEQL
HLLDLLARL	HLLDLLARL
SISPIVLYL	SISPIVLYL
AVQDFLHEI	AVQDFLHEI
LLSQSVHYL	LLSQSVHYL
ILQDRLNQV	ILQDRLNQV
TLLGHLDYI	TLLGHLDYI
FLLPILSQI	FLLPILSQI
YLDEYIARM	YLDEYIARM
VVLNATWLV	VVLNATWLV
FLLDSSLRKL	FLLDSLRKL
ILGSVTFL	ILGS-VTFL
SLLHTLEEL	SLLHTLEEL
FLQEGDLISA	FLQEGLISA
FLNKEILEL	FLNKEILEL
IILGKIWDL	IILGKIWDL
KILDIGLAYI	KILDILAYI
ILYDIPDIRL	ILYDIDIRL
TILNLLPRL	TILNLLPRL
SLRQLLHQL	SLRQLLHQL
QLLTAIVKL	QLLTAIVKL
LGDLKLPEI	LGDLKLPEI
LLSDYGYHL	LLSDYGYHL
VLASPWLIL	VLASPWLIL
SLQEEIAFL	SLQEEIAFL
TLQEVHFLL	TLQEVHFLL
FLDPNARPLV	FLDPNRPLV
SLLNPPETLNL	SLLNPPETL
FTNHFIPTL	FTNHFIPTL
VLRDNIQGI	VLRDNIQGI
FLAQRAVEL	FLAQRAVEL
FINGDISSL	FINGDISSL
FLLHIQQQV	FLLHIQQQV
LVLVPAQKL	LVLVPAQKL
TLNDIMTRV	TLNDIMTRV
SLLNEIAFL	SLLNEIAFL
KLFEPYVVHV	KLFEPVVHV
SLLDEFYKL	SLLDEFYKL
LLMPSPSHL	LLMPSPSHL
ILAQLLPLL	ILAQLLPLL
FLLPKVQSIQL	FLLPKVQSI
FLLGGIGEL	FLLGGIGEL
KASPLTFTV	KASPLTFTV
TLLHFLVEI	TLLHFLVEI
GLATDVQTV	GLATDVQTV
RLLPPGAVVAV	RLLPPGAVV
LGPLLAGLIS	LLAG----L
TVLDAIYEV	TVLDAIYEV
KLQEVLDYL	KLQEVLDYL
KILGNLQQL	KILGNLQQL
LTAEEIFSL	LTAEEIFSL
SLNKWIFTV	SLNKWIFTV
GLAVILPPL	GLAVILPPL
YLSGIIVTL	YLSGIIVTL
KILPTLEAV	KILPTLEAV
VLFTGVKEV	VLFTGVKEV
ALLNTINYL	ALLNTINYL
FLSELTQQL	FLSELTQQL
GILSFLPVL	GILSFLPVL
SLWKEVSEL	SLWKEVSEL
RVLPPSALQSV	VLPPSLQSV
TLLIQVPRI	TLLIQVPRI
ILGKIWDL	ILGK-IWDL
ALGFVYKL	ALGF-VYKL
RLLVKLQEL	RLLVKLQEL
FLSEVFHQA	FLSEVFHQA
TLVEAIKQV	TLVEAIKQV
GLQVKIQRL	GLQVKIQRL
SLQDLIEKV	SLQDLIEKV
ALATKLLSL	ALATKLLSL
FLKDLVASV	FLKDLVASV
ILLEKILSL	ILLEKILSL
SIQLHGAKLL	SIQLHGAKL
TLNEKLTAL	TLNEKLTAL
QILFWIQEI	QILFWIQEI
MLSPFISSV	MLSPFISSV
KLILLITQV	KLILLITQV
ALGQILPQL	ALGQILPQL
SLVDTVYAL	SLVDTVYAL
EKSPLQTI	EKSP-LQTI
VLLDAPIQL	VLLDAPIQL
VLWFKPVEL	VLWFKPVEL
ALINVLNAL	ALINVLNAL
VLIDVGTGYYV	VLIDVGYYV
ILISTLPSV	ILISTLPSV
FIINGIEKV	FIINGIEKV
TLWPEVQKL	TLWPEVQKL
LLLSLLPAL	LLLSLLPAL
KLIPQLPTL	KLIPQLPTL
YLLPLLQRL	YLLPLLQRL
AVSNHVFQL	AVSNHVFQL
RQADKVWRL	RQADKVWRL
RLELELLRQ	RLELELLRQ
ALLNILSEV	ALLNILSEV
RLTPKLMEV	RLTPKLMEV
ATYVFLHTV	ATYVFLHTV
ILMEHIHKL	ILMEHIHKL
FLLDKPQDLSI	FLLDKPQDL
ALLEQVNAL	ALLEQVNAL
YLRTLINEL	YLRTLINEL
AVTGILVQL	AVTGILVQL
VLFEHAVGYAL	VLFEHGYAL
ALTGYLHTI	ALTGYLHTI
LLIERILLL	LLIERILLL
SLVENIERLKV	SLVENIERL
NLLPKLHIV	NLLPKLHIV
RLLPPELLRQL	LLPPELRQL
ALALWKELL	ALALWKELL
SLYDYNPNL	SLYDYNPNL
ALSDILINF	ALSDILINF
ILFGHENRV	ILFGHENRV
TVTTVILEV	TVTTVILEV
YLFERIKEL	YLFERIKEL
ALLPSSPTL	ALLPSSPTL
QLLLEPPKL	QLLLEPPKL
RIASWLPSFSV	RIASWLPSF
VALDILSRI	VALDILSRI
ALLGRLAEL	ALLGRLAEL
ALTAHLYSL	ALTAHLYSL
RLLDYVATV	RLLDYVATV
ILVDWLVEV	ILVDWLVEV
GMASVISRL	GMASVISRL
GLLKTLQKL	GLLKTLQKL
TVAPFNPTV	TVAPFNPTV
ILQHAVEAL	ILQHAVEAL
ALMPQLVQL	ALMPQLVQL
LSNHAVAAL	LSNHAVAAL
AIQDKLFQV	AIQDKLFQV
YIIRIYQEL	YIIRIYQEL
RTISVILFL	RTISVILFL
SLIKWILIV	SLIKWILIV
HLFLDLPKL	HLFLDLPKL
SLLESVQKL	SLLESVQKL
FLIEYGPAQL	FLIEYPAQL
LLLDILEKL	LLLDILEKL
AIIPHVTIR	AIIPHVTIR
SLADLQNDEV	SLADLNDEV
RLVEIQYEL	RLVEIQYEL
VLFGEITRL	VLFGEITRL
FLLPLRIAL	FLLPLRIAL
SLLSGLVRL	SLLSGLVRL
SLLYHLSEL	SLLYHLSEL
YLAPHVRTL	YLAPHVRTL
YLIPLLERL	YLIPLLERL
RLSDYLFTL	RLSDYLFTL
YLAHFIEGL	YLAHFIEGL
ALFKAWAL	ALFK-AWAL
LLDVTPLSL	LLDVTPLSL
LLQAQIQRL	LLQAQIQRL
LLLEPGSLYIL	LLLEPLYIL
NLLTHVESL	NLLTHVESL
FSLENNFLL	FSLENNFLL
ALSSLLQQL	ALSSLLQQL
RILDILEYI	RILDILEYI
KLIPGLNNL	KLIPGLNNL
VLAHEIERL	VLAHEIERL
SLQTRLIFL	SLQTRLIFL
FQNPFRSEL	FQNPFRSEL
LVLDPPTDLKF	LVLDPPTDL
SLLDGVVEKL	SLLDGVEKL
ALLKVNQEL	ALLKVNQEL
SVLVSPPAV	SVLVSPPAV
ALLYGILQL	ALLYGILQL
SLFDAVSSL	SLFDAVSSL
ALLALLPEL	ALLALLPEL
SILDGLIHL	SILDGLIHL
RLQDAIAKV	RLQDAIAKV
LRINAIYEV	LRINAIYEV
FLANIGTSV	FLANIGTSV
LRLDEKELL	LRLDEKELL
WLLPYNGVTV	WLLPYGVTV
KVLGIVVGV	KVLGIVVGV
LLVEEIHRL	LLVEEIHRL
NLFKWVGTI	NLFKWVGTI
LLQDFSRNL	LLQDFSRNL
SIQQSIERL	SIQQSIERL
SLLELPHPLL	SLLELHPLL
SLQETIQSL	SLQETIQSL
FLGKIDEL	FLGK-IDEL
ILLPYLQTL	ILLPYLQTL
QINAVSLYLL	QINAVLYLL
TLAETLVNL	TLAETLVNL
KLLEAISSL	KLLEAISSL
LLAEKIYKI	LLAEKIYKI
YLNEWLQIL	YLNEWLQIL
SLQEKLWAI	SLQEKLWAI
VLATLLNNL	VLATLLNNL
AILTTLIHL	AILTTLIHL
QLNEKVAQL	QLNEKVAQL
KIADFGWSV	KIADFGWSV
YLDEYIARMV	YLDEYIARM
ALFPRLPSI	ALFPRLPSI
YGLPVVVKL	YGLPVVVKL
ALPEIFTEL	ALPEIFTEL
KLMELLEEI	KLMELLEEI
GLLPVPVPAV	GLLPVVPAV
FTNDKIINL	FTNDKIINL
VLMDRLPSL	VLMDRLPSL
HLFSTIPEL	HLFSTIPEL
GLSSLSIHL	GLSSLSIHL
GLHGWAFTL	GLHGWAFTL
FIWENIHTL	FIWENIHTL
VLGPKIEAV	VLGPKIEAV
KLLEEIEFL	KLLEEIEFL
TLQQQIQTL	TLQQQIQTL
GLGSNIFRL	GLGSNIFRL
VPGLYTLEEL	GLYT-LEEL
AVADHLFKL	AVADHLFKL
SIAVKFLA	SIAV-KFLA
SLLYDLENL	SLLYDLENL
RQLEAIVRI	RQLEAIVRI
TLSSLVFQL	TLSSLVFQL
QLLANLARL	QLLANLARL
KVQEQIFNL	KVQEQIFNL
ILVDTVWAL	ILVDTVWAL
LLLPEYHQRV	LLLPEHQRV
SIRNFLIYV	SIRNFLIYV
AAKSWVFGV	AAKSWVFGV
QLNELQAQL	QLNELQAQL
FLGKIYQI	FLGK-IYQI
YLADIFTKL	YLADIFTKL
FLYQYSTRL	FLYQYSTRL
LQNPIIVQL	LQNPIIVQL
LLSQLIAEL	LLSQLIAEL
QLLEALVAL	QLLEALVAL
LLAEWLIQT	LLAEWLIQT
SLIDIVTEI	SLIDIVTEI
RLWEKLTLL	RLWEKLTLL
IQLTQMSLQL	QLTQMSLQL
NLLEWPFARRV	NLLEWPFAR
RLFDDVPQV	RLFDDVPQV
VNLPINGNGKQ	NLPINGNGK
IVADVQISV	IVADVQISV
QILPTLVRL	QILPTLVRL
KLQKILRQL	KLQKILRQL
SLNISLPNL	SLNISLPNL
SLLEFDRI	SLLE-FDRI
HLLDQIQTL	HLLDQIQTL
RLWGEPVNL	RLWGEPVNL
FLANVSTVL	FLANVSTVL
SISERLEMK	SISERLEMK
SLFGGSVKL	SLFGGSVKL
RLFEASDPYQV	RLFEAPYQV
GLQVYIRQL	GLQVYIRQL
SLTESIAQL	SLTESIAQL
VLLAEGRLLNL	LLAEGLLNL
GLIGVGLINV	GLIGVLINV
YLGKVLEL	YLGK-VLEL
VLLSALERL	VLLSALERL
SILTSIQSL	SILTSIQSL
RLLPALTVL	RLLPALTVL
SVNGFISTL	SVNGFISTL
TLQEITFSF	TLQEITFSF
KLNFIVTGL	KLNFIVTGL
ALLGKLDAI	ALLGKLDAI
KLGEIVTTI	KLGEIVTTI
ILGPTFTL	ILGP-TFTL
LLNEILEQV	LLNEILEQV
TLNQIDSVKV	TLNQISVKV
LLRDAIEKL	LLRDAIEKL
KLQELVRKL	KLQELVRKL
TLTKNIVEL	TLTKNIVEL
FLISRLIKL	FLISRLIKL
