Data	Data aligned
VVSETISSK	VVSETISSK
KVAIKIISK	KVAIKIISK
RLFLFQIQK	RLFLFQIQK
RLEAGLNRVK	RLEALNRVK
SLFSRLFGK	SLFSRLFGK
RQTGIVLNR	RQTGIVLNR
LIYEETRGVLK	LIYERGVLK
RTGPPMGSRF	RTGPPMGSR
RTRETSIVK	RTRETSIVK
KIADMGHLK	KIADMGHLK
RLVDLPISK	RLVDLPISK
KLFIPWTNQK	KLFIWTNQK
RTRETSIVKK	RTRESIVKK
KMLEENTNILK	MLEETNILK
AVSLQQLTY	AVSLQQLTY
QVLNADAIVVK	VLNAAIVVK
GVSAATFLK	GVSAATFLK
RTYGVSFFLVK	RTYGFFLVK
KTNLTSVTK	KTNLTSVTK
RLFGIRAK	RLF-GIRAK
VVYQYWNTK	VVYQYWNTK
KTEVHIRPK	KTEVHIRPK
ILNLKVIDK	ILNLKVIDK
ITFDVAPSRL	ITFDVAPSR
KITVPASQKL	KITVPASQK
GTILIILTGR	TILIILTGR
RQVIPIIGK	RQVIPIIGK
ALAGHQLIR	ALAGHQLIR
SLYPQFMFH	SLYPQFMFH
SLAEILLKK	SLAEILLKK
RLAEVIKNRF	RLAEVIKNR
LLYATQQGQAK	LLYAQGQAK
ITFGIREDLK	ITFGREDLK
RVPDVVLIK	RVPDVVLIK
AMYSRKAMYK	AMYSKAMYK
YVKPLSNK	YVK-PLSNK
MIASHLLAY	MIASHLLAY
KLFEKKYSVK	KLFEKYSVK
QLKAIPLGR	QLKAIPLGR
RTFTWLVGK	RTFTWLVGK
ATPLSTLSLK	ATPLTLSLK
KLNPYAKTMR	KLNPAKTMR
RLKPFYLVPK	RLKPYLVPK
KTYHALSNLPK	KTYHALSNL
FLVPWFIPK	FLVPWFIPK
ASYVSPVLK	ASYVSPVLK
AVADAVIEK	AVADAVIEK
LADLLVPTKA	LADLLVPTK
VLYNGFTGR	VLYNGFTGR
TLRKPPAVGR	TLRKPAVGR
ILAGATANK	ILAGATANK
VVLPYLVPK	VVLPYLVPK
LSYLKYRSP	LSYLKYRSP
VVYFPVRGR	VVYFPVRGR
QAADILLYK	QAADILLYK
HTLEPLIPR	HTLEPLIPR
ALYSVPRNH	ALYSVPRNH
HTRTPPIIHR	HTRTPIIHR
RLFDEGTISK	RLFDGTISK
FPSLLTNPK	FPSLLTNPK
RTAVPSFLTK	RTAVSFLTK
LLAYTLGVK	LLAYTLGVK
KLFGETTLVK	KLFGTTLVK
KAAPAPKAQK	KAAPPKAQK
GTMTGMLYK	GTMTGMLYK
LVIPFTIKK	LVIPFTIKK
ILENIQRNK	ILENIQRNK
SLLSPLLEK	SLLSPLLEK
KLQQGILVK	KLQQGILVK
RTFLSKTGR	RTFLSKTGR
VLSAQQILH	VLSAQQILH
RAYQQALSR	RAYQQALSR
KITAPLINK	KITAPLINK
RLWGDIYFNPK	RLWGYFNPK
RALDIPLVK	RALDIPLVK
YLYITKVLK	YLYITKVLK
TVAVPLVGKLG	TVAVPLVGK
KLFGFLLEY	KLFGFLLEY
KTRTGELINRL	KTRTELINR
SLFGSPVAK	SLFGSPVAK
KLYQSIIGY	KLYQSIIGY
ATKKPAPEK	ATKKPAPEK
STNSFALNK	STNSFALNK
VLYDRQGIGR	VLYDQGIGR
KMLRDTLYY	KMLRDTLYY
PLYGRGSQK	PLYGRGSQK
ALLTYMIAH	ALLTYMIAH
IIYPTAPPR	IIYPTAPPR
GTGKTLIGK	GTGKTLIGK
TVAVPLVGKL	TVAVPLVGK
KLPDLERLLSK	KLPDRLLSK
SIWSHQMYY	SIWSHQMYY
IVAGSLITK	IVAGSLITK
KLYEQLSGK	KLYEQLSGK
RLSNLALVK	RLSNLALVK
SLSGISLQK	SLSGISLQK
RTTHNIIEK	RTTHNIIEK
VVNEPRIFK	VVNEPRIFK
RIIPHLPAPK	RIIPLPAPK
SVYHISGKK	SVYHISGKK
IVDEAHRLK	IVDEAHRLK
RLYPTPRVR	RLYPTPRVR
ALHSISVAK	ALHSISVAK
TIIDTKGVTAL	IIDTGVTAL
RVIFTGGVGK	VIFTGGVGK
ATIDGSVNPK	ATIDSVNPK
RLLPGNATISK	LLPGATISK
RVYSPYNHR	RVYSPYNHR
GMFDTLVKIYK	GMFDTLVKI
SVLNFATNR	SVLNFATNR
KVRGQTPKVAK	KVR-GQTPK
KSISGTSPK	KSISGTSPK
RLFPPLRQR	RLFPPLRQR
RILLDIHIFMK	ILLDHIFMK
RVLSKAFSRL	RVLSKAFSR
RTLNPQMLQKK	RTLNQMLQK
AVNEVVAGIK	AVNEVAGIK
KTPDFILQV	KTPDFILQV
LLWDRILGY	LLWDRILGY
KQYQDSPNQKK	KQYQSPNQK
KLEDGPKFLK	KLEDPKFLK
YTRPTPVQK	YTRPTPVQK
TVMELVKIIYK	VMELKIIYK
RISDVHFSVK	RISDHFSVK
RSNFRAISK	RSNFRAISK
VTFRPLFFKL	VTFRPLFFK
LSGPRLLFK	LSGPRLLFK
KLFVGFLNR	KLFVGFLNR
AVNSIFLSH	AVNSIFLSH
RLQDQGLILYH	RLQDGLILY
AVLDQQIHLEK	VLDQIHLEK
KLKAWNDIKK	KLKANDIKK
RVSSVKLISK	RVSSKLISK
ALVSGKSTAK	ALVSKSTAK
RVRDIVPTLR	RVRDVPTLR
MAYLGTITK	MAYLGTITK
RLPPPTILK	RLPPPTILK
GTLSSWNLK	GTLSSWNLK
RIRELTAVVQK	RELTAVVQK
RLGQPLTGR	RLGQPLTGR
ALIEELLLYK	ALIELLLYK
VLPEHVSVL	VLPEHVSVL
AIALPVTMK	AIALPVTMK
KSFDTSLIRK	KSFDSLIRK
RAAPAVQTK	RAAPAVQTK
KLYAGQVGY	KLYAGQVGY
NAPLVHATL	NAPLVHATL
VVSKSGSLK	VVSKSGSLK
AILPALKQTPK	ILPAKQTPK
IITSVLRIS	IITSVLRIS
RLKLSTWKV	RLKLSTWKV
KLPHRLIEK	KLPHRLIEK
KVWSDPFGRK	KVWSPFGRK
AVALPLQTK	AVALPLQTK
KAGEVFIHK	KAGEVFIHK
AVKDPLVKK	AVKDPLVKK
AQNAKVIEK	AQNAKVIEK
IVVPKAAIVAR	VVPKAIVAR
RVGDVYIPR	RVGDVYIPR
AVLTKQLLH	AVLTKQLLH
ITYKPVKH	ITY-KPVKH
ILNNKLISK	ILNNKLISK
RLYFSQQTY	RLYFSQQTY
AVYVPFWQK	AVYVPFWQK
RLAEVIKNR	RLAEVIKNR
VTFVPGLYK	VTFVPGLYK
RLLEYTPTAR	RLLETPTAR
LVFPSEIVGK	LVFPEIVGK
KTSESPVREK	KTSEPVREK
SIFDGRVVAK	SIFDRVVAK
AVSTFAMVK	AVSTFAMVK
QLYWSHPRKF	QLYWSHPRK
SVFFPESGLAK	VFFPSGLAK
ALYKKILKY	ALYKKILKY
RIGNFIVKK	RIGNFIVKK
RLLSPPLRPRL	RLLSPLRPR
ALLGTSGLK	ALLGTSGLK
AVRKPIVLK	AVRKPIVLK
AIRTSLGPK	AIRTSLGPK
IVAKSPASAK	IVAKPASAK
LISPIILKK	LISPIILKK
KLNPQQAPLY	KLNPQAPLY
SLFPGSLKPKL	SLFPSLKPK
KLVKPTTEK	KLVKPTTEK
SVSPLEPPTK	SVSPEPPTK
ISQEPFVPK	ISQEPFVPK
RTAPLLLSY	RTAPLLLSY
VLKGVHSHK	VLKGVHSHK
RTIFPLFMK	RTIFPLFMK
KLSDILNEK	KLSDILNEK
KVLDAIIQEK	KVLDIIQEK
KQFDAVLPGY	KQFDVLPGY
AVKGIGSGK	AVKGIGSGK
RLKEAYSVK	RLKEAYSVK
TLFGKAILR	TLFGKAILR
ALPVLERLIYK	PVLERLIYK
ALRQEVDTLK	ALRQVDTLK
RQNQRALNR	RQNQRALNR
KSTRLTMTR	KSTRLTMTR
TIKEGSQLK	TIKEGSQLK
KLYDIDVAK	KLYDIDVAK
RTAVYSLHK	RTAVYSLHK
ALYPHFPAH	ALYPHFPAH
RTDKYKRLK	RTDKYKRLK
RQIPYTMMK	RQIPYTMMK
STLLNPIPK	STLLNPIPK
TLAAWLINK	TLAAWLINK
YAPGARLAL	YAPGARLAL
ATLSICSPK	ATLSICSPK
VVWPQPATTK	VVWPPATTK
RLSQLKQLLK	RLSQKQLLK
GSYDPQQIFK	GSYDQQIFK
KTKDPTAALR	KTKDTAALR
TLLDYTYTSK	TLLDTYTSK
AVIENPEMLK	AVIEPEMLK
RLSSPISKR	RLSSPISKR
SVQNRQNFVVK	VQNRNFVVK
KLLPNGFTK	KLLPNGFTK
ALSTPVVEK	ALSTPVVEK
STAQRVTYK	STAQRVTYK
RIKEIFCPK	RIKEIFCPK
AVPTNIIAAK	AVPTIIAAK
TVATFILQK	TVATFILQK
IQAEPPTNK	IQAEPPTNK
GLTVPTSPK	GLTVPTSPK
SVSLPVRKK	SVSLPVRKK
AISSSAISK	AISSSAISK
GTDSHLVVKK	GTDSHLVVK
RLIDQKWQRK	RLIDKWQRK
LLNPFQPSPK	LLNPQPSPK
AVNPYFDIPK	AVNPFDIPK
AVQEFGLARFK	AVQEFGLAR
IIFVGTPVQK	IIFVTPVQK
AIYLVTSLASK	YLVTSLASK
RMHTGEKPYK	RMHTEKPYK
RLYQVEYAFK	RLYQEYAFK
IVYAVDFNHK	IVYADFNHK
KLIAWERTK	KLIAWERTK
SIPGGYNAL	SIPGGYNAL
SLFNHIYFK	SLFNHIYFK
KLNIPAILR	KLNIPAILR
SVHWFPVQK	SVHWFPVQK
ALNVPLHNR	ALNVPLHNR
RIGQVGKFK	RIGQVGKFK
GLSIPHSTK	GLSIPHSTK
SVSSPVKSK	SVSSPVKSK
STYYGSFVTR	STYYSFVTR
KVKAPPSVPR	KVKAPSVPR
RVNKVIIGTK	RVNKIIGTK
FPGTPLKK	FPG-TPLKK
RLLLPGELAK	RLLLGELAK
ISGSVTSAK	ISGSVTSAK
KLLAEVTLK	KLLAEVTLK
TTVPHVFSK	TTVPHVFSK
RLNHYVLYK	RLNHYVLYK
AVLRNQIHVK	VLRNQIHVK
RVINEEYKIWK	VINEYKIWK
RLFNAIIHR	RLFNAIIHR
TLWDRIGGSFK	RIG--GSFK
RTVLKNLSLLK	VLKNLSLLK
QLFEVKVFK	QLFEVKVFK
KLTDQTLIY	KLTDQTLIY
KQRDSEIMQQK	RDSEIMQQK
QVNGGTVAEK	QVNGTVAEK
IVGTVLIIK	IVGTVLIIK
VLFSATLPK	VLFSATLPK
HLYGSLLYY	HLYGSLLYY
ATFFGEVVK	ATFFGEVVK
RTIAPIIGR	RTIAPIIGR
GLSPATPLK	GLSPATPLK
SSAPPLTGK	SSAPPLTGK
RILGPGLNK	RILGPGLNK
RLASLGLKFNK	RLASLGLKF
RSDTPLIYK	RSDTPLIYK
KAFNQGKIFK	KAFNGKIFK
RASHPIVQK	RASHPIVQK
RLSYNTASNK	RLSYTASNK
KVYTKSSHLK	KVYTSSHLK
ALIGFPSVGK	ALIGPSVGK
KSLGHGLINK	KSLGGLINK
AMMAIAIMK	AMMAIAIMK
GIWPEKSFCL	GIWPKSFCL
KIYNANYLK	KIYNANYLK
RLYVPLYSSK	RLYVLYSSK
AVNAHSNILK	AVNASNILK
RVQPGLLQWVK	RVQPGLLQW
AVASEDSVLLY	ASEDSVLLY
RIREPALLSK	RIREALLSK
GLTDVILYH	GLTDVILYH
VLAPEGSVANK	LAPESVANK
RTGPPMGSR	RTGPPMGSR
RTFQEVLAY	RTFQEVLAY
ALYSVYRQK	ALYSVYRQK
AIRENPVYEK	AIREPVYEK
ALARQLLLY	ALARQLLLY
SLAPVNIFK	SLAPVNIFK
RVFTTVGSAEK	RVFTGSAEK
AVAAFVLYK	AVAAFVLYK
GVIGQDGLLFK	VIGQGLLFK
RTRDYASLPPK	RDYASLPPK
KVADHSGQVK	KVADSGQVK
VIWKYPTMAK	VIWKPTMAK
SLFTASDYK	SLFTASDYK
ATSVITIVK	ATSVITIVK
RLYSVSYLLK	RLYSSYLLK
ALAGTFHYY	ALAGTFHYY
TLWVIDQGLKK	WVIDQGLKK
RTLRGHLAK	RTLRGHLAK
RLSSLRASTSK	SSLRASTSK
IIYFARKANMK	IIY--FARK
SLMPWFHGK	SLMPWFHGK
TVSRFFLYR	TVSRFFLYR
ALFKDSEILRK	ALFKSEILR
GGLPERSVSL	GLPERSVSL
KLFSELPLAKK	KLFSLPLAK
ATNLVQLYH	ATNLVQLYH
TTQDPLSNK	TTQDPLSNK
RIYLDMLNVYK	RIYLMLNVY
AVFVTSEASLK	FVTSEASLK
ATTTTVTTK	ATTTTVTTK
RILLPIVQK	RILLPIVQK
KVMAGSLLLDK	KVMAGSLLL
RLFEGNALLR	RLFENALLR
TSALPIIQK	TSALPIIQK
GSSLPTSSK	GSSLPTSSK
STSEPLSSK	STSEPLSSK
ALLVPSLPR	ALLVPSLPR
KVGENVLPPK	KVGEVLPPK
TIAPALVSK	TIAPALVSK
GILPPLMQK	GILPPLMQK
SIFPYVTTK	SIFPYVTTK
GLGCVLIRK	GLGCVLIRK
LLYSNPTVK	LLYSNPTVK
ALLSPGSPK	ALLSPGSPK
KLWDEVLSHL	KLWDEVLSH
IQNVPLSEKI	IQNVPLSEK
GLAGLPGSPK	GLAGPGSPK
RLAEWKATKL	RLAEWKATK
ALRAGQIIRK	ALRAQIIRK
SLLPLQPTK	SLLPLQPTK
KSNKYLTVNK	KSNKLTVNK
SASNRIIGAK	ASNRIIGAK
RIYGESADAVK	RIYGADAVK
RIFANTESYLK	RIFANTESY
RLSNPSLVKK	RLSNPSLVK
KLLESIFHR	KLLESIFHR
ILSNDNQTATC	ILSNNQTAT
RLIAQRYLLQY	LIAQYLLQY
QISAPQSNK	QISAPQSNK
AVLDLSWNK	AVLDLSWNK
ATFMEVLTK	ATFMEVLTK
KTFTWPSILSK	FTWPSILSK
IIFSPVAPK	IIFSPVAPK
GLAAFLLQH	GLAAFLLQH
HLLITNSIK	HLLITNSIK
GLSDIILGK	GLSDIILGK
TLFQLKFTAK	TLFQKFTAK
KLLEVWFSR	KLLEVWFSR
KLPVKIVQK	KLPVKIVQK
KLQDFKSFLLK	KLQDSFLLK
ILSGGVFNK	ILSGGVFNK
KLPNTVLGK	KLPNTVLGK
KTGEVLDTK	KTGEVLDTK
TVIRDVEQQFK	VIRDEQQFK
YTFDWTMLK	YTFDWTMLK
RLMEIYQEK	RLMEIYQEK
ALYMASQPKNK	ALYMASQPK
KVKYLPQQQK	KVKYPQQQK
RQPEFFFYY	RQPEFFFYY
KSPSEPLIPK	KSPSPLIPK
AQKFPFNTPK	AQKFFNTPK
GLLEKIATPK	GLLEIATPK
GLVDVILYH	GLVDVILYH
GLYEFFRAK	GLYEFFRAK
HLINAFHTPK	LINAFHTPK
KVYTPVASR	KVYTPVASR
AVFPFKPPQRI	AVFPKPPQR
KVIHPYSRK	KVIHPYSRK
RMLEKLGVPK	RMLELGVPK
KVQTAVTMK	KVQTAVTMK
RLMHIQPPK	RLMHIQPPK
KLKEGGLIDK	KLKEGLIDK
HVYVGNISK	HVYVGNISK
KLLEPVLLLGK	KLLEPVLLL
IIWLPTGAGK	IIWLTGAGK
RVWDVRPFAPK	RVWDPFAPK
SVYVYKVLK	SVYVYKVLK
TLFNLGLTK	TLFNLGLTK
RLDSRLWPK	RLDSRLWPK
RIFEPPPPK	RIFEPPPPK
VIYVPLTDK	VIYVPLTDK
ATYYGAFIKK	ATYYAFIKK
TVTSYVFLK	TVTSYVFLK
KAFNQSSIFTK	AFNQSIFTK
LLFSATMPK	LLFSATMPK
RLRELVPGVPR	RLREPGVPR
IVLGLPLWWK	IVLGPLWWK
RSRLATLNEK	RSRLTLNEK
ASVPAQAPK	ASVPAQAPK
SMFPAAPAPK	SMFPAPAPK
LLLAPAVSK	LLLAPAVSK
KLREPNFTLK	KLRENFTLK
SLASQPLSR	SLASQPLSR
RTYDREGFKK	RTYDEGFKK
RLMEQQGALLK	RLMEGALLK
ATITKVLQK	ATITKVLQK
AVLSFSLYR	AVLSFSLYR
KVAPAPAVVK	KVAPPAVVK
SITSVFITK	SITSVFITK
RTKDVKEAVRK	RTKDKEAVR
ISASPLTSK	ISASPLTSK
GTYSKIMNH	GTYSKIMNH
ALFKNLLLKK	ALFKNLLLK
GTATRILQEK	GTATILQEK
ALWGRTTLK	ALWGRTTLK
VLNGNPLLH	VLNGNPLLH
KSNYQVFQK	KSNYQVFQK
RTLPVLLLY	RTLPVLLLY
SILNNPIVK	SILNNPIVK
GTFQQMWISK	GTFQMWISK
RQIDFVLSY	RQIDFVLSY
AISFVLGEK	AISFVLGEK
SLSPVILIK	SLSPVILIK
AVFPFKPPQR	AVFPKPPQR
ALPEIFTEL	ALPEIFTEL
QVFKILGAK	QVFKILGAK
ALLDGSNVVFK	LLDGNVVFK
VIIPTAPLYK	VIIPAPLYK
ALFSRIFGK	ALFSRIFGK
DRVYIHPF	DRV-YIHPF
PLYSSPIVK	PLYSSPIVK
SLMSVLIPK	SLMSVLIPK
TISAARLYY	TISAARLYY
RVASPPIKY	RVASPPIKY
AEVNADRITWL	VNADRITWL
AVLPSVLNK	AVLPSVLNK
ASLVGQTSPK	SLVGQTSPK
RLLPSLIGR	RLLPSLIGR
KTYIQLLIREK	KTYIQLLIR
ALNHKVLHY	ALNHKVLHY
KLKVVITSK	KLKVVITSK
RIAEFAFEY	RIAEFAFEY
RIVFPSRAK	RIVFPSRAK
AMHGVFLYH	AMHGVFLYH
RMFAPTKTWRR	RMFATKTWR
RLINTQAIFAK	LINTAIFAK
RLFAYPDTHRH	RLFAPDTHR
RMFHIRAVILR	HIR-AVILR
RLQEIFTEK	RLQEIFTEK
SVLEPPLFLK	SVLEPLFLK
SAFGQAFSK	SAFGQAFSK
AQYSPQQLAGK	AQYSQLAGK
SLAGGIIGVK	SLAGIIGVK
RIYAGGEHY	RIYAGGEHY
RVLYEWFLGK	VLYEWFLGK
ILFIRIMPK	ILFIRIMPK
RLYEFIVRH	RLYEFIVRH
ALLPWPFRNK	ALLPPFRNK
KLRETQGIEKL	KLREQGIEK
LVNQDILENK	LVNQILENK
HINGRVLYY	HINGRVLYY
GLLTKPIVK	GLLTKPIVK
RVLPAPMLQY	RVLPPMLQY
GLSEKIFAK	GLSEKIFAK
ALLAYTLGVK	ALLATLGVK
VLFPEGGFLRK	VLFPGGFLR
NVEIDPEIQ	NVEIDPEIQ
AVFEWHITK	AVFEWHITK
SVAKTILKR	SVAKTILKR
ALYGVVNVK	ALYGVVNVK
AVAASISSK	AVAASISSK
RTYYSPVYR	RTYYSPVYR
ALNPRTQTH	ALNPRTQTH
QTWAGSHSLK	QTWASHSLK
RLGSTVATGK	RLGSVATGK
ALAIKVLNK	ALAIKVLNK
SVIVQPFSK	SVIVQPFSK
KLATTILQH	KLATTILQH
AMFALPAEK	AMFALPAEK
GSWSQVLSQK	GSWSVLSQK
RIMDPDVITGY	IMDPVITGY
ILYENPNFTGK	ILYENFTGK
GLRDPLIFK	GLRDPLIFK
KIADFGLAR	KIADFGLAR
SLFSNVVTK	SLFSNVVTK
RIFTLKPVRK	RIFTKPVRK
AIAQPATTAK	AIAQATTAK
SIAWFTVFY	SIAWFTVFY
RVFAAESIIKR	RVFAESIIK
RLFGLTKPKEK	RLFGLTKPK
AVHNGLGEK	AVHNGLGEK
ATYPYQVVR	ATYPYQVVR
RVLRPLKTIK	RVLRLKTIK
ATQTPVSNK	ATQTPVSNK
AVYSMVEFNGK	AVYSEFNGK
ATAPAPTAHK	ATAPPTAHK
ALYPEGQAPVK	ALYPQAPVK
ATADVVILY	ATADVVILY
AVNFPFLVK	AVNFPFLVK
AVWDVGSHFK	AVWDGSHFK
SLSLPLINR	SLSLPLINR
KVAEIRKEAQK	KVAEKEAQK
FSPVGSVL	FSP-VGSVL
RSAQPLPLKI	RSAQPLPLK
VVYEKQMLY	VVYEKQMLY
QIYTYFVYK	QIYTYFVYK
FLYQQQGRLDK	FLYQQQGRL
RVYVGSIYY	RVYVGSIYY
GIADFVLKY	GIADFVLKY
SVHWFPVQKL	SVHWFPVQK
SLMNVPLFK	SLMNVPLFK
RLKDPARNAK	RLKDARNAK
KLLDIRSYLEK	KLLDIRSYL
VAIKAMAK	VAI-KAMAK
RTLPKILSH	RTLPKILSH
ALFDGVVSK	ALFDGVVSK
VLDPKSKWRSK	VLDPKSKWR
YILSPLSYK	YILSPLSYK
SVYSWDIVVQR	YSWDIVVQR
IIYPTAPPRF	IIYPTAPPR
ALAQARLLY	ALAQARLLY
MLYPAYYSYK	MLYPYYSYK
TIYVGRVK	TIY-VGRVK
SIYFPYVLK	SIYFPYVLK
LIYKLFTLK	LIYKLFTLK
RANVGKLLK	RANVGKLLK
RSLGSSPVK	RSLGSSPVK
ALYEYARRR	ALYEYARRR
VLPLFVLSK	VLPLFVLSK
KLFEEGLNIQK	KLFELNIQK
IVTSVLLLY	IVTSVLLLY
FLSAVFFAK	FLSAVFFAK
RQFWTRTKK	RQFWTRTKK
TVAVPLVGK	TVAVPLVGK
TLSGWILSK	TLSGWILSK
RVRQSPLATR	RVRQPLATR
LLFPSRPGLLK	LLFPPGLLK
LLKDQKPKK	LLKDQKPKK
QVSVRPLQH	QVSVRPLQH
VLFDTQLIIEK	VLFDLIIEK
TIARPTIGNK	TIARTIGNK
GTKLPGLLK	GTKLPGLLK
KLLDEVFFSEK	LLDEFFSEK
RVSPQPMISRL	RVSPPMISR
RVRPENTKEK	RVRPNTKEK
VSPYTEIHL	VSPYTEIHL
QLPEAPVIGK	QLPEPVIGK
TVLCQPTGGK	VLCQPTGGK
ATATLIIEH	ATATLIIEH
AVVKPGNTK	AVVKPGNTK
RTMPIYPTY	RTMPIYPTY
KIPDWFLNR	KIPDWFLNR
TLADILLYY	TLADILLYY
STIPPELVKQK	STIPPELVK
ILSGPFVQK	ILSGPFVQK
SLFEGSLSK	SLFEGSLSK
AAREQQILEK	AAREQILEK
LLIENVASL	LLIENVASL
SLLSQMLHY	SLLSQMLHY
VLYENPNLK	VLYENPNLK
KAKEPPFVRK	KAKEPFVRK
AVLDALLASK	AVLDLLASK
SLNNKILNR	SLNNKILNR
IQNDRQLQY	IQNDRQLQY
KMYEEFLSK	KMYEEFLSK
KLGGVIKEK	KLGGVIKEK
KMQYATGPLLK	MQYAGPLLK
SLDIPSQFRSK	SLDIPSQFR
KTLDQAKAVLK	TLDQKAVLK
QVYISSLALLK	YISSLALLK
SLNQAVVSK	SLNQAVVSK
RLFVGSIPK	RLFVGSIPK
IVSSLRLAY	IVSSLRLAY
SIFRTPISK	SIFRTPISK
TVALLPNGK	TVALLPNGK
RIMKKTSLY	RIMKKTSLY
RVWDVESGSLK	RVWDSGSLK
RIRVSQPLTR	RIRVQPLTR
VDKAIYLSGY	AIY--LSGY
KQYGNEVFLAK	KQYGVFLAK
VTAPIALLK	VTAPIALLK
RVITEEEKNFK	VITEEKNFK
QIFKPIISK	QIFKPIISK
GTYQPLSTR	GTYQPLSTR
GVIPESVILLK	VIPEVILLK
IVSGQPGTQK	IVSGPGTQK
SINKPTSER	SINKPTSER
SVYVLVRQK	SVYVLVRQK
RAKSPISLK	RAKSPISLK
SIRQAGGIGK	SIRQGGIGK
RIIDLVLQK	RIIDLVLQK
GLFQGKTPLRK	GLFQKTPLR
YTAPPLQSK	YTAPPLQSK
AVKVPSVFK	AVKVPSVFK
GVYETVNQNTK	GVYENQNTK
KLREIPSVVY	KLREPSVVY
TVYRNPESFK	TVYRPESFK
NINNPFVFK	NINNPFVFK
AVTKYTSAK	AVTKYTSAK
KLYGKPIRV	KLYGKPIRV
QITLPTVQK	QITLPTVQK
SVFGTMPLK	SVFGTMPLK
VLFFHTMRY	VLFFHTMRY
GLSEVQLNH	GLSEVQLNH
QIFVKTLTGK	QIFVTLTGK
VTGSLSSAK	VTGSLSSAK
IGYYSATSK	IGYYSATSK
SLWQFYLSK	SLWQFYLSK
RSYSDPPLKF	RSYSDPPLK
LLYEKNLVK	LLYEKNLVK
ATSKVALVY	ATSKVALVY
STNAKELSSK	STNAELSSK
AMLDTVVFK	AMLDTVVFK
ATVAVPLVGK	TVAVPLVGK
ATIYPVLPK	ATIYPVLPK
KVNIVPVIAK	KVNIPVIAK
RLFIGGIPKM	RLFIGGIPK
IINSSITTK	IINSSITTK
SVLDMEAITFK	VLDMAITFK
ILYIRNLPY	ILYIRNLPY
YLGEFSITYK	YLGESITYK
KVCNPIITKL	KVCNPIITK
AVYDRPGASPK	AVYDGASPK
RIKEVNETNK	RIKENETNK
GIKDWVTPYK	GIKDVTPYK
RVAPSLKSQR	RVAPLKSQR
SLYQYFLSY	SLYQYFLSY
KVSDYILQH	KVSDYILQH
GSYGAWYPLLK	GSYGYPLLK
ATNYITRNK	ATNYITRNK
KTATAVAHCKR	KTATVAHCK
RIRDLNDEINK	RDLNDEINK
ILGPMFSGK	ILGPMFSGK
QLYAAQSTK	QLYAAQSTK
RLRGSLTAIK	RLRGLTAIK
KVANIILSY	KVANIILSY
RVFTQLGSVLK	RVFTLGSVL
EIYDPRNPVNK	EIYDNPVNK
RLDAVRHAR	RLDAVRHAR
KLRGIVSEK	KLRGIVSEK
HLEDIVRQK	HLEDIVRQK
SLGQVVITK	SLGQVVITK
LVGPVGSGK	LVGPVGSGK
HLFDHVVNR	HLFDHVVNR
SIAAAVAPK	SIAAAVAPK
LAYRGFIFK	LAYRGFIFK
LIGVAGYYLK	LIGVGYYLK
SLRQGGTLTGK	RQGGTLTGK
RSFPWQSLEAK	RSFPSLEAK
SQYPNQPTRF	SQYPNQPTR
ALKTGIVAK	ALKTGIVAK
RIHPVSTMVK	RIHPSTMVK
RTTQILLEY	RTTQILLEY
KTAEDAKDFFK	KTAEDAKDF
QISEVVVVK	QISEVVVVK
LLYGGLLVK	LLYGGLLVK
ATFIKAMFK	ATFIKAMFK
VVFEKAIQRT	VVFEKAIQR
HSATTIGNK	HSATTIGNK
KMALPMPTKR	KMALPMPTK
SIFKQPVTK	SIFKQPVTK
IIDEQPLIFK	IIDEPLIFK
GTNTTGISEK	GTNTGISEK
RMFLSFPTTK	RMFLFPTTK
SVFAGVVGVK	SVFAVVGVK
KVADMALHY	KVADMALHY
KSKEYFSKQK	KSKEFSKQK
RIRTGSALVQR	RTGSALVQR
QIFNGTFVK	QIFNGTFVK
ELYVILNQK	ELYVILNQK
KIMKDILEKK	KIMKDILEK
LSYDQPRKK	LSYDQPRKK
KLEEVERKK	KLEEVERKK
KLQANGPVAK	KLQAGPVAK
AVANIVNSVK	AVANVNSVK
KMKEALLSIGK	KEALLSIGK
RMKDPTFLGK	RMKDTFLGK
KVSDWQVLY	KVSDWQVLY
MLLAHVDLIEK	LLAHDLIEK
VTKYTSAK	VTK-YTSAK
AVMGAYVLLK	AVMGYVLLK
VVDPVVREK	VVDPVVREK
QLYSTILSH	QLYSTILSH
AVFPKPFVEK	AVFPPFVEK
KLLAIPVEK	KLLAIPVEK
RLTTPVFGK	RLTTPVFGK
VVQDGITLITK	VQDGTLITK
RVKEIVINK	RVKEIVINK
LLFQPLDLLK	LLFQLDLLK
ATFTVMGLK	ATFTVMGLK
AILEYILHQK	AILEILHQK
AIYKQVLR	AIY-KQVLR
SLLSVLIPK	SLLSVLIPK
MLYGYQVGLFK	YGYQVGLFK
MILPLPLRK	MILPLPLRK
IVISSAELLQK	VISSELLQK
GIFPGTPLKK	GIFPTPLKK
QLYSKAIQR	QLYSKAIQR
KLPSSVGQK	KLPSSVGQK
RVLDALVAREK	RVLDALVAR
ALFKAWALFK	ALFKWALFK
AVRDGLRAVK	AVRDLRAVK
KVVNPLFEK	KVVNPLFEK
KLAPAMKTQKL	KLAPMKTQK
RLYHELVGLAK	RLYHELVGL
SVSPFLLGR	SVSPFLLGR
VLGTVVHGK	VLGTVVHGK
KVVNGCRLGK	VVNGCRLGK
MVYVGIPK	MVY-VGIPK
SSNSYAIKK	SSNSYAIKK
HTFGGPLLK	HTFGGPLLK
TTVPRRLGPK	TVPRRLGPK
KLYAWELAFK	KLYAELAFK
SLFNTGFLK	SLFNTGFLK
VINSIPLAK	VINSIPLAK
VVPPFLQPE	VVPPFLQPE
KVPDQKGTPK	KVPDKGTPK
KIIAFVLEGK	KIIAVLEGK
LLGPVLVK	LLG-PVLVK
RTEYNLRLK	RTEYNLRLK
RVIPRITIEMK	RVIPITIEM
RSYPVTEQRVK	RSYPVTEQR
KIYNGLFAISK	KIYNFAISK
VTFEKIFSQK	VTFEIFSQK
ISSIPINLR	ISSIPINLR
SLVSPLSPR	SLVSPLSPR
RIHFPLATY	RIHFPLATY
RSLSEDVRFYY	SLSEDVRFY
KMWGVLQKK	KMWGVLQKK
YLYYTGRIK	YLYYTGRIK
RTGKPIAVKL	RTGKPIAVK
ATLPVLYMLFK	TLPVYMLFK
SLYEMVSRVMK	SLYEMVSRV
STGMYVANTK	STGMVANTK
KLKERPSSR	KLKERPSSR
KLPEYFFENK	KLPEFFENK
RLYQHAVEY	RLYQHAVEY
SVYSPVKKK	SVYSPVKKK
TVYSVFGFSFK	SVF-GFSFK
KTNFRLLKR	KTNFRLLKR
RLFVGSIPKNK	RLFVGSIPK
GVDIRVRVK	GVDIRVRVK
RIFVYFITK	RIFVYFITK
GLFAHELFY	GLFAHELFY
KLFNGTFLK	KLFNGTFLK
FLAGVPTPK	FLAGVPTPK
ALYQPLFDK	ALYQPLFDK
GLPLSPGLPK	GLPLPGLPK
VLLGPPGAGK	VLLGPGAGK
SVSIPSITK	SVSIPSITK
IVFDPLGGK	IVFDPLGGK
SIAPPVPLK	SIAPPVPLK
KAIEKILRNK	KAIEILRNK
KTIDASVSKK	KTIDSVSKK
AQATISFPK	AQATISFPK
HIPLNLSGK	HIPLNLSGK
KASEVFLQR	KASEVFLQR
VTYNGVDNNK	VTYNVDNNK
LIKLNAVK	LIK-LNAVK
GTSHLPGLLK	GTSHPGLLK
RTSEIYVHR	RTSEIYVHR
RSTLTNYK	RST-LTNYK
AIMPYGVYK	AIMPYGVYK
RVYGGLTTK	RVYGGLTTK
RIIEKVIHR	RIIEKVIHR
GIYPPGSPGK	GIYPGSPGK
RVYIGRLSY	RVYIGRLSY
ISWEALRWKA	ISWEALRWK
ITNPKSLLY	ITNPKSLLY
SIFFESMPYK	SIFFSMPYK
IILFDRLLK	IILFDRLLK
QILTPMAQK	QILTPMAQK
GLRPGPELIQK	RPGPELIQK
AVSEHRLSNK	AVSERLSNK
ATRILFFNTPK	RILFFNTPK
TIFGKIIRK	TIFGKIIRK
KTLYLIMEY	KTLYLIMEY
RLKSIKNIQK	RLKSKNIQK
RVLDVGFVGR	RVLDGFVGR
SLPDFPAAAK	SLPDPAAAK
GLMGFIVYK	GLMGFIVYK
AIRDAKTPDK	AIRDKTPDK
VTKYTSSK	VTK-YTSSK
ALMPQETQALK	ALMPTQALK
AVYENAREK	AVYENAREK
KVSDLTIPK	KVSDLTIPK
KLPLYLRLK	KLPLYLRLK
RLYGNTPMRR	RLYGTPMRR
ALHLHPLLH	ALHLHPLLH
ILAAPGILK	ILAAPGILK
KVYDKAINR	KVYDKAINR
GVYESGPRK	GVYESGPRK
SLYKEGHSK	SLYKEGHSK
RVKTNLPIFK	RVKTLPIFK
RIKSNQISK	RIKSNQISK
AVLGETLIPHY	AVLGTLIPH
QIASFILLR	QIASFILLR
KVLDTIMATKL	KVLDIMATK
YVFPKPFNR	YVFPKPFNR
TIMPKDIQLAR	IMPKIQLAR
VVRNDNQVPK	VVRNNQVPK
QICSSIRTHK	QICSIRTHK
ATLPNQPVEK	ATLPQPVEK
RLYTKFSAR	RLYTKFSAR
SLGVAALYK	SLGVAALYK
RVAGTTAVK	RVAGTTAVK
KLFWSQRKITK	KLF-WSQRK
SLIPAEGTLSK	LIPAGTLSK
RLFGGLLRR	RLFGGLLRR
HVYTPSTTK	HVYTPSTTK
YLNENPLRAL	YLNEPLRAL
AVFPSLLTNPK	AVFPSLLTN
LIISSMITGV	IISSMITGV
RLMEFNSLINK	RLMESLINK
HLTAVTIFY	HLTAVTIFY
IQFNPPLSEK	IQFNPLSEK
IINPFPASK	IINPFPASK
KMSSSVISY	KMSSSVISY
KIWQNLRLK	KIWQNLRLK
RLKELLRAK	RLKELLRAK
RLFPNSFNDK	RLFPSFNDK
SVNLKVSPK	SVNLKVSPK
ALAGPTVPPR	ALAGTVPPR
IVALILSTK	IVALILSTK
HSIDGRVVEPK	SIDGVVEPK
SIFVPGTQK	SIFVPGTQK
RLMELFPANK	RLMEFPANK
KIYKSDGIK	KIYKSDGIK
RLFGTTVTFK	RLFGTVTFK
KQQTIPLKKK	KQQTIPLKK
VLYQPLFDK	VLYQPLFDK
KISALALLK	KISALALLK
AVIPEKQLVEK	VIPEQLVEK
SVSNVVITK	SVSNVVITK
QLSQIPLLGK	QLSQPLLGK
RVFEVMLPEKL	RVFEMLPEK
RLFEWVVNR	RLFEWVVNR
KSTAISLFY	KSTAISLFY
ALYNIGLTY	ALYNIGLTY
LTNPKTNIQK	LTNPTNIQK
AIFKVLNEK	AIFKVLNEK
AVLRIPILY	AVLRIPILY
RTNWPNTGK	RTNWPNTGK
GLLSEKAASKI	GLLSKAASK
TVTAQILLK	TVTAQILLK
ALFEVPSLK	ALFEVPSLK
RVQEAVESMVK	RVQEAVESM
AQYQFTGIK	AQYQFTGIK
AVRTLNKVAMK	RTLNKVAMK
RMKLPSSVGQK	KLPSSVGQK
KLLNYAPLEK	KLLNAPLEK
KVAPAPAVVKK	KVAPPAVVK
RLPPTPASK	RLPPTPASK
RVKLPSGSK	RVKLPSGSK
RIFQEPTEPK	RIFQPTEPK
KLVSFPIGIYK	VSFPIGIYK
SVAQLLLSK	SVAQLLLSK
KSGPVIAK	KSG-PVIAK
RLPSSTLKR	RLPSSTLKR
RLFEGTGAR	RLFEGTGAR
RLAEWKATKLK	RLAEWKATK
RVRDVVTKY	RVRDVVTKY
RTYDLYITY	RTYDLYITY
ALLDITVTK	ALLDITVTK
ALYGNLILRK	ALYGLILRK
AINSRQAQK	AINSRQAQK
HVIETLIGKK	HVIETLIGK
STYEKALGY	STYEKALGY
KSHFIVALK	KSHFIVALK
SVYSPSGPVNR	SVYSGPVNR
AVLQSPGLSGK	VLQSGLSGK
RAAQSLLNK	RAAQSLLNK
VNLPINGNGKQ	NLPINGNGK
RVFQGFFTGR	RVFQFFTGR
AMADTFLEH	AMADTFLEH
VILFWFPLK	VILFWFPLK
NLATKIISK	NLATKIISK
GIYAYGFEK	GIYAYGFEK
KLEDILDPIIK	KLEDDPIIK
KVRQPPAYKK	KVRQPPAYK
KLYAVHQEGNK	KLYAQEGNK
RSNPYYIVK	RSNPYYIVK
KVLFPLLTK	KVLFPLLTK
RLFTVPWPVK	RLFTPWPVK
NVYPNFRPTPK	NVYPRPTPK
KVSSINSRFAK	KVSSINSRF
KLNDNVSAY	KLNDNVSAY
KVYLGDIPLK	KVYLDIPLK
KVGEVIVTK	KVGEVIVTK
KTMNIYFPK	KTMNIYFPK
SLYQPLQNSSK	SLYQQNSSK
KLFSEGLFSAK	KLFSLFSAK
QTLVRILSH	QTLVRILSH
SLADFQIEK	SLADFQIEK
TVYAFSIENFK	YAFSIENFK
GTWSTGLPK	GTWSTGLPK
RLYLNGDGTGK	YLNGDGTGK
KASEVFLQRL	KASEVFLQR
RLYLNVLNR	RLYLNVLNR
AVLSWKLAK	AVLSWKLAK
SLLHLTLPK	SLLHLTLPK
KVNIIPIIAK	KVNIPIIAK
KAMRFPPK	KAM-RFPPK
RLFSVIFKY	RLFSVIFKY
SVLKPGNSK	SVLKPGNSK
VILPPLSPY	VILPPLSPY
RSFIPSLVEK	RSFISLVEK
RVYNWDVKR	RVYNWDVKR
KLFDKLLEY	KLFDKLLEY
IVYDIAQVNLK	IVYDAQVNL
SILRNPVTNK	ILRNPVTNK
TLLEKQLEY	TLLEKQLEY
RVLPEFKKK	RVLPEFKKK
RVNNSVQNR	RVNNSVQNR
KLIKDGLIIRK	LIKDLIIRK
RIIEETLALK	RIIETLALK
ITDPHSPSRFR	ITDPHSPSR
QIFIPMVNK	QIFIPMVNK
SVLNLVIVK	SVLNLVIVK
RVKGVTIVK	RVKGVTIVK
RSRSPSGSPR	RSRSSGSPR
AIVAYGLYK	AIVAYGLYK
RVLIGEGVLTK	LIGEGVLTK
ATYNKQPMYR	ATYNQPMYR
RLDQSRTWLVK	RLDQTWLVK
SLSSPLNPKL	SLSSPLNPK
ILFVPGEYSLK	FVPGEYSLK
RLQGKPPTK	RLQGKPPTK
KVTSMSTQTK	KVTSSTQTK
ALANVSIEK	ALANVSIEK
TVAKIILIH	TVAKIILIH
ITSPVVTQK	ITSPVVTQK
ALRADDPLLK	ALRADPLLK
ATGDMSGLLK	ATGDSGLLK
HVIETLIGK	HVIETLIGK
VVLYPLVAK	VVLYPLVAK
ALVNQDILENK	LVNQILENK
RQYMHVLQH	RQYMHVLQH
RTSPALKTTRL	RTSPLKTTR
VLADVILLK	VLADVILLK
GLYGGLPPTH	GLYGLPPTH
LLYKHIVGK	LLYKHIVGK
TIGHVAHGK	TIGHVAHGK
TIYSISSLK	TIYSISSLK
HLISPLIQK	HLISPLIQK
RTKAATIIQK	RTKATIIQK
ATWATKELRK	ATWAKELRK
GIISSPLTGK	IISSPLTGK
RVYGTTGTK	RVYGTTGTK
SVPLPISHK	SVPLPISHK
AQYGNILKH	AQYGNILKH
AIYKTPPGIQK	AIYKPGIQK
VIYPLAVPK	VIYPLAVPK
QLGALFILK	QLGALFILK
IIYDPKLQTPK	IIYDLQTPK
RLRDGQLVSQR	RLRDQLVSQ
TLLPMPLSGR	TLLPPLSGR
RVADRLYGVYK	RVADLYGVY
RVTPFILKK	RVTPFILKK
KTFLFSATMTK	FLFSATMTK
GVLGTVVHGK	GVLGVVHGK
ASSKDAIKK	ASSKDAIKK
VVNSPHRQYK	VVNSPHRQY
RLFPGLAIK	RLFPGLAIK
RMLAQQAVK	RMLAQQAVK
ILYAPYNPVTK	ILYANPVTK
RLSKSIIKH	RLSKSIIKH
TLFASPLAK	TLFASPLAK
GVMDYYLKY	GVMDYYLKY
AMSERALAQK	AMSEALAQK
RIYDYDPLYK	RIYDDPLYK
KLDSLADELK	KLDSADELK
KILNLRFLGK	KILNRFLGK
RIYPYAAISY	RIYPAAISY
VISSNTSLK	VISSNTSLK
NAHSNILK	NAH-SNILK
KQYALGRKK	KQYALGRKK
GLYGQTTGK	GLYGQTTGK
VIYYLAFSAK	VIYYAFSAK
KVIDGERVIGR	VIDGRVIGR
RLLLLLLRY	RLLLLLLRY
ALHNHYTQK	ALHNHYTQK
SVKEPSKTAK	SVKESKTAK
RVLDFDVKRK	RVLDDVKRK
RTFSGSLSH	RTFSGSLSH
SLFSPAFYTAK	SLFSFYTAK
GTVQKGMPHK	TVQKGMPHK
ATYETKESKK	ATYEKESKK
SVASAAAVLSH	ASAAAVLSH
RLGLPLRLR	RLGLPLRLR
VILEVQSNPK	VILEQSNPK
AMFSPPVNSGK	FSPPVNSGK
TTNQNVIKK	TTNQNVIKK
PPYTVVYFPVR	YTVVYFPVR
AIYATIPVYK	AIYAIPVYK
SIGSPVGTPK	SIGSVGTPK
RIIEPLTSR	RIIEPLTSR
ASNFKSPVK	ASNFKSPVK
TLALWPVSK	TLALWPVSK
KVAVVLIQK	KVAVVLIQK
VISQEPFVPK	VISQPFVPK
TLGPILKK	TLG-PILKK
VLQAADILLYK	QAADILLYK
RVWDISGLRK	RVWDSGLRK
RLQHQQLYY	RLQHQQLYY
KTLPYPLKK	KTLPYPLKK
KVYNIQIRY	KVYNIQIRY
LLKSFFTEK	LLKSFFTEK
VLCQPTGGK	VLCQPTGGK
RLPAFTLSH	RLPAFTLSH
IVLYFKLRSK	VLYFKLRSK
STMYPGLPSRL	TMYPGLPSR
KILPVGGIKEK	KILPVGGIK
RIFDLGRKK	RIFDLGRKK
RAAPFSLEY	RAAPFSLEY
RLLGNLVVK	RLLGNLVVK
AVLPAVIPK	AVLPAVIPK
RLAEPSQMLK	RLAESQMLK
KVISKDLVIER	ISKDLVIER
ITGPNMGGK	ITGPNMGGK
GVDKLTRLK	GVDKLTRLK
HSNTQTLGK	HSNTQTLGK
VQVSPLGHK	VQVSPLGHK
RVAKTNSLR	RVAKTNSLR
KLPTRPGLNK	KLPTPGLNK
KAFVGAFKK	KAFVGAFKK
KLRETQGIEK	KLREQGIEK
AVFGVIGSQK	AVFGIGSQK
QIYSTCVSK	QIYSTCVSK
KAHLGTALK	KAHLGTALK
KVSTSPLTK	KVSTSPLTK
KLNTGRTEAWK	KLNTGRTEA
MAPLKMLAL	MAPLKMLAL
RIYEQLPEVQK	RIYEPEVQK
ALLPKFLLR	ALLPKFLLR
RIYKPLRTR	RIYKPLRTR
RASPFLLQY	RASPFLLQY
SVFQQGMKNK	SVFQGMKNK
SSLSSPLNPK	SLSSPLNPK
RIYSYVVSR	RIYSYVVSR
SSFSGLLRK	SSFSGLLRK
SVAPSPAVDK	SVAPPAVDK
GVADKILKK	GVADKILKK
RLLDSEIKIMK	RLLDSEIKI
SSNKQILINK	SSNKILINK
KVLAIQARK	KVLAIQARK
RMFAPTKTWR	RMFATKTWR
VIFTGGVGK	VIFTGGVGK
KTYGEIFEK	KTYGEIFEK
AVLSSSVSSK	AVLSSVSSK
AVRQLKNNLK	AVRQKNNLK
LLTAVQLLY	LLTAVQLLY
ALAEYVIYR	ALAEYVIYR
SVYFPTLRH	SVYFPTLRH
ATLLIFANK	ATLLIFANK
SLLAKVFITK	SLLAVFITK
ATLAAVLQR	ATLAAVLQR
MLMKNTIIAAK	LMKNIIAAK
KAAGNFATK	KAAGNFATK
AQAESLRYK	AQAESLRYK
RLYQRALQKL	RLYQRALQK
AVYGMLNLTPK	AVYGNLTPK
ALIQQATTVK	ALIQATTVK
RLPKGAVLYK	RLPKAVLYK
SLYPKLFQK	SLYPKLFQK
KVFKQIFSK	KVFKQIFSK
KQSASQLQK	KQSASQLQK
KVYYPKYLSK	KVYYKYLSK
TLFASIILK	TLFASIILK
VTAVPTLLK	VTAVPTLLK
KLYEEGSNK	KLYEEGSNK
RANITLSGK	RANITLSGK
KTFDAPPALPK	KTFDPALPK
RISNREKLNLK	ISNRKLNLK
KAYPFPLSH	KAYPFPLSH
KLPLPLPPRL	KLPLPLPPR
LLHLPLSQR	LLHLPLSQR
KLRQPFFQK	KLRQPFFQK
KTLAYRGFIFK	TLAYGFIFK
IVYLGDYLTVK	YLGDYLTVK
TISPPLQPK	TISPPLQPK
KLNSALCNR	KLNSALCNR
RLFQCLLHR	RLFQCLLHR
RILKHILTQR	RILKILTQR
SIYRPSKNLDK	SIYRPSKNL
LLPSHPLEL	LLPSHPLEL
FLFELPSRLTK	FLFELPSRL
ILGPNLGDK	ILGPNLGDK
KLFDYSKPSAK	KLFDKPSAK
AIREAATSNLK	AIREATSNL
GTFNRAMLRL	GTFNRAMLR
KTYGVSFFLVK	KTYGFFLVK
ILYAQFEIRQK	ILYAQFEIR
EAGHQKVVFY	AGHQKVVFY
GSYNKVFLAK	GSYNVFLAK
KLNIRPLLRL	KLNIRPLLR
KTKQLPVLGK	KTKQPVLGK
GLARTTTGNK	GLARTTGNK
SLKSRGYVK	SLKSRGYVK
GLFGKTVPK	GLFGKTVPK
AILSKFLYY	AILSKFLYY
AIFPSPMMY	AIFPSPMMY
LLREAESLIAK	REAESLIAK
GQFSGFPFEK	GQFSFPFEK
SVIDRKDLIIK	VIDRDLIIK
AIYEPKTFK	AIYEPKTFK
QLYWSHPRK	QLYWSHPRK
SIYDSKRQSGK	SIYDRQSGK
RTSTSTLLH	RTSTSTLLH
ILFTEDPRVFK	FTEDPRVFK
MIYASSKDAIK	YASSKDAIK
KFKFPGRQK	KFKFPGRQK
ASLSRPLNY	ASLSRPLNY
AVNKQLADK	AVNKQLADK
KLLQPLVPR	KLLQPLVPR
SIFSKFTSK	SIFSKFTSK
KIIEPIQSR	KIIEPIQSR
SLWDRLIFH	SLWDRLIFH
GTFALNLLK	GTFALNLLK
HIHIPLLVK	HIHIPLLVK
RLYGNTPMR	RLYGNTPMR
VLYPHPPLAR	VLYPPPLAR
SLLYGSIPK	SLLYGSIPK
VLYDRVLKY	VLYDRVLKY
RTLSDYNIQK	RTLSYNIQK
RVADLVHILTH	RVADLVHIL
AAYNVPLPK	AAYNVPLPK
SVYDHQGIFK	SVYDQGIFK
AVAAVLLSR	AVAAVLLSR
VLPTFILER	VLPTFILER
RVSTEVTLAVK	VSTETLAVK
KIRSEFKRK	KIRSEFKRK
RLGNSLLLK	RLGNSLLLK
RLFHLHSQK	RLFHLHSQK
KSFLSQGQVLK	FLSQGQVLK
KTTDRYIQQK	KTTDYIQQK
ALSGFTIFR	ALSGFTIFR
HIRESLPALR	HIRELPALR
RANGKVITNK	RANGVITNK
RVRDVFEAK	RVRDVFEAK
LLNGKVGSFK	LLNGVGSFK
KVLKAQAQSQK	VLKAAQSQK
SVLLFVTKK	SVLLFVTKK
ATNDSVVADK	ATNDVVADK
KTHAVILSR	KTHAVILSR
SLWESSQELLK	SLWESSQEL
AQYQFTGIKK	AQYQTGIKK
ALLRVTPFILK	LLRVPFILK
RVFTGQAKVK	RVFTQAKVK
RLATSLVEKL	RLATSLVEK
RIFAPNHVVAK	RIFAHVVAK
RTMVKTLEY	RTMVKTLEY
KIGDFGLTK	KIGDFGLTK
SAPYGRITL	SAPYGRITL
LSFDRILKK	LSFDRILKK
RLSGVSSNIQK	RLSGSNIQK
GTSSLFIYK	GTSSLFIYK
VLRDNIQGITK	RDNIQGITK
RLRELTSIVNR	RELTSIVNR
AVNKQLHQK	AVNKQLHQK
RIAGQVAAANK	RIAGAAANK
ISFPATGCQK	ISFPTGCQK
KTSTVPPSLRK	STVPPSLRK
RTLGAIVRQK	RTLGIVRQK
VLAGTQLLY	VLAGTQLLY
KVYYPVRHH	KVYYPVRHH
VIAPSTKCK	VIAPSTKCK
STHGTFLNK	STHGTFLNK
KLYLPVQNK	KLYLPVQNK
RLAKPMSER	RLAKPMSER
KLFDFVNAKK	KLFDFVNAK
VLFSYSFSYK	VLFSSFSYK
SLYGPGTNR	SLYGPGTNR
RVYHYFQWR	RVYHYFQWR
VMLGTQLLY	VMLGTQLLY
ATEESFFILK	ATEEFFILK
RIYDIFRSK	RIYDIFRSK
RVVSYQIRY	RVVSYQIRY
ALFAKPLKGK	ALFAPLKGK
VVNIVPVIAK	VVNIPVIAK
RTISGNVYILK	TISGVYILK
VVNKVPLTGK	VVNKPLTGK
RVKLPSGSKK	RVKLSGSKK
VLNNSLLLH	VLNNSLLLH
SLWQVPYFSK	SLWQPYFSK
RTYQSITER	RTYQSITER
ATLKWILENK	ATLKILENK
ILNTWISLK	ILNTWISLK
ASSPPAIPK	ASSPPAIPK
AVLPTPVTK	AVLPTPVTK
AISWPLLQK	AISWPLLQK
FPEILLIVLK	ILL--IVLK
RLPLISGFYK	RLPLSGFYK
SLYFSTGQNPK	SLYFGQNPK
KIIENNTASK	KIIENTASK
RLNEKMITK	RLNEKMITK
KTLYPIIGK	KTLYPIIGK
KLYTLPASH	KLYTLPASH
SILDYISTSK	SILDISTSK
GLSNESVNLLK	LSNEVNLLK
TLYRIFNNK	TLYRIFNNK
ALWPQIIQK	ALWPQIIQK
ALFASGLIH	ALFASGLIH
ALFVAFLLRGK	ALFVAFLLR
VVLENAAKK	VVLENAAKK
RLYKPILWR	RLYKPILWR
KILDIGLAY	KILDIGLAY
RILFFNTPK	RILFFNTPK
RSRTPPVTRR	RSRTPPVTR
SLLGTWIGK	SLLGTWIGK
AQWQKVLPR	AQWQKVLPR
VMHTPPVLK	VMHTPPVLK
SLNPPIFLK	SLNPPIFLK
TLYFNTQEK	TLYFNTQEK
AVFLGLARK	AVFLGLARK
ILFPHQPLSR	ILFPQPLSR
GTIGHVAHGK	GTIGVAHGK
KLLPQFLLH	KLLPQFLLH
RIYQTTTER	RIYQTTTER
KTYYQDRPFFR	KTYYQDRPF
IVDDRGRSTGK	IVDDRSTGK
LIYVAGGLTK	LIYVGGLTK
RNLVSYLKQ	RNLVSYLKQ
ALLSMTFPLK	ALLSTFPLK
TVYHSPVSR	TVYHSPVSR
SILPAIFQK	SILPAIFQK
AIFKPVMSK	AIFKPVMSK
QTYGQQLQK	QTYGQQLQK
AIYNIFSLK	AIYNIFSLK
SLAERLLSH	SLAERLLSH
GTLGGSPTK	GTLGGSPTK
SVAEHPLSR	SVAEHPLSR
LLDIQSSGRAK	LLDIQSSGR
AILDYLITK	AILDYLITK
TVYPKPEEWPK	TVYPKPEEW
RILPKPTRK	RILPKPTRK
RLSNIFVIGK	RLSNFVIGK
ALRNINLIVQK	RNINLIVQK
GTLTKNLSEK	GTLTNLSEK
ALLPWPFKQK	ALLPPFKQK
QLYPRNFLR	QLYPRNFLR
ATLEVILRPK	ATLEILRPK
ILAGLGFTPK	ILAGGFTPK
KLIGEYGLRNK	LIGEGLRNK
RILYIRNLPYK	ILYINLPYK
ILFPRKPSAPK	ILFPPSAPK
KAFQEGIAK	KAFQEGIAK
RLYGGMNYR	RLYGGMNYR
RQKTGQVPK	RQKTGQVPK
KIKEIAVTVK	KIKEAVTVK
ATALFGQPPFK	ALFGQPPFK
KMADKILPQRI	KMADILPQR
ATDKSFVEK	ATDKSFVEK
TSLPPLPFK	TSLPPLPFK
AIFPRAFPK	AIFPRAFPK
ALYYPELYILK	ALYYLYILK
RLSLPSKNGSK	SLPSKNGSK
TVLPGSPSK	TVLPGSPSK
KVLQKFLTY	KVLQKFLTY
RIRDGDFVVLK	RDGDFVVLK
RSYSPRNSR	RSYSPRNSR
VIIAKVTAK	VIIAKVTAK
TLLDLMIAK	TLLDLMIAK
ATFRFPGALQH	ATFRFPGAL
ALLTGIISK	ALLTGIISK
ALIDYENSNK	ALIDENSNK
IIAASASVK	IIAASASVK
KTPEQIMQEK	KTPEIMQEK
VLFEHAVGY	VLFEHAVGY
IVLSAVITK	IVLSAVITK
SVIGFRILLLK	VIGFILLLK
SLNSLLLPK	SLNSLLLPK
RLGETSASK	RLGETSASK
SLFDRQGFLK	SLFDQGFLK
TVFDAKRLIGR	TVFDRLIGR
KEFLGLLKK	KEFLGLLKK
VLGAPVKGK	VLGAPVKGK
KTKELIGSMK	KTKEIGSMK
LVGPPGTGK	LVGPPGTGK
ALMTIFTIK	ALMTIFTIK
AVAIKAMAK	AVAIKAMAK
VLAPEGSVPNK	LAPESVPNK
KFRHVFGK	KFR-HVFGK
RLFIGGIPK	RLFIGGIPK
KIFNVAIPRF	KIFNVAIPR
LMAISATFK	LMAISATFK
RTLKEILRY	RTLKEILRY
KLLDIEGLYSK	KLLDIEGLY
KLYPTLVIR	KLYPTLVIR
RIYIPLPTAK	RIYILPTAK
AVISPPTVPK	AVISPTVPK
ALFKNLLLK	ALFKNLLLK
KLKQDIARQK	KLKQIARQK
GVHGGILNK	GVHGGILNK
ATAAVIFLH	ATAAVIFLH
RLLSTPSFWLY	RLLSPSFWL
VVLTRVKEK	VVLTRVKEK
SLAERSSLLQK	SLAESLLQK
RIKPLPTKK	RIKPLPTKK
RIYPSKTNR	RIYPSKTNR
SLLKQRLR	SLL-KQRLR
KTYQVTPMTPR	KTYQPMTPR
RVYGEPHRR	RVYGEPHRR
YVLGYKQTLK	VLGYKQTLK
KILGPQGNTIK	ILGPGNTIK
KLPVVGIGK	KLPVVGIGK
KLSPSPSSR	KLSPSPSSR
ATALPTGTSK	ATALTGTSK
VSFPIGIYK	VSFPIGIYK
AMGDVVIFK	AMGDVVIFK
ATGSWDSFLK	ATGSDSFLK
RLDQPFIPR	RLDQPFIPR
SIWDYFIAK	SIWDYFIAK
AVYLRALVR	AVYLRALVR
KLIENPLLRY	KLIENPLLR
LVGKPGSSK	LVGKPGSSK
RTVVRPTYK	RTVVRPTYK
SVFNHAIRH	SVFNHAIRH
ATFPLSVQK	ATFPLSVQK
SVAVRVLSY	SVAVRVLSY
IIYVSTKK	IIY-VSTKK
ALNALILAY	ALNALILAY
AIYPFLDSPNK	AIYPDSPNK
VLNLVIVKK	VLNLVIVKK
AVRHSQDLSSK	RHSQDLSSK
HLPETKFSEL	HLPEKFSEL
GVLAWVKEK	GVLAWVKEK
LIYKHTKLLK	LIYKTKLLK
RLVQGSILK	RLVQGSILK
KTLSILSVK	KTLSILSVK
AVMAESAFSFK	VMAEAFSFK
SVLSALTNK	SVLSALTNK
MLYQTINSLK	MLYQINSLK
RTAGHPLTR	RTAGHPLTR
SVLNIPMAK	SVLNIPMAK
RVLNKLGGVK	RVLNLGGVK
KIFSQANTPLK	KIFSANTPL
GLRGFPNVLK	GLRGPNVLK
QIASFLLSK	QIASFLLSK
ILFGGYVAK	ILFGGYVAK
VVYVIDSCK	VVYVIDSCK
ALFHAQLAY	ALFHAQLAY
GVKRPSSVK	GVKRPSSVK
KTTAQVLIRF	KTTAQVLIR
AVAVDVAVPK	AVAVVAVPK
KLWDNELQY	KLWDNELQY
ALSNPILNK	ALSNPILNK
ALWSPGLAK	ALWSPGLAK
KVHGSLAR	KVH-GSLAR
RVMKALVNR	RVMKALVNR
AVLPYELRFK	AVLPELRFK
GTLNQPLTK	GTLNQPLTK
RVYSPPEWIRY	RVYSPEWIR
QICRQAGLVK	QICRAGLVK
SLSSPLNPK	SLSSPLNPK
KSAPSTGGVK	KSAPTGGVK
ASYGVSKGK	ASYGVSKGK
STLPKPVQK	STLPKPVQK
LIYVSVPGSKK	LIYVVPGSK
MQYATGPLLK	MQYAGPLLK
RVAEKEPINK	RVAEEPINK
ALFGQPPFK	ALFGQPPFK
RIAYFTLPKT	RIAYFTLPK
SLVGQTSPK	SLVGQTSPK
RIFDSPEELPK	RIFDSPEEL
VMGNPGTFK	VMGNPGTFK
RVYNGRLK	RVY-NGRLK
NLPIGFLEL	NLPIGFLEL
HIAENILSY	HIAENILSY
TVTEVLLKY	TVTEVLLKY
HTNSKAFTAK	HTNSAFTAK
QVYMKPPAH	QVYMKPPAH
QLFTDGITNK	QLFTGITNK
RLYGSSLTRF	RLYGSSLTR
GTYRDANIK	GTYRDANIK
AVFGVPASK	AVFGVPASK
TTAPSLSGK	TTAPSLSGK
ALAGIVMTK	ALAGIVMTK
HLFEHILNGY	HLFEILNGY
ALSPSLKNK	ALSPSLKNK
KLGIKSLVSK	KLGISLVSK
KMKETFKEK	KMKETFKEK
RVLSERLLHK	RVLSRLLHK
TLYYQPGLLY	TLYYPGLLY
RPPGFSPFR	RPPGFSPFR
IIFQGQSLK	IIFQGQSLK
KVFERAVQY	KVFERAVQY
RLLAFERDR	RLLAFERDR
SMFTAILKK	SMFTAILKK
GTFANIKLFNK	GTFANIKLF
ASNPAMLLY	ASNPAMLLY
KTLVAELLILK	LVAELLILK
RLNVTPLAR	RLNVTPLAR
VLPTFILEK	VLPTFILEK
ALKVPTTEK	ALKVPTTEK
TLPTSTLQY	TLPTSTLQY
ILFPLRFTLK	ILFPRFTLK
IITKPPVRK	IITKPPVRK
KAYEKPPEK	KAYEKPPEK
RVYNWFANR	RVYNWFANR
KQKKPLVGK	KQKKPLVGK
FAPYNKPSL	FAPYNKPSL
RIMSETYMLIK	IMSEYMLIK
KIKGKPLCK	KIKGKPLCK
KLAEILYYK	KLAEILYYK
VVSEKQFSK	VVSEKQFSK
KTATAVAHCK	KTATVAHCK
RMVEMFLEY	RMVEMFLEY
SLLGKDVLFLK	LLGKVLFLK
MAAAAFAEK	MAAAAFAEK
RTLMPEKLSHK	TLMPKLSHK
RILPKPTR	RIL-PKPTR
VLYLKPLRI	VLYLKPLRI
QIPQLPAPPK	QIPQPAPPK
AVFGAGGVGK	AVFGGGVGK
GLLSWTLSR	GLLSWTLSR
AVIGADSVTLK	VIGASVTLK
KMHIPLEVRL	KMHIPLEVR
RVWQVTIGTR	RVWQTIGTR
ALNSGVSQK	ALNSGVSQK
RLFGNILDK	RLFGNILDK
KLYRPGSVAY	KLYRGSVAY
QLFYLPAKK	QLFYLPAKK
LNKLGGVK	LNK-LGGVK
FVYEPKEQK	FVYEPKEQK
SLSVPSVSK	SLSVPSVSK
QLFQLPAKK	QLFQLPAKK
STFSAPLNK	STFSAPLNK
RVAPRSGLAAK	RVAPGLAAK
KTYQDIQNTIK	KTYQIQNTI
TIFTARLYY	TIFTARLYY
ILFSEGLIK	ILFSEGLIK
SIAAPFTSK	SIAAPFTSK
ILLGGNALSPK	LLGGALSPK
ATASPPRQK	ATASPPRQK
KSSDFAVLK	KSSDFAVLK
RIKRALDLNLK	KRALDLNLK
KVWRGTLAR	KVWRGTLAR
STNSHPILR	STNSHPILR
RLAKADGIVSK	RLAKGIVSK
KQYHRILKR	KQYHRILKR
HLIRAPLAGK	LIRAPLAGK
RLNDRYPKKL	RLNDRYPKK
KLYSKHFTLK	KLYSHFTLK
ATSQVLLPSK	ATSQLLPSK
KIYNSRVQR	KIYNSRVQR
RIHGVGFKK	RIHGVGFKK
RTYPAVKMK	RTYPAVKMK
VISGPGTGK	VISGPGTGK
RLASSYIAH	RLASSYIAH
KSNPATPTSK	KSNPTPTSK
VSFPAGKFTIK	VSFPKFTIK
YIYDGELVSK	YIYDELVSK
LVFATMITK	LVFATMITK
VLTTPWKFK	VLTTPWKFK
VVYPKVIER	VVYPKVIER
SVVGLFLRH	SVVGLFLRH
ATFSTGERK	ATFSTGERK
LLFPYILPPK	LLFPILPPK
SVASPFTSK	SVASPFTSK
SLSFKVLKH	SLSFKVLKH
RVLPYPFTH	RVLPYPFTH
KTTGQVVAMK	KTTGVVAMK
RLVPREIIVEK	LVPRIIVEK
GLWHMKTYK	GLWHMKTYK
KTDFTRTGK	KTDFTRTGK
RVPDVVLIKK	RVPDVLIKK
RTGIPTLGK	RTGIPTLGK
GSWDGTLRL	GSWDGTLRL
RVASTSMNR	RVASTSMNR
SMLPGSGSVPK	MLPGGSVPK
LLFSATMPKKI	LLFSATMPK
SFILLEIIK	SFILLEIIK
AIYGGTYMLNK	AIYGYMLNK
RSPSGSRTPK	RSPSSRTPK
HLYSTILGH	HLYSTILGH
QIFSEFLLK	QIFSEFLLK
GLLNGKVGSFK	LLNGVGSFK
ITWERIISHF	ITWERIISH
KIGDTSVSYK	KIGDSVSYK
ATQVAVSVPK	ATQVVSVPK
RSYDEAILRL	RSYDEAILR
KVTEGSFVYK	KVTESFVYK
KSLSLSPGK	KSLSLSPGK
ATFPVAPRY	ATFPVAPRY
KLKNRKEK	KLK-NRKEK
ALASRFLKK	ALASRFLKK
SIGDIFLKY	SIGDIFLKY
AAAAALQAK	AAAAALQAK
KSTSPVKLK	KSTSPVKLK
KLLDDPSKQK	KLLDPSKQK
RLGSYVINGR	RLGSVINGR
STAHPPTGK	STAHPPTGK
ATIGFSLVAK	ATIGSLVAK
RLPAFTLSHL	RLPAFTLSH
AAFVPLLLK	AAFVPLLLK
RVAPAHGLFLK	RVAPHGLFL
AVPPPRSTK	AVPPPRSTK
KGIVPLAK	KGI-VPLAK
SLYDSKIWTTK	SLYDIWTTK
GLFNRIIRK	GLFNRIIRK
RLQETGLLSK	RLQEGLLSK
HLGPVHREK	HLGPVHREK
RVKDPNSGLPK	RVKDSGLPK
KVIQSLPK	KVI-QSLPK
KLIDVNHYAK	KLIDNHYAK
SIYIAYGPNGK	YIAYGPNGK
LILSVTGLK	LILSVTGLK
GVIGFPNVGK	GVIGPNVGK
RVSLRVLSER	RVSLVLSER
TVAGGAWTYK	TVAGAWTYK
RQYDKFLTHF	RQYDKFLTH
AVVPSYIPLVK	VVPSIPLVK
GLINFGIYK	GLINFGIYK
RALLPIKGK	RALLPIKGK
RVWDLPGVLK	RVWDPGVLK
KTSPLNFKK	KTSPLNFKK
KLPPTVSKK	KLPPTVSKK
RMAPVLPSVLK	APVLPSVLK
KIDEKTAELK	KIDETAELK
HISPNAIFK	HISPNAIFK
RIQKSISQK	RIQKSISQK
AVLGPNVSIGK	VLGPVSIGK
AVAAVAARR	AVAAVAARR
HTPQFFIYK	HTPQFFIYK
VILPPLSPYFK	VILPPLSPY
RQYDKFLTH	RQYDKFLTH
KVFVGRFK	KVF-VGRFK
IVYPPPPAK	IVYPPPPAK
RTLLGFFLAK	RTLLFFLAK
GMYLISKYIRK	YLISKYIRK
VVLGQFLVLK	VVLGFLVLK
ILYGPPGTGK	ILYGPGTGK
SIASWFGLK	SIASWFGLK
RLYQHAVEYF	RLYQHAVEY
RMAGPSTTR	RMAGPSTTR
AVAPGHPLAK	AVAPHPLAK
SVLPFQIYY	SVLPFQIYY
VVYSGLENIKK	VVYSLENIK
SVGPVIQK	SVG-PVIQK
SLLDKFLIK	SLLDKFLIK
RVLPSSLMLPK	VLPSLMLPK
TLSNQPLLK	TLSNQPLLK
LLREQVAQLK	LLREVAQLK
KVFVGRFKSR	KVFVRFKSR
RVYDPASPQRR	RVYDASPQR
RVLSGASQK	RVLSGASQK
ALNFSVFYY	ALNFSVFYY
QLFSFPIKH	QLFSFPIKH
GVFGFPLGR	GVFGFPLGR
ALLEVLSQK	ALLEVLSQK
RLLLEQILNK	RLLLQILNK
AVVNKVPLTGK	VVNKPLTGK
NLATPIAIK	NLATPIAIK
KIADMGHLKY	KIADMGHLK
SVLLPLVAK	SVLLPLVAK
KSFPGIPLHH	KSFPIPLHH
AVNGVQLHY	AVNGVQLHY
KLLPDTILEK	KLLPTILEK
NLAIPVINK	NLAIPVINK
RMFQDIGVSK	RMFQIGVSK
SLNSSPVSK	SLNSSPVSK
SVFDFQKAYK	SVFDQKAYK
GVFRGPVLPK	GVFRPVLPK
FINPKPITY	FINPKPITY
RLNPNASRK	RLNPNASRK
GTHLSLKAK	GTHLSLKAK
ALESSIEQRLK	ALESSIEQR
AIIDHIFASK	AIIDIFASK
VLAPVIDLK	VLAPVIDLK
RLKQQTIPLK	RLKQTIPLK
AVLYQPLFDK	VLYQPLFDK
FLYAFIGVK	FLYAFIGVK
VVFVIDPGFAK	FVIDPGFAK
RSMDPFPWQQK	SMDPPWQQK
KLVELPYTVK	KLVEPYTVK
KVDAGKLHY	KVDAGKLHY
ALTDAYLLY	ALTDAYLLY
VSLGTPIMK	VSLGTPIMK
KLPPLPVVEK	KLPPPVVEK
KVFDGIPPPY	KVFDIPPPY
STYEKALGYF	STYEKALGY
AAPAWAALPL	AAPAAALPL
KLYASHSQFIK	KLYASHSQF
VVFSGKAYSPK	VVFSAYSPK
RFWTSFFPK	RFWTSFFPK
IVSNIRLLH	IVSNIRLLH
QTYVGITEK	QTYVGITEK
KLDRPRFER	KLDRPRFER
IIAFVLEGK	IIAFVLEGK
YLYTLVITDK	YLYTVITDK
ALMGYATHK	ALMGYATHK
HSSPASTPK	HSSPASTPK
KVIKADKK	KVI-KADKK
RTQMPDPKTFK	QMPDPKTFK
RVQVSPLGHK	RVQVPLGHK
IVSAQNLLK	IVSAQNLLK
ILSVTGLK	ILS-VTGLK
KMMDVTVTIK	KMMDTVTIK
ILANHVAKK	ILANHVAKK
VTYRNLINKL	VTYRNLINK
RVLTFLPAK	RVLTFLPAK
KTVYPASYR	KTVYPASYR
VLNPTPIKR	VLNPTPIKR
RISEQFTAMFR	RISEQFTAM
KSFPEGKTAR	KSFPGKTAR
KLQKAALLK	KLQKAALLK
RLSPSPTSQR	RLSPPTSQR
RLRFSEIPMK	RLRFEIPMK
KLYEKKLLKL	KLYEKKLLK
VLNPNEQPTHK	VLNPEQPTH
SLAPSQLAK	SLAPSQLAK
HVYVGNISKK	HVYVNISKK
VSKPSGTTK	VSKPSGTTK
AQNSVIIVDK	AQNSIIVDK
KVFNQPKAK	KVFNQPKAK
KTIDMELVKRK	KTIDMELVK
KTFNKVLGH	KTFNKVLGH
RSYVTTSTR	RSYVTTSTR
RIYFRLRNK	RIYFRLRNK
KLIDIVSSQK	KLIDVSSQK
RTFRKFTYR	RTFRKFTYR
TLYSNNITKL	TLYSNNITK
ALRNSPVNTK	ALRNPVNTK
VISPPTVPK	VISPPTVPK
KLFGPFTRNYY	KLFGFTRNY
GTNSVICSK	GTNSVICSK
SLTASVTNK	SLTASVTNK
RTFGHLLRY	RTFGHLLRY
SVMGVYVGK	SVMGVYVGK
RILSGVVTK	RILSGVVTK
RQHKPRFTTK	RQHKRFTTK
SIAVPIVLK	SIAVPIVLK
RLYPVFFLK	RLYPVFFLK
KIACTQPRR	KIACTQPRR
KILDTERMLAK	ILDTRMLAK
RTKKVGIVGK	RTKKGIVGK
KSFDKNLYR	KSFDKNLYR
RLFPYSQYY	RLFPYSQYY
KVFGGTVHKK	KVFGGTVHK
KLWLDAYLHK	KLWLAYLHK
ASFDKAKLK	ASFDKAKLK
KVYEGERPLTK	KVYERPLTK
KLHTSIAGR	KLHTSIAGR
RVYIHPFHL	RVYIHPFHL
ILYPATTGR	ILYPATTGR
TEEMKSLIRLP	KSL---IRL
RTDNISFMLK	RTDNSFMLK
RLAKNLVEK	RLAKNLVEK
KLLAHPLQR	KLLAHPLQR
KTSSAFVGK	KTSSAFVGK
KALPAPIEK	KALPAPIEK
KIAEHIAGR	KIAEHIAGR
KLFNPPEESEK	KLFNEESEK
ILNSPTVTSIK	ILNSTVTSI
RLFKDQLVY	RLFKDQLVY
KLYPLPSAR	KLYPLPSAR
SIGQVFLLK	SIGQVFLLK
KNTRIPISK	KNTRIPISK
VVGLPNVGK	VVGLPNVGK
KLLGLPEDYLY	KLLGLPEDY
ALFGANANR	ALFGANANR
GIFPGTPLK	GIFPGTPLK
ASLLNVSTPK	SLLNVSTPK
KLGMTPIRK	KLGMTPIRK
KMAEVIGSKL	KMAEVIGSK
LVYSSNFQNVK	YSSNFQNVK
KVLENIELNK	KVLEIELNK
IQFSMKLLY	IQFSMKLLY
ALVGGGSSPK	ALVGGSSPK
KIGKSILGK	KIGKSILGK
GVNPYILKK	GVNPYILKK
RSRSPLSPR	RSRSPLSPR
ALFEIALRK	ALFEIALRK
GLYKGLEAK	GLYKGLEAK
AVAYHQPTLK	AVAYQPTLK
SLNQPLTSSK	SLNQLTSSK
RLFEGTGARL	RLFEGTGAR
IIFDRPLLY	IIFDRPLLY
RVGEVGQSK	RVGEVGQSK
GTAIIQLPSK	GTAIQLPSK
LRNLGSLLK	LRNLGSLLK
KVLSIDQRNFK	VLSIQRNFK
SILGTPLSK	SILGTPLSK
KVLSILLKH	KVLSILLKH
LLWKDKKIG	LLWKDKKIG
KVKGPALSRK	KVKGALSRK
GIKSGRMIFK	GIKSRMIFK
ALPALVMSK	ALPALVMSK
ATLTNILEH	ATLTNILEH
ATLPKNPPPK	ATLPNPPPK
AAAKVILKK	AAAKVILKK
ALHTSPVCAK	ALHTPVCAK
ISNKKVLPK	ISNKKVLPK
KTYVIKRVK	KTYVIKRVK
RLSPVPVPR	RLSPVPVPR
AVFTGALIY	AVFTGALIY
ALAQGVLEH	ALAQGVLEH
KTLDHVLTH	KTLDHVLTH
KLYQFNPAFF	KLYQFNPAF
RVYSHLKSVLK	RVYSKSVLK
GLNLHTLLY	GLNLHTLLY
KLAYTLLNKL	KLAYTLLNK
TTFSPNTGK	TTFSPNTGK
SIYVYKVLK	SIYVYKVLK
SKEIIFLPSK	KEIIFLPSK
RLFVGSIPKSK	RLFVGSIPK
KTSNLLLSH	KTSNLLLSH
IVNENLVERF	IVNENLVER
RVRGPKGPEEK	RVRGGPEEK
LLYPKSLSR	LLYPKSLSR
KTQPIPVLK	KTQPIPVLK
RTKYTITPVK	RTKYITPVK
TVWNKPTVK	TVWNKPTVK
RLFCVGFTKK	RLFCGFTKK
GLLAAQKVISK	LLAAKVISK
GTAQLTLLH	GTAQLTLLH
AVSLWAKLK	AVSLWAKLK
KLSFSQVFK	KLSFSQVFK
AMWTTALLH	AMWTTALLH
SLMHSFILK	SLMHSFILK
ALWSHLLHY	ALWSHLLHY
ILKPTDENLLK	KPTDENLLK
QSFDKEWVAK	QSFDEWVAK
RTFPFSLQY	RTFPFSLQY
MVFGAPVPK	MVFGAPVPK
SVYYNEATGGK	SVYYATGGK
ADYHRQLQAK	ADYHQLQAK
KQLNIKLTSFK	QLNILTSFK
RLARYYKTK	RLARYYKTK
QIYNPPSGK	QIYNPPSGK
RVRVPEGLLK	RVRVEGLLK
RTDKVRALR	RTDKVRALR
IVNIIVPTK	IVNIIVPTK
RVLPAPILQY	RVLPPILQY
KTVIEPLKK	KTVIEPLKK
ATTLKNRPL	ATTLKNRPL
GTYVSSVPR	GTYVSSVPR
RVYEVRETAVR	RVYERETAV
RLIESLFTIQK	RLIEFTIQK
GVFLSLIQK	GVFLSLIQK
KVLPLLKIIKK	VLPLKIIKK
RVTYPAKAK	RVTYPAKAK
KSKVFFGLLK	KSKVFGLLK
VVLSWVLCLGV	VVLSWVLCL
RLQEALNLFK	RLQELNLFK
RLQSKVTAK	RLQSKVTAK
KTFTIKRFLAK	FTIKRFLAK
ALFSSKDFAGK	ALFSDFAGK
SIFIGGSFILK	FIGGSFILK
AVYSGISLK	AVYSGISLK
QKIYIYTLK	QKIYIYTLK
RIYNMEMARK	RIYNEMARK
KVLFPLLTKL	KVLFPLLTK
RVLLGEGVLTK	VLLGGVLTK
LLAEKVLAGK	LLAEVLAGK
RLACETAGVIR	RLACETAGV
KLAEQYESFVK	KLAEQYESF
RVFPYSVFY	RVFPYSVFY
KTLDEILQEKK	KTLDILQEK
ATSQQPLRK	ATSQQPLRK
KVAENVIRQK	KVAEVIRQK
RINFYKKTYK	RINFKKTYK
RTGSPLAAR	RTGSPLAAR
SLNTPNSNR	SLNTPNSNR
ALLKAPAKKK	ALLKAPAKK
KLGGVIKEKL	KLGGVIKEK
STFNQVVLK	STFNQVVLK
RVVERTITMK	RVVETITMK
RTIQMFLVY	RTIQMFLVY
KIQEKVVKK	KIQEKVVKK
HTKDLPFRCK	HTKDPFRCK
RVYYVSEKIMK	RVY-YVSEK
RVLAAFLRR	RVLAAFLRR
SMNIPALVGK	SMNIALVGK
KMAEEKLTHK	KMAEKLTHK
SAYYPSSFPK	SAYYSSFPK
RVYGQPSTKHY	RVYGQPSTK
SLDIYSRLR	SLDIYSRLR
RTLADIIMEK	TLADIIMEK
RLLGLTGLLSK	LLGLGLLSK
IIAATFLFK	IIAATFLFK
RLLDQPKPKAK	RLLDQPKPK
RTASPPPPPK	RTASPPPPK
RISNLIVLH	RISNLIVLH
ILFDGIPLEK	ILFDIPLEK
SLPTVIMRNK	SLPTIMRNK
RTYLPSQVSR	RTYLSQVSR
KVIAAMTVGK	VIAAMTVGK
ASYGLALLH	ASYGLALLH
ATGSVFTGK	ATGSVFTGK
STFFYPKLK	STFFYPKLK
VVKPGNTKEK	VVKPNTKEK
RIFQKFLQR	RIFQKFLQR
STYPAQNGQVK	STYPNGQVK
AIIPSKKLRNK	IIPSKLRNK
RLNITYPMLFK	ITY-PMLFK
HVYDGKFLAR	HVYDKFLAR
RIRNISNTVMK	RNISNTVMK
KTKEAVLLLK	KTKEVLLLK
KSSAISLHY	KSSAISLHY
RLQGKPPTKK	RLQGPPTKK
VIPTNVPEL	VIPTNVPEL
ALYETPTGWK	ALYEPTGWK
KVAPETKVK	KVAPETKVK
RLIDLCQPTQK	LIDLQPTQK
TSILQALLK	TSILQALLK
KTLDEILQEK	KTLDILQEK
ASFDGTFLWK	ASFDTFLWK
ALDKARLK	ALD-KARLK
STYGVTKGK	STYGVTKGK
KTYTGPFVYY	KTYTPFVYY
LVSSRILSR	LVSSRILSR
VLKEAVANK	VLKEAVANK
ATATSSPPPK	ATATSPPPK
SVSTHLITK	SVSTHLITK
ILTSVLLLY	ILTSVLLLY
GLYEFPLNK	GLYEFPLNK
RIHFHTLVY	RIHFHTLVY
KSAKPSTNVK	KSAKSTNVK
RIFIGTFK	RIF-IGTFK
LLPWPFRNK	LLPWPFRNK
RLTDTFLKR	RLTDTFLKR
KTNGKFLIR	KTNGKFLIR
RVHPRPLVK	RVHPRPLVK
VVKPNTSSK	VVKPNTSSK
KIIDFIYTAK	KIIDIYTAK
ALAAKALAR	ALAAKALAR
SVFPLAPSSK	SVFPAPSSK
KSADPLKSK	KSADPLKSK
AIHSQLLEK	AIHSQLLEK
RLAQVKLLNR	RLAQKLLNR
KVYASQRMR	KVYASQRMR
LIRKVFNLY	LIRKVFNLY
LLLAEPPLK	LLLAEPPLK
SLPANTPLRK	SLPATPLRK
SILNWVKFK	SILNWVKFK
KIGVKINEK	KIGVKINEK
SIYPLGDIK	SIYPLGDIK
RIRDPNQGGK	RIRDNQGGK
RLKAYASPAKL	RLKAASPAK
NAPWAVTSL	NAPWAVTSL
RAYPHVFTK	RAYPHVFTK
KLFDHAVSKF	KLFDHAVSK
RLLSPPLRPR	RLLSPLRPR
RLKGDAWVYK	RLKGAWVYK
RLLQDVGLVSK	LLQDGLVSK
RIWEPTYTIMY	RIWEPTYTI
RLNAPLSQM	RLNAPLSQM
RLMSLPIAK	RLMSLPIAK
RIRGINGVSPK	RGINGVSPK
KLPKQPVIVK	KLPKPVIVK
RLLAHRVETKM	RLLARVETK
KLYNKITSR	KLYNKITSR
RLREGANINR	RLREANINR
RLFGLTKPK	RLFGLTKPK
TLQGPVSFK	TLQGPVSFK
SISRPYKTK	SISRPYKTK
RAYGGSMCAK	RAYGSMCAK
VVAPPGVVVSR	VAPPVVVSR
RSSSPFLSK	RSSSPFLSK
RLNIPVSQV	RLNIPVSQV
QIYAIRQSISK	AIR-QSISK
KLYQEMFAWK	KLYQMFAWK
VVYAPLSKK	VVYAPLSKK
STPSRPSSAK	STPSPSSAK
FIYLGEVFK	FIYLGEVFK
RTNHIETLGK	RTNHETLGK
TTGEPATPK	TTGEPATPK
SSYSQVRNK	SSYSQVRNK
RVSLPTSPR	RVSLPTSPR
KLMENILLY	KLMENILLY
ALNSKILSV	ALNSKILSV
RLASTATPR	RLASTATPR
KVDAETVGRVK	KVDAETVGR
ALYDLAVLK	ALYDLAVLK
AIAAVAVALK	AIAAAVALK
KLDSVRVLR	KLDSVRVLR
KQYVKSLSR	KQYVKSLSR
ATYTPQAPK	ATYTPQAPK
KTKAATILTK	KTKATILTK
SIKPGVTQK	SIKPGVTQK
AVMDNKNPTIK	VMDNNPTIK
RLLETVLGY	RLLETVLGY
IVYEKIMEH	IVYEKIMEH
STLPKSLLK	STLPKSLLK
GQYGNPLNK	GQYGNPLNK
RSRFPIGSQK	RSRFIGSQK
AVREEVEILK	AVREVEILK
RTKELGYTVK	RTKEGYTVK
GSRAGPLSGK	GSRAPLSGK
RLLPKFSLKEK	RLLPKFSLK
NAPLVNVTL	NAPLVNVTL
RTGKPIAVK	RTGKPIAVK
SGLTVPTSPK	GLTVPTSPK
TIIGELGLDPG	IIGELGLDP
KQKQPSFSAK	KQKQSFSAK
SVATKLLLY	SVATKLLLY
SVSNMVHTAK	SVSNVHTAK
KVLGQGKWNLK	VLGQKWNLK
STYSSTPGR	STYSSTPGR
NVYPSKPLTK	NVYPKPLTK
TVFQYLKMLQK	FQYLKMLQK
ALLGVPHCRK	ALLGPHCRK
GTYVKPLSNK	GTYVPLSNK
ALKNPPINTK	ALKNPINTK
VVPEPGQPL	VVPEPGQPL
IVYPPPPTK	IVYPPPPTK
RLWFKTNTK	RLWFKTNTK
ATSAFQTQK	ATSAFQTQK
IVNGHTLLV	IVNGHTLLV
RVYNTDPLKEK	RVYNTDPLK
KLLDVVHPAAK	KLLDHPAAK
KLANPSIVTK	KLANSIVTK
GLYAGDPVSK	GLYADPVSK
GLYYIHRNK	GLYYIHRNK
RIQLPVVSK	RIQLPVVSK
STYISILNQK	STYIILNQK
SVSPASAGK	SVSPASAGK
KLGGVVSIK	KLGGVVSIK
RLQDQHMFY	RLQDQHMFY
KIFSGVFVK	KIFSGVFVK
GVLYPLSSK	GVLYPLSSK
RITTPYMTK	RITTPYMTK
AVYETPTAH	AVYETPTAH
LPWPFRNK	LPW-PFRNK
RTLGSDSVILK	TLGSSVILK
GSLKQFLKK	GSLKQFLKK
RLQAYTSVAK	RLQATSVAK
LVMTHLILK	LVMTHLILK
VVFAVKQYISK	AVK-QYISK
TVLGGVYILGK	VLGGYILGK
VVNSYPLAH	VVNSYPLAH
ALFKHILLY	ALFKHILLY
ATFSSSHRYHK	ATFSSSHRY
ALIKHKPSVK	ALIKKPSVK
KTNMPIITSK	KTNMIITSK
RLLQDPLGLAY	RLLQDPLGL
RSYSGSRSR	RSYSGSRSR
VVYTSHLQLK	VVYTHLQLK
GIFPLSFVK	GIFPLSFVK
RLYFSQQTYY	RLYFQQTYY
IIHEIAVLEL	IIHEAVLEL
SSFGRGFFK	SSFGRGFFK
VIDEAHRLK	VIDEAHRLK
KLISEEDLLRK	LISEDLLRK
VLSLGVAALYK	SLGVAALYK
KTGHVIAVK	KTGHVIAVK
RVDAHRCIVR	RVDARCIVR
KIYKAVEK	KIY-KAVEK
AILLPQPPK	AILLPQPPK
KTFPNTIEH	KTFPNTIEH
RVFPVRPGSGR	RVFPPGSGR
KLKDTKSRPK	KLKDKSRPK
AVLKHVLTPR	AVLKVLTPR
HVPSPAVPK	HVPSPAVPK
ATLSQFYINKL	ATLSFYINK
SVNGKVLSK	SVNGKVLSK
QLLLNPLLH	QLLLNPLLH
STSQTFIYK	STSQTFIYK
KSYFSGLSK	KSYFSGLSK
IVYGQPRTR	IVYGQPRTR
VLKGVHSHKK	VLKGVHSHK
AMYDKGPFRSK	AMYDPFRSK
KIYPGHGRR	KIYPGHGRR
KVNEIAKHK	KVNEIAKHK
TTTGHLIYK	TTTGHLIYK
RLLLETHLPSK	LLLEHLPSK
FTFDNVLPGK	FTFDVLPGK
RVGTHIRAK	RVGTHIRAK
RILPWSTFR	RILPWSTFR
LIAPIFLHR	LIAPIFLHR
TVRAGLTPK	TVRAGLTPK
SVDGPVSQK	SVDGPVSQK
RLSFPNLFK	RLSFPNLFK
ISFGAFVAK	ISFGAFVAK
TLADIIMEK	TLADIIMEK
RLWQTTEEIPK	RLWQEEIPK
IVTSINFSK	IVTSINFSK
RTYSHGTYR	RTYSHGTYR
RLHIEALLH	RLHIEALLH
HLLELNKLIMK	LLELKLIMK
AVADKVHLMYK	AVADVHLMY
SIYDVKYLMK	SIYDKYLMK
RVSGLVPSRF	RVSGLVPSR
RIAKAVNEK	RIAKAVNEK
RIVHGDVLTFK	IVHGVLTFK
KTSDVVLKR	KTSDVVLKR
ATYKGVPFEVK	ATYKPFEVK
NVYEVVNPK	NVYEVVNPK
KLLSGVLFH	KLLSGVLFH
IQATPLELK	IQATPLELK
RIIQQPLIY	RIIQQPLIY
LTGPVMPVR	LTGPVMPVR
STMGYMMAK	STMGYMMAK
IDHIFASK	IDH-IFASK
GVMSPPLSR	GVMSPPLSR
ATWFNQPARK	ATWFQPARK
KVYHLASVRL	KVYHLASVR
KLNGQVLVF	KLNGQVLVF
AIPGFTINR	AIPGFTINR
RVKGPGISKF	RVKGPGISK
VMHTPPVLKK	VMHTPVLKK
AAYAWPFYK	AAYAWPFYK
TVSDAILRY	TVSDAILRY
KMYEEHLKRM	KMYEEHLKR
KSSSGTKTTK	KSSSTKTTK
ASYEFVQRLLK	ASYEVQRLL
RIFNPHLNK	RIFNPHLNK
ALNVPISVK	ALNVPISVK
LVANFFPKK	LVANFFPKK
RLFDTPHTPK	RLFDPHTPK
VVKPGNTK	VVK-PGNTK
KLFSELPLAK	KLFSLPLAK
RILSGPFVQK	RILSPFVQK
GLYTKSKTK	GLYTKSKTK
ALSSSVSSSK	ALSSVSSSK
RTFMIKFPWK	RTFMKFPWK
RLLPAEHCITK	LLPAHCITK
KLNITPTKK	KLNITPTKK
QTYSTEPNNLK	YSTEPNNLK
KLGDIMGVK	KLGDIMGVK
TVQQHPSTPK	TVQQPSTPK
AILEKSRLK	AILEKSRLK
RVAHLALKH	RVAHLALKH
KTYHVTPMTPR	KTYHPMTPR
SMMDVDHQIAK	MMDVHQIAK
RTQNVLGEK	RTQNVLGEK
SISGPISTSK	SISGISTSK
RLSPATENK	RLSPATENK
RIAGEASRLAH	RIAGEASRL
ILAEGGGAK	ILAEGGGAK
RVFTGVVTKL	RVFTGVVTK
SSAKPVIKK	SSAKPVIKK
RLGDSQLVK	RLGDSQLVK
AIKKPLTQK	AIKKPLTQK
SIRRGFQVYK	SIRRFQVYK
ATAAVTAAVK	ATAATAAVK
KLLPSALQK	KLLPSALQK
EARLLTQFPN	RLL---TQF
TLLGFFLAK	TLLGFFLAK
VIYIQAIFRGK	VIYIQAIFR
SIWDETLYK	SIWDETLYK
KQSQILLVY	KQSQILLVY
RISVSAASK	RISVSAASK
KISPYYRTK	KISPYYRTK
RQVVPISKK	RQVVPISKK
AIYGTRKFK	AIYGTRKFK
KLVENILAK	KLVENILAK
KVEHTSRLK	KVEHTSRLK
VMAPRTLIL	VMAPRTLIL
RLLSMAKPVYH	RLLSAKPVY
KSIDFPLTK	KSIDFPLTK
SILNTWISLK	ILNTWISLK
VLYISTQK	VLY-ISTQK
SLSSPLNPKLW	SLSSPLNPK
KSAEKALGK	KSAEKALGK
DRVYIHPFHL	RVYIHPFHL
AIAQAESLRYK	AQAESLRYK
SVVLVYVKI	SVVLVYVKI
FVYPGNPLRH	FVYPNPLRH
STASELSPK	STASELSPK
KITVPASQK	KITVPASQK
RIDKPILK	RID-KPILK
VMGAYVLLK	VMGAYVLLK
KSNSIIVSPR	KSNSIVSPR
GTLAEFIQK	GTLAEFIQK
KVGFFKRNLK	KVGFKRNLK
RQEGVPRTFK	RQEGPRTFK
KEGLPTRALQK	GLPTRALQK
RLVQGSILKK	RLVQSILKK
RVGTVIGSNK	RVGTIGSNK
KQYPPNTSK	KQYPPNTSK
RLLAEPVPGIK	LLAEVPGIK
LGSTVIKEVLK	STVIKEVLK
RLLEEGVLR	RLLEEGVLR
VLFVSVLPF	VLFVSVLPF
KLYTKHGTLKY	KLYTHGTLK
RQTATQLLK	RQTATQLLK
KPRKPATSSKP	KPRKATSSK
AMMGAVAEK	AMMGAVAEK
AVADSVLTK	AVADSVLTK
RLPLRVVKH	RLPLRVVKH
KVYELQASR	KVYELQASR
KLAPGGHVGR	KLAPGHVGR
SIRPVSEVTLK	RPVSEVTLK
HLLDIQGLPK	HLLDQGLPK
VTGPSQISK	VTGPSQISK
RTAHVILRY	RTAHVILRY
KTFEGNLTTK	KTFENLTTK
VLSERLLHK	VLSERLLHK
RIMENVFQH	RIMENVFQH
IIGTIFIIK	IIGTIFIIK
KVKTPQPKK	KVKTPQPKK
IVGDPSTAK	IVGDPSTAK
LLAKVFITK	LLAKVFITK
KVCDIYINY	KVCDIYINY
KQILTPMAQK	QILTPMAQK
ATYGKPVHH	ATYGKPVHH
ALKSINNAEK	ALKSNNAEK
KSAPATGGVK	KSAPTGGVK
AEWKATKL	AEW-KATKL
RLYFGERNVK	RLYFERNVK
NVGKKTVIWK	NVGKTVIWK
RLLQHTPSAR	RLLQTPSAR
KVNIIPVIAK	KVNIPVIAK
KLPKGKHSVK	KLPKKHSVK
KLDVDAPRLLK	DVDAPRLLK
SAAGHVLVK	SAAGHVLVK
WLVDLLNK	WLV-DLLNK
VSGPTLLAK	VSGPTLLAK
RTWLGYLFY	RTWLGYLFY
KVGEFSGANK	KVGESGANK
VTGPNMGGK	VTGPNMGGK
RVTDLFIGK	RVTDLFIGK
RTAFTLKQK	RTAFTLKQK
AVYPVFLFY	AVYPVFLFY
ATYREGMTK	ATYREGMTK
KQQELVQK	KQQ-ELVQK
RLASSVLRCGK	RLA-SSVLR
RVYYVDHVEK	RVYYDHVEK
HIHKSLIGK	HIHKSLIGK
QLFRGDTVLLK	QLFRTVLLK
AIFVPIHLVK	AIFVIHLVK
ALAEVNLKK	ALAEVNLKK
GVYGSFASK	GVYGSFASK
IIAKVFLAY	IIAKVFLAY
ATVTPSPVK	ATVTPSPVK
TLLGKPLLGK	TLLGPLLGK
KVAPVVITY	KVAPVVITY
RLRNLPTINR	RLRNPTINR
RLGITMKAKL	RLGITMKAK
KVLQIGSAK	KVLQIGSAK
KSYPSLTTK	KSYPSLTTK
AIRNDEELNK	AIRNEELNK
AVVETVTTAK	AVVEVTTAK
TVYIIENAK	TVYIIENAK
ILPYPVSPK	ILPYPVSPK
ASYENVRAK	ASYENVRAK
KAMGYFLKH	KAMGYFLKH
SVAQQLLNGK	SVAQLLNGK
SLFHAQLAY	SLFHAQLAY
AISPKPQSQK	AISPPQSQK
LSSGAVLYK	LSSGAVLYK
LAYFPYFITYK	LAYFYFITY
VLGQFLVLK	VLGQFLVLK
IIRVAVLDK	IIRVAVLDK
RAYPAQITPK	RAYPQITPK
RQGGTLTGK	RQGGTLTGK
SMLEYFINR	SMLEYFINR
RSTDPVTTK	RSTDPVTTK
VHEGPCGISY	HEGPCGISY
KLKNVFLAY	KLKNVFLAY
RLKDNRDLQK	RLKDRDLQK
LSLLPLSEK	LSLLPLSEK
KIGGIFAFK	KIGGIFAFK
AVYGQKEIHRK	AVYGKEIHR
KSFEKTNPK	KSFEKTNPK
STRKDYPAAK	STRKYPAAK
KTKAIMKH	KTK-AIMKH
RLYEHIKNDK	RLYEIKNDK
KTSSGFLAK	KTSSGFLAK
RIYLDLPQNFK	YLDLPQNFK
KTANPVAKR	KTANPVAKR
KSTELLIRK	KSTELLIRK
QLRAQILAYK	QLRAILAYK
VLMPKVMHY	VLMPKVMHY
GTSSVIVSRK	GTSSIVSRK
KLIENPLLR	KLIENPLLR
KLDGRSLIK	KLDGRSLIK
VVFPFPVNK	VVFPFPVNK
AVDSQILPK	AVDSQILPK
AIYGRGIAY	AIYGRGIAY
FFKEEELEY	FFKEEELEY
ATWTYSPLLK	ATWTSPLLK
ATVDKTVCK	ATVDKTVCK
ATHTAFVAK	ATHTAFVAK
WLRQKVGEK	WLRQKVGEK
IVHGDVLTFK	IVHGVLTFK
KMAPTVLVH	KMAPTVLVH
TVLGGVLGQK	VLGGVLGQK
KTHSGILGK	KTHSGILGK
VLLGSLFSRK	VLLGLFSRK
TLGPALLQK	TLGPALLQK
IVFNGPHLLLR	IVFNPHLLL
SLIGKKGQQK	SLIGKGQQK
RVDSKTLTR	RVDSKTLTR
RTYDGDGYKK	RTYDDGYKK
RLDSNRIGR	RLDSNRIGR
AVATFLIRH	AVATFLIRH
QVYPGKGGGSK	QVYPGGGSK
RTYVGSMPGR	RTYVSMPGR
KLNSGVDYR	KLNSGVDYR
ALKAAAAAQK	ALKAAAAQK
GVSPMPGTQK	GVSPPGTQK
KIYHISLEY	KIYHISLEY
KVIDPVTGK	KVIDPVTGK
KTFKTVEPTGK	KTFKEPTGK
ATYGDTINR	ATYGDTINR
KANPQVLKK	KANPQVLKK
VLSSFVLAEK	VLSSVLAEK
ATTQTIMQK	ATTQTIMQK
KMYEEHLKR	KMYEEHLKR
KLFPGSPAIY	KLFPSPAIY
RIAEPSVCGR	RIAESVCGR
GLYKAPLSK	GLYKAPLSK
AIFEVNTDLQK	AIFEVNTDL
KQLGRIMLK	KQLGRIMLK
KIHAGPITK	KIHAGPITK
RTFSWASVTSK	RTFSSVTSK
KMADKVLPQRI	KMADVLPQR
ATAGFTIGR	ATAGFTIGR
RTGSVSVHK	RTGSVSVHK
ALPEKVVNK	ALPEKVVNK
ALFGVVFPH	ALFGVVFPH
RAYHKYKAK	RAYHKYKAK
KILSNVISK	KILSNVISK
KVFEVHVRPK	KVFEHVRPK
KIGYHLLYY	KIGYHLLYY
KTLDSALFY	KTLDSALFY
IVVPPLPEK	IVVPPLPEK
KTLGPILKK	KTLGPILKK
KSGKPKVTK	KSGKPKVTK
VIFKDFVNK	VIFKDFVNK
KLYSLFLKY	KLYSLFLKY
ATYILEAGK	ATYILEAGK
RVYKEVKNR	RVYKEVKNR
RVRASAALLDK	RASAALLDK
LREFAPGVP	LREFAPGVP
QVADAFLSK	QVADAFLSK
RGYWGNKIGK	RGYWNKIGK
KMTDVQIATKL	KMTDQIATK
ATFPDPNVK	ATFPDPNVK
TSGPVTTSK	TSGPVTTSK
QIFNGTFVKL	QIFNGTFVK
RTLEPLAKK	RTLEPLAKK
RLFGISLSY	RLFGISLSY
SVLQFLGLYK	SVLQLGLYK
KTYEVSLREK	KTYESLREK
GSYSKAFAR	GSYSKAFAR
GTFVSPEVFLK	FVSPEVFLK
KLKSTESELK	KLKSESELK
SLLGYFPNK	SLLGYFPNK
KLQGQVSAK	KLQGQVSAK
KMLPKTMNR	KMLPKTMNR
RLKEEAAMK	RLKEEAAMK
VVGPVSLPR	VVGPVSLPR
LLYSHPTSR	LLYSHPTSR
AVFQIILRR	AVFQIILRR
SLAALPAKPE	SLA-ALPAK
ALWGGTQPLLK	ALWGQPLLK
GTLSGWILSK	GTLSWILSK
GTLPKALTK	GTLPKALTK
GLNSPVLIGK	GLNSVLIGK
GVSSIFIYH	GVSSIFIYH
RTYGVVAQY	RTYGVVAQY
VVMRDPQTK	VVMRDPQTK
KLFLIDFGLAK	FLIDFGLAK
KVIPSPFKH	KVIPSPFKH
ATFTNVFGK	ATFTNVFGK
IVFSLTFFK	IVFSLTFFK
AMYNQGFIRK	AMYNGFIRK
GTNPGIITK	GTNPGIITK
HVLEAQDLIAK	VLEADLIAK
KIADRFLLY	KIADRFLLY
RIKPPWVVK	RIKPPWVVK
GIYPHEPKHK	GIYPEPKHK
LLYGPPGTGK	LLYGPGTGK
RVHDPVTAKPK	RVHDPVTAK
KSLDQAISRF	KSLDQAISR
ATYSVGMQK	ATYSVGMQK
RLFEYILLY	RLFEYILLY
ITPCKPIDIK	ITPCPIDIK
RLEPPEQRKK	RLEPEQRKK
KLLGPVLVK	KLLGPVLVK
AVLGFAMYK	AVLGFAMYK
ATNKITIIFK	ATNKTIIFK
AVYLLPVPK	AVYLLPVPK
GTWKTPSFPK	GTWKPSFPK
RIYIPLPSAK	RIYILPSAK
RSQKPVMVK	RSQKPVMVK
SILSVLKGLT	SILSVLKGL
VTYSLPRTK	VTYSLPRTK
RAAEHTLLH	RAAEHTLLH
RLLTSITTK	RLLTSITTK
SVLDTVLLRPK	SVLDTVLLR
SSYPVCVSK	SSYPVCVSK
IIFGPPGTGK	IIFGPGTGK
RLIAAFEQK	RLIAAFEQK
IVFMPVIGK	IVFMPVIGK
KISLPPVLK	KISLPPVLK
RVRFNLMEK	RVRFNLMEK
KGFLTRRLM	KGFLTRRLM
TLAVNIIAK	TLAVNIIAK
LPALKQTPK	LPALKQTPK
ILYIATPNK	ILYIATPNK
IALWPPVREK	ALWPPVREK
RSYSDPPLK	RSYSDPPLK
KTYTITEGSLR	KTYTTEGSL
YVYFTNELK	YVYFTNELK
KLNIRPLLR	KLNIRPLLR
RQAVPLFSK	RQAVPLFSK
SVSPIPAGSK	SVSPPAGSK
STFQQMWISK	STFQMWISK
SLFPKALQR	SLFPKALQR
ALWEEQVLQK	ALWEQVLQK
ATYPIKAVK	ATYPIKAVK
KLLQEAEQRLK	KLLQEAEQR
ATDIPSSQK	ATDIPSSQK
VVFRDPYRFK	VVFRPYRFK
RIKEAVRSK	RIKEAVRSK
PIGKGKPVSVP	PIGKKPVSV
SLYRNILMY	SLYRNILMY
FVKTLTGK	FVK-TLTGK
AVHQQILSNK	AVHQILSNK
KVYENYPTY	KVYENYPTY
SLQPSISQK	SLQPSISQK
RVWIQGKFQK	RVWIGKFQK
VLKPGNSK	VLK-PGNSK
VTKYGTLQGK	VTKYTLQGK
RSYEEHLEK	RSYEEHLEK
VSPPVLSPK	VSPPVLSPK
KIRAAQNISK	KIRAQNISK
RVLEALLPLK	RVLELLPLK
GSYVTHETK	GSYVTHETK
IVMETGNTK	IVMETGNTK
ATYETKESK	ATYETKESK
AIAPKGSEK	AIAPKGSEK
VTISIELKK	VTISIELKK
AVKLGAVPK	AVKLGAVPK
KIYVGLSK	KIY-VGLSK
VVGAVVFQK	VVGAVVFQK
RLFTDVLLH	RLFTDVLLH
KQLTKPQELK	KQLTPQELK
RVFPWFSVK	RVFPWFSVK
ATLSQFYINK	ATLSFYINK
RINHQLHTNK	RINHLHTNK
LPINGNGKQ	LPINGNGKQ
ALVFPPLTQR	LVFPPLTQR
RLGPLLGK	RLG-PLLGK
HLLETPLVVK	HLLEPLVVK
QVYEQKSLK	QVYEQKSLK
GSYSSHISSK	GSYSHISSK
RIHENGYNFK	RIHEGYNFK
RVYNIYIRR	RVYNIYIRR
VVFDTSLQVKK	VVFDSLQVK
SLWHIQISR	SLWHIQISR
AVKDAVGTLK	AVKDVGTLK
KLNVGGALYY	KLNVGALYY
GSNGYILNK	GSNGYILNK
ALALGVTLLK	ALALVTLLK
MLILGFIIAF	LILGFIIAF
RTFFSVQKE	RTFFSVQKE
VLGPNVSIGK	VLGPVSIGK
ILRIPTQVGK	ILRITQVGK
KVSPASGVSK	KVSPSGVSK
RVFNIMREK	RVFNIMREK
RLPVEPHIGK	RLPVPHIGK
RVNPRVSNVK	RVNPVSNVK
RLFTSEKMVK	RLFTEKMVK
LLPNHVLQK	LLPNHVLQK
KIRQDSVTKL	KIRQDSVTK
KLFEAPNFFQK	KLFENFFQK
GTMPVSLLK	GTMPVSLLK
KSGPPELRK	KSGPPELRK
MMFSATFPK	MMFSATFPK
SVVLEKNFK	SVVLEKNFK
KVHAYIISY	KVHAYIISY
VTVSGGTPK	VTVSGGTPK
KIGEVSSPK	KIGEVSSPK
KLADQIFAYY	KLADQIFAY
RLAEVALAY	RLAEVALAY
RVGPVSHHR	RVGPVSHHR
GLFTHTIFY	GLFTHTIFY
VLKAQAQSQK	VLKAAQSQK
VLGPIINK	VLG-PIINK
SVISSPLLK	SVISSPLLK
RLSSKLIQH	RLSSKLIQH
KVDGRVVEPK	KVDGVVEPK
QLYEKGLYY	QLYEKGLYY
ALYFPKNGD	ALYFPKNGD
RIAEIFMRH	RIAEIFMRH
RIHGSPLQK	RIHGSPLQK
VIKPGNTKEK	VIKPNTKEK
KLLDAYLLY	KLLDAYLLY
QIAVIAIFK	QIAVIAIFK
WPRSLTLLQSN	RSLTLLQSN
KVTLTKSPK	KVTLTKSPK
ILPKNVLKK	ILPKNVLKK
RIKKPIKTK	RIKKPIKTK
RVILAGNLLSH	ILAGNLLSH
KLREKISEK	KLREKISEK
GTIPGNPYPK	GTIPNPYPK
KLFPGSPAIYK	KLFPPAIYK
KVNIIPLIAK	KVNIPLIAK
ALNEKQILEK	ALNEQILEK
LLNYAPLEK	LLNYAPLEK
TLAFKPIKK	TLAFKPIKK
SLLGKPLSY	SLLGKPLSY
KSYLAVRLK	KSYLAVRLK
KLADFGLAR	KLADFGLAR
RTATQLAVNK	RTATLAVNK
RIKIGLNSK	RIKIGLNSK
RVMQDIVYK	RVMQDIVYK
SVRPGASYK	SVRPGASYK
KLPEEVVKK	KLPEEVVKK
LSLGVAALYK	SLGVAALYK
KSYDQVHSGK	KSYDVHSGK
ILTYKYLQK	ILTYKYLQK
VLFHNTIYY	VLFHNTIYY
PAHGLFLK	PAH-GLFLK
QVNERVLNR	QVNERVLNR
KLTPSLEQK	KLTPSLEQK
RLLSGVPLYK	RLLSVPLYK
LSYNTASNK	LSYNTASNK
QLYDKGLVY	QLYDKGLVY
AMNHPGHLK	AMNHPGHLK
RLSEKQLKH	RLSEKQLKH
ATPKKTVPK	ATPKKTVPK
LILPTIQKS	LILPTIQKS
LEDLLTSLLQR	DLLTSLLQR
RLLLIATGK	RLLLIATGK
KVHGSLARAGK	KVH-GSLAR
RLKSPFRKK	RLKSPFRKK
AAKPPISKK	AAKPPISKK
LINPSLIGSK	LINPLIGSK
GLFGGAGVGK	GLFGAGVGK
RVYSPPEWISR	RVYSEWISR
VIYKNTHIK	VIYKNTHIK
KLEEQRPERVK	KLEEQRPER
RIGKVGNQK	RIGKVGNQK
SVFGGLVNYFK	SVFGGLVNY
RVYDLGKKK	RVYDLGKKK
KFSLYCTK	KFS-LYCTK
RVFDVPIRR	RVFDVPIRR
RQKQGVVLK	RQKQGVVLK
GLGPKASQK	GLGPKASQK
KTIDYIQFLHK	KTIDIQFLH
RLPPATLTLK	RLPPTLTLK
RLYPGSVYGR	RLYPSVYGR
TIYTSYKEK	TIYTSYKEK
KILKPVKKK	KILKPVKKK
GIYVQDVKTGK	YVQDVKTGK
KTFHGLLTR	KTFHGLLTR
STAAFFLLR	STAAFFLLR
SVSTVLTSK	SVSTVLTSK
IVNSAQTGSFK	NSAQTGSFK
FQYDRFFEK	FQYDRFFEK
RLRDPDSHIVK	RLRDSHIVK
QVFKLGLAK	QVFKLGLAK
GVYVSETQNR	GVYVETQNR
RVASVMQEY	RVASVMQEY
IVREDLLSAK	IVRELLSAK
SIAAKILSY	SIAAKILSY
FVFKPNSKK	FVFKPNSKK
GLGEPLALK	GLGEPLALK
TVNPQFVQK	TVNPQFVQK
SVLPEYLKVFK	VLPELKVFK
RTTSHLLRY	RTTSHLLRY
STYPPEIVVPK	STYPIVVPK
RLSVSTPSR	RLSVSTPSR
AIQNPTMINK	AIQNTMINK
STTPPTSAK	STTPPTSAK
RVLKPGGLLK	RVLKGGLLK
IIGPNGSGK	IIGPNGSGK
VTLSWKPVQK	VTLSKPVQK
IVSGPPSHK	IVSGPPSHK
ATATELTTK	ATATELTTK
SLYSVPEGQSK	SLYSEGQSK
HVGISFVPK	HVGISFVPK
GSYSLPGTLAK	YSLPGTLAK
RLMDRPIFY	RLMDRPIFY
KLAVADLEK	KLAVADLEK
ALYFITPTSK	ALYFTPTSK
SLLNVSTPK	SLLNVSTPK
RSALPTKTVK	RSALTKTVK
RVTSQVSNLK	RVTSVSNLK
SLHPGSSALHY	SLHPSSALH
VTISFRIYK	VTISFRIYK
AVNPKEIASK	AVNPEIASK
IINCAQGKK	IINCAQGKK
ILTCTLLLLY	ILTCLLLLY
VVVPPLPGK	VVVPPLPGK
SMNANTITK	SMNANTITK
AVAHALTEK	AVAHALTEK
VTNQPVTPK	VTNQPVTPK
LILEPSLYTVK	ILEPLYTVK
KTLEGVITRTK	KTLEGVITR
LTRKPMTTK	LTRKPMTTK
VVYTSEMALK	VVYTEMALK
ATAASSSSLEK	AASSSSLEK
RIKEIAQDALK	RIKEAQDAL
ILYDHAHVK	ILYDHAHVK
VVDYPNSAK	VVDYPNSAK
ASYGSTTTK	ASYGSTTTK
PISGWFALK	PISGWFALK
RLKPTNPAAQK	RLKPPAAQK
KQSPPISTSK	KQSPISTSK
KTYIPPKGETK	YIPPKGETK
IVAFTTATK	IVAFTTATK
RLREGQTLR	RLREGQTLR
RLMDFLLQR	RLMDFLLQR
AVSPSSSEK	AVSPSSSEK
KQIRLIEK	KQI-RLIEK
ASKENVSQPK	ASKEVSQPK
HLHPTSTEK	HLHPTSTEK
AQYEDIAQK	AQYEDIAQK
QLRAQIMAY	QLRAQIMAY
AVSNSFLAY	AVSNSFLAY
GLEAIQRTPK	GLEAQRTPK
SLGHFENLQK	SLGHENLQK
RLAEAAVAEK	RLAEAVAEK
RLLTSLRAK	RLLTSLRAK
QVLKQTLKQK	VLKQTLKQK
AVDATLRKK	AVDATLRKK
QLYKEQLAK	QLYKEQLAK
HVVLPVKPK	HVVLPVKPK
ALSSYVVKK	ALSSYVVKK
RLFYDISEK	RLFYDISEK
ASATVAIPK	ASATVAIPK
RLSSCKPPK	RLSSCKPPK
RTASFAVRK	RTASFAVRK
ATAAPLTPR	ATAAPLTPR
ILNSHCFAR	ILNSHCFAR
ALKTGIVAKK	ALKTGIVAK
GLFALPFGR	GLFALPFGR
KSAPATGGVKK	KSAPTGGVK
ISAPVVRPK	ISAPVVRPK
MLAPPRELFK	MLAPRELFK
KISDFGLSK	KISDFGLSK
KLMENTFVSK	KLMETFVSK
AANKVVLQLK	AANKVLQLK
RSHSPLRSK	RSHSPLRSK
RIWAAAPNRF	RIWAAAPNR
TLDKHLRQK	TLDKHLRQK
HIFMKVFPK	HIFMKVFPK
KLLDPIREK	KLLDPIREK
RVYNGRLKVQR	RVY-NGRLK
ASGSFKLNK	ASGSFKLNK
QLSPPSQSK	QLSPPSQSK
RVLTSGIFETK	VLTSIFETK
RIRTDTYVK	RIRTDTYVK
ILYVGSMPLK	ILYVSMPLK
AIMDAGIFITK	IMDAIFITK
RLNESTSYKF	RLNESTSYK
ALANKPLRR	ALANKPLRR
LLHEQNMAK	LLHEQNMAK
RGAVPMSTK	RGAVPMSTK
RLAEKLRAQK	RLAELRAQK
GTVNRATEK	GTVNRATEK
RSYSCQVTH	RSYSCQVTH
KTKAPPLSK	KTKAPPLSK
SVFKSARQK	SVFKSARQK
GLAPVRSSR	GLAPVRSSR
VVMRDPASK	VVMRDPASK
AVFPVAPTSSK	AVFPPTSSK
ATNGKVLKK	ATNGKVLKK
VTLSMAYRLLK	LSMAYRLLK
STSGTVINK	STSGTVINK
RIRQNEINNPK	RQNEINNPK
KASDEKPSPTK	ASDEPSPTK
KVSASPLLY	KVSASPLLY
LLRVTPFILK	LLRVPFILK
KLKSTTESY	KLKSTTESY
KVSPLTFGRK	KVSPTFGRK
LTYRRRLSY	LTYRRRLSY
KLNWTGTSK	KLNWTGTSK
SLATVILVK	SLATVILVK
GVLPSALNPK	GVLPALNPK
KLFKPGQEAVK	KLFKQEAVK
ALKCIPKK	ALK-CIPKK
SVLSPLLNK	SVLSPLLNK
RLYQAVVDARK	RLYQVVDAR
RSMPEQTGEK	RSMPQTGEK
AVAPLSASK	AVAPLSASK
AVYATGNAR	AVYATGNAR
IVFVTGNAK	IVFVTGNAK
KTDVTMLLY	KTDVTMLLY
ALVSTPVRTK	ALVSPVRTK
RTRPPSVQVAK	RPPSVQVAK
RQRLNPTSNK	RLN-PTSNK
KTLSIFMEY	KTLSIFMEY
AVIGDQSSGK	VIGDQSSGK
RIYSQKIGIKK	RIYSKIGIK
SVNKASTVTK	SVNKSTVTK
SIYPHGSTDK	SIYPGSTDK
KSWNAENTTEK	KSWNNTTEK
ILRDGITAGK	ILRDITAGK
AVLKGVHSHK	AVLKVHSHK
SLRSSLSGK	SLRSSLSGK
KTTDRYVQQK	KTTDYVQQK
KTYPAHQNR	KTYPAHQNR
KQIEHTLNEK	KQIETLNEK
AVTTTVTGAK	AVTTVTGAK
KTQGARQK	KTQ-GARQK
PVEQYLGVP	PVEQYLGVP
VMRDPASK	VMR-DPASK
ALGPVVGAR	ALGPVVGAR
RSRSPPPVSK	RSRSPPVSK
KIRTSPTFR	KIRTSPTFR
GSSSVILEK	GSSSVILEK
KGNSPLLQK	KGNSPLLQK
SVSSHLFTHK	SVSSLFTHK
SVNPSVTTIK	SVNPVTTIK
AIAKQALKK	AIAKQALKK
RVVDGKDLTTK	VVDGDLTTK
RVNKLICVK	RVNKLICVK
RSYSPDHRQK	RSYSDHRQK
ATAQFKINK	ATAQFKINK
YLPDGTASL	YLPDGTASL
QTGKPSAPK	QTGKPSAPK
KLANPSIVTKK	KLANSIVTK
RVYGQPSTK	RVYGQPSTK
KLREAEQQRVK	KLREAEQQR
KAFGRRANLFK	KAFGRRANL
KTQSEKYTTSF	TQSEYTTSF
KLQDGSIKMK	KLQDSIKMK
RLSSVSVTY	RLSSVSVTY
AVGPIIEK	AVG-PIIEK
SVKPGAHLTVK	SVKPHLTVK
KLFNGTFLKA	KLFNGTFLK
GLDDPRLEK	GLDDPRLEK
RVGTPQSTK	RVGTPQSTK
VVFRDPYRFKK	VVFRPYRFK
GLDPSQRPK	GLDPSQRPK
KVISSNTSLK	KVISNTSLK
RTDDKVIRFK	RTDDVIRFK
ATANQIILK	ATANQIILK
RVFHGNETTK	RVFHNETTK
RTKKLSDYVGK	KLS-DYVGK
TLMTILKNSI	TLM--TILK
TTNDIVISK	TTNDIVISK
KQFSVPLRR	KQFSVPLRR
RLRDPAQQVRK	RLRDAQQVR
ISAPKPGPLK	ISAPPGPLK
