Data	Data aligned
SYEDRVTFL	SYEDRVTFL
TYDISQLF	TYDIS-QLF
VFDMGAEVGF	VFDMG-AEV
NFDVATHV	NFDVA-THV
VWDQASTL	VWDQA-STL
RFDDGLVHL	RFDDGLVHL
YFDKELIQL	YFDKELIQL
HFDVQSMLF	HFDVQSMLF
LFDNPRTF	LFDNP-RTF
IYDKCITEL	IYDKCITEL
IFDSTAVLL	IFDSTAVLL
SVDVTNTTF	SVDVTNTTF
SMDEKVEL	SMDEK-VEL
RFDGYVFL	RFDGY-VFL
GWDVAELQL	GWDVAELQL
NYDEALRLL	NYDEALRLL
YFDAIPVTMTM	YFDAIPVTM
VFDLIQEL	VFDLI-QEL
HYDLFIERF	HYDLFIERF
HPDKDVRLL	HPDKDVRLL
IYDSVKVYF	IYDSVKVYF
IFDLMDAKA	IFDLMDAKA
MFDEPSSYL	MFDEPSSYL
SFDVSQKF	SFDVS-QKF
TWYLDESTL	TWYLDESTL
TFDNVTSYL	TFDNVTSYL
TYDDFRNVL	TYDDFRNVL
SFDDLSVDF	SFDDLSVDF
GYDTRVTVL	GYDTRVTVL
NFDVLMVKL	NFDVLMVKL
TFDPTNQWL	TFDPTNQWL
YYDGVAKI	YYDGV-AKI
SYDESKVEF	SYDESKVEF
VYDVTLNF	VYDVT-LNF
IFDLSEVL	IFDLS-EVL
TFESLVAKL	TFESLVAKL
LYDVSNIL	LYDVS-NIL
FMDDKRVYI	FMDDKRVYI
TYDQMYNDL	TYDQMYNDL
HYDLNQLL	HYDLN-QLL
IFDVVDGTYV	IFDVVGTYV
LEDYIVEI	LEDYI-VEI
VFDESLSMF	VFDESLSMF
LFDVTGQV	LFDVT-GQV
AFDIAEELV	AFDIAEELV
VWDIVGTEL	VWDIVGTEL
FFVPFSYL	FFVPF-SYL
FFEVFTPVF	FFEVFTPVF
FFDHSTRIV	FFDHSTRIV
YVDTEVEM	YVDTE-VEM
LFEVISHSF	LFEVISHSF
HYDLAFTDV	HYDLAFTDV
AFDVHLNAF	AFDVHLNAF
YSDDHVKF	YSDDH-VKF
IVDLPVHQL	IVDLPVHQL
AYDVLIKM	AYDVL-IKM
NFDRLVSNL	NFDRLVSNL
TFDFRTGKM	TFDFRTGKM
YFDVSHEHL	YFDVSHEHL
STDDPPRPTF	TDDPPRPTF
VFDTPEEAF	VFDTPEEAF
GFDHHVVRV	GFDHHVVRV
RFDGMLLAM	RFDGMLLAM
PVEIHEYL	PVEIH-EYL
LFDARTSLV	LFDARTSLV
DLQARITSL	DLQARITSL
DFDMTLSRF	DFDMTLSRF
NYDLALKYF	NYDLALKYF
LFDKSINEF	LFDKSINEF
NYDRGYSSL	NYDRGYSSL
VYDPSLKTL	VYDPSLKTL
VYDHQGIF	VYDHQ-GIF
DPEGEFIITV	DPEGEIITV
MVDPAINLF	MVDPAINLF
EYDTVTREV	EYDTVTREV
RWEEHRSLL	RWEEHRSLL
HFDEVHRGL	HFDEVHRGL
YFDLLGELM	YFDLLGELM
VFFLFDHQM	VFFLFDHQM
LMDGRDAFL	LMDGRDAFL
YPDATPEEL	YPDATPEEL
KFWDYLQEF	KFWDYLQEF
IYDLVDRHL	IYDLVDRHL
IYDVLIRL	IYDVL-IRL
LLDGKLVLL	LLDGKLVLL
LLDPVPPVL	LLDPVPPVL
TYDNVHQQF	TYDNVHQQF
AFDALVTF	AFDAL-VTF
DYDPQTVRL	DYDPQTVRL
TWDDAFATF	TWDDAFATF
FMDESTQCF	FMDESTQCF
SMDPLPVFL	SMDPLPVFL
IFTPIVEHL	IFTPIVEHL
FWDNVVYI	FWDNV-VYI
KFDDKFAYL	KFDDKFAYL
SFDEINKAF	SFDEINKAF
DGTIRIWDL	DGTIRIWDL
RFSDHVALL	RFSDHVALL
IAPGVTHEL	IAPGVTHEL
GMDVAASEF	GMDVAASEF
TYDPETQEF	TYDPETQEF
YVPDSPALL	YVPDSPALL
HFDYQSLLM	HFDYQSLLM
GGSFDVADRMF	SFDVADRMF
STDDGVQF	STDDG-VQF
VSDDRVKL	VSDDR-VKL
IHDLLTIFV	IHDLLTIFV
SFDPKDIFL	SFDPKDIFL
AFDSSSAVFL	AFDSSSAVF
VFDDIETNM	VFDDIETNM
TYYLWVKSV	TYYLWVKSV
TDPRVVDL	TDPRV-VDL
LYDFIHTSF	LYDFIHTSF
VFDEADRMF	VFDEADRMF
LPDIVSKVL	LPDIVSKVL
IYDTHSLM	IYDTH-SLM
YCDERITEL	YCDERITEL
KFDEGRNNF	KFDEGRNNF
YFDDALEDF	YFDDALEDF
QYDLATKRV	QYDLATKRV
VFDPYYFI	VFDPY-YFI
MPEQWARLL	MPEQWARLL
AFYDWDNTEL	FYDWDNTEL
YFEYFGPDF	YFEYFGPDF
EYDNAIITM	EYDNAIITM
FVDPAQITM	FVDPAQITM
GFDLSEEKF	GFDLSEEKF
MFDEKLVTV	MFDEKLVTV
IQDITQRL	IQDIT-QRL
FYDWDNTEL	FYDWDNTEL
ITDHLIAML	ITDHLIAML
NLDPLVYLL	NLDPLVYLL
AFDDVVKYF	AFDDVVKYF
ISDFGLATVF	ISDFGLATV
RWDAIVAEV	RWDAIVAEV
VFDVLDGEEM	VFDVLGEEM
FFDTSVPLM	FFDTSVPLM
MWDQRLVRL	MWDQRLVRL
FFDTNTSVL	FFDTNTSVL
TWEAQPVKV	TWEAQPVKV
SFDEVEGVF	SFDEVEGVF
LFDQANKL	LFDQA-NKL
LWDKIAAQL	LWDKIAAQL
FYDKFILL	FYDKF-ILL
VGDERVLL	VGDER-VLL
LFDEIRMTY	LFDEIRMTY
VYDGEHLGSF	VYDGELGSF
YWDNSIQVM	YWDNSIQVM
FDEAIRAV	FDEAI-RAV
IPEDVSGLVSL	IPEDVSGLV
VWNAQEAQADF	NAQEAQADF
TYEGKPIFL	TYEGKPIFL
NLPIGFLEL	NLPIGFLEL
VFDNVKDF	VFDNV-KDF
KADSVVVLL	KADSVVVLL
VFDEVVQI	VFDEV-VQI
YFDAIPVTMT	YFDAIPVTM
YIDLPPPRL	YIDLPPPRL
YFPELIANF	YFPELIANF
FYDPDTVEL	FYDPDTVEL
SIPEKNRPL	SIPEKNRPL
LLMDRVDEM	LLMDRVDEM
VWDRFLSTM	VWDRFLSTM
FYPPDPAQL	FYPPDPAQL
LFDASGHGL	LFDASGHGL
VADLAESIM	VADLAESIM
VFDLAWVPGEL	VFDLAPGEL
LFDPINLVF	LFDPINLVF
SYDHVELTF	SYDHVELTF
TFDSEVELM	TFDSEVELM
TFDDVAVTF	TFDDVAVTF
IFDEDAGFL	IFDEDAGFL
HYDAVEAEL	HYDAVEAEL
NFEVSTVIF	NFEVSTVIF
IFEDKTVKL	IFEDKTVKL
AFDRCATL	AFDRC-ATL
VYDISYLL	VYDIS-YLL
AVVQDPALKPL	VQDPALKPL
SFDSGIAGL	SFDSGIAGL
LWDLETQGM	LWDLETQGM
VYDIAAKF	VYDIA-AKF
LFDTTNQLF	LFDTTNQLF
SGDDKVFL	SGDDK-VFL
MMDFFNAQM	MMDFFNAQM
YYDDLKYRYF	YYDDLYRYF
HYDHVLIEL	HYDHVLIEL
VTDGKEVLL	VTDGKEVLL
SYDVIIRM	SYDVI-IRM
IYDEVVKLL	IYDEVVKLL
YYEVAGHL	YYEVA-GHL
NFDEALVDYF	NFDEAVDYF
KYDPINSML	KYDPINSML
AFDLTEQRY	AFDLTEQRY
VFDPVTKLW	VFDPVTKLW
IWDPVLSVM	IWDPVLSVM
DYVDSALLM	DYVDSALLM
LFDSLSTL	LFDSL-STL
FDDIVHSF	FDDIV-HSF
SFDIQLTSV	SFDIQLTSV
TYDYAKTIL	TYDYAKTIL
AYDGKDYIAL	AYDGKYIAL
VFDDTITEM	VFDDTITEM
NYDTTESKL	NYDTTESKL
WPDDKVHKL	WPDDKVHKL
TFDPFCYL	TFDPF-CYL
IFHHFAPLL	IFHHFAPLL
VFDNQLTI	VFDNQ-LTI
KFWQFLETV	KFWQFLETV
VWDVGSHF	VWDVG-SHF
FFDPSLLHLL	FFDPSLLHL
MVDPFHTLF	MVDPFHTLF
FLDLTEQEF	FLDLTEQEF
YFDEHYEY	YFDEH-YEY
TFDVSILTI	TFDVSILTI
VFDEADRLF	VFDEADRLF
NFDKIRVWL	NFDKIRVWL
RFDGRVVLV	RFDGRVVLV
NYDAASGTM	NYDAASGTM
YWDWSDSEF	YWDWSDSEF
TFDIEAVTL	TFDIEAVTL
WFDNSNMTF	WFDNSNMTF
LFDTMQHHL	LFDTMQHHL
AFDLKAAVL	AFDLKAAVL
VPEEKAAEL	VPEEKAAEL
SFDEMNAEL	SFDEMNAEL
RFDMAVMFM	RFDMAVMFM
KFDEVLVNHF	KFDEVVNHF
KWDTANNPL	KWDTANNPL
HPDTGEKMIL	HPDTG-EKM
FYDRAEYL	FYDRA-EYL
NFDVGHVPIRL	NFDVGHVPI
RYDDMAAAM	RYDDMAAAM
AAPIRLLAA	AAPIRLLAA
YFDDLKGEM	YFDDLKGEM
AFDKPKVEL	AFDKPKVEL
FYDSTAGKF	FYDSTAGKF
LFDAVSSLI	LFDAVSSLI
DFDVHGNL	DFDVH-GNL
YTDELVEL	YTDEL-VEL
VFDGHGGI	VFDGH-GGI
IWDETPLYF	IWDETPLYF
HLVDEPQNLIK	LVDEP-QNL
NFDDKVML	NFDDK-VML
IWDRAITTL	IWDRAITTL
TFPQNPVEL	TFPQNPVEL
KSDVEAIF	KSDVE-AIF
ITDPEVVFV	ITDPEVVFV
LGASRTLSL	LGASRTLSL
NYDAALRKI	NYDAALRKI
TFDPVTKM	TFDPV-TKM
IYDYAIVLF	IYDYAIVLF
VFDQYLNF	VFDQY-LNF
LFDRPMHVKM	LFDRP-MHV
SFDLLVKNL	SFDLLVKNL
IYDIYGKRGL	IYDIYKRGL
WFEAQVVRV	WFEAQVVRV
FFDNISSEL	FFDNISSEL
NFDMLYNHV	NFDMLYNHV
FYDPDTSIIYL	FYDPDTSII
SIPILASAL	SIPILASAL
VYDVVELKF	VYDVVELKF
TFDPVTKML	TFDPVTKML
IFDEGHML	IFDEG-HML
DFDPALLEFL	DFDPALLEF
YFEAMFRSF	YFEAMFRSF
VFDKMSSLL	VFDKMSSLL
VFDETGHFVL	VFDETGHFV
NYDETISTL	NYDETISTL
LFDIFLETV	LFDIFLETV
KFPVKPADL	KFPVKPADL
FLDALIVSM	FLDALIVSM
AFDNMVTSM	AFDNMVTSM
IWDLLKNAI	IWDLLKNAI
SFDSVPVSL	SFDSVPVSL
KVDQEVKL	KVDQE-VKL
EFDSTVTHV	EFDSTVTHV
QFDVQRKYF	QFDVQRKYF
FYDERGDQF	FYDERGDQF
IFDVHTKI	IFDVH-TKI
VFEVSLADL	VFEVSLADL
TFDDIVHSF	TFDDIVHSF
IVNSVILIL	IVNSVILIL
YFFTWDTEY	YFFTWDTEY
FPEYELPEL	FPEYELPEL
SYDTFVVRV	SYDTFVVRV
RFDSDVGEF	RFDSDVGEF
FWDGKIVLV	FWDGKIVLV
IVDGAVVKF	IVDGAVVKF
VSPVVRVAV	VSPVVRVAV
VFEPSWAEF	VFEPSWAEF
YAEVGRVL	YAEVG-RVL
HFPGLASEL	HFPGLASEL
QFDNYGEEF	QFDNYGEEF
NWFVWVTQM	NWFVWVTQM
LFDAETVAL	LFDAETVAL
TFDNEIVMM	TFDNEIVMM
FYDSELFRM	FYDSELFRM
TFDAGLQAF	TFDAGLQAF
LPDGQVITI	LPDGQVITI
FFDDCIEKL	FFDDCIEKL
VFDTAKEDV	VFDTAKEDV
VFDNSIKTF	VFDNSIKTF
VFDASSIQYF	VFDASIQYF
HNDTWVLL	HNDTW-VLL
VFDMAGEIGF	VFDMAEIGF
YYPAFLDMV	YYPAFLDMV
LFDDSEVKV	LFDDSEVKV
LVTVYAFPF	LVTVYAFPF
FLDEEVKL	FLDEE-VKL
SFDPLLITL	SFDPLLITL
LFDGSPTYV	LFDGSPTYV
KWDPTGNLL	KWDPTGNLL
LFDDMFEDM	LFDDMFEDM
VLDVVERSL	VLDVVERSL
YFHEALRAF	YFHEALRAF
AFLESVKKL	AFLESVKKL
VFDEAIRAVL	VFDEAIRAV
FRDDVVFL	FRDDV-VFL
AFDVAEREF	AFDVAEREF
IYDIHVGL	IYDIH-VGL
MYDSFWRQF	MYDSFWRQF
RFDGVTSML	RFDGVTSML
ITDLPIKL	ITDLP-IKL
FYEEKEVDL	FYEEKEVDL
ILDAQTAFV	ILDAQTAFV
FWESSIVYL	FWESSIVYL
FFDFSTKEF	FFDFSTKEF
EVSPEVVEI	EVSPEVVEI
FFDHSGTL	FFDHS-GTL
YYDEIAVPF	YYDEIAVPF
TYDLQESNV	TYDLQESNV
YYDLVKAFM	YYDLVKAFM
LELFPAPIL	LELFPAPIL
NFDVTYNWI	NFDVTYNWI
ILDSHAATL	ILDSHAATL
VTDEPVYIDL	VTDEP-VYI
IFDLSNHL	IFDLS-NHL
YYDVAKQL	YYDVA-KQL
NYDYAVYL	NYDYA-VYL
LPDPFTPNLKV	LPDPFTPNL
SFDPSRTF	SFDPS-RTF
VVPDHPVLL	VVPDHPVLL
KTDVVVNSV	KTDVVVNSV
TFDIASDAF	TFDIASDAF
FFNYTVRTL	FFNYTVRTL
QYDAFVKF	QYDAF-VKF
LFESPVYL	LFESP-VYL
YLPDGTASL	YLPDGTASL
AFDDAIAEL	AFDDAIAEL
FTEDQTAEF	FTEDQTAEF
VFMDKPEEF	VFMDKPEEF
AFDPTSTLL	AFDPTSTLL
SLDPLPPYI	SLDPLPPYI
RFDYTNSEF	RFDYTNSEF
VFDAMFNGGM	VFDAMNGGM
IFDNAMAGV	IFDNAMAGV
AFDEAFAEF	AFDEAFAEF
ITDESGHL	ITDES-GHL
VFDLSEKL	VFDLS-EKL
YFDMGAAVL	YFDMGAAVL
VFDVESREL	VFDVESREL
LNQPHMVL	LNQPH-MVL
MFDIVGTHL	MFDIVGTHL
IFDNSDNRL	IFDNSDNRL
SFDPLASFI	SFDPLASFI
YYDPKHVIF	YYDPKHVIF
FYERGVAVL	FYERGVAVL
VFDAFLNM	VFDAF-LNM
FYDGIKAIL	FYDGIKAIL
YFDEKELEL	YFDEKELEL
VFDLNTPVHTF	VFDLN-TPV
HLDRPVFL	HLDRP-VFL
AYDLASREWL	AYDLASREW
IYDALIYM	IYDAL-IYM
VFDEAILAAL	VFDEALAAL
LYDVVDVKY	LYDVVDVKY
IYDIVRNSW	IYDIVRNSW
LYDLTLEYL	LYDLTLEYL
LYDLLRNTNF	LYDLLNTNF
VFDVSHNAV	VFDVSHNAV
TTDDFVKM	TTDDF-VKM
SWDSRDVVL	SWDSRDVVL
FYDPDTVELM	FYDPDTVEL
LYPEVPPEEF	LYPEVPEEF
FFDVTYRHF	FFDVTYRHF
KFDSQERMF	KFDSQERMF
IWDWKTTKL	IWDWKTTKL
NPDDVFREF	NPDDVFREF
VTEEFGVHL	VTEEFGVHL
VYDQQREVYV	VYDQQEVYV
MFDQQEIQV	MFDQQEIQV
HFDDIGPSV	HFDDIGPSV
YFDGDLSKV	YFDGDLSKV
VFDNVKDFF	VFDNVKDFF
MYEEFLSKV	MYEEFLSKV
DFDIPAEF	DFDIP-AEF
SYDDPATKM	SYDDPATKM
SWDIVVQRV	SWDIVVQRV
QYDEAISDYF	QYDEASDYF
LSDHHIYL	LSDHH-IYL
YFDLQTHVI	YFDLQTHVI
TPEEKSAVTAL	TPEEK-SAV
FFDHVTHRV	FFDHVTHRV
NFDTIDQQF	NFDTIDQQF
TFDSTIHF	TFDST-IHF
FLLDKKIGV	FLLDKKIGV
LFDANKAELF	LFDANKAEL
YYDDCAKI	YYDDC-AKI
KFPSPPAFI	KFPSPPAFI
KFDNIGMNAM	KFDNIMNAM
LFDAFHAGF	LFDAFHAGF
DFDSVSSIM	DFDSVSSIM
MPEKEPSVL	MPEKEPSVL
IWDLTTATL	IWDLTTATL
VFDQPQEYF	VFDQPQEYF
SFDETCTRF	SFDETCTRF
FIDEAGHCM	FIDEAGHCM
AYDLAKALL	AYDLAKALL
AMDLVKNHL	AMDLVKNHL
LWDEVLSHL	LWDEVLSHL
AYDVSSFSF	AYDVSSFSF
TWDPLGQYV	TWDPLGQYV
VFDLIQELF	VFDLIQELF
RMPEKVTWM	RMPEKVTWM
LFDVLHEPF	LFDVLHEPF
YYDLQGHLF	YYDLQGHLF
IFEPFGKI	IFEPF-GKI
SYDPVTNTW	SYDPVTNTW
YFDEPVELR	YFDEPVELR
VFDLMGSELF	VFDLMGSEL
FYETLPVAI	FYETLPVAI
FTDEESRVF	FTDEESRVF
IYDIILDM	IYDII-LDM
IFDVGTRL	IFDVG-TRL
KFDQVTVFL	KFDQVTVFL
SFDLAIKGV	SFDLAIKGV
NFDGKFANL	NFDGKFANL
AFDLIEHYF	AFDLIEHYF
VFDKFSNKV	VFDKFSNKV
DGSVRIWEL	DGSVRIWEL
FYDETYDYGGF	FYDET-YDY
IYDFTDTVI	IYDFTDTVI
FSDSESKL	FSDSE-SKL
NTDEPPMVF	NTDEPPMVF
KFDDIRIYF	KFDDIRIYF
IWPEKVLDIL	IWPEKVLDI
TYDDRAYSSF	TYDDRYSSF
FLDENVVSF	FLDENVVSF
SFDKLEAVV	SFDKLEAVV
LYDLVTEKM	LYDLVTEKM
SFDVTQSPF	SFDVTQSPF
KWPDRITLL	KWPDRITLL
VFDGKPPQL	VFDGKPPQL
SFDAHLTEL	SFDAHLTEL
NEELRNLSL	NEELRNLSL
IFDEVHYL	IFDEV-HYL
VYDDMAFRYL	VYDDMFRYL
RYDDMAACM	RYDDMAACM
TFDQYRGV	TFDQY-RGV
HYDRSGRSL	HYDRSGRSL
FYEVVDARL	FYEVVDARL
NFDNPVYL	NFDNP-VYL
VFDARELEL	VFDARELEL
TYDTYQHV	TYDTY-QHV
YFDEKGLV	YFDEK-GLV
VPDPNKPQKL	VPDPNPQKL
FYESLPPEM	FYESLPPEM
FYEERALYL	FYEERALYL
HWDSEVFI	HWDSE-VFI
HWDPVNGYFF	HWDPVNGYF
VLDDKDYFLF	VLDDKDYFL
KFDNKTVSF	KFDNKTVSF
HFDVVQLLV	HFDVVQLLV
VLDEQLNEF	VLDEQLNEF
SLDSPVLL	SLDSP-VLL
VYDLSIRGF	VYDLSIRGF
TMDIHLNEM	TMDIHLNEM
KWEWPNPVLL	EWPNP-VLL
YWDGEKETYV	YWDGEETYV
FFDKKYSNM	FFDKKYSNM
SWDRAPTFL	SWDRAPTFL
IFDVASIIL	IFDVASIIL
RYDGQIAVF	RYDGQIAVF
FFDQIDEL	FFDQI-DEL
KYDNMAELF	KYDNMAELF
SFDAAMKGL	SFDAAMKGL
AGDDRVLV	AGDDR-VLV
AFDVEIHM	AFDVE-IHM
KLDDTVYL	KLDDT-VYL
LYDVPANSM	LYDVPANSM
AKENAPAI	AKENA-PAI
KFDPMGKYF	KFDPMGKYF
YHDKNIVLL	YHDKNIVLL
VFDREIAQM	VFDREIAQM
ILPGFIDFI	ILPGFIDFI
GTDGHVHL	GTDGH-VHL
IFDIATEL	IFDIA-TEL
AYDTTTATV	AYDTTTATV
FFDIAHYL	FFDIA-HYL
IYDNQGNF	IYDNQ-GNF
FYEAAIPEM	FYEAAIPEM
FADKETLI	FADKE-TLI
KMDKTGASF	KMDKTGASF
YYDEKKMANF	YYDEKMANF
RFDEATQL	RFDEA-TQL
YVDGPASTAF	YVDGPSTAF
VVDNPIYL	VVDNP-IYL
YFEELITML	YFEELITML
YFDRAALF	YFDRA-ALF
FYDDVTTL	FYDDV-TTL
SFDTGFTSF	SFDTGFTSF
YVDFEGINF	YVDFEGINF
SFDTMQQEL	SFDTMQQEL
IFDEINLM	IFDEI-NLM
LYDELRNLL	LYDELRNLL
VWDYAGDNYV	VWDYADNYV
RFMDLATYI	RFMDLATYI
NFDQTLRNV	NFDQTLRNV
AFSLAEAKF	AFSLAEAKF
SYDLANRDF	SYDLANRDF
VFDVIAEI	VFDVI-AEI
VFDEWVSKL	VFDEWVSKL
TADGAHFEL	TADGAHFEL
FADKHIQV	FADKH-IQV
MFNDTLELF	MFNDTLELF
VIDEPVRL	VIDEP-VRL
FPEHIFPAL	FPEHIFPAL
SYDFTVRF	SYDFT-VRF
SFDEMLPGTHF	SFDEMGTHF
AWEERETIL	AWEERETIL
LWDPVIELI	LWDPVIELI
NFDMTSKFL	NFDMTSKFL
FPDKVAIQL	FPDKVAIQL
FYDKRAASF	FYDKRAASF
VYDGFSFI	VYDGF-SFI
YYDVVLSF	YYDVV-LSF
DQDLRTYL	DQDLR-TYL
GYDGPIYM	GYDGP-IYM
HFDQMFQRF	HFDQMFQRF
HPEPASGLAAL	HPEPA-SGL
AFDEAIAEL	AFDEAIAEL
SMETKVQFL	SMETKVQFL
HWDVTEAVFH	HWDVTEAVF
YFDKVVTL	YFDKV-VTL
YYDKHFTEF	YYDKHFTEF
LWDNAFSEM	LWDNAFSEM
LFHPSNVEM	LFHPSNVEM
IFDDPLNAF	IFDDPLNAF
VFDQPQEYFM	VFDQPQEYF
VYDQVVEDL	VYDQVVEDL
SYDPTIENTF	SYDPTENTF
FFDEVVKQM	FFDEVVKQM
YFEEYGKI	YFEEY-GKI
YYDYGHGEV	YYDYGHGEV
HPDPFANKSL	HPDPFNKSL
YYDNADKL	YYDNA-DKL
YFEQYGKI	YFEQY-GKI
HFEELETIM	HFEELETIM
LFPLWPAEM	LFPLWPAEM
VVDGNVARV	VVDGNVARV
VNDFRSVSL	VNDFRSVSL
TFDASRTTF	TFDASRTTF
YLGYLEQLLR	YLGYLEQLL
FTDNVPALV	FTDNVPALV
MWDPAAQAF	MWDPAAQAF
AYDLEANL	AYDLE-ANL
FSDDEVWV	FSDDE-VWV
VYDIAQVNL	VYDIAQVNL
LFDLSDNTGK	LFDLSDNTG
SYDDTVKL	SYDDT-VKL
RFDPTWESL	RFDPTWESL
NVDDPTGNF	NVDDPTGNF
FWPPYVELLL	FWPPYVELL
VFDKVKVKI	VFDKVKVKI
FVDFEGISL	FVDFEGISL
HFDDFVTNL	HFDDFVTNL
SWDKTVRL	SWDKT-VRL
FWDKKVTHF	FWDKKVTHF
YLDNGVVFV	YLDNGVVFV
HYWTWINHF	HYWTWINHF
HLDPGPIYM	HLDPGPIYM
HYDVQSILF	HYDVQSILF
IFDVHVHEV	IFDVHVHEV
EFDLLDVRF	EFDLLDVRF
VLPNDPVFL	VLPNDPVFL
KLDVVVRF	KLDVV-VRF
WFDATIGYL	WFDATIGYL
FTDSEIMV	FTDSE-IMV
RFDDPGLMLM	RFDDPGLML
YFDTVPVAA	YFDTVPVAA
VYDPLFSQL	VYDPLFSQL
VYDALNVLM	VYDALNVLM
FFDVHPPL	FFDVH-PPL
IFDEVHYI	IFDEV-HYI
LFDASPTFF	LFDASPTFF
SAPGYLPTSL	SAPGYPTSL
LWDLQDRVL	LWDLQDRVL
ILDVASLEV	ILDVASLEV
EFDAGIIEL	EFDAGIIEL
EFDIFTRLF	EFDIFTRLF
VLDPESVEL	VLDPESVEL
YLDLILNDF	YLDLILNDF
TFVSPEVFL	TFVSPEVFL
NFDPHYPIIL	NFDPHPIIL
IYDPNLAFL	IYDPNLAFL
FDAVFLDPF	FDAVFLDPF
VFDWIEANL	VFDWIEANL
VYDTNPAKF	VYDTNPAKF
ILDNPVVQL	ILDNPVVQL
SYDPLVIYL	SYDPLVIYL
VVDEAVLV	VVDEA-VLV
TFDSEVEL	TFDSE-VEL
ALDVMVSTF	ALDVMVSTF
VYDRTTVLI	VYDRTTVLI
KYDPNVYSI	KYDPNVYSI
RFDNFSSL	RFDNF-SSL
LFDANKAEL	LFDANKAEL
NFDTTEEKL	NFDTTEEKL
HPDAFDNEL	HPDAFDNEL
FYDSQGIHF	FYDSQGIHF
FFDLNDTKL	FFDLNDTKL
YTDNLVRV	YTDNL-VRV
ISDEANSNF	ISDEANSNF
SWDGRYALV	SWDGRYALV
AWDESGVF	AWDES-GVF
VWDVIGRSL	VWDVIGRSL
HVTQEDFEM	HVTQEDFEM
FFEDDVNEF	FFEDDVNEF
ITDFHPDTW	ITDFHPDTW
FLDLSSNQL	FLDLSSNQL
FAYDGKDYI	FAYDGKDYI
TWDRTPVSM	TWDRTPVSM
LYDPASGTISL	LYDPASGTI
IYDEAISSFF	IYDEAISSF
YLDEYIARM	YLDEYIARM
YYDPKHVIFS	YYDPKHVIF
SFDKSIRIF	SFDKSIRIF
VLDMHGFL	VLDMH-GFL
AYDPYLIAM	AYDPYLIAM
NFDDIKNGL	NFDDIKNGL
ANDGFVRL	ANDGF-VRL
ITDPSVIVM	ITDPSVIVM
VFDPALNLF	VFDPALNLF
FFDDLGDELL	FFDDLGDEL
FFDAAKLMF	FFDAAKLMF
KFDLAARTLL	KFDLAARTL
FLPDHPIVL	FLPDHPIVL
SWDEPGVDF	SWDEPGVDF
QFDVATHL	QFDVA-THL
YDEKVVKL	YDEKV-VKL
MLDLAKIIF	MLDLAKIIF
TFDYHQKL	TFDYH-QKL
VFDPVQKTL	VFDPVQKTL
HFDNLFSKM	HFDNLFSKM
IFDEAALEV	IFDEAALEV
FPEKSLLLL	FPEKSLLLL
IVDKFVIV	IVDKF-VIV
SWPTKIIYL	SWPTKIIYL
VYDVAMKL	VYDVA-MKL
TTDDRAYV	TTDDR-AYV
SFDLAKVLL	SFDLAKVLL
FVDDYTVRV	FVDDYTVRV
VFDETGHFV	VFDETGHFV
TADPSHQTM	TADPSHQTM
YPENGVVQM	YPENGVVQM
AFDIAEKEL	AFDIAEKEL
VYDDGKHVYL	VYDDGHVYL
FFDDLGDEL	FFDDLGDEL
EPEPAPNSV	EPEPAPNSV
SLDDGWIRF	SLDDGWIRF
ITDVQLAIF	ITDVQLAIF
KTDKSILV	KTDKS-ILV
IYDPACLTI	IYDPACLTI
IFDSKVTEI	IFDSKVTEI
HPDDSVKIL	HPDDSVKIL
FFDNIKNI	FFDNI-KNI
RIDEPILL	RIDEP-ILL
FYDLYGGEKF	FYDLYGEKF
NFDMSSLVV	NFDMSSLVV
FMDFQMQRM	FMDFQMQRM
SYDDVQQSF	SYDDVQQSF
RTDEQALL	RTDEQ-ALL
LYDPVISKL	LYDPVISKL
LWEYDPVKL	LWEYDPVKL
LFDAVSSL	LFDAV-SSL
SFDEIHQLF	SFDEIHQLF
NYDIAIAEL	NYDIAIAEL
MFDLTTRLIL	MFDLT-TRL
SDGLRLIAL	SDGLRLIAL
HFITPVSTL	HFITPVSTL
AVDAVIAEL	AVDAVIAEL
FADAHSNL	FADAH-SNL
AFDLDVVKL	AFDLDVVKL
YFMQVAHL	YFMQV-AHL
VTDPRVVDL	VTDPRVVDL
AWDIAIATM	AWDIAIATM
TYDDGATKL	TYDDGATKL
AYDEALAEL	AYDEALAEL
YYDVEPFLF	YYDVEPFLF
IFDPVKQQF	IFDPVKQQF
FSDVETHF	FSDVE-THF
VFDDMINL	VFDDM-INL
HWDGNMSLV	HWDGNMSLV
VYDDGKYVYV	VYDDGYVYV
HFDMHGFL	HFDMH-GFL
IFEPFGRI	IFEPF-GRI
FFDEGTINF	FFDEGTINF
LFDAISIAV	LFDAISIAV
KFDFPVSYL	KFDFPVSYL
RYDPYSKV	RYDPY-SKV
IFDIIDREA	IFDIIDREA
IYDPNLAF	IYDPN-LAF
SFDGIIAM	SFDGI-IAM
HFDASLSTY	HFDASLSTY
LYDVRTILL	LYDVRTILL
AFGLHLIDF	AFGLHLIDF
TRDPLVIEL	TRDPLVIEL
HFDASLSTYF	HFDASSTYF
IYDTKGRF	IYDTK-GRF
VTDAESKL	VTDAE-SKL
IFDGNVAHI	IFDGNVAHI
DGSIRIFSL	DGSIRIFSL
LFDLIQSEL	LFDLIQSEL
FLDSEVSEL	FLDSEVSEL
LWEPTPVKL	LWEPTPVKL
VFDEAIIAI	VFDEAIIAI
TFDILQDLEF	TFDIL-QDL
LFDEEMEQM	LFDEEMEQM
IFDEFRTVL	IFDEFRTVL
SQDARFYAL	SQDARFYAL
IWDVTILEY	IWDVTILEY
VIDAAVLL	VIDAA-VLL
YFDPQYFEF	YFDPQYFEF
TYDDIENKV	TYDDIENKV
FFDDVGAVTL	FFDDVAVTL
LFSDEEDSEDL	FSDEESEDL
SFDEFIKIF	SFDEFIKIF
IFPEPVAFL	IFPEPVAFL
FPDAREQEI	FPDAREQEI
AYDASLAML	AYDASLAML
IYDLATQTL	IYDLATQTL
FVDTEIRL	FVDTE-IRL
VFDLTKEIF	VFDLTKEIF
VYDIAKHL	VYDIA-KHL
HFDLNLRQF	HFDLNLRQF
MFDEPVLL	MFDEP-VLL
NFEAATESF	NFEAATESF
FFDVLPVHKF	FFDVLVHKF
SYIELPAYL	SYIELPAYL
VFDKTLAEL	VFDKTLAEL
LLDPLMPEL	LLDPLMPEL
YFDNVSSTEL	YFDNVSTEL
KFDDGAVFL	KFDDGAVFL
IFDLPRTNI	IFDLPRTNI
RYDGQVAVF	RYDGQVAVF
LFDANRAEL	LFDANRAEL
VMDLSIVRL	VMDLSIVRL
GFDAVTGEF	GFDAVTGEF
YYDLQEVLL	YYDLQEVLL
VFDVIIRCF	VFDVIIRCF
IIDDRVIL	IIDDR-VIL
VYDLLKTNL	VYDLLKTNL
FSDHMALL	FSDHM-ALL
HYDEQQNFF	HYDEQQNFF
SLDGIVRL	SLDGI-VRL
FPDEKIPTL	FPDEKIPTL
FFGTHETAF	FFGTHETAF
FFEPWVYSF	FFEPWVYSF
YLNQTSRSF	YLNQTSRSF
LFDDIDHNM	LFDDIDHNM
FFDGELTKV	FFDGELTKV
FTEDHYVEF	FTEDHYVEF
TMDLAGRKV	TMDLAGRKV
TFDPSLAYY	TFDPSLAYY
IYDDQGHIHL	IYDDQHIHL
SYNLFSREF	SYNLFSREF
YFDWGPGEM	YFDWGPGEM
AYDVADMV	AYDVA-DMV
IFDNTFSRF	IFDNTFSRF
SPEAQPKTL	SPEAQPKTL
FFDHAAHL	FFDHA-AHL
TFDMNGSL	TFDMN-GSL
LPEEEQQRVL	LPEEEQQRV
TFDEVLELM	TFDEVLELM
FYDNKGITYL	FYDNKITYL
YPEKIQASL	YPEKIQASL
ITDPDVVHI	ITDPDVVHI
YFPEFLDML	YFPEFLDML
VADGYPVRL	VADGYPVRL
TYDTSFLDFL	TYDTSFLDF
AFDRHMVLL	AFDRHMVLL
IADLGLIRV	IADLGLIRV
TFDPMTRQI	TFDPMTRQI
LYDPCTVM	LYDPC-TVM
RFDEGPVRL	RFDEGPVRL
IYDMSTVM	IYDMS-TVM
VFDDMINLL	VFDDMINLL
FFDSAMESYF	FFDSAESYF
VYDIVNNL	VYDIV-NNL
TYDYGGFTM	TYDYGGFTM
LYQYYLDHL	LYQYYLDHL
ITDTAYRSM	ITDTAYRSM
LFDAVIRL	LFDAV-IRL
SFDEGKTTM	SFDEGKTTM
VTDVGQILL	VTDVGQILL
NFDLDRGVF	NFDLDRGVF
VWDTKEVQM	VWDTKEVQM
NYDEMKDFL	NYDEMKDFL
SADFPALVV	SADFPALVV
IYDLIKTL	IYDLI-KTL
IVDGRVYYI	IVDGRVYYI
LWDSAVSHFF	LWDSAVSHF
TFDTTFSHF	TFDTTFSHF
LFDLSVLKL	LFDLSVLKL
MPDDLLTTL	MPDDLLTTL
VFDTAIAHLF	VFDTAIAHL
NFEDEPPLL	NFEDEPPLL
NFDNPLGM	NFDNP-LGM
HFDETVNRY	HFDETVNRY
FSDVEAHF	FSDVE-AHF
GFDERVTVM	GFDERVTVM
EFDNAGAMM	EFDNAGAMM
TWDKIAVSL	TWDKIAVSL
SLDEAVIM	SLDEA-VIM
HYDPATEEFI	HYDPATEEF
VYDNHVHV	VYDNH-VHV
SFDAVLEAL	SFDAVLEAL
FYDVQFKEL	FYDVQFKEL
VYDGKIYTL	VYDGKIYTL
LFDEYHKL	LFDEY-HKL
AFDVVERSFL	AFDVVERSF
TYDTAGLTM	TYDTAGLTM
SLPAGDALYL	SLPAGALYL
AFDLYEQRY	AFDLYEQRY
VVDAIPVFL	VVDAIPVFL
VFDTSQFF	VFDTS-QFF
LFDLVCHEF	LFDLVCHEF
FFDTELENL	FFDTELENL
FFDAQEVLL	FFDAQEVLL
YFEDVANAM	YFEDVANAM
VLDGKIVAL	VLDGKIVAL
AYEPLASFL	AYEPLASFL
VYDLGGGTF	VYDLGGGTF
IFDPLEIIL	IFDPLEIIL
SFDFHFGF	SFDFH-FGF
FYEPQKGSIYL	FYEPQKGSI
LYDLVTEKMF	LYDLVTEKM
SWEDAAILL	SWEDAAILL
YFDHALTL	YFDHA-LTL
LYDIVFKHF	LYDIVFKHF
VADLVGFLL	VADLVGFLL
LYDQAEKL	LYDQA-EKL
VFDTAPTGHTL	VFDTAGHTL
HFDASHVAL	HFDASHVAL
RTDPIPIVV	RTDPIPIVV
YFDSGDYNM	YFDSGDYNM
FLDEYIFL	FLDEY-IFL
YYDGMIQL	YYDGM-IQL
VVDEEVFF	VVDEE-VFF
RYDLGGLVM	RYDLGGLVM
YFDPANGKF	YFDPANGKF
NSDDRVLL	NSDDR-VLL
KYDPSYIEF	KYDPSYIEF
TWDELGEAL	TWDELGEAL
IYDTAKGM	IYDTA-KGM
KFDHADRTF	KFDHADRTF
YIDDLVVIL	YIDDLVVIL
HLPEGALNSL	LPEGALNSL
TFDSQTKENM	TFDSQKENM
EYEKLPAYL	EYEKLPAYL
TYDLIANIV	TYDLIANIV
VLPEHVSVL	VLPEHVSVL
YLDELVEL	YLDEL-VEL
VFDLNDESKW	VFDLNESKW
ATDEFASYF	ATDEFASYF
VFMTHLEF	VFMTH-LEF
IFDRVLTEL	IFDRVLTEL
IFDANESGF	IFDANESGF
IYDVYRYL	IYDVY-RYL
FVDTNLYFL	FVDTNLYFL
LFDDKAVEI	LFDDKAVEI
KSDPSIVRL	KSDPSIVRL
NWDIAHMI	NWDIA-HMI
VYDVTKMTSF	VYDVTMTSF
TYDEIGVMF	TYDEIGVMF
HFDTIFEVF	HFDTIFEVF
FFDLWEEHI	FFDLWEEHI
SYDVRIENF	SYDVRIENF
VWDYVEKI	VWDYV-EKI
FYDFFRYVEM	FYDFFYVEM
HPESVSQSL	HPESVSQSL
FPDREENAV	FPDREENAV
AYDDLGNSGHF	AYDDLSGHF
FFDEMADPDL	FFDEMDPDL
FDETVTHF	FDETV-THF
KFDEVVSL	KFDEV-VSL
FFDALDHVI	FFDALDHVI
ITDQYIYM	ITDQY-IYM
IYDIPEMF	IYDIP-EMF
HFDLASSIFVA	HFDLASSIF
RFDPLGHYL	RFDPLGHYL
LYDVVSVL	LYDVV-SVL
KFDALITTF	KFDALITTF
TMDLAEHHM	TMDLAEHHM
VMDVAFVQF	VMDVAFVQF
VYDVTPPEL	VYDVTPPEL
SFDGIIAMM	SFDGIIAMM
EFDPVMVIL	EFDPVMVIL
IYDKYGSL	IYDKY-GSL
IFDIPGRL	IFDIP-GRL
FFDIFGRL	FFDIF-GRL
AFDLSQVLF	AFDLSQVLF
VWDETSNKV	VWDETSNKV
VVFVLCWMP	VVFVLCWMP
FYDQRQVLL	FYDQRQVLL
RFDPLGHYLL	RFDPLGHYL
MVDGKPVNL	MVDGKPVNL
DFDEVRQEI	DFDEVRQEI
VADDTPVLL	VADDTPVLL
SFDGTIKV	SFDGT-IKV
MPEQIVIHAL	MPEQIIHAL
TFDLAAPTV	TFDLAAPTV
AFDRKVQFL	AFDRKVQFL
QFDTDAVRL	QFDTDAVRL
KFDTEIQAF	KFDTEIQAF
INDERVFV	INDER-VFV
IYDHNPKVF	IYDHNPKVF
YFDALYNIM	YFDALYNIM
MPETYQARL	MPETYQARL
EAEKSQLIM	EAEKSQLIM
HWDDKAKSLL	HWDDKAKSL
AFDSTSRF	AFDST-SRF
FTEKEWPLL	FTEKEWPLL
FNDTFVHV	FNDTF-VHV
NYDVSHTF	NYDVS-HTF
VMDVQYNKF	VMDVQYNKF
FPEEVIATIF	FPEEVIATI
KYDTALNLL	KYDTALNLL
QWDLVENYL	QWDLVENYL
FFDGAKDV	FFDGA-KDV
DQTIRIHGL	DQTIRIHGL
FWDDSIVEF	FWDDSIVEF
DFDHHGRV	DFDHH-GRV
SFDYSNTVM	SFDYSNTVM
HFDLLHEDV	HFDLLHEDV
FADLNLAEF	FADLNLAEF
TFDAQIVII	TFDAQIVII
KFDYVMQFL	KFDYVMQFL
AYDPQTNEW	AYDPQTNEW
FWDGKIVL	FWDGK-IVL
FLDEPTNHL	FLDEPTNHL
HYDETYREV	HYDETYREV
ILDSQTVVL	ILDSQTVVL
LWDISEVMV	LWDISEVMV
TFDAGAGIAL	TFDAGGIAL
NVEIDPEIQ	NVEIDPEIQ
DYDPLVVKL	DYDPLVVKL
SAPYGRITL	SAPYGRITL
FYPEEVSSM	FYPEEVSSM
FLDFAPHYF	FLDFAPHYF
YYDLYGGEKF	YYDLYGEKF
FWDDAVKEV	FWDDAVKEV
TFDVAPSRL	TFDVAPSRL
SVDLTEVEV	SVDLTEVEV
REDLVGPEV	REDLVGPEV
VFDPVPVGV	VFDPVPVGV
AKDFEKAYKTV	DFEKAYKTV
FFEEHISSV	FFEEHISSV
YYDPDYSFL	YYDPDYSFL
VFDYSINSV	VFDYSINSV
LFDAFVSVL	LFDAFVSVL
VLDALDSIK	VLDALDSIK
RFEDSPSYV	RFEDSPSYV
IFDEMKKKF	IFDEMKKKF
KYDATMIEI	KYDATMIEI
YVDDGLISL	YVDDGLISL
FWDPSPQL	FWDPS-PQL
AFSWSSAF	AFSWS-SAF
HPDYGSHIQAL	HPDYG-SHI
YFGEIALL	YFGEI-ALL
FFDIPVDNL	FFDIPVDNL
HFDLSVIEL	HFDLSVIEL
HPEPQSQHEL	HPEPQQHEL
KFDVSPVKI	KFDVSPVKI
VFDLPESL	VFDLP-ESL
TLEMNLNSF	TLEMNLNSF
LSDTVQHL	LSDTV-QHL
FFEDEKPALL	FFEDEPALL
ATDGRVYV	ATDGR-VYV
FVDMDLNL	FVDMD-LNL
NFDPPIEEF	NFDPPIEEF
FGDFGHGILM	FGDFGHGIL
LFDLTNEQSF	LFDLTEQSF
YYELAQVLL	YYELAQVLL
VLDVSNSF	VLDVS-NSF
FFDEESYSL	FFDEESYSL
VLDVHAEL	VLDVH-AEL
TYDVTDSRI	TYDVTDSRI
TFDPQRQTV	TFDPQRQTV
FFDEKLNSL	FFDEKLNSL
AYDVSSFSFF	AYDVSSFSF
VSDPVTVHF	VSDPVTVHF
TYDIGHVLL	TYDIGHVLL
PAPPPPPPP	PAPPPPPPP
AFDVVERSF	AFDVVERSF
RFDESTTGF	RFDESTTGF
VFDAFLNMM	VFDAFLNMM
YYDDYRVQL	YYDDYRVQL
ITDLYTDL	ITDLY-TDL
AYDIYSRL	AYDIY-SRL
WYDPNASLL	WYDPNASLL
ILDPHVVLL	ILDPHVVLL
NFDAHHTAM	NFDAHHTAM
DAALRKITF	DAALRKITF
FFDSQGQVLL	FFDSQQVLL
FLDEYMNEF	FLDEYMNEF
FFDEMADPDLL	FFDEMDPDL
HYDPMIAKL	HYDPMIAKL
TFEDVAIDF	TFEDVAIDF
KYDEVLHMV	KYDEVLHMV
YIPEITSVL	YIPEITSVL
TFQPYLDTL	TFQPYLDTL
RFEDGAVFL	RFEDGAVFL
TFDKSSTTV	TFDKSSTTV
NYDPALHPF	NYDPALHPF
FDPALLEF	FDPAL-LEF
IFDSVSVQV	IFDSVSVQV
NFDERPISV	NFDERPISV
TFDPFLYL	TFDPF-LYL
TMDVARHV	TMDVA-RHV
IFDNTTSL	IFDNT-TSL
YYDPQEEVYL	YYDPQEVYL
YYDVAKIL	YYDVA-KIL
KYDGHQQF	KYDGH-QQF
LDTDFIVL	LDTDF-IVL
EFDPIPVLI	EFDPIPVLI
VWDTAGQEKF	VWDTAQEKF
PEKETIPDID	IPDID----
AYDVPNPVFL	AYDVPPVFL
IFDLTSHL	IFDLT-SHL
IADPNIAKL	IADPNIAKL
AFESEPLFL	AFESEPLFL
NLDLTERQV	NLDLTERQV
SWDKILALV	SWDKILALV
FFYTHLINF	FFYTHLINF
HWDVTEAVF	HWDVTEAVF
FFDEANKQVF	FFDEANKQV
HFEESSKL	HFEES-SKL
TWDYVAPFL	TWDYVAPFL
AVDPLLALL	AVDPLLALL
HMDTFIETF	HMDTFIETF
YDLSIRGF	YDLSI-RGF
SFDVADRMF	SFDVADRMF
RYDLYHTF	RYDLY-HTF
VFDGSGTDM	VFDGSGTDM
VFDFGRRPVLL	VFDFGPVLL
YYDVAKQLL	YYDVAKQLL
NFYPFLQRF	NFYPFLQRF
EFDSMMNTV	EFDSMMNTV
GFDDTVKF	GFDDT-VKF
SFDYAASIL	SFDYAASIL
FFDSVQVVF	FFDSVQVVF
VLPERYSSL	VLPERYSSL
YWEPAEVFL	YWEPAEVFL
SYDLFVNSF	SYDLFVNSF
IYDLLDTAM	IYDLLDTAM
SYDHVIYSL	SYDHVIYSL
VFDFMETDL	VFDFMETDL
FYDTKVTVM	FYDTKVTVM
AFDPVLNRW	AFDPVLNRW
LFEVSEVI	LFEVS-EVI
FDHSTRIV	FDHST-RIV
IVDSYLPVIL	IVDSYPVIL
AFDVAEKYL	AFDVAEKYL
YFDPKQTDV	YFDPKQTDV
NADAIVVKL	NADAIVVKL
LYDHTTILF	LYDHTTILF
RYDEFLVHM	RYDEFLVHM
IFPNQTEEL	IFPNQTEEL
VFEHDSVEL	VFEHDSVEL
STDSRPVSV	STDSRPVSV
FTDEESRVFL	FTDEESRVF
IYDIMNELM	IYDIMNELM
FFDAHEGF	FFDAH-EGF
TYDEAIHSV	TYDEAIHSV
AFDRHCNM	AFDRH-CNM
IYELAVASF	IYELAVASF
QYDDSGNTFF	QYDDSGNTF
NYDEALRL	NYDEA-LRL
IYDFIGEFM	IYDFIGEFM
YYEEQHPEL	YYEEQHPEL
FSDGAVSL	FSDGA-VSL
TYDLMSSAY	TYDLMSSAY
VYDPSLKTLL	VYDPSLKTL
LWPEKTSFL	LWPEKTSFL
YYDQTGALV	YYDQTGALV
FFVENVSEL	FFVENVSEL
NTDKFVLM	NTDKF-VLM
FYEETKVKF	FYEETKVKF
TFDEFQEL	TFDEF-QEL
SVPVSLQTL	SVPVSLQTL
YMDTSHLF	YMDTS-HLF
RFDVSLVYL	RFDVSLVYL
QFDFVVRMM	QFDFVVRMM
FYDEVSRL	FYDEV-SRL
IFDSSDLSF	IFDSSDLSF
ITDSKVKL	ITDSK-VKL
NFDTGSHV	NFDTG-SHV
IWDINAML	IWDIN-AML
TFDLLFVTL	TFDLLFVTL
MPEEESAKVCL	MPEEESAKV
FYDEIKIEL	FYDEIKIEL
SAPVGVTAL	SAPVGVTAL
FYDGHENM	FYDGH-ENM
FYPPKVELF	FYPPKVELF
IFDRYGEEGL	IFDRYEEGL
DWDLMERFM	DWDLMERFM
VTDSKVLL	VTDSK-VLL
IFDGLLEYL	IFDGLLEYL
VFDRHKML	VFDRH-KML
VFDIVIHRF	VFDIVIHRF
NPDEVHAIL	NPDEVHAIL
IYDVSHNI	IYDVS-HNI
EDDDDNDIM	EDDDDNDIM
NFDSAMKV	NFDSA-MKV
IFDNKEIKL	IFDNKEIKL
TFDETVSTYV	TFDETVSTY
DFDEVQYQM	DFDEVQYQM
SYDAPAGNSF	SYDAPGNSF
AYDTLPVLI	AYDTLPVLI
LTDPAIVKV	LTDPAIVKV
HLDEAIHV	HLDEA-IHV
FFDMAYQGF	FFDMAYQGF
VFDMVVAHI	VFDMVVAHI
SWENIPVTF	SWENIPVTF
LYDEIKKYV	LYDEIKKYV
YFDESFFHF	YFDESFFHF
TFDRSVTLL	TFDRSVTLL
HFDHAVRM	HFDHA-VRM
FFDPSLLHL	FFDPSLLHL
FYDGIKAIF	FYDGIKAIF
KWDSNICEL	KWDSNICEL
SVPEAQSAL	SVPEAQSAL
VFDPKVFTF	VFDPKVFTF
TFSEEHPVLL	FSEEHPVLL
SYDPLRIYL	SYDPLRIYL
TFDSDPPLL	TFDSDPPLL
TVDFLSLDL	TVDFLSLDL
VFDLGGGTF	VFDLGGGTF
AYDQHLNM	AYDQH-LNM
VFDPVTKL	VFDPV-TKL
VWPLQIILL	VWPLQIILL
LFDHVVNRV	LFDHVVNRV
VFDNYAVTV	VFDNYAVTV
TYDLIKDAL	TYDLIKDAL
TYDAHHSAF	TYDAHHSAF
FFDHASAAL	FFDHASAAL
KFDPFLDL	KFDPF-LDL
LYDVTWEEM	LYDVTWEEM
HFDGLIFV	HFDGL-IFV
NYDETLSTL	NYDETLSTL
GPPPPPGKPQ	GPPPPPGKP
TLDELPAML	TLDELPAML
IYDPFAGM	IYDPF-AGM
LFDKTPVLL	LFDKTPVLL
LMDREVALL	LMDREVALL
VFDPVQKTLL	VFDPVQKTL
AYDIGNHFNEF	AYDIG-NHF
KFDIYTIAF	KFDIYTIAF
VWELLPTTL	VWELLPTTL
AFEDVAVYF	AFEDVAVYF
KFDAEFRRF	KFDAEFRRF
SYDPQMRAI	SYDPQMRAI
NYDHSLVKV	NYDHSLVKV
FYDGYRHEM	FYDGYRHEM
RYDNTESEF	RYDNTESEF
TWDERFSAL	TWDERFSAL
DFDGQVVQV	DFDGQVVQV
NAEPEPRSL	NAEPEPRSL
NFDRFSEMM	NFDRFSEMM
LWDSAVSHF	LWDSAVSHF
FFDLPQQL	FFDLP-QQL
EWEATSIYL	EWEATSIYL
SFDLHQQL	SFDLH-QQL
VFDESLNF	VFDES-LNF
KFDAELLEI	KFDAELLEI
VFDETGHF	VFDET-GHF
VSPYTEIHL	VSPYTEIHL
HLPETKFSEL	LPETKFSEL
QFHMQLNEM	QFHMQLNEM
IFDLQSNTVL	IFDLQSNTV
MPEPASRCL	MPEPASRCL
RFDEARARF	RFDEARARF
VFDNKVLTI	VFDNKVLTI
YTDLEVRV	YTDLE-VRV
YFDVGLHNF	YFDVGLHNF
TFDISILEI	TFDISILEI
YYDPHQATF	YYDPHQATF
FIDKPVCF	FIDKP-VCF
HYEGAVVIL	HYEGAVVIL
IEGELPAAVGL	ELPAA-VGL
LFDLTPAKV	LFDLTPAKV
IFDPNILTI	IFDPNILTI
EWDPLDVRF	EWDPLDVRF
FPEEEAPSTVL	FPEEEPSTV
ILDRMHCIL	ILDRMHCIL
IYEEFLAAF	IYEEFLAAF
LEAERFENL	LEAERFENL
EWDVLIAHF	EWDVLIAHF
YSTDVSVDEVK	STDVSVDEV
AYDKAVASF	AYDKAVASF
AFEQLVVEL	AFEQLVVEL
HFDLASSIFV	HFDLASSIF
FIDEEVLM	FIDEE-VLM
SFDFRTSEI	SFDFRTSEI
YYDPNPQSTV	YYDPNQSTV
HFDFFSVNF	HFDFFSVNF
SFDETVTHF	SFDETVTHF
NFDYLRKEM	NFDYLRKEM
AYDSTMETM	AYDSTMETM
IWDDPDAGF	IWDDPDAGF
FFDAGAAEFL	FFDAGAAEF
NFDEFSKHL	NFDEFSKHL
LFDTAISL	LFDTA-ISL
SWDEAVQAL	SWDEAVQAL
VTDEFLSDFL	VTDEFLSDF
VFDLAQAL	VFDLA-QAL
WFDPAIFTI	WFDPAIFTI
FFDPNTHENL	FFDPNHENL
DSAFRGVGL	DSAFRGVGL
VFEYHNVL	VFEYH-NVL
YYDGKVMKL	YYDGKVMKL
LYDELRNLLL	LYDELRNLL
RYDLSPITV	RYDLSPITV
NVKVDPEIQN	KVDPE-IQN
FFEVSPVSF	FFEVSPVSF
FDHAVSKF	FDHAV-SKF
YYDEKVVKL	YYDEKVVKL
VFPKEPVEL	VFPKEPVEL
EGFSLFVKI	EGFSLFVKI
MYEQQVVKL	MYEQQVVKL
HFDLHEEML	HFDLHEEML
ALDANIARL	ALDANIARL
FSDGDAKL	FSDGD-AKL
NFDGSHVYM	NFDGSHVYM
IFDLSSEFIL	IFDLS-SEF
GSFDVADRMF	SFDVADRMF
RFDPVRVDI	RFDPVRVDI
KDDIATIET	KDDIATIET
YFPDKVALL	YFPDKVALL
TFDFVHNVM	TFDFVHNVM
MWDTRIAKL	MWDTRIAKL
ANDNEIKV	ANDNE-IKV
TFDLMQILL	TFDLMQILL
HFDDIGPSVVM	HFDDIPSVV
LVDLEPGTM	LVDLEPGTM
IYDKFIAQL	IYDKFIAQL
KADGVPVYL	KADGVPVYL
YWIDEPDVLVM	WIDEPDVLV
SFDPNLSEL	SFDPNLSEL
ILDNSPAFL	ILDNSPAFL
SFDWTVKL	SFDWT-VKL
VFDRMKVAL	VFDRMKVAL
MQDKTQHL	MQDKT-QHL
YTDFHIDF	YTDFH-IDF
FLDSTSPLL	FLDSTSPLL
FYDDTYNTL	FYDDTYNTL
EFDNAGGMM	EFDNAGGMM
HYDIPKISM	HYDIPKISM
YLDSPLVRF	YLDSPLVRF
IYDHAVLF	IYDHA-VLF
KYDLAIKDL	KYDLAIKDL
NAFKEITTM	NAFKEITTM
KYDQLKVYL	KYDQLKVYL
IYDEDEVL	IYDED-EVL
FYDTFHTV	FYDTF-HTV
AMPGVPAFL	AMPGVPAFL
FFVPHGYL	FFVPH-GYL
NFDTKDPLIL	NFDTKPLIL
IFDVLPNFF	IFDVLPNFF
AYDNFGVL	AYDNF-GVL
HYDMNTASL	HYDMNTASL
IIDKEVSL	IIDKE-VSL
KFDETEQAL	KFDETEQAL
VLDQVEARL	VLDQVEARL
KTDAAVEM	KTDAA-VEM
IADLVVAVF	IADLVVAVF
TPESGKQTL	TPESGKQTL
VFDRHVVL	VFDRH-VVL
YFDVEPFVF	YFDVEPFVF
LLDQLHTLL	LLDQLHTLL
VYDTVFKHF	VYDTVFKHF
YNDTQIKL	YNDTQ-IKL
NSDDEVRF	NSDDE-VRF
VSDHEATL	VSDHE-ATL
TPEEGAQAL	TPEEGAQAL
YYDIYLKV	YYDIY-LKV
LYDGTYITL	LYDGTYITL
IFDNFSNL	IFDNF-SNL
SWDKVVKM	SWDKV-VKM
FFDRNLFF	FFDRN-LFF
VFEPTIVKV	VFEPTIVKV
NYDFGPIHM	NYDFGPIHM
VYDVTRFL	VYDVT-RFL
TFDIGYGSF	TFDIGYGSF
IIDQVNPEL	IIDQVNPEL
FYEDNVLYM	FYEDNVLYM
HFDPEVVQI	HFDPEVVQI
IYDEGNFSF	IYDEGNFSF
RFDDGIKL	RFDDG-IKL
AYDYNKAQV	AYDYNKAQV
SFDTIPTYL	SFDTIPTYL
LFDGAEVVL	LFDGAEVVL
VFPNNVVFV	VFPNNVVFV
RVYEFLDKL	RVYEFLDKL
KSDERPVHI	KSDERPVHI
TFDLQMKFV	TFDLQMKFV
KFDGNKQHFF	KFDGNKQHF
LFDTLVNFF	LFDTLVNFF
SFDYQKTGM	SFDYQKTGM
LFDEAIKL	LFDEA-IKL
LVVSTQTALA	VVSTQ-TAL
VFDTSLQV	VFDTS-LQV
LFDSVIHL	LFDSV-IHL
VWDLAQQVVL	VWDLAQVVL
IYDITNVL	IYDIT-NVL
LTRSPFEII	LTRSPFEII
NYDVLANEI	NYDVLANEI
VYDYAGKNKV	VYDYAKNKV
IWDMGLELF	IWDMGLELF
YFDLPGAL	YFDLP-GAL
IFDMHSPYF	IFDMHSPYF
FFIPDIEYL	FFIPDIEYL
TFDDLPARF	TFDDLPARF
HFDSVMQL	HFDSV-MQL
IYDLFQKSF	IYDLFQKSF
LFDYTDTFL	LFDYTDTFL
LLDPDTAVL	LLDPDTAVL
RFDVAWFL	RFDVA-WFL
VFDTSIAQLF	VFDTSIAQL
HFDLHEEM	HFDLH-EEM
NYDEFPTMV	NYDEFPTMV
FYDLHETL	FYDLH-ETL
LPDKTLIDL	LPDKTLIDL
KYDEGLYRF	KYDEGLYRF
YFENLLSHF	YFENLLSHF
FYETLPAEM	FYETLPAEM
VLDLAETMV	VLDLAETMV
VFDAKSTIV	VFDAKSTIV
MPEPDAQRFF	EPDAQ-RFF
NTDEMVEL	NTDEM-VEL
FFDSAYQGF	FFDSAYQGF
YFDPTIVSV	YFDPTIVSV
VLDAEVLL	VLDAE-VLL
NYDASAARV	NYDASAARV
VNDGVVRL	VNDGV-VRL
NYDACLQHL	NYDACLQHL
RYPDRITLI	RYPDRITLI
HPESTPKSL	HPESTPKSL
VFDIGVRVV	VFDIGVRVV
LQGERIVSL	LQGERIVSL
IMDVSLRSF	IMDVSLRSF
EVDLPISYL	EVDLPISYL
VFENCGHL	VFENC-GHL
AFDEIVAL	AFDEI-VAL
HFHPSVALF	HFHPSVALF
LLDLALEGM	LLDLALEGM
RWEDKESKI	RWEDKESKI
SPDEHEPLL	SPDEHEPLL
SFDDIIVF	SFDDI-IVF
AFDKHMNL	AFDKH-MNL
VFDLQWLEL	VFDLQWLEL
SFDITGRFL	SFDITGRFL
YLDRIGQLF	YLDRIGQLF
IFDSPYHL	IFDSP-YHL
VFDDLESKM	VFDDLESKM
AYDDKIYYF	AYDDKIYYF
VFDASSIQY	VFDASSIQY
RFDSNNVVLI	RFDSNNVVL
VFDESTRKI	VFDESTRKI
QYDEAVAQF	QYDEAVAQF
TFDQKIVEW	TFDQKIVEW
TFDVAPSRLDF	TFDVAPSRL
LYQIYIDEL	LYQIYIDEL
TFDPIAKM	TFDPI-AKM
AFDGRPSVAM	AFDGRSVAM
VFDTSIAQL	VFDTSIAQL
MYDEQVTSL	MYDEQVTSL
FFDATDRVSF	FFDATRVSF
LYDLAKEL	LYDLA-KEL
IADLMEEKF	IADLMEEKF
LFDHAVSKF	LFDHAVSKF
LYDLGISKV	LYDLGISKV
FFDPAIRVL	FFDPAIRVL
YFDSRGMFI	YFDSRGMFI
IFDLGGGTF	IFDLGGGTF
LFDITGQDF	LFDITGQDF
TFEDVAVHF	TFEDVAVHF
LFDDVGTF	LFDDV-GTF
IIHEIAVLEL	IHEIAVLEL
YYDQTAQM	YYDQT-AQM
ITDPRTVFV	ITDPRTVFV
VYDNIGIL	VYDNI-GIL
WYDPKVTRV	WYDPKVTRV
MLDPLEVHL	MLDPLEVHL
SLPNEIAYL	SLPNEIAYL
IVDEGALL	IVDEG-ALL
SYDYSGRYL	SYDYSGRYL
STDVAKTF	STDVA-KTF
VFDEAIRAV	VFDEAIRAV
VMDSKIVQV	VMDSKIVQV
RYDEIKEEF	RYDEIKEEF
FTEAESNMNDL	FTEAE-SNM
IFSPNVVNL	IFSPNVVNL
MPDHTDVSL	MPDHTDVSL
IYDFIGEF	IYDFI-GEF
IFDSIIVTL	IFDSIIVTL
FLDWPQGTF	FLDWPQGTF
FYDENDSKL	FYDENDSKL
SFDITGRF	SFDIT-GRF
ATEEPGESF	ATEEPGESF
TYDLPGNFL	TYDLPGNFL
VFDTAIAHL	VFDTAIAHL
AFDIAEEL	AFDIA-EEL
FFDSIEKGF	FFDSIEKGF
LWDTSPSYI	LWDTSPSYI
LFDVSIMAV	LFDVSIMAV
VYDEGPLYV	VYDEGPLYV
YYEEFPINL	YYEEFPINL
LFDRVVTL	LFDRV-VTL
YFYDRRRIYL	FYDRRRIYL
VFDLTDLDVL	VFDLTLDVL
KIVKWDRDM	KIVKWDRDM
LFDEVAIYF	LFDEVAIYF
HPDQAQAIL	HPDQAQAIL
MLPSEPVLL	MLPSEPVLL
IADGLPVAV	IADGLPVAV
AFDASRTSF	AFDASRTSF
VYDPSPVSPFI	VYDPSVSPF
EFDNAGGM	EFDNA-GGM
KYDSTAIYL	KYDSTAIYL
HFDPEVYL	HFDPE-VYL
LFELNTPEF	LFELNTPEF
TPDEIDHVF	TPDEIDHVF
AFEDVAVNF	AFEDVAVNF
KFDSEYERM	KFDSEYERM
FFDNRPGKL	FFDNRPGKL
FFDTLPSSEF	FFDTLSSEF
ILDEAVEL	ILDEA-VEL
MFDVTNATTF	MFDVTATTF
SEDFRENIF	SEDFRENIF
MPDGKIQKL	MPDGKIQKL
FADFERHFL	FADFERHFL
RFPDLTVEL	RFPDLTVEL
LFDSTLTAF	LFDSTLTAF
HFDTPPHLF	HFDTPPHLF
MVDSKPVNL	MVDSKPVNL
LFDAHQDL	LFDAH-QDL
AKDIGFIKLD	AKDIGFIKL
IPDGHTKEM	IPDGHTKEM
SFDDKILEV	SFDDKILEV
TLDVQTQQM	TLDVQTQQM
IADKVVFL	IADKV-VFL
SFEEKPVYI	SFEEKPVYI
YWPTYTPMEV	YWPTYPMEV
IYDVNKNEW	IYDVNKNEW
IYDKTSVLF	IYDKTSVLF
VTDEPVYI	VTDEP-VYI
FPEADKVRTM	EADKV-RTM
WEEKLLMF	WEEKL-LMF
LFDNLIEFL	LFDNLIEFL
NYDMHNPF	NYDMH-NPF
MFDKDVVML	MFDKDVVML
WFDKSFTFV	WFDKSFTFV
VFDLGPFI	VFDLG-PFI
TYDQSQSPM	TYDQSQSPM
LFDISGRAPL	LFDISRAPL
TMDDVVKV	TMDDV-VKV
LNDPNPIWL	LNDPNPIWL
LFDLGGQYL	LFDLGGQYL
KFDVQWIFV	KFDVQWIFV
NAPLVHATL	NAPLVHATL
IFDRAVAAY	IFDRAVAAY
VFDPIGHFT	VFDPIGHFT
VPDSSGPERIL	VPDSSPERI
GFDDVVRL	GFDDV-VRL
NFDNILNSF	NFDNILNSF
LFDPMTGTF	LFDPMTGTF
YYDLVRTEI	YYDLVRTEI
FFDVLIKSM	FFDVLIKSM
KFDNKTVTF	KFDNKTVTF
KIEDYFPEF	KIEDYFPEF
KTDVTVVRF	KTDVTVVRF
LLPEEQVYL	LLPEEQVYL
VYDIADHPDF	VYDIAHPDF
YYDNPHMV	YYDNP-HMV
LYDKDAVYV	LYDKDAVYV
VFDLAQTL	VFDLA-QTL
VFDEAHNI	VFDEA-HNI
SFDYSNTV	SFDYS-NTV
LYDLLVNEI	LYDLLVNEI
DNTIKLTSL	DNTIKLTSL
LLPTGLSSL	LLPTGLSSL
DFRDGLKL	DFRDG-LKL
SFDHVPALV	SFDHVPALV
MWDETELGL	MWDETELGL
LSDDHVLI	LSDDH-VLI
TFDPVDNIVF	TFDPVDNIV
SYDWFPAEL	SYDWFPAEL
LPDERTISL	LPDERTISL
NYEGHTPL	NYEGH-TPL
SFDKTASVF	SFDKTASVF
VMDVVVKSV	VMDVVVKSV
FFEEVFTEM	FFEEVFTEM
RFDYVPSFL	RFDYVPSFL
SYDEAILRL	SYDEAILRL
RTDPVPVTI	RTDPVPVTI
LFDSLSQML	LFDSLSQML
HFDMNIISML	HFDMNIISM
FYEENGFL	FYEEN-GFL
NLDVHTSVM	NLDVHTSVM
TWDVAGEVTGV	TWDVA-GEV
NFDALISKI	NFDALISKI
VWDVNTGEML	VWDVNTGEM
MYDKDIIML	MYDKDIIML
RWDEAFRKF	RWDEAFRKF
ALDKATVLL	ALDKATVLL
NYDEMKDFI	NYDEMKDFI
AWDLGTNFF	AWDLGTNFF
MFDDIGRNFL	MFDDIGRNF
VWTELLDVL	VWTELLDVL
VWDLHNQTL	VWDLHNQTL
FYDIVAEL	FYDIV-AEL
VFSEMEANF	VFSEMEANF
MPEQNPTHAL	MPEQNTHAL
NFDFTRSYL	NFDFTRSYL
VYDITNVNSF	VYDITVNSF
IFDAVLKGV	IFDAVLKGV
LFDSTLTAFL	LFDSTLTAF
KTDSQTLL	KTDSQ-TLL
HLDLIEAKF	HLDLIEAKF
VWDPEGEF	VWDPE-GEF
TNTLRILAL	TNTLRILAL
FVDNHVEL	FVDNH-VEL
FFPAFITLL	FFPAFITLL
TYDPWIGKL	TYDPWIGKL
IFDPTRECM	IFDPTRECM
VFEPSWEEF	VFEPSWEEF
AFDPAAAAF	AFDPAAAAF
VFDEAVRV	VFDEA-VRV
HFDADGNYF	HFDADGNYF
SLDERIYV	SLDER-IYV
AFDFQDVTL	AFDFQDVTL
FWEQKPLLI	FWEQKPLLI
AADSAVRL	AADSA-VRL
ITDEQIQEM	ITDEQIQEM
AFDVVERSFLE	AFDVVERSF
YYDEKVVKLL	YYDEKVVKL
SFDSTVRL	SFDST-VRL
YYDVAKILI	YYDVAKILI
IYDVQHANL	IYDVQHANL
IWEEWPLLI	IWEEWPLLI
NQDARILAM	NQDARILAM
FFDNLVYYI	FFDNLVYYI
DFDLLNNSL	DFDLLNNSL
IYDPQEGAVVV	IYDPQEGAV
FTDEMAHF	FTDEM-AHF
HFDTPVQFL	HFDTPVQFL
KYEDGIALL	KYEDGIALL
YMDLASRLV	YMDLASRLV
AFDMFNFL	AFDMF-NFL
TWDEYNIQM	TWDEYNIQM
MFDELRTWL	MFDELRTWL
IYDNAVQGL	IYDNAVQGL
FWDKLQAEL	FWDKLQAEL
HFDIVIRNL	HFDIVIRNL
MPEEGKIL	MPEEG-KIL
AFDSTLTHL	AFDSTLTHL
VYQEMPAQL	VYQEMPAQL
SFDVVTKCV	SFDVVTKCV
SYLDVYLI	SYLDV-YLI
VFDVTKGSKF	VFDVTGSKF
IFDGFIVSL	IFDGFIVSL
VWDLRNMGY	VWDLRNMGY
YFWEALNNF	YFWEALNNF
LFDIFSQQV	LFDIFSQQV
NYDNKQVRI	NYDNKQVRI
VFDDTLGSF	VFDDTLGSF
KLPGNISSL	KLPGNISSL
VYDVRQAYV	VYDVRQAYV
VLDNPTPEM	VLDNPTPEM
GFDPHFSYM	GFDPHFSYM
SFDLNTIQI	SFDLNTIQI
FYDGVVQTV	FYDGVVQTV
FFDHSGTLV	FFDHSGTLV
HFPDMEIFL	HFPDMEIFL
IFDLQKTSL	IFDLQKTSL
NYDNLLSQF	NYDNLLSQF
IRDSENGAF	IRDSENGAF
RFDNADRMF	RFDNADRMF
LFDMFPNQF	LFDMFPNQF
VFDTYMLFF	VFDTYMLFF
VYDFVGLLV	VYDFVGLLV
GFDPVSTVL	GFDPVSTVL
LEDYVARPDKI	DYVARPDKI
KYFLWEEKF	KYFLWEEKF
SFDKGPFATF	SFDKGFATF
KFDAQGKSF	KFDAQGKSF
ITSMLNPLI	ITSMLNPLI
HWDWKIALL	HWDWKIALL
RYDLQIRYL	RYDLQIRYL
LYDLEARGF	LYDLEARGF
NADPQAVTM	NADPQAVTM
FYIESISYL	FYIESISYL
FWDQQEPVIV	FWDQQPVIV
NFDEENAYF	NFDEENAYF
YFDEILNKL	YFDEILNKL
TLDVGGLVF	TLDVGGLVF
HPDESGSKFQL	HPDESGSKF
FDSKVTEI	FDSKV-TEI
TFDEIVNI	TFDEI-VNI
IFDLSSEF	IFDLS-SEF
HYDGSYSTF	HYDGSYSTF
RFDTAFFL	RFDTA-FFL
IWDVSVNSV	IWDVSVNSV
VTDDHIRM	VTDDH-IRM
PNAEIHIL	PNAEI-HIL
HFDSRSVIF	HFDSRSVIF
VFDPHGTL	VFDPH-GTL
MPETTETVL	MPETTETVL
LFDATLTQY	LFDATLTQY
AGDLDKFISEF	DLDKFISEF
KFDDSLVHI	KFDDSLVHI
TIIDTKGVTAL	IIDTKVTAL
LFDVQRNNI	LFDVQRNNI
FPDSGHFNV	FPDSGHFNV
MFDELTATY	MFDELTATY
MFDQSQIQEF	MFDQSIQEF
MFEELSDIF	MFEELSDIF
AFDTSSADV	AFDTSSADV
DFDVAVVTF	DFDVAVVTF
FWADKVASL	FWADKVASL
LYDQQEQHM	LYDQQEQHM
LFDHVTVRI	LFDHVTVRI
RTDREIKV	RTDRE-IKV
YYDEFANL	YYDEF-ANL
KFDDIFGSSF	KFDDIGSSF
SLAVRVNSL	SLAVRVNSL
FYDFFRYV	FYDFF-RYV
MFSDFLQSF	MFSDFLQSF
IYDNPNLI	IYDNP-NLI
KFDLAARTL	KFDLAARTL
FSDENVPRL	FSDENVPRL
SFDNIRNWI	SFDNIRNWI
SFDSALQSV	SFDSALQSV
IYDKVSGDM	IYDKVSGDM
IYDMIGQAI	IYDMIGQAI
VFDVTAPNTF	VFDVTPNTF
HFDPSKAF	HFDPS-KAF
TFDVYTKL	TFDVY-TKL
NFDYKRFIKF	NFDYKFIKF
KIDEKTAEL	KIDEKTAEL
TYDDGAATRL	TYDDGATRL
VFDKYMTI	VFDKY-MTI
VIPTNVPEL	VIPTNVPEL
IYDSSMKL	IYDSS-MKL
YFDVEPAQV	YFDVEPAQV
VFDNLIQL	VFDNL-IQL
VFDLVRTL	VFDLV-RTL
MFDVASGRLM	MFDVASGRL
IYDLLSITL	IYDLLSITL
MPEDLVEAL	MPEDLVEAL
NYDVNVIM	NYDVN-VIM
HPESERISM	HPESERISM
NFEVAESDF	NFEVAESDF
IYEYVESRM	IYEYVESRM
TYDTSYNNKM	TYDTSNNKM
YTDFHVDF	YTDFH-VDF
AFDLTKTNM	AFDLTKTNM
HFYYFVKEF	HFYYFVKEF
NFDKIGKEF	NFDKIGKEF
LFDLFRGFF	LFDLFRGFF
EIGVLAKAF	EIGVLAKAF
SWDEHVFEL	SWDEHVFEL
IYELMQTEF	IYELMQTEF
HFDYSPAGL	HFDYSPAGL
KWDALVIKL	KWDALVIKL
VWDLAQQVV	VWDLAQQVV
VMAPRTLIL	VMAPRTLIL
RFDEAYIYM	RFDEAYIYM
FADYPCHTV	FADYPCHTV
MPDGQFKDISL	MPDGQFKDI
LYDEAIRHF	LYDEAIRHF
NFDVRFETF	NFDVRFETF
TVEEVFLNL	TVEEVFLNL
HFDTATKV	HFDTA-TKV
AFDPELRIM	AFDPELRIM
LYDGFQYL	LYDGF-QYL
NPDEAEKAL	NPDEAEKAL
VFENIVAVL	VFENIVAVL
YFISHVLAF	YFISHVLAF
SFDATGSGF	SFDATGSGF
NFDRSSSTF	NFDRSSSTF
NPEHASVAM	NPEHASVAM
EFDKNIALL	EFDKNIALL
YYEHEFVEL	YYEHEFVEL
LFDRQGFL	LFDRQ-GFL
AYDNFVEL	AYDNF-VEL
VFDEVVQIF	VFDEVVQIF
VFDVGGLLED	VFDVG-GLL
LFDLTPAKVL	LFDLTPAKV
NFDVEVLL	NFDVE-VLL
IFDKIHSLL	IFDKIHSLL
LWDDKGPAKI	LWDDKPAKI
NFDEILRVV	NFDEILRVV
RYDEMVESM	RYDEMVESM
VYDTFMMI	VYDTF-MMI
YFPTKPMFV	YFPTKPMFV
LYDGSRLL	LYDGS-RLL
RFDESMQVF	RFDESMQVF
FMDKKTVVL	FMDKKTVVL
LFDYEVRL	LFDYE-VRL
FFSPKVVSL	FFSPKVVSL
FTDDSARTF	FTDDSARTF
IFDEAEKL	IFDEA-EKL
YFDGLSETIL	YFDGLETIL
SYDTWVSRV	SYDTWVSRV
STDNGRIFL	STDNGRIFL
SYDTRVYI	SYDTR-VYI
FWPPYVELL	FWPPYVELL
MPEPTVLSL	MPEPTVLSL
FLETNVPLLV	FLETNVPLL
LPEKKGNTL	LPEKKGNTL
MYDFSGQF	MYDFS-GQF
TYETKTALL	TYETKTALL
YFEDKLTEI	YFEDKLTEI
IFDSKTVSI	IFDSKTVSI
QYDSTHGKF	QYDSTHGKF
SFDMAQVF	SFDMA-QVF
MFDASLVNHV	MFDASVNHV
SYDLAIKAI	SYDLAIKAI
FFDSSVEL	FFDSS-VEL
SPDSGVYEM	SPDSGVYEM
NYDYAVYLL	NYDYAVYLL
VWDEVSGQW	VWDEVSGQW
KAPEPLSSL	KAPEPLSSL
NYDPLPMWI	NYDPLPMWI
VTAPKNVSDII	TAPKNVSDI
VYDSQAEAM	VYDSQAEAM
YYDDFLQRL	YYDDFLQRL
VLDELVRP	VLDEL-VRP
KFDPVGEIL	KFDPVGEIL
HFDPVIQL	HFDPV-IQL
FFDDLSDSF	FFDDLSDSF
VYDLYKTL	VYDLY-KTL
LFDEIDQAL	LFDEIDQAL
WFDAEITTL	WFDAEITTL
VFDPIGHF	VFDPI-GHF
HMDPSGTF	HMDPS-GTF
VFEDLSVTL	VFEDLSVTL
VADPYVVIM	VADPYVVIM
DAQFHFVL	DAQFH-FVL
NFPEMATYL	NFPEMATYL
AYDPTAPTLF	AYDPTAPTL
YFEGSIYEI	YFEGSIYEI
VVDVPFASF	VVDVPFASF
YVDVAVGAF	YVDVAVGAF
LYDICFRTL	LYDICFRTL
VYDVVEEKL	VYDVVEEKL
IYSSLPVEV	IYSSLPVEV
YFDSYAHF	YFDSY-AHF
SVDGIPARL	SVDGIPARL
EISYAKYGSF	SYAKY-GSF
IYDGDLESEF	IYDGDESEF
HTDTTVKF	HTDTT-VKF
LVNELTEFAK	LVNEL-TEF
SFDNTGNV	SFDNT-GNV
QFDMTRNLF	QFDMTRNLF
YFDRNPYF	YFDRN-PYF
AFDPSGQRL	AFDPSGQRL
YFDAIPVTM	YFDAIPVTM
IFSEKPVFV	IFSEKPVFV
WFDGKLVTV	WFDGKLVTV
SLDGRPPSL	SLDGRPPSL
TFDPVTKVL	TFDPVTKVL
KTDLAKALM	KTDLAKALM
NFDDYTVNL	NFDDYTVNL
YWPTYVPMEV	YWPTYPMEV
FFSEREASF	FFSEREASF
FFEVFDNSM	FFEVFDNSM
IFDEDHDEM	IFDEDHDEM
TFDVAMRF	TFDVA-MRF
MQDPMEVFV	MQDPMEVFV
TFDMFNFL	TFDMF-NFL
NFDLTKNYL	NFDLTKNYL
LLDEVLNVM	LLDEVLNVM
SFDLLPREF	SFDLLPREF
KYDYVGRLL	KYDYVGRLL
LTDMSRPVEL	LTDMSPVEL
VFDERAANF	VFDERAANF
SFDEAAKI	SFDEA-AKI
FYNERVVIM	FYNERVVIM
TFDAVLIVGA	TFDAV-LIV
VYDDGTNTF	VYDDGTNTF
VADPIIYVL	VADPIIYVL
VFDTTFQSHL	VFDTTQSHL
KFWDYLHEI	KFWDYLHEI
FYDPPRRL	FYDPP-RRL
RFDLLKRIL	RFDLLKRIL
IFDEIHYM	IFDEI-HYM
LYENLGEYF	LYENLGEYF
YFDNILNSF	YFDNILNSF
SYMEVPTYL	SYMEVPTYL
LPDGSRVEL	LPDGSRVEL
TFDPIHQWL	TFDPIHQWL
LPDKGAQRL	LPDKGAQRL
AYDNGINLF	AYDNGINLF
ATDGKVLL	ATDGK-VLL
VFDNYAVTVMI	VFDNYAVTV
AYDDLSPLL	AYDDLSPLL
FYQEHPDL	FYQEH-PDL
VWDHQGVEL	VWDHQGVEL
AHDVDPIEL	AHDVDPIEL
QWDPMITTL	QWDPMITTL
SQPLGPRII	SQPLGPRII
DYDFSYHQM	DYDFSYHQM
VSDHFPVEF	VSDHFPVEF
FWEPNIAIV	FWEPNIAIV
SYDGRAYVI	SYDGRAYVI
SFDIGDQPVF	SFDIGQPVF
LYDEYMYYL	LYDEYMYYL
SWDEVIHI	SWDEV-IHI
HFDRSVVL	HFDRS-VVL
NYDNLLEAF	NYDNLLEAF
YYEERTCIL	YYEERTCIL
LFDAHVEF	LFDAH-VEF
TAMDVVYAL	TAMDVVYAL
YFELVQHEY	YFELVQHEY
IWDDTALI	IWDDT-ALI
TFDLQRIGF	TFDLQRIGF
RFDPFGPIG	RFDPFGPIG
FFKELIQEF	FFKELIQEF
FFDDPMLL	FFDDP-MLL
FYNTSIEEM	FYNTSIEEM
FFEHEVKL	FFEHE-VKL
MFDKDVVM	MFDKD-VVM
IFDQLLEFV	IFDQLLEFV
VYDPATETW	VYDPATETW
YMDLASRL	YMDLA-SRL
FWDYGRIAL	FWDYGRIAL
SYDVFQLEF	SYDVFQLEF
YPEGFEIHSM	YPEGFIHSM
VWDIFQPLLF	VWDIFQPLL
TWEGKGTYV	TWEGKGTYV
QYDMTLTSF	QYDMTLTSF
YFDEPVEL	YFDEP-VEL
IFDDEPTII	IFDDEPTII
YFDQVLVNI	YFDQVLVNI
FTDVIGHYI	FTDVIGHYI
NYSDAIVWL	NYSDAIVWL
YVQDYEDFM	YVQDYEDFM
KTDDPGTHV	KTDDPGTHV
FYSNKEIFL	FYSNKEIFL
FFDYSGRDL	FFDYSGRDL
YPEEVSSMVL	YPEEVSSMV
KVDTGVIL	KVDTG-VIL
MYDRAGEM	MYDRA-GEM
SQISFIDYF	SQISFIDYF
MVDGTLLLL	MVDGTLLLL
VADLQLIDF	VADLQLIDF
FFESFGDL	FFESF-GDL
FTDVEASL	FTDVE-ASL
APELESKESVL	ELESKESVL
IFDWLGRSL	IFDWLGRSL
RTDTYVKL	RTDTY-VKL
ISDFAVFL	ISDFA-VFL
VFDEADRI	VFDEA-DRI
AFDNVLNYI	AFDNVLNYI
QWEDLTPLTF	WEDLTPLTF
SFDETLTAL	SFDETLTAL
HWFVWVTQM	HWFVWVTQM
NLDVSDEKM	NLDVSDEKM
NTDEHARVM	NTDEHARVM
MPDLPHLL	MPDLP-HLL
TWDELVEHL	TWDELVEHL
IYDEVVKL	IYDEV-VKL
VEALHEVL	VEALH-EVL
IWDFVSGSF	IWDFVSGSF
FFDDIGYL	FFDDI-GYL
FPELDSPQL	FPELDSPQL
SFDETVTHFI	SFDETVTHF
VYDPQKATV	VYDPQKATV
VYDNIGILGNF	VYDNI-GIL
SMDEALEKF	SMDEALEKF
SVDLQTRIM	SVDLQTRIM
IYIQIEHSAI	IYIQIHSAI
YFDVPELI	YFDVP-ELI
TFEKTPVEV	TFEKTPVEV
VFDSVNARL	VFDSVNARL
TPEVDDEALEK	TPEVDDEAL
LWDFQGSTM	LWDFQGSTM
VAPVTHVSV	VAPVTHVSV
IYDGKVEM	IYDGK-VEM
LGDGPKLV	LGDGP-KLV
EWDQVTVYL	EWDQVTVYL
SFDVTQSPFFP	SFDVTQSPF
DFDLHSEL	DFDLH-SEL
TWDYTNPNL	TWDYTNPNL
FFEEFGKL	FFEEF-GKL
NVDRHVDL	NVDRH-VDL
LYMIPVGAFI	LYMIPVGAF
VWEETIILL	VWEETIILL
FLDPTLSLF	FLDPTLSLF
FFDPHQSTF	FFDPHQSTF
KVDMPITV	KVDMP-ITV
QFDGLVEL	QFDGL-VEL
FFSEKIYKL	FFSEKIYKL
VFDEADRL	VFDEA-DRL
YFDDRVHF	YFDDR-VHF
FFNYKVVLL	FFNYKVVLL
IFDNWIPLL	IFDNWIPLL
IYEQKIAEL	IYEQKIAEL
YYDYISPRF	YYDYISPRF
NFDPTANL	NFDPT-ANL
FLPEAPAEL	FLPEAPAEL
FYDSQPTLI	FYDSQPTLI
RFWTWINHF	RFWTWINHF
NIDIDPVYL	NIDIDPVYL
KTDGEVQV	KTDGE-VQV
YFNAPVYL	YFNAP-VYL
LFDVLHEPFL	LFDVLEPFL
FYDPTAGVVM	FYDPTAGVV
YFDKMSNEM	YFDKMSNEM
LLIENVASL	LLIENVASL
YIDFMGTDAA	YIDFMGTDA
FFEGPPFKF	FFEGPPFKF
HADHSSLTL	HADHSSLTL
YDQIHFVL	YDQIH-FVL
ITDGQIFL	ITDGQ-IFL
FFDPDTNIVYL	FFDPDTNIV
HYDPATEEF	HYDPATEEF
SYMPVIDVF	SYMPVIDVF
RWDVSSFF	RWDVS-SFF
LFDGFADGLGV	LFDGFADGL
IYDEDEVLL	IYDEDEVLL
IMDSTEAQL	IMDSTEAQL
MWPLVAALL	MWPLVAALL
HFWTWINHL	HFWTWINHL
SRELDALLI	SRELDALLI
NHDMTLTEF	NHDMTLTEF
SLDAFMSEM	SLDAFMSEM
QWDLRLTAV	QWDLRLTAV
RFAARPVLL	RFAARPVLL
TYDIVITTY	TYDIVITTY
IWQAYLDYL	IWQAYLDYL
SYDEAIANL	SYDEAIANL
YFDVIEEI	YFDVI-EEI
NMDGPISL	NMDGP-ISL
DYDIVILEV	DYDIVILEV
VFDKTYQFL	VFDKTYQFL
TSEPSRDSF	TSEPSRDSF
LFPEWPSYL	LFPEWPSYL
LFDVHTTL	LFDVH-TTL
NFDVHDDV	NFDVH-DDV
SIPGGYNAL	SIPGGYNAL
VYDEFLLL	VYDEF-LLL
AYDVTYSL	AYDVT-YSL
ATDPFASVF	ATDPFASVF
SFDLVAQMI	SFDLVAQMI
HYDYHQEI	HYDYH-QEI
NYDEHISNF	NYDEHISNF
SYDNVLIKW	SYDNVLIKW
VFDDGRYVYL	VFDDGYVYL
FLDAAKAL	FLDAA-KAL
NFEDFLTIM	NFEDFLTIM
FFDIASQI	FFDIA-SQI
SYDHTVKM	SYDHT-VKM
FLDKPTLL	FLDKP-TLL
FFGTHETAFL	FFGTHETAF
LSDHHVYL	LSDHH-VYL
VYDNNSSTL	VYDNNSSTL
STDREASI	STDRE-ASI
VYDVTNEESF	VYDVTEESF
NLEMIILI	NLEMI-ILI
NFVEETVYL	NFVEETVYL
HWDAAIHGF	HWDAAIHGF
TFDVHLDL	TFDVH-LDL
FQDAYVLL	FQDAY-VLL
NFDDFEEDF	NFDDFEEDF
HPETRSAFL	HPETRSAFL
NYDRFHYL	NYDRF-HYL
LFDLALQGL	LFDLALQGL
HFYEHLNQM	HFYEHLNQM
TFDDLLNRL	TFDDLLNRL
QFDGTNSAF	QFDGTNSAF
IFDAVGFTF	IFDAVGFTF
KYDENMVLV	KYDENMVLV
YFDLPGALL	YFDLPGALL
SFDGHHYI	SFDGH-HYI
VFDFGLEPVLM	VFDFGEPVL
SWDEAVQALL	SWDEAVQAL
YYEVHKELF	YYEVHKELF
FADQPVMF	FADQP-VMF
YSDNSNGSF	YSDNSNGSF
IFDEILVNA	IFDEILVNA
FFDYNYGQYF	FFDYNGQYF
SFNDTFVHV	SFNDTFVHV
TFDAHLTEL	TFDAHLTEL
EYDLPALL	EYDLP-ALL
VFDNTPAAL	VFDNTPAAL
NFDEKLVEHF	NFDEKVEHF
LYDYAKDLF	LYDYAKDLF
ATDDPAARF	ATDDPAARF
LFDLPPALL	LFDLPPALL
HYIYPPAIV	HYIYPPAIV
TFDDLKIQT	TFDDLKIQT
QFPTPEAVL	QFPTPEAVL
QLDPLVVEL	QLDPLVVEL
ATDAAIRV	ATDAA-IRV
VFDHPWETV	VFDHPWETV
FGDPGNPPEF	FGDPGPPEF
AFDNFKEV	AFDNF-KEV
KFDADPVEL	KFDADPVEL
FVDQFVEL	FVDQF-VEL
NFERNKAIKV	NFERNAIKV
NFDESLNSL	NFDESLNSL
HFSELLDEF	HFSELLDEF
ASEQILLATAH	ASEQILATA
NYEDVATFL	NYEDVATFL
NYDLHDTVSF	NYDLHTVSF
IFDVGENL	IFDVG-ENL
MFDDIGRNF	MFDDIGRNF
LFDHVGCL	LFDHV-GCL
HFDTPVQF	HFDTP-VQF
VFDINAEV	VFDIN-AEV
GWDEALLTM	GWDEALLTM
MFDNALSTL	MFDNALSTL
IVDEAIYYF	IVDEAIYYF
GFDPFMNL	GFDPF-MNL
IWEQYTVTL	IWEQYTVTL
DAAIRVWSL	DAAIRVWSL
LYDTHITVL	LYDTHITVL
VNLPINGNGKQ	NLPINGNGK
KLDVALKEM	KLDVALKEM
VWDESASFL	VWDESASFL
FPFDVTKVEV	PFDVTKVEV
LYDLSKVVL	LYDLSKVVL
VYDLLKNHL	VYDLLKNHL
AYDEHQTLL	AYDEHQTLL
MAPLKMLAL	MAPLKMLAL
HPDEPLYSF	HPDEPLYSF
IFDLQSNTVLA	IFDLQSNTV
VWPLLPALL	VWPLLPALL
VLDLMKVDM	VLDLMKVDM
RTDDLVYL	RTDDL-VYL
FFDTNTSVLM	FFDTNTSVL
SYDSKLVWF	SYDSKLVWF
FSEEHPVLL	FSEEHPVLL
IFSPSVEDF	IFSPSVEDF
EFDEVSRIV	EFDEVSRIV
RFDVHDVTL	RFDVHDVTL
ETDWEVYL	ETDWE-VYL
HWDPSARL	HWDPS-ARL
TFDFQNDFL	TFDFQNDFL
FLPEAPAELL	FLPEAPAEL
TFEDVAVHL	TFEDVAVHL
FWDNVVYIL	FWDNVVYIL
RFDPFNFL	RFDPF-NFL
YFIKPPVYV	YFIKPPVYV
ASDVHGNF	ASDVH-GNF
GFDLQETLV	GFDLQETLV
RFEEETVLL	RFEEETVLL
TLDSPAHL	TLDSP-AHL
RYDDMATCM	RYDDMATCM
YADRHAEL	YADRH-AEL
FFDNSSSPHL	FFDNSSPHL
KFDHNAIM	KFDHN-AIM
LFDLALRGL	LFDLALRGL
MPESGAGSEF	MPESGGSEF
GWDGLIKL	GWDGL-IKL
LYDLAAVVV	LYDLAAVVV
NFDMFVSHY	NFDMFVSHY
QTDHTPVHL	QTDHTPVHL
HFDFQGCNF	HFDFQGCNF
AWDYVQAQV	AWDYVQAQV
GYDTRVTIL	GYDTRVTIL
QFDPQPLAM	QFDPQPLAM
SWDQTVKL	SWDQT-VKL
EASFDGTFLW	SFDGT--FL
DFNATSALFW	DFNATSALF
FMDQHPEMDF	FMDQH-PEM
FFDDLGDELLF	FFDDLGDEL
VYDLSKGLA	VYDLSKGLA
VMAPRTLLL	VMAPRTLLL
IFDIATGKL	IFDIATGKL
IHDGLTVHL	IHDGLTVHL
YFWEYSEQL	YFWEYSEQL
VFEDVAIHF	VFEDVAIHF
SYDPVLNPVL	SYDPVLNPV
VFDFPDLNRF	VFDFPLNRF
FLDVAGLL	FLDVA-GLL
VWDHGGRIF	VWDHGGRIF
IIDEQPLIF	IIDEQPLIF
FPDEKEDNL	FPDEKEDNL
FFEIYNEL	FFEIY-NEL
TYDESTKL	TYDES-TKL
LFDVHSIL	LFDVH-SIL
KADLGKIVL	KADLGKIVL
AWDEVGDEF	AWDEVGDEF
IWEPLAVKL	IWEPLAVKL
VYDGHQHI	VYDGH-QHI
YGMPRQIL	YGMPR-QIL
FAEVTENFAF	FAEVT-ENF
VFDVTERTAL	VFDVTRTAL
VFQPSLAVF	VFQPSLAVF
LPDFERESL	LPDFERESL
SFDFHGRRM	SFDFHGRRM
SYDTHWITM	SYDTHWITM
IFDENELEL	IFDENELEL
SMDNNRSLDL	SMDNN-RSL
YDGKVMKL	YDGKV-MKL
VLDDKLVFV	VLDDKLVFV
VWDVPVEEF	VWDVPVEEF
IMDATNILV	IMDATNILV
VFDVGGLL	VFDVG-GLL
EYDPVIILI	EYDPVIILI
VGDGYVVHL	VGDGYVVHL
QFDNFKRVF	QFDNFKRVF
TFDSTIHFY	TFDSTIHFY
IIAVDWLL	IIAVD-WLL
NFYVFPKPF	NFYVFPKPF
YYAYLPAKL	YYAYLPAKL
VYDAVGML	VYDAV-GML
AWDKEPVLV	AWDKEPVLV
VWDLAQQV	VWDLA-QQV
AFDFAAREM	AFDFAAREM
ASDDKTVKL	ASDDKTVKL
SIDSEPALV	SIDSEPALV
SFPSEPVKL	SFPSEPVKL
NTDIQVEI	NTDIQ-VEI
FPDPAHPNTL	FPDPAPNTL
KFDGDSAYV	KFDGDSAYV
LYDTHQNL	LYDTH-QNL
DFDFNFQEF	DFDFNFQEF
KYFLWVVKF	KYFLWVVKF
TPEQQAAIL	TPEQQAAIL
SVPLAATSM	SVPLAATSM
TWDPALAQI	TWDPALAQI
LYDEFGNYI	LYDEFGNYI
FYDPTHAW	FYDPT-HAW
FFDSNGNF	FFDSN-GNF
NFDVNGYI	NFDVN-GYI
LSCLQPLL	LSCLQ-PLL
LFEEAFAIF	LFEEAFAIF
EFDNAGAM	EFDNA-GAM
TFDNIYLHV	TFDNIYLHV
NTDQGVYL	NTDQG-VYL
FYDIGEEL	FYDIG-EEL
VFDEADRMFD	VFDEADRMF
YLDVAEAFL	YLDVAEAFL
ALPEIFTEL	ALPEIFTEL
IYDRFGRL	IYDRF-GRL
IPEEILGKVSI	IPEEILGKV
RFDCSDRQF	RFDCSDRQF
SFDAAVAL	SFDAA-VAL
NFDIPKEM	NFDIP-KEM
HPDKHRDPEL	HPDKHDPEL
FFNQHIITF	FFNQHIITF
HTDLPVSVF	HTDLPVSVF
FFNLTVKEM	FFNLTVKEM
NRDLATPVM	NRDLATPVM
VMDLMGQL	VMDLM-GQL
MFDHIPVGV	MFDHIPVGV
WFDNQIHEA	WFDNQIHEA
HFSEQLLNL	HFSEQLLNL
VFDALIYI	VFDAL-IYI
FAYDGKDYIAL	AYDGKYIAL
RWDDSVTYI	RWDDSVTYI
LFDFYNKL	LFDFY-NKL
TWDYVAPFLE	TWDYVAPFL
VFDRFTVVL	VFDRFTVVL
FFDDAPVF	FFDDA-PVF
YFDLAADVL	YFDLAADVL
FFSEYEKL	FFSEY-EKL
NFDRTGQM	NFDRT-GQM
FFENHPYF	FFENH-PYF
HFNPTGSAF	HFNPTGSAF
HFDMNIISM	HFDMNIISM
NLDQPPAFF	NLDQPPAFF
FHDATRVYL	FHDATRVYL
FDVSHEHL	FDVSH-EHL
VMAPRTLVL	VMAPRTLVL
RYDNVTILF	RYDNVTILF
FFDEVVKQNV	FFDEVKQNV
HYDPDYEFL	HYDPDYEFL
ATDGRVLL	ATDGR-VLL
HFDVTVKM	HFDVT-VKM
TYDYGGFTMM	TYDYGGFTM
IYDNQGNFM	IYDNQGNFM
YYDVPIATL	YYDVPIATL
VYDQAQSVM	VYDQAQSVM
PASSSLPAFL	ASSSLPAFL
TFDEIASGF	TFDEIASGF
SFDEYSSEL	SFDEYSSEL
AIEALLHDL	AIEALLHDL
NYDDAMQF	NYDDA-MQF
VFDDSGVFDQT	VFDDS-GVF
IWDPHNGDILM	IWDPHGDIL
HFDLFLRFL	HFDLFLRFL
LTDQHVQL	LTDQH-VQL
RWEEYISKV	RWEEYISKV
IWDLASGKL	IWDLASGKL
TFDPAALL	TFDPA-ALL
SYDFFSGEF	SYDFFSGEF
YYTEFPTVL	YYTEFPTVL
YYDKLMPMV	YYDKLMPMV
FLDLARNIF	FLDLARNIF
ILDPHVVL	ILDPH-VVL
HFDLPWYL	HFDLP-WYL
YWEEEPAEV	YWEEEPAEV
FSPFHASVL	FSPFHASVL
FWDGFEEV	FWDGF-EEV
VYDDAHNML	VYDDAHNML
EPDPEEWQL	EPDPEEWQL
LPDPQNISL	LPDPQNISL
YSPYYNTID	YSPYYNTID
YMDYAQARF	YMDYAQARF
IYDDGITSL	IYDDGITSL
LLDLQSALF	LLDLQSALF
ITDKGIIAL	ITDKGIIAL
HWDEVKEEM	HWDEVKEEM
FFDHSGTLVMD	FFDHSGTLV
SADPNVVDL	SADPNVVDL
IDALNENK	IDALN-ENK
LYDPCTVMF	LYDPCTVMF
KTDIIDHSF	KTDIIDHSF
FPEQIAEKL	FPEQIAEKL
VFDNCQTF	VFDNC-QTF
WWEDMVAEF	WWEDMVAEF
FFDGAAVL	FFDGA-AVL
TFPNNPVEL	TFPNNPVEL
IWDFPGQIDF	IWDFPQIDF
SYDVFSLL	SYDVF-SLL
FFDPASIMDES	FFDPA-SIM
YMDTLNIFM	YMDTLNIFM
LYDGEFREF	LYDGEFREF
YLDSEQRL	YLDSE-QRL
TFEDVAVLL	TFEDVAVLL
FFDHQDQVW	FFDHQDQVW
FPDTGSLNL	FPDTGSLNL
LLPDIISRL	LLPDIISRL
MFDLAVDAL	MFDLAVDAL
MWDQRLVKL	MWDQRLVKL
IFDVGALL	IFDVG-ALL
FWPLIPQFV	FWPLIPQFV
HFDHSGGL	HFDHS-GGL
FWDTSPLLL	FWDTSPLLL
EFDGTKVFL	EFDGTKVFL
SLIEQTTAL	SLIEQTTAL
SSDPATRQM	SSDPATRQM
HFDLSHGSA	HFDLSHGSA
TFDVSPKAV	TFDVSPKAV
KMDFTAARL	KMDFTAARL
NAESGRGQVM	NAESGRGQV
LFDDCTQQF	LFDDCTQQF
SFDVTQSPFF	SFDVTQSPF
LFDVHSVL	LFDVH-SVL
AFADSSYLL	AFADSSYLL
VFSLSSEF	VFSLS-SEF
FKDLGEEHFK	FKDLGEEHF
LFDYTDTLV	LFDYTDTLV
FLPELPADL	FLPELPADL
FPEALARLL	FPEALARLL
FPERKEREM	FPERKEREM
HFDLAVEV	HFDLA-VEV
RFDGTHSNF	RFDGTHSNF
TADGRVVKL	TADGRVVKL
VFDLQWMEV	VFDLQWMEV
QFDSVVHL	QFDSV-VHL
LPEDEGHTRTL	EDEGHTRTL
YWENKIVRI	YWENKIVRI
FFDPSLLHLLY	FFDPSLLHL
IGDFSKGYLF	IGDFSKGYL
FYDPTAGVVML	FYDPTAGVV
DFDLIEENL	DFDLIEENL
FFDDVTVYL	FFDDVTVYL
NMDMSLHSM	NMDMSLHSM
DLGEEHFK	DLGEE-HFK
AGDGPPRSF	AGDGPPRSF
TFDVSLLTI	TFDVSLLTI
KYDPEEPIYF	KYDPEPIYF
IFYATATLI	IFYATATLI
FFDPIVLL	FFDPI-VLL
GKDIVWFL	GKDIV-WFL
VYDPQQKTL	VYDPQQKTL
AYDDKIYYFF	AYDDKIYYF
IFDQSGTYL	IFDQSGTYL
YYDEIINAL	YYDEIINAL
GFDTRVTVL	GFDTRVTVL
VFDFAGEEV	VFDFAGEEV
AFDITYVRL	AFDITYVRL
KTDVAKTL	KTDVA-KTL
VFDNLIISL	VFDNLIISL
IYDGPIHL	IYDGP-IHL
TFDSSGAFL	TFDSSGAFL
MMDVAFVQF	MMDVAFVQF
FFDPDTNIV	FFDPDTNIV
TFDDVAVYF	TFDDVAVYF
VLMTEDIKL	VLMTEDIKL
YSDDKVQL	YSDDK-VQL
LLDGRVALL	LLDGRVALL
SYWEWLPLL	SYWEWLPLL
YFDEQFEF	YFDEQ-FEF
TTDDKAVVL	TTDDKAVVL
FPDPNVKYVF	FPDPNVKYV
EFDHLPALL	EFDHLPALL
LFEEVISKM	LFEEVISKM
IFEVADTHL	IFEVADTHL
LYDNDIYFI	LYDNDIYFI
FYDDREFIYL	FYDDRFIYL
AFTSDPALL	AFTSDPALL
FMDDVGQTLL	FMDDVGQTL
MTDPIRILV	MTDPIRILV
MFPLVKSAL	MFPLVKSAL
TFEDVAIYF	TFEDVAIYF
IYDNQGIEL	IYDNQGIEL
IGDEPPKVF	IGDEPPKVF
YYDMMDLKV	YYDMMDLKV
TLDEGLIEF	TLDEGLIEF
HFEEHNSM	HFEEH-NSM
HFDTEETRV	HFDTEETRV
KTDEGSRL	KTDEG-SRL
FLDLSIIRF	FLDLSIIRF
HWDPEYSDVKL	HWDPEYSDV
FMEAIAPPLL	FMEAIPPLL
TFEDVAVTF	TFEDVAVTF
IYDALDVSL	IYDALDVSL
TPDGTEKGDFL	TPDGTKGDF
IYDFIGEFMKA	IYDFIGEFM
MLDDRAYL	MLDDR-AYL
FTDEESYSF	FTDEESYSF
NFDSASSL	NFDSA-SSL
KWSWYLDYL	KWSWYLDYL
DRYDSFIEL	DRYDSFIEL
VLDVANHF	VLDVA-NHF
NYDYLKGFL	NYDYLKGFL
IFENNVVHL	IFENNVVHL
YADGESFL	YADGE-SFL
DVQLRLNSI	DVQLRLNSI
LFDVQILNY	LFDVQILNY
FPESQTKEL	FPESQTKEL
YYDPMISKL	YYDPMISKL
YFDDTEEM	YFDDT-EEM
LYDIANVL	LYDIA-NVL
NYTDNELEK	NYTDNELEK
AYDEHQTL	AYDEH-QTL
TFDDVAVHF	TFDDVAVHF
TYDEVKARL	TYDEVKARL
FLDSQTATF	FLDSQTATF
SFDNSDLVM	SFDNSDLVM
LSDEHAREM	LSDEHAREM
MAPSETQFSHL	APSETFSHL
SNDGPVKV	SNDGP-VKV
NFDKASFL	NFDKA-SFL
FFHLVNSEM	FFHLVNSEM
VYDVTDQESF	VYDVTQESF
SYDVLHLVEF	SYDVLLVEF
IFEGYRSM	IFEGY-RSM
KVDFTEYLL	KVDFTEYLL
VMDSPVHL	VMDSP-VHL
VFDDSGSIF	VFDDSGSIF
SYDDQLAQI	SYDDQLAQI
MPEKLSHKL	MPEKLSHKL
LPDPIIIHL	LPDPIIIHL
YYDVSQEVL	YYDVSQEVL
YVDTAVRHV	YVDTAVRHV
NSDHETYL	NSDHE-TYL
IYDIFQKL	IYDIF-QKL
TYDTSFLDF	TYDTSFLDF
MAEFPLDPQL	EFPLD-PQL
FNDEKTYL	FNDEK-TYL
FVDILQKD	FVDIL-QKD
FLDGYVSQL	FLDGYVSQL
AYDREVHL	AYDRE-VHL
LRDLLVQTL	LRDLLVQTL
IYDTQTLGV	IYDTQTLGV
ALSNLEVKL	ALSNLEVKL
HWDIADATVL	HWDIAATVL
SYLLFFPAL	SYLLFFPAL
FTDEESRV	FTDEE-SRV
NFDDSKNGL	NFDDSKNGL
VSDNQVHL	VSDNQ-VHL
YPEELKPVL	YPEELKPVL
RFDLSAQQM	RFDLSAQQM
AFEDDAIQL	AFEDDAIQL
AFDLSQVLFI	AFDLSQVLF
VYDPTTNAW	VYDPTTNAW
TYDLMSSAYL	TYDLMSAYL
FLDENVHFF	FLDENVHFF
ILDVIVRSF	ILDVIVRSF
FFDQKPEEL	FFDQKPEEL
HPEKLATVL	HPEKLATVL
YFDAVIPKM	YFDAVIPKM
TYDVQKLSL	TYDVQKLSL
MPEPDAQRF	MPEPDAQRF
LLDGGVINL	LLDGGVINL
LWDQSILGF	LWDQSILGF
LFNVAHTL	LFNVA-HTL
PIRLLAAAA	PIRLLAAAA
TFDTHALV	TFDTH-ALV
YFETEAVEI	YFETEAVEI
IFDWVEANL	IFDWVEANL
TAEGHPKSL	TAEGHPKSL
VGDANPALQK	VGDAN-PAL
IWDYHVVLL	IWDYHVVLL
FFDTNTSV	FFDTN-TSV
YVDDTQFV	YVDDT-QFV
HIDVITAEM	HIDVITAEM
FADGAPHYV	FADGAPHYV
AFDEAKADF	AFDEAKADF
TFDLLRNSY	TFDLLRNSY
RWEDTPLVI	RWEDTPLVI
FYEGVVEL	FYEGV-VEL
VWDDVGNLI	VWDDVGNLI
FPEELSPGITL	FPEELSPGI
VFDEAILAA	VFDEAILAA
IFDDNAKL	IFDDN-AKL
RYDMAQLRF	RYDMAQLRF
YYDFLVEV	YYDFL-VEV
YYEDGNVQL	YYEDGNVQL
VYDSQGLLIF	VYDSQ-GLL
SFEASVALL	SFEASVALL
IFAPYVDIF	IFAPYVDIF
TPEGYYMFI	TPEGYYMFI
VVDKPPSTM	VVDKPPSTM
FLDEKSGSF	FLDEKSGSF
LFPGQVVIM	LFPGQVVIM
FFEHERTFL	FFEHERTFL
YLDHYPPYL	YLDHYPPYL
FYEETTQEL	FYEETTQEL
NMDLMRADM	NMDLMRADM
FPDLFSEQL	FPDLFSEQL
SWDLPGSHV	SWDLPGSHV
FYDRRRIYL	FYDRRRIYL
YFEGGVSSV	YFEGGVSSV
VFDQYLNFI	VFDQYLNFI
SLPDIPAHL	SLPDIPAHL
LFDQTRHSL	LFDQTRHSL
NFDEKPVII	NFDEKPVII
IWDQDIQFL	IWDQDIQFL
MPEDVKNFYL	MPEDV-KNF
SFDVFHRAF	SFDVFHRAF
YDEAIRHF	YDEAI-RHF
NQDIRFQAV	NQDIRFQAV
FTDPLGVQI	FTDPLGVQI
FPEEVIATI	FPEEVIATI
AKENAPAIIFI	AKENAPAII
IWPLHPSLL	IWPLHPSLL
FFDHSGTLVM	FFDHSGTLV
SFDDTNEKF	SFDDTNEKF
DFDLVDALL	DFDLVDALL
TYDATTHF	TYDAT-THF
HYDPAELKL	HYDPAELKL
SYDAPSDFINF	SYDAP-SDF
FLPPFPAHL	FLPPFPAHL
YFDIYYPL	YFDIY-YPL
LFDVPVLNL	LFDVPVLNL
FFPEDPVKI	FFPEDPVKI
IWDDPDAGFF	IWDDPDAGF
HMDPSGTFV	HMDPSGTFV
IFSENDIF	IFSEN-DIF
VFDQIIEL	VFDQI-IEL
YLLESVNKL	YLLESVNKL
IFDIPGRLY	IFDIPGRLY
HIIAGAGEL	HIIAGAGEL
HIQKEDVPSER	KEDVP-SER
MWDPVTPYRL	MWDPVPYRL
VFDPDSTQV	VFDPDSTQV
NFDEAAKV	NFDEA-AKV
DGTVRLWSL	DGTVRLWSL
NFDRFSEM	NFDRF-SEM
SFDNIKNWI	SFDNIKNWI
NRFPAVNSL	NRFPAVNSL
SFDVADRM	SFDVA-DRM
NYDYSHTV	NYDYS-HTV
FNEKSKEL	FNEKS-KEL
SWDPVGTSL	SWDPVGTSL
FFDKVQDL	FFDKV-QDL
VFEHHGQV	VFEHH-GQV
VPDPFFVEL	VPDPFFVEL
AFDISKKEM	AFDISKKEM
IYDRDFSYNYF	DRDFSYNYF
AFDYAYVVL	AFDYAYVVL
NAPWAVTSL	NAPWAVTSL
RYDDMASAM	RYDDMASAM
YFPPGIVEV	YFPPGIVEV
YFDQHFGPF	YFDQHFGPF
LEADRMAAL	LEADRMAAL
SYDSVLALV	SYDSVLALV
VFDVFLVEGY	VFDVFLVEG
YFAERVTSL	YFAERVTSL
FYDLQEADL	FYDLQEADL
SWEARTTNL	SWEARTTNL
HWVDLLDRF	HWVDLLDRF
FPDEFHLQTL	FPDEFLQTL
FIDENPELF	FIDENPELF
RFDKEVALF	RFDKEVALF
YLPDFLDYF	YLPDFLDYF
VTDVGVHL	VTDVG-VHL
LTDGPARL	LTDGP-ARL
TFDRSVTL	TFDRS-VTL
DGLIHTSL	DGLIH-TSL
YFLPDTAHF	YFLPDTAHF
VWDLFPEADKV	LFPEA-DKV
VFDVGGLLE	VFDVGGLLE
TFEDFVAII	TFEDFVAII
RYDDLKEEM	RYDDLKEEM
ISDDHVIL	ISDDH-VIL
EFDEQGREL	EFDEQGREL
FWDPSVNLF	FWDPSVNLF
FYDRTVRVF	FYDRTVRVF
IFDPSPEDI	IFDPSPEDI
MFDRHSSL	MFDRH-SSL
FFDAIFTQL	FFDAIFTQL
SAPKYIDYL	SAPKYIDYL
SALPLLSAL	SALPLLSAL
KYDDAERRF	KYDDAERRF
APEEHPVLL	APEEHPVLL
VWDVTMQDL	VWDVTMQDL
TFDETVSTY	TFDETVSTY
FLDLSENLI	FLDLSENLI
IFDITNNL	IFDIT-NNL
MYPGLPSRL	MYPGLPSRL
AFIEPPERM	AFIEPPERM
SYDEAILHL	SYDEAILHL
MLDVNGLF	MLDVN-GLF
FYDDETVTV	FYDDETVTV
YFDVVEEI	YFDVV-EEI
TIPITPAFL	TIPITPAFL
LLDPKLCYL	LLDPKLCYL
HYMPPPYASL	YMPPPYASL
ATDSPVHV	ATDSP-VHV
AYDEATDEF	AYDEATDEF
TTDDHCQEF	TTDDHCQEF
HFDPEAPFL	HFDPEAPFL
FPEPLIIPVL	FPEPLIPVL
NYDDIRTEL	NYDDIRTEL
KTDGSVVKL	KTDGSVVKL
AWWEWDTKF	AWWEWDTKF
LLPSHASYL	LLPSHASYL
QIPEIKQTL	QIPEIKQTL
FFDDLLVVL	FFDDLLVVL
RLDVTVQSF	RLDVTVQSF
LRPLLAAAA	LRPLLAAAA
SLDAPVKL	SLDAP-VKL
YYDIHRSYL	YYDIHRSYL
VYDIDNKTIEL	VYDIDNKTI
AFDASGTKL	AFDASGTKL
NFDVGHVPI	NFDVGHVPI
TFWLLLRQF	TFWLLLRQF
DFDPALGMM	DFDPALGMM
FADREVQL	FADRE-VQL
FSEAREDM	FSEAR-EDM
SYEYPEYFL	SYEYPEYFL
VYDPYKPYQL	VYDPYPYQL
FLDSEVNL	FLDSE-VNL
FLDLEQHL	FLDLE-QHL
VFEDVPLFL	VFEDVPLFL
VYDEPGHAV	VYDEPGHAV
FAPYNKPSL	FAPYNKPSL
RFDEISFVNF	RFDEI-SFV
EADFPVYF	EADFP-VYF
QQAPQPYEFF	APQPY-EFF
DWDLHQSLF	DWDLHQSLF
LLDPPLIAL	LLDPPLIAL
SNDDAVRV	SNDDA-VRV
VMDDEVFM	VMDDE-VFM
VFEKATFI	VFEKA-TFI
TSDGRPAWM	TSDGRPAWM
YYDQTGAL	YYDQT-GAL
LFIHYLAI	LFIHY-LAI
SFEEKQSL	SFEEK-QSL
YYDPKTCGF	YYDPKTCGF
IYDEAISSF	IYDEAISSF
FYDKPMRI	FYDKP-MRI
ILDRHLAIL	ILDRHLAIL
DDTVRYTSL	DDTVRYTSL
AYDHSYVEL	AYDHSYVEL
YLDALDLLI	YLDALDLLI
AYDPTAPTL	AYDPTAPTL
LSFDPLLIT	LSFDPLLIT
PFDLQSVIF	PFDLQSVIF
IFDLQNKVL	IFDLQNKVL
IYDIMNEL	IYDIM-NEL
TFDLTVVSY	TFDLTVVSY
FYEGRPVRL	FYEGRPVRL
LYDRYGEQGL	LYDRYEQGL
FPEGKGVAV	FPEGKGVAV
IWDLTTATLM	IWDLTTATL
IFDEMDKL	IFDEM-DKL
MKEVGSHF	MKEVG-SHF
QFDGGVVL	QFDGG-VVL
FYDNGKVVI	FYDNGKVVI
GFDRNAVIV	GFDRNAVIV
YFDENPYF	YFDEN-PYF
DPFNPFELTNH	DPFNP-FEL
LYDLAAVL	LYDLA-AVL
ILDVTVVYL	ILDVTVVYL
EFDAVLADF	EFDAVLADF
FYDPRSLDI	FYDPRSLDI
AEFVEVTK	AEFVE-VTK
RTDRETKL	RTDRE-TKL
YFDGNLEKL	YFDGNLEKL
IWDGLILL	IWDGL-ILL
RYDPSLTF	RYDPS-LTF
YFDLNSEQM	YFDLNSEQM
NSDTHSSTF	NSDTHSSTF
HMDETVSF	HMDET-VSF
NFDEALVDY	NFDEALVDY
AWDIFQPLLF	AWDIFQPLL
FFDGLQVIF	FFDGLQVIF
NFDCFGDKL	NFDCFGDKL
ISDHYPVEV	ISDHYPVEV
AFDSQNNTV	AFDSQNNTV
HFDTQNNISTM	HFDTQ-NNI
SYDEARNL	SYDEA-RNL
AWDEADVRF	AWDEADVRF
