Data	Data aligned
KVVDVDVKL	KVVDVDVKL
IASPVIAAV	IASPVIAAV
STSNLNEKI	STSNLNEKI
SQSWNVETL	SQSWNVETL
SQAAEELITRI	QAAELITRI
SVPDVTHHL	SVPDVTHHL
MVPEPKIIDAA	MVPEKIIDA
TLYKEILTRA	TLYKILTRA
SQAETVHGL	SQAETVHGL
STFSAPLNKA	STFSPLNKA
AGYQGEITSV	AGYQEITSV
VLPLLLMAS	VLPLLLMAS
YQIHKEYLL	YQIHKEYLL
SAIGYIHSL	SAIGYIHSL
FQSDTNAML	FQSDTNAML
KLFNGTFLKA	KLFNTFLKA
KVVEELTRI	KVVEELTRI
SMKDDLERV	SMKDDLERV
KQSNVQILV	KQSNVQILV
TVIARIEAL	TVIARIEAL
IVPEGVHAL	IVPEGVHAL
SVYKNVILQV	SVYKVILQV
RVFSDIIYTVA	RVFSIIYTV
KVVTGVANA	KVVTGVANA
SIPEKNRPL	SIPEKNRPL
IIFDPNILTI	IIFDNILTI
LVKTDMEKL	LVKTDMEKL
TMKDHLVRV	TMKDHLVRV
FVVEKIELL	FVVEKIELL
FISGHTSEL	FISGHTSEL
GQSKENNYL	GQSKENNYL
YVAELIQQL	YVAELIQQL
FIFPASNVYL	FIFPSNVYL
RAIENIDTL	RAIENIDTL
FIPATGHSL	FIPATGHSL
SQIHDIVLV	SQIHDIVLV
FQIRNLPSL	FQIRNLPSL
EQIEAIHKA	EQIEAIHKA
FAEDVGSNKGA	FAEDVGSNK
TNQELQEINR	-TNQELQEI
FTAEKTDEL	FTAEKTDEL
IDTIEIITDR	DTIEIITDR
YIAEEYSRL	YIAEEYSRL
RLKEELEEA	RLKEELEEA
STSKWNHLL	STSKWNHLL
IIPDKVWAV	IIPDKVWAV
TLYEHNNEL	TLYEHNNEL
IQALPGPFL	IQALPGPFL
FGFEITHEV	FGFEITHEV
SVSSVVHYL	SVSSVVHYL
KTVEYITKL	KTVEYITKL
QTKEAIVSA	QTKEAIVSA
RIIDVVYNA	RIIDVVYNA
YVNGEIQKA	YVNGEIQKA
EVDDEALE	-EVDDEALE
KISDIQSQL	KISDIQSQL
ALKKNLEKI	ALKKNLEKI
PDPKLLEKV	PDPKLLEKV
KVPEYIKKA	KVPEYIKKA
RTMENLVEL	RTMENLVEL
KQIKEIKEV	KQIKEIKEV
SVIRDIGAI	SVIRDIGAI
NIIPVIAKA	NIIPVIAKA
QVVDHIDSL	QVVDHIDSL
RIPDIVLWPT	RIPDVLWPT
QDGQFSVLFTK	GQFSVLFTK
VVPDSAHKL	VVPDSAHKL
KVFFDLMREI	KVFFLMREI
RVPELLHRL	RVPELLHRL
KLFGHLTSA	KLFGHLTSA
LVAEHLDHL	LVAEHLDHL
KVVDEEAMEKV	KVVDAMEKV
DTNADKQL	-DTNADKQL
FIAPTGHSL	FIAPTGHSL
QLYPENSEQL	QLYPNSEQL
KTAEFLSKL	KTAEFLSKL
YQVEGMEWL	YQVEGMEWL
SQFSGKITV	SQFSGKITV
IQKEDVPSE	IQKEDVPSE
TVPKPDVVVQV	TVPKPDVVV
AQIRTIAII	AQIRTIAII
YLPYPIHQV	YLPYPIHQV
RMKDALDYL	RMKDALDYL
VVSPVNVHI	VVSPVNVHI
YLSGIAHFL	YLSGIAHFL
YIYHGTVKL	YIYHGTVKL
LLPEDSQKL	LLPEDSQKL
YVADLGDIL	YVADLGDIL
LAYSGKLEEL	LAYSKLEEL
AVAEEALVDHV	AVAELVDHV
ITKEHIQAL	ITKEHIQAL
QIADIVTSV	QIADIVTSV
VVAAAAAEAK	VVAAAAAEA
AVIGDVIRV	AVIGDVIRV
TVMGRIATL	TVMGRIATL
LVTHLVTKL	LVTHLVTKL
NIFPSNLVSA	NIFPNLVSA
SISSIDREL	SISSIDREL
YVVAKLDDL	YVVAKLDDL
NVIDNLIVA	NVIDNLIVA
HVPSTDLILNV	HVPSTDLIL
YMAELIERL	YMAELIERL
YIPRTLNEV	YIPRTLNEV
ALKDEVQEL	ALKDEVQEL
KIFTDIFHYL	KIFTIFHYL
NIPSFIVRL	NIPSFIVRL
RAIPELTKL	RAIPELTKL
AVFPFQPGSV	AVFPQPGSV
SVIEAHEQL	SVIEAHEQL
SQHDLSQSAFL	SQHDLSQSA
TVFKNVDLL	TVFKNVDLL
YVAPHLNNL	YVAPHLNNL
AIPDIINEI	AIPDIINEI
AVFPFQQVSL	AVFPQQVSL
STVDAEAVHKL	VDAEAVHKL
TMAKESSIIGV	MAKESIIGV
YLVEDIQHI	YLVEDIQHI
LLKQKMDEL	LLKQKMDEL
TVIKLIERL	TVIKLIERL
HVFDLIQEL	HVFDLIQEL
FIFSEGVERA	FIFSGVERA
AVAAELVSA	AVAAELVSA
ATAPQTQHV	ATAPQTQHV
RVVGTIDQL	RVVGTIDQL
KQKEHLDTL	KQKEHLDTL
FVVHITDVL	FVVHITDVL
SLPDIKVYL	SLPDIKVYL
NQIKKIENLE	NQIKKIENL
FAFESDLHSL	FAFEDLHSL
RTFDRALRAL	RTFDALRAL
HQAVIAEQL	HQAVIAEQL
IVKEVEAKA	IVKEVEAKA
IQYELTDRL	IQYELTDRL
GVVNKPATFTV	VVNKATFTV
YVKEELHQL	YVKEELHQL
GTKALMDEV	GTKALMDEV
GVTNFIHML	GVTNFIHML
RVADRLYGV	RVADRLYGV
FIADAHEKI	FIADAHEKI
NVPKFGLAHL	NVPKGLAHL
DVNAAIATIK	DVNAAIATI
GVFTRDIQRA	GVFTDIQRA
GRLASLNLR	GRLASLNLR
FTYHHIQEI	FTYHHIQEI
FLIRESETL	FLIRESETL
TVIENIHTII	TVIENIHTI
YGSHIQALL	YGSHIQALL
QIADLQQKL	QIADLQQKL
TDAPSFSDIPN	TDAPSFSDI
KLYDIDVAKV	KLYDDVAKV
LQTEIKNQL	LQTEIKNQL
MVAEILHHL	MVAEILHHL
LFNKQLESI	LFNKQLESI
TQESVFATV	TQESVFATV
SQFDEELYKV	SQFDELYKV
FIPLPSAVVQA	PLPSAVVQA
GVPVTITSV	GVPVTITSV
FQYAKESYI	FQYAKESYI
RVFKQFVQA	RVFKQFVQA
FLKNELDNV	FLKNELDNV
NLKEAIETI	NLKEAIETI
TIIDTKGVTAL	TIIDKGVTA
SVADLAHVL	SVADLAHVL
FTIGEAITSA	FTIGAITSA
SMYGVDLHHA	SMYGDLHHA
EQADFYRTV	EQADFYRTV
FIISRTQAL	FIISRTQAL
ISSSSFSR	-ISSSSFSR
LLKEYLVTL	LLKEYLVTL
SQPALWHTV	SQPALWHTV
IVIGIIKTV	IVIGIIKTV
KLPGNISSL	KLPGNISSL
AVNDFELARA	AVNDELARA
SLPSFSEKL	SLPSFSEKL
RVFEVSLADL	RVFESLADL
FVNPKFEHL	FVNPKFEHL
LLAEVIENL	LLAEVIENL
FVKEHFDEL	FVKEHFDEL
KIFDENELELL	KIFDNELEL
SVAGSVERV	SVAGSVERV
ETPKNELYN	ETPKNELYN
GVIPTLVKL	GVIPTLVKL
KLIKGVERL	KLIKGVERL
FLPSHSLDTV	FLPSSLDTV
TVVMYLHHV	TVVMYLHHV
NQAEPREFL	NQAEPREFL
STIQKIKEA	STIQKIKEA
KQFEPNDFYL	KQFENDFYL
KLPEFYDETL	KLPEYDETL
TVYGGSDEL	TVYGGSDEL
FQAHKEAIREA	AHKEAIREA
RLYPAFMEGI	RLYPFMEGI
EVISKLYAV	EVISKLYAV
TQAEQAAQL	TQAEQAAQL
SQFGPIERA	SQFGPIERA
YQIVPSHKL	YQIVPSHKL
IQAGLLSAL	IQAGLLSAL
FQAAEGHDL	FQAAEGHDL
SLISGIIRA	SLISGIIRA
KLADIQIEQL	KLADQIEQL
AVFPSQVNVA	AVFPSQVNV
LPAAAAAAAAA	AAAAAAAAA
TAFQEALDAA	TAFQALDAA
KLFPHHIGEL	KLFPHIGEL
IQAEHSESGQL	IQAEHSESG
RVAPEEHPVLL	RVAPEEHPV
KTFSYPLDLL	KTFSPLDLL
YASGINVNL	YASGINVNL
AVADLQTRL	AVADLQTRL
RLFTEKILRA	RLFTKILRA
LQVEEVHQL	LQVEEVHQL
KVIESTQDL	KVIESTQDL
SVAPFDQNL	SVAPFDQNL
EESNYELEGK	---ESNYEL
SGITRVEKA	SGITRVEKA
KVKDDVDKL	KVKDDVDKL
AQIEAQNRL	AQIEAQNRL
HVIGQLDKL	HVIGQLDKL
HTVGELIEV	HTVGELIEV
NQIKKIENL	NQIKKIENL
TTYKLVINGK	TTYKLVING
SLFYRDIISI	SLFYDIISI
KIAPNTPQL	KIAPNTPQL
SVKEQMDQI	SVKEQMDQI
FAAPEKDIFL	AAPEKDIFL
YVAPAYGVYL	YVAPYGVYL
TIKETADEL	TIKETADEL
YVAEAEEKL	YVAEAEEKL
LTAPEDVFSKL	TAPEVFSKL
GVIDLIFEKA	GVIDIFEKA
IQEEEDEKQRL	IQEEEKQRL
NQIGDAGVQHL	QIGDGVQHL
SIPDFPMHLA	SIPDPMHLA
AVKEFLEKL	AVKEFLEKL
SVPEAQSAL	SVPEAQSAL
FQVDIPEHLI	FQVDIPEHL
NEEVVLNDVMI	EVVLNDVMI
QQNGSVVRV	QQNGSVVRV
KLMELLEEI	KLMELLEEI
GQSALYDAL	GQSALYDAL
AVIGTRLHAA	AVIGRLHAA
STGPQPVTV	STGPQPVTV
NQSMLFDKL	NQSMLFDKL
RVIDDSLVVGV	RVIDDSLVV
EQSDLVHRI	EQSDLVHRI
KVFEHDSVEL	KVFEDSVEL
KQYGITGENV	KQYGTGENV
NVVLEIPAA	NVVLEIPAA
RVPETVADA	RVPETVADA
ILAAIVNHL	ILAAIVNHL
KVFNGEGEQI	KVFNEGEQI
YLITLLEHL	YLITLLEHL
YIIKDLEKL	YIIKDLEKL
RVFIGNLNTAI	RVFINLNTA
YLSEEVQAV	YLSEEVQAV
VVIGSIRHV	VVIGSIRHV
LLREKVEFL	LLREKVEFL
AVPKEGKVVDA	AVPKEGKVV
TVFGNLHQA	TVFGNLHQA
YIKRLLETL	YIKRLLETL
RIADLSYTV	RIADLSYTV
VPGEIVESL	VPGEIVESL
GLVPFLVSV	GLVPFLVSV
AQYSGAQVRV	AQYSAQVRV
SLVENIERL	SLVENIERL
LVPEFVHSI	LVPEFVHSI
AQAEAAEQL	AQAEAAEQL
YQFSKNFSL	YQFSKNFSL
KVKEFLSTL	KVKEFLSTL
FLPTILNQL	FLPTILNQL
KIPNTVEEA	KIPNTVEEA
AVIREIQNA	AVIREIQNA
TTYEGIFKTL	TTYEIFKTL
RLYDTHITVL	RLYDHITVL
SVIEQGGIQTV	SVIEGIQTV
AASPIITLV	AASPIITLV
SVIKVKIHEA	SVIKKIHEA
YENEVALR	-YENEVALR
FVAETSQRI	FVAETSQRI
RLMNDMTAV	RLMNDMTAV
VLYGDVEEL	VLYGDVEEL
QVYRGALQKV	QVYRALQKV
KVVTIIPKI	KVVTIIPKI
MIFVDNFVHA	MIFVNFVHA
AVANIVNSV	AVANIVNSV
AVYSQFITQL	AVYSFITQL
KIGDFGLATV	KIGDGLATV
AVAQLAQEL	AVAQLAQEL
SIPELQNFL	SIPELQNFL
VPQLEIVPN	VPQLEIVPN
YIPQIVQAL	YIPQIVQAL
VQSGIKVRL	VQSGIKVRL
SLPDHHEEL	SLPDHHEEL
APAAAAAAAAA	AAAAAAAAA
AIFPTPDPAAL	AIFPTPDPA
FLIQEIKTL	FLIQEIKTL
LGAEVYHTL	LGAEVYHTL
FVNEIISRI	FVNEIISRI
SQITSLVTL	SQITSLVTL
FSEGLIKA	-FSEGLIKA
SIAEQAHEL	SIAEQAHEL
AIFEYIDRL	AIFEYIDRL
YIGPDTPAL	YIGPDTPAL
IASAIVNEL	IASAIVNEL
KTVQVIVQA	KTVQVIVQA
YLAHLAHHL	YLAHLAHHL
QSFDSSLHGA	QSFDSLHGA
FVIDLQTRL	FVIDLQTRL
RIKNKIAEL	RIKNKIAEL
KLVEYIVKA	KLVEYIVKA
NQYENAEKL	NQYENAEKL
EEAENTLQSFR	---EAENTL
YTIQSIERI	YTIQSIERI
RLAVYIDKV	RLAVYIDKV
TEDHEEAGPL	--TEDHEEA
AIIDHIFAS	AIIDHIFAS
MVAPDKDYFL	MVAPKDYFL
KVIYVLPML	KVIYVLPML
LTNDWEDHL	LTNDWEDHL
KVIEDVAFA	KVIEDVAFA
ADVDAATLAR	ADVDAATLA
GLADITQQL	GLADITQQL
SVAESLNYV	SVAESLNYV
VLIKTAEEL	VLIKTAEEL
YIAHLRQIL	YIAHLRQIL
WVYPFLEHI	WVYPFLEHI
SQPDLLHQL	SQPDLLHQL
NASPVISSV	NASPVISSV
RAYDASLAML	RAYDSLAML
TSFNYAMKEA	TSFNAMKEA
TIVDALDTL	TIVDALDTL
YLSDIPLHDA	YLSDPLHDA
SMISKLKQA	SMISKLKQA
ITFPGLHEL	ITFPGLHEL
VQFEHGYRL	VQFEHGYRL
SVYPTQEEL	SVYPTQEEL
KVIQEIWPVL	KVIQEIWPV
TVADVDEKA	TVADVDEKA
FQSKENLSV	FQSKENLSV
FVADILKGENL	FVADILKGE
KVSELKEEL	KVSELKEEL
RVFNFDSVEL	RVFNDSVEL
VISPLNQLL	VISPLNQLL
HTIPVIQRA	HTIPVIQRA
RQYPWGTVQV	RQYPGTVQV
ALTHIDHSL	ALTHIDHSL
VPPFLQPE	-VPPFLQPE
KMAEMLVEL	KMAEMLVEL
RVNETTEFL	RVNETTEFL
HIPDVITYL	HIPDVITYL
VQSGLRILL	VQSGLRILL
TVKNIMDSV	TVKNIMDSV
ELFPAPILRA	ELFPPILRA
SQSELENRL	SQSELENRL
LVYDQQREVYV	LVYDQQREV
AQIGSYVHV	AQIGSYVHV
LTSVINQKL	LTSVINQKL
YIYNEKIVNG	YIYNKIVNG
KLIDRTESL	KLIDRTESL
STVEKLYAA	STVEKLYAA
RVPDFILEKI	RVPDILEKI
GAFSDHMALL	GAFSHMALL
YQNQEIHNL	YQNQEIHNL
KSVDFIEKA	KSVDFIEKA
MLVPVIEKL	MLVPVIEKL
RVADGLPLA	RVADGLPLA
FLPSANEHL	FLPSANEHL
RVYGGLTTKV	RVYGLTTKV
ATSGLDHQL	ATSGLDHQL
LIPKFVSFL	LIPKFVSFL
MVVDIVQEL	MVVDIVQEL
VTVENVQEL	VTVENVQEL
SISPIVLYL	SISPIVLYL
GVAPSRAIYFA	VAPSAIYFA
YVTEELPQL	YVTEELPQL
LLKDSIVQL	LLKDSIVQL
KIAEGVNSL	KIAEGVNSL
FLVPIESIERA	LVPISIERA
YQYPRPLLI	YQYPRPLLI
FLAKLIAQA	FLAKLIAQA
YTSESGDRL	YTSESGDRL
YIPEITSVL	YIPEITSVL
IQHDLIFSL	IQHDLIFSL
RIYPHGLVLL	RIYPGLVLL
ATSDLNIKV	ATSDLNIKV
KLIDKLDSL	KLIDKLDSL
YAVELFEGL	YAVELFEGL
SAFGASHHV	SAFGASHHV
YLPEADSILFL	YLPEADSIL
VLENAEGAR	VLENAEGAR
AAAAAVDPH	AAAAAVDPH
LLAEENQRL	LLAEENQRL
SIYPKSELL	SIYPKSELL
SLITRLLEV	SLITRLLEV
SQIPAQPSV	SQIPAQPSV
VIINQIYEA	VIINQIYEA
RTYKNSEEL	RTYKNSEEL
RVVDYLTKL	RVVDYLTKL
SIIQRLLEV	SIIQRLLEV
FSVSPQAVYTA	SVSPAVYTA
ITPQTIHGV	ITPQTIHGV
TTPERIAQI	TTPERIAQI
QQIKELEKL	QQIKELEKL
QVFDAKNMMAA	QVFDKNMMA
AKNKLNDLED	-AKNKLNDL
STIKTLEEA	STIKTLEEA
GQAFLYHQV	GQAFLYHQV
YMFPDTMLQA	YMFPTMLQA
ILKFGAEEL	ILKFGAEEL
SAPVGVTAL	SAPVGVTAL
YSFHKFHYL	YSFHKFHYL
VEIIANDQGNR	IIANDQGNR
RQIEYYFSV	RQIEYYFSV
LMVDHVTEV	LMVDHVTEV
AQAEIEQYRL	AQAEEQYRL
AAFGRDLFLA	AAFGRDLFL
SQADFAEKL	SQADFAEKL
FIFSDTHEL	FIFSDTHEL
ALYAVIEKA	ALYAVIEKA
FVPEPSSTMGL	FVPEPSSTM
VGEFSGANK	VGEFSGANK
RLPETVHTA	RLPETVHTA
KAIDLVTKA	KAIDLVTKA
NIIEAINEL	NIIEAINEL
KLPDFLTAKL	KLPDLTAKL
NTPEYMEKI	NTPEYMEKI
AIEHLDKI	-AIEHLDKI
FQVEHFSQEEL	FQVESQEEL
KQAEILQES	KQAEILQES
ALVQDLAKA	ALVQDLAKA
YQILDGIHYL	YQILGIHYL
ISPSRTEAL	ISPSRTEAL
VQLGYSVLS	VQLGYSVLS
KQIESDRQNLL	KQIEDRQNL
GVNPHVNHL	GVNPHVNHL
TVIDQIPFL	TVIDQIPFL
YLSAKVEAL	YLSAKVEAL
FGYDHLILNV	FGYDLILNV
KLFKDDMEKL	KLFKDMEKL
RVFNRPRIETL	RVFNRIETL
KTFPEIIDYL	KTFPIIDYL
GILDRTISV	GILDRTISV
MVPPNIAEL	MVPPNIAEL
FVYPLDFART	FVYPDFART
LMEHIHKL	-LMEHIHKL
SIAEVVHQL	SIAEVVHQL
SVANADIINAA	SVANDIINA
KVKDWVERL	KVKDWVERL
NVASIQNYL	NVASIQNYL
FQANEVRKV	FQANEVRKV
FTAKQLEKL	FTAKQLEKL
TVPEHIQQL	TVPEHIQQL
ALIPVINKL	ALIPVINKL
TTFQDELIRA	TTFQELIRA
VISGINEKL	VISGINEKL
SQVGFIDYI	SQVGFIDYI
KQAGLVSKI	KQAGLVSKI
AQAKIYWNL	AQAKIYWNL
RAFGGKDIKV	RAFGKDIKV
QQIKKLEEL	QQIKKLEEL
LQIKHTQAL	LQIKHTQAL
IIIDSVPEV	IIIDSVPEV
QVPETIETL	QVPETIETL
RTVGTPIASV	TVGTPIASV
NQPEYIQKL	NQPEYIQKL
TMVGEIASA	TMVGEIASA
YLIPLLERL	YLIPLLERL
TTIEAIHGL	TTIEAIHGL
GQSKVFFRA	GQSKVFFRA
YVVDTGMVKA	YVVDGMVKA
TVAEISQFL	TVAEISQFL
YVSEILEKV	YVSEILEKV
QQSSIHNVL	QQSSIHNVL
GVIDLVFEKA	GVIDVFEKA
VVYLQKLDTA	VVYLKLDTA
STIDFLDRA	STIDFLDRA
IIAQIVQKL	IIAQIVQKL
YTPEHHLIQA	YTPEHLIQA
SVSHITQHL	SVSHITQHL
FLPDGMEARL	FLPDMEARL
TAMDVVYAL	TAMDVVYAL
YVADLVHSA	YVADLVHSA
FLSDLRDML	FLSDLRDML
NAAPRIALHTA	AAPRALHTA
LLIPGLATA	LLIPGLATA
SQAPFIVAL	SQAPFIVAL
GQFPSYLETV	GQFPYLETV
FGVPLIVHV	FGVPLIVHV
SIVQDIKRA	SIVQDIKRA
TVMDSKIVQV	TVMDKIVQV
KTAVAIEKV	KTAVAIEKV
SVVESVFKL	SVVESVFKL
STVGEIVNL	STVGEIVNL
VLKVFLENV	VLKVFLENV
GPSSVEDIK	GPSSVEDIK
IQAEHSYSL	IQAEHSYSL
AQIKVTKEL	AQIKVTKEL
FQSEEQQQ	-FQSEEQQQ
AQAEVYKELR	AQAEVYKEL
KTIDYIQFL	KTIDYIQFL
RIAEFTTNL	RIAEFTTNL
GTYADYLAEA	GTYAYLAEA
KVSELVQFL	KVSELVQFL
YQVGVHYEL	YQVGVHYEL
FIIGPGGVVNL	IIGPGVVNL
GVVDGIYRL	GVVDGIYRL
QLVDIIEKV	QLVDIIEKV
KLILLITQV	KLILLITQV
TVFDEAIRAV	TVFDAIRAV
TLIRSIPTM	TLIRSIPTM
MVPEDVPRL	MVPEDVPRL
AVVTQVNKV	AVVTQVNKV
KLFEKVKEV	KLFEKVKEV
SVSDLADKL	SVSDLADKL
AIISKLVAL	AIISKLVAL
FQSFQDHKL	FQSFQDHKL
GVISKVSTL	GVISKVSTL
KLFEGENEHL	KLFEENEHL
LQFTPQHKL	LQFTPQHKL
YSFSRKITEA	YSFSKITEA
TAFDEAIAEL	TAFDAIAEL
SQFGTEHVL	SQFGTEHVL
SIPTTIYKA	SIPTTIYKA
LLIENVASL	LLIENVASL
SQIDQQNSV	SQIDQQNSV
RQADFVQVL	RQADFVQVL
FVAPPGNISL	FVAPGNISL
SVYGKLRKV	SVYGKLRKV
YTSRIVVRL	YTSRIVVRL
ALIRVISKL	ALIRVISKL
SQFGTVEKA	SQFGTVEKA
AAAAAAAVTAA	AAAAAVTAA
YVTELAELI	YVTELAELI
IVVGRITEV	IVVGRITEV
KVAELFEKL	KVAELFEKL
LAAARLAAA	LAAARLAAA
SVIEQIVYV	SVIEQIVYV
QTYGQQLQKA	QTYGQLQKA
KVGPVPVLV	KVGPVPVLV
FAFTNKITSV	FAFTKITSV
FMIKHSQKL	FMIKHSQKL
RIFQEQVEKL	RIFQQVEKL
AVFQKQMDSL	AVFQQMDSL
MIIENFEAL	MIIENFEAL
HVGIHPSKV	HVGIHPSKV
SVAPKNALVQL	SVAPKNALV
NMVAKVDEV	NMVAKVDEV
FGIDRDAIAQA	FGIDRDAIA
KIIDEDGLLNL	KIIDEDGLL
KVFPSEITDTV	KVFPITDTV
KVVEDIEYL	KVVEDIEYL
LQAHYEDFL	LQAHYEDFL
HQADIGEYV	HQADIGEYV
KQADLYISEGL	KQADLYISE
YQPDWRFMES	YQPDRFMES
YIFEGLGHLI	YIFEGLGHL
WLANEGLITRL	LANELITRL
FVAPLQEKV	FVAPLQEKV
SQIQRLIVA	SQIQRLIVA
MLIEDVDAL	MLIEDVDAL
FVPDLKELL	FVPDLKELL
YTYEELLNRV	YTYELLNRV
QTISALIKA	QTISALIKA
RISTINILL	RISTINILL
NTKEVIDRL	NTKEVIDRL
FVHPGAATV	FVHPGAATV
QVIPQIQSA	QVIPQIQSA
FASGLIHRV	FASGLIHRV
KASAISIKL	KASAISIKL
YTAEIKQNL	YTAEIKQNL
RIFYPEIEEV	RIFYEIEEV
YLKDLIEEV	YLKDLIEEV
SQITKIPIL	SQITKIPIL
SQITAIEAQHL	ITAIEAQHL
ATVEEVDAA	ATVEEVDAA
ILSELVEKI	ILSELVEKI
SIAPIVIFA	SIAPIVIFA
ITQIEHEVSSS	TQIEEVSSS
IQSSISGVTA	IQSSSGVTA
QAADLAYQL	QAADLAYQL
KIFQEALVQI	KIFQALVQI
YTAPTAIRL	YTAPTAIRL
RQADKVWRL	RQADKVWRL
KQFEGTVEI	KQFEGTVEI
QIVELIEKI	QIVELIEKI
STFGELKTV	STFGELKTV
VLAFLVHEL	VLAFLVHEL
RQADVEYEL	RQADVEYEL
QQIGKVVQV	QQIGKVVQV
AADIDHKL	-AADIDHKL
GLAHFVNEI	GLAHFVNEI
SAAELNYGL	SAAELNYGL
IIAPPERK	-IIAPPERK
SIIHEIDSI	SIIHEIDSI
AVSRVLNKL	AVSRVLNKL
SQFPTPEAV	SQFPTPEAV
AAADITSSL	AAADITSSL
KITDLQNQL	KITDLQNQL
AVISHIDQT	AVISHIDQT
NQFPGFKEV	NQFPGFKEV
YIYDKDMEIIA	YIYDKDMEI
LVVEHIEKM	LVVEHIEKM
KQSEEHNML	KQSEEHNML
TLFAGAHEL	TLFAGAHEL
ILYGEVEKL	ILYGEVEKL
ITAIEAQHL	ITAIEAQHL
LMKDLADEL	LMKDLADEL
LVPQNNEKL	LVPQNNEKL
MQISFIHQL	MQISFIHQL
FVYEMESHAI	FVYEMESHA
YVTEKVLAA	YVTEKVLAA
QLIRDMVNV	QLIRDMVNV
VLAGHDNRV	VLAGHDNRV
NIFGEELERL	NIFGELERL
YVFSHNHKL	YVFSHNHKL
GVFTRDINKA	GVFTDINKA
SVADLAESI	SVADLAESI
YIMSYISRV	YIMSYISRV
IVVGDIAQV	IVVGDIAQV
YLNDFTHEI	YLNDFTHEI
SVIDPPAVNLA	SVIDPAVNL
YSAAILEYL	YSAAILEYL
AQAPIAAVL	AQAPIAAVL
VVADFGLARL	VVADGLARL
SLPEIDNAL	SLPEIDNAL
HVYDGKFLARV	HVYDFLARV
NQIESKAAYV	NQIEKAAYV
FLYTGEGDTV	FLYTEGDTV
LLSEIEEHL	LLSEIEEHL
SVIGVSPAV	SVIGVSPAV
KVAEKLEAL	KVAEKLEAL
FVVYENVSHFL	VVYEVSHFL
RIQSKLYRA	RIQSKLYRA
LLPEELTPL	LLPEELTPL
FLPKKLDEA	FLPKKLDEA
GLVKRLHKV	GLVKRLHKV
KVIDVDHGI	KVIDVDHGI
RQPSLFYHL	RQPSLFYHL
AAAPTANLL	AAAPTANLL
NVFDEAILAA	NVFDAILAA
FVDDYTVRV	FVDDYTVRV
KAADIDQEV	KAADIDQEV
GTIKKINIL	GTIKKINIL
SVAPFADYL	SVAPFADYL
AQAEDYSQL	AQAEDYSQL
LLSPSNEKL	LLSPSNEKL
YVASNQHEV	YVASNQHEV
FIINGSEKV	FIINGSEKV
KAFNIRLEEL	KAFNRLEEL
QIFNGTFVKL	QIFNTFVKL
ALKPDLVNV	ALKPDLVNV
GTKNRIITA	GTKNRIITA
YQAQHDDEL	YQAQHDDEL
KVFSGALQEAL	KVFSALQEA
RIPSFVTEL	RIPSFVTEL
LSADIFQQV	LSADIFQQV
KIVDFSYSV	KIVDFSYSV
GGIDIYHLL	GGIDIYHLL
VLFGLLREV	VLFGLLREV
RTAGHMQTL	RTAGHMQTL
RTPPPELLQTL	TPPPLLQTL
FTAPKEIAEI	FTAPEIAEI
YQHKEEYQL	YQHKEEYQL
KMIEAIKES	KMIEAIKES
SVYDGHGGEEV	SVYDGGEEV
LLRLQVEEL	LLRLQVEEL
VVVDPIQSV	VVVDPIQSV
SQADVHRQI	SQADVHRQI
SVVHLYELL	SVVHLYELL
IIPNFSLDKI	IIPNSLDKI
KTVAQSQQL	KTVAQSQQL
ILNEIVNFV	ILNEIVNFV
AVFPSIVGRPR	AVFPSIVGR
SLADIAQKL	SLADIAQKL
SVIRKIPAL	SVIRKIPAL
RLAALQHRL	RLAALQHRL
YQWDDPDPRL	YQWDPDPRL
FVADEELVHL	FVADELVHL
ASFNDTFVHV	ASFNTFVHV
RTIDIGVVTA	RTIDGVVTA
YAAPYKSDFL	YAAPKSDFL
IQSPHVAVL	IQSPHVAVL
SAFEDEIVSL	SAFEEIVSL
KVFSEKLDHL	KVFSKLDHL
GAADKSAVVAA	GAADKSAVV
RLAQHITYV	RLAQHITYV
AQALINRGV	AQALINRGV
YVSKYINYI	YVSKYINYI
FISDIANDAL	FISDANDAL
KLIPFLEKL	KLIPFLEKL
LIPEYLNFI	LIPEYLNFI
AAVRDISEA	AAVRDISEA
RLPEIYIQL	RLPEIYIQL
STSAIIDYL	STSAIIDYL
EVIKELAQI	EVIKELAQI
SLVDIYSQL	SLVDIYSQL
RVVDLLNQA	RVVDLLNQA
AQAFIHNSL	AQAFIHNSL
LLSSIVEEL	LLSSIVEEL
TVMDEIHTV	TVMDEIHTV
NVPDITTGL	NVPDITTGL
FIADQLDHL	FIADQLDHL
YLLESVNKL	YLLESVNKL
NTAPDDLIRYA	TAPDLIRYA
KVPDFPSKRL	KVPDPSKRL
YSKYYKTID	YSKYYKTID
GQFDRPAGV	GQFDRPAGV
YIPDLYNHFL	YIPDYNHFL
RVFIGNLNTL	RVFINLNTL
FQIDRSWKA	FQIDRSWKA
VQIPFFAKL	VQIPFFAKL
AVFKELVKL	AVFKELVKL
TMIGEIAAA	TMIGEIAAA
ILKEHITQL	ILKEHITQL
VQIEHISSL	VQIEHISSL
AVTPLNESL	AVTPLNESL
YQALALWKL	YQALALWKL
KVVALVHAV	KVVALVHAV
RVIEGDVVSA	RVIEDVVSA
SLFGNIKGA	SLFGNIKGA
KTPIESLFIEA	TPIELFIEA
SAPKYIDYL	SAPKYIDYL
RLFDRGDFYTA	RLFDDFYTA
YLFDEIDQAL	YLFDEIDQA
YIYDKDMEII	YIYDKDMEI
HVLDVIHEV	HVLDVIHEV
LLPDIISRL	LLPDIISRL
KLPDFESRYV	KLPDESRYV
KTTTIAVEV	KTTTIAVEV
SQADVHRQV	SQADVHRQV
YLPEVKDLL	YLPEVKDLL
LSMDDEIQKL	LSMDEIQKL
ILKKVLEAL	ILKKVLEAL
HVYSGKDLI	HVYSGKDLI
YGAEALERMFL	YGAEALERM
NVAAVDTNL	NVAAVDTNL
RLKPALETL	RLKPALETL
FQPPIHQSL	FQPPIHQSL
NQAIIKHLL	NQAIIKHLL
NQAVILYHL	NQAVILYHL
VLSDIIQNL	VLSDIIQNL
YVFDVESREL	YVFDESREL
KIIDRAITSL	KIIDAITSL
HVAPQQNAL	HVAPQQNAL
FIPEKEVVQA	FIPEEVVQA
YASPDLSKL	YASPDLSKL
SIASPDVKL	SIASPDVKL
ALMDEVVKA	ALMDEVVKA
SVKEQMETI	SVKEQMETI
KVSESTHVL	KVSESTHVL
SLKEDIQKA	SLKEDIQKA
SLFNGSHYL	SLFNGSHYL
HVKEQLETL	HVKEQLETL
STIKEVAQA	STIKEVAQA
ATIQKIPRL	ATIQKIPRL
NAFLLPIKTV	NAFLPIKTV
LTGQRVLDAL	LTGQVLDAL
QAFSDVILAV	QAFSVILAV
QVIEGISRL	QVIEGISRL
LVIDAVREI	LVIDAVREI
NQIPTVNNL	NQIPTVNNL
LISDLEHRL	LISDLEHRL
YQYTSPDFL	YQYTSPDFL
QLAQFVHEV	QLAQFVHEV
FITEDKTEL	FITEDKTEL
AQSRIALAL	AQSRIALAL
FLSSVIQNL	FLSSVIQNL
KLFPGFEIETV	KLFPEIETV
AVANEEGFVRL	VANEGFVRL
RVIEGDVVSAL	RVIEDVVSA
ITVGPVQKL	ITVGPVQKL
ITFESIEKA	ITFESIEKA
AVPEKIGQV	AVPEKIGQV
RAIELLEKL	RAIELLEKL
AVSAQVEEL	AVSAQVEEL
KQSSVMQRL	KQSSVMQRL
RTIGVITKL	RTIGVITKL
KTPDFESTGL	KTPDESTGL
TVVKAISGV	TVVKAISGV
SVTTVNKKL	SVTTVNKKL
YTYEKLLWTT	YTYELLWTT
SVPGRGTVVTG	SVPGRGTVV
RTPENHENL	RTPENHENL
NAAAIYDLL	NAAAIYDLL
FILEKIEYL	FILEKIEYL
AVFDDDMEQL	AVFDDMEQL
YTVEDIQRL	YTVEDIQRL
LLIDELNKL	LLIDELNKL
QDVDNASLAR	QDVDNASLA
QVGPQIPRA	QVGPQIPRA
ITVGDIAQV	ITVGDIAQV
LLGPRLVLA	LLGPRLVLA
FVVDLSDQV	FVVDLSDQV
AIFPFNIHEN	AIFPNIHEN
LTSELITHI	LTSELITHI
RVIEEAKTAFL	RVIEEAKTA
YVIESDEDL	YVIESDEDL
NQSKIRVTL	NQSKIRVTL
LQSVISHLL	LQSVISHLL
ILMEHIHKL	ILMEHIHKL
VAAPYIAKA	VAAPYIAKA
FIINGIEKV	FIINGIEKV
YIPYEAGTYSL	IPYEGTYSL
AAPEGKRSL	AAPEGKRSL
KQAEIVKRL	KQAEIVKRL
ITHDIEEKGV	ITHDIEEKG
ALSPNNHEV	ALSPNNHEV
YIITEIPSL	YIITEIPSL
AQYPSEHLI	AQYPSEHLI
MTIENMNHL	MTIENMNHL
YIFPAGGDGL	YIFPGGDGL
FVVDIESRL	FVVDIESRL
YVIDSTDEERL	YVIDSTDEE
AQILELPYA	AQILELPYA
YTYDEAIHSV	YTYDAIHSV
HLPSDFTPAV	HLPSFTPAV
RIIDEEGVESI	RIIDGVESI
RLAEVVHEL	RLAEVVHEL
FLFEDFSKA	FLFEDFSKA
YQGEGAHHI	YQGEGAHHI
DQVANSAFVER	QVANAFVER
ALFPGDVDRL	ALFPDVDRL
GVGPVPARA	GVGPVPARA
FIPPDGNFRL	FIPPGNFRL
VVAPSIIAA	VVAPSIIAA
PAASAAAALAP	AASAAAALA
YIPDGHTKEM	YIPDHTKEM
LEDALQQAKED	-LEDALQQA
KTFEDNLIEA	KTFENLIEA
AQIDHYLGL	AQIDHYLGL
SQATALAKL	SQATALAKL
SVSKLIHYV	SVSKLIHYV
SIPDIEQPNV	SIPDEQPNV
IQYIPTELDQV	YIPTELDQV
YASENVNKL	YASENVNKL
FIAPSGHGL	FIAPSGHGL
SVAPLVDHL	SVAPLVDHL
SLFAGGMLRV	SLFAGMLRV
KVFEHFLENL	KVFEFLENL
VVNETVEKL	VVNETVEKL
SLANETHQL	SLANETHQL
TLIDLPGITKV	TLIDGITKV
SQTSVAERL	SQTSVAERL
KLADFGLARAF	KLADGLARA
SVAGDALTRHL	SVAGDALTR
VAPFPEVFG	VAPFPEVFG
IVFPAGILQA	IVFPGILQA
MIIPSLEEL	MIIPSLEEL
SVISHLLRV	SVISHLLRV
IVADKDYSV	IVADKDYSV
LTKKLLDLV	LTKKLLDLV
YQAEINDLENL	AEINDLENL
VSKAQQLAEV	SKAQQLAEV
EVDDEALEK	EVDDEALEK
RSYDFEFMQV	RSYDEFMQV
KLISELQKL	KLISELQKL
FVSDKDTGL	FVSDKDTGL
ILRAILEVL	ILRAILEVL
AQIDSNIAHTV	AQIDNIAHT
KIPKKGFVEV	KIPKGFVEV
RLFTSEKMVKA	FTSEKMVKA
GVPSATEIIKA	GVPSATEII
HQAKDFGNYL	HQAKFGNYL
LQADLQNGL	LQADLQNGL
QVPEEQVLNAA	QVPEQVLNA
SLYDQAEKL	SLYDQAEKL
TLFQHQIIHA	TLFQQIIHA
SQSNMTQKV	SQSNMTQKV
SLAGDVALQQL	LAGDALQQL
SVAKTSQLL	SVAKTSQLL
KIIEENITSA	KIIENITSA
FIIQGLRSVGA	FIIQGLRSV
ALVDHVAEL	ALVDHVAEL
ALPRHLHTA	ALPRHLHTA
YVPETVYRV	YVPETVYRV
GQSELASRL	GQSELASRL
HQSGIVQLL	HQSGIVQLL
STYEEELAKA	STYEELAKA
KLKNVIHKI	KLKNVIHKI
KVPEWVDTV	KVPEWVDTV
SVPDTVHHV	SVPDTVHHV
HLFSGHLSTL	HLFSHLSTL
IVIDGLREL	IVIDGLREL
TVSPLFQKL	TVSPLFQKL
RVFENIVAVL	RVFENIVAV
HVSHLTEKL	HVSHLTEKL
RIMGNIWDA	RIMGNIWDA
LLAPIRVLL	LLAPIRVLL
SLIRNLEQL	SLIRNLEQL
YVITDLTQL	YVITDLTQL
AVASFKHAL	AVASFKHAL
GQSYVVNRV	GQSYVVNRV
TVFTDHMLTV	TVFTHMLTV
ATAPLISGV	ATAPLISGV
KIFHPNIDEA	KIFHNIDEA
KQAETIEKL	KQAETIEKL
LSVEIVHEL	LSVEIVHEL
SIAAFIQRL	SIAAFIQRL
LISPLVQLL	LISPLVQLL
QTYHAKLENA	QTYHKLENA
TIFTGHTAVV	TIFTHTAVV
TLKRQLDEV	TLKRQLDEV
ALADKELLPSV	ALADLLPSV
KVPEIISSI	KVPEIISSI
SIVNHLEFL	SIVNHLEFL
TISSNVASKA	TISSVASKA
YVKDRVEKV	YVKDRVEKV
KAVDAEPVLKA	KAVDAEPVL
FLSTLEHHL	FLSTLEHHL
IMPAFIFEHI	IMPAIFEHI
AAAAAAPAAPA	AAAAAAPAA
TIMPKDIQLA	TIMPKDIQL
GEVPLTPT	-GEVPLTPT
NIVEKLREV	NIVEKLREV
VVMETANRV	VVMETANRV
FLPETRIMTSV	FLPEIMTSV
KLFDDMMYEL	KLFDMMYEL
KAYNHHIQEL	KAYNHIQEL
KIIEKDAMIKV	KIIEKDAMI
FQIGKMRYV	FQIGKMRYV
KVKDILSKV	KVKDILSKV
KLFDTQQFL	KLFDTQQFL
LLTELSNSL	LLTELSNSL
AGYTDNLVRV	AGYTNLVRV
AVVETVTTA	AVVETVTTA
APSFSDIPNPI	SFSDIPNPI
SQSSIRTEA	SQSSIRTEA
VTWHGRGDYL	VTWHRGDYL
YQAPDIDVQL	YQAPIDVQL
YQAEIPDRL	YQAEIPDRL
RAADVLVYL	RAADVLVYL
FAYDGKDYI	FAYDGKDYI
FLPQKIIYL	FLPQKIIYL
LVSQLVHSL	LVSQLVHSL
ALFPAFIHQS	ALFPFIHQS
RLGPVPSGL	RLGPVPSGL
SQAEWREEV	SQAEWREEV
LQYSFPLQL	LQYSFPLQL
NVPEGLLATV	NVPELLATV
SVPGQTAVTAA	SVPGTAVTA
RQFQADLQTA	RQFQDLQTA
IQRTPKIQV	IQRTPKIQV
LYSEVKEVL	LYSEVKEVL
FQYESKVFYL	FQYEKVFYL
AVGPVHNSV	AVGPVHNSV
QLIDIIHTA	QLIDIIHTA
AIAPIIAAV	AIAPIIAAV
YLKEILEQL	YLKEILEQL
NIIELVHQV	NIIELVHQV
YAYDGKDYIAL	YAYDGKDYI
YISDGKEYL	YISDGKEYL
ALADGVQKV	ALADGVQKV
TTVGKGVTTV	TVGKGVTTV
TVISEDSVVKA	VISESVVKA
KTAAEDAIRNL	TAAEAIRNL
KLIESAEEL	KLIESAEEL
YQTPLHLAV	YQTPLHLAV
SVPNKDVFQEL	SVPNVFQEL
SVFDYSINSV	SVFDSINSV
TLKITLDNA	TLKITLDNA
AGAPARAVSAV	GAPAAVSAV
LLSPHSQVL	LLSPHSQVL
HVVDSPIINA	HVVDPIINA
KVFQGTDEQL	KVFQTDEQL
SVINEINKI	SVINEINKI
KVFELMTSL	KVFELMTSL
TMAIIVNKL	TMAIIVNKL
STIPGIQKI	STIPGIQKI
SQFPGAITL	SQFPGAITL
FTAEFLEKV	FTAEFLEKV
YTTDFIYQL	YTTDFIYQL
LQMEPDNVNAL	LQMEDNVNA
IQVQVFEKL	IQVQVFEKL
IVADTENLL	IVADTENLL
GAFGFQLKEV	GAFGQLKEV
KQIESDRQNL	KQIEDRQNL
FAYDGKDYLT	FAYDGKDYL
AAFQETLETL	AAFQTLETL
YIPEAILNL	YIPEAILNL
VVPPFLQPE	VVPPFLQPE
VLFTGLHVYL	VLFTLHVYL
VAVPLYDTL	VAVPLYDTL
YLNDLIHSV	YLNDLIHSV
KIFIDKIYSI	KIFIKIYSI
KMPEINAKV	KMPEINAKV
KVFPSISKL	KVFPSISKL
FVFPGELLL	FVFPGELLL
LLVGDVAQA	LLVGDVAQA
KLKPGDLVGV	KLKPDLVGV
KQFSENIYEA	KQFSNIYEA
MVPETTHEA	MVPETTHEA
TQTPVVVPPFL	QTPVVPPFL
FLVTVIHTL	FLVTVIHTL
MTKEELNAL	MTKEELNAL
SQMPVPVHV	SQMPVPVHV
AVASFVTQL	AVASFVTQL
SQAFISHHL	SQAFISHHL
VAAPQVQQV	VAAPQVQQV
VEELKPTPE	VEELKPTPE
KQMEKIQPA	KQMEKIQPA
AQYDPAKPNYI	YDPAKPNYI
SLKETIEEL	SLKETIEEL
LTADAHHYL	LTADAHHYL
RVIGTLEEV	RVIGTLEEV
KTVLELQYV	KTVLELQYV
LTKEKIEEL	LTKEKIEEL
AIIPYIPTL	AIIPYIPTL
TLADLVHHV	TLADLVHHV
AQIEGGVHGL	AQIEGVHGL
RAAAMANNL	RAAAMANNL
APFPEVFG	-APFPEVFG
QAYQHDLERL	QAYQDLERL
LLFPSDVQTL	LLFPDVQTL
RTPEAVQKL	RTPEAVQKL
SVFEGLERL	SVFEGLERL
VTIEDVQKL	VTIEDVQKL
QVFQGTNSL	QVFQGTNSL
AAVEKLHHL	AAVEKLHHL
RMFADDLHNL	RMFADLHNL
YGYDNVKEYL	YGYDVKEYL
KVYENDDQL	KVYENDDQL
YIIELNHMI	YIIELNHMI
YAFPLAHSL	YAFPLAHSL
KIKEGAENL	KIKEGAENL
SQYPFPVTL	SQYPFPVTL
FLIPIYHQV	FLIPIYHQV
IIVDIFHGL	IIVDIFHGL
SVVAIDNKI	SVVAIDNKI
STYDETLHVA	STYDTLHVA
SVAYLINTL	SVAYLINTL
QLVESLHKV	QLVESLHKV
SVVGNLHRL	SVVGNLHRL
SQAQTLHKV	SQAQTLHKV
LIAKINQRL	LIAKINQRL
LVASHLEKL	LVASHLEKL
IVPDKMQKA	IVPDKMQKA
IVISAAGIPNL	VISAGIPNL
HVIQALESL	HVIQALESL
SMKEELERV	SMKEELERV
LQIDNARLA	LQIDNARLA
VTQTHIAEA	VTQTHIAEA
RQFQELNEL	RQFQELNEL
FVADGIFKA	FVADGIFKA
SQSVIHNLL	SQSVIHNLL
IQAEEIMKL	IQAEEIMKL
GQSTVNHSL	GQSTVNHSL
RIIDTVAQV	RIIDTVAQV
TQADMGEKL	TQADMGEKL
ELEKRVME	-ELEKRVME
FVPEIFHRI	FVPEIFHRI
RVFGSQNLTTV	FGSQNLTTV
RLIGDAAKNQV	RLIGDAAKN
YVTPVNRNV	YVTPVNRNV
KIADFGFSNL	KIADGFSNL
GVYDGTEIHEA	GVYDEIHEA
AVIEAEKIAQV	AVIEKIAQV
SLSDTVEKL	SLSDTVEKL
ILAPTVQEL	ILAPTVQEL
VQADAPHGV	VQADAPHGV
KVIEELLQT	KVIEELLQT
NVIRLISSL	NVIRLISSL
SIPEINHRL	SIPEINHRL
LIPMIIHQL	LIPMIIHQL
GLAELGHRL	GLAELGHRL
AQIKEMVEL	AQIKEMVEL
KIIYIVHDEV	KIIYVHDEV
YQAKENDFDRL	QAKEDFDRL
LTAPLSQRL	LTAPLSQRL
NVIQSTAVTTV	IQSTAVTTV
IVMEHVVFL	IVMEHVVFL
TVKENLDQL	TVKENLDQL
SVANHNSFL	SVANHNSFL
YAFPKSITV	YAFPKSITV
FIPKFITHL	FIPKFITHL
NIFGPLVKL	NIFGPLVKL
KQYGNEVFL	KQYGNEVFL
AVPDEIPPLE	AVPDEIPPL
SQISRLQNI	SQISRLQNI
MVIDVLHPG	MVIDVLHPG
FLYQYSTRL	FLYQYSTRL
SVAKNGVIRA	SVAKGVIRA
TVTEKPEVIDA	TVTEKPEVI
LKERLTKI	-LKERLTKI
ALFPHLLQPVL	ALFPLLQPV
RQTEIYQYVL	RQTEIYQYV
RVAEHHVATL	RVAEHVATL
VQTEVNREL	VQTEVNREL
HVIEALRRA	HVIEALRRA
FVIETARQL	FVIETARQL
RIVDKLLAL	RIVDKLLAL
QVGPLPSRL	QVGPLPSRL
ATSYLSHQL	ATSYLSHQL
AQIKHLARL	AQIKHLARL
ITREMVEML	ITREMVEML
RLPPEGILHNV	RLPPILHNV
GVVEYIDTL	GVVEYIDTL
AVIKFLELL	AVIKFLELL
GQFSEVYKA	GQFSEVYKA
ATMERLEKV	ATMERLEKV
GQAEVLNFL	GQAEVLNFL
YQAHYGEQL	YQAHYGEQL
YLIKDIRFL	YLIKDIRFL
TVIHHVHSL	TVIHHVHSL
RSYDDQLAQI	RSYDQLAQI
SVIQNLRTV	SVIQNLRTV
STVEALQNL	STVEALQNL
YQTEIGQTL	YQTEIGQTL
AMFDHIPVGV	AMFDIPVGV
ALFTGGMKES	ALFTGMKES
YQIPTENSMTA	YQIPTENSM
KVFYTELLNL	KVFYELLNL
RVVTHELIHA	RVVTELIHA
KVPELIRTI	KVPELIRTI
GQTPVFSKA	GQTPVFSKA
SQMEKIVRI	SQMEKIVRI
VDAEAVHKL	VDAEAVHKL
VQTAIKSEL	VQTAIKSEL
TIANIPAAAV	TIANIPAAA
RQFPGSHRV	RQFPGSHRV
YTFSEPFHLI	YTFSEPFHL
LQAEEVARL	LQAEEVARL
HVIGQIIGA	HVIGQIIGA
TVYPGLMITA	TVYPLMITA
KVMDEVEKA	KVMDEVEKA
KIIDETMAQL	KIIDTMAQL
YQRELLETL	YQRELLETL
YQTPFNKEV	YQTPFNKEV
ITVEKIIKI	ITVEKIIKI
VADHIQKV	-VADHIQKV
SQYPFHVPLL	SQYPHVPLL
YVYEYLLHV	YVYEYLLHV
RTPDLYEKL	RTPDLYEKL
KVVVYLQKL	KVVVYLQKL
VLGPKIEAV	VLGPKIEAV
GVYGDVQRV	GVYGDVQRV
EITTLNHKL	EITTLNHKL
KIFEDIPTL	KIFEDIPTL
TIIDLPGITRV	TIIDGITRV
MTYWHLLNA	MTYWHLLNA
IVAPGKGILAA	IVAPKGILA
AIATELAQA	AIATELAQA
IIPAEIPLA	IIPAEIPLA
LVPETIHDEL	LVPEIHDEL
AVVNSLYKL	AVVNSLYKL
FQAEIAQLM	FQAEIAQLM
EQAHLWAEL	EQAHLWAEL
FTFPNIASA	FTFPNIASA
QVMKFIEKA	QVMKFIEKA
KIFTEDLPEV	KIFTDLPEV
SVIPQIQKV	SVIPQIQKV
RQIKNFHKL	RQIKNFHKL
TIPDFIFANV	TIPDIFANV
YIAPLKALV	YIAPLKALV
LSRSSALASKA	RSSALASKA
FDGHGGIRAS	FDGHGGIRA
LIPGFTPGL	LIPGFTPGL
VQFPSHYTL	VQFPSHYTL
KIADFGLARV	KIADGLARV
GVISRVEKI	GVISRVEKI
RLPEAIEEV	RLPEAIEEV
VLIGEFLEKV	VLIGFLEKV
ATSDLVNAI	ATSDLVNAI
LIIDENGVHEL	LIIDGVHEL
LLLPGELAK	LLLPGELAK
IISQVDAKV	IISQVDAKV
FINQDNNTL	FINQDNNTL
SSPQPGSAL	SSPQPGSAL
AVALEVQRL	AVALEVQRL
HVIKYLETL	HVIKYLETL
KVKEQLEAA	KVKEQLEAA
SIIGRLLEV	SIIGRLLEV
AAAAAPALAAA	AAAPALAAA
YQIGEKGAVKV	QIGEGAVKV
YQHYMADRL	YQHYMADRL
ILPEKVARV	ILPEKVARV
YSKEGWEYV	YSKEGWEYV
YIKTELISV	YIKTELISV
RVYEIDITDA	RVYEDITDA
FLPESMYERI	FLPEMYERI
YQSDFWQHL	YQSDFWQHL
ILFPDIIARA	ILFPIIARA
YLAHAIHQV	YLAHAIHQV
LTATSIDRL	LTATSIDRL
RVIDYILDL	RVIDYILDL
GVEVAVLRV	GVEVAVLRV
AVIDVGINRV	AVIDGINRV
ATAPDSQRL	ATAPDSQRL
DLIGVVEAL	DLIGVVEAL
AVITGAVVAA	AVITAVVAA
FASTILHLV	FASTILHLV
HQAQIDHYL	HQAQIDHYL
KTFEELEHV	KTFEELEHV
TVADKIHSV	TVADKIHSV
ETADITHAL	ETADITHAL
YVHMVTHFI	YVHMVTHFI
HVISADAIEAL	ISADAIEAL
YTYEEGLSHL	YTYEGLSHL
KLYQYYLDHL	KLYQYLDHL
KIIERLDHL	KIIERLDHL
RQSETYNYL	RQSETYNYL
NIPPLTQTPV	NIPPLTQTP
ALFQPHLINV	ALFQHLINV
SLFSHSLISI	SLFSSLISI
TVFGTALNYV	TVFGALNYV
FVVDHVIKI	FVVDHVIKI
SIYPLHDVFV	SIYPHDVFV
AVPEHAARL	AVPEHAARL
RIAELLTEL	RIAELLTEL
SVHKGFAFV	SVHKGFAFV
VTFSENHGV	VTFSENHGV
SVAVIHQSL	SVAVIHQSL
VIAPLTEEL	VIAPLTEEL
HTKEILDTA	HTKEILDTA
SIIKKLAAL	SIIKKLAAL
LDTNADKQL	LDTNADKQL
FISEFEHRV	FISEFEHRV
KIKATVEEL	KIKATVEEL
FTYDQDGESL	FTYDDGESL
KTKDIVNGL	KTKDIVNGL
QAEIVKRL	-QAEIVKRL
FQSSAVMAL	FQSSAVMAL
KAFQEGIAKA	KAFQGIAKA
DVIEVIEKA	DVIEVIEKA
AMMAKAEYL	AMMAKAEYL
FAYDGKDYLTL	FAYDGKDYL
RFFDGELTKV	RFFDELTKV
SQSSLIHLV	SQSSLIHLV
LIFPKEFETA	LIFPEFETA
VMFGGKQVVV	VMFGKQVVV
LVSPANQEL	LVSPANQEL
SLVKDVIGA	SLVKDVIGA
ALKDLINEA	ALKDLINEA
KVMGTFSTV	KVMGTFSTV
AIVDLIHDI	AIVDLIHDI
KVVDSLYNKA	KVVDLYNKA
GVFPDNFVKL	GVFPNFVKL
SIYNGDMEKI	SIYNDMEKI
TVMPEDLVEA	TVMPDLVEA
YQVDSRTYL	YQVDSRTYL
IDIIPNPQER	DIIPNPQER
AAGAGTGYFLF	AGAGTGYFL
FQVENDQERFL	FQVENDQER
EQAAWYHTL	EQAAWYHTL
WVAERVELL	WVAERVELL
PFPGPIPN	-PFPGPIPN
SQIGIEATTRA	IGIEATTRA
KIIETDFEKA	KIIEDFEKA
YQYPVIIHL	YQYPVIIHL
YVYDKDIEQI	YVYDDIEQI
SAADLVHFL	SAADLVHFL
FVANLDYKV	FVANLDYKV
FVADHPFLFL	FVADPFLFL
SQTDYISRL	SQTDYISRL
AVYGFKLQSL	AVYGKLQSL
KQSDVMRFL	KQSDVMRFL
FQAVHVQGEDL	FQAVHVQGE
QIFGNIKEA	QIFGNIKEA
FQTIARNAL	FQTIARNAL
LVYHEDMTAT	LVYHEDMTA
GLFGKELHKV	GLFGELHKV
HISSQNSEL	HISSQNSEL
TEDELQDK	-TEDELQDK
YVTQINRLL	YVTQINRLL
SVFERALSSV	SVFEALSSV
ILIKGLAKL	ILIKGLAKL
ITVSIIKEL	ITVSIIKEL
TVVPWDHAL	TVVPWDHAL
FQNSGNVNL	FQNSGNVNL
QVFDQELDAL	QVFDELDAL
YQIDSVVRA	YQIDSVVRA
VVAEEVAAL	VVAEEVAAL
FVPGSQVVVQA	FVPGSQVVV
HQVMVFVHA	HQVMVFVHA
FMFDEKLVTV	FMFDKLVTV
SAGPPLLAV	SAGPPLLAV
NVAEINRQV	NVAEINRQV
YVFPGVTRL	YVFPGVTRL
YLADIFTKL	YLADIFTKL
LQFPRPVKL	LQFPRPVKL
LQFDKAINA	LQFDKAINA
FLASESLIKQI	LASELIKQI
QMISRIEYI	QMISRIEYI
FVNYATEKL	FVNYATEKL
KAFSSDLISI	KAFSDLISI
LQKKIEENERL	KKIEENERL
GQIPATALL	GQIPATALL
YIPEVELNHKL	YIPELNHKL
ILPDITKDEL	ILPDTKDEL
VQEDFSVRV	VQEDFSVRV
SLAELIQAL	SLAELIQAL
RVVDLITNL	RVVDLITNL
KQIETGPFL	KQIETGPFL
SQVEILQRV	SQVEILQRV
KVFSDVMEDL	KVFSVMEDL
QSFPEHMANV	SFPEHMANV
AVFREKILHI	AVFRKILHI
KVAELKQEL	KVAELKQEL
AVADKHELL	AVADKHELL
LLVDEIMRA	LLVDEIMRA
YAIKNIHGV	YAIKNIHGV
RTFLGKLNEA	RTFLKLNEA
QQSETFQFL	QQSETFQFL
SVIDHIHLI	SVIDHIHLI
KVIDYVPGI	KVIDYVPGI
YTIGEVPISFV	TIGEPISFV
SIPGFVERL	SIPGFVERL
HLANIVERV	HLANIVERV
SVFNHLEEL	SVFNHLEEL
SQPEKVYTL	SQPEKVYTL
GIYKDDIAQV	GIYKDIAQV
TVIEKVQIA	TVIEKVQIA
ILPEVENDRL	ILPEENDRL
LLKERLDQI	LLKERLDQI
GQADLATKV	GQADLATKV
FLFDGSPTYV	FLFDSPTYV
KTIEDTLMTV	KTIETLMTV
KTKESSEYL	KTKESSEYL
AVASKTYNL	AVASKTYNL
LTFPEKVNKA	LTFPKVNKA
KIIPAIATT	KIIPAIATT
YQANITETQRL	ANITETQRL
SSIEKIVEI	SSIEKIVEI
FKGKFKEG	-FKGKFKEG
SVTGKIQKL	SVTGKIQKL
LLNSEVHML	LLNSEVHML
RTFEKDHRL	RTFEKDHRL
NQAQIEVRL	NQAQIEVRL
RLFNEHLVSA	RLFNHLVSA
KIISSAQKV	KIISSAQKV
LVYQEPIPTA	LVYQPIPTA
AGFAGDDAPR	AGFADDAPR
AQVSKVEAL	AQVSKVEAL
TIPSFLLTRA	TIPSLLTRA
LTGLLLLQ	-LTGLLLLQ
RLFEGNALL	RLFEGNALL
KAFEESLSTL	KAFESLSTL
ALYPGQLVQL	ALYPQLVQL
VIFPEFLKEL	VIFPFLKEL
SVSAVTEEA	SVSAVTEEA
MIFDHEFTKL	MIFDEFTKL
SQAAVLSQL	SQAAVLSQL
AQIAEGMAYI	QIAEGMAYI
FIFSEKPVFV	FIFSKPVFV
DTNADKQLSF	TNADKQLSF
AQFEESMIAA	AQFESMIAA
FVAPPTAAV	FVAPPTAAV
KIKDYLEELW	KIKDYLEEL
AQFAQKTEAL	AQFAKTEAL
SQPLGPRII	SQPLGPRII
LLAEKVEQL	LLAEKVEQL
FQVPDWLHHL	QVPDWLHHL
LQSAVITKV	LQSAVITKV
ATFPKEIQML	ATFPEIQML
KLFVGFLNRA	KLFVFLNRA
VQIGDIVTV	VQIGDIVTV
GVFEPTIVKV	GVFETIVKV
ATIRLLDVL	ATIRLLDVL
FLADPSAFV	FLADPSAFV
VLFEKEVNEV	VLFEEVNEV
FQHEDLNFL	FQHEDLNFL
KTATELSTVYL	KTATELSTV
AVPREELFVTS	AVPREELFV
AIIANGITKA	IIANGITKA
KLIDDVHRL	KLIDDVHRL
VELQELNDR	VELQELNDR
SVISKVNSV	SVISKVNSV
GQMGSFIRL	GQMGSFIRL
FLYDDNQRV	FLYDDNQRV
HQSQAVHGL	HQSQAVHGL
KTIEDDLVSA	KTIEDLVSA
LQAHGADEL	LQAHGADEL
FIFEKKLAQA	FIFEKLAQA
TLFPGTDHI	TLFPGTDHI
VLKEIVERV	VLKEIVERV
VVATEKNVIAA	VVATKNVIA
SLIAKVATA	SLIAKVATA
LVAEIANVV	LVAEIANVV
TVFKYKLIGI	TVFKKLIGI
KLTEIRHEV	KLTEIRHEV
AIKELLDTV	AIKELLDTV
RQGPVNQTV	RQGPVNQTV
RIFQTLLEV	RIFQTLLEV
TLYPLHILFV	TLYPHILFV
KQVSDLISV	KQVSDLISV
YAIEKIERI	YAIEKIERI
NLIGKIEKL	NLIGKIEKL
KAIEELLKEA	KAIELLKEA
GQIELRTYV	GQIELRTYV
RTPYHVNLL	RTPYHVNLL
NAAEITDKL	NAAEITDKL
KTADVVQQA	KTADVVQQA
AIPGFTINRV	AIPGTINRV
AIPERVEEI	AIPERVEEI
ALADFAELI	ALADFAELI
AVFDKTLAEL	AVFDTLAEL
HVIDLDDATFL	HVIDLDDAT
LIIEKLLKL	LIIEKLLKL
YTPEEIEKL	YTPEEIEKL
FIPKEGDDFL	FIPKGDDFL
FQDEINWRL	FQDEINWRL
QIVEHLEEL	QIVEHLEEL
AVIEAEHTL	AVIEAEHTL
RVPAHISLL	RVPAHISLL
YEDIAQKSKAE	EDIAQKSKA
KVFDFAGEEV	KVFDAGEEV
AVVAGIAKA	AVVAGIAKA
TYLGAEALL	TYLGAEALL
HVINHILKA	HVINHILKA
TVPDEIQEV	TVPDEIQEV
NVVVKIEEA	NVVVKIEEA
KIGPALKTV	KIGPALKTV
VVKGKVEYL	VVKGKVEYL
LLPDNVHYV	LLPDNVHYV
KVIEINPYL	KVIEINPYL
GIFGGHIRSV	GIFGHIRSV
AAAGVVHAV	AAAGVVHAV
KLISDINKA	KLISDINKA
ALPDQGIAKA	ALPDGIAKA
HTILIVEKV	HTILIVEKV
RNVSTGDVNVE	NVSTGDVNV
AQAHMFVKL	AQAHMFVKL
ILKKIIPTL	ILKKIIPTL
MVAQLVQRL	MVAQLVQRL
KVKSILNSL	KVKSILNSL
YAYDGKDYIA	YAYDGKDYI
RTIDFVHQV	RTIDFVHQV
YLAPHVRTL	YLAPHVRTL
LLVKELQSL	LLVKELQSL
AQAEVYKELRL	AQAEVYKEL
YQSKVRELI	YQSKVRELI
NAFNQDITAL	NAFNDITAL
RVISELQEA	RVISELQEA
KTAEMNEKL	KTAEMNEKL
VLFEGRTVQL	VLFERTVQL
QQSELQSQV	QQSELQSQV
SLFEKGLKNV	SLFEGLKNV
KIKDYLEEL	KIKDYLEEL
QLYKEQLAKL	QLYKQLAKL
VVAAGGVEKA	VVAAGVEKA
YQHGGVTGL	YQHGGVTGL
KQIQNLQKA	KQIQNLQKA
QVPENTEEL	QVPENTEEL
FGYPFRLNEA	FGYPRLNEA
VVAQEAQSL	VVAQEAQSL
QMVKELQEI	QMVKELQEI
KLFDQANKL	KLFDQANKL
FIIGRVIKA	FIIGRVIKA
HQHEPFLDFL	HQHEFLDFL
RQSPLTTGL	RQSPLTTGL
IIYDFEDPEM	IIYDEDPEM
RIIEENIPEL	RIIENIPEL
VSFYEHIITV	SFYEHIITV
YVIGGFDGL	YVIGGFDGL
AQIELLQLL	AQIELLQLL
LMKQYIEFV	LMKQYIEFV
VTISSIEKL	VTISSIEKL
ILSHLSSEL	ILSHLSSEL
SVALINRAL	SVALINRAL
LVPGHLDQV	LVPGHLDQV
KIPDISSFL	KIPDISSFL
YVTELTDRI	YVTELTDRI
YLGPHIASV	YLGPHIASV
AMIELVERL	AMIELVERL
KLYEKKLLKL	KLYEKLLKL
SQIQKVEPA	SQIQKVEPA
NITELVNYL	NITELVNYL
MLANDIARL	MLANDIARL
TVIQTVKEV	TVIQTVKEV
LVADLVQEV	LVADLVQEV
TIAQLVHAV	TIAQLVHAV
KVAEIHQAL	KVAEIHQAL
KLYQRDLEVAL	KLYQDLEVA
KIIDFLSAL	KIIDFLSAL
YMAEREDEL	YMAEREDEL
KISDFGLATV	KISDGLATV
LTFEHEMEKA	LTFEEMEKA
FVVDRSDKL	FVVDRSDKL
FVIRNIVEA	FVIRNIVEA
YLSNADERL	YLSNADERL
AVIVPEGVHAL	IVPEGVHAL
RLAVYIDRV	RLAVYIDRV
SLAQYLINV	SLAQYLINV
TTFQSHLNKA	TTFQHLNKA
SVAMHTNYL	SVAMHTNYL
FTILDVRPA	FTILDVRPA
QVPQANTIVQA	PQANTIVQA
RVPAHAVVVRA	RVPAHAVVV
SIFEFVHAL	SIFEFVHAL
AVSPTVSQL	AVSPTVSQL
FLYKEKLVSV	FLYKKLVSV
SQHDQVTLL	SQHDQVTLL
YQYMHETITV	YQYMETITV
MQAPRAALVFA	MQAPRAALV
IQYDKTNVL	IQYDKTNVL
TLFPGKVHSL	TLFPKVHSL
RLIDDMVAQA	RLIDMVAQA
KVIDGLETL	KVIDGLETL
SQIEADFRL	SQIEADFRL
FLITILDHL	FLITILDHL
IQSRIVYYL	IQSRIVYYL
FLFDEEMEQM	FLFDEMEQM
IGAEVYHNL	IGAEVYHNL
HQFDQVMPGV	HQFDVMPGV
SVSSLAERL	SVSSLAERL
GAADIDHKL	GAADIDHKL
HLKNTMETI	HLKNTMETI
KTYDTSFLDFL	YDTSFLDFL
SVIEEMGKEI	SVIEMGKEI
STAAVIQNV	STAAVIQNV
SVIKELRKA	SVIKELRKA
RIIDKNGIHDL	RIIDGIHDL
KMKETLQNV	KMKETLQNV
GVIRSLHSL	GVIRSLHSL
ATAAKQVAAKP	ATAAKQVAA
KSFDAVLEAL	KSFDVLEAL
SLAEFVQSL	SLAEFVQSL
GQADVISKL	GQADVISKL
SQIDPSSIERA	SQIDSIERA
RVIEPFSRV	RVIEPFSRV
AAFEFDIHQV	AAFEDIHQV
GVAVKAHQV	GVAVKAHQV
TLSPVNHSL	TLSPVNHSL
FLFPNKESLI	FLFPNKESL
KQGPVATGV	KQGPVATGV
FLPLIVNTV	FLPLIVNTV
NQAKLIEFL	NQAKLIEFL
RVINKEHVLAA	RVINKEHVL
PGIGGAPTLNP	PGIGGAPTL
IIIPEIQKV	IIIPEIQKV
TLVDEVQEL	TLVDEVQEL
KVIDEIYRV	KVIDEIYRV
YLYESGETEKL	YLYEETEKL
ATYEDIVTL	ATYEDIVTL
SGSEIHVEV	SGSEIHVEV
YLAHFIEGL	YLAHFIEGL
FAFQAEIAQL	FAFQEIAQL
TQLGPPYHIL	QLGPPYHIL
YVSPRILTA	YVSPRILTA
YTRESTEFL	YTRESTEFL
FIPEHTNLSL	FIPETNLSL
KLFEFMHET	KLFEFMHET
FLADPSAFVAA	FLADPSAFV
FQYPDTRYL	FQYPDTRYL
KIIDFIYTA	KIIDFIYTA
RKYPTLLEV	RKYPTLLEV
ILKDVIPPLE	ILKDVIPPL
IVAPGTFEV	IVAPGTFEV
RVFTTQELVQA	RVFTTQELV
AAISQVDRL	AAISQVDRL
VVFGGGEARL	VVFGGEARL
FVIHDMETL	FVIHDMETL
RQFSTPFQL	RQFSTPFQL
VIFEENVEHA	VIFENVEHA
NAVSEALIREV	AVSELIREV
LVEPKLAEL	LVEPKLAEL
KIYEHHIKVL	KIYEHIKVL
KQGAIYHGL	KQGAIYHGL
NLFPSNLVVA	NLFPNLVVA
RMISEELVAA	MISEELVAA
FAYPNRPDVL	FAYPRPDVL
SQAEIEARL	SQAEIEARL
KQAVLYNAL	KQAVLYNAL
RVIGDLDTV	RVIGDLDTV
KLAEIRHEV	KLAEIRHEV
LTKVGAEEL	LTKVGAEEL
FVADFADKL	FVADFADKL
RQYPWGVVQV	RQYPGVVQV
KVSELTERL	KVSELTERL
VIGIIKTV	-VIGIIKTV
FLPPEHTIVYI	FLPPEHTIV
LVYPEELKPVL	LVYPELKPV
GVIKRTENV	GVIKRTENV
ITPETAEKL	ITPETAEKL
SIFDAVLKGV	SIFDVLKGV
LQAEPHNSL	LQAEPHNSL
TQANPGKGEGL	QANPKGEGL
GLSHVDYAL	GLSHVDYAL
KVITDIAGVIP	KVITDIAGV
LLVEEIHRL	LLVEEIHRL
ESYSVYVYK	ESYSVYVYK
YLPTHTSLL	YLPTHTSLL
YHADIYDKV	YHADIYDKV
FLPDPSALQNL	FLPDALQNL
ISEFEHRV	-ISEFEHRV
TIVEMLHKA	TIVEMLHKA
SVFGGKNIHV	SVFGKNIHV
TQAESAQSNRL	TQAESAQSN
GIADLAHLL	GIADLAHLL
ILYDKLEKI	ILYDKLEKI
AGAPVYMAA	AGAPVYMAA
GVSDVDYSL	GVSDVDYSL
SVAPANSAL	SVAPANSAL
AVADNVERA	AVADNVERA
FLADNHHQV	FLADNHHQV
TKAVDAETAE	KAVDAETAE
LVASFSERV	LVASFSERV
FTYATTEKV	FTYATTEKV
KAVWAKGIRNV	AVWAGIRNV
KAPEMTNEL	KAPEMTNEL
YIPGRQIIEV	YIPGQIIEV
NMVDIIHSV	NMVDIIHSV
SQHDQVNLL	SQHDQVNLL
GTIGLIHAI	GTIGLIHAI
VVASDKETYEL	VASDETYEL
SVIPVINKI	SVIPVINKI
SVITQVFHV	SVITQVFHV
AVPSAGSVQRV	AVPSSVQRV
MVMETIEKI	MVMETIEKI
GAADIDHK	-GAADIDHK
YLINEIDRI	YLINEIDRI
RTITVGVYEA	RTITGVYEA
FLPEEQDRL	FLPEEQDRL
KIADFGLAKL	KIADGLAKL
AVVTGAVVAA	AVVTAVVAA
SVFAGVVGV	SVFAGVVGV
AVVKTMQAL	AVVKTMQAL
NQNPEVFFL	NQNPEVFFL
GVVDPRAISVL	GVVDRAISV
AMFEHEMEES	AMFEEMEES
ESFDGSVR	-ESFDGSVR
GQQEITNRL	GQQEITNRL
LQIEDFEARIA	LQIEFEARI
ALYDNVEKL	ALYDNVEKL
VLPAFTSNL	VLPAFTSNL
ATYTGRVDAV	ATYTRVDAV
SVAEKLSKL	SVAEKLSKL
RAFSDPFVEA	RAFSPFVEA
YLYPDITRL	YLYPDITRL
IQTELQETV	IQTELQETV
KQMDHFVGL	KQMDHFVGL
GQIDLLERL	GQIDLLERL
YTVILIERA	YTVILIERA
YTFPLAEKV	YTFPLAEKV
SLAPYRDYL	SLAPYRDYL
RLSSVNAEV	RLSSVNAEV
KLFEQILKA	KLFEQILKA
LLFDHLEPIEL	LLFDHLEPI
GQYEGHEAEL	GQYEHEAEL
RLYPWGVVEV	RLYPGVVEV
QLIDKVWQL	QLIDKVWQL
KMAEEKLTHKM	KMAEKLTHK
QVIEKFEAL	QVIEKFEAL
TEELAYLK	-TEELAYLK
WQYIKTHKL	WQYIKTHKL
AQAESNKAFL	AQAENKAFL
KIINNTENL	KIINNTENL
TVIQFLERI	TVIQFLERI
SVPEKIERI	SVPEKIERI
HVKEGMDVV	HVKEGMDVV
AVVSPPALHNA	VVSPALHNA
LQAILVHEA	LQAILVHEA
YLPDIQERL	YLPDIQERL
KVAGMDVEL	KVAGMDVEL
KQFDDVLIYL	KQFDVLIYL
KQFEGSTSFV	KQFESTSFV
ITSELVSKI	ITSELVSKI
VISAAGIPNLI	SAAGIPNLI
KQFQFGHAL	KQFQFGHAL
TVAPPQGVVKA	VAPPGVVKA
QTGPLPTLV	QTGPLPTLV
AQVKPDGTYV	QVKPDGTYV
YLKSSDNRL	YLKSSDNRL
HIADVSHFI	HIADVSHFI
KIAKESQFL	KIAKESQFL
GVFEGKLNVI	GVFEKLNVI
YIPPMAQPGL	YIPPAQPGL
FQAEIPVGI	FQAEIPVGI
AQIDQYVGL	AQIDQYVGL
QAPDIDVQL	QAPDIDVQL
YQQQQQSEL	YQQQQQSEL
GLYPFRVNSA	GLYPRVNSA
IILDEIHLL	IILDEIHLL
MQGPIPERI	MQGPIPERI
TQMNAELNYKV	MNAELNYKV
LMPYFLLTQA	LMPYLLTQA
SQATELITQAL	SQATLITQA
RVMEYINRL	RVMEYINRL
RQSDLLVKL	RQSDLLVKL
SLIGHLQTL	SLIGHLQTL
FLSPVDNHM	FLSPVDNHM
QMYHYDMNTA	QMYHDMNTA
HIPNIFQKI	HIPNIFQKI
RVFTEANLVSV	RVFTEANLV
HQFESSFEL	HQFESSFEL
RIPNFKGSYL	RIPNKGSYL
FQIDEDGWRA	FQIDDGWRA
SVAHWSLDVA	SVAHSLDVA
GQFKDIITKV	GQFKIITKV
KQSSVAEEV	KQSSVAEEV
RTFEKIEEV	RTFEKIEEV
RLYPEGLAQL	RLYPGLAQL
KVPAGVQEL	KVPAGVQEL
VIPDIPDHFL	VIPDPDHFL
KIFDEILVNA	KIFDILVNA
TVTELSDFL	TVTELSDFL
YIPTELDQV	YIPTELDQV
AVNAAVQRV	AVNAAVQRV
SLITLIEKV	SLITLIEKV
VSTSHTTIS	VSTSHTTIS
NVPGEIVE	-NVPGEIVE
KQPAFTIHV	KQPAFTIHV
AQAGLSSGL	AQAGLSSGL
FQNPFRSEL	FQNPFRSEL
QVKQHIDAV	QVKQHIDAV
QVIEELFKA	QVIEELFKA
FQIGPVAGV	FQIGPVAGV
IEEELGSK	-IEEELGSK
YLIELIDRV	YLIELIDRV
FVIATSTKI	FVIATSTKI
FVIRNIVEAA	FVIRNIVEA
RLAHYIDRV	RLAHYIDRV
LIAKVIQNL	LIAKVIQNL
YAVDRAITHL	YAVDAITHL
FQIVNPHLL	FQIVNPHLL
AAYVGDLQTL	AAYVDLQTL
FVTEEIIPL	FVTEEIIPL
KLYEGKTKEV	KLYEKTKEV
KTKDLLNNV	KTKDLLNNV
RMFDKNLQDL	RMFDNLQDL
QVIPVLPQV	QVIPVLPQV
AVADTVYRA	AVADTVYRA
IQAHSSDQL	IQAHSSDQL
KIPKHLTDA	KIPKHLTDA
YAITTLHNL	YAITTLHNL
AQYEDIAQK	AQYEDIAQK
GVYNGKTFNQV	GVYNTFNQV
VLKEKLDSL	VLKEKLDSL
KVSQLIHHL	KVSQLIHHL
LLAARVVEEL	LLAAVVEEL
GTYQYDLERL	GTYQDLERL
VIAAVSHEL	VIAAVSHEL
ALKERADSL	ALKERADSL
YLKDEIEEL	YLKDEIEEL
FIAKLLNKL	FIAKLLNKL
KQADPFASL	KQADPFASL
HAVGDIPGV	HAVGDIPGV
SQIALNEKL	SQIALNEKL
RVAAQGFVVGA	VAAQFVVGA
TIPERGTIGV	TIPEGTIGV
YIYDGKTGEKV	YIYDTGEKV
LVYDGKIYTL	LVYDKIYTL
SVVKKSLITFV	VVKKLITFV
TVVPSISKL	TVVPSISKL
FVIGHLKGA	FVIGHLKGA
ATVPIRLIINA	TVPILIINA
SLASHIQSL	SLASHIQSL
GLIDKVNEL	GLIDKVNEL
LTNQEDLPEV	LTNQDLPEV
SQAGKGLMHHL	AGKGLMHHL
AISEMTDKL	AISEMTDKL
KVLERVNAV	KVLERVNAV
SQSDMFDQRL	SQSDFDQRL
FLSPKVDPS	FLSPKVDPS
NVEIDPEIQ	NVEIDPEIQ
ALIEKLVEL	ALIEKLVEL
FLFGEVHKA	FLFGEVHKA
TTFESSHYL	TTFESSHYL
YIPGVDVKL	YIPGVDVKL
FLMDFIHQV	FLMDFIHQV
RVAGFNPAL	RVAGFNPAL
ADASLLKKV	ADASLLKKV
FLPEVIYKM	FLPEVIYKM
HIPVFSPAL	HIPVFSPAL
MLPLLAALL	MLPLLAALL
FQYASTDMDKV	YASTDMDKV
TTISKVSQV	TTISKVSQV
IVFDSEMDKL	IVFDEMDKL
FGFLGKIDEL	FGFLKIDEL
SLFPGKLEVV	SLFPKLEVV
KVVDAKTIFTG	KVVDKTIFT
AIYDHINEGV	AIYDINEGV
FIVEEIQRI	FIVEEIQRI
YVYEFRDKL	YVYEFRDKL
NVIRQLGSL	NVIRQLGSL
FVEEEEHFL	FVEEEEHFL
SIIEQLDPVSF	SIIEQLDPV
YGAEALERM	YGAEALERM
KIYERTMAVL	KIYETMAVL
FLPSYIIDV	FLPSYIIDV
DIGSESTEDQ	IGSESTEDQ
SIPLLINHL	SIPLLINHL
RIPSDIAKL	RIPSDIAKL
FSIGKMSTA	FSIGKMSTA
KIYDEETAEL	KIYDETAEL
ILIDPFHKA	ILIDPFHKA
TLPELVQRL	TLPELVQRL
AVINSLEKA	AVINSLEKA
GVVKGLQEV	GVVKGLQEV
FVKQGEEEV	FVKQGEEEV
MVAPAVASV	MVAPAVASV
NVKEYLESL	NVKEYLESL
KVKEGMNIV	KVKEGMNIV
SQAEIEQKI	SQAEIEQKI
TVEDIAARL	TVEDIAARL
GQVEEKLLQKL	QVEELLQKL
HIADIVHTL	HIADIVHTL
KVIAATNRV	KVIAATNRV
KVLGKIEKV	KVLGKIEKV
ATVGEITHA	ATVGEITHA
SLINVGLISV	SLINGLISV
ILIDEVDKI	ILIDEVDKI
QQSQLVEKL	QQSQLVEKL
AQAEDMNVKL	AQAEMNVKL
FLSELTQQL	FLSELTQQL
IPPLTQTPV	IPPLTQTPV
QIFGSHLHKV	QIFGHLHKV
SQINKFLYL	SQINKFLYL
IQTRIKIGL	IQTRIKIGL
VALELLASN	VALELLASN
LTTYLQEKL	LTTYLQEKL
VKPEEHEQV	VKPEEHEQV
RVPESIKNA	RVPESIKNA
LVAEVTQQL	LVAEVTQQL
YLITGNLEKL	YLITNLEKL
NQEDFFQRV	NQEDFFQRV
YVAEREDEL	YVAEREDEL
KVMDVTEKL	KVMDVTEKL
FVTEGSHFVEA	FVTEGSHFV
YIPSVLHDV	YIPSVLHDV
PKEGKVVDA	PKEGKVVDA
AAAAAAAAVAA	AAAAAAAAV
QLFQDEVAKA	QLFQEVAKA
ILADLEDYL	ILADLEDYL
KVMDDLDRA	KVMDDLDRA
KLPKQPVIVKA	KLPKQPVIV
KTAPGKIEKV	KTAPKIEKV
ATAPLTELL	ATAPLTELL
RTVEENILKKA	TVEEILKKA
KLAESVEKA	KLAESVEKA
KISDFGLATVF	KISDGLATV
RVQEPGAVLLA	VQEPGAVLL
NTFGYIAKA	NTFGYIAKA
TQADWQHRV	TQADWQHRV
KLKERLHQL	KLKERLHQL
KQAGLVVKL	KQAGLVVKL
RMFDGKFVVA	RMFDKFVVA
QVAELVKEL	QVAELVKEL
RQYPWGVAEV	RQYPGVAEV
KQYPYNNLYL	KQYPNNLYL
RVFENIVAV	RVFENIVAV
FQVKEVDVGL	QVKEVDVGL
KTIGDLSTL	KTIGDLSTL
QQIPASDTQQL	QIPADTQQL
AQIEVVPSA	AQIEVVPSA
SVTHLNDHL	SVTHLNDHL
AVAELNYGL	AVAELNYGL
YQIAEQFRV	YQIAEQFRV
AATEIVERV	AATEIVERV
LQNPDLVSL	LQNPDLVSL
AAFGGTFKKV	AAFGTFKKV
NQSDASHLL	NQSDASHLL
YLSWKAHRL	YLSWKAHRL
AMFEPDMQEA	AMFEDMQEA
LMPATLARA	LMPATLARA
TQIDAQNKL	TQIDAQNKL
FIYHGEVPQA	FIYHEVPQA
GLYEFPLNKV	GLYEPLNKV
AAFGQLHKV	AAFGQLHKV
HLANIVERL	HLANIVERL
AQAEVYKEL	AQAEVYKEL
HLPEGKLLTA	HLPEKLLTA
KIYEGQVEV	KIYEGQVEV
ALKDKIEKA	ALKDKIEKA
RVFDREIAQM	RVFDEIAQM
YVIELQHVV	YVIELQHVV
IQEAGTEVVK	IQEAGTEVV
RLFSKSIETL	RLFSSIETL
KQIDVYRSV	KQIDVYRSV
YLNKHIQKV	YLNKHIQKV
SVFNHAIRHT	SVFNAIRHT
YVHPFIFAL	YVHPFIFAL
KLSPKAEEV	KLSPKAEEV
AVATAVQRV	AVATAVQRV
AAFYHHLPAA	AAFYHLPAA
RLFADILNDV	RLFAILNDV
VLKENADFL	VLKENADFL
QVAERVEAL	QVAERVEAL
RTFDETVSTYV	RTFDETVST
YIVDLLTHL	YIVDLLTHL
QVIPQLQTV	QVIPQLQTV
TSAAIYHVL	TSAAIYHVL
IVIGVLHQL	IVIGVLHQL
QASEGPLK	-QASEGPLK
ITAQQINKL	ITAQQINKL
SVFGQVERA	SVFGQVERA
TIVDHINGA	TIVDHINGA
GVVPQLVKL	GVVPQLVKL
VVFTDEMAHF	VVFTEMAHF
YVVDNIDHL	YVVDNIDHL
KAYQDRLAYL	KAYQRLAYL
AQAELQHVL	AQAELQHVL
RVANVADVV	RVANVADVV
VLFKAQLEKA	VLFKQLEKA
SAAGFPLSGA	SAAGPLSGA
YQIEHYSMDDL	YQIESMDDL
STIAILNSV	STIAILNSV
YLPRHSIGL	YLPRHSIGL
AQVNLKYLL	AQVNLKYLL
ALFNGAQKL	ALFNGAQKL
MLPSILNQL	MLPSILNQL
KLFNEHIEAL	KLFNHIEAL
KTAEAQLAYEL	AEAQLAYEL
YTIPLAIKL	YTIPLAIKL
VVVGDLVEV	VVVGDLVEV
SVAGVVESL	SVAGVVESL
FTIAEGFVKA	TIAEGFVKA
LVFPHDSSAL	LVFPDSSAL
LIIQAGIKEV	LIIQGIKEV
LVFDTAIAHL	LVFDAIAHL
AQQNSGHFL	AQQNSGHFL
TLIEDILGV	TLIEDILGV
LTMEVIRQV	LTMEVIRQV
NAVPITPT	-NAVPITPT
RMYPFQIHSI	RMYPQIHSI
AAAAAAPAAAA	AAAAPAAAA
TIFAKVDRL	TIFAKVDRL
VIAEQIQHL	VIAEQIQHL
SLFPPGLHAI	SLFPGLHAI
LTKELLHSV	LTKELLHSV
GVYGDVHRV	GVYGDVHRV
KQFEKQVEL	KQFEKQVEL
MVVQDGIVKA	VVQDGIVKA
SQVPNIVKA	SQVPNIVKA
GQIQKVHPA	GQIQKVHPA
LTAEILELA	LTAEILELA
VPGEIVES	-VPGEIVES
YQNEDEKVTL	YQNEEKVTL
RLYEFDLIDG	RLYEDLIDG
NIIPIIAKA	NIIPIIAKA
RVFIGNLNTA	RVFINLNTA
AQASIKQLV	AQASIKQLV
KAVPKSAVQQV	AVPKAVQQV
KLKKELERL	KLKKELERL
KLIGQVHEV	KLIGQVHEV
SVPEKIERIEL	SVPEKIERI
GVMPEIAQA	GVMPEIAQA
LQAMVAHEL	LQAMVAHEL
QVFEGHTHYV	QVFEHTHYV
FLPLHYDYL	FLPLHYDYL
AVISSAGTHSV	VISSGTHSV
TTSDIDYAL	TTSDIDYAL
LIAEENALRG	LIAEENALR
GIPEHADNL	GIPEHADNL
KVFELDLVTL	KVFEDLVTL
FIFDVHVHEV	FIFDHVHEV
HLWTGEEQL	HLWTGEEQL
QIIRELQVL	QIIRELQVL
NGLLFKELL	NGLLFKELL
FAITAIKGV	FAITAIKGV
FQNNVQVKV	FQNNVQVKV
TVTEKPEVID	TVTEKPEVI
SSSKGSLGGGF	SSSKGSLGG
FQEAIISKL	FQEAIISKL
EIPEWVHQL	EIPEWVHQL
FQNPQTHVI	FQNPQTHVI
LQADVISKL	LQADVISKL
YLEDILAKL	YLEDILAKL
SAAPVAHLL	SAAPVAHLL
QIAEAVEFL	QIAEAVEFL
IQEEILVHI	IQEEILVHI
YAFPKAVSV	YAFPKAVSV
GVVEKLSVL	GVVEKLSVL
LVPDVVNEV	LVPDVVNEV
GVIPHIHKS	GVIPHIHKS
MLKEKLAEL	MLKEKLAEL
MLSEHTSKL	MLSEHTSKL
VLPNFLPYNV	VLPNLPYNV
EQADIFERV	EQADIFERV
QVADIDGQYA	QVADDGQYA
KLIKSLEAA	KLIKSLEAA
FQEADSPTL	FQEADSPTL
SVVSSTEKL	SVVSSTEKL
SVIPVINKIDL	SVIPVINKI
YITELANAL	YITELANAL
VLIPKLPQL	VLIPKLPQL
KTFEEKLTPL	KTFEKLTPL
AQFEHTILL	AQFEHTILL
ALSSLIHAL	ALSSLIHAL
AVPDGPLQEV	AVPDPLQEV
KQTEIAKRL	KQTEIAKRL
ITKDLLDLL	ITKDLLDLL
TAAPAAAAAAA	TAAPAAAAA
FIFDEAEKL	FIFDEAEKL
SVIKELRQL	SVIKELRQL
KQGPTGIHV	KQGPTGIHV
YAAPGGLIGV	YAAPGLIGV
SLVGLGGTK	SLVGLGGTK
GGFDGTNRL	GGFDGTNRL
SISDVIAQV	SISDVIAQV
AQYDGAYKV	AQYDGAYKV
AVIDEIQMI	AVIDEIQMI
RQIEYEYKL	RQIEYEYKL
GVTHVIPVA	GVTHVIPVA
AVVPKILTV	AVVPKILTV
KLMDQLEAL	KLMDQLEAL
RLPLKADFV	RLPLKADFV
SQSSIQQEL	SQSSIQQEL
NAADIENRV	NAADIENRV
LVFNEILQA	LVFNEILQA
YLVPELDGV	YLVPELDGV
FMKKYIHVA	FMKKYIHVA
AVAEPANAV	AVAEPANAV
SSFSIEMEKV	SSFSEMEKV
AAFDFLLQRV	AAFDLLQRV
GVKKDIEKL	GVKKDIEKL
ALKKALAAA	ALKKALAAA
AQAGEFGDRL	AQAGFGDRL
VQKELSDMDYL	VQKEDMDYL
KTMETAEKL	KTMETAEKL
SIPSMVDGL	SIPSMVDGL
RQFSGARNQL	RQFSARNQL
AQAKEENVGL	AQAKENVGL
AVFKGKFKEG	AVFKKFKEG
FVVHTVQFL	FVVHTVQFL
YIPDEADFLL	YIPDEADFL
RVFPEKGYSFV	RVFPKGYSF
YIPEHIKKL	YIPEHIKKL
ASGLIHRV	-ASGLIHRV
NIPEITPFL	NIPEITPFL
YQIDAAIVRI	YQIDAIVRI
KVRETIEAL	KVRETIEAL
YLIPNIKHL	YLIPNIKHL
RVIGSVGKKV	RVIGVGKKV
GIYAKVDRL	GIYAKVDRL
TLFGTFHVA	TLFGTFHVA
RSFTTTIHKV	RSFTTIHKV
TLKEYLESL	TLKEYLESL
FLVQNIHTL	FLVQNIHTL
KTIDAMKRV	KTIDAMKRV
TQFEGMNHRV	TQFEMNHRV
KAYTDELVEL	KAYTELVEL
YQPDEPLTQFL	YQPDLTQFL
AAALIIHHV	AAALIIHHV
TTVSSLHQA	TTVSSLHQA
FVEPSRQFV	FVEPSRQFV
MTGPGTHQL	MTGPGTHQL
SVFNIKLVQA	SVFNKLVQA
TVAELVQFL	TVAELVQFL
RAAELFHQL	RAAELFHQL
IVADLGSPL	IVADLGSPL
GVFTTMEKA	GVFTTMEKA
NVAPIISKV	NVAPIISKV
VVAITVQEL	VVAITVQEL
YIAPLFDKF	YIAPLFDKF
YVNAMNDKI	YVNAMNDKI
KQMSISTGL	KQMSISTGL
VVAEELENV	VVAEELENV
KVFGDILDFA	KVFGILDFA
FAIPLIEKL	FAIPLIEKL
KQMEQISQFL	KQMEISQFL
HIFGHIAKA	HIFGHIAKA
AVISKIEST	AVISKIEST
FTVSLNHKL	FTVSLNHKL
AVINRVQKV	AVINRVQKV
SQIQEFKEA	SQIQEFKEA
SVKTKIQKL	SVKTKIQKL
SIAPILAEA	SIAPILAEA
AAFLGHLEVL	AAFLHLEVL
RVPDGMVGL	RVPDGMVGL
KLREDLERL	KLREDLERL
KQFPLIISSV	KQFPIISSV
AMASIINRL	AMASIINRL
LGAGARIQAL	LGAGRIQAL
KLFSEGLFSA	KLFSGLFSA
VVIKKLNEI	VVIKKLNEI
VLIDEVESL	VLIDEVESL
AVFPDDMPTL	AVFPDMPTL
AQADLAYQL	AQADLAYQL
VQNGKVIGV	VQNGKVIGV
AIKKELTQI	AIKKELTQI
KLKKEIEEL	KLKKEIEEL
ITPTGTHPL	ITPTGTHPL
YQAEAREAL	YQAEAREAL
TQAVIFINT	TQAVIFINT
RQIQKITNA	RQIQKITNA
SLAPLFFKL	SLAPLFFKL
RAVEELHKL	RAVEELHKL
VLVEMVQAL	VLVEMVQAL
KLFTAESLIGL	FTAESLIGL
KVFGDLDQV	KVFGDLDQV
HVFAEKITSL	HVFAKITSL
SAPSRATAL	SAPSRATAL
KMMDKVEFV	KMMDKVEFV
LQIEDFEARI	LQIEFEARI
AIFSEDLENL	AIFSDLENL
LLPDYYLVTV	LLPDYLVTV
FLIEPEHVNTV	LIEPHVNTV
YAFVHMERA	YAFVHMERA
YAYDGKDYI	YAYDGKDYI
NAANIFERL	NAANIFERL
KAISGVHTV	KAISGVHTV
SVLGAITSV	SVLGAITSV
KVKAEVQNL	KVKAEVQNL
YVSPEDLEAQL	YVSPEDLEA
AAGPPLVAA	AAGPPLVAA
AQYEHDLEVA	AQYEDLEVA
WLIEDGKVVTV	LIEDKVVTV
YLKDKLDET	YLKDKLDET
SIFEGGATEL	SIFEGATEL
KIAGYVTHL	KIAGYVTHL
HLPETKFSEL	HLPEKFSEL
TLFPVRLLVA	TLFPVRLLV
FLFGEEPSKL	FLFGEPSKL
IVVDAIDVL	IVVDAIDVL
HVMGSALTGA	HVMGALTGA
TLAESSDHV	TLAESSDHV
TVIRPFPGL	TVIRPFPGL
IMPKDIQLA	IMPKDIQLA
AQVALVNEV	AQVALVNEV
FVPIKVEQI	FVPIKVEQI
RQIDQFLVV	RQIDQFLVV
ALKPEVDKL	ALKPEVDKL
AQAPPTAQL	AQAPPTAQL
RLIPTLVSI	RLIPTLVSI
ALPEAIAAL	ALPEAIAAL
SVTQLRHML	SVTQLRHML
FLPTLLHQA	FLPTLLHQA
SVAETAQTI	SVAETAQTI
PLGPAPVSV	PLGPAPVSV
FQMPTPIQM	FQMPTPIQM
TQFGGKRPFGV	TQFGKRPFG
AVADKVHLM	AVADKVHLM
PAAAAAAAAAP	AAAAAAAAA
YTYESKMAFL	YTYEKMAFL
YQFGEIRTI	YQFGEIRTI
KAPSAARSL	KAPSAARSL
VLSAADKGNV	VLSADKGNV
RVFQEFIKMT	RVFQEFIKM
RAIDSIHQL	RAIDSIHQL
HLKVHIERV	HLKVHIERV
EQVANSAFVER	EQVANSAFV
YQIKEMMQL	YQIKEMMQL
TTFTWNINHA	TTFTNINHA
NTSSHVQEL	NTSSHVQEL
AIIPYIPTLIT	AIIPYIPTL
YSKYYKTIDD	SKYYKTIDD
YLADVTNAL	YLADVTNAL
FAYDPSNYEYL	YDPSNYEYL
SVYPNGHFV	SVYPNGHFV
TAPTGHTL	-TAPTGHTL
MTSEIHNTV	MTSEIHNTV
ISPTGHSL	-ISPTGHSL
MIYEQKIAEL	MIYEKIAEL
KTGPVAKEL	KTGPVAKEL
IVAKHTSAL	IVAKHTSAL
AAGPPTHEV	AAGPPTHEV
FQTEVGKQL	FQTEVGKQL
RVYEFLDKL	RVYEFLDKL
KVIEVFIRA	KVIEVFIRA
FTFEKTLEEL	FTFETLEEL
RIIDSLFNTV	RIIDLFNTV
FNEKSKEL	-FNEKSKEL
KQIDSVNHI	KQIDSVNHI
QLFGQDFSHA	QLFGDFSHA
KQVEEIFNL	KQVEEIFNL
SVFPYNHRM	SVFPYNHRM
SLMEKISKL	SLMEKISKL
HLFETISQA	HLFETISQA
TYDDATKTFT	-TYDDATKT
RAFGFMTRV	RAFGFMTRV
IAIDNLEKA	IAIDNLEKA
QITQINHGL	QITQINHGL
SVFVDSLTKA	SVFVSLTKA
FVPLFAENL	FVPLFAENL
RQPEPTKFDYL	RQPEKFDYL
RMVAEIQNV	RMVAEIQNV
QIFLRDIEQV	QIFLDIEQV
AQAPPTFRA	AQAPPTFRA
AVITKVKGV	AVITKVKGV
KAMTEDGFLAV	AMTEGFLAV
LVYPNNDPVM	LVYPNNDPV
FLMGPVKQL	FLMGPVKQL
VSQINHKL	-VSQINHKL
LQHDKLVRL	LQHDKLVRL
KVGNFKFIYV	KVGNKFIYV
YSFYLPIAAA	SFYLPIAAA
KIPDEINDRV	KIPDINDRV
FLAEHPNVTL	FLAEPNVTL
FASHVSPEV	FASHVSPEV
STIRLLTSL	STIRLLTSL
WLVDHVYAI	WLVDHVYAI
FQSILRQDL	FQSILRQDL
SQIAKIVAA	SQIAKIVAA
FAKMVVDAV	FAKMVVDAV
KQVDVNIKL	KQVDVNIKL
GTIFIIKGV	GTIFIIKGV
RIPEKVFQA	RIPEKVFQA
RVIDHSQYL	RVIDHSQYL
LVAQIVTKV	LVAQIVTKV
SLKSKLEHA	SLKSKLEHA
ITGPAHWEV	ITGPAHWEV
SLVNLGGSK	SLVNLGGSK
AVIEHLERL	AVIEHLERL
VQASHFEGL	VQASHFEGL
SVEDMNFRV	SVEDMNFRV
INPETLETI	INPETLETI
AQFAEATQRL	AQFAATQRL
VLKESLDQL	VLKESLDQL
QVVEKVQEA	QVVEKVQEA
PFGPPIPK	-PFGPPIPK
TTFEHDIQAL	TTFEDIQAL
HAYDGKDYI	HAYDGKDYI
NVPGEIVES	NVPGEIVES
LLASIVSEL	LLASIVSEL
YAPKGSSL	-YAPKGSSL
KVVGFDAVMRV	VGFDAVMRV
YGVDLHKA	-YGVDLHKA
RIAEYAFKL	RIAEYAFKL
QQAELIQQL	QQAELIQQL
LTFVAPIYGA	LTFVPIYGA
SVISYLKKL	SVISYLKKL
IAFSYELSKL	IAFSELSKL
IQIGLIDLL	IQIGLIDLL
FQSPLFAKA	FQSPLFAKA
KMADIEYRL	KMADIEYRL
FIIQGLRSV	FIIQGLRSV
GLKDKIHHV	GLKDKIHHV
RIFGGLDML	RIFGGLDML
FTIPHTQEA	FTIPHTQEA
KIAELNTKL	KIAELNTKL
YVTELTHRI	YVTELTHRI
NIIKLIDTV	NIIKLIDTV
GLATDVQTV	GLATDVQTV
SQAAIAELL	SQAAIAELL
MLASAVEKL	MLASAVEKL
SVIDIINGEA	SVIDIINGE
IGYDYKLEQI	IGYDKLEQI
VVKEKLTGL	VVKEKLTGL
SVAGKIQKL	SVAGKIQKL
NVIERLQEA	NVIERLQEA
SAAPGSAAPAA	SAAPSAAPA
SLFERLVVL	SLFERLVVL
NIAPIIQKV	NIAPIIQKV
TEKPEVID	-TEKPEVID
RAAMEALVVEV	AAMELVVEV
HQAGISDTL	HQAGISDTL
VVSGVVSKV	VVSGVVSKV
RQIEALDPPM	RQIEALDPP
FAIPLIERL	FAIPLIERL
KLFPQETLFL	KLFPETLFL
IAPTGHSL	-IAPTGHSL
EVIGKITAL	EVIGKITAL
NIVERVKEV	NIVERVKEV
QVFPGLLERV	QVFPLLERV
VIIKYLESL	VIIKYLESL
MVADKFTEL	MVADKFTEL
SVSDAPVHITA	SVSDAPVHI
YVIAYIRDLA	YVIAYIRDL
LAPTDVKEL	LAPTDVKEL
VLFNKLTYL	VLFNKLTYL
KAAVMVHQL	KAAVMVHQL
TTVTELQKV	TTVTELQKV
AGAPVYLAA	AGAPVYLAA
HQEGFSIPL	HQEGFSIPL
QVISQAAVVHA	QVISQAAVV
HIPEEAQKV	HIPEEAQKV
VLFQEALWHV	VLFQALWHV
YQVVQFNRL	YQVVQFNRL
AVFENKIYVV	AVFEKIYVV
TVGPVQKL	-TVGPVQKL
AQAELAQKL	AQAELAQKL
KTAEEVAAL	KTAEEVAAL
KIYPEEITPLL	KIYPEITPL
YVIAYIRDL	YVIAYIRDL
KIFLPVLLAA	KIFLVLLAA
KTFTVPIVEV	KTFTPIVEV
IVIRGLNTI	IVIRGLNTI
QLNEKVAQL	QLNEKVAQL
KLPEISHRL	KLPEISHRL
SVALHVEKL	SVALHVEKL
VLAYFLPEA	VLAYFLPEA
ILGPKPQGV	ILGPKPQGV
KAYYHLLEQV	KAYYLLEQV
QQADLQRRL	QQADLQRRL
SVVENLQRL	SVVENLQRL
KIPELDMTEV	KIPEDMTEV
FISPFGHGL	FISPFGHGL
FVAGVLPFKVA	FVAGLPFKV
KAMEKLESV	KAMEKLESV
FVPESMFDRL	FVPEMFDRL
ALATLIHQV	ALATLIHQV
ILINKADLL	ILINKADLL
SLIFKLEEL	SLIFKLEEL
QVADILFQTA	QVADLFQTA
KQAEIVKRLN	KQAEIVKRL
IQIMKVEEI	IQIMKVEEI
RAYGRDIVEA	RAYGDIVEA
TLKEEMESL	TLKEEMESL
HVANIVEKL	HVANIVEKL
LQTSIREEI	LQTSIREEI
LTAEDLFEA	LTAEDLFEA
AQTTLRNVL	AQTTLRNVL
VVMNVVHQL	VVMNVVHQL
HIMPTVHTV	HIMPTVHTV
SVPELKDAL	SVPELKDAL
LYEKDIEEL	LYEKDIEEL
AVARVGAVASA	AVARVGAVA
YQQKEIEFL	YQQKEIEFL
YTPEHHLIQAV	YTPEHLIQA
AQIKELEEL	AQIKELEEL
NIAILNNNL	NIAILNNNL
VTFPRELASL	VTFPELASL
RLFDDSTVTTV	RLFDTVTTV
MQAHITQAL	MQAHITQAL
VVYEDIFDA	VVYEDIFDA
ALIEAEKVAQV	ALIEKVAQV
KVPEIEVTV	KVPEIEVTV
LTPEFSQRL	LTPEFSQRL
KTIETVKAA	KTIETVKAA
HQSNVFHHI	HQSNVFHHI
SVVELVNKL	SVVELVNKL
KLHDVELHQV	KLHDELHQV
AIIEYMPLL	AIIEYMPLL
FVADEELVHLL	FVADELVHL
KTVNVITTA	KTVNVITTA
LIPDIDLKL	LIPDIDLKL
TVADHIQKV	TVADHIQKV
KTASINQNV	KTASINQNV
VIFTSPIKAL	VIFTPIKAL
GQMDTKGLVRA	MDTKGLVRA
GQYEGKVSSV	GQYEKVSSV
HIIENIVAV	HIIENIVAV
RMKEFLDSL	RMKEFLDSL
KMYEEFLSKV	KMYEFLSKV
KAKVKLDFV	KAKVKLDFV
KIFSGVFVKV	KIFSVFVKV
ASVSQNAIVSA	SVSQAIVSA
HVIEKMHHV	HVIEKMHHV
GSYPDAILQA	SYPDAILQA
RVFTGIVTSL	RVFTIVTSL
NQADTTHPL	NQADTTHPL
GTNESLER	-GTNESLER
SQANIAQVL	SQANIAQVL
NIIPYITNV	NIIPYITNV
YMIAHITGL	YMIAHITGL
FQFGVPQAL	FQFGVPQAL
KLFQSKLIKA	KLFQKLIKA
SVAYQINAL	SVAYQINAL
KAFEKELSHA	KAFEELSHA
VQDGIVKA	-VQDGIVKA
NLFPAALVHL	NLFPALVHL
ALPEIFTEL	ALPEIFTEL
YLADLYHFV	YLADLYHFV
IQVEPVLDYL	IQVEVLDYL
YTFPGWKVGV	YTFPWKVGV
AIKEILTQV	AIKEILTQV
VLKGDVEKL	VLKGDVEKL
KVYPVQEAL	KVYPVQEAL
FIAHFQDNL	FIAHFQDNL
NQVEALNNL	NQVEALNNL
KQTEVLVTA	KQTEVLVTA
HTIEEIEGL	HTIEEIEGL
GVYGGSVHEA	GVYGSVHEA
AVFDNLIQL	AVFDNLIQL
HVSTYAAFV	HVSTYAAFV
TIMPKDIQL	TIMPKDIQL
RSVTKQAIREA	VTKQAIREA
TVPELTQQV	TVPELTQQV
GVINRVEKI	GVINRVEKI
KMFNQDIEKL	KMFNDIEKL
SLPYHSQKL	SLPYHSQKL
VTPKFFLEEA	VTPKFLEEA
SVAKESIPL	SVAKESIPL
SQEGRPVQV	SQEGRPVQV
VLPSIVNEV	VLPSIVNEV
SQIRETQQL	SQIRETQQL
TVADFFIKAV	TVADFIKAV
KVVVVQAISAL	VVVQAISAL
KLGPAPKTL	KLGPAPKTL
AIVDKVPSV	AIVDKVPSV
FIPDSGTEFI	FIPDGTEFI
SLIKQIPRI	SLIKQIPRI
FLSEVFHQA	FLSEVFHQA
IQATWYEKL	IQATWYEKL
GTIDEIQKLHI	GTIDEIQKL
IVAEAIEKA	IVAEAIEKA
KLAAVVNNL	KLAAVVNNL
YIPEITSVLL	YIPEITSVL
AVIEKFAPIK	AVIEKFAPI
KVIEKVLIA	KVIEKVLIA
GLADASLLKKV	ADASLLKKV
QQASILHVL	QQASILHVL
AAIKIIRQL	AAIKIIRQL
KVVEDGILKL	KVVEGILKL
LLFSESLKQL	LLFSSLKQL
FTPNNIKQV	FTPNNIKQV
FGYDKDTSLL	FGYDKDTSL
SLPELTHAL	SLPELTHAL
LTFRDPLALL	LTFRPLALL
SVFENLEQL	SVFENLEQL
RTTEILHHL	RTTEILHHL
ILTDITKGV	ILTDITKGV
SVIQTVNHV	SVIQTVNHV
LTNEGIQYL	LTNEGIQYL
NQFDYQHGA	NQFDYQHGA
ITPWFKIIAA	ITPWKIIAA
AIVKEIVNI	AIVKEIVNI
AIFDRVLTEL	AIFDVLTEL
GVKQLIVGV	GVKQLIVGV
SLNKHVEAV	SLNKHVEAV
LLMDRVDEM	LLMDRVDEM
TVFSKSFEQV	TVFSSFEQV
LQQEIYQTL	LQQEIYQTL
SQIREMETL	SQIREMETL
KTIRDIIAL	KTIRDIIAL
RLFHKDLTSL	RLFHDLTSL
KLKKFLNKL	KLKKFLNKL
SVAPDTINNHV	VAPDINNHV
SVAEIEEAL	SVAEIEEAL
TQIDHYVGI	TQIDHYVGI
QTIQEIRHL	QTIQEIRHL
AAAAPAAATAA	AAAPAAATA
KSADEVLFTGV	KSADEVLFT
SAIDRIFTL	SAIDRIFTL
GTYMGEEKL	GTYMGEEKL
FVNDIFERI	FVNDIFERI
KIPNFDVREI	KIPNDVREI
SIVSSLHQA	SIVSSLHQA
LLPDLIQKV	LLPDLIQKV
GVYTEKVLEA	GVYTKVLEA
LTFDGKRMRKA	LTFDRMRKA
NVPGEIVESL	NVPGIVESL
FLAPELPAV	FLAPELPAV
TTAELNYGL	TTAELNYGL
MAINSISKL	MAINSISKL
SVAQLEARL	SVAQLEARL
FVPETKEEL	FVPETKEEL
MTPEIIQKL	MTPEIIQKL
KAFDKHMNLI	KAFDHMNLI
AQIPVVFRL	AQIPVVFRL
FQKADGVPVYL	FQKADGVPV
KLSEVNKRL	KLSEVNKRL
YQTQLIQRV	YQTQLIQRV
NVTHIDQAL	NVTHIDQAL
LLEGEESR	-LLEGEESR
KIKEGVENL	KIKEGVENL
SQVEAHHSL	SQVEAHHSL
YVFEGKMLEA	YVFEKMLEA
RVFNFDVRQL	RVFNDVRQL
SAIHTIAHL	SAIHTIAHL
AQFKGTQSL	AQFKGTQSL
FSDIPNPI	-FSDIPNPI
IVHEALYFL	IVHEALYFL
VATVSLPR	-VATVSLPR
FDKTLAEL	-FDKTLAEL
KIQEILTQV	KIQEILTQV
TLAAIIEHL	TLAAIIEHL
SVADLIESM	SVADLIESM
HMIRDIQTL	HMIRDIQTL
SQANVVVKI	SQANVVVKI
YIATIHSRL	YIATIHSRL
LVFLEGLKSA	LVFLGLKSA
LTAPALALA	LTAPALALA
YVISEGFLKA	YVISGFLKA
LQAGDILHRV	LQAGILHRV
KTAITVEHL	KTAITVEHL
YLIASIDHL	YLIASIDHL
LVSDANQHV	LVSDANQHV
KVYGSGEKV	KVYGSGEKV
AVKKMLVEA	AVKKMLVEA
KVFGALKGA	KVFGALKGA
KQAEAVTAL	KQAEAVTAL
TVFEHTFHV	TVFEHTFHV
SDPFTHLAP	SDPFTHLAP
NQIQAHSSDQL	IQAHSSDQL
QQIRKLIKDGL	QQIRKLIKD
ENAGEDPGLAR	ENAGEDPGL
FVSPIRPLGL	FVSPRPLGL
LVYEGQLSQA	LVYEQLSQA
HLVDEPQNLIK	HLVDEPQNL
AVNEKINRV	AVNEKINRV
YVVPYTIHL	YVVPYTIHL
KQIDRQLTA	KQIDRQLTA
KRISELEAL	KRISELEAL
GVFEGHTSKV	GVFEHTSKV
FGGHIRSV	-FGGHIRSV
YLVVKIEKV	YLVVKIEKV
FMATIAEGL	FMATIAEGL
NVKVDPEIQ	NVKVDPEIQ
KLSDLDNKL	KLSDLDNKL
SQYPEIIFL	SQYPEIIFL
AQASFRDGL	AQASFRDGL
KDFVTLLTA	KDFVTLLTA
AVIEHTNRV	AVIEHTNRV
TVIAKVNNV	TVIAKVNNV
EDAANNYAR	EDAANNYAR
LQNAQHDPL	LQNAQHDPL
RLPGSGAVQAA	RLPGGAVQA
AVFTDKDANV	AVFTKDANV
YQSIEFSRL	YQSIEFSRL
HIAHIIELL	HIAHIIELL
TVFSHAQTV	TVFSHAQTV
ATIDKVVKI	ATIDKVVKI
SVVGPVKGV	SVVGPVKGV
IIYNGGNHKL	IIYNGNHKL
YVPDFVLQGI	YVPDVLQGI
SVTELIQAA	SVTELIQAA
TQEEIVAKV	TQEEIVAKV
SQSIVWVHA	SQSIVWVHA
AVPQPGAFQRA	PQPGAFQRA
SQIKYAAKV	SQIKYAAKV
VVFGPELVSL	VVFGELVSL
KAYQELLATV	KAYQLLATV
YVIEPHSMEFA	YVIESMEFA
VTLTSEEEAR	VTLTSEEEA
KVFDPVPVGV	KVFDVPVGV
STGDVNVE	-STGDVNVE
RLAAMANNL	RLAAMANNL
KTIETSPSL	KTIETSPSL
KVAETAVQL	KVAETAVQL
AAFVEELDKV	AAFVELDKV
FAADLAEEL	FAADLAEEL
SAPYGRITL	SAPYGRITL
FIFEKKLAQAL	FIFEKLAQA
YETDAIQR	-YETDAIQR
AQYEHDLEV	AQYEHDLEV
HIAEVSQEV	HIAEVSQEV
TVKDTMEFI	TVKDTMEFI
FTPSLSETV	FTPSLSETV
QSFTLELERA	QSFTELERA
KTMEDTLMTV	KTMETLMTV
LTAPPEALLMV	LTAPPEALL
TVYSGEEKL	TVYSGEEKL
IAYDRYIKEV	IAYDYIKEV
VVYENVSHFL	VVYEVSHFL
SVYDSISMETL	SVYDSMETL
ITAPIEAQV	ITAPIEAQV
AQAPDLQRV	AQAPDLQRV
ASSPISHFL	ASSPISHFL
KAVETVHNL	KAVETVHNL
SQTDFSQLL	SQTDFSQLL
RLIESLFTI	RLIESLFTI
YQAPDMDTL	YQAPDMDTL
RLYDGLFKVI	RLYDGLFKV
IQVDLADKL	IQVDLADKL
RQFQYLHVL	RQFQYLHVL
RIFPNQTEEL	RIFPQTEEL
RLVPFLTEL	RLVPFLTEL
KVIDTQQKV	KVIDTQQKV
KAIGSLKEV	KAIGSLKEV
NTATIFHEL	NTATIFHEL
YIPFYGILGA	YIPFGILGA
ALGPKPQGL	ALGPKPQGL
AVIRDLNSL	AVIRDLNSL
HLSIINEYL	HLSIINEYL
KIFVGNVSAA	KIFVNVSAA
VTIRLLETI	VTIRLLETI
GVAEKTQLL	GVAEKTQLL
RLPPDTLLQQV	RLPPLLQQV
SMYGVDLHKA	SMYGDLHKA
AVPEIMDRI	AVPEIMDRI
SLAERVDRL	SLAERVDRL
FLPSHYNYL	FLPSHYNYL
STAAKIMGV	STAAKIMGV
YLFERIKEL	YLFERIKEL
MLIEVIEKL	MLIEVIEKL
GVVDGNVARV	GVVDNVARV
AVASALHKL	AVASALHKL
TQAGIVAHI	TQAGIVAHI
TVPVKIDKV	TVPVKIDKV
NLPAFVNRL	NLPAFVNRL
VLYTGDFRLA	VLYTGDFRL
FLIPIVNIS	FLIPIVNIS
AQFGYYFRV	AQFGYYFRV
LQAEAFQARL	LQAEFQARL
IQNEAVNLL	IQNEAVNLL
RTPSSASTVSV	RTPSSASTV
NQIEDNDDFQL	QIEDDDFQL
IIFDRDLVVT	IIFDRDLVV
KVASLLHQV	KVASLLHQV
ELFPIQMEGV	ELFPQMEGV
SVPPPDITYTL	SVPPDITYT
VVAPDNLKQV	VVAPNLKQV
KLAEFIDFL	KLAEFIDFL
SLPDFGISYV	SLPDGISYV
RVFHPAFTKA	RVFHAFTKA
AVAQQVQQV	AVAQQVQQV
FQHTGIYSV	FQHTGIYSV
VILEGELERA	VILEELERA
RTVETEAVQML	TVETAVQML
RLSPIENFL	RLSPIENFL
KTFSEILNRV	KTFSILNRV
VQIEEVRQV	VQIEEVRQV
AQIPVVKTA	AQIPVVKTA
GVVPTIQKV	GVVPTIQKV
YLPDIIKDQKA	YLPDIKDQK
VIPELAQEL	VIPELAQEL
HQIEAVDGEEL	HQIEAVDGE
KVYSKMEKL	KVYSKMEKL
RTMPRIPTL	RTMPRIPTL
AEQRGENALKD	AEQRGENAL
SVSQINHKL	SVSQINHKL
KIAPLVKSL	KIAPLVKSL
RTIEYLEEV	RTIEYLEEV
KVVDVVRNL	KVVDVVRNL
VIVPLYDTL	VIVPLYDTL
FQNEVARQL	FQNEVARQL
KTYEAALETI	KTYEALETI
ESPPEINT	-ESPPEINT
RQAQVAEKL	RQAQVAEKL
LQAETSQQL	LQAETSQQL
TYDDATKTF	TYDDATKTF
ALFPAPLAQI	ALFPPLAQI
NTISEQAVKAS	TISEQAVKA
FIPYLVVKV	FIPYLVVKV
KIKEVTEEV	KIKEVTEEV
IAAGIFNDL	IAAGIFNDL
HVIENLHAA	HVIENLHAA
EDQTEYLEER	DQTEYLEER
FTSDRGFQFV	FTSDGFQFV
FLPEAPAELL	FLPEAPAEL
VMKKIIETV	VMKKIIETV
MLPKDIAKL	MLPKDIAKL
KVFEEKTQHL	KVFEKTQHL
ITKDGIEAL	ITKDGIEAL
RVIDREGVYEI	RVIDGVYEI
AALALLFAIH	AALALLFAI
LTATLMHRL	LTATLMHRL
LQAAIQKSL	LQAAIQKSL
FTVDQIRAI	FTVDQIRAI
ALAPASLTSA	ALAPSLTSA
TLVDFDNHL	TLVDFDNHL
NQHPDVFYL	NQHPDVFYL
AAIENLNEA	AAIENLNEA
LIGPKLYEA	LIGPKLYEA
KIMEAMEKL	KIMEAMEKL
LLSESNERL	LLSESNERL
VVYGGGAAEI	VVYGGAAEI
ALFPGVALL	ALFPGVALL
AVPVIISRA	AVPVIISRA
ILPEELQTL	ILPEELQTL
VQPEHIQYL	VQPEHIQYL
ATYPYQVVRA	ATYPQVVRA
DSYVGDEAQSK	YVGDEAQSK
HLVPFIHSA	HLVPFIHSA
LIFSHMLAEI	LIFSMLAEI
HTIDTILTV	HTIDTILTV
IGGIGTVPVGR	GIGTVPVGR
VVITEKGISDL	VITEGISDL
FISPTGHSL	FISPTGHSL
FAIDPHLLLSV	FAIDPHLLL
FVPFITEHI	FVPFITEHI
TVVERLVKV	TVVERLVKV
SQFSYQHAI	SQFSYQHAI
LIVDQVQKL	LIVDQVQKL
QTIAKLEKA	QTIAKLEKA
ELIERIPEL	ELIERIPEL
ATFKGIVRA	ATFKGIVRA
FVAEGGPEL	FVAEGGPEL
FLVPTFEQL	FLVPTFEQL
ILYSKTEHL	ILYSKTEHL
NQMSEAHKL	NQMSEAHKL
TVAEINATM	TVAEINATM
KIIGIMEEV	KIIGIMEEV
MVKDALDQL	MVKDALDQL
YQTEKGITV	YQTEKGITV
TVTGKLVHA	TVTGKLVHA
QIHAFVDYL	QIHAFVDYL
VLYGPKIDRA	VLYGKIDRA
GQIKQIIRI	GQIKQIIRI
VVPPFLQPEV	VVPPLQPEV
LQTDLSDGL	LQTDLSDGL
FVSDKDASL	FVSDKDASL
LLSHSLLVTLA	LLSHLLVTL
RLFQQKLDEL	RLFQKLDEL
MLAWINESL	MLAWINESL
SVAAQLTGV	SVAAQLTGV
NLFKHLAKA	NLFKHLAKA
LFLHAGIVLP	FLHAGIVLP
GVYGALTKA	GVYGALTKA
TINGHNAEV	TINGHNAEV
RLKQEIERL	RLKQEIERL
ILFSEGLIKA	ILFSGLIKA
KVVDRIYSL	KVVDRIYSL
SQDENYHHL	SQDENYHHL
NLNDRLAS	-NLNDRLAS
LLMEHIQEI	LLMEHIQEI
RVGPIEATSFI	RVGPIEATS
TVIENIHTI	TVIENIHTI
SVAPSPAVDKA	VAPSAVDKA
AQAQEVFFL	AQAQEVFFL
KVIGIIEHL	KVIGIIEHL
KAADIASKV	KAADIASKV
FLVGEAARALS	FLVGEAARA
YVSKYIDYI	YVSKYIDYI
RVFDWIEANL	RVFDIEANL
RAFHPDLEFV	RAFHDLEFV
GQFAEHLLGA	GQFAHLLGA
SLPQNIPPLTQ	SLPQNIPPL
FTYPKGAGEML	FTYPKGAGE
FQNDFLRLL	FQNDFLRLL
LIADLKYEL	LIADLKYEL
SQFGHVVDI	SQFGHVVDI
QTAPEEAFIKL	TAPEAFIKL
AVIEQVKAA	AVIEQVKAA
NVIETISSL	NVIETISSL
VLKEYLDNV	VLKEYLDNV
QQINKLEEL	QQINKLEEL
FLADIVQKL	FLADIVQKL
ALAEEVEQV	ALAEEVEQV
IMPNGDHIVSA	IMPNGDHIV
HLPSDFTPA	HLPSDFTPA
SLIDGIKRA	SLIDGIKRA
IVVPDVETL	IVVPDVETL
LTIEKISAL	LTIEKISAL
TVAPFNPTV	TVAPFNPTV
KLLDVVHPA	KLLDVVHPA
GYSFVTTAER	YSFVTTAER
GVSPVIDEL	GVSPVIDEL
TVAEKVDAV	TVAEKVDAV
SLIKKIKDV	SLIKKIKDV
KAIRDGVIEA	KAIRGVIEA
HLIEPLANA	HLIEPLANA
SVAELQSRL	SVAELQSRL
VVAEKIQRI	VVAEKIQRI
AQYGKLESL	AQYGKLESL
NAPWAVTSL	NAPWAVTSL
LVFPGAQRM	LVFPGAQRM
GVIDGHIYAV	GVIDHIYAV
SQTTVYEKL	SQTTVYEKL
VTAPKAERL	VTAPKAERL
