Data	Data aligned
KLNPYAKTM	KLNPYAKTM
ATGPPNTSY	ATGPPNTSY
KQFPEVIKY	KQFPEVIKY
SLGGGFGGGSR	SLGGFGGGS
LQHPNIVRF	LQHPNIVRF
GQIHTGMGSY	GQIHGMGSY
AQRTPVQMM	AQRTPVQMM
AVYPQATQTY	AVYPATQTY
RVADTFQDY	RVADTFQDY
RQNIGVATF	RQNIGVATF
ALRASVETGF	ALRAVETGF
NAPWAVTSL	NAPWAVTSL
NQIKSGTPY	NQIKSGTPY
QSSKALLQL	QSSKALLQL
GGGLSVSSSR	GLS-VSSSR
VQRNVNVF	VQR-NVNVF
ILKEDPANTVY	ILKEANTVY
VQKAIPMY	VQK-AIPMY
GQFGVGFYSAY	GQF-GVGFY
GQTGTGKTF	GQTGTGKTF
FQYDDSGNTF	FQYDSGNTF
YTQQATQSY	YTQQATQSY
RQLGLEHTRY	RQLGEHTRY
KLIESTSTM	KLIESTSTM
MIKGVTLGF	MIKGVTLGF
LQKPVLPLY	LQKPVLPLY
FMKDTDSINLY	FMKDDSINL
IQEESLRTY	IQEESLRTY
MMYSGELKF	MMYSGELKF
LMIDVTKSYY	LMIDVTKSY
AIIAPHAGY	AIIAPHAGY
RMQHSLAGQTY	MQHSAGQTY
RQMAHVQIF	RQMAHVQIF
GAYEQVIKY	GAYEQVIKY
SVNLQVATY	SVNLQVATY
KLVEAIRTNY	KLVEIRTNY
AGHAIITNY	AGHAIITNY
AIKDKQVKY	AIKDKQVKY
IIAEVAKNEF	IIAEAKNEF
AQAEKHFHY	AQAEKHFHY
VLKAAAHHY	VLKAAAHHY
ALVNAAVTY	ALVNAAVTY
AIVKEKGTVY	IVKEKGTVY
KIKSFEVVF	KIKSFEVVF
TGKLISSY	TGK-LISSY
AGIFPRLSF	AGIFPRLSF
SAPKGSVL	SAP-KGSVL
AQPLNVGVAH	AQPLVGVAH
ALTTIFQKY	ALTTIFQKY
LLKQIQEAY	LLKQIQEAY
RLYKEELEQTY	RLYKLEQTY
IISSVIQKF	IISSVIQKF
ISGPLSPAY	ISGPLSPAY
RVISKASAY	RVISKASAY
RSIPAITRY	RSIPAITRY
KQYPYNNLY	KQYPYNNLY
GQQVIVSY	GQQ-VIVSY
RQALLIERY	RQALLIERY
YQQQQQSEL	YQQQQQSEL
IQAQKSSEY	IQAQKSSEY
SYGGGSGGGF	YGGGSGGGF
LQPLLDNQVGF	PLLDNQVGF
LQKVVLPSY	LQKVVLPSY
VQRGGIKLH	VQRGGIKLH
LIKEKEEAF	LIKEKEEAF
RVFPEKGYSF	RVFPKGYSF
KQNPKDIHTL	KQNPDIHTL
LLIPGLATAY	LLIPLATAY
GQPGQKQSTTF	GQK-QSTTF
RQHEIVLKVAY	RQHEIVLKV
LLYESPERY	LLYESPERY
KLYDPGQQY	KLYDPGQQY
KQFGNILIL	KQFGNILIL
VVRDEESHEF	VVRDESHEF
GQRRHFIIQY	GQRRFIIQY
SIYRGPSHTY	SIYRPSHTY
IQPPKGVLMY	IQPPGVLMY
RQIEETLAHF	RQIETLAHF
RQAHLTNQY	RQAHLTNQY
GAKISIMTY	GAKISIMTY
AQRLIRMY	AQR-LIRMY
ALAEAGVAVF	ALAEGVAVF
SQKALMLEL	SQKALMLEL
SQSAVKTKF	SQSAVKTKF
LSAGATRVY	LSAGATRVY
SLGQPHIAY	SLGQPHIAY
SQLLVHVL	SQL-LVHVL
QQRVVRVY	QQR-VVRVY
LVRELEKKF	LVRELEKKF
YQTDPSGTY	YQTDPSGTY
AQFGHTSIVAY	AQFGSIVAY
VQKHNIQAL	VQKHNIQAL
RMSPFPLTSM	RMSPPLTSM
QQNPQPLIF	QQNPQPLIF
SQFIGYPITLY	SQFIYPITL
TIMQNPRQY	TIMQNPRQY
SQGPASHSRF	SQGPSHSRF
RLAEQVSSY	RLAEQVSSY
GVAPPAGAY	GVAPPAGAY
YQIEPVKKM	YQIEPVKKM
VQIEHISSL	VQIEHISSL
GQAGMHATY	GQAGMHATY
TQVLNTHY	TQV-LNTHY
TQHPTLRLY	TQHPTLRLY
ALKIKEITY	ALKIKEITY
NVEIDPEIQ	NVEIDPEIQ
KSSEVFTTF	KSSEVFTTF
HSVLIHEY	HSV-LIHEY
ISKSTGQEY	ISKSTGQEY
KQIYTAEEKY	KQIYAEEKY
VQKNDVNVEF	VQKNVNVEF
IMKKIRESY	IMKKIRESY
TLKGVTQYY	TLKGVTQYY
KQYGEGLSY	KQYGEGLSY
RQYPWGVAEV	RQYPGVAEV
RQMVEHGGF	RQMVEHGGF
RMIDIQTRM	RMIDIQTRM
RLKDGVLAY	RLKDGVLAY
AQMPTVHY	AQM-PTVHY
AQLGLGHSY	AQLGLGHSY
AQAEAAGAAF	AQAEAGAAF
AQRDVMLENY	AQRDMLENY
RLMAEDEEGY	LMAEDEEGY
AQLAAAEKF	AQLAAAEKF
RIADISQVY	RIADISQVY
RLPAGQATY	RLPAGQATY
GQFLVRIIY	GQFLVRIIY
LIYEHLQQY	LIYEHLQQY
AAAAAQSVY	AAAAAQSVY
KVKPDSKAF	KVKPDSKAF
SQLEHLQSKY	SQLELQSKY
SLKDPSNNF	SLKDPSNNF
SIPGGYNAL	SIPGGYNAL
RVIVVSMNY	RVIVVSMNY
LQKELQEQM	LQKELQEQM
RQQPPSTTTF	RQQPSTTTF
LIREEKNSY	LIREEKNSY
LSDTEVLEY	LSDTEVLEY
AIKIEVATY	AIKIEVATY
LAKGGTVEY	LAKGGTVEY
AQPLQPLQVY	AQPLPLQVY
GQRKGAGSVF	GQRKAGSVF
AQKMQTVTA	AQKMQTVTA
AQFHPDGLIF	AQFHDGLIF
MQYPGRSLVF	MQYPRSLVF
ILNGSHPVSF	ILNGHPVSF
SVIDIINKY	SVIDIINKY
IQVKVRDTY	IQVKVRDTY
MLAPPRELF	MLAPPRELF
YLIDRDPTY	YLIDRDPTY
GSIYIHVY	GSI-YIHVY
TQTNKTSSF	TQTNKTSSF
YQASYNQSF	YQASYNQSF
ALAVIITSY	ALAVIITSY
RVFDHKQGTY	RVFDKQGTY
HQRIQEEKY	HQRIQEEKY
VQRPQVVEY	VQRPQVVEY
RLVQSPNSY	RLVQSPNSY
VLYLEGVKF	VLYLEGVKF
TSFPHESTF	TSFPHESTF
QQRHLFRTY	QQRHLFRTY
GQKPGGSDF	GQKPGGSDF
SQPAVATSF	SQPAVATSF
AARVIIEKY	AARVIIEKY
SQILSVESY	SQILSVESY
SQRPGAQAL	SQRPGAQAL
KQLNIAYDVTY	QLNIYDVTY
AQKAVGKDNF	AQKAGKDNF
ILKQKNVSY	ILKQKNVSY
KLMSELESF	KLMSELESF
SQHASETF	SQH-ASETF
SQVPRSSSM	SQVPRSSSM
AQKGLQVDL	AQKGLQVDL
KLFPGSPAIY	KLFPSPAIY
GQVKAAVKY	GQVKAAVKY
RMHPHLSKGY	RMHPLSKGY
TMKDFNHSY	TMKDFNHSY
YQQTIKKY	YQQ-TIKKY
KLSEPSSLQY	KLSESSLQY
YQPSPSPQSY	YQPSSPQSY
VQKILQDY	VQK-ILQDY
RVYWNDGLDQY	YWNDGLDQY
GMQIPSTQF	GMQIPSTQF
IQYSGEVRRF	IQYSEVRRF
KQNPTVGFELY	KQN-PTVGF
QPSSQYRIKEY	SQY-RIKEY
LLREENEGY	LLREENEGY
GQIEGVRQM	GQIEGVRQM
HQVEIKVY	HQV-EIKVY
AQVSRRISF	AQVSRRISF
SLPNFKQNEF	SLPNKQNEF
SLMHPSISF	SLMHPSISF
SQFDSTTGF	SQFDSTTGF
RLFSRLYTY	RLFSRLYTY
LQKGEANIF	LQKGEANIF
TAYPGQTQY	TAYPGQTQY
KSFPGGKEY	KSFPGGKEY
KQIANSQDGY	KQIASQDGY
IIHTEEKPY	IIHTEEKPY
AVVQTVKASY	VVQTVKASY
AQYAQRASVAF	AQR-ASVAF
GQLGLLARY	GQLGLLARY
PQRATSNVF	PQRATSNVF
VQGLLSETY	VQGLLSETY
LSKPVPESEF	LSKPPESEF
IIYTGEKPY	IIYTGEKPY
RQPLITLQY	RQPLITLQY
SQVPQQSHF	SQVPQQSHF
RQLEDILSTY	RQLEILSTY
HQHLAAGY	HQH-LAAGY
LQKLISQL	LQK-LISQL
GQFWGQKPW	GQFWGQKPW
RQRTEIARL	RQRTEIARL
RQALPQVRLY	RQALQVRLY
ALIARSLGKY	ALIASLGKY
RVIVGGSSEY	RVIVGSSEY
SQYNIRGVTY	SQYNRGVTY
HISPVTSTY	HISPVTSTY
GQYYKPEQF	GQYYKPEQF
IQIKQQSTSY	IQIKQSTSY
RQQPMEGATY	RQQPEGATY
AQRLVRVL	AQR-LVRVL
QQSGAHVEL	QQSGAHVEL
KQYEVEIQTY	KQYEEIQTY
SQIDNRAVL	SQIDNRAVL
AMRIGAEVY	AMRIGAEVY
AQHSYFGSF	AQHSYFGSF
RVADNAQQQY	RVADAQQQY
TQQLLKTAL	TQQLLKTAL
GQFLAPNSH	GQFLAPNSH
VTRPTGVSF	VTRPTGVSF
GQNNSVFTLY	GQNNVFTLY
TLMLEHQAF	TLMLEHQAF
VVAPITTGY	VVAPITTGY
YQLKVVNPQEY	QLKVNPQEY
KQIDRQLTAY	KQIDQLTAY
LQRPNLQKY	LQRPNLQKY
KIYPGHGRRY	KIYPHGRRY
GQTEPHTVLF	GQTEPHTVL
SLREDQQSF	SLREDQQSF
AQYDQASTKY	AQYDASTKY
YQAEAREAL	YQAEAREAL
ALIQSFSHY	ALIQSFSHY
IIISGGPNSVY	IISGPNSVY
AMKPKPLSV	AMKPKPLSV
AQRIQNGSY	AQRIQNGSY
KQIEERMLSH	KQIERMLSH
KQIVPKESL	KQIVPKESL
AGAPPGTAY	AGAPPGTAY
LQSLPTRAY	LQSLPTRAY
ALIKDREGY	ALIKDREGY
SQIGDDRPISY	SQIGRPISY
VQINVPITF	VQINVPITF
KAFDLTEQRY	KAFDTEQRY
SQFGGGSQY	SQFGGGSQY
SLPPGVHISY	SLPPVHISY
IEMPSHQTY	IEMPSHQTY
RQRPSVGVQSL	RQRPSVGVQ
VVNSPHRQY	VVNSPHRQY
GEMPTSVAY	GEMPTSVAY
ILATAGTHF	ILATAGTHF
MQQPQISVY	MQQPQISVY
SLHPHERLSY	SLHPERLSY
YQHDDGRVSY	YQHDGRVSY
VLKNQEVEF	VLKNQEVEF
TQKDNYRVY	TQKDNYRVY
KLAEQAERY	KLAEQAERY
FQKVILDGY	FQKVILDGY
AVASFRSKAY	AVASRSKAY
SQYPNQPTRF	SQYPQPTRF
SQRSVRLY	SQR-SVRLY
AQAGHAIITNY	AQAGIITNY
HQYKVRAY	HQY-KVRAY
AVTASIHVY	AVTASIHVY
AQRRDPSIHY	AQRRPSIHY
TQRSHLTQEY	TQRSLTQEY
RTAPSGSEY	RTAPSGSEY
LIAGQINTY	LIAGQINTY
KQFFQDKARFY	KQFFDKARF
RVKEIGSTM	RVKEIGSTM
QQFYQPKIQQF	YQP-KIQQF
ALSPNAKEF	ALSPNAKEF
KLVHPTDKY	KLVHPTDKY
RVKEKEAEL	RVKEKEAEL
SQRPAARAF	SQRPAARAF
YISFRHHVY	YISFRHHVY
ILQKGQTAY	ILQKGQTAY
VIFGGLTGY	VIFGGLTGY
KISPFEHQTY	KISPEHQTY
ASFDGRISVY	ASFDRISVY
KQAEWSSKTSY	KQAESKTSY
SSFKVAQY	SSF-KVAQY
IQNDRQLQY	IQNDRQLQY
AQAVINAY	AQA-VINAY
LLKPNTSVQF	LLKPTSVQF
ISREWTQKY	ISREWTQKY
GQNGQQILSA	GQNGQILSA
IMFDVTSRVTY	IMFDVTSRV
DSQRVLYIRY	SQRVLYIRY
RITENTSQY	RITENTSQY
LLADITSKY	LLADITSKY
TQKEHLLKY	TQKEHLLKY
KQHNHLERAF	KQHNLERAF
AMIDTGKAF	AMIDTGKAF
SLFVSNHAY	SLFVSNHAY
TQREFMLSF	TQREFMLSF
GLHPERVSY	GLHPERVSY
RQTTITSHF	RQTTITSHF
WQTVVGKTY	WQTVVGKTY
ILIQIISHY	ILIQIISHY
AQQKKSLSL	AQQKKSLSL
TLKGPDSHY	TLKGPDSHY
SQYPFPVTL	SQYPFPVTL
VLKHPDKKF	VLKHPDKKF
RVFQGAPKGY	RVFQAPKGY
LLKEDDPSY	LLKEDDPSY
LQKEDVKPY	LQKEDVKPY
RQRLQSNAL	RQRLQSNAL
IQPPKGVLLY	IQPPGVLLY
RMYPGLQVY	RMYPGLQVY
RSFPGFQAF	RSFPGFQAF
ALFAVPKNY	ALFAVPKNY
LQIVHETGY	LQIVHETGY
RMQDTSVSFGY	RMQDTSVSF
SQISILKELY	SQISLKELY
AQRILRVNL	AQRILRVNL
GANQSGQVF	GANQSGQVF
RLIHPKSGRSY	LIHPSGRSY
KIAEQVASF	KIAEQVASF
AIYGGSASY	AIYGGSASY
SVADIRNAY	SVADIRNAY
YQRHETEQF	YQRHETEQF
TQRGSIPTY	TQRGSIPTY
SQRPPTRETF	SQRPTRETF
AVSQIVTVY	AVSQIVTVY
AQHYTETAL	AQHYTETAL
IMKSIGEAIQY	KSIGEAIQY
FQSSAVMAL	FQSSAVMAL
AMRPGLEGY	AMRPGLEGY
SMIIFIHSY	SMIIFIHSY
AIIDILTHY	AIIDILTHY
LAKQVIEY	LAK-QVIEY
KQRLTPKLF	KQRLTPKLF
RQYGDESTLAF	RQYGDESTL
AQRKTLSGF	AQRKTLSGF
FQNDIHVY	FQN-DIHVY
AQAPIPAWF	AQAPIPAWF
KLIHPTENITF	LIHPENITF
LQAMPRTEF	LQAMPRTEF
LQKAQTQEF	LQKAQTQEF
RMKETQKSIY	RMKEQKSIY
SLFDNPRTF	SLFDNPRTF
AQKSGDGVQF	AQKSDGVQF
LQQGHLNQAF	LQQGLNQAF
AQKSSELEQY	AQKSELEQY
YQSPVRVY	YQS-PVRVY
LQRATPEQY	LQRATPEQY
FQNNTTNRY	FQNNTTNRY
TQAPIFISF	TQAPIFISF
AQQDVLKKSY	AQQDLKKSY
LQQAKDEI	LQQ-AKDEI
YQSDPSGNY	YQSDPSGNY
LQIQSPDQY	LQIQSPDQY
SQLVAGVAF	SQLVAGVAF
RLNEAEQKY	RLNEAEQKY
SQIYQSIEF	SQIYQSIEF
YSVMINKATPY	VMINKATPY
RVFPYISVM	RVFPYISVM
STYQGERAY	STYQGERAY
YMIDPSGVSY	YMIDSGVSY
RMKVTNEDF	RMKVTNEDF
SVPEAQSAL	SVPEAQSAL
MLAKTGVHHY	LAKTGVHHY
SQIDNNEPY	SQIDNNEPY
GVIPSTLAF	GVIPSTLAF
RLHEAFSPVSY	RLHESPVSY
RLKTMTDTY	RLKTMTDTY
RIKPRPERF	RIKPRPERF
IQKQVSVL	IQK-QVSVL
HQYDGLVEL	HQYDGLVEL
IIAPPERKY	IIAPPERKY
AQKLLEQY	AQK-LLEQY
GMKDGQKITF	GMKDQKITF
TLNERFTSY	TLNERFTSY
HLKEDQTEY	HLKEDQTEY
AQQLQGQQF	AQQLQGQQF
LQPAGSLPHA	LQPAGSLPH
RLPSETIQTY	RLPSTIQTY
IQVVSKNLY	IQVVSKNLY
LVKSQISVY	LVKSQISVY
QQNKELENKY	QQNKLENKY
SQGPVKHVY	SQGPVKHVY
IQINPQNKADF	IQINPQNKA
IQKESQYIKY	IQKEQYIKY
SVIESHTEF	SVIESHTEF
GMAGSGKTTF	GMAGGKTTF
RQIEPANREF	RQIEANREF
YQTAPKAGY	YQTAPKAGY
YVNLPTIAL	YVNLPTIAL
IVKKPGNIY	IVKKPGNIY
EEQLQQIR	EEQ-LQQIR
IRHTGEKPF	IRHTGEKPF
GQAYTIQGQY	GQAYIQGQY
TLFPEKQIY	TLFPEKQIY
ATAAAAAAY	ATAAAAAAY
RVASVMQEY	RVASVMQEY
LLAKNRQTF	LLAKNRQTF
AAMPRPVSY	AAMPRPVSY
KVKAKSIVF	KVKAKSIVF
ILAEGGGAKF	ILAEGGAKF
FQFIMKQSY	FQFIMKQSY
RQYVVRKPL	RQYVVRKPL
SQHGLSKVVY	SQHGSKVVY
QLINHIEQF	QLINHIEQF
VQFQGKKTKF	VQFQKKTKF
KAPSAARSL	KAPSAARSL
KLSEIVREF	KLSEIVREF
IQQRVVRVY	IQQRVVRVY
TQPDLPATTY	TQPDPATTY
SQKNINLIF	SQKNINLIF
GIYPHKLVF	GIYPHKLVF
SVINSKASLTY	SVINSKASL
AQLGPVGGVF	AQLGVGGVF
RQATSTASTF	RQATTASTF
AQVLAELKEY	AQVLELKEY
KQKISKEEF	KQKISKEEF
LLKDKITQY	LLKDKITQY
KTIDKKTFY	KTIDKKTFY
RQGPEGLEVSF	RQGPLEVSF
SQMVISFY	SQM-VISFY
KTQIPTQRY	KTQIPTQRY
SIFGLGLAY	SIFGLGLAY
SQRPTVEEL	SQRPTVEEL
YHIRNQTY	YHI-RNQTY
SQRAVTNHSVY	RAVTNHSVY
RAKEIRLSL	RAKEIRLSL
SQIPAAVKLTY	SQIPAAVKL
ILRPEELGF	ILRPEELGF
SLFGSSRVQY	SLFGSRVQY
RMKTGNKIRY	RMKTNKIRY
RVIEEAKTAF	RVIEAKTAF
QIRDVPVLY	QIRDVPVLY
KVNTPTTTVY	KVNTTTTVY
GQYPTQPTY	GQYPTQPTY
AQNRFEVLTF	AQNREVLTF
RQKDNLNNY	RQKDNLNNY
TQYTKPNQY	TQYTKPNQY
LLNKTNVKF	LLNKTNVKF
AQYLPKEQY	AQYLPKEQY
GQVPHSLETL	GQVPSLETL
RQREIEIRF	RQREIEIRF
KLSKPRVTF	KLSKPRVTF
RLTTSTSTF	RLTTSTSTF
ALRKSEIEYY	ALRKSEIEY
VQAVHKNTTY	VQAVKNTTY
LLTKNGHVY	LLTKNGHVY
KQAKLVEQY	KQAKLVEQY
FQHVGKAF	FQH-VGKAF
TLNPNAKEF	TLNPNAKEF
SLIKETTTGY	LIKETTTGY
RQKLIAQDY	RQKLIAQDY
SQFKGYFIF	SQFKGYFIF
VQKKLRSSL	VQKKLRSSL
KQISRVEAM	KQISRVEAM
AGRLLLENY	AGRLLLENY
RTHLPGRTY	RTHLPGRTY
AGFAAIVAY	AGFAAIVAY
GQRKEVEVF	GQRKEVEVF
GQHPNIITL	GQHPNIITL
TQISKTNTQTY	ISKTNTQTY
KLFDDLTSSY	KLFDLTSSY
VGIDLGTTY	VGIDLGTTY
RLFPLIQTM	RLFPLIQTM
MTNPHNHLY	MTNPHNHLY
AMAEPNAKF	AMAEPNAKF
SQVPTQMSF	SQVPTQMSF
GQRVIGHY	GQR-VIGHY
AQAAPQTY	AQA-APQTY
ALVASKVFY	ALVASKVFY
RIHTGERPY	RIHTGERPY
VLYPHEPTAVF	VLYPPTAVF
GQRKPVAVL	GQRKPVAVL
AQRPDNPREF	AQRPNPREF
ALFLEHEGY	ALFLEHEGY
GQFGVGFY	GQF-GVGFY
VLFEHAVGY	VLFEHAVGY
GQPQAPMGSY	GQPQPMGSY
SQKIPGMTL	SQKIPGMTL
GQSRLIFTY	GQSRLIFTY
ALQRASTAL	ALQRASTAL
AQREKQEIL	AQREKQEIL
VTAVAGLTSY	AVA-GLTSY
KFNEPGSQY	KFNEPGSQY
RVIELAVKY	RVIELAVKY
LLMPHSAQF	LLMPHSAQF
QQAALASQY	QQAALASQY
KMKEIAEAY	KMKEIAEAY
RMITETEKF	RMITETEKF
GIARFFTEY	GIARFFTEY
AQKTSLRY	AQK-TSLRY
SVFPGHPVQF	SVFPHPVQF
AAYGGYPTAH	AAYGYPTAH
VQNPALTAL	VQNPALTAL
TQSPVSSEEY	TQSPSSEEY
SQKVIGTPH	SQKVIGTPH
RVAELDKITY	RVAEDKITY
QAIKNGQAL	QAIKNGQAL
HQHLSKESM	HQHLSKESM
SVNGERLGTY	SVNGRLGTY
GQMPHSHQY	GQMPHSHQY
SQPYGQQSY	SQPYGQQSY
FAFEHSEEY	FAFEHSEEY
AQPEISRAF	AQPEISRAF
RMLFKSKAY	RMLFKSKAY
KLPDVYGVF	KLPDVYGVF
KIYPLPHMY	KIYPLPHMY
IEKDPSLVY	IEKDPSLVY
RLKDVVRAY	RLKDVVRAY
RLPETELGEY	RLPEELGEY
IIIGDNKTQY	IIIGNKTQY
ALASAVSGY	ALASAVSGY
RQKLVRNIY	RQKLVRNIY
SSYAHKASSI	SSYAKASSI
ALKPSVKVY	ALKPSVKVY
ALRDNSTMGY	ALRDSTMGY
RQRPYVVTF	RQRPYVVTF
SQIFISRTY	SQIFISRTY
ALKPGLSAY	ALKPGLSAY
KQFKSEAY	KQF-KSEAY
MMNGGHYTY	MMNGGHYTY
IIHDFPQFY	IIHDFPQFY
IRHTGERPY	IRHTGERPY
RLKEEGNEQF	RLKEGNEQF
AVILPPLSPY	AVILPLSPY
HQRLIFRL	HQR-LIFRL
VQIPPSTTY	VQIPPSTTY
AQFKTSNSY	AQFKTSNSY
IIIDGGNSEY	IIIDGNSEY
ALNIATHVL	ALNIATHVL
RQYHLQQLFY	RQYHLQQLF
AIFRPGTSF	AIFRPGTSF
KLPDIFQSY	KLPDIFQSY
AQLSKQSSF	AQLSKQSSF
ALRDVRQQY	ALRDVRQQY
KLIDSLHSY	KLIDSLHSY
LQNLFEEKY	LQNLFEEKY
KQPSILSKF	KQPSILSKF
NQIRPGLQY	NQIRPGLQY
AIHTGEKPY	AIHTGEKPY
LQRVFPHAEF	LQRVPHAEF
ALNSKATFY	ALNSKATFY
SQQAAIQAY	SQQAAIQAY
AQINELHLAY	AQINLHLAY
YLYPDQTHF	YLYPDQTHF
AIKPGTSVEY	AIKPTSVEY
GQNRDGIVF	GQNRDGIVF
ISPTGHSL	ISP-TGHSL
LMKAIDFEYY	LMKAIDFEY
RQPAKVAAL	RQPAKVAAL
LQVVKQLAY	LQVVKQLAY
ENAGEDPGLAR	AGEDPGLAR
SQKGSLISH	SQKGSLISH
FMQPGGTKY	FMQPGGTKY
KLNVAPLAVF	KLNVPLAVF
RLNSAPDMR	RLNSAPDMR
QQQQPALVNY	QQQPALVNY
GQVFLKTAL	GQVFLKTAL
HEIVLKVAY	HEIVLKVAY
GQYGNPLNKY	GQYGPLNKY
VLREESREY	VLREESREY
YAQDEHLITF	AQDEHLITF
GMQRATNVTY	MQRATNVTY
AQNVGTTHDL	AQNVTTHDL
KLKDATERY	KLKDATERY
RQYPEVIKY	RQYPEVIKY
ITKPPDGSAF	ITKPDGSAF
RQPRPSSQY	RQPRPSSQY
AQQHPQAAASY	QQHPAAASY
RVFDKDGNGY	RVFDDGNGY
IIHEEVEKY	IIHEEVEKY
RVVKGEKSF	RVVKGEKSF
QQNLNTITY	QQNLNTITY
NIHSGDRPY	NIHSGDRPY
LQRATGISF	LQRATGISF
LQIDNARLA	LQIDNARLA
ILKPDGSLY	ILKPDGSLY
AQVSKVEAL	AQVSKVEAL
RQPAAFIVTQY	RQPAIVTQY
AVAPVASAL	AVAPVASAL
ANAGAILSQF	ANAGILSQF
QQIQEKVATF	QQIQKVATF
TQRLKIMEY	TQRLKIMEY
RLYFSQQTY	RLYFSQQTY
SGFENKISY	SGFENKISY
IVFIERTDF	IVFIERTDF
VQFSNHTGY	VQFSNHTGY
AIITTHLQY	AIITTHLQY
QMWISKQEY	QMWISKQEY
VSAVVHEY	VSA-VVHEY
AQQRYATSF	AQQRYATSF
KLPDFESRY	KLPDFESRY
ATNPESKVFY	ATNPESKVF
FQAPTAKEM	FQAPTAKEM
AIQPGSINY	AIQPGSINY
GQTSIRPY	GQT-SIRPY
VTKALEHAF	VTKALEHAF
AQLPEKVEY	AQLPEKVEY
SQVQGTYKY	SQVQGTYKY
HQKQISSL	HQK-QISSL
SARAGETRF	SARAGETRF
KAYGENIGY	KAYGENIGY
KLDPHNHVLY	KLDPNHVLY
FGKLIDLAY	FGKLIDLAY
RQIASNTSL	RQIASNTSL
ISAPHMHAY	ISAPHMHAY
HVAQPDSVY	HVAQPDSVY
FQKEDSPATFY	FQKESPATF
SQIRLIVY	SQI-RLIVY
RQFMAETQF	RQFMAETQF
AQPEPSTGF	AQPEPSTGF
VQRGIGTAY	VQRGIGTAY
AVSPSSVFY	AVSPSSVFY
KIFPSVIKY	KIFPSVIKY
HQVVVAKY	HQV-VVAKY
SMARETVGY	SMARETVGY
AIFGPPNTYY	AIFGPPNTY
YQKAIEVL	YQK-AIEVL
LQNKVSGKF	LQNKVSGKF
RANPFNTPH	RANPFNTPH
GIREEEVSY	GIREEEVSY
VQPPKQQPM	VQPPKQQPM
QQLQLFTEY	QQLQLFTEY
MSKAPSNTF	MSKAPSNTF
QAYHSPATA	QAYHSPATA
RQAHMQARF	RQAHMQARF
KQFEKQVELY	KQFEQVELY
SQATPNQQTY	SQATNQQTY
SIYWTAVTY	SIYWTAVTY
RLFPRPVVAF	RLFPPVVAF
VLKTDEGIAY	VLKTEGIAY
ALQKFTEAY	ALQKFTEAY
RQKQVVIL	RQK-QVVIL
AQNLGNFIVRY	AQNLFIVRY
SQQSKISGY	SQQSKISGY
KQIFETIYY	KQIFETIYY
SQKENINVL	SQKENINVL
SQRVLYIRY	SQRVLYIRY
QQVPVPHVY	QQVPVPHVY
TQIPTETTY	TQIPTETTY
GAHLDLSAF	GAHLDLSAF
QIIQEKRGY	QIIQEKRGY
GQQSSYPGY	GQQSSYPGY
SQRDPPHNNFF	SQRDPHNNF
GQLDAAQRTLY	GQLDAQRTL
AVIEDTWHY	AVIEDTWHY
ALSQAVARY	ALSQAVARY
RLSPAGAAL	RLSPAGAAL
KAFPFHIIF	KAFPFHIIF
ISRETGEPY	ISRETGEPY
AQKLLSEAL	AQKLLSEAL
RLFSTAEAAVY	RLFSTAEAA
AGKTVVAEY	AGKTVVAEY
HQSPATPAF	HQSPATPAF
VQRVASVM	VQR-VASVM
AQSGTGKTATF	AQSGTGKTA
ALEEQLQQIR	ALEEQLQQI
LQFNPKFMTF	LQFNKFMTF
GQKIIKKNL	GQKIIKKNL
VLKLTPVAY	VLKLTPVAY
RLAHEVGWKY	RLAHVGWKY
KQKNTVVRY	KQKNTVVRY
RSSPPSSQF	RSSPPSSQF
AQLERQLQF	AQLERQLQF
RLFTSAEETF	RLFTAEETF
AQRALDEATKY	RALDEATKY
FNEKSKEL	FNE-KSKEL
SQRDTVLSTLY	SQRDVLSTL
YLPQHTIETY	YLPQTIETY
VVAPAGITL	VVAPAGITL
TLMKQYIEF	TLMKQYIEF
IIIETDHNAY	IIIEDHNAY
KIHKPEKAF	KIHKPEKAF
AMRWFQQKY	AMRWFQQKY
QQHSAQAMF	QQHSAQAMF
HQFLQNEY	HQF-LQNEY
AQMKPIFSF	AQMKPIFSF
TMILTVGGTAY	ILTVGGTAY
KLYPWIHQF	KLYPWIHQF
AQRAINNEM	AQRAINNEM
VVIDLGEAF	VVIDLGEAF
AVKNDYEMTF	AVKNYEMTF
TMKPSETSF	TMKPSETSF
SQRLGSQKF	SQRLGSQKF
GASQAGMTGY	ASQAGMTGY
RQSPHSNLF	RQSPHSNLF
EVGDKVVIF	EVGDKVVIF
KLHVSGESSVF	HVSGESSVF
KFKEVGEAF	KFKEVGEAF
IQGVPKVTY	IQGVPKVTY
LLGAAFYGVY	LLGAFYGVY
VLREIAEEY	VLREIAEEY
AVIAHQDSY	AVIAHQDSY
YSFDSRHKPAF	YSFDSRHKP
HQITEVGTM	HQITEVGTM
RNVSTGDVNVE	VSTGDVNVE
RQAPVLLQTY	RQAPLLQTY
RAKLLQKY	RAK-LLQKY
RAYAKDVKF	RAYAKDVKF
YQTDNKKAITY	TDNKKAITY
RVSSQQTVSY	RVSSQTVSY
RTMEIESTF	RTMEIESTF
VQFGANKSQY	VQFGNKSQY
GQRLVYQF	GQR-LVYQF
RLIPHVQVF	RLIPHVQVF
IIYDRDFSY	IIYDRDFSY
RTYDMIQYY	RTYDMIQYY
AQAPAQSQF	AQAPAQSQF
ANKLITVY	ANK-LITVY
SVAKTNTVSY	SVAKNTVSY
RLILDWVPY	RLILDWVPY
RLPATRTVY	RLPATRTVY
RIITKGTQTY	RIITGTQTY
KVNDILELY	KVNDILELY
GQAPSSSSL	GQAPSSSSL
SLRFIDVEF	SLRFIDVEF
VQSSIASAF	VQSSIASAF
AMMHGGTGF	AMMHGGTGF
SQHPQQTSF	SQHPQQTSF
AQERSRLTY	AQERSRLTY
AQIKEKLERY	AQIKKLERY
SQKIPKVDF	SQKIPKVDF
VQKKDTGHIY	VQKKTGHIY
SQVTKSVDF	SQVTKSVDF
LQHDYGHLSVY	LQHDHLSVY
VIRDEVEKY	VIRDEVEKY
SQNMNTKYY	SQNMNTKYY
TAAAVGAVF	TAAAVGAVF
AQTVGNTY	AQT-VGNTY
GVAGVGAGLAY	AGVGAGLAY
IIAPHAGYTY	IIAPAGYTY
YQNNIKNDKY	YQNNKNDKY
SIYPLHDVF	SIYPLHDVF
AQIEGVVPF	AQIEGVVPF
IQPNTTGKQLF	IQPNTGKQL
AQYPSQPQRF	AQYPQPQRF
SLPSHLNISY	SLPSLNISY
KLHLQSTDY	KLHLQSTDY
KQFHRIVTY	KQFHRIVTY
LQKIEVPLY	LQKIEVPLY
AVNGHTNSF	AVNGHTNSF
RSPDFASSF	RSPDFASSF
VQRNHETAF	VQRNHETAF
RLISGVVQSY	RLISVVQSY
LLAGQATTAY	LLAGATTAY
GQKMTTLQH	GQKMTTLQH
LLKKGPKVY	LLKKGPKVY
AVKAELRQY	AVKAELRQY
VGVKPVGSD	VGVKPVGSD
TQSGGVRPF	TQSGGVRPF
AQTVVVEY	AQT-VVVEY
SQKVSGPQY	SQKVSGPQY
HQNLIATY	HQN-LIATY
AMKLGEEAF	AMKLGEEAF
RIIPRSVLY	RIIPRSVLY
GQVQKIVLY	GQVQKIVLY
RLFRDATRY	RLFRDATRY
VQKEDISVVF	VQKEISVVF
TQQPFDVSAF	TQQPDVSAF
SVIGASSQF	SVIGASSQF
LQKTGHRVTY	LQKTHRVTY
KVSSINSRF	KVSSINSRF
YMKSEDPLF	YMKSEDPLF
VLVQHNLVSY	VLVQNLVSY
QLQKDKQVY	QLQKDKQVY
AQRSARALLDY	AQRSARALL
AAAPVIKAY	AAAPVIKAY
QLRAQILAY	QLRAQILAY
KIKTIGATY	KIKTIGATY
LQNPKVTEF	LQNPKVTEF
AVAPVSAVH	AVAPVSAVH
GIHTGQFVY	GIHTGQFVY
RSYAGKNAVAY	AGK-NAVAY
SQRSPSELF	SQRSPSELF
RQNLLSQSHAY	RQNLLSQSH
VAPGKDLTK	VAPGKDLTK
GQVTFLHVF	GQVTFLHVF
AQRPTATY	AQR-PTATY
IQRQETISL	IQRQETISL
RVIGEDGQSVY	VIGEGQSVY
IIKVGGERF	IIKVGGERF
SLARTSSAEY	SLARSSAEY
RQHFSPLSL	RQHFSPLSL
TLNREGTETF	TLNRGTETF
RSNTGGQAF	RSNTGGQAF
KLYQDTHQEY	KLYQTHQEY
SQHQETPVY	SQHQETPVY
AANPAYGRY	AANPAYGRY
RMVQEAEKY	RMVQEAEKY
ALMGEHIHY	ALMGEHIHY
GQHRSTIITLY	GQHRTIITL
AQLDPSLVAF	AQLDSLVAF
GQKYPVHIY	GQKYPVHIY
KLPKGTVSF	KLPKGTVSF
RMPPFTQAF	RMPPFTQAF
RLKSKDVKL	RLKSKDVKL
SQNKSVHSF	SQNKSVHSF
AQDEHLITF	AQDEHLITF
FQQIYARQY	FQQIYARQY
KQFQFGHAL	KQFQFGHAL
SQHYHQGYY	SQHYHQGYY
IVKPKPRAL	IVKPKPRAL
RQKDPVKGM	RQKDPVKGM
RQIDRQNRL	RQIDRQNRL
YQIGDVFISH	YQIGVFISH
VQGRPGAPF	VQGRPGAPF
KLVSEKLASY	LVSEKLASY
KVINAAHSF	KVINAAHSF
RMQKEITAL	RMQKEITAL
RLLDTTITF	RLLDTTITF
YQRDLEVAL	YQRDLEVAL
SQHQVKEAL	SQHQVKEAL
AQREDELTF	AQREDELTF
KIKTIGSTY	KIKTIGSTY
TQAQIKAAYY	TQAQIKAAY
RQIDATFVRF	RQIDTFVRF
MQKLPGTSH	MQKLPGTSH
HGQVQRVAF	HGQVQRVAF
AQVIVFQTY	AQVIVFQTY
LIHRGVSAY	LIHRGVSAY
KQNELLEPNSF	KQNEEPNSF
SQLHARPSY	SQLHARPSY
ALKNRQELY	ALKNRQELY
SARLEKLGY	SARLEKLGY
SQISKVELF	SQISKVELF
SQRLVEERY	SQRLVEERY
AQKVSSQSF	AQKVSSQSF
LAQTTRTAY	LAQTTRTAY
AVFEEIDTY	AVFEEIDTY
RTAQEVETY	RTAQEVETY
AAAAAAPPDP	AAAAAAPPD
SQRAGLQF	SQR-AGLQF
HSAPGGPSY	HSAPGGPSY
AQSHVKISF	AQSHVKISF
LQKSDLSTL	LQKSDLSTL
LIFPQDRVF	LIFPQDRVF
AQVPKSSAL	AQVPKSSAL
HLPLLPNVSY	HLPLPNVSY
LEDALQQAKED	ALQ-QAKED
SVIKQTSAF	SVIKQTSAF
QQPNGAGFAAF	QQP-NGAGF
RLKENNIEQIY	RLKENNIEQ
VLAEKAAAY	VLAEKAAAY
YMIAHITGL	YMIAHITGL
AQLLQYRA	AQL-LQYRA
AQKRLSENAF	AQKRSENAF
AIQEVMESY	AIQEVMESY
VIAPIISNF	VIAPIISNF
RLAEAQSNSF	RLAEQSNSF
IQNGTSGIRF	IQNGSGIRF
VQRRPGQSF	VQRRPGQSF
KQINSVNKF	KQINSVNKF
KLFIGGLSF	KLFIGGLSF
RLYQLDKSTF	RLYQDKSTF
YSKKLEAKY	YSKKLEAKY
VVQEPGQVF	VVQEPGQVF
TLQRATGISF	LQRATGISF
GQPQPGFGY	GQPQPGFGY
GQYEQVKQL	GQYEQVKQL
SLMALQNAY	SLMALQNAY
KSMFQRTTY	KSMFQRTTY
RLNVSQDDVLY	NVSQDDVLY
AQKVAISEF	AQKVAISEF
AVHDITVAY	AVHDITVAY
ILNKSETGY	ILNKSETGY
VVRKEVIRF	VVRKEVIRF
AQLILKAISSY	LILKAISSY
RVYIGRLSY	RVYIGRLSY
LIKRNKQTY	LIKRNKQTY
VQYRYFKGY	VQYRYFKGY
AVAAPSSTF	AVAAPSSTF
QQNVSFVTGY	QQNVFVTGY
GQRVISMY	GQR-VISMY
SVFPERLGF	SVFPERLGF
VQNMKPEEY	VQNMKPEEY
VLIDVGTGY	VLIDVGTGY
AQAQLRNLEAY	AQLRNLEAY
LLADPTGAF	LLADPTGAF
ILRETTVKY	ILRETTVKY
SANVSKVSF	SANVSKVSF
AQRASSNVF	AQRASSNVF
RVFPDKGYSF	RVFPKGYSF
TEELAYLK	TEE-LAYLK
IMQDFESDTF	IMQDESDTF
SSSKGSLGGGF	SSKGLGGGF
YQPETNSSF	YQPETNSSF
TQRMFEIDY	TQRMFEIDY
TQKGPENLHY	TQKGENLHY
GLRAPVSAY	GLRAPVSAY
PQMKVNEY	PQM-KVNEY
QVYGGVTYY	QVYGGVTYY
RQKTAVHVL	RQKTAVHVL
ILINSGSRY	ILINSGSRY
ILIGPTFSY	ILIGPTFSY
VQRKLGFAL	VQRKLGFAL
GQHSHVVRY	GQHSHVVRY
AQAAIVVY	AQA-AIVVY
VVEGNHTVY	VVEGNHTVY
GQFEEFGQTF	GQFEFGQTF
KQKERFAAL	KQKERFAAL
RQKVKNTEF	RQKVKNTEF
KASNPHASF	KASNPHASF
RVKPGDVAV	RVKPGDVAV
IQMETQSSM	IQMETQSSM
RQPLALNVAY	RQPLLNVAY
KLYEKFLEF	KLYEKFLEF
GQIKTVYPASY	QIKTYPASY
SQRQAKIQRY	SQRQKIQRY
RQIIGPFQRF	RQIIPFQRF
VLMPKVMHY	VLMPKVMHY
AEQNRKDAEAW	EQNRKDAEA
GTGFPHMLF	GTGFPHMLF
AQKPSVPRSNF	AQKPPRSNF
IQNQAEPREF	IQNQEPREF
IGQSKSVKIY	GQSKSVKIY
ALPPGSVISY	ALPPSVISY
VVREMTEGY	VVREMTEGY
RIMKKTSLY	RIMKKTSLY
FVAEQKVEY	FVAEQKVEY
RQLPEPLISF	RQLPPLISF
AAVGTGSSY	AAVGTGSSY
IQKTGGTTF	IQKTGGTTF
KVIQAQTAF	KVIQAQTAF
KQPAIMPGQSY	AIM-PGQSY
RTSTSQAVF	RTSTSQAVF
RIKLGDYHF	RIKLGDYHF
TLMGPTRVF	TLMGPTRVF
RVKLPSKAL	RVKLPSKAL
GINISGNFY	GINISGNFY
GQKIQIVTA	GQKIQIVTA
GQLSWHQKTY	GQLSHQKTY
ITKDRPINF	ITKDRPINF
AVIKSNHSY	AVIKSNHSY
IMRAGMSSL	IMRAGMSSL
MIIFIHSYY	MIIFIHSYY
KQPSVLVTF	KQPSVLVTF
GTGGIVSTAF	GTGGVSTAF
AQVLSVVAH	AQVLSVVAH
AVNPSILPTAF	AVNPLPTAF
STYPRPHEY	STYPRPHEY
KMYSTDDGVQF	YSTDDGVQF
RQNKLTYTM	RQNKLTYTM
LVRPPVQVY	LVRPPVQVY
RIKNNDPKL	RIKNNDPKL
RVYVGSIYY	RVYVGSIYY
IQQRPSMQF	IQQRPSMQF
LQRGGLKQL	LQRGGLKQL
LSHEESVSF	LSHEESVSF
GQKPNPYFY	GQKPNPYFY
GQKISTVAV	GQKISTVAV
YQPTPTAGY	YQPTPTAGY
SQRPGAHLTV	SQRPAHLTV
HLRPESHSY	HLRPESHSY
VLKKLDEQY	VLKKLDEQY
YDAEISQIHQ	YDAEISQIH
VLKEKIAKY	VLKEKIAKY
YQPEQPNLVY	YQPEPNLVY
RVSPDGTAF	RVSPDGTAF
LQSQVGTKTY	LQSQGTKTY
ALFRHEVGY	ALFRHEVGY
HQYSIQVAF	HQYSIQVAF
KMPEVRQSSF	KMPERQSSF
YQKQPKIGY	YQKQPKIGY
IQQEVIKAY	IQQEVIKAY
KLANIVERY	KLANIVERY
VRDEESHEFV	VRDEESHEF
VLSAADKGNVK	SAADKGNVK
KVYQETSEM	KVYQETSEM
LQNHENESVY	LQNHNESVY
LIRKDTPHY	LIRKDTPHY
RLQDQGLILY	RLQDGLILY
RVKAWTSRY	RVKAWTSRY
RMHPALSAF	RMHPALSAF
AQFPSSGRF	AQFPSSGRF
SVMRLTISY	SVMRLTISY
SQAAVSARF	SQAAVSARF
LQIHPVVITSF	QIHPVITSF
RQIPYTMMKF	RQIPTMMKF
RLVPVLSSY	RLVPVLSSY
VQIFERSVY	VQIFERSVY
KQKVPLGTF	KQKVPLGTF
RQREMEEQM	RQREMEEQM
YQIHRIRHF	YQIHRIRHF
AQQVVLSSY	AQQVVLSSY
NLKTVQPVL	NLKTVQPVL
HQGYPHRNF	HQGYPHRNF
AQHDAQEFMAF	AQH-DAQEF
ARVIIEKY	ARV-IIEKY
TVKVEDLTF	TVKVEDLTF
SQNFHTSY	SQN-FHTSY
AQYKEISKF	AQYKEISKF
GQRKPATSY	GQRKPATSY
SVKSAAKESLY	SVKSAKESL
QQMWISKQEY	QQMWSKQEY
RQATAASSVM	RQATASSVM
GQSGLFTQY	GQSGLFTQY
QQNEVRVL	QQN-EVRVL
SQIFIGPTYY	SQIFIGPTY
PQMPTQAMF	PQMPTQAMF
GQNPFELAF	GQNPFELAF
KLKGTVGEPTY	KGTVGEPTY
SISKALVAY	SISKALVAY
SVHQPGSHY	SVHQPGSHY
KQFQKVITEY	KQFQVITEY
KMRPGEATL	KMRPGEATL
RLKGKDMVV	RLKGKDMVV
GQRPTQPVY	GQRPTQPVY
KIIRNVGKY	KIIRNVGKY
GQPERKFMQTF	GQP--ERKF
RQPGFASNF	RQPGFASNF
RQLEAARY	RQL-EAARY
FQKIVVLF	FQK-IVVLF
RQVGATVEF	RQVGATVEF
YMSGYHTGY	YMSGYHTGY
ALVPPSADY	ALVPPSADY
AQFKGTQSL	AQFKGTQSL
KQFRPPMGGY	KQFRPMGGY
SQKEKLSH	SQK-EKLSH
VQKRKQLEL	VQKRKQLEL
LVKAGKVY	LVK-AGKVY
SLIDTVRSY	SLIDTVRSY
TLHERFTKY	TLHERFTKY
KIIKEKQAF	KIIKEKQAF
RQYDKFLTHF	RQYDFLTHF
SQIPGPTAAY	SQIPPTAAY
RQKQGVVLKY	RQKQVVLKY
EQIYPVNAISF	QIYPNAISF
ILSGVVTKM	ILSGVVTKM
RQNALGHVRY	RQNAGHVRY
AQLWTDLQY	AQLWTDLQY
ILSKLTDIQY	LSKLTDIQY
AMFDQSQIQEF	AMFDQIQEF
RENDIKSYF	RENDIKSYF
AQYREVAAF	AQYREVAAF
VMYNSSDHDVY	YNSSDHDVY
GLYSPQYISY	GLYSQYISY
KQFEKQVEL	KQFEKQVEL
RVITISKSEY	RVITSKSEY
ISSPVVTSL	ISSPVVTSL
TVIPNSHVY	TVIPNSHVY
VLHQDSGLGY	VLHQSGLGY
AQINSVFNKY	AQINVFNKY
IIKEESDSF	IIKEESDSF
MMKTEGPSY	MMKTEGPSY
GQIGMIQAL	GQIGMIQAL
RQLDRNLTF	RQLDRNLTF
VSHWQQQSY	VSHWQQQSY
VVKPPGSSL	VVKPPGSSL
LVIGVRESY	LVIGVRESY
RMFNGEKINY	RMFNEKINY
KQRPTKLKSL	KQRPKLKSL
GQPLPTSNY	GQPLPTSNY
AQIPVDLSEL	AQIPDLSEL
TLIHSDLTSVY	LIHSLTSVY
NTSQYQGVVVY	SQYQGVVVY
SQKEVVLY	SQK-EVVLY
VLRQETEFF	VLRQETEFF
GQKAGELSL	GQKAGELSL
AIKAFIAVY	AIKAFIAVY
MMIPSQISY	MMIPSQISY
GQIYDRQGATY	QIYDQGATY
QQYVGKVKF	QQYVGKVKF
SIRDGVRAY	SIRDGVRAY
ALSPNHRIY	ALSPNHRIY
YQIDITTENQY	YQIDITTEN
LQHLQIFTY	LQHLQIFTY
SQKENVLQY	SQKENVLQY
KQIVEILTAY	KQIVILTAY
GIIRPGTAF	GIIRPGTAF
GIFPAKTITY	GIFPKTITY
RQIHANHETL	RQIHNHETL
LQAQKLVQY	LQAQKLVQY
IQRTEAYEY	IQRTEAYEY
TQRLVQVM	TQR-LVQVM
SQVVTRYAY	SQVVTRYAY
ISRELYEY	ISR-ELYEY
AVISTILKY	AVISTILKY
AQYQFTGIKKY	YQFTGIKKY
TVYMGKVTF	TVYMGKVTF
ALSKGATVY	ALSKGATVY
AQKKLLSKM	AQKKLLSKM
KQRDVDFKAF	KQRDDFKAF
RMKKLDQQY	RMKKLDQQY
SQTEVSSEY	SQTEVSSEY
KLTKAVATY	KLTKAVATY
SQYDPKIVY	SQYDPKIVY
LQKVITLY	LQK-VITLY
RMVLVNAVY	RMVLVNAVY
KLFPDIPIGY	KLFPIPIGY
AMMGLAQIY	AMMGLAQIY
RLFPLIQAM	RLFPLIQAM
HVYEIPVEY	HVYEIPVEY
RMHQAIERF	RMHQAIERF
SKNLSSIS	SKN-LSSIS
ATSGVHSNF	ATSGVHSNF
SMKGDPVNY	SMKGDPVNY
RVINLHEVY	RVINLHEVY
ISERIQLSI	ISERIQLSI
RVVEGNHVVY	RVVENHVVY
VQAGNSSLY	VQAGNSSLY
NSKVVSQY	NSK-VVSQY
RVVDIYSKF	RVVDIYSKF
RQIHKVLGM	RQIHKVLGM
HQNVSILY	HQN-VSILY
ALQNHENESVY	LQNHNESVY
FQKILTLTY	FQKILTLTY
KLYVPVKEY	KLYVPVKEY
IQMTLPKTY	IQMTLPKTY
LLYTEVTRY	LLYTEVTRY
KIRPGEQEQY	KIRPEQEQY
GQYPLQVNGY	GQYPQVNGY
RQYEGHVNEY	RQYEHVNEY
RQKQMKVL	RQK-QMKVL
TIHTGEKPY	TIHTGEKPY
HQLATDSTF	HQLATDSTF
AQRQPMKPTY	AQRQMKPTY
AVKAIIYQY	AVKAIIYQY
IQFNLRNLY	IQFNLRNLY
AVNGAVGTTF	AVNGVGTTF
RQYGSEGRFTF	RQYGSEGRF
RIAPAFSSM	RIAPAFSSM
LLKGIDRY	LLK-GIDRY
GQTLFAGY	GQT-LFAGY
RIFGTDSQY	RIFGTDSQY
NVIRDAVTY	NVIRDAVTY
AVGPRVFQY	AVGPRVFQY
QQHDFTSQIF	QQHDTSQIF
SQPQSSTGGY	SQPQSTGGY
RIFANAHTY	RIFANAHTY
GLMKGKHYY	GLMKGKHYY
KQIEERASHY	KQIERASHY
QQIAPDVDTY	QQIADVDTY
PQAPSGPSY	PQAPSGPSY
VLFPLKSEF	VLFPLKSEF
FVKDEKTRF	FVKDEKTRF
HQHTISTL	HQH-TISTL
SVAGHVEVY	SVAGHVEVY
LQHDNIIAYY	LQHDNIIAY
TTKSADRVTY	TTKSDRVTY
KQILTEGERY	KQILEGERY
GQILMPNIGY	GQILPNIGY
HQREITSL	HQR-EITSL
RQHNYTEAF	RQHNYTEAF
TVTEKPEVID	TVTEKPEVI
YQTIGNHASY	QTIGNHASY
TLKKAAVHY	TLKKAAVHY
ILARNFVNY	ILARNFVNY
AVGFPTHLY	AVGFPTHLY
SIIPGSAAY	SIIPGSAAY
AQPLESGTHF	AQPLSGTHF
VAMYVHAY	VAM-YVHAY
YQFTGIKKY	YQFTGIKKY
SMRKTFARY	SMRKTFARY
VQRGGTPSAF	VQRGTPSAF
IAPTGHSL	IAP-TGHSL
YLKIRHSSY	YLKIRHSSY
LMVPVTVVF	LMVPVTVVF
GVKSVGQGY	GVKSVGQGY
AQSSIALHHQY	SSIALHHQY
GQTAYATSY	GQTAYATSY
RLYQHAVEY	RLYQHAVEY
RIMDPDVITGY	IMDPVITGY
SQMPKLEAF	SQMPKLEAF
RLPDAHSDY	RLPDAHSDY
IQHPSNVL	IQH-PSNVL
GQILRIIQL	GQILRIIQL
RIKETKEVY	RIKETKEVY
AEQRGENALKD	AEQRGENAL
GLYRTGKSY	GLYRTGKSY
TVSAKNEAGI	TVSAKNEAG
QQFPAFNSY	QQFPAFNSY
SGSQRISSIY	SQR-ISSIY
IEYPTGSGNVY	IEYPSGNVY
AQIPPHAVM	AQIPPHAVM
SQYPVPDVSTY	SQYPDVSTY
KLISQQKAF	KLISQQKAF
GQKIFYVNY	GQKIFYVNY
GQHVATQHF	GQHVATQHF
KMFNALIHRY	KMFNLIHRY
LQSPNRVGF	LQSPNRVGF
AQNEGKAMSY	AQNEKAMSY
TQVPPKHVY	TQVPPKHVY
QQALLRISL	QQALLRISL
SQIRMQNHF	SQIRMQNHF
RTFDETVSTY	RTFDTVSTY
VQKYQSPVRVY	YQS-PVRVY
ILKSPGSVVF	ILKSGSVVF
DTGRPSTTVR	TGRPSTTVR
AQSDFISAF	AQSDFISAF
GQQPSQSAF	GQQPSQSAF
KQILLENTF	KQILLENTF
LQQRHQLESY	QQRHQLESY
FQKADGVPVY	FQKAGVPVY
NQVQSGRAF	NQVQSGRAF
RLKEFLKNY	RLKEFLKNY
TQIRVVNAF	TQIRVVNAF
RVVEGNHTVY	RVVENHTVY
RLYEDSGYSSF	RLY-EDSGY
SVIDSAELQAY	SVIDELQAY
GQMAQKFSF	GQMAQKFSF
TLQDSRTNTAY	LQDSTNTAY
AQGVPRYSY	AQGVPRYSY
AQRSTETALY	AQRSTETAL
ILAQLNAKY	ILAQLNAKY
HQLAVTAY	HQL-AVTAY
KMKQDAQVVLY	KQDAQVVLY
RQYHLQQLF	RQYHLQQLF
AAAPAGTTF	AAAPAGTTF
RVFSLSSEF	RVFSLSSEF
AQVKADGHKVY	QVKAGHKVY
YQYLEQSKY	YQYLEQSKY
RIMDSSQNAY	RIMDSQNAY
KANPFGGASH	KANPGGASH
IQKFHSRAL	IQKFHSRAL
GQKLGGQSF	GQKLGGQSF
RQITDKAREF	RQITKAREF
AQPGSEPTPM	AQPGEPTPM
KSIDNKALY	KSIDNKALY
SGRMQKVSY	SGRMQKVSY
KVFDGIPPPY	KVFDIPPPY
AQYLINVRL	AQYLINVRL
AQQSIREKY	AQQSIREKY
RIIPRHLQL	RIIPRHLQL
KQYPPNTSKVY	KQYPPNTSK
MQHSLAGQTY	MQHSAGQTY
GQNASVLAY	GQNASVLAY
AQRPSSPAL	AQRPSSPAL
GQNAQTMAY	GQNAQTMAY
LVYRADTQTY	LVYRDTQTY
RVKDLESLF	RVKDLESLF
VILPPLSPY	VILPPLSPY
GQIEVVKY	GQI-EVVKY
QQHPQAAASY	QQHPAAASY
VMHQIISKY	VMHQIISKY
KLIEFMDTF	KLIEFMDTF
YQKLLKYY	YQK-LLKYY
YENEVALRQ	YENEVALRQ
SLKGLTNSY	SLKGLTNSY
SIRPDNMSEY	SIRPNMSEY
GQIPEIIFY	GQIPEIIFY
IISPVGDAY	IISPVGDAY
RVGPIEATSF	RVGPEATSF
KQIDPEMLNSF	KQIDMLNSF
IRLENEIQTY	RLENEIQTY
SQPDWPGGSRY	SQPDGGSRY
TQREGVSSL	TQREGVSSL
TLAFPSEHF	TLAFPSEHF
YVHDDGRVSY	YVHDGRVSY
SQHIGTGNLY	SQHITGNLY
AQLKDYITY	AQLKDYITY
SLFLPRTDY	SLFLPRTDY
AQAIEDMVGY	AQAIDMVGY
RLNFSHGTHEY	RLNFSHGTH
ALNPQNTVF	ALNPQNTVF
EQILATAVY	EQILATAVY
AQKTIVKETY	AQKTVKETY
RVQGFQVEY	RVQGFQVEY
GQRFLEVQY	GQRFLEVQY
KVHVPARPY	KVHVPARPY
LQHPDVAAY	LQHPDVAAY
AGHLSTAQY	AGHLSTAQY
AQRDIIFEL	AQRDIIFEL
KIYDREQTRY	KIYDEQTRY
IQSHVIRGY	IQSHVIRGY
RQGAHIVGY	RQGAHIVGY
YQPAPPSGY	YQPAPPSGY
LVINSKNQY	LVINSKNQY
GQTGSGKTF	GQTGSGKTF
IQKELIEEF	IQKELIEEF
RQAFFLHTTY	RQAFLHTTY
ISKALVAYY	ISKALVAYY
SQADIKKAY	SQADIKKAY
FIIDTRDAGY	FIIDRDAGY
HQIGNLKKY	HQIGNLKKY
QQNPKVQKY	QQNPKVQKY
SVVKELSSF	SVVKELSSF
VQHGVEGLTY	VQHGEGLTY
AQVVQWVSF	AQVVQWVSF
GQKENVVVY	GQKENVVVY
GQRELIESY	GQRELIESY
RQAEMKRLY	RQAEMKRLY
RLYGPSSVSF	RLYGSSVSF
KIIETTGVHF	KIIETGVHF
SQHIADTHF	SQHIADTHF
SLFRKVSVY	SLFRKVSVY
RQAPQPQSSL	RQAPPQSSL
AQQEAERARF	AQQEERARF
GQHGYSTGY	GQHGYSTGY
KLFDATLTQY	KLFDTLTQY
GQKQAQQVM	GQKQAQQVM
KQIIRNIKF	KQIIRNIKF
VQRTQAPAV	VQRTQAPAV
GQIIGEGRY	GQIIGEGRY
FLAPLVTEY	FLAPLVTEY
AIKADHVSTY	AIKAHVSTY
GQIPQILYY	GQIPQILYY
HQLRAQILAY	QLRAQILAY
AQQEARTEF	AQQEARTEF
AQVKPDGTY	AQVKPDGTY
RQAAFVDSY	RQAAFVDSY
FQKLPSKVQY	FQKLSKVQY
KQRTHVMRF	KQRTHVMRF
TMFVQRQVF	TMFVQRQVF
KVQKEGKISY	VQKEGKISY
GQREVHRLY	GQREVHRLY
RLVGLKKSFY	RLVGLKKSF
SQKQIEEHF	SQKQIEEHF
KQMEDGHTLF	KQMEGHTLF
SVKASSVVY	SVKASSVVY
AQQKAMKSL	AQQKAMKSL
ITNDTVQTY	ITNDTVQTY
KQQHFDVQQY	KQQHDVQQY
AVSPAVPVY	AVSPAVPVY
IQVDPNYAY	IQVDPNYAY
AAAVPTRSY	AAAVPTRSY
SQGVHISVY	SQGVHISVY
QQYYPDGNSQY	QYYPGNSQY
QLGPVGGVF	QLGPVGGVF
RTAGPHTQF	RTAGPHTQF
FVEVGRVAY	FVEVGRVAY
SLFHGGKSHY	SLFHGKSHY
HQFYPTVVY	HQFYPTVVY
TQRLISEL	TQR-LISEL
QQQQQQQFQ	QQQQQQQFQ
TQREVIQAL	TQREVIQAL
AQIVHAISY	AQIVHAISY
MQNHIVQAF	MQNHIVQAF
RVADFGSATF	RVADGSATF
SQARLLTSF	SQARLLTSF
RQAPPHIEL	RQAPPHIEL
TEELNREVATN	ELNREVATN
SQKIETMQF	SQKIETMQF
RLFDANKAELF	RLFDNKAEL
RAYAKALHY	RAYAKALHY
GQVKFKSSNY	GQVKKSSNY
LQHDNIVKY	LQHDNIVKY
AQYEEIAQR	AQYEEIAQR
QQLDPDEKITY	QLDPEKITY
FLFDGSPTY	FLFDGSPTY
RQLLQEDRY	RQLLQEDRY
TQQIPSKVLF	QQIPSKVLF
LQREEEEAF	LQREEEEAF
RLQSSFTAF	RLQSSFTAF
TINAAHVEY	TINAAHVEY
YLNEQGDRVY	YLNEGDRVY
TQKSVTVAF	TQKSVTVAF
ILQDYTHEF	ILQDYTHEF
AQITQKIGVH	AQITQKIGV
RQHEEPESF	RQHEEPESF
GQHPALSY	GQH-PALSY
IMKIDIEKF	IMKIDIEKF
KQKEVIEGY	KQKEVIEGY
IQIGLTREF	IQIGLTREF
SQRMVEGY	SQR-MVEGY
SLKGVDPKF	SLKGVDPKF
VQTLVEKY	VQT-LVEKY
LLQTRGDSF	LLQTRGDSF
KQIVDRVSY	KQIVDRVSY
KLIWKVTDY	KLIWKVTDY
ILAAANPAY	ILAAANPAY
AQKFATDGEGY	AQKFDGEGY
AQILDKATEY	AQILKATEY
KQIDPVLQVY	KQIDVLQVY
GLFQGKTPL	GLFQGKTPL
RVHTGERPF	RVHTGERPF
IQTHVLSY	IQT-HVLSY
RIFANTESY	RIFANTESY
RQKPVDLLKY	RQKPDLLKY
QQVQQVAAEY	QQVQVAAEY
RAFPYGNVAF	RAFPGNVAF
SQSPAYNSQY	SQSPYNSQY
SQFTDGQQLY	SQFTGQQLY
RQSTPRVSF	RQSTPRVSF
QQVHNLLLTY	QVHNLLLTY
LQRMEQQEM	LQRMEQQEM
SQQMVMVKY	SQQMVMVKY
IQQVGNEAY	IQQVGNEAY
ITSPHTTSY	ITSPHTTSY
AEVNADRITWL	EVNADRITW
IQLLQKLTY	IQLLQKLTY
QSKTIKVSY	QSKTIKVSY
TLITGLEEY	TLITGLEEY
AVRDISEASVF	AVRDISEAS
KQIKPDMETY	KQIKDMETY
HQLRAQIMAY	QLRAQIMAY
VINPKDNNQF	VINPDNNQF
VQYQDPAAVSF	YQDPAAVSF
SQMGNLHAF	SQMGNLHAF
AQNGPNTSL	AQNGPNTSL
YQYPVIIHL	YQYPVIIHL
VLRPFPASY	VLRPFPASY
TVSPAHTSY	TVSPAHTSY
KLFDHAVSKF	KLFDAVSKF
VQLEQLRPF	VQLEQLRPF
SQYPFPVTLY	SQYPPVTLY
RQPVTKNTF	RQPVTKNTF
RQLLYITAF	RQLLYITAF
AQNPRPTRL	AQNPRPTRL
YIRPEGQDSAF	YIRPQDSAF
QALILKIA	QAL-ILKIA
KQMTFEAQAF	KQMTEAQAF
RINNEDNSQF	RINNDNSQF
PQYQTWEEF	PQYQTWEEF
GQYSTGKTTF	GQYSGKTTF
ILAGHENSY	ILAGHENSY
RQKEIPRVL	RQKEIPRVL
YIQKNVQLY	YIQKNVQLY
VIIKGTQIY	VIIKGTQIY
RGFAHGSVY	RGFAHGSVY
YSLDGRLLSTY	SLDGLLSTY
RLQRQRAILY	LQRQRAILY
VQQVHVATY	VQQVHVATY
AVAGARDTY	AVAGARDTY
RIYPYAAISY	RIYPAAISY
AVSAVVHEY	AVSAVVHEY
TQQGAALQNY	TQQGALQNY
RVREAENVAF	RVREENVAF
QQVPVNQVF	QQVPVNQVF
KQKAAGVRDVF	KAAGVRDVF
AVRDHNVEF	AVRDHNVEF
RLMQVGEEF	RLMQVGEEF
LVFKEDGQEY	LVFKDGQEY
LQRDKPIEM	LQRDKPIEM
HQNEIVQSL	HQNEIVQSL
HQEIARSSY	HQEIARSSY
RLFNLVHQAY	RLFNVHQAY
LQRLENTQY	LQRLENTQY
GQSKSVKIY	GQSKSVKIY
IQKDNPKIVH	IQKDPKIVH
KITDSAGHILY	ITDSGHILY
ALVDIIHGY	ALVDIIHGY
RQRDYKLAAL	RQRDKLAAL
FQRNIKKEY	FQRNIKKEY
ALGPPLNIHY	ALGPLNIHY
QQIPSKVLF	QQIPSKVLF
RAYQQSEAY	RAYQQSEAY
KLNEGVVEF	KLNEGVVEF
ALLKIEGVY	ALLKIEGVY
HQKELAAQL	HQKELAAQL
RQHLQATGV	RQHLQATGV
KLASTGTSEY	KLASGTSEY
SQRIFITY	SQR-IFITY
HQVAPSPAGY	QVAPSPAGY
TQKIGVHAF	TQKIGVHAF
RLFQDEEIY	RLFQDEEIY
FQKQLLEDY	FQKQLLEDY
RVIELVQKY	RVIELVQKY
YQSHGRSAF	YQSHGRSAF
KQVMEGRVTF	QVMEGRVTF
PQKIAGELY	PQKIAGELY
VQRYSQDSF	VQRYSQDSF
VLAPHLTRAY	VLAPLTRAY
IQHLVPASF	IQHLVPASF
AQHEDQVEQY	AQHEQVEQY
GQPVKVRVSY	GQPVVRVSY
ALKNPSEEY	ALKNPSEEY
KQLPDQISF	KQLPDQISF
AQIKHLARL	AQIKHLARL
ADVQKERY	ADV-QKERY
AQVKKATVF	AQVKKATVF
YQPEVHGVSY	YQPEHGVSY
AQHIVTIVH	AQHIVTIVH
VQSSTSIRY	VQSSTSIRY
YQKKLRSM	YQK-KLRSM
HQNSNIRTY	HQNSNIRTY
AVHPGNMMY	AVHPGNMMY
VAKTNTVSY	VAKTNTVSY
NQKPPSAEF	NQKPPSAEF
RQHRMMILY	RQHRMMILY
KQKVTSKIDY	KQKVSKIDY
KQNPAANKTNY	KQNPNKTNY
RAAPFSLEY	RAAPFSLEY
ELKAPGISY	ELKAPGISY
LSAGATKVY	LSAGATKVY
RLKSQDLEL	RLKSQDLEL
AQKYHEYSHY	AQKYEYSHY
VVVAVGRALY	VVAVGRALY
AQHLSQLLF	AQHLSQLLF
QQQAPGKNF	QQQAPGKNF
RQRIVQQY	RQR-IVQQY
GSRVISHY	GSR-VISHY
QVFEGHTHY	QVFEGHTHY
YTAQPTQGY	YTAQPTQGY
LQKISGQNGTF	KISGQNGTF
ITSSPHPEY	ITSSPHPEY
IQSRITKTF	IQSRITKTF
QLPKPTSTY	QLPKPTSTY
IVFVGTGQTY	IVFVTGQTY
VAFPSSSVY	VAFPSSSVY
SINPDEAVAY	SINPEAVAY
LQIGADDVEAF	IGADDVEAF
LQQNPVTEY	LQQNPVTEY
AVNALQSVY	AVNALQSVY
GQYSPPPYSEY	YSPPPYSEY
MIIGGGMAF	MIIGGGMAF
RQHEIDGKALF	RQHEDGKAL
GVMKSGHVF	GVMKSGHVF
AGKMITAAY	AGKMITAAY
GQKPWSQHY	GQKPWSQHY
FQISKEYERF	FQISEYERF
AMHPQVNIY	AMHPQVNIY
AQRRLKAEL	AQRRLKAEL
RQIVSAVQY	RQIVSAVQY
TQAQTTATY	TQAQTTATY
QTVLESIEY	QTVLESIEY
AIIERTASF	AIIERTASF
SQRYQVGVHY	SQRYVGVHY
KLYSPSSQQY	KLYSSSQQY
ITKPQNLNDAY	PQN-LNDAY
HMMEKIKSY	HMMEKIKSY
QVAPVANSY	QVAPVANSY
HQAPRQLFY	HQAPRQLFY
HQPLHVTKGY	HQPLVTKGY
LLFPITEKY	LLFPITEKY
VQADVQKERY	VQADQKERY
RQVVRSSKF	RQVVRSSKF
AQHPNIVTV	AQHPNIVTV
AVFQGKKITF	AVFQKKITF
SLFKSLSRY	SLFKSLSRY
RQLGIIVSDF	RQLGIVSDF
QQRNAYTRF	QQRNAYTRF
RQQQSQTAY	RQQQSQTAY
AQKPQLLRH	AQKPQLLRH
VIVPSSEITY	IVPSSEITY
RLSTPSASTY	RLSTSASTY
KIISDNLTY	KIISDNLTY
ASQKGMSVY	ASQKGMSVY
KVMELHKSY	KVMELHKSY
TQRDFMLSF	TQRDFMLSF
KMNPQSAFF	KMNPQSAFF
SQAESKVFY	SQAESKVFY
LNITNVAF	LNI-TNVAF
IQPGEQKYEY	IQPGQKYEY
KQYSPLLAAF	KQYSLLAAF
ALIEFIRSEY	ALIEIRSEY
ITAPTVRQY	ITAPTVRQY
VTIKKDVDGA	TIKKDVDGA
KLSEGVTISY	KLSEVTISY
KVANIILSY	KVANIILSY
RLRVSSEIRY	RLRVSEIRY
AQKNHIPVF	AQKNHIPVF
SQAIIHQY	SQA-IIHQY
KLNPRLAILY	KLNPLAILY
ILPLIISKY	ILPLIISKY
ASSPPHLQF	ASSPPHLQF
RLQEALNLF	RLQEALNLF
SQMKSYQSF	SQMKSYQSF
VQELQNLL	VQE-LQNLL
GQHFPIEVRHY	GQHFPIEVR
RQFWFQGNRY	RQFWQGNRY
AIKPGTPLY	AIKPGTPLY
IIMSKSTTY	IIMSKSTTY
RIKKPDYKVAY	IKKPYKVAY
SQHQAIERF	SQHQAIERF
KLFGEKSASF	KLFGKSASF
AVNEAIKSY	AVNEAIKSY
AQPKPATAL	AQPKPATAL
QAGPATGQAY	AGPATGQAY
KVIQSVANY	KVIQSVANY
YANEVGEAF	YANEVGEAF
RLNLESSNSKY	RLNLSNSKY
RLFEKMQAY	RLFEKMQAY
ILGPPGSVY	ILGPPGSVY
GQNGKDEVVAY	GQNGEVVAY
GIIPVGGTY	GIIPVGGTY
IIHTGENLY	IIHTGENLY
GQFRDQIKF	GQFRDQIKF
RVHLPSSIY	RVHLPSSIY
AQYEDIAQK	AQYEDIAQK
IQLEPDQIIHY	QLEPQIIHY
SQFSAPRDY	SQFSAPRDY
GQNPTNAEVL	GQNPNAEVL
RVKEKEAIL	RVKEKEAIL
QQIDIQTHF	QQIDIQTHF
IQKAPGERL	IQKAPGERL
VANPNSAIF	VANPNSAIF
LLARPSSTITY	LARPSTITY
LIARSLGKY	LIARSLGKY
IQQLVRKSY	IQQLVRKSY
RMRHLKIVY	RMRHLKIVY
YAKSSVGETVY	KSSVGETVY
GQHIQLVQY	GQHIQLVQY
KLYQSIIGY	KLYQSIIGY
GQFLPQTQF	GQFLPQTQF
ALAPALVETY	ALAPLVETY
ASAAPHTSF	ASAAPHTSF
IIKSGDQTF	IIKSGDQTF
YQVGINQRF	YQVGINQRF
VQGPVGTDF	VQGPVGTDF
QIKPDMETY	QIKPDMETY
GSQRISSIY	GSQRISSIY
HQYPNFKDIRY	HQYPKDIRY
RLRDDIKEY	RLRDDIKEY
YSVNGERLGTY	SVNGRLGTY
IMQSIQSKY	IMQSIQSKY
AQNRFLLEL	AQNRFLLEL
SQLPLKVEF	SQLPLKVEF
RISDFHETY	RISDFHETY
GQEFIRVGY	GQEFIRVGY
ILKDMGITEY	ILKDGITEY
HQKQAPISY	HQKQAPISY
TQVQGLQHY	TQVQGLQHY
VVQGLLSETY	VQGLLSETY
AVAEPVVSY	AVAEPVVSY
SINPLGGFVHY	SIN-PLGGF
ALRQMQVLY	ALRQMQVLY
IQYDKTNVL	IQYDKTNVL
SIREAGGAF	SIREAGGAF
RQFEGLQGY	RQFEGLQGY
VQEGNVESAY	VQEGVESAY
LSKELRQKY	LSKELRQKY
AQVDGGANF	AQVDGGANF
KLADQIFAYY	KLADQIFAY
HQAIHTIEY	HQAIHTIEY
RLRISPDRVY	RLRIPDRVY
LLYQEKIRY	LLYQEKIRY
GQNAAVVHRF	GQNAVVHRF
VVGPSSVLTY	VVGPSVLTY
TQAAPALDF	TQAAPALDF
AVRTTGNVY	AVRTTGNVY
GQIGVRTPL	GQIGVRTPL
HQMTPSSSY	HQMTPSSSY
ILKRNIQQY	ILKRNIQQY
SQGRPSSMY	SQGRPSSMY
AQNLSIIQY	AQNLSIIQY
SQHSPSKKALY	SQHSSKKAL
VQKAIAHY	VQK-AIAHY
RGQQVIVSY	RGQQVIVSY
TQMPDPKTF	TQMPDPKTF
LLIAGQINTY	LLIAQINTY
VQRPEFHAL	VQRPEFHAL
AAAAAAAGSPY	AAAAAGSPY
RQQSHFAMM	RQQSHFAMM
IQKQISYNY	IQKQISYNY
GQERPSVTSY	GQERSVTSY
KLFGFTERY	KLFGFTERY
RQKELESNY	RQKELESNY
RQNVAVNEL	RQNVAVNEL
ILKFPHSAH	ILKFPHSAH
GQAPGYSY	GQA-PGYSY
KVADMALHY	KVADMALHY
YLPDGTASL	YLPDGTASL
TLNVSTTRY	TLNVSTTRY
GVIQPGRGF	GVIQPGRGF
ALAADHTVY	ALAADHTVY
RVSNVKSVY	RVSNVKSVY
RLKKLIEQY	RLKKLIEQY
RLISENSVY	RLISENSVY
IQQHFSATLAY	QQHFATLAY
AQRENLSAAF	AQRELSAAF
IMIRESGQLF	MIRESGQLF
AQHLFIQTF	AQHLFIQTF
SQIKAVENY	SQIKAVENY
TQIQPQPGF	TQIQPQPGF
VQPTFTASQY	VQPTTASQY
SQARTLITF	SQARTLITF
RQFDLAWQY	RQFDLAWQY
LMPEFQFGTY	LMPEQFGTY
YQQIIQTY	YQQ-IIQTY
VTSPIRASY	VTSPIRASY
AQRPTEQEL	AQRPTEQEL
RIATPFQVY	RIATPFQVY
TQFINPETPGY	FINPETPGY
ILFPVSGVGSY	ILFPGVGSY
KVAQPKEVY	KVAQPKEVY
AVMKSLTQTF	VMKSLTQTF
AMYSRKAMY	AMYSRKAMY
FQYDSTHGKF	FQYDTHGKF
TVKDGVTLY	TVKDGVTLY
AQAQLQKRY	AQAQLQKRY
GQADVISKL	GQADVISKL
AQRPNPVQL	AQRPNPVQL
AQQEAQRAQF	AQQEQRAQF
VQNKNSSYF	VQNKNSSYF
VVAGSVVSY	VVAGSVVSY
HQFEKIEQF	HQFEKIEQF
IINNAIVHY	IINNAIVHY
RVVPQFVVF	RVVPQFVVF
SLAYLVNTY	SLAYLVNTY
RLHSGEVKF	RLHSGEVKF
VQKAAPGSQRY	KAAPGSQRY
GQKSLRSY	GQK-SLRSY
SAPVGVTAL	SAPVGVTAL
GQHSQGLGGHY	HSQGLGGHY
AASRIKTIY	AASRIKTIY
RQVHPFHVY	RQVHPFHVY
VQFIGRESKY	VQFIRESKY
YLNEKAVSY	YLNEKAVSY
IQSTIRTQF	IQSTIRTQF
KQIIVDPLSF	KQIIDPLSF
TQRSQQLEF	TQRSQQLEF
GQIQEKVRY	GQIQEKVRY
TMQSATGIQY	MQSATGIQY
LIHEGENSY	LIHEGENSY
KQVVPVSSH	KQVVPVSSH
VSGSQRISSIY	SQR-ISSIY
TNAENEFVTIK	AENEFVTIK
SVKEMRERY	SVKEMRERY
LLHGNPGSTY	LLHGPGSTY
RMNPNSPSITY	RMNPPSITY
GAYGQAVRY	GAYGQAVRY
GQVALRTSL	GQVALRTSL
IQMRDLEGY	IQMRDLEGY
RSSPPGHYY	RSSPPGHYY
AMLRQLAQY	AMLRQLAQY
KLYQFNPAFF	KLYQFNPAF
SAPSRATAL	SAPSRATAL
GQTKQVTVY	GQTKQVTVY
GQKVTDDMY	GQKVTDDMY
YSHLVPVY	YSH-LVPVY
IVVKPNLEY	IVVKPNLEY
KQKGDRVVLF	KQKGDRVVL
VQPKHVKEAF	VQPKVKEAF
IQPGRGFVLY	IQPGGFVLY
SQSPQGRVM	SQSPQGRVM
RLFKDQLVY	RLFKDQLVY
AVKVSPVSY	AVKVSPVSY
KQIASVMKH	KQIASVMKH
RQYPWGVVQV	RQYPGVVQV
FQMEQIVY	FQM-EQIVY
AVTHIGRVY	AVTHIGRVY
IQKQEQIPLTY	KQEQIPLTY
SLVGITSAY	SLVGITSAY
SQVVFSGKAY	SQVVSGKAY
SLKQEVESF	SLKQEVESF
RQLEEEGITF	RQLEEGITF
GLSKPVSSY	GLSKPVSSY
AQYGKLESL	AQYGKLESL
GQVFPLSSH	GQVFPLSSH
GQIMDSETF	GQIMDSETF
LQINDKIAL	LQINDKIAL
ALYKKILKY	ALYKKILKY
AVSPLARSY	AVSPLARSY
KLKGSGLRY	KLKGSGLRY
KIIHTGEKPY	IIHTGEKPY
RQALAYLEQSY	ALAYLEQSY
RVKQEEQRY	RVKQEEQRY
AQRPNLIGL	AQRPNLIGL
LSQVPSLSH	LSQVPSLSH
ASQAGMTAY	ASQAGMTAY
AQKAASKVTL	AQKASKVTL
VEKAPQETY	VEKAPQETY
QQPASGVAY	QQPASGVAY
QLKGGIHKY	QLKGGIHKY
ALKRQGRTLY	ALKRGRTLY
KQIYYSDKY	KQIYYSDKY
LQIGVKSEF	LQIGVKSEF
RVSNIRQVF	RVSNIRQVF
KTFPYQHRY	KTFPYQHRY
TMVGKTFTY	TMVGKTFTY
SQYGELIEKY	SQYGLIEKY
KVADPVVTF	KVADPVVTF
HQRSFTETM	HQRSFTETM
RMIDFAHSTF	RMIDAHSTF
KQASVVIQQQY	ASVVIQQQY
VVKMPSGEF	VVKMPSGEF
IQKESTLHL	IQKESTLHL
KQIEGTGISM	KQIETGISM
SQATPHSSY	SQATPHSSY
GQRSYLVQY	GQRSYLVQY
VVAGDIAVY	VVAGDIAVY
AQREPLSSAF	AQRELSSAF
AQAGWLQHDF	AQAGLQHDF
MVADRVEVY	MVADRVEVY
SVKRHEVQF	SVKRHEVQF
FVAEERKHY	FVAEERKHY
HQYNPKFQTLF	HQYNKFQTL
LQKGVNILTSY	GVN-ILTSY
SVHNAGISF	SVHNAGISF
HQHLSKESL	HQHLSKESL
AQAEAQQPTF	AQAEQQPTF
AQKKLISQV	AQKKLISQV
FQSLPKSAF	FQSLPKSAF
KLAPAQYIRY	KLAPQYIRY
AQQSEPIAY	AQQSEPIAY
RQLPSSHAL	RQLPSSHAL
RTYGVVAQY	RTYGVVAQY
GQIDKEAVQKY	GQIDAVQKY
TAKGGDISV	TAKGGDISV
KQIGGGDIAVF	KQIGDIAVF
RIADLISSF	RIADLISSF
RVYPELQRF	RVYPELQRF
RVFFVHEGY	RVFFVHEGY
VQKKPAELQGF	VQKKELQGF
KLQVQIQAY	KLQVQIQAY
QQQQQTQAF	QQQQQTQAF
AQPPVSTEY	AQPPVSTEY
AVAPPSTSA	AVAPPSTSA
RQHNTEIRM	RQHNTEIRM
KQQNPRLVY	KQQNPRLVY
VQPEAAGSVAM	VQPEAGSVA
GQPPFASRSF	GQPPASRSF
NQKQQHLAF	NQKQQHLAF
IITKGTQTY	IITKGTQTY
SLHPGSSAL	SLHPGSSAL
AQAASQHVF	AQAASQHVF
VQREYNLNF	VQREYNLNF
KLFGPFTRNYY	KLFGFTRNY
KQQQPPTVY	KQQQPPTVY
KVADWTGATY	KVADTGATY
TVKDSRTVY	TVKDSRTVY
GQPLRPQANY	GQPLPQANY
RQIEEQKAL	RQIEEQKAL
AQKSISQHY	AQKSISQHY
KLYEGKTKEVY	KLYETKEVY
FQYESKVFY	FQYESKVFY
AMYLHRPEEY	AMYLRPEEY
VLYDQPRHVQY	VLYDRHVQY
IIHTGEKPY	IIHTGEKPY
AQFETKKLY	AQFETKKLY
RSFAGNLNTY	RSFANLNTY
MQQIQKGSY	MQQIQKGSY
HGIDPTGTY	HGIDPTGTY
KMIPPGIHF	KMIPPGIHF
LRNQLQSVY	LRNQLQSVY
GMNRFNSRTY	GMNRNSRTY
ISKALVAY	ISK-ALVAY
SQVLNRLTF	SQVLNRLTF
YSMPSTHAM	YSMPSTHAM
VQKPDAANY	VQKPDAANY
AQFEPDSTEY	AQFEDSTEY
SQINRAYQF	SQINRAYQF
RISDIMDVY	RISDIMDVY
QVVFSGKAY	QVVFSGKAY
YIRQGEQSL	YIRQGEQSL
AQLNRDMIVSF	QLNRMIVSF
SQIQNREF	SQI-QNREF
MQAQSIETY	MQAQSIETY
TLSSIRSKY	TLSSIRSKY
QQNQYQASY	QQNQYQASY
FVIEEKHGF	FVIEEKHGF
RQIGSVDTF	RQIGSVDTF
KQMEQISQF	KQMEQISQF
ILGPSHPDTSY	LGPSPDTSY
RQFDPQPLAM	RQFDQPLAM
GLARHAMAVY	GLARAMAVY
EQFLDTNETPY	FLDTNETPY
YLLPDTKAY	YLLPDTKAY
AQKKPFTPVKY	AQKKTPVKY
YIRGSTIKY	YIRGSTIKY
RAQILRIQY	RAQILRIQY
GLHSVDVTY	GLHSVDVTY
GQQVTLTTH	GQQVTLTTH
AVRSGIVEY	AVRSGIVEY
LQAPPLTSL	LQAPPLTSL
IVAKSSLQY	IVAKSSLQY
IVYPGIAVF	IVYPGIAVF
VQKVDQYLY	VQKVDQYLY
IMKNPEVEF	IMKNPEVEF
SQFHGLITH	SQFHGLITH
FEIDGRKNKSY	IDGRKNKSY
GQFPGHNEFF	GQFPGHNEF
SMKAKITAY	SMKAKITAY
IIIDKEYYY	IIIDKEYYY
TLQVVTAHY	TLQVVTAHY
AMQQKPTAY	AMQQKPTAY
AAAAAAAQY	AAAAAAAQY
VLKQEQEEY	VLKQEQEEY
GQNDPLKDSY	GQNDLKDSY
GQVAAGGAF	GQVAAGGAF
ALRPGDPGF	ALRPGDPGF
AVIAIFKSY	AVIAIFKSY
AVTVSGHVY	AVTVSGHVY
AIIADSSTF	AIIADSSTF
KLKEVDRTAM	KLKEDRTAM
SQHDEKMTTF	SQHDKMTTF
GQNKAVKVY	GQNKAVKVY
SVAPGQQVY	SVAPGQQVY
LVYNGVYQY	LVYNGVYQY
KVMPQNHSF	KVMPQNHSF
KVYDPVSEY	KVYDPVSEY
KQKELLKQY	KQKELLKQY
RQEDDRGITY	RQEDRGITY
RVIVPSSEITY	IVPSSEITY
AAFPGASLY	AAFPGASLY
KQIPRILGP	KQIPRILGP
ALIPETTTL	ALIPETTTL
YQYSDQGIDY	YQYSQGIDY
SQVPVKHVY	SQVPVKHVY
GVKPGVVQY	GVKPGVVQY
VQHKTTEAL	VQHKTTEAL
SQQAYQEAF	SQQAYQEAF
AQLRNLEAY	AQLRNLEAY
GQKLILTTL	GQKLILTTL
RLQAKVEKY	RLQAKVEKY
RINENDPEY	RINENDPEY
TMKPMNVEY	TMKPMNVEY
KQMSISTGL	KQMSISTGL
RIKLEAERF	RIKLEAERF
IQTKRSFQY	IQTKRSFQY
GSGPAGYSY	GSGPAGYSY
KQISVGFIGY	KQISGFIGY
IQRKVEKL	IQR-KVEKL
TQRPADVIF	TQRPADVIF
RMKETQKSIYY	RMKEQKSIY
RVSHINSNY	RVSHINSNY
ALRPLDHESY	ALRPDHESY
RQINWTVLY	RQINWTVLY
SQVPFPSRL	SQVPFPSRL
SLSDRTNLY	SLSDRTNLY
VLSPVGKQY	VLSPVGKQY
YEREAILEY	YEREAILEY
RIQGVPKVTY	IQGVPKVTY
RQRDSKIDSL	RQRDKIDSL
GIFGKGSAY	GIFGKGSAY
ASYEVKELY	ASYEVKELY
VVISSDGQF	VVISSDGQF
YLFEPHSGEDY	YLFESGEDY
IQAGIFQEF	IQAGIFQEF
SQIFIGPTY	SQIFIGPTY
AQSSLQEVY	AQSSLQEVY
LLQNSVKQY	LLQNSVKQY
FIFREGDGVYY	IFREGDGVY
YVKDDKASF	YVKDDKASF
AQRVLTQTA	AQRVLTQTA
AQFTAQVHHF	AQFTQVHHF
QQMNSFLSRY	QMNSFLSRY
RLQEFLTAY	RLQEFLTAY
SLDAPHSTY	SLDAPHSTY
AQAFIHNSLY	AQAFIHNSL
SQVSHTHLAF	SQVSTHLAF
LQKPQPQLY	LQKPQPQLY
IQFEIAHAY	IQFEIAHAY
IQLRAQKGY	IQLRAQKGY
RLYTQGYISY	RLYTGYISY
AVIKIQSSY	AVIKIQSSY
RAFDSQNNTVY	SQN--NTVY
AQIDSNIAH	AQIDSNIAH
AQMPTVHYEF	AQMPVHYEF
RVSNFKPGVY	RVSNKPGVY
RQIKHMIKY	RQIKHMIKY
SEPSFITESY	SEPSITESY
GQAPPGKAL	GQAPPGKAL
LQIQRNVTL	LQIQRNVTL
ILADMADVY	ILADMADVY
IQKEQDYQRY	IQKEDYQRY
TQKAAVETSF	TQKAVETSF
MLAGATAVY	MLAGATAVY
AQNLHNSYY	AQNLHNSYY
VLKLVDISY	VLKLVDISY
TMMQSGGTF	TMMQSGGTF
KIKPVSLTF	KIKPVSLTF
VMIIRTMLY	VMIIRTMLY
VQIDITRVF	VQIDITRVF
GQPLHASNY	GQPLHASNY
KQRDFNQNF	KQRDFNQNF
IIRENEFSF	IIRENEFSF
RAFHPDLEF	RAFHPDLEF
YQIKVHRKY	YQIKVHRKY
KLKTEQGGAHF	KLKTQGGAH
PQHQSIQEY	PQHQSIQEY
KLKPTSKDQVL	KLKPSKDQV
VQRLPVGAAF	VQRLVGAAF
SQIVPKVAVFY	SQIVKVAVF
RLAPRGSGY	RLAPRGSGY
KLPDIFSVY	KLPDIFSVY
FQKPSGVSA	FQKPSGVSA
LISSAHSTF	LISSAHSTF
LQKEGPRAF	LQKEGPRAF
RLIGIYKTY	RLIGIYKTY
AQKVIAVVM	AQKVIAVVM
KLKEKFQHY	KLKEKFQHY
GQYPYPSGF	GQYPYPSGF
RIQESSQVLY	RIQESSQVL
RLQSKTIKVSY	LQSKIKVSY
VIIKGTQVY	VIIKGTQVY
KIIKNVEKY	KIIKNVEKY
IVKEKGTVY	IVKEKGTVY
RQADFVQVL	RQADFVQVL
RQVYLPMSY	RQVYLPMSY
ILHANVVVY	ILHANVVVY
GQNVADYMRY	GQNVDYMRY
VAKEKDIVY	VAKEKDIVY
AQRAPGGLSY	AQRAGGLSY
SSQFGGGSQY	SQFGGGSQY
FQKVITEY	FQK-VITEY
GQHAGLEKY	GQHAGLEKY
SVNSHAATTQY	NSHAATTQY
AQNPANMSKY	AQNPNMSKY
TLPGHIQAVY	TLPGIQAVY
VQQVQRLPF	VQQVQRLPF
VMINKATPY	VMINKATPY
KQIVPKESLVY	KQIVPKESL
KQVGSHPSF	KQVGSHPSF
GQLTGMYRY	GQLTGMYRY
KQFEGSTSF	KQFEGSTSF
LQRVLQSEF	LQRVLQSEF
RQKHPPATL	RQKHPPATL
RVKGPGISKF	RVKGGISKF
IMRELDVSY	IMRELDVSY
LSSFVGGLSV	SSFVGGLSV
QQGPVGVNVTY	QQGPVNVTY
MARSPGRAY	MARSPGRAY
RQFPVTVHF	RQFPVTVHF
AQHNTRMLATY	AQHNTRMLA
EMMKVVQVY	EMMKVVQVY
HINSIKSVF	HINSIKSVF
GQVKTGISM	GQVKTGISM
RLFKIDKEY	RLFKIDKEY
RAATFIQSTF	RAATIQSTF
GQWGGGSHY	GQWGGGSHY
AQIENKEAY	AQIENKEAY
RVKPNIFSY	RVKPNIFSY
RVQEGNESY	RVQEGNESY
SLYASSPGGVY	YASSPGGVY
TLKPSNKAF	TLKPSNKAF
SQRSTATMY	SQRSTATMY
ALFGGSQKY	ALFGGSQKY
FVYKGGKIY	FVYKGGKIY
LQFPVGRVH	LQFPVGRVH
KQKLILKY	KQK-LILKY
AQQDLQSKF	AQQDLQSKF
RLYGKDYNVY	RLYGDYNVY
YVIDQGETDVY	VIDQETDVY
AQPHHGVPY	AQPHHGVPY
RVVKGQVEY	RVVKGQVEY
HQFEGAEEY	HQFEGAEEY
LIKETTTGY	LIKETTTGY
TQKVTAGY	TQK-VTAGY
LLNGQVREEY	LLNGVREEY
GQKQYNVDY	GQKQYNVDY
SQISEALSRY	SQISALSRY
RVFKSGETTY	RVFKGETTY
TLRSEGFDTY	TLRSGFDTY
AQRASVAF	AQR-ASVAF
HIKTETVTY	HIKTETVTY
VQIGQVHEEF	VQIGVHEEF
IVIGDEHISF	IVIGEHISF
FMSEISDEF	FMSEISDEF
SQYRIKEY	SQY-RIKEY
KTFVTYTVY	KTFVTYTVY
VVKEPETRY	VVKEPETRY
SSKEGGVTF	SSKEGGVTF
SVYRTVIEY	SVYRTVIEY
TYDDATKTF	TYDDATKTF
IVEGENHTY	IVEGENHTY
ILKQEQEEY	ILKQEQEEY
AQRQEIRTAY	AQRQIRTAY
RLQVSYEEY	RLQVSYEEY
KMRGGSILSH	KMRGSILSH
IVKEVSTY	IVK-EVSTY
AMYPIRSAY	AMYPIRSAY
SLKKQVQSY	SLKKQVQSY
QQIEIERSLY	QQIEERSLY
KQIENARMF	KQIENARMF
RIIFVDEVF	RIIFVDEVF
AQRHVLTY	AQR-HVLTY
QQRDLTSQF	QQRDLTSQF
TTIDVRTTF	TTIDVRTTF
GQKRVVNVY	GQKRVVNVY
AQAAPKSLF	AQAAPKSLF
ALPEIFTEL	ALPEIFTEL
HQAIHTIEF	HQAIHTIEF
KVRESERAF	KVRESERAF
LSHLPSHHY	LSHLPSHHY
IQKEATWTM	IQKEATWTM
KQYYALEVSYF	KQYYLEVSY
FQQLIQSSF	FQQLIQSSF
ILKEADQKEQF	KEADQKEQF
RLYHEADKTY	RLYHADKTY
SQSGYSQSY	SQSGYSQSY
ILYNIKQEY	ILYNIKQEY
RVSPPHLTL	RVSPPHLTL
AEKAPTNIVY	AEKATNIVY
IGKVVQVY	IGK-VVQVY
FQTTISKY	FQT-TISKY
YSQEQRQAF	YSQEQRQAF
GQITHIQY	GQI-THIQY
RLKPTRKFAY	RLKPRKFAY
SMFTEKTTTY	SMFTKTTTY
KLPNFGFVVF	KLPNGFVVF
SEFPGAQHY	SEFPGAQHY
YMRDPDDQY	YMRDPDDQY
SQFSVPSSY	SQFSVPSSY
RSKNPSKESF	RSKNSKESF
IQYKTLRTF	IQYKTLRTF
ETQITQIEHEV	TQI-TQIEH
KQPDNSPEY	KQPDNSPEY
VQQLQRLSF	VQQLQRLSF
ALRPSTSRSLY	ALRPTSRSL
VQRARQIAA	VQRARQIAA
KMYTDGSTF	KMYTDGSTF
SMKPGEYSY	SMKPGEYSY
RILGLLQTY	RILGLLQTY
RMIAILTENY	RMIALTENY
SQLKGVSTF	SQLKGVSTF
AQKPLPQAL	AQKPLPQAL
AVRPLELAY	AVRPLELAY
KMQGVGEKF	KMQGVGEKF
YQKEVSHL	YQK-EVSHL
SQYGSQVGY	SQYGSQVGY
VVYKNPSEY	VVYKNPSEY
AVISSVAHY	AVISSVAHY
LQKQSVVY	LQK-QSVVY
VQYVHTQRF	VQYVHTQRF
FQKIVVLFY	FQKIVVLFY
VIKDDVASEVY	VIKDASEVY
HQKVEAQVY	HQKVEAQVY
QLIDIKVAH	QLIDIKVAH
SVKEWTITY	SVKEWTITY
KQKDIVSIHY	KQKDVSIHY
GQGTFGEVF	GQGTFGEVF
RLFSHEGSSF	RLFSEGSSF
SQKKDSLSM	SQKKDSLSM
KQAEEYLSF	KQAEEYLSF
LIIGKGAAY	LIIGKGAAY
GQAGMHATYY	GQAGMHATY
KQRQLTSY	KQR-QLTSY
LVKREDYLY	LVKREDYLY
AQNRKLIEF	AQNRKLIEF
RVAPKQKEF	RVAPKQKEF
LLREEDNKY	LLREEDNKY
SQKVIAHSEY	SQKVAHSEY
RLKNERTVF	RLKNERTVF
KQLVAEQVTY	KQLVEQVTY
SLFPHHGTF	SLFPHHGTF
AQKVIKSQL	AQKVIKSQL
LLKDGKTQDY	LLKDKTQDY
RQNGDDPLLTY	RQNGPLLTY
YIFKERESF	YIFKERESF
TKAVDAETAE	KAVDAETAE
AIIDTVINY	AIIDTVINY
GQAYIVSSGF	GQAYVSSGF
ATHQNLTSY	ATHQNLTSY
SQALAIRSY	SQALAIRSY
RIMSGESTF	RIMSGESTF
LSKLTDIQY	LSKLTDIQY
AAIRENPVY	AAIRENPVY
VLQITKIIY	VLQITKIIY
VLKPNIISY	VLKPNIISY
ILFKGDLNY	ILFKGDLNY
KQYKVVVY	KQY-KVVVY
RTSPFFSVY	RTSPFFSVY
RLFTEKVNNTF	RLFTVNNTF
RQYPDLETKY	RQYPLETKY
GQNISQQAL	GQNISQQAL
GQGAFGRVY	GQGAFGRVY
LIRDNRVVY	LIRDNRVVY
HQYHIRAY	HQY-HIRAY
SMQNGVKVY	SMQNGVKVY
AQKDHLSKL	AQKDHLSKL
LQKPGETVF	LQKPGETVF
ALAPAGFSY	ALAPAGFSY
VMMIPSQISY	MMIPSQISY
LQNNLVELY	LQNNLVELY
SQQPGHQDF	SQQPGHQDF
VVRDENSSVY	VVRDNSSVY
KLFVGGLNF	KLFVGGLNF
RLFVGARIY	RLFVGARIY
HQKKEFVKY	HQKKEFVKY
GQILSVIKM	GQILSVIKM
AQLPKPTSTY	AQLPPTSTY
VQFVGREAKY	VQFVREAKY
REIESSPQY	REIESSPQY
HQLGNNSVF	HQLGNNSVF
LLKSEKSSY	LLKSEKSSY
GLGSGGSIRSS	GLGSGGSIR
AVRHTIQVY	AVRHTIQVY
TVHGVTQAF	TVHGVTQAF
ALMPPFTAF	ALMPPFTAF
SIPEKNRPL	SIPEKNRPL
TQYIIHNY	TQY-IIHNY
RLKPDFIDGY	RLKPFIDGY
RQFPGSHRV	RQFPGSHRV
TLHGLQQYY	TLHGLQQYY
AVNSLISKY	AVNSLISKY
FQKPISTL	FQK-PISTL
SQAPQRLSF	SQAPQRLSF
TLVHADLSEY	LVHADLSEY
HQGPATTVAF	HQGPTTVAF
RQKAVSLF	RQK-AVSLF
RQIEITIY	RQI-EITIY
AQVQYPLQTF	AQVQPLQTF
AQTPGAHHF	AQTPGAHHF
RQLIQESKF	RQLIQESKF
SSNPSVTRY	SSNPSVTRY
RIMKAQAY	RIM-KAQAY
ILKEDPFLF	ILKEDPFLF
GQRQVGVGY	GQRQVGVGY
AQYKARVAL	AQYKARVAL
IQPHPRTGNKY	IQPHTGNKY
FSKDIVENY	FSKDIVENY
MQRLIEKY	MQR-LIEKY
VIRDVEQQF	VIRDVEQQF
SQAKALVYY	SQAKALVYY
AQIVVPVTF	AQIVVPVTF
ILPPFFKHF	ILPPFFKHF
ALVKAGKVY	ALVKAGKVY
RIHNEDNSQF	RIHNDNSQF
SQFPTQPGQY	SQFPQPGQY
ASKVVTVF	ASK-VVTVF
AQKVIYTLM	AQKVIYTLM
IIHSGEKPY	IIHSGEKPY
AQKDQEIAF	AQKDQEIAF
AQQPALIHGY	AQQPLIHGY
AQYSQDYQQF	AQYSDYQQF
FQIEVQKGRY	FQIEQKGRY
AVQKAIAHY	AVQKAIAHY
IVIEEKDVVY	IVIEKDVVY
RLSLNGVRF	RLSLNGVRF
SQHSASSANVF	HSASSANVF
AQAESLRY	AQA-ESLRY
AQPPVGAAY	AQPPVGAAY
ILPPPVHVDY	ILPPVHVDY
AILDYYKTG	AILDYYKTG
GQTGVTTSF	GQTGVTTSF
GQDPHSSQAF	GQDPSSQAF
KQKALNAGY	KQKALNAGY
GQIGHGYKY	GQIGHGYKY
VQADSKGTVSF	VQADGTVSF
RLVELLVSY	RLVELLVSY
AQRFFAQKF	AQRFFAQKF
AQALVLQVF	AQALVLQVF
VMIRDILMY	VMIRDILMY
LIKKDVNY	LIK-KDVNY
SQALIEAY	SQA-LIEAY
SQYSQQSSSY	SQYSQSSSY
AQQIQKVVM	AQQIQKVVM
KILDMQQTY	KILDMQQTY
RVAMYVHAY	RVAMYVHAY
IARDEGGKAFF	IARDGGKAF
HQQKVLRLY	HQQKVLRLY
AQIVTRSVL	AQIVTRSVL
KQKPMNVGL	KQKPMNVGL
RQELSHALY	RQELSHALY
TTFPKDPVY	TTFPKDPVY
VVAGIKEYF	VVAGIKEYF
YQTAISENY	YQTAISENY
RQALLLLAL	RQALLLLAL
SIKETVEAY	SIKETVEAY
KVFERAVQY	KVFERAVQY
IQRMHLRQY	IQRMHLRQY
RANPQVGVAF	RANPVGVAF
IQKFPYDDPTY	IQKFDDPTY
VASQKGMSVY	SQK-GMSVY
ITINAAHVEY	TINAAHVEY
RQSISKALVAY	SISKALVAY
FLIKRNKQTY	LIKRNKQTY
EEQLQQIRAE	EQLQQIRAE
ALAGLKTVSSY	GLK-TVSSY
RQKVGTSSRY	RQKVTSSRY
SQNNLRVHY	SQNNLRVHY
TVIPNSHVYY	TVIPNSHVY
RQPGSTAQY	RQPGSTAQY
TVTEKPEVIDA	TVTEKPEVI
MQKEITAL	MQK-EITAL
AMHSDSQTF	AMHSDSQTF
LMVGTSIHY	LMVGTSIHY
AIFSKNSKY	AIFSKNSKY
KLPEKTQTF	KLPEKTQTF
KQLQKDKQVY	QLQKDKQVY
AQQPSYVY	AQQ-PSYVY
ALKPPPIKLY	ALKPPIKLY
VIRELKEQY	VIRELKEQY
AQPATAAAY	AQPATAAAY
FQQDLEAKY	FQQDLEAKY
AIKKPSGDDRY	IKKPGDDRY
ILMPNIGY	ILM-PNIGY
AFIITGQTY	AFIITGQTY
ATAPPAPAY	ATAPPAPAY
ILTVGGTAY	ILTVGGTAY
TQSGINGTY	TQSGINGTY
RLATLFESY	RLATLFESY
AGGYFTSPGGY	GYFTSPGGY
NQIESKAAY	NQIESKAAY
AIIERVQRY	AIIERVQRY
LSKRQGLF	LSK-RQGLF
RVAQLEQVY	RVAQLEQVY
TQVIHSIEY	TQVIHSIEY
RVPKTGSAY	RVPKTGSAY
GQKLPKSRTAY	KLPKSRTAY
LLHQTGLSLY	LLHQGLSLY
LLHEVDTQY	LLHEVDTQY
GQRPQLTAA	GQRPQLTAA
KQIVAGVNY	KQIVAGVNY
QVADIDGQY	QVADIDGQY
TQRPIALELY	TQRPALELY
VQRITQETF	VQRITQETF
LIFDNKHTNY	LIFDKHTNY
SQANIAQVL	SQANIAQVL
IQRNPEISH	IQRNPEISH
QQIPASDTQQL	QQIPASDTQ
QQFLIQQQY	QQFLIQQQY
QLSFPVRAY	QLSFPVRAY
SQRQGRISF	SQRQGRISF
AVRPGLPAY	AVRPGLPAY
KQKLTSIQF	KQKLTSIQF
RLSPGESAY	RLSPGESAY
SQIADVARF	SQIADVARF
ALIEGGMKY	ALIEGGMKY
AGFAGDDAPR	AGFAGDDAP
RQVDLSVHAY	RQVDSVHAY
VQQPGQTNFY	VQQPGQTNF
YAFDFARQS	YAFDFARQS
EQRKIVEF	EQR-KIVEF
MEIGKTETF	MEIGKTETF
AQNAVQRAAY	AQNAQRAAY
SQKDKVRQF	SQKDKVRQF
SVVDISQQY	SVVDISQQY
VVKPSDEEL	VVKPSDEEL
HVIENSNAF	HVIENSNAF
KLAQIRHIY	KLAQIRHIY
VSKPDLITF	VSKPDLITF
KQVKYFIHY	KQVKYFIHY
RQFGKKHLF	RQFGKKHLF
VQVDGKIGLF	VQVDGKIGL
KSVRPGASY	KSVRPGASY
RINPQTTEF	RINPQTTEF
VQIVSKKVSY	VQIVKKVSY
TMAPPVMAY	TMAPPVMAY
ALQEALTEHY	ALQELTEHY
RTKADSVPGTY	KADSVPGTY
RILDGKRIQY	RILDKRIQY
ILSHINTVF	ILSHINTVF
RIFPSHISSRY	RIFPISSRY
RMMNAIKESY	RMMNIKESY
STHVTISTY	STHVTISTY
IQNNPHASY	IQNNPHASY
RVIDVGSEW	RVIDVGSEW
QQSPGSKAF	QQSPGSKAF
RIFDRAVAAY	RIFDAVAAY
MQREPNQAF	MQREPNQAF
QLVAEQVTY	QLVAEQVTY
LVIQDKNKY	LVIQDKNKY
TSAPTGHTF	TSAPTGHTF
LIFPDRATLY	LIFPRATLY
RVADFTEQY	RVADFTEQY
RQYLEEVGY	RQYLEEVGY
RQRETEAAL	RQRETEAAL
RQIHKFEEL	RQIHKFEEL
GQTKPVVVY	GQTKPVVVY
KVFGATTNY	KVFGATTNY
GQKKVEEL	GQK-KVEEL
KLAGDHIEY	KLAGDHIEY
IQHSTIIGF	IQHSTIIGF
SQILPTEEY	SQILPTEEY
AIKPTSKEF	AIKPTSKEF
TQQIKSHEY	TQQIKSHEY
LIRPVSASF	LIRPVSASF
QQHFDVQQY	QQHFDVQQY
AQTPAHIAAF	AQTPHIAAF
SIYPGNSDTRY	SIYPSDTRY
LLMGKEVGF	LLMGKEVGF
KQMENDIQLY	KQMEDIQLY
KLREDLERL	KLREDLERL
RQIEKDITSF	RQIEDITSF
AMYPHIFYF	AMYPHIFYF
AQHPSALRF	AQHPSALRF
QQLDPDEKIAY	QLDPEKIAY
AMLAGATAVY	MLAGATAVY
ALQEASEAY	ALQEASEAY
LLYPYEQAQY	LLYPEQAQY
TLFKEDFINY	TLFKDFINY
TLNQKEAVAY	TLNQEAVAY
FLQESNVLY	FLQESNVLY
KLIKRHEAF	KLIKRHEAF
STKPADMKY	STKPADMKY
KLFLEGMHY	KLFLEGMHY
AVAVGHRVY	AVAVGHRVY
VIIDDRHVY	VIIDDRHVY
TVKDDLSFAGY	TVK-DDLSF
HQHVPAGY	HQH-VPAGY
GQYTGHEY	GQY-TGHEY
AERLVEIQY	AERLVEIQY
VLQLPARNLTY	LQLPRNLTY
YTGPSHHSY	YTGPSHHSY
HLYPNTPYAY	HLYPTPYAY
RQISTSGELSF	RQISTSGEL
LQRVPSYDSF	LQRVSYDSF
LQNSVKQY	LQN-SVKQY
RQNLLSQSH	RQNLLSQSH
ALKEDMSGY	ALKEDMSGY
YQHGHINSY	YQHGHINSY
SQFIFEHSY	SQFIFEHSY
RQGFVPAAY	RQGFVPAAY
AQRPGPMEL	AQRPGPMEL
SSHVTNVSF	SSHVTNVSF
TQAQIKAAY	TQAQIKAAY
RVQLERVAF	RVQLERVAF
SVNTPTKTY	SVNTPTKTY
VVIGSHAAF	VVIGSHAAF
RMMDSQENY	RMMDSQENY
KQIESKTAF	KQIESKTAF
YLNQTSRSF	YLNQTSRSF
RLNNKINSY	RLNNKINSY
AQQVQQVAAEY	QQVQVAAEY
VQQNNTESF	VQQNNTESF
LSKQLNIAY	LSKQLNIAY
RVAPTANIF	RVAPTANIF
RLFYFSNEKY	RLFYSNEKY
RLVAIRTEY	RLVAIRTEY
AQVWMITRY	AQVWMITRY
IQTSTGKVF	IQTSTGKVF
AAHTVTAAY	AAHTVTAAY
AVNVGVTAY	AVNVGVTAY
SQFPQPQHF	SQFPQPQHF
GQPDISRPF	GQPDISRPF
KIMDVGQSY	KIMDVGQSY
VMRKLQKTY	VMRKLQKTY
GQSPLSQKY	GQSPLSQKY
AIFPSPMMY	AIFPSPMMY
KIINDNATY	KIINDNATY
KLVSKIAKY	KLVSKIAKY
SQNRPPPNAY	SQNRPPNAY
RLQPYNGVAL	RLQPNGVAL
AQIFRPLKF	AQIFRPLKF
KQYADVEGF	KQYADVEGF
GQQVHNLLLTY	QVHNLLLTY
VQPSKFNSY	VQPSKFNSY
ILKDSISSY	ILKDSISSY
VIKQEKLGTVY	KQEKLGTVY
NTKLPSSF	NTK-LPSSF
KIADMGHLKY	KIADGHLKY
VQKPDAANYY	VQKPDAANY
VQFGANKNQY	VQFGNKNQY
SISGVTAAY	SISGVTAAY
TQRRGNMVTTY	TQRRMVTTY
GMIDAARTY	GMIDAARTY
RQVSHKHIVY	RQVSKHIVY
HSIPSGHVY	HSIPSGHVY
TLKTPGKSF	TLKTPGKSF
GQRAKSMKF	GQRAKSMKF
GQTPGGAQF	GQTPGGAQF
RQPNIKQKF	RQPNIKQKF
GVNPHVNHLY	GVNPVNHLY
FQKGESPVDY	FQKGSPVDY
RFYIESISY	RFYIESISY
RAFIITGQTY	RAFITGQTY
QLRAQIMAY	QLRAQIMAY
RQLQQLISF	RQLQQLISF
RQKYNVRSM	RQKYNVRSM
SQNRVAEF	SQN-RVAEF
SQKSGLIEH	SQKSGLIEH
SQVRDVIGF	SQVRDVIGF
RLQPFLQRY	RLQPFLQRY
AAAAAAQSVY	AAAAAQSVY
QQLDPEQKITY	QLDPQKITY
GVIEKLLTSY	GVIELLTSY
IQKIIETL	IQK-IIETL
HLRDYFEEY	HLRDYFEEY
AQAPPTAQL	AQAPPTAQL
AQIKEMVEL	AQIKEMVEL
KQFDAGTVNY	KQFDGTVNY
AIFPNGAAY	AIFPNGAAY
RQPDNAKALY	RQPDAKALY
YENEVALR	YEN-EVALR
RIREDIAKY	RIREDIAKY
AVKFPEITY	AVKFPEITY
GQFPSPHHH	GQFPSPHHH
RQREQEIAL	RQREQEIAL
KQSVQGAGTSY	SVQGAGTSY
RQVEDLQATF	RQVELQATF
AVAGMKMSY	AVAGMKMSY
AISPSSLTY	AISPSSLTY
AQIVSATAI	AQIVSATAI
LKEKIAKY	LKE-KIAKY
VLNKVITVY	VLNKVITVY
KQIFKGKTF	KQIFKGKTF
RAFKEVGIEF	RAFKVGIEF
QMSNITVTY	QMSNITVTY
KQQNQYQASY	QQNQYQASY
SLHDNKYIRY	SLHDKYIRY
ILREDPAYLHY	ILREDPAYL
ISNGGAQTY	ISNGGAQTY
AEQRGELAIKD	EQRGELAIK
AQSHLVTGY	AQSHLVTGY
TTGKPHVAY	TTGKPHVAY
AVIQVGKEKY	AVIQGKEKY
GQIVQSKINSF	IVQSKINSF
KLPEFTKSEY	KLPETKSEY
NQRVQTVHF	NQRVQTVHF
AQKVGAVAA	AQKVGAVAA
QQQIVRETF	QQQIVRETF
LQQKISVLY	LQQKISVLY
AQAFIHNSL	AQAFIHNSL
RQPPSTTTF	RQPPSTTTF
RLIPSLRTY	RLIPSLRTY
AIRVELVQY	AIRVELVQY
LMKEVMEHY	LMKEVMEHY
STAPHETSF	STAPHETSF
QQIGKVVQVY	QQIGVVQVY
RQIQESVTF	RQIQESVTF
LQMAKQLGY	LQMAKQLGY
KQTQTFTTY	KQTQTFTTY
RIYNDDKNTY	RIYNDKNTY
RIADRGAEY	RIADRGAEY
RLAEQAERY	RLAEQAERY
AQNAVRLHY	AQNAVRLHY
AQHLTVSGF	AQHLTVSGF
LQRAHEQRF	LQRAHEQRF
GLSGLHRTY	GLSGLHRTY
HQNQLLSSL	HQNQLLSSL
MQIFVKTL	MQI-FVKTL
SLIGAARTKTY	IGAARTKTY
HSRLIVLHY	HSRLIVLHY
AQHLQAAVAF	AQHLAAVAF
TSQYQGVVVY	SQYQGVVVY
AIKGVGRRY	AIKGVGRRY
TQYESKVFY	TQYESKVFY
AMVGHQVSF	AMVGHQVSF
HQRPDKQNLF	HQRPKQNLF
HLRPRPRAY	HLRPRPRAY
GQNKKVMIY	GQNKKVMIY
GQRTGQVTV	GQRTGQVTV
QQVESRWGY	QQVESRWGY
AQQPHIAGVF	AQQPIAGVF
AQFPNGPQF	AQFPNGPQF
LLNSATTSL	LLNSATTSL
SLPDFGISY	SLPDFGISY
LIYEKAKHY	LIYEKAKHY
AQAELESRY	AQAELESRY
GLGSGGSIR	GLGSGGSIR
ALFASQEKF	ALFASQEKF
KVISSSSSF	KVISSSSSF
TIKSATISY	TIKSATISY
VNLGGSKSIS	VNLGGSKSI
KQNPLLAEAY	KQNPLAEAY
AQKGGAAGF	AQKGGAAGF
AQAGWLQHDY	AQAGLQHDY
VLMKKSETY	VLMKKSETY
SQRIPAHRF	SQRIPAHRF
KQYYALEVSY	KQYYLEVSY
FQRGYYRYY	FQRGYYRYY
ITFEGKVAF	ITFEGKVAF
MLAPLSTTY	MLAPLSTTY
SQPASGNTF	SQPASGNTF
RQYAKDIGF	RQYAKDIGF
SMFDQSQIQEF	SQI---QEF
SQIEEHKVF	SQIEEHKVF
GQIEHKLAFL	GQIEHKLAF
FQIMNEIVY	FQIMNEIVY
SVIATIQEY	SVIATIQEY
DQLEYQEELR	DQLEYQEEL
ILKEEQELY	ILKEEQELY
GQTGTKSVF	GQTGTKSVF
GQVLGVIGY	GQVLGVIGY
IQNGAQGIRF	IQNGQGIRF
VIVGGSSEY	VIVGGSSEY
KQKVDLQSL	KQKVDLQSL
VQPKLWARY	VQPKLWARY
AQKEPHPLQF	AQKEHPLQF
IQKQFEELY	IQKQFEELY
RQKGEQFRL	RQKGEQFRL
GLFPGSNATF	GLFPSNATF
MLKIAEMEY	MLKIAEMEY
VSHIMLESY	VSHIMLESY
ALNDKGQVY	ALNDKGQVY
VINSKASLTY	VINSASLTY
LQDAEIAR	LQD-AEIAR
RQNVGTLESF	RQNVTLESF
TQNGMVQEY	TQNGMVQEY
KQIKTIERY	KQIKTIERY
LQNIAEKGSY	LQNIEKGSY
AQRLLEVTA	AQRLLEVTA
VVFPNGKSH	VVFPNGKSH
LQIATHTAF	LQIATHTAF
VIASIISRY	VIASIISRY
SSKPWPDATY	SSKPPDATY
RQFEGLMRF	RQFEGLMRF
GGPGGVGGL	GGPGGVGGL
IQHPLIKKY	IQHPLIKKY
AQIYQLIEY	AQIYQLIEY
TQNQRSESNRF	NQRSESNRF
VQKDGVGMVEY	VQKDGMVEY
TLIDSSSSF	TLIDSSSSF
KMKPEVTAL	KMKPEVTAL
VTNPNNTFY	VTNPNNTFY
TLKSGDGITF	TLKSDGITF
ALPPQQQHY	ALPPQQQHY
GQQQPVPSY	GQQQPVPSY
ALAPSFVEF	ALAPSFVEF
SQRDPPHNNF	SQRDPHNNF
TQKENLRKF	TQKENLRKF
AVIAPKSSY	AVIAPKSSY
HQALPSVSH	HQALPSVSH
GAIKADHVSTY	AIKAHVSTY
ILKPGSTAL	ILKPGSTAL
LQLPARNLTY	LQLPRNLTY
ISIDGSRSY	ISIDGSRSY
AIANLQRAY	AIANLQRAY
TVIDSQTHY	TVIDSQTHY
SQQSGEKAF	SQQSGEKAF
QVAEIVSKY	QVAEIVSKY
QQIYARQYY	QQIYARQYY
TQRPNLIGL	TQRPNLIGL
VSHLIATEY	VSHLIATEY
RQIGVEHVVVY	RQIGHVVVY
VQFKLPDVY	VQFKLPDVY
MQKPFEDASF	MQKPEDASF
RQYPWGTVQV	RQYPGTVQV
WQKGIGEFF	WQKGIGEFF
KVFPEDMAKY	KVFPDMAKY
VQMKIKELY	VQMKIKELY
ITIEGVNTPY	ITIEVNTPY
RQNVKRATF	RQNVKRATF
IQNPDITSSRY	IQNPITSSR
HSKVLYVY	HSK-VLYVY
LQIGVIRVY	LQIGVIRVY
AQAHFNNGEY	AQAHNNGEY
IQKGQALITF	IQKGALITF
RQIDLVDNY	RQIDLVDNY
TIHGAAGTVY	TIHGAGTVY
RVYVDITTY	RVYVDITTY
ATPDIKSHY	ATPDIKSHY
LQKYEKEKF	LQKYEKEKF
IIIGQESITY	IIIGESITY
AQRIVRVPILY	RIVRVPILY
MIIGPPRTNY	IIGPPRTNY
IQFADDMQEF	IQFADMQEF
VQRVETISL	VQRVETISL
RIAPPDRRF	RIAPPDRRF
QQFRNAPPF	QQFRNAPPF
IMVKPHEEY	IMVKPHEEY
GQNPAEGSF	GQNPAEGSF
VQISPMSAF	VQISPMSAF
AQAAPQTYAEY	AQA-APQTY
RMSDVVKGVY	RMSDVKGVY
HVNGIVQKY	HVNGIVQKY
KQYISAVQMY	KQYIAVQMY
QQYNSFVSL	QQYNSFVSL
YQILQGIVF	YQILQGIVF
RVNKEMARY	RVNKEMARY
KLSPLKSKF	KLSPLKSKF
RMIIAVTSY	RMIIAVTSY
RVHSGERPF	RVHSGERPF
VLAGHGHLY	VLAGHGHLY
TQNNAMKISF	TQNNMKISF
TQPAPRSIF	TQPAPRSIF
HQQPPSQQY	HQQPPSQQY
AQPETRVSY	AQPETRVSY
VQFDGTNSAF	VQFDTNSAF
SKEEAEAL	SKE-EAEAL
AVFNHTEDY	AVFNHTEDY
RAFDQGADAIY	RAFDQGADA
KVFVVGESY	KVFVVGESY
LQRSPHQGF	LQRSPHQGF
LQYLSQGNVVF	YLSQGNVVF
VQKEDIEVY	VQKEDIEVY
VMKSLTQTF	VMKSLTQTF
IQMKPGSKIRY	QMKPSKIRY
TLKDRELSF	TLKDRELSF
SQRAVLVQF	SQRAVLVQF
KQISAEKQY	KQISAEKQY
LQNADPLKVY	LQNAPLKVY
KFSPNTSQF	KFSPNTSQF
KVQEESVTF	KVQEESVTF
SVKPASSSF	SVKPASSSF
KQYIMDTVF	KQYIMDTVF
AQKPGAPLQAF	AQKPPLQAF
KTKEIEQVY	KTKEIEQVY
IIHTEGKSY	IIHTEGKSY
QQQIIRETF	QQQIIRETF
HLPETKFSEL	HLPEKFSEL
IKDKQVKY	IKD-KQVKY
KTAPFDSRF	KTAPFDSRF
ASNPRQAAY	ASNPRQAAY
VLKPGMVVTF	VLKPMVVTF
KAIATTVTY	KAIATTVTY
AGQKATAAF	AGQKATAAF
SQKQISIQH	SQKQISIQH
SQKPGVLTH	SQKPGVLTH
TQIGGERYNF	TQI-GGERY
ILTSNDALLF	ILTSDALLF
LAKQITSY	LAK-QITSY
IQFRLPDGSSF	RLP-DGSSF
TQFPSTVSTVY	TQFPVSTVY
SGKPQEAVY	SGKPQEAVY
LQQEGLLSRY	LQQELLSRY
GQQVPMELY	GQQVPMELY
GLMKANHVF	GLMKANHVF
LQRQGLVSL	LQRQGLVSL
AQAPAGTSF	AQAPAGTSF
RQVSTLNSY	RQVSTLNSY
AQKIDLPEY	AQKIDLPEY
RQSPPRAAL	RQSPPRAAL
YSHLVSVGY	YSHLVSVGY
IQKKAVKNF	IQKKAVKNF
RQIAKAMEA	RQIAKAMEA
KVYDLVKAY	KVYDLVKAY
RQLPSFQTF	RQLPSFQTF
RLIGHQEAF	RLIGHQEAF
IQRVAAGVL	IQRVAAGVL
HLFDIITQY	HLFDIITQY
IQKDPGESL	IQKDPGESL
GMFDQKSSSH	GMFDKSSSH
AAHPSEATF	AAHPSEATF
AVAYVHSQGY	VAYVHSQGY
QERPSVTSY	QERPSVTSY
RQKQLQQQF	RQKQLQQQF
ALTETGSVF	ALTETGSVF
KVFGPTIVAH	KVFGTIVAH
RSLQENIAY	RSLQENIAY
GLKPVVGEVY	GLKPVGEVY
ITAPPGTAA	ITAPPGTAA
IQPEKDIIVEF	IQPEIIVEF
TMRPLATAY	TMRPLATAY
SQIQPKLIF	SQIQPKLIF
GQSKAVKVY	GQSKAVKVY
AIRKELNEF	AIRKELNEF
LQRANLLSY	LQRANLLSY
YLMEEDEDAY	YLMEDEDAY
RQIEDTVLY	RQIEDTVLY
EVAPAGASY	EVAPAGASY
VVYLQKLDTAY	LQK-LDTAY
VLAEVAQHY	VLAEVAQHY
IQPDVFSHY	IQPDVFSHY
ASSPAAVSY	ASSPAAVSY
KQTALASRF	KQTALASRF
FANLPNQVY	FANLPNQVY
FMKPSHQGY	FMKPSHQGY
HAAEYGAEALE	HAAEGAEAL
RLFPSAAQVTF	RLFPSAAQV
LMPQFSTIEY	LMPQSTIEY
SVRKDIESY	SVRKDIESY
AQLTHTQF	AQL-THTQF
RQPDSPTALY	RQPDPTALY
LQKNVPILY	LQKNVPILY
RTFDLTVVSY	RTFDTVVSY
TQKPLPVSL	TQKPLPVSL
KLFPYALAF	KLFPYALAF
TQTLVREY	TQT-LVREY
RIIAEPGRYY	IIAEPGRYY
RLIAQRYLLQY	AQR-YLLQY
SQFGTVTRF	SQFGTVTRF
FIRPVDPEY	FIRPVDPEY
VIYPQSASY	VIYPQSASY
QMAGLRDTY	QMAGLRDTY
HQREIFLF	HQR-EIFLF
GVNPRVNHLY	GVNPVNHLY
RIKPNAITY	RIKPNAITY
RQNESYLNF	RQNESYLNF
MISEPRISY	MISEPRISY
TQRGLKTVF	TQRGLKTVF
KSFSESGINY	KSFSSGINY
IIAEPGRYY	IIAEPGRYY
QQQPALVNY	QQQPALVNY
GQREGSRGF	GQREGSRGF
FEKSTGLPH	FEKSTGLPH
LVSGGHMEY	LVSGGHMEY
LQHPNIVGY	LQHPNIVGY
SAYGSVKAY	SAYGSVKAY
ALPDTLKVTY	ALPDLKVTY
VQVAAQDLTDY	VAAQDLTDY
KLVPPHETF	KLVPPHETF
IVYPQKAYY	IVYPQKAYY
AINASTGNY	AINASTGNY
YQYLLVTAL	YQYLLVTAL
TQKQVLNY	TQK-QVLNY
GQHVTAALY	GQHVTAALY
AQPALKTQF	AQPALKTQF
RMIYLVTEY	RMIYLVTEY
QQQHSPQQIAY	QQHSQQIAY
AQMEVASF	AQM-EVASF
IQKKIREKF	IQKKIREKF
SLVNLGGSK	SLVNLGGSK
QQMEQFIQY	QQMEQFIQY
LQAPAFTGY	LQAPAFTGY
LQREIQEGAY	LQREQEGAY
AANPISGHY	AANPISGHY
AQPKGVLLY	AQPKGVLLY
SVVGAISSY	SVVGAISSY
VMFPGNSPSY	VMFPNSPSY
VQQPGQTNF	VQQPGQTNF
ALKNVTVSF	ALKNVTVSF
TVHTGDRPY	TVHTGDRPY
GQLVFKSDAY	GQLVKSDAY
LLYPTEDYKVY	LLY-PTEDY
GLKPSTSKY	GLKPSTSKY
GQLPGLHEY	GQLPGLHEY
LAGQATTAY	LAGQATTAY
VQQKESGLKY	QQKESGLKY
HGHLSAVY	HGH-LSAVY
SQQPASGVAY	SQQPSGVAY
FFLLAYDLY	FFLLAYDLY
AQMAQVLQF	AQMAQVLQF
IQAQMVTTDF	IQAQVTTDF
GMNPREPAVY	GMNPEPAVY
VQGIFVEKY	VQGIFVEKY
LLQTVHAEY	LLQTVHAEY
RIIHTGEKF	RIIHTGEKF
ALSLVRQLY	ALSLVRQLY
AVQKAIPMY	AVQKAIPMY
LQKDLSKSM	LQKDLSKSM
EQYEQILAF	EQYEQILAF
FVAEERVSF	FVAEERVSF
KVAGHSLGY	KVAGHSLGY
RMQEGSEVY	RMQEGSEVY
RQATVNVSY	RQATVNVSY
AQSPIPNLY	AQSPIPNLY
AIAKAGIPVY	AIAKGIPVY
EQRSGDITY	EQRSGDITY
RLHSHDVRY	RLHSHDVRY
KLQEALMHY	KLQEALMHY
GQIQKVHPA	GQIQKVHPA
LQREGVSHY	LQREGVSHY
SVQGAGTSY	SVQGAGTSY
RQHPIQVFY	RQHPIQVFY
IQKNVQLY	IQK-NVQLY
RARELLVSY	RARELLVSY
SQYPGGQPTY	SQYPGQPTY
GQFSKPFSF	GQFSKPFSF
SVIDYSNAF	SVIDYSNAF
KQITADKQY	KQITADKQY
AVYKEAQYY	AVYKEAQYY
AVSKPGMDY	AVSKPGMDY
SMSDPGVSY	SMSDPGVSY
LLKPGGVLTY	LLKPGVLTY
KLIYEKAKHY	LIYEKAKHY
SLNSKVVSQY	SLNSVVSQY
QVQQVAAEY	QVQQVAAEY
HIKAFDRAF	HIKAFDRAF
AQEPNVKETY	AQEPVKETY
AQKQLLEY	AQK-QLLEY
KLQDPFSLY	KLQDPFSLY
VMMDPNSTQRY	MMDPSTQRY
RQIGSRSY	RQI-GSRSY
SQFHGLITHY	SQFHLITHY
KQIHFLYQY	KQIHFLYQY
RISGVDRYY	RISGVDRYY
IKVGGERF	IKV-GGERF
IQKPGSNAF	IQKPGSNAF
YQKPIIQSEY	YQKPIQSEY
LQEQMRALY	LQEQMRALY
KQIDNTGSSTY	KQIDGSSTY
GQIEHKLAF	GQIEHKLAF
HSRNEGVATY	HSRNGVATY
RISVIKSVF	RISVIKSVF
KVAMSKEQY	KVAMSKEQY
NQKPPSAEY	NQKPPSAEY
QVMPGNIVF	QVMPGNIVF
HVGKTPIVG	HVGKTPIVG
RLGGGTYGEVF	GGGTYGEVF
AFKKGDRVF	AFKKGDRVF
SQGLPASRY	SQGLPASRY
AQIRYEGILY	AQIREGILY
RQPLKATAY	RQPLKATAY
KLFEDGKTGF	KLFEGKTGF
ALREEVESF	ALREEVESF
SIPDIKTAF	SIPDIKTAF
KQAPPQKVSF	KQAPQKVSF
SLNAGKQRY	SLNAGKQRY
RERELAEKY	RERELAEKY
SQHVVTNY	SQH-VVTNY
VQKEGKISY	VQKEGKISY
SQSIQNTVY	SQSIQNTVY
HQVTVAQSY	HQVTVAQSY
GQVQVRTLY	GQVQVRTLY
VQRLNESTSY	VQRLESTSY
GSFQTPSSF	GSFQTPSSF
ITAPPSRVL	ITAPPSRVL
AQHLFLQAF	AQHLFLQAF
SQIGAVVSH	SQIGAVVSH
AQYLPKEQYLY	AQYLPKEQY
AVNKVIKSY	AVNKVIKSY
AQKEIATL	AQK-EIATL
LIIANTMAF	LIIANTMAF
HQQLHNETY	HQQLHNETY
IQRTPKIQVY	IQRTKIQVY
ALPGHAESY	ALPGHAESY
FQLPGGHLEF	FQLPGHLEF
STKEDAVSF	STKEDAVSF
HLKKLKESY	HLKKLKESY
RLNKVISEL	RLNKVISEL
RLQEVLNDY	RLQEVLNDY
GMYGKIAVM	GMYGKIAVM
KFIDTTSKF	KFIDTTSKF
KLYPLEIVF	KLYPLEIVF
RLLKPGGVLTY	LLKPGVLTY
RQFSEQQPAF	RQFSQQPAF
AAAVPRAAF	AAAVPRAAF
RQIDFVLSY	RQIDFVLSY
KLYDVVDVKY	KLYDVDVKY
AQRGIGVAA	AQRGIGVAA
ALNTIVTVY	ALNTIVTVY
RLINTQAIF	RLINTQAIF
AIIPSHLAY	AIIPSHLAY
RIKAQDEAF	RIKAQDEAF
QQNNVENVY	QQNNVENVY
GQKLAEQMF	GQKLAEQMF
RQRGINMRY	RQRGINMRY
SVINPGAIY	SVINPGAIY
GQQAALASQY	GQQALASQY
QQAQAFYTF	QQAQAFYTF
TVFSRSQVY	TVFSRSQVY
YQILQNYQF	YQILQNYQF
AMKKVFRVY	AMKKVFRVY
FQIGQAKNTY	FQIGAKNTY
ILNREVVNY	ILNREVVNY
AVIGDVIRVY	AVIGVIRVY
YVAPAYGVY	YVAPAYGVY
FQKVITEYL	FQKVITEYL
TQFGGKRPF	TQFGGKRPF
AVRDYEKVY	AVRDYEKVY
VLYPHLSTY	VLYPHLSTY
AVAPFFKSY	AVAPFFKSY
VSYKGSISY	VSYKGSISY
RVYESKAEF	RVYESKAEF
VIFPEGTRY	VIFPEGTRY
KSPDASSAF	KSPDASSAF
RVGPVAATY	RVGPVAATY
VIKETQERY	VIKETQERY
QVMEGRVTF	QVMEGRVTF
ILHTTGLQY	ILHTTGLQY
IVGPTLKATF	IVGPLKATF
TVKGVSLSSY	TVKGSLSSY
RQFLIHEL	RQF-LIHEL
RIFPLSEDY	RIFPLSEDY
VQVKRIHEY	VQVKRIHEY
GQANKVMIY	GQANKVMIY
KEIESRVVF	KEIESRVVF
YVTTSTRTY	YVTTSTRTY
AQSRFLSTY	AQSRFLSTY
AQVVLYRSY	AQVVLYRSY
SQVDSKSTF	SQVDSKSTF
VLKADEGISF	VLKAEGISF
AVAKPFITY	AVAKPFITY
GQPAQDIFSVY	AQD-IFSVY
RQIDLVDNYF	RQIDLVDNY
LQREAQTLQQY	REAQTLQQY
MQLPNGVTY	MQLPNGVTY
VTKPEGKDY	VTKPEGKDY
GQIPATALL	GQIPATALL
KQMLSALNY	KQMLSALNY
RQITQVYGF	RQITQVYGF
HQKSELLEL	HQKSELLEL
ANALGGKGAGF	ALGGKGAGF
QQQQPQHAF	QQQQPQHAF
HTFLHTVY	HTF-LHTVY
IQIKDAIGRY	IQIKAIGRY
GQISGLNVL	GQISGLNVL
KLRVETQKF	KLRVETQKF
ISKSGGDYAY	ISKSGDYAY
QQHSPQQIAY	QQHSQQIAY
SQRFKSSVY	SQRFKSSVY
RIKTEEEAF	RIKTEEEAF
RMKLKAEAY	RMKLKAEAY
AVYKVSEY	AVY-KVSEY
SQKKPTVTL	SQKKPTVTL
AQYQSVPVY	AQYQSVPVY
TLTPISAAY	TLTPISAAY
HQPDNIKALF	HQPDNIKAL
ASQAVGETY	ASQAVGETY
TQKIPDQDFY	TQKIPDQDF
VQKEGPTAL	VQKEGPTAL
NVKVDPEIQ	NVKVDPEIQ
SQFGGGSQYAY	SQFGGGSQY
KLKEAETRAEF	KLKEAETRA
RLVPGAYLEY	RLVPAYLEY
KLAPPSSTL	KLAPPSSTL
VQKLLEQGL	VQKLLEQGL
AQAISRFAY	AQAISRFAY
RLRDENGRPY	RLRDNGRPY
GQKPNEYQEY	GQKPEYQEY
AQYRISMAAY	AQYRSMAAY
AAANPTLAF	AAANPTLAF
VGYPGRQYY	VGYPGRQYY
AQYLINARL	AQYLINARL
HQITVLHVY	HQITVLHVY
ILNPEEIEKY	ILNPEIEKY
QGLISRGYSY	GLISRGYSY
GQKVLVNVL	GQKVLVNVL
GVISKTLTY	GVISKTLTY
GSFIHREEY	GSFIHREEY
VQQVAAEY	VQQ-VAAEY
SLATPATHY	SLATPATHY
RQIVSGLKY	RQIVSGLKY
LIREYIVEY	LIREYIVEY
RLQPLTQAAY	LQPLTQAAY
RAAQLEPITY	AAQLEPITY
IQKENPKVV	IQKENPKVV
KLYRPGSVAY	KLYRGSVAY
RHMEQHVSF	RHMEQHVSF
IQQKRTVAF	IQQKRTVAF
LQFGPTEKF	LQFGPTEKF
GQISDPSRSY	GQISPSRSY
ALIKSGLGF	ALIKSGLGF
TQPHPNTVY	TQPHPNTVY
SQSLSHNVF	SQSLSHNVF
ESRQITQVY	ESRQITQVY
RQNPHHVHEW	RQNPHHVHE
SLFVGHMDY	SLFVGHMDY
AQILKVIEAY	AQILVIEAY
IQAPLVYHF	IQAPLVYHF
TQNKDINQY	TQNKDINQY
LVVDSHVQY	LVVDSHVQY
NQIPFIIQY	NQIPFIIQY
AMNPTNTVF	AMNPTNTVF
RLAQLLEGY	RLAQLLEGY
RQAGLSYIRY	RQAGSYIRY
KLAEQYESF	KLAEQYESF
RLKLQGAKF	RLKLQGAKF
KVTWITKSF	KVTWITKSF
YLFEPHSGEEY	YLFESGEEY
RVYPQAVYF	RVYPQAVYF
RVVPHGQSF	RVVPHGQSF
RMVSEAGTGF	RMVSAGTGF
VQRILRERF	VQRILRERF
TQFVSGSKY	TQFVSGSKY
AQQKNLEGY	AQQKNLEGY
VVGPNHAAF	VVGPNHAAF
RAFPNKQGY	RAFPNKQGY
RMSPATTGTF	RMSPTTGTF
TVEKGDHVAY	VEKGDHVAY
HQVPFAPIVF	HQVPAPIVF
RQFPFHEMF	RQFPFHEMF
SQAEDVATY	SQAEDVATY
GIHPDDLSF	GIHPDDLSF
SQYQGVVVY	SQYQGVVVY
VTKPVGGNY	VTKPVGGNY
ISPFEHQTY	ISPFEHQTY
KQYERSIVDY	KQYESIVDY
KQYADKLEF	KQYADKLEF
LQNPDLVSL	LQNPDLVSL
TLTPIIQEY	TLTPIIQEY
AQSGTQLATY	AQSGQLATY
RMVEMFLEY	RMVEMFLEY
RVYPERSTSY	RVYPRSTSY
KVASQKGMSVY	SQK-GMSVY
ASIEEKVAY	ASIEEKVAY
AQYENPPHIY	AQYEPPHIY
ASKEEATTF	ASKEEATTF
SQRDYTQYY	SQRDYTQYY
AIRQQIESY	AIRQQIESY
VLKEEGVSF	VLKEEGVSF
RMKEVGKVF	RMKEVGKVF
IQRLIEQEEY	IQRLEQEEY
AVKPDQIQY	AVKPDQIQY
LVSKQVKEY	LVSKQVKEY
TQAYGQQSY	TQAYGQQSY
AQIKFLNTY	AQIKFLNTY
VQPSKQLEY	VQPSKQLEY
AQIKVTKEL	AQIKVTKEL
IIHEGSSVY	IIHEGSSVY
KQTQIFTTY	KQTQIFTTY
GQTKPVYVY	GQTKPVYVY
RMKKEASVKF	RMKKASVKF
AQKVIYTL	AQK-VIYTL
MLRDIIREY	MLRDIIREY
YQYTIRAH	YQY-TIRAH
FIMGKTIEF	FIMGKTIEF
LLKDSIVQL	LLKDSIVQL
RSIQQNIQY	RSIQQNIQY
LQVEGHSNVY	LQVEHSNVY
VQRVASVMQEY	RVASVMQEY
GLNKVSPVY	GLNKVSPVY
AQIIQRSF	AQI-IQRSF
RQYSRNEPLTF	RQYSRNEPL
TLRQKIRKY	TLRQKIRKY
AIATGGAVF	AIATGGAVF
AAYGYGIRY	AAYGYGIRY
SQTLPTSNY	SQTLPTSNY
IQRIFLITL	IQRIFLITL
FIKDGSSTY	FIKDGSSTY
AVALDNSVY	AVALDNSVY
RQALQDLLSEY	ALQDLLSEY
LQRTMNEIY	LQRTMNEIY
QQTNSIRNY	QQTNSIRNY
NSGDVNVEIN	NSGDVNVEI
GQHNQSVNY	GQHNQSVNY
SQFLQAAERY	SQFLAAERY
AQRKFGVVL	AQRKFGVVL
RAQPRGAVY	RAQPRGAVY
IQNPDLWNSY	IQNPLWNSY
ILNKPGLKY	ILNKPGLKY
ILNSGARGY	ILNSGARGY
GQKQVIPGL	GQKQVIPGL
ALKEDAATF	ALKEDAATF
AQKQIFDVVY	AQKQFDVVY
AQKSDIVQL	AQKSDIVQL
SLVGPTQSF	SLVGPTQSF
RAFALVSQAY	RAFAVSQAY
KIKEYIQKY	KIKEYIQKY
TQNPYHQQAL	TQNPHQQAL
SGKLVQIEY	SGKLVQIEY
AMIDGQSAF	AMIDGQSAF
VEKGDHVAY	VEKGDHVAY
RQKEVNENF	RQKEVNENF
AQIRETETF	AQIRETETF
KIKSFVKVY	KIKSFVKVY
LQQPRSLTY	LQQPRSLTY
AAGPPISEGK	AAGPPISEG
AQFRVTEAL	AQFRVTEAL
KQQLQTQGY	KQQLQTQGY
GQQIGKVVQVY	QQIGVVQVY
SQRIIRNAL	SQRIIRNAL
AQRYNELSY	AQRYNELSY
SQEKPSTTY	SQEKPSTTY
TLQKQSVVY	TLQKQSVVY
DRIINTLSI	DRIINTLSI
LQPEPIKVY	LQPEPIKVY
VQNKLGVVF	VQNKLGVVF
AQNASRNTF	AQNASRNTF
FKQYANDNGVD	KQYANDNGV
ILSDPKKKTRY	LSDPKKTRY
SAAQPGVAF	SAAQPGVAF
GQAPINNTGF	GQAPNNTGF
HQREIQVM	HQR-EIQVM
VGTHLAYAAAF	GTHLYAAAF
GLKDKETRY	GLKDKETRY
