Data	Data aligned
SPSELMLTL	SPSELMLTL
TYDDATKTF	TYDDATKTF
LPQEDPPT	LPQE-DPPT
FPYQTQEEPL	FPYQTEEPL
LPANVGGQIL	LPANVGQIL
YPDSKDLTM	YPDSKDLTM
TPIEGMLSHQL	TPIEGMLSH
YPDPSKQKPM	YPDPSQKPM
HPYQPDPKM	HPYQPDPKM
QAFIDLHSA	QAFIDLHSA
LPQLTGAENVL	LPQLTENVL
FPIEVRHYL	FPIEVRHYL
QPHPFDPIL	QPHPFDPIL
PSEPHPVL	PSEP-HPVL
HPEKLATVL	HPEKLATVL
VPIESDKTL	VPIESDKTL
LPVHGEQAL	LPVHGEQAL
YPETLGRLL	YPETLGRLL
FVTEVAYKM	FVTEVAYKM
TAFDRDRAM	TAFDRDRAM
TAPTGHTL	TAPT-GHTL
SPSEILQEL	SPSEILQEL
TAAAVGAVF	TAAAVGAVF
YPLQDPKNLIL	YPLQDPKNL
MPTSTILRL	MPTSTILRL
TPSDVKELVL	TPSDVELVL
YAIEVDPVL	YAIEVDPVL
FPIAPEIAL	FPIAPEIAL
HPLPGTQLL	HPLPGTQLL
SPTENSFTL	SPTENSFTL
EPEPSPKAL	EPEPSPKAL
TAMEQLYTL	TAMEQLYTL
YPFQDSEPVL	YPFQDEPVL
YPFTGDHKQKF	YPFTGDHKQ
MAVEGDHSM	MAVEGDHSM
MPFQQWEAL	MPFQQWEAL
MPVHAAVQM	MPVHAAVQM
HINEGETAM	HINEGETAM
YPSKQFDVL	YPSKQFDVL
FVDPNGKISL	FVDPNKISL
EPFQDGYSL	EPFQDGYSL
NAMEDAQTL	NAMEDAQTL
LPFSGPREPSL	LPFSGEPSL
FPHAVDHIL	FPHAVDHIL
FPDPNVKYVF	FPDPNKYVF
FPFRKDLRM	FPFRKDLRM
TPQDHEVAL	TPQDHEVAL
YPFESAEAQLL	YPFESEAQL
IPKSSDPEM	IPKSSDPEM
MPHSYPYVAL	MPHSYYVAL
FPQQGQISL	FPQQGQISL
SASGVLFSL	SASGVLFSL
LPLQTSHAL	LPLQTSHAL
SPIPHDPEF	SPIPHDPEF
DAHKGVAL	DAHK-GVAL
FPISEETIKL	FPISETIKL
HAIEDKETI	HAIEDKETI
FPIKDVPL	FPIK-DVPL
YPEEVSSMVL	YPEEVSMVL
VPDPNKPQKL	VPDPNPQKL
LPNAVITRI	LPNAVITRI
MPSEDVVSL	MPSEDVVSL
LPVSVSREL	LPVSVSREL
VPAPTNVL	VPAP-TNVL
FPRDPEIEM	FPRDPEIEM
LPDGQVITI	LPDGQVITI
LPVASSSTL	LPVASSSTL
YPSETFTRV	YPSETFTRV
LPISQESLL	LPISQESLL
LPHSTAAL	LPHS-TAAL
NPTEIDKVL	NPTEIDKVL
HPYPHNHYM	HPYPHNHYM
TPSDIFMVM	TPSDIFMVM
YPEGAPAVL	YPEGAPAVL
SPDEHEPLL	SPDEHEPLL
IPLRSSWVM	IPLRSSWVM
TPYNGTEAL	TPYNGTEAL
MPVEVQTELL	MPVEVQTEL
MPLRDAAKL	MPLRDAAKL
LPFFTEREQTL	LPFFTEQTL
VPNDIQSEL	VPNDIQSEL
YPNERFELL	YPNERFELL
FVVEHDFIM	FVVEHDFIM
MVLEYDHPL	MVLEYDHPL
YPEEITPLL	YPEEITPLL
HPADMQLVL	HPADMQLVL
HPLEGTHEL	HPLEGTHEL
SASALAVAL	SASALAVAL
FPVSRNANL	FPVSRNANL
HPFDQRIIL	HPFDQRIIL
LPTSVVTIT	LPTSVVTIT
FPSTETATL	FPSTETATL
YPLEDATHIAL	YPLEDATHI
HPTSHVSLL	HPTSHVSLL
MPIREGDTVTL	MPIRETVTL
LPTDSAIIM	LPTDSAIIM
SADPNVVDL	SADPNVVDL
YPYTPRKEDEL	YPYTPEDEL
PIHADPRL	PIHA-DPRL
TPSPDIIVL	TPSPDIIVL
EAFPHDSQL	EAFPHDSQL
FPTPDPAAL	FPTPDPAAL
FPVSIPAVL	FPVSIPAVL
LPAEFFEVL	LPAEFFEVL
FPSSSVYPT	FPSSSVYPT
SPIGRDGKL	SPIGRDGKL
FPGSEDVKL	FPGSEDVKL
FPHSMEPQL	FPHSMEPQL
TAAMIDAVL	TAAMIDAVL
MPFTTVSEL	MPFTTVSEL
MVADPDNPL	MVADPDNPL
FPDSGHFNV	FPDSGHFNV
YPQDWFQVL	YPQDWFQVL
FPAPSHVV	FPAP-SHVV
LPAPPTQNM	LPAPPTQNM
LPNGMIVTL	LPNGMIVTL
IPNEIIHAL	IPNEIIHAL
HPIRLGLAL	HPIRLGLAL
TPSPIIQQL	TPSPIIQQL
MPEPTVLSL	MPEPTVLSL
MPLGSAVDIL	MPLGSVDIL
YPASTVQIL	YPASTVQIL
MPNQIVQIL	MPNQIVQIL
FPESQTKEL	FPESQTKEL
FPEEDAEQL	FPEEDAEQL
LPAPALEYETL	APALEYETL
MPDPTPFLL	MPDPTPFLL
VAPGKDLTK	VAPGKDLTK
IPIGIDKAL	IPIGIDKAL
LPLEEGQAVL	LPLEEQAVL
IPEQTYITL	IPEQTYITL
HATIIPKVL	HATIIPKVL
FPIPEEYTF	FPIPEEYTF
HPDAFDNEL	HPDAFDNEL
FPHKFEISF	FPHKFEISF
MPLTADPTL	MPLTADPTL
EAITGDFAL	EAITGDFAL
TAAPTIGVL	TAAPTIGVL
SAIFPDVAL	SAIFPDVAL
FVNPVQVVL	FVNPVQVVL
FPDEKEDNL	FPDEKEDNL
KPIEVDELL	KPIEVDELL
HATFNDPVM	HATFNDPVM
FPDEKIPTL	FPDEKIPTL
YPSEFSTYL	YPSEFSTYL
MPEFPNGSSI	MPEFPGSSI
LPNNAKLEM	LPNNAKLEM
LPSRVIEEL	LPSRVIEEL
HPQPGAVEL	HPQPGAVEL
HPEINAVQL	HPEINAVQL
FPLDGHVL	FPLD-GHVL
FPQMGRFTL	FPQMGRFTL
FPVPTPEM	FPVP-TPEM
FPFSRPELL	FPFSRPELL
FPIQMEGVKL	FPIQMGVKL
MPADSGYPA	MPADSGYPA
HPIKQVDVL	HPIKQVDVL
LPDSGDSML	LPDSGDSML
FPEAIIVKP	FPEAIIVKP
MPSPIMHPLIL	MPSPIMHPL
HPISDHEATL	HPISDEATL
SIPEKNRPL	SIPEKNRPL
FPVIETSTL	FPVIETSTL
FPDEGFSGL	FPDEGFSGL
YPFESAEAQL	YPFESEAQL
HPISSGLEAM	HPISSLEAM
LATVVAETL	LATVVAETL
YPDRIMNTF	YPDRIMNTF
FAVLEDHTL	FAVLEDHTL
HAFSEDPML	HAFSEDPML
NPDDVFREF	NPDDVFREF
HPSFDDYEL	HPSFDDYEL
TPDGAVRVL	TPDGAVRVL
LPSIVNEVL	LPSIVNEVL
EAAPDGPAL	EAAPDGPAL
MPDVVVRSF	MPDVVVRSF
LPVVDFNEM	LPVVDFNEM
HAAPFQNIL	HAAPFQNIL
AAPSAAREL	AAPSAAREL
SPSDFSVSL	SPSDFSVSL
HPISNNNSL	HPISNNNSL
FPYPTQAEL	FPYPTQAEL
FPWEKPTTL	FPWEKPTTL
HPFHILIAL	HPFHILIAL
LPIATVEEL	LPIATVEEL
FPSDTFHTM	FPSDTFHTM
MPKMDQDSL	MPKMDQDSL
RPTSVDPAL	RPTSVDPAL
FADGHVLEL	FADGHVLEL
IPSPVLVKL	IPSPVLVKL
LPAGIVAVL	LPAGIVAVL
FPNKQGYVL	FPNKQGYVL
LPWASTHSL	LPWASTHSL
HPHPLITVL	HPHPLITVL
SPFPASQAL	SPFPASQAL
FPVGRVHRL	FPVGRVHRL
FPQYPDKEL	FPQYPDKEL
LEDALQQAKED	DALQQAKED
NVKVDPEIQ	NVKVDPEIQ
LPAQSAATL	LPAQSAATL
SPHDISNVL	SPHDISNVL
MPYLEHESF	MPYLEHESF
IPDSHEITL	IPDSHEITL
WPAAGFEL	WPAA-GFEL
DPNLEFVAM	DPNLEFVAM
RPLDVDWTL	RPLDVDWTL
IPIPSTGSVEM	IPSTGSVEM
FASLPDPVL	FASLPDPVL
MPDLAHVM	MPDL-AHVM
MPVLEQSVL	MPVLEQSVL
MPDSAAALL	MPDSAAALL
HPDPTRLLLF	HPDPTRLLL
NAMRADPAL	NAMRADPAL
IPNPQERTLTL	IPNPQERTL
LPAPADFLSL	LPAPAFLSL
VPVGNSPAL	VPVGNSPAL
VVTGVANAL	VVTGVANAL
HPETIVLDPLP	HPETILDPL
SPNDFSVSL	SPNDFSVSL
IPHMDIEAL	IPHMDIEAL
MPVEKNITL	MPVEKNITL
MPVGPAPGM	MPVGPAPGM
MPMVTDNKM	MPMVTDNKM
HPQGFEVAL	HPQGFEVAL
WGPLPGIP	WGPL-PGIP
IPQPTPASL	IPQPTPASL
LPSGLDSVL	LPSGLDSVL
HAIEESVVL	HAIEESVVL
FPNSVENIL	FPNSVENIL
WPGPLADM	WPGP-LADM
TANPFPVPSL	TANPFVPSL
YPVDKDMEL	YPVDKDMEL
LPQPSSIVL	LPQPSSIVL
IPFDGDLLSM	IPFDGLLSM
STPAPVPVI	STPAPVPVI
FPAKPGSLTL	FPAKPSLTL
YPNGTSAAL	YPNGTSAAL
FPSEDILLV	FPSEDILLV
TANALALAM	TANALALAM
FPGQLNADL	FPGQLNADL
LPVHVFEAL	LPVHVFEAL
SPDSGVYEM	SPDSGVYEM
YPFIGDVHSL	YPFIGVHSL
FPVEIANEI	FPVEIANEI
SPNYDHVVL	SPNYDHVVL
MPETSHIVAL	MPETSIVAL
MPSRELASM	MPSRELASM
MPEDVKNFYL	MPEDVNFYL
MPEQWARLL	MPEQWARLL
EGSPIKVTL	EGSPIKVTL
HPIRVVNAL	HPIRVVNAL
IPAPPSSPL	IPAPPSSPL
SAPSRATAL	SAPSRATAL
IPSSHPVSL	IPSSHPVSL
TPSSDVLVF	TPSSDVLVF
DAIARDAEL	DAIARDAEL
YPWEGLNAL	YPWEGLNAL
FPTTDGNHL	FPTTDGNHL
HPEGSLPDLTM	HPEGSLPDL
MPAPHTSITM	MPAPHSITM
HPEPTDHVL	HPEPTDHVL
TAISLFYEL	TAISLFYEL
MANPTALLL	MANPTALLL
HPQPIDPLL	HPQPIDPLL
SVPEAQSAL	SVPEAQSAL
HPMAYQLQL	HPMAYQLQL
LPHSGEAQL	LPHSGEAQL
LEEYAATL	LEEY-AATL
HPVDQANTL	HPVDQANTL
FPLSESQTL	FPLSESQTL
FPFERLYDL	FPFERLYDL
HPLDLQSAL	HPLDLQSAL
MPQHIMAIL	MPQHIMAIL
MIFQDPTAM	MIFQDPTAM
YPLDLLLKL	YPLDLLLKL
LPTEKEVAL	LPTEKEVAL
RPEEIAALL	RPEEIAALL
HPSQLVLTL	HPSQLVLTL
TPISAGDLL	TPISAGDLL
IPSSVAEAL	IPSSVAEAL
MAPERVASL	MAPERVASL
MPVQDLPRL	MPVQDLPRL
FPIDHFTHI	FPIDHFTHI
FPTIGDVHL	FPTIGDVHL
HPETRSAFL	HPETRSAFL
LPIAEAPGKL	LPIAEPGKL
IPIKKSDPV	IPIKKSDPV
FPRHIEPEL	FPRHIEPEL
IPYARDAVI	IPYARDAVI
YPETGVFVI	YPETGVFVI
LPHSATVTL	LPHSATVTL
FPIPGEPGF	FPIPGEPGF
VPVSRDFTL	VPVSRDFTL
FPAAPIPTL	FPAAPIPTL
MPNLYGDIL	MPNLYGDIL
LPVESVHIL	LPVESVHIL
TADPSHQTM	TADPSHQTM
HPVEAAQTL	HPVEAAQTL
LPSKDVQSL	LPSKDVQSL
HPGEADSVL	HPGEADSVL
FPDSTKSSL	FPDSTKSSL
QPDNIVYVM	QPDNIVYVM
MPESGVAL	MPES-GVAL
HPNQAELIV	HPNQAELIV
FPHPGFNMSL	FPHPGNMSL
HPESERISM	HPESERISM
MPTGAGKSL	MPTGAGKSL
LPMPTEPLL	LPMPTEPLL
FPSEYVPTV	FPSEYVPTV
LPSLSAHEL	LPSLSAHEL
LPSGAVFVI	LPSGAVFVI
LPSEHQTIL	LPSEHQTIL
VPQSGVPAL	VPQSGVPAL
HPFFKDMSL	HPFFKDMSL
TPIREQHVL	TPIREQHVL
LPNGQPTVL	LPNGQPTVL
FPTAEEPHL	FPTAEEPHL
FPVRDGVVL	FPVRDGVVL
FPVSWDNEV	FPVSWDNEV
SPEPSPVTL	SPEPSPVTL
QPAPISPHL	QPAPISPHL
MPVTKGDFEL	MPVTKDFEL
DNPIQTVSL	DNPIQTVSL
MPEEDPATL	MPEEDPATL
EPYKTNKGDEL	YKTNKGDEL
VPQLHGEVL	VPQLHGEVL
TPLSSTVTL	TPLSSTVTL
SPIERNEQL	SPIERNEQL
LPFPKDASL	LPFPKDASL
YPEPAPAAL	YPEPAPAAL
NAAGVPKQSL	NAAGVKQSL
FPYEGPLRL	FPYEGPLRL
FPHFDLSHGSA	FPHF-DLSH
MPVDLELVA	MPVDLELVA
VPLDEKLLPQL	VPLD-EKLL
VPYWPEVGM	VPYWPEVGM
LPSPSPRISL	LPSPSRISL
FPEDVVRVIF	FPEDVVRVI
HPFEDGAKL	HPFEDGAKL
YPNPKPEVL	YPNPKPEVL
LPDFGGNVL	LPDFGGNVL
HVSLVQLTL	HVSLVQLTL
HPDKDVRLL	HPDKDVRLL
TPSEPHPVL	TPSEPHPVL
IPVAIRTQI	IPVAIRTQI
MPMGSLEHEGL	MGSLEHEGL
YPTIATGIL	YPTIATGIL
YPQDYQFYI	YPQDYQFYI
LPAHIPYQEL	LPAHIYQEL
AANPIQFTL	AANPIQFTL
LPIDESNTI	LPIDESNTI
FPVESEAVM	FPVESEAVM
LPIVTPAL	LPIV-TPAL
FPAAIEHTI	FPAAIEHTI
IPIALSGRDIL	IALSGRDIL
LPFGKVTNI	LPFGKVTNI
LPSGEDYNL	LPSGEDYNL
FPGPFEEEM	FPGPFEEEM
LPLPAERVTL	LPLPARVTL
YPFEDHNPP	YPFEDHNPP
FPSNFIKEL	FPSNFIKEL
IPVPINAEL	IPVPINAEL
AQDPLLLQM	AQDPLLLQM
TADGAHFEL	TADGAHFEL
LPYPKDVYSV	LPYPKVYSV
HPVEKPVVL	HPVEKPVVL
LPQKGDVEM	LPQKGDVEM
IPVHEEFIL	IPVHEEFIL
QPNPLPLRL	QPNPLPLRL
MPNGTVQRF	MPNGTVQRF
MPFQDGKPFNL	MPFQDGKPF
IPVNEKDTL	IPVNEKDTL
TEKPEVID	TEKP-EVID
LPTEEEWEF	LPTEEEWEF
FPIHVQTSL	FPIHVQTSL
YAVTGDVKM	YAVTGDVKM
YPGLADPVF	YPGLADPVF
SPTDSDVSL	SPTDSDVSL
LPEDSKAVL	LPEDSKAVL
MAATGDVAL	MAATGDVAL
FPSAPDVKA	FPSAPDVKA
SAPVGVTAL	SAPVGVTAL
FPEQIAEKL	FPEQIAEKL
TPAVVSERL	TPAVVSERL
LPLAGEEEL	LPLAGEEEL
VPDSSGPERIL	VPDSSERIL
FPEPSRPPL	FPEPSRPPL
FPMAHPPNL	FPMAHPPNL
FPSNLVTEM	FPSNLVTEM
HPEDVEPAL	HPEDVEPAL
LPVQPENAL	LPVQPENAL
MPDELLTSL	MPDELLTSL
SPNSYVVIM	SPNSYVVIM
IPSAATLII	IPSAATLII
LPIAASSSL	LPIAASSSL
SPLESDVSL	SPLESDVSL
FPDDATSPL	FPDDATSPL
LPSTTIVSM	LPSTTIVSM
MPLVEETSL	MPLVEETSL
ASAPPGPPA	ASAPPGPPA
LPLWVDKEASL	LWVDKEASL
IPADTFAAL	IPADTFAAL
IPILYEHQL	IPILYEHQL
LPASPAHQL	LPASPAHQL
TPDEIDHVF	TPDEIDHVF
VPNEEDPSL	VPNEEDPSL
TVAPAQVAL	TVAPAQVAL
SAGPADAEM	SAGPADAEM
LPAFSPLM	LPAF-SPLM
FPYARDDLSL	FPYARDLSL
TAYYNDPAF	TAYYNDPAF
FADPVDVNPF	FADPVVNPF
FPFLDENVV	FPFLDENVV
HPVLLTEAPL	HPVLLEAPL
HAGPVINTL	HAGPVINTL
NAPWAVTSL	NAPWAVTSL
LPDHINIVL	LPDHINIVL
FPIANGPNL	FPIANGPNL
YPVNSVNIL	YPVNSVNIL
LPFSDQVVL	LPFSDQVVL
TPYPSSASL	TPYPSSASL
IPVPVVSAL	IPVPVVSAL
YPMGSAEAL	YPMGSAEAL
HPSVDSSVL	HPSVDSSVL
FPMELRQFL	FPMELRQFL
FPVEKQLDL	FPVEKQLDL
IPTEQVNEL	IPTEQVNEL
FPAPILRAV	FPAPILRAV
HPSASYNQL	HPSASYNQL
LPYDVTPEQAL	LPYDVEQAL
FPVQGVHTV	FPVQGVHTV
FPLTKVYVV	FPLTKVYVV
HADSNIVIM	HADSNIVIM
FPADEASIQAL	FPADEIQAL
LPAEEEATL	LPAEEEATL
MPEDLVEAL	MPEDLVEAL
LPLDNPSVL	LPLDNPSVL
SPNSDDTVL	SPNSDDTVL
TPEEGAQAL	TPEEGAQAL
MPSDQYEL	MPSD-QYEL
EPFPDGAEL	EPFPDGAEL
LPVEDDIDL	LPVEDDIDL
VPEEKAAEL	VPEEKAAEL
IPTGEGPPL	IPTGEGPPL
LPFDDDNVM	LPFDDDNVM
FPYEYSYGL	FPYEYSYGL
MPVRAADKL	MPVRAADKL
FPDLFSEQL	FPDLFSEQL
SPISSDQSL	SPISSDQSL
MPIDQGFASL	MPIDQFASL
YPTVDSNSL	YPTVDSNSL
MPDSELFEL	MPDSELFEL
MPETTETVL	MPETTETVL
HPVSREWTL	HPVSREWTL
LPYAGDVSM	LPYAGDVSM
APVKYDHIL	APVKYDHIL
YPTPYPDEL	YPTPYPDEL
NIAGPDAAL	NIAGPDAAL
LPIEDSQDL	LPIEDSQDL
IPDSSKISL	IPDSSKISL
FPFVDDNEV	FPFVDDNEV
MPEEAIETL	MPEEAIETL
HPEIYPLVL	HPEIYPLVL
YPVSSPKSM	YPVSSPKSM
FPISEETIKLL	FPISETIKL
LPDSFSPEL	LPDSFSPEL
HPLGDIVAF	HPLGDIVAF
IPENVDITL	IPENVDITL
MPLQDSISL	MPLQDSISL
HPYLAQNEL	HPYLAQNEL
FATSTEPVL	FATSTEPVL
YPDATPEEL	YPDATPEEL
LPSDKALVL	LPSDKALVL
LPIDEDEEM	LPIDEDEEM
MPETYQARL	MPETYQARL
IAPTGHSL	IAPT-GHSL
IPDSHIVLM	IPDSHIVLM
TPVPSVNEL	TPVPSVNEL
IANPTATLL	IANPTATLL
HAFVQDTTL	HAFVQDTTL
TPGGSHPAL	TPGGSHPAL
YPLEDHTEF	YPLEDHTEF
SPSDADREL	SPSDADREL
MPIGPDVSL	MPIGPDVSL
FPVNKDVTL	FPVNKDVTL
FPQLDVSRL	FPQLDVSRL
YPTISLHAL	YPTISLHAL
LPNASADSL	LPNASADSL
HPSESDFSL	HPSESDFSL
LPVDIRQYL	LPVDIRQYL
FPVEVEVPM	FPVEVEVPM
MAYGVEPAL	MAYGVEPAL
MPHEKHYTL	MPHEKHYTL
LPHKGNIL	LPHK-GNIL
IIHEIAVLEL	IIHEIVLEL
MANGAVIHL	MANGAVIHL
VTIKKDVDG	VTIKKDVDG
YPYEHSYGL	YPYEHSYGL
HASIVEVLL	HASIVEVLL
DPFRDLHSL	DPFRDLHSL
MPHSSSAKL	MPHSSSAKL
TVTEKPEVID	TVTEKPEVI
MPAEEFREL	MPAEEFREL
FPDEGILAV	FPDEGILAV
YPFPLSHSV	YPFPLSHSV
LPSGVSAKL	LPSGVSAKL
FPYAQRQFL	FPYAQRQFL
TPDPSANISL	TPDPSNISL
VPSSIDPIL	VPSSIDPIL
VPIPKDHQV	VPIPKDHQV
MPTQEVQEL	MPTQEVQEL
ITPTGTHPL	ITPTGTHPL
IPNSIMTIL	IPNSIMTIL
HPASSDPRF	HPASSDPRF
HPVSGKHIL	HPVSGKHIL
QAIENAHVL	QAIENAHVL
YPNTYIFDL	YPNTYIFDL
TPADVFIVF	TPADVFIVF
FPSVLVEEL	FPSVLVEEL
IPYEGFASL	IPYEGFASL
NPIEEISVL	NPIEEISVL
FPNRLNLEA	FPNRLNLEA
YLPDGTASL	YLPDGTASL
YAPSGNYV	YAPS-GNYV
YPDINFNRL	YPDINFNRL
SPDHTIILL	SPDHTIILL
HPSGATPTL	HPSGATPTL
HAGPTAHEL	HAGPTAHEL
YPHLHNAEL	YPHLHNAEL
NAVGDGIVL	NAVGDGIVL
MPSLQPVVM	MPSLQPVVM
HPIDGFLQSL	HPIDGLQSL
IAHLEITAL	IAHLEITAL
FPLTEDQKL	FPLTEDQKL
SPHEESISL	SPHEESISL
NASEVPMVL	NASEVPMVL
QADTTRLEL	QADTTRLEL
MPVDSFNSM	MPVDSFNSM
MPVVAGAVF	MPVVAGAVF
YPLPAVKVSM	YPLPAKVSM
FPDGLAHSDLM	FPDGLAHSD
APEPRAALL	APEPRAALL
HPADKDYGL	HPADKDYGL
VPYEKGFAL	VPYEKGFAL
FPHEQKIKL	FPHEQKIKL
LPIGDSASNLL	LPIGDASNL
LPVGTTATL	LPVGTTATL
YPYPYPHTLYL	YPYPYPHTL
NAAFPDTSM	NAAFPDTSM
TPVEEVEAL	TPVEEVEAL
MPDHVIPEI	MPDHVIPEI
LPQHPDVEM	LPQHPDVEM
IPAPAEKTPV	IPAPAEKTP
LPNVNAAIL	LPNVNAAIL
HPVSDHEATL	HPVSDEATL
DPYQGTIVL	DPYQGTIVL
YGPPGTGKTL	GPPGTGKTL
FPEPSRPPLF	FPEPSRPPL
FPEALRLAL	FPEALRLAL
LPEAFPITL	LPEAFPITL
YPFDSPQVM	YPFDSPQVM
FAMEIDPSL	FAMEIDPSL
HPDKMHLVL	HPDKMHLVL
SPIEKSGVL	SPIEKSGVL
MPTDVLEVT	MPTDVLEVT
LPDGTSLTQTF	LPDGTSLTQ
IAQLDPEAL	IAQLDPEAL
YPIDDVYTGM	YPIDDVYTG
HPTIISESF	HPTIISESF
FASEVSNVL	FASEVSNVL
HPLEDRNTI	HPLEDRNTI
NPHDRVVAL	NPHDRVVAL
MPQSMPEYAL	MPQSMEYAL
LPAEEVDVL	LPAEEVDVL
HPFPGPGLAI	HPFPGGLAI
TPFHEIMSL	TPFHEIMSL
HADDSFLVL	HADDSFLVL
FPNAIEHTL	FPNAIEHTL
FNEKSKEL	FNEK-SKEL
MPIGGDVPAL	MPIGGVPAL
FPLDKMTYL	FPLDKMTYL
FPVAEDISL	FPVAEDISL
IPFAAPTAL	IPFAAPTAL
MPEGGQGAPPM	MPEGGAPPM
FPVGGPGTSL	FPVGGGTSL
FPASVHDSL	FPASVHDSL
YPSINPPTL	YPSINPPTL
MPDEETPL	MPDE-ETPL
MPSPMPEYL	MPSPMPEYL
LPEYNPRTL	LPEYNPRTL
FPEYELPEL	FPEYELPEL
RPSEVSEAL	RPSEVSEAL
TPTIANPIL	TPTIANPIL
YAFPLAHSL	YAFPLAHSL
LPALPTQAL	LPALPTQAL
LAPTDVKEL	LAPTDVKEL
FPSQDPVL	FPSQ-DPVL
FPQEGMHQM	FPQEGMHQM
MPVGPDAIL	MPVGPDAIL
TASQVYETL	TASQVYETL
LPLAHVLEL	LPLAHVLEL
MPSQFRDIL	MPSQFRDIL
SPLAFEHVM	SPLAFEHVM
TSSPPDKVL	TSSPPDKVL
FPIPGEPGFPL	FPIPGEPGF
MPVKQPYYL	MPVKQPYYL
FPEHIFPAL	FPEHIFPAL
YPLEDLPSL	YPLEDLPSL
HPIEGSTTV	HPIEGSTTV
LPLENASIL	LPLENASIL
MPSKTELIV	MPSKTELIV
SPSKADPAL	SPSKADPAL
SPHDVSSVL	SPHDVSSVL
APAPVQPPM	APAPVQPPM
MPTGGGKSL	MPTGGGKSL
MPSDVLEVT	MPSDVLEVT
YPFSSSNDEEL	FSSSNDEEL
MPVRWVTGL	MPVRWVTGL
SPVGVNHRL	SPVGVNHRL
LPSDFTPAV	LPSDFTPAV
YPQGQAPPL	YPQGQAPPL
HPQIEPANQEL	HPQIENQEL
YAVRDTIAL	YAVRDTIAL
IPVHDGYVL	IPVHDGYVL
FPESSAIEAL	FPESSIEAL
LPFYESSPQVL	FYESSPQVL
LPTAVEPLM	LPTAVEPLM
LPTDTLQEL	LPTDTLQEL
FPVSKTLVL	FPVSKTLVL
MIAFHDPEL	MIAFHDPEL
LPIPRPGEVL	LPIPRGEVL
FPLDKSLLL	FPLDKSLLL
LPNPTLVTI	LPNPTLVTI
IPMSDPQVL	IPMSDPQVL
NAWDKEPVL	NAWDKEPVL
HATVTSVTL	HATVTSVTL
LPVNDEHVTV	LPVNDEHVT
IPFSGALEL	IPFSGALEL
FPDQVAIQL	FPDQVAIQL
FPEPNPRVI	FPEPNPRVI
HPTDERVAL	HPTDERVAL
MPLHVAPLL	MPLHVAPLL
YPLEEGSTSL	YPLEESTSL
TAIESTPTL	TAIESTPTL
FPDTPLAL	FPDT-PLAL
LPDNSILVV	LPDNSILVV
APSPEDPEL	APSPEDPEL
NAEPEPRSL	NAEPEPRSL
FPDAGEDEL	FPDAGEDEL
PVEIHEYL	PVEI-HEYL
FPEADKVRTM	FPEADVRTM
HPDTGEKMIL	HPDTGKMIL
YPDFTNPTM	YPDFTNPTM
DPASLDHKL	DPASLDHKL
LPSTEAVAL	LPSTEAVAL
FPNQGEVKL	FPNQGEVKL
HPTAHAPMM	HPTAHAPMM
YPSMSDPYL	YPSMSDPYL
MPLPGTKAL	MPLPGTKAL
TPIPGTIEM	TPIPGTIEM
MPLDKHMEM	MPLDKHMEM
LPTEISQSL	LPTEISQSL
IPMEFVNKM	IPMEFVNKM
YVLPEHMSM	YVLPEHMSM
FPEERPEVL	FPEERPEVL
HPMNSISSL	HPMNSISSL
IPSEDHQVL	IPSEDHQVL
FAEDITTGQVL	FAEDIGQVL
LPVALQTRL	LPVALQTRL
IPLQDLVAA	IPLQDLVAA
FPTVQHQEL	FPTVQHQEL
NAIREVLEL	NAIREVLEL
FPIPLINRL	FPIPLINRL
MPTTERVTL	MPTTERVTL
MPEKEPSVL	MPEKEPSVL
HPESVSQSL	HPESVSQSL
MPAETEEL	MPAE-TEEL
LPNFGSHVL	LPNFGSHVL
APEEHPVLL	APEEHPVLL
LPHISDVVL	LPHISDVVL
GGLPERSVSL	LPER-SVSL
HPQTHETAL	HPQTHETAL
FPAPVQPVSL	FPAPVPVSL
TPSVHEPVL	TPSVHEPVL
HPNEGALVL	HPNEGALVL
TPINQNVSL	TPINQNVSL
LPQTGEQEL	LPQTGEQEL
IPYPKEELPL	IPYPKELPL
FPSTAEHTL	FPSTAEHTL
TPENLPQIL	TPENLPQIL
SPAPTHNSL	SPAPTHNSL
FPYEEHLEM	FPYEEHLEM
FPSPGPVAL	FPSPGPVAL
FPHELEVPAL	FPHELVPAL
SPIGDDVQL	SPIGDDVQL
LPNIHPELL	LPNIHPELL
FPSGETIVM	FPSGETIVM
HPIYPDPARL	HPIYPPARL
MPEQIVIHAL	MPEQIIHAL
FPDQNFEVM	FPDQNFEVM
MPEEKLVEAL	MPEEKVEAL
FPFYDKPM	FPFY-DKPM
SPFSFHHVL	SPFSFHHVL
FPVEVNTVL	FPVEVNTVL
TPLDEKSLAL	TPLDESLAL
LPEGGETPI	LPEGGETPI
SAAPPEPAV	SAAPPEPAV
HPQPFEEGL	HPQPFEEGL
YPEELKPVL	YPEELKPVL
FPSPNQITL	FPSPNQITL
FPHLQDAQV	FPHLQDAQV
FPEEPHVPL	FPEEPHVPL
MPFAPAIQTF	MPFAPIQTF
FPIVGEPL	FPIV-GEPL
MPTKETTKL	MPTKETTKL
NPTEPDHAI	NPTEPDHAI
RPITDSPVL	RPITDSPVL
EASPFSRSL	EASPFSRSL
YPHAAVNGL	YPHAAVNGL
TAVENMPSL	TAVENMPSL
MPHHTPHQL	MPHHTPHQL
FPAPNVIL	FPAP-NVIL
YPITRTQQL	YPITRTQQL
YPYPYPHTL	YPYPYPHTL
YPSPYPIRSL	YPSPYIRSL
MPEQNPTHAL	MPEQNTHAL
SPEPGAVVL	SPEPGAVVL
LPHLESQSL	LPHLESQSL
LPDDIGAAL	LPDDIGAAL
IPASEQETL	IPASEQETL
MPFEDDNRTRL	MPFEDDNRT
FPDFKSAGVTL	FPDFKGVTL
PVGRVHRL	PVGR-VHRL
YPYDGIHPDDL	YPYDGIHPD
PARSFGPAI	PARSFGPAI
VPDPNVIKL	VPDPNVIKL
MPNHSASIQL	MPNHSSIQL
FPEHRAAEI	FPEHRAAEI
NAAFKDVAL	NAAFKDVAL
FPSVPMKEEVL	VPMK-EEVL
MPAEEREKKL	MPAEEEKKL
SPEAQPKTL	SPEAQPKTL
EPSAVALEL	EPSAVALEL
MPGTTDTIQVL	MPGTTIQVL
LPLEKVYSL	LPLEKVYSL
IPEPIDPLF	IPEPIDPLF
YPFIIDAHL	YPFIIDAHL
RPWLDPAAA	RPWLDPAAA
YSKYYKTID	YSKYYKTID
TPVDDRISL	TPVDDRISL
YPASAGTSL	YPASAGTSL
TPVENSHSL	TPVENSHSL
IPDSTAETL	IPDSTAETL
LPDPIIIHL	LPDPIIIHL
NPIEDEAVI	NPIEDEAVI
LPFQFAHHL	LPFQFAHHL
NPDEAEKAL	NPDEAEKAL
RPNSIDPAL	RPNSIDPAL
LPDSNYNTL	LPDSNYNTL
YPGQPHPAL	YPGQPHPAL
LPSDATVVL	LPSDATVVL
FPELDSPQL	FPELDSPQL
FPFAVANQL	FPFAVANQL
HPNGNITEL	HPNGNITEL
HPDAMNQQL	HPDAMNQQL
VPTIYPLETL	VPTIYLETL
HPIHQGITEL	HPIHQITEL
FPNNVATVL	FPNNVATVL
FPAVGMHSL	FPAVGMHSL
YPLPEHRSTAL	LPEHRSTAL
NAPLVHATL	NAPLVHATL
HPNYLGDLIM	HPNYLDLIM
HPLHNDPNL	HPLHNDPNL
APEERPAAL	APEERPAAL
HAASVFLTL	HAASVFLTL
FPNIPGKSL	FPNIPGKSL
FPVPGSGLVL	FPVPGGLVL
HPDGVIPVL	HPDGVIPVL
DPIYKENIM	DPIYKENIM
FPGLASEL	FPGL-ASEL
FPSSGSVSL	FPSSGSVSL
MPVGLIAGASL	MPVGLGASL
FPAEGVESAL	FPAEGESAL
TPISNEVEM	TPISNEVEM
NAESGRGQVM	NAESGGQVM
TPAGVQVIL	TPAGVQVIL
HPDDSVKIL	HPDDSVKIL
SSLLEKGLD	SSLLEKGLD
YPSEFATYL	YPSEFATYL
MPYNYPVLL	MPYNYPVLL
MPVDDVIGTL	MPVDDIGTL
SIPGGYNAL	SIPGGYNAL
LPNSGDSTL	LPNSGDSTL
HPNVQKVVL	HPNVQKVVL
IPFEFPLHL	IPFEFPLHL
FPSWTDSEL	FPSWTDSEL
HPYIQYNVL	HPYIQYNVL
LPHTDFTL	LPHT-DFTL
HPIEGSTTVF	HPIEGSTTV
LPAEEDSVL	LPAEEDSVL
FPDEDEIL	FPDE-DEIL
EPNPDDPLM	EPNPDDPLM
TPFYGDEAL	TPFYGDEAL
LPTENVDKM	LPTENVDKM
LPFLEASTL	LPFLEASTL
FPHHEFVAL	FPHHEFVAL
LPIDKEEVSL	LPIDKEVSL
HPTDDTTTL	HPTDDTTTL
HPHAVNEIAL	HPHAVEIAL
YAFSGVEEL	YAFSGVEEL
LAATHEPT	LAAT-HEPT
TAAQVAYVL	TAAQVAYVL
HLPETKFSEL	LPETKFSEL
LPSEVDKAL	LPSEVDKAL
MPSPAPEVPL	MPSPAEVPL
VEPDITVPM	VEPDITVPM
YPNPYSKHVL	YPNPYKHVL
HPSEGGQVL	HPSEGGQVL
MPYPDETNL	MPYPDETNL
MPVSELTDKL	MPVSETDKL
YPDPVIQEL	YPDPVIQEL
QADPTKLEL	QADPTKLEL
LPTSPGPAL	LPTSPGPAL
IPAEGRVAL	IPAEGRVAL
TAIEAQHLL	TAIEAQHLL
HPEGVASLL	HPEGVASLL
HPDSVNASL	HPDSVNASL
FPNIVIKGSEL	FPNIVGSEL
APAPTAVVL	APAPTAVVL
LPEENYQVL	LPEENYQVL
TPVSFDETL	TPVSFDETL
MPEQIVVQAL	MPEQIVQAL
FPFTREEAL	FPFTREEAL
FPSEAPISL	FPSEAPISL
FPVTPVSTL	FPVTPVSTL
NPVEYSIVM	NPVEYSIVM
MPDIIIKAL	MPDIIIKAL
QPAEMAAEL	QPAEMAAEL
LPDEKNVL	LPDE-KNVL
HAQNQNYTL	HAQNQNYTL
LPAAGVGDMVM	LPAAGVGDM
LPSQEDMPH	LPSQEDMPH
TAKDSDPEL	TAKDSDPEL
QPINSTHEL	QPINSTHEL
FPSEITDTV	FPSEITDTV
FPITDVLQM	FPITDVLQM
FPEALARLL	FPEALARLL
YPQEDYESF	YPQEDYESF
LPMTTEVL	LPMT-TEVL
IPDQVIRVF	IPDQVIRVF
HPNIDTASL	HPNIDTASL
FPSKQDILL	FPSKQDILL
HPDSSNTPL	HPDSSNTPL
HPQQFQYTL	HPQQFQYTL
LPDDVRRRL	LPDDVRRRL
TPAEVRQVL	TPAEVRQVL
GPYPYTLKL	GPYPYTLKL
HAVKDAVAM	HAVKDAVAM
LPVQPEVAL	LPVQPEVAL
DAFSKDHQL	DAFSKDHQL
SAVPSDPAM	SAVPSDPAM
HGYDKDPVL	HGYDKDPVL
YPSLPTPLL	YPSLPTPLL
HVAPSDTVL	HVAPSDTVL
SADPGILVL	SADPGILVL
MPVKVEAAI	MPVKVEAAI
KAPAPRPSL	KAPAPRPSL
DPVEPHGEM	DPVEPHGEM
HADHSSLTL	HADHSSLTL
HPDQAQAIL	HPDQAQAIL
FPVEIKSFYM	FPVEISFYM
FPITQDREQLM	FPITQREQL
FPLTTESAM	FPLTTESAM
IPVEEHFQTL	IPVEEFQTL
EASPVEPQL	EASPVEPQL
IPYHSEVPVSL	YHSEVPVSL
TPAPPDLTL	TPAPPDLTL
HPFPESKPVL	HPFPEKPVL
FPEPNPRVIEL	EPNPRVIEL
SPIKDQPVM	SPIKDQPVM
QPDPESVVL	QPDPESVVL
LPDKGAQRL	LPDKGAQRL
IPVSRDWEL	IPVSRDWEL
VPAEVTVIL	VPAEVTVIL
TAMDVVYAL	TAMDVVYAL
LPVPMDAAL	LPVPMDAAL
IPIEPDYKF	IPIEPDYKF
HPVHPDIKL	HPVHPDIKL
FAADIISVL	FAADIISVL
FPISDDRNSSV	FPISDNSSV
HPIDDLQSA	HPIDDLQSA
HPYRNSDPVI	HPYRNDPVI
NPQFLDPVL	NPQFLDPVL
LPAPPHIDVM	LPAPPIDVM
TAAPPAQPL	TAAPPAQPL
HPSELIAEM	HPSELIAEM
LPDINIYQL	LPDINIYQL
LPWGGGTAL	LPWGGGTAL
VPQDTKLVL	VPQDTKLVL
EATKINLSL	EATKINLSL
APAPKAYVL	APAPKAYVL
KPVGPDLEL	KPVGPDLEL
LPEEEQQRVL	LPEEEQRVL
LPLASDPLL	LPLASDPLL
MPDLPHLL	MPDL-PHLL
TATATNHVL	TATATNHVL
SPVSFSPVL	SPVSFSPVL
LPSHVVTML	LPSHVVTML
EPVQLTFAL	EPVQLTFAL
FPQHTIASL	FPQHTIASL
LPSDIAAEA	LPSDIAAEA
IPIAVGGAL	IPIAVGGAL
TASEMILVL	TASEMILVL
MPNLYGNII	MPNLYGNII
FPEADAEKL	FPEADAEKL
LPSKVPTTL	LPSKVPTTL
TPLPEEFEL	TPLPEEFEL
MPLEDMNEF	MPLEDMNEF
HPIEIARQL	HPIEIARQL
FPDKVAIQL	FPDKVAIQL
FAYDGKDYI	FAYDGKDYI
LPDGPDAPA	LPDGPDAPA
TAVKNDYEM	TAVKNDYEM
IPYGERITL	IPYGERITL
YPIGTNAIV	YPIGTNAIV
MPVTARVVF	MPVTARVVF
MPTKTIEVL	MPTKTIEVL
SPFNDRFPL	SPFNDRFPL
MPLAEAGAL	MPLAEAGAL
MPHYDIDSA	MPHYDIDSA
DPEAFLVQI	DPEAFLVQI
DAQLQIYTL	DAQLQIYTL
FPVEHVQLL	FPVEHVQLL
NAFKEITTM	NAFKEITTM
FPAEAGRDTL	FPAEARDTL
WPDEDSRLL	WPDEDSRLL
YPDTDVILM	YPDTDVILM
LPNKVDPLV	LPNKVDPLV
MPFYNPAQL	MPFYNPAQL
QPMDIHVEL	QPMDIHVEL
YPVDLGDKF	YPVDLGDKF
LPVEEFNEL	LPVEEFNEL
MPIKLKIGL	MPIKLKIGL
FPQYSPKMQL	FPQYSKMQL
LPDDTVSTL	LPDDTVSTL
TASPVAVSL	TASPVAVSL
SPNHLYLVM	SPNHLYLVM
TPSQIGVIL	TPSQIGVIL
MPISSHVDLGL	MPISSHVDL
TPLPEDNSM	TPLPEDNSM
FPALDGGDAL	FPALDGDAL
VPIQSSVVL	VPIQSSVVL
IPEPVVRIL	IPEPVVRIL
YPIADLVKM	YPIADLVKM
FPSPEYETF	FPSPEYETF
LPDFERESL	LPDFERESL
FPIKDLVHL	FPIKDLVHL
PYPEPSKL	PYPE-PSKL
TPTEISLVL	TPTEISLVL
MPAPSDQSETL	APSDQSETL
MPSSAVRVL	MPSSAVRVL
YAIGVSHPL	YAIGVSHPL
MPADIATLL	MPADIATLL
FPVRDGKIKL	FPVRDKIKL
TAAERDEIL	TAAERDEIL
MPHVPITTL	MPHVPITTL
FPPKDDHTL	FPPKDDHTL
HPQPGSQAL	HPQPGSQAL
VPIYEGYAL	VPIYEGYAL
LPVDLAEEL	LPVDLAEEL
MVVDIVQEL	MVVDIVQEL
YPIALTRAEM	YPIALRAEM
YPQNPDHVL	YPQNPDHVL
HPIQQAKAL	HPIQQAKAL
IPYSKDVDL	IPYSKDVDL
WPAPSLSL	WPAP-SLSL
YPLLKDPSL	YPLLKDPSL
FPAEDWAGL	FPAEDWAGL
MPFGNVISA	MPFGNVISA
YPVEIHEYL	YPVEIHEYL
LEEALQQAKED	EALQQAKED
VGPPGRSSL	VGPPGRSSL
FPLQPEAQRAL	FPLQPQRAL
FPQSLPKLLL	FPQSLPKLL
MPISSHVDL	MPISSHVDL
MPVHMVPTEL	MPVHMPTEL
LPSMPEPAL	LPSMPEPAL
FPYPYAERL	FPYPYAERL
YPDEQTSRTL	YPDEQSRTL
FPFSDKLGEL	FPFSDLGEL
MPGRVEPIL	MPGRVEPIL
FPEEVIATI	FPEEVIATI
HAVHVALVL	HAVHVALVL
HPQPGSANSL	HPQPGANSL
EPNPESLEL	EPNPESLEL
MPDNNFHSL	MPDNNFHSL
SPHSAAYVL	SPHSAAYVL
NPDPAVYQL	NPDPAVYQL
SLVNLGGSK	SLVNLGGSK
YPSQDPQRM	YPSQDPQRM
MPHNQFIKM	MPHNQFIKM
VPSAVALVL	VPSAVALVL
HPAPSISSL	HPAPSISSL
MPHDLITQL	MPHDLITQL
MPVEVQTEL	MPVEVQTEL
TPLDEKSLALL	TPLDESLAL
LPFAKEIVSL	LPFAKIVSL
IPAASAAAM	IPAASAAAM
LPARDSPSL	LPARDSPSL
LPSFDAHLTEL	LPSF-DAHL
LDPVLQNPL	LDPVLQNPL
TANNVEIHI	TANNVEIHI
IPEPEAAVL	IPEPEAAVL
SPFPTSTPL	SPFPTSTPL
MPEYNAPAL	MPEYNAPAL
MPYGSRENSL	MPYGSENSL
LPDPQNISL	LPDPQNISL
MPEKLSHKL	MPEKLSHKL
LPEDEGHTRTL	LPEDETRTL
IPLEEGELEL	IPLEEELEL
LPSNDEPIL	LPSNDEPIL
MADPNIRFL	MADPNIRFL
APAPAEKTPV	APAPAEKTP
TPFNTREPVM	TPFNTEPVM
DASGPDPQL	DASGPDPQL
LPIEDRETIIM	LPIEDRETI
HAELTVPVL	HAELTVPVL
IPDQETTSL	IPDQETTSL
TPAPPTHAL	TPAPPTHAL
HAAASFETL	HAAASFETL
MPDGQFKDISL	MPDGQDISL
MPEEESAKV	MPEEESAKV
MPANGETVTL	MPANGTVTL
TPVPDSHKL	TPVPDSHKL
MPMNVADLI	MPMNVADLI
HPASAEFVL	HPASAEFVL
HPDPTRLLL	HPDPTRLLL
HAGEAIPAL	HAGEAIPAL
EPGPAEEL	EPGP-AEEL
TPQFPDMIL	TPQFPDMIL
VPAPNFAM	VPAP-NFAM
NPLHLDYVM	NPLHLDYVM
SAPYGRITL	SAPYGRITL
IPIFTDVAL	IPIFTDVAL
LPYGREDVL	LPYGREDVL
FPFHSAPAL	FPFHSAPAL
HPVVSSVPL	HPVVSSVPL
YPEPSTSTTM	YPEPSSTTM
HAVAEGAKNVL	VAEGAKNVL
LPAETMRI	LPAE-TMRI
FPNADSKAL	FPNADSKAL
FPNALVTKL	FPNALVTKL
MPQLDPRVL	MPQLDPRVL
DAYALNHTL	DAYALNHTL
IPSSVIHPAM	IPSSVIHPA
YPESGYSML	YPESGYSML
FPQLDSTSF	FPQLDSTSF
ISPTGHSL	ISPT-GHSL
FPIPAAEVDRL	IPAAEVDRL
MPTIQITAL	MPTIQITAL
YPENGVVQM	YPENGVVQM
TPVAGSQSL	TPVAGSQSL
HPLTQSAVM	HPLTQSAVM
EPIMDNNISL	EPIMDNISL
FPMEIRQYL	FPMEIRQYL
NPISTVTEL	NPISTVTEL
NAAPVDPTL	NAAPVDPTL
FPELGAAL	FPEL-GAAL
QPIPILYEHQL	IPILYEHQL
FPQDRVFML	FPQDRVFML
FPQDQLTAL	FPQDQLTAL
QPADAERAL	QPADAERAL
LPQEDLEAL	LPQEDLEAL
SPDGSDPKL	SPDGSDPKL
MPVFPDFKM	MPVFPDFKM
HPYILADRM	HPYILADRM
YPENIVPSF	YPENIVPSF
FPGPIFHL	FPGP-IFHL
SPNANEPPL	SPNANEPPL
MPIKDNAL	MPIK-DNAL
MPVPTTPEF	MPVPTTPEF
MPVSGPGLSL	MPVSGGLSL
HPISSEELL	HPISSEELL
LPVFDKEEL	LPVFDKEEL
FPAYERVLL	FPAYERVLL
FASHVSPEV	FASHVSPEV
FASEYPLIL	FASEYPLIL
QPTEVVNIL	QPTEVVNIL
PEKEPSVL	PEKE-PSVL
HPIDIETSV	HPIDIETSV
DASPVQAVF	DASPVQAVF
TPEEVIAKL	TPEEVIAKL
WPDDKVHKL	WPDDKVHKL
YPEDVSEEL	YPEDVSEEL
IPYMGDEVL	IPYMGDEVL
YPETLGRLLIL	YPETLGRLL
VPVDSAPVM	VPVDSAPVM
PNAIEHTL	PNAI-EHTL
YPNKYESVI	YPNKYESVI
LPIDESNTIHL	LPIDESNTI
LPHGSSYSL	LPHGSSYSL
APHAPGPPA	APHAPGPPA
YPFELEKDL	YPFELEKDL
HPESTPKSL	HPESTPKSL
MPDPLLTREL	MPDPLTREL
YPHQVPLVL	YPHQVPLVL
FPNENQVVF	FPNENQVVF
TKAVDAETAE	KAVDAETAE
TAAPVQETL	TAAPVQETL
FPIHLTDQL	FPIHLTDQL
YPGPAVVL	YPGP-AVVL
FPEVEDVVM	FPEVEDVVM
LPEKKGNTL	LPEKKGNTL
FPFSDKEKNKL	FPFSDKNKL
MPVPEILQL	MPVPEILQL
DSAPGILVL	DSAPGILVL
IPYSPDVQI	IPYSPDVQI
FPSGSVHSF	FPSGSVHSF
FPVREDVLNSL	FPVR-EDVL
FPSMPSPRL	FPSMPSPRL
HPDVLPFAL	HPDVLPFAL
PALHEGPPL	PALHEGPPL
IPIHADPRL	IPIHADPRL
LPTAVIANL	LPTAVIANL
YPDTDVIL	YPDT-DVIL
MPQGNPLLL	MPQGNPLLL
FPWGDGNHTL	FPWGDNHTL
HPSDIEVDL	HPSDIEVDL
SPVTQEPEL	SPVTQEPEL
FPIEDASNKL	FPIEDSNKL
MAVIDGNVM	MAVIDGNVM
YALEEHENQRL	LEEHENQRL
FPDDVPTSL	FPDDVPTSL
RPFEDQTSL	RPFEDQTSL
AAPATRAAL	AAPATRAAL
LPVGSSQVL	LPVGSSQVL
TPSPSADLL	TPSPSADLL
MPQDLSEAL	MPQDLSEAL
NAILVDTPL	NAILVDTPL
APVFRDYVF	APVFRDYVF
FPGPSKPF	FPGP-SKPF
FPEDHDPTI	FPEDHDPTI
MPLPGVGEEL	MPLPGGEEL
FPDELEEML	FPDELEEML
HPVSLEQYL	HPVSLEQYL
FPSFLTNSL	FPSFLTNSL
FPVSEAQVHL	FPVSEQVHL
YPEDVAEEL	YPEDVAEEL
IPVNEKETL	IPVNEKETL
FPQIEINKM	FPQIEINKM
MPGKTAIEL	MPGKTAIEL
FPDTSTPRPF	FPDTSTPRP
LPSQEVQAL	LPSQEVQAL
SPMDDGFVSL	SPMDDFVSL
FPTSTPREL	FPTSTPREL
TPMDLAVAL	TPMDLAVAL
MPVGMTHGL	MPVGMTHGL
MPDHTDVSL	MPDHTDVSL
LPSDMAVAL	LPSDMAVAL
FPNAIEHTLQW	FPNAIEHTL
YPVHAQMPSL	YPVHAMPSL
HPNALNLQL	HPNALNLQL
IPVEDNQM	IPVE-DNQM
SPTSPDYSL	SPTSPDYSL
FPLDKDELL	FPLDKDELL
APLEDEATL	APLEDEATL
MPEDSDTYL	MPEDSDTYL
MPDDLLTTL	MPDDLLTTL
TALQEVYTL	TALQEVYTL
MVTAVAYRL	MVTAVAYRL
MPYDSNRVVL	MPYDSRVVL
DPTAVGPVL	DPTAVGPVL
YPQDLPRPL	YPQDLPRPL
LPSSFVEKL	LPSSFVEKL
FPEHMANVEL	FPEHMNVEL
SPYPEAVEL	SPYPEAVEL
APYPHSNEL	APYPHSNEL
LANEVKVLL	LANEVKVLL
YAPKGSSL	YAPK-GSSL
FPSLEVKEL	FPSLEVKEL
TANNDHTVL	TANNDHTVL
HPIPGEYKF	HPIPGEYKF
FPSTPGPEL	FPSTPGPEL
VPAESAAVL	VPAESAAVL
MPSPVSPKL	MPSPVSPKL
LPIDGANDL	LPIDGANDL
FPTGDANSL	FPTGDANSL
MPLNVADLI	MPLNVADLI
YADPTKRLEL	YADPTRLEL
NATGPDLEF	NATGPDLEF
MPQKERESIM	MPQKERESI
EASPAPLVL	EASPAPLVL
MAHADPTEL	MAHADPTEL
YPAAVPQAL	YPAAVPQAL
MPQEEVELL	MPQEEVELL
LPASVHPQL	LPASVHPQL
SPNAEIHIL	SPNAEIHIL
HPTPQVDEL	HPTPQVDEL
MPAPADPTA	MPAPADPTA
YPEPLGERL	YPEPLGERL
FPAEPLEL	FPAE-PLEL
