Data	Data aligned
ATEVHPAKY	ATEVHPAKY
KLDDIVQHIY	KLDDVQHIY
QLTSENLQSK	LTSENLQSK
RSDSRAPVY	RSDSRAPVY
SSDKYGDTSY	SSDKGDTSY
VTDKFTESVY	VTDKTESVY
GADVNRVTY	GADVNRVTY
SSDKITTGY	SSDKITTGY
KLDPFLTPY	KLDPFLTPY
RSEKPNWDY	RSEKPNWDY
MTERQDLVY	MTERQDLVY
YAPSGNFV	YAPS-GNFV
LLLEGVENK	LLLEGVENK
GKFEDMAK	GKFE-DMAK
LTDADAMKY	LTDADAMKY
TEISEMNR	TEIS-EMNR
TADGKTYYY	TADGKTYYY
VVNISSMLGR	VVNISMLGR
LTVNDFVR	LTVN-DFVR
VDAGKLHY	VDAG-KLHY
RTDFQKDFAKY	RTDFKDFAK
RTDYSFHKFHY	RTDY-SFHK
KVDEYGAKDY	KVDEGAKDY
GIAPYSYAG	GIAPYSYAG
ATGYPLAF	ATGY-PLAF
RLDDVAVHYY	RLDDVAVHY
QEISQELLY	QEISQELLY
KMDDKALLV	KMDDKALLV
GSDGKLVLHY	GSDGLVLHY
QAESTALKY	QAESTALKY
RADKIPPSLY	RADKPPSLY
ITDHLDTQY	ITDHLDTQY
SLERLQLEY	SLERLQLEY
EGPEGFAR	EGPE-GFAR
HSDVAPTHILY	DVAPTHILY
EYVAELGTVP	YVAE-LGTV
FVMQEEFSR	FVMQEEFSR
RLDMYGEKY	RLDMYGEKY
DSYVGDEAQSK	VGDE-AQSK
RTDPALLRH	RTDPALLRH
RTERQQRDLAY	RTERRDLAY
DHNIIPGL	DHNI-IPGL
SLERSSKPLA	SLERSKPLA
RLAHEVGWKY	RLAHVGWKY
TVAHLQTVQHK	VAHLTVQHK
GTQVEQLLY	GTQVEQLLY
KTDLHNEGY	KTDLHNEGY
KLEKETTMY	KLEKETTMY
HLSERADWQY	LSERADWQY
SIYYITGESK	SIYYTGESK
KTDLNNLEM	KTDLNNLEM
SSDRTITEY	SSDRTITEY
KVDKEKWLY	KVDKEKWLY
TYDDATKTF	TYDDATKTF
LVLEGAGLR	LVLEGAGLR
RTFPFSLQY	RTFPFSLQY
ILQEGVDPK	ILQEGVDPK
KLDEQYQKY	KLDEQYQKY
ANTFVAELK	ANTFVAELK
GLDQPLLK	GLDQ-PLLK
RADQELMTY	RADQELMTY
ASQQPGHQDFY	SQQPHQDFY
STTTGHLIYK	STTTGHLIY
IMEKSTMLY	IMEKSTMLY
ADKVHLMY	ADKV-HLMY
SSQFLAPK	SSQF-LAPK
RTELFDLKTKY	RTEL-FDLK
LTDDKLSQY	LTDDKLSQY
KVDVEQVVMY	KVDVQVVMY
VGLQVVAVK	VGLQVVAVK
QLDSAQKNLY	QLDSQKNLY
KMMDSGQIDFY	MMDSQIDFY
TEKPEVID	TEKP-EVID
NLLSVAYK	NLLS-VAYK
VADLHLYLY	VADLHLYLY
TVDPASLWEY	TVDPSLWEY
DGIVSHLK	DGIV-SHLK
RTEPINTTYSY	RTEPINTTY
SLDALQTHY	SLDALQTHY
TAAYVNAIEK	TAAYNAIEK
TSDQQRQLY	TSDQQRQLY
ISDEASRY	ISDE-ASRY
RLDLAVQAY	RLDLAVQAY
KSDDNSYDEKY	KSDDSYDEK
KLPEFTKSEY	KLPETKSEY
KSDPSIVRL	KSDPSIVRL
LTDDDLLRY	LTDDDLLRY
LGIPLPEIK	LGIPLPEIK
ISEQTGKELLY	ISEQKELLY
QMETFMLHY	QMETFMLHY
VIDKESEVY	VIDKESEVY
LTEKANHYY	LTEKANHYY
KSARLDLLY	KSARLDLLY
KTDDSLEKY	KTDDSLEKY
QGIQFYTQLK	GIQFYTQLK
PMFIVNTNVPR	IVNT-NVPR
ASDRNIVLY	ASDRNIVLY
VTDKSMVDKY	VTDKMVDKY
ATEEAPYWTY	ATEEPYWTY
GSDRSSFSHY	GSDRSFSHY
NAVIIPHSGW	AVIIPHSGW
KTQEHGLFY	KTQEHGLFY
ATDLTREVY	ATDLTREVY
MSDSDKVGVFY	DSDKVGVFY
SSDRHLTQY	SSDRHLTQY
QGEIFLLPAR	QGEILLPAR
HSDTDALGY	HSDTDALGY
AINVNDSVTK	AINVDSVTK
KSETEKLLEY	KSETKLLEY
SGYLLPDTK	SGYLLPDTK
RNVSTGDVNVE	VSTGDVNVE
VTDPSTLEQY	VTDPTLEQY
QTALPGNDRY	QTALGNDRY
ASDNTGRYAY	ASDNGRYAY
AAYQVAALPK	AAYQAALPK
EITALAPSTMK	ITALPSTMK
ATDRWYDEY	ATDRWYDEY
TTDKKSLAY	TTDKKSLAY
ATDLLKRLY	ATDLLKRLY
ASEFPGAQHY	ASEFGAQHY
KTDEGIAY	KTDE-GIAY
KSDVETIFSKY	KSDVTIFSK
RSDSYVELSQY	RSDSYVELS
KMDVSKITRY	KMDVKITRY
HRPELIEYDK	RPELIEYDK
ITDSAGHILY	ITDSGHILY
LEDALQQAKED	LEDALQQAK
AVAALDGAK	AVAALDGAK
RVDKSAVGFDY	RVDKSAVGF
QSDYFRALY	QSDYFRALY
DKETYELRY	DKETYELRY
VLVAQHDAYK	VLVAQHDAY
KTFPYQHRY	KTFPYQHRY
DAHSTLLSK	DAHSTLLSK
IGDPLLEDTR	IGDPLEDTR
KTLGDFAAEY	KTLGFAAEY
LIIYDDLSK	LIIYDDLSK
GVDVTGPHLY	GVDVGPHLY
ATDMPVKNQY	ATDMVKNQY
VIPELNGK	VIPE-LNGK
IMGTSPLQIDR	GTSPLQIDR
YENEVALRQ	YENEVALRQ
IVDEFAMRY	IVDEFAMRY
VTDRSDARLQY	RSDA-RLQY
GIVNEQFLLQR	IVNEFLLQR
KSSDVYVSY	KSSDVYVSY
YSGLLLPDAQY	GLLLPDAQY
RLDPNFLLK	RLDPNFLLK
MLDSHEELY	MLDSHEELY
ELSEPSSTR	ELSEPSSTR
HTDIRSQLRY	HTDISQLRY
VSDRVTVLY	VSDRVTVLY
AEQRGENALKD	AEQRENALK
KVEKHYLFY	KVEKHYLFY
ATELQSMMY	ATELQSMMY
ISDHGTVTY	ISDHGTVTY
TVDEHVWFY	TVDEHVWFY
VLDIQNNLY	VLDIQNNLY
EADDIVNWLK	ADDIVNWLK
IAPTGHSL	IAPT-GHSL
RIDQASLDY	RIDQASLDY
ATEYKNEEY	ATEYKNEEY
VTDGAFFDY	VTDGAFFDY
KVDDLLESY	KVDDLLESY
VEIIANDQGNR	IIANDQGNR
RLYEHIKNDKY	LYEHKNDKY
RADGNFLLY	RADGNFLLY
KADFSTKDIY	KADFTKDIY
ADEGISFR	ADEG-ISFR
AIDHNQMFQY	AIDHQMFQY
GADRFYLGY	GADRFYLGY
HTDIDAAKVYM	HTDIAAKVY
LLVVYPWTQR	LLVVPWTQR
RLATHHYLY	RLATHHYLY
KTDIIDHSF	KTDIIDHSF
LVDRYNLYY	LVDRYNLYY
KLDEALAQY	KLDEALAQY
ASYPGASVDNY	SYPGSVDNY
AFAAGADIK	AFAAGADIK
VQQTVQDLFGR	QTVQDLFGR
KIDALQLEY	KIDALQLEY
RSAGVEQLMY	RSAGEQLMY
ITEKVKSMQY	ITEKKSMQY
ASSQDALMY	ASSQDALMY
ISDGKEYLFY	ISDGEYLFY
RIEGATLLY	RIEGATLLY
ATETQPIVY	ATETQPIVY
ISDSSGVMVY	ISDSGVMVY
VLENAEGAR	VLENAEGAR
MGDAPDYDR	MGDAPDYDR
KLDEKEQALYY	KLDEEQALY
RTDKSFPNAY	RTDKFPNAY
MSDHRPAMGY	MSDHPAMGY
ITDIQIPLDY	ITDIIPLDY
KLEKDLDRY	KLEKDLDRY
TTDKRTSFY	TTDKRTSFY
RSDSLYPAPGY	RSDS---LY
KVDEEQMKY	KVDEEQMKY
KSDPFLELY	KSDPFLELY
QTDKLKELY	QTDKLKELY
RTDRSGFPRY	RTDRGFPRY
VTEDGNQHVY	VTEDNQHVY
KADVILKY	KADV-ILKY
ALDKDAPLRY	ALDKAPLRY
VATVSLPR	VATV-SLPR
STVAQLVK	STVA-QLVK
KSDVEAIFSKY	KSDVAIFSK
MADPGNPDLY	MADPNPDLY
FDAGELITQR	AGEL-ITQR
GTDGHVHLY	GTDGHVHLY
IADMGHLKY	IADMGHLKY
ITDKNSLAY	ITDKNSLAY
QVDPLSALKY	QVDPSALKY
RSEIQRLTY	RSEIQRLTY
VLKDSLRY	VLKD-SLRY
VLDGTIEY	VLDG-TIEY
RTEEGPTLSY	RTEEPTLSY
SSDVSHQEY	SSDVSHQEY
KTERGSYSSY	KTERSYSSY
AMDATKLEY	AMDATKLEY
HTDVGLLEY	HTDVGLLEY
LVDSKGFDEY	LVDSGFDEY
GTVYEDLRY	GTVYEDLRY
GPPPPPGKPQ	GPPP-PPGK
EDAANNYAR	EDAANNYAR
MGFPEAASSFR	GFPEASSFR
TSSSHTLTY	TSSSHTLTY
KAPAPRPSL	KAPAPRPSL
VGPETLGR	VGPE-TLGR
MVDPLLTKY	MVDPLLTKY
KTEQEALEYF	KTEQEALEY
IIAPPERK	IIAP-PERK
RLDIVRSLY	RLDIVRSLY
YVGSMVADVHR	GSMVADVHR
ASDAAMYY	ASDA-AMYY
KLEDGPKFLK	KLEDPKFLK
LSSLLSGALAG	LSSLLSGAL
AIAEELAPER	IAEELAPER
QTEKPTHYRY	QTEKTHYRY
NFEEVAFDEK	FEEVAFDEK
VMEKSFLEYY	VMEKSFLEY
KSDHSFFKI	KSDHSFFKI
KLDEEALLK	KLDEEALLK
RAKFKQLL	RAKF-KQLL
LTSQGAGTYWY	LTSQGAGTY
KIADRFLLY	KIADRFLLY
IVDEAIYY	IVDE-AIYY
QADNQRLKY	QADNQRLKY
HSDPRQTFLY	HSDPQTFLY
ITDSAGHILYS	ITDSGHILY
KSDVMMKY	KSDV-MMKY
RTEIIEDLAFY	IIED-LAFY
TVSVLNGGFR	VSVLNGGFR
KTDRLWHDKY	KTDRWHDKY
LGLTEAQTR	LGLTEAQTR
RTSLDIEEY	RTSLDIEEY
KADTLKERY	KADTLKERY
TITLYGKS	TITL-YGKS
EGGLLTLAGAK	GLLTLAGAK
RSDTPLIY	RSDT-PLIY
MTERQALSY	MTERQALSY
NLSIYDGPEQR	LSIYGPEQR
AVVTADLR	AVVT-ADLR
NVEIDPEIQ	NVEIDPEIQ
FEDENFILK	FEDENFILK
KADEPIADY	KADEPIADY
RLEERSSEFY	RLEESSEFY
SVDSQILYY	SVDSQILYY
RTENGGQVMY	RTENGQVMY
RTDHELGKY	RTDHELGKY
LTDRGVMSY	LTDRGVMSY
RTDSREAFEAY	RTDSAFEAY
STDLQDYTYY	STDLQDYTY
RVDHGLMLTY	RVDHLMLTY
KEADIHFLI	KEADIHFLI
AAPEGKRSL	AAPEGKRSL
KLDQLIEFY	KLDQLIEFY
RTDVHNVLV	RTDVHNVLV
KTWDQLEYY	KTWDQLEYY
SSEQTFMYY	SSEQTFMYY
QITLNDLPVGR	ITLNLPVGR
VSDRDRNLMVY	VSDRDRNLM
LTDKDTGVTRY	LTDKTGVTR
LTEPTGLLY	LTEPTGLLY
MSDSYLPSY	MSDSYLPSY
VVDKIDYY	VVDK-IDYY
HTEARELMY	HTEARELMY
KTDSEATNIYL	KTDSATNIY
KSEDKVIAVY	KSEDVIAVY
LLPLELEK	LLPL-ELEK
KIDENQLMY	KIDENQLMY
KLDEMTASY	KLDEMTASY
ITQIEHEVS	ITQIEHEVS
KSDVNAIIHY	KSDVAIIHY
VVDEHTGQY	VVDEHTGQY
RVDPIGPLSY	RVDPGPLSY
LVQAFQFTDK	LVQAQFTDK
EVEMDAVGK	EVEMDAVGK
RTIAQDYGVLK	IAQDYGVLK
GTDRTGFTFKY	GTDRGFTFK
RSDFNEIVY	RSDFNEIVY
IVDGHLQLSY	IVDGLQLSY
RIEDNSLLY	RIEDNSLLY
RVSNFKPGVY	RVSNKPGVY
SVDSNLLSDY	SVDSLLSDY
KSDDHPDVVY	KSDDPDVVY
RTEPFQDGY	RTEPFQDGY
AGDLGVDLTSK	AGDLVDLTS
TADHNLLLY	TADHNLLLY
NELESYAYSLK	ELESAYSLK
KADKVTQLY	KADKVTQLY
SDVVTAVR	SDVV-TAVR
KLDIWNIKY	KLDIWNIKY
LSDFESGLKY	LSDFSGLKY
ILDTYLGKY	ILDTYLGKY
KLDIDGYEY	KLDIDGYEY
VTAQVVGTERY	VTAQVGTER
TTDSSYGQNY	TTDSYGQNY
FSGGFGARDY	FSGGGARDY
ATEQAPLWAY	ATEQPLWAY
ITDIHIKY	ITDI-HIKY
RQDLPSPSDFY	DLPSPSDFY
KTDYFFLEV	KTDYFFLEV
KVASDTQFY	KVASDTQFY
TIEEVVGR	TIEE-VVGR
SSEHQTQLY	SSEHQTQLY
TLDPQTGLFY	TLDPTGLFY
RTDGKVFQFL	RTDGVFQFL
VTDPEKLNNY	VTDPKLNNY
ATDVAKGMHYL	ATDVKGMHY
AVDPQHNGY	AVDPQHNGY
ATDSYKVTHY	ATDSKVTHY
LAGQGELNR	LAGQGELNR
KVDKATRDLLY	KVDKRDLLY
RVDVFTNLGY	RVDVTNLGY
VTDSIRDEY	VTDSIRDEY
KIDRHMYHSLY	KIDRYHSLY
KTEALRLQY	KTEALRLQY
KLDKDNLSY	KLDKDNLSY
EVTELLARY	EVTELLARY
KDLVTILFY	KDLVTILFY
VFADYEAYVK	FADYEAYVK
LSDPSGPKSY	LSDPGPKSY
ILDIPNQLY	ILDIPNQLY
STDPREALQY	STDPEALQY
FTERSKLIDHY	RSKL-IDHY
RIEPPDRRWQY	RIEP-PDRR
LLDQGQLNKY	LLDQQLNKY
LVDPWTPHLY	LVDPTPHLY
SLPGHSKPL	SLPGHSKPL
KVDLTNPQY	KVDLTNPQY
KLDIPTAAKY	KLDITAAKY
VHVIFNYK	VHVI-FNYK
SSDPASQLSY	SSDPSQLSY
ASEPRPFWGY	ASEPPFWGY
RMDTLAHVLY	RMDTAHVLY
EFEPLLNWMK	EFEPLNWMK
FNEKSKEL	FNEK-SKEL
SAEKTDSSYFY	KTDS-SYFY
GSDYINANY	GSDYINANY
RSEDSPDILTY	SEDSDILTY
KTDSTGTHSLY	KTDSTHSLY
KTAEAQLAY	KTAEAQLAY
RVDSAATSGY	RVDSATSGY
LSDLKHMRY	LSDLKHMRY
GSSSVRPGLY	SSSVRPGLY
IVDQSQQAY	IVDQSQQAY
KSDGSFIGY	KSDGSFIGY
EAESSPFVER	EAESPFVER
VLDNPSPFY	VLDNPSPFY
KIADMGHLKY	IADMGHLKY
KTDRDDKYFSY	KTDR-DDKY
HSEDYSKVPKY	SEDYKVPKY
VGPPGRSSL	VGPPGRSSL
RTDRAHPYY	RTDRAHPYY
RTELAIKLLEY	RTELKLLEY
LTDEGYEHFY	LTDEYEHFY
RSNPEDQILY	RSNPDQILY
RADKSTLSTY	RADKTLSTY
RTMVKTLEY	RTMVKTLEY
HTDPDYSAAY	HTDPYSAAY
VVDVPFGGAK	VVDVFGGAK
KSDALLSKDRY	KSDA-LLSK
RADENIDKY	RADENIDKY
VSDSKQFTYY	VSDSKQFTY
MSEDKPQDY	MSEDKPQDY
KSSTIYGTESY	STIYGTESY
HLQSGSESLLY	QSGSESLLY
YTDVSTRY	YTDV-STRY
RSDKPLLV	RSDK-PLLV
DTIGYPVMIR	TIGYPVMIR
MSEGLGMRY	MSEGLGMRY
KSDPFLEFF	KSDPFLEFF
LLADQAEAR	LLADQAEAR
RTSIWDETLY	RTSIDETLY
AIDEDVLRY	AIDEDVLRY
KIDEPSTPY	KIDEPSTPY
QTESQQIRY	QTESQQIRY
KTDLDLQQY	KTDLDLQQY
FVAVTSTNAAK	AVTSTNAAK
HLLIGVSSDR	LLIGVSSDR
AVDAARLHY	AVDAARLHY
IIDNIKGTEY	IIDNKGTEY
LTDDHVQFLIY	LTDDHVQFL
IMDPDVITGY	IMDPVITGY
FTDKKTHLY	FTDKKTHLY
KIDHYVLEY	KIDHYVLEY
KTELERAFGYY	KTELRAFGY
PEFAKLLY	PEFA-KLLY
RTAADNFSTQY	AADNFSTQY
KSDLRPMLY	KSDLRPMLY
ITDKELLK	ITDK-ELLK
PLRQPLLK	PLRQ-PLLK
KSDHTDVLYY	KSDHDVLYY
TVDARVYSY	TVDARVYSY
RSESSPEAY	RSESSPEAY
HSELLEDYY	HSELLEDYY
RVDQSLLLY	RVDQSLLLY
ITDHGSLIY	ITDHGSLIY
KLDTDLKNY	KLDTDLKNY
LSEVVGSGK	LSEVVGSGK
LEGLKGGHTY	LEGLGGHTY
KTDVHSPLKY	KTDVSPLKY
ISPRDFIDLVY	RDFI-DLVY
STESMDFLKY	STESDFLKY
SSDVGHDEY	SSDVGHDEY
MTDPIRILV	MTDPIRILV
EVFPLKVFGY	VFPLKVFGY
VTESPAKFALY	VTESKFALY
VVEQLKDWLY	VVEQKDWLY
RVDENNPEY	RVDENNPEY
RIEEDNLTY	RIEEDNLTY
RVDPAKGLFY	RVDPKGLFY
KTQEPDNLLFY	KTQEDNLLF
HLDQSQKSLY	HLDQQKSLY
ATDVAKGMHY	ATDVKGMHY
DPSVLGKY	DPSV-LGKY
FVHDNYVIRR	VHDNYVIRR
HMNGYGSHTFK	NGYGSHTFK
IEANEALVK	IEANEALVK
ITQSNAILR	ITQSNAILR
KVDELYEAY	KVDELYEAY
KSETGALGENY	KSETLGENY
GSDITSITERY	GSDISITER
AVDSLVPIGR	AVDSVPIGR
IIEKETKEY	IIEKETKEY
AIDQLHLEY	AIDQLHLEY
KSEFLGFTSY	KSEFGFTSY
RLEPNLQAQMY	RLEPQAQMY
HQGVMVGMGQK	GVMVGMGQK
RTDYNASVSV	RTDYASVSV
STDHIPILY	STDHIPILY
RLDHWIHSY	RLDHWIHSY
KSDHSFFKISY	KSDH-SFFK
QFADIAYNYR	FADI-AYNY
ASDPFFRHY	ASDPFFRHY
GESPVDYDGGR	ESPVYDGGR
GTDDGRLLEY	GTDDRLLEY
RTEEALQLY	RTEEALQLY
GGEIQPVSVK	GGEIPVSVK
ALDGGFQMHY	ALDGFQMHY
STEQFQEYY	STEQFQEYY
KMDVPSKY	KMDV-PSKY
QSDPWQQELY	QSDPQQELY
EGLYITEEIYK	GLYITEEIY
RTEEVKHVDFY	RTEEHVDFY
ITERSVLNLY	ITERVLNLY
RVDDIFSDLYY	RVDDFSDLY
FVDLYGAQK	FVDLYGAQK
KTETPAQSFGY	KTETQSFGY
ASDPYVKLSLY	ASDPVKLSL
RSDPSIMNW	RSDPSIMNW
VTEFEDIKSGY	EFEDIKSGY
IVDHIHFQY	IVDHIHFQY
DSTLIMQLLR	STLIMQLLR
STDKFKTDFY	STDKKTDFY
VMLGAETEEK	MLGAETEEK
VIDQQNGLY	VIDQQNGLY
RADPKTVGY	RADPKTVGY
RSMGGTLDLY	RSMGTLDLY
IVDRFTSKY	IVDRFTSKY
RSDPGTSGEAY	RSDPSGEAY
LITPAVVSER	ITPAVVSER
KTAGLSDLY	KTAGLSDLY
FSDVNMQEY	FSDVNMQEY
KSELSHYTFY	KSELHYTFY
STDWHVVNY	STDWHVVNY
RVQDSNLEY	RVQDSNLEY
RVTLELGGK	RVTLELGGK
HTETKTITY	HTETKTITY
KSDESLEKY	KSDESLEKY
ISDGKMQLY	ISDGKMQLY
KTFLEYLEY	KTFLEYLEY
ATDYHFHFY	ATDYHFHFY
KADIPLVVLY	KADILVVLY
RMDENSPLMY	RMDESPLMY
TIAPALVSK	TIAPALVSK
RVETEYSFLDY	ETEYSFLDY
HTGDGMGSLIY	TGDGGSLIY
FGAYGGLLK	FGAYGGLLK
RSEDFDIYTLY	RSED-FDIY
NHGVVMPDANK	VVMP-DANK
ADMGHLKY	ADMG-HLKY
SVDPTQTEY	SVDPTQTEY
QSDPTQSGMY	QSDPQSGMY
GSDEPAFMYY	GSDEAFMYY
ATDGRVYVV	ATDGRVYVV
VLDVETGNEY	VLDVTGNEY
LGADFIGR	LGAD-FIGR
KSDLFFHDY	KSDLFFHDY
GTDDGKVGLY	GTDDKVGLY
TTDLFGRDLSY	TTDLRDLSY
ISDHIYGGIS	ISDHIYGGI
RSDPGHYSF	RSDPGHYSF
SLVNLGGSK	SLVNLGGSK
VADHRFYRY	VADHRFYRY
RVDFTEALY	RVDFTEALY
KADIPAKY	KADI-PAKY
RVEPKVTVY	RVEPKVTVY
LLDPSQKNLY	LLDPQKNLY
RSDVEILGY	RSDVEILGY
RLEPPSSSHY	RLEPSSSHY
LIDDMVAQAMK	LIDDMVAQA
RTDSSHQAWY	RTDSHQAWY
SADSFQSFY	SADSFQSFY
KISEAGKDLLY	ISEAKDLLY
AIDRLVNIY	AIDRLVNIY
SIFSAVLDELK	FSAVLDELK
KVEKAPQETY	KVEKPQETY
AIDNPLHY	AIDN-PLHY
IMDPYKASY	IMDPYKASY
EIIGKRGIIGY	IIGKGIIGY
KADELFTEY	KADELFTEY
RTHLASDDLY	RTHLSDDLY
LSDLGLISY	LSDLGLISY
RSDHEFLFHY	RSDHFLFHY
KVDLSEKY	KVDL-SEKY
VLLPEYGGTK	LLPEYGGTK
GTDGQGGTFRY	GTDGGGTFR
SAELNKEVSTN	SAELNKEVS
IGLFGGAGVGK	GLFGAGVGK
KGDTPSLQEY	KGDTSLQEY
TAPTGHTL	TAPT-GHTL
IIALDGDTK	IIALDGDTK
AGFAGDDAPR	AGFADDAPR
ITDAYLDQY	ITDAYLDQY
VSDPVGVLY	VSDPVGVLY
ITDVDNGYY	ITDVDNGYY
KLDRSVFTAY	KLDRVFTAY
RSDEFRPQNY	RSDERPQNY
KSEMQRHYVMY	KSEM-QRHY
GTDMEPSLY	GTDMEPSLY
STTTGHLIY	STTTGHLIY
HSEYHTLLY	HSEYHTLLY
GSDEQLGKLVY	GSDE-QLGK
KTENEKVLTGY	KTENVLTGY
LSDAKKRELY	LSDAKRELY
IVDKNGRLVY	IVDKGRLVY
AMEAVAAQGK	AMEAAAQGK
KLDKSRLERY	KLDKRLERY
VVDEIFNEY	VVDEIFNEY
SLGQWLQEEK	SLGQLQEEK
KAEAVALKY	KAEAVALKY
LVIITAGAR	LVIITAGAR
GDTNFYGK	GDTN-FYGK
LTEVDNYHFY	LTEVNYHFY
NLSTFAVDGK	LSTFAVDGK
YNLGLDLR	YNLG-LDLR
ALDTKIGRY	ALDTKIGRY
IINTFHQY	IINT-FHQY
KSEATQEQY	KSEATQEQY
ASETGFLTY	ASETGFLTY
KLAGDHIEY	KLAGDHIEY
KTEPDNAQEY	KTEPNAQEY
LTDFIQKY	LTDF-IQKY
HTDDPLTWDY	HTDDLTWDY
YEDIAQKS	YEDI-AQKS
SVGEVMAIGR	VGEVMAIGR
ATSKVALVY	ATSKVALVY
YAPSGNYV	YAPS-GNYV
ETVWRLEEF	ETVWRLEEF
LTDEQLLY	LTDE-QLLY
GGIMLPEK	GGIM-LPEK
QSDPKTSLY	QSDPKTSLY
KTDTHLKEY	KTDTHLKEY
RVEGMTELY	RVEGMTELY
KTVGEPGWLY	KTVGPGWLY
KTDDLGSLRL	KTDDLGSLR
DTNADKQL	DTNA-DKQL
ATVFRTVLDYY	ATVFTVLDY
YGVSGYPTLK	GVSGYPTLK
KTEETLRFLY	KTEELRFLY
RLDAVTLLY	RLDAVTLLY
TDGHVHLY	TDGH-VHLY
KSDSGKPYYY	KSDSKPYYY
RSMDSYLNQSY	SMDSLNQSY
RLDPGESKSY	RLDPESKSY
RSDIEDEQLAY	RSDIEQLAY
ILDEVIMGY	ILDEVIMGY
VGEVIVTK	VGEV-IVTK
LLSYVLTVG	LLSYVLTVG
SSDGAISLLTY	SSDGAISLL
ISNAQDHLLY	ISNADHLLY
VVDIQGVGDLY	VVDIVGDLY
GTDELRLLY	GTDELRLLY
ATDWGDTQAY	ATDWDTQAY
KSDTGKPYYY	KSDTKPYYY
RLDEVISKY	RLDEVISKY
KTEVNSGFFY	KTEVSGFFY
HTDILKEKY	HTDILKEKY
YYAGWADK	YYAG-WADK
AELHLVHWNPK	ELHLHWNPK
KTERLEVSY	KTERLEVSY
RADGNFLLYA	RADGNFLLY
KTDEIVALK	KTDEIVALK
RASLSDRTNLY	LSDR-TNLY
RLAQEGIYTLY	LAQEIYTLY
TSERTVLRY	TSERTVLRY
AADSYTDSY	AADSYTDSY
GSLLLTAIDRY	LLLTAIDRY
IVEAEAMNY	IVEAEAMNY
WYVAPGVTR	WYVAPGVTR
HSDTIQWLY	HSDTIQWLY
KTEEAIIYSY	KTEEIIYSY
ATEMTLQRY	ATEMTLQRY
KSSQEEVRSY	KSSQEVRSY
MEAEATALLSD	EAEATALLS
RVDSWTPFY	RVDSWTPFY
KVDENQKAYY	KVDEQKAYY
VLDLSENQLQK	LSEN-QLQK
AVDPRFLAY	AVDPRFLAY
KTQSAMLRY	KTQSAMLRY
HSDIFPARHY	HSDIPARHY
GTATKHLTY	GTATKHLTY
KTDHFIFTY	KTDHFIFTY
ASDIAKHVY	ASDIAKHVY
TVTEKPEVID	VTEKPEVID
LDTNADKQLS	DTNADKQLS
KTETEPVFWYY	ETEPVFWYY
YFAERVTSL	YFAERVTSL
KTEPSIAEY	KTEPSIAEY
MTEKQLNLY	MTEKQLNLY
GGLPERSVSL	GLPERSVSL
KSESSHKGFHY	KSESKGFHY
LLDEPFLQ	LLDE-PFLQ
RTHLYGSLLY	RTHLGSLLY
ALETLGFLNHY	ETLGFLNHY
GFLPPASEK	GFLPPASEK
KTELQFSDY	KTELQFSDY
VTEITDDLHFY	ITDD-LHFY
VADVHQYFY	VADVHQYFY
AIINYVSKV	AIINYVSKV
RSESTENQSY	RSESENQSY
KVDYNRLGY	KVDYNRLGY
RSDGAGPLY	RSDGAGPLY
STQKQVLNY	STQKQVLNY
AKNKLNDLED	KNKLNDLED
ASDSIVLFY	ASDSIVLFY
ASDSMDSLY	ASDSMDSLY
KMDPTDAKY	KMDPTDAKY
SSPQPGSAL	SSPQPGSAL
KSDLHEVKQEY	KSDL-HEVK
VTELHVISY	VTELHVISY
VTVAGLAGK	VTVAGLAGK
QGEYIAPEK	QGEYIAPEK
KADKLDFEY	KADKLDFEY
RTEPEQGTLY	RTEPQGTLY
VSDPSSPQY	VSDPSSPQY
HSDELTSLLGY	HSDELTSLL
LTPEEEEILNK	LTPEEEEIL
YVDPQFLTY	YVDPQFLTY
PEAGLLLY	PEAG-LLLY
SADTLWGIQK	SADTWGIQK
LRDADPILR	LRDADPILR
IRYESLTDPSK	RYESTDPSK
KLDPHNHVLY	KLDPNHVLY
RLDVLVNNAY	RLDVVNNAY
QGTIVLATVK	GTIVLATVK
HLDLGILYY	HLDLGILYY
RMDPLTKPMQY	RMDPKPMQY
DYSVTANSK	DYSVTANSK
KVEPFLPGHY	KVEPLPGHY
FTDPRAYLKY	FTDPAYLKY
RGDKVDILY	RGDKVDILY
RVDGNDVFAVY	RVDGVFAVY
HFDETVNR	HFDE-TVNR
SAPKGSVL	SAPK-GSVL
ASDALDKIRY	ASDADKIRY
SAPASQASL	SAPASQASL
AVDSKVASY	AVDSKVASY
RLEETARALY	RLEEARALY
SLDLDVNV	SLDL-DVNV
ILQTDVPEEK	QTDV-PEEK
KTEVPGSVTEY	KTEVSVTEY
MTVSSDQMAK	MTVSDQMAK
QHGIPIPVTPK	GIPIPVTPK
RVDPVGPLSF	RVDPGPLSF
TVGPPPDTY	TVGPPPDTY
VTEKIPVRHLY	KIPV-RHLY
GSEYLKLGY	GSEYLKLGY
IIDRHVSRY	IIDRHVSRY
SIPGGYNAL	SIPGGYNAL
KMDEIGNHY	KMDEIGNHY
QTEASALLY	QTEASALLY
KLDGKNVKAFY	KLDG-KNVK
KSNPHRDFY	KSNPHRDFY
KLDVTSVEDY	KLDVSVEDY
LTHSLVLHY	LTHSLVLHY
RSDFFTSFY	RSDFFTSFY
ISDSYFPRY	ISDSYFPRY
NQAPPGLYTK	QAPPGLYTK
VTDSGPTFNYL	VTDSPTFNY
HSDPSILGY	HSDPSILGY
RIEKQFLLY	RIEKQFLLY
RLEIEPEWAY	RLEIPEWAY
KTDQFPLFL	KTDQFPLFL
KSELKDFFQSY	KSELFFQSY
ILVDYDEK	ILVD-YDEK
KVDDDFTAQDY	VDDDTAQDY
STDKQMGY	STDK-QMGY
FSDKLHSKY	FSDKLHSKY
IAQAESLRY	IAQAESLRY
FNASQLITQR	ASQL-ITQR
VADMALHY	VADM-ALHY
LSDPAGAIIY	LSDPGAIIY
KIAQDLEMY	KIAQDLEMY
RIDLIPSLY	RIDLIPSLY
KTLLRTWSELY	TLLRWSELY
VISSIEQK	VISS-IEQK
ITDDLHFYV	ITDDLHFYV
FGGETDEATR	GGETDEATR
STDKAEYTFY	STDKEYTFY
DLTDYLMK	DLTD-YLMK
QTVAVGVIK	QTVAVGVIK
WTTTQYTEAK	TTTQYTEAK
KTGQPMINLY	KTGQMINLY
MSDVNLKY	MSDV-NLKY
GLDKAGSTALY	GLDKSTALY
IMDSTEAQLRY	STEA-QLRY
EFAEEQLRA	EFAEEQLRA
IDIIPNPQER	DIIPNPQER
ATEVDSRWQEY	EVDSRWQEY
DTPGFIVNR	DTPGFIVNR
ATEDPWKTNY	ATEDWKTNY
TDRSDARLQY	RSDA-RLQY
RTLKEILRY	RTLKEILRY
VVDEDHELIY	VVDEHELIY
LTDRLASLY	LTDRLASLY
RIDKPILK	RIDK-PILK
RAEGYPVDLYY	RAEGPVDLY
LLDTPVKTQY	LLDTVKTQY
KIEPPDTGLYY	KIEPDTGLY
LNLQEYQSK	LNLQEYQSK
GSDFYSMHY	GSDFYSMHY
VTIEYYSQLK	TIEYYSQLK
IIAVDINK	IIAV-DINK
ISPSRTEAL	ISPSRTEAL
VVPEPGQPL	VVPEPGQPL
AIYGVDTR	AIYG-VDTR
RTDELVREY	RTDELVREY
LITLEEEMTK	ITLEEEMTK
KIDSFNSLY	KIDSFNSLY
LDTNADKQL	LDTNADKQL
RTEYTITMY	RTEYTITMY
QADIARMLY	QADIARMLY
KMMNGGHYTY	KMMNGHYTY
AQYEEIANR	AQYEEIANR
ENAGEDPGLAR	AGEDPGLAR
IVEMSTSK	IVEM-STSK
IEGIQNMPNVR	GIQNMPNVR
MNPQSAFFQGK	QSAF-FQGK
ISPTGHSL	ISPT-GHSL
KLDELKLKY	KLDELKLKY
KLDEKEQALY	KLDEEQALY
QTDNIIYVY	QTDNIIYVY
SWGSGLDMHTK	GSGLDMHTK
LSDREHPLY	LSDREHPLY
KLDSKELGKY	KLDSKELGK
HSDPESDFY	HSDPESDFY
TDKSMVDKY	TDKSMVDKY
RTTAHALKY	RTTAHALKY
TTDDWKDFLY	TTDDKDFLY
RVDGSKPIWKY	RVDGKPIWK
RSAGLAFSLY	RSAGAFSLY
AGVYNLTK	AGVY-NLTK
ISERNQDATVY	ISERDATVY
KTDLPQSVVY	KTDLQSVVY
LLQDFFNGK	LLQDFFNGK
HSDIAQRY	HSDI-AQRY
LTDEQIRFLY	LTDEIRFLY
ATNPESKVFY	ATNPSKVFY
DAGMQLQGYR	DAGMQLQGY
KSSAISLHY	KSSAISLHY
IIHEIAVLEL	IHEIAVLEL
LTDARRSEDY	LTDARSEDY
ISESIKELQFY	ISESKELQF
RTETNGGQVTY	RTETGQVTY
LVDGYNVHY	LVDGYNVHY
STETHEELLY	STETEELLY
GLDSANEKGLY	DSANEKGLY
TAVAPIER	TAVA-PIER
RTERNVAVY	RTERNVAVY
IFGVTTLDIVR	GVTTLDIVR
RTHGVDHLSY	RTHGDHLSY
DISLSDYK	DISL-SDYK
LGGVAHTLQK	LGGVHTLQK
GSDAGWTLGY	GSDAWTLGY
RLDHKFDLMYA	RLDHFDLMY
SADPDNLKY	SADPDNLKY
GYSFTTTAER	YSFTTTAER
QTDHLFFKY	QTDHLFFKY
RVDSHSKILY	RVDSSKILY
VVAGYGDVGK	VVAGGDVGK
KSDVNKEYY	KSDVNKEYY
ALDSHILDY	ALDSHILDY
VLGVENLR	VLGV-ENLR
RMDNIYFEY	RMDNIYFEY
RLDQLEADYY	RLDQEADYY
RADDADEFGY	RADDDEFGY
LFAEAVQK	LFAE-AVQK
KLDGTGYGDY	KLDGGYGDY
RVDQSAVGFEY	RVDQVGFEY
KLEDTENWLY	KLEDENWLY
IVDSATALY	IVDSATALY
AMDVYKNLY	AMDVYKNLY
PILTELKN	PILT-ELKN
SADVPLVVEY	SADVLVVEY
LTDPEAAKY	LTDPEAAKY
KSENPAKRLY	KSENAKRLY
VLDEAFQRY	VLDEAFQRY
SSAKTILKY	SSAKTILKY
HLDSDQKLLY	HLDSQKLLY
KSDPIMLLK	KSDPIMLLK
TSYAQHQQVR	TSYAHQQVR
RTSINVVR	RTSI-NVVR
KMDDLNLHY	KMDDLNLHY
KQDVLLLYY	KQDVLLLYY
ITPTGTHPL	ITPTGTHPL
VTDQNKIVTY	VTDQKIVTY
IGGIGTVPVGR	GIGTVPVGR
KAPSAARSL	KAPSAARSL
KSELGLNFY	KSELGLNFY
IADSNYNWFY	IADSYNWFY
LLDDAQRLLY	LLDDQRLLY
GRNDLMEYAK	RNDLMEYAK
HSDVTEAMLY	HSDVEAMLY
RTEAAFSYY	RTEAAFSYY
ALDAAVLAY	ALDAAVLAY
DPTSGQLY	DPTS-GQLY
HTEENSHFEY	HTEESHFEY
FVHDNYVIR	FVHDNYVIR
SSSKGSLGGGF	SSSKGSLGG
LDQVLKEAK	LDQVLKEAK
FHHTFSTEIAK	HTFSTEIAK
RSSLGGRDLY	RSSLGRDLY
ITDIVNKY	ITDI-VNKY
RLDSPLSNRY	RLDSLSNRY
VLDPYLLKY	VLDPYLLKY
ITSEAPFLHY	TSEAPFLHY
KVEAKFINY	KVEAKFINY
KSDLFQEDLY	KSDLQEDLY
ITDEQRQYY	ITDEQRQYY
RMDSTNADALY	RMDSNADAL
HTDHHMFFDY	HTDHMFFDY
LSDLGRLSY	LSDLGRLSY
LTDNGRHITY	LTDNRHITY
RVDELLEKY	RVDELLEKY
IVNAAGFWAR	IVNAGFWAR
HSAVNMNLHY	HSAVMNLHY
YAPKGSSL	YAPK-GSSL
RTESELNSYNY	RTESELNSY
LSEPEEAAALY	LSEPAAALY
KSELLVEQY	KSELLVEQY
VETTEDLVAK	TTED-LVAK
SADQVALVY	SADQVALVY
VVDGFNVLY	VVDGFNVLY
LYFEELSLER	YFEELSLER
GSDRFGRDLNY	GSDRRDLNY
TVDRVVLLY	TVDRVVLLY
MSMVANLLY	MSMVANLLY
KVDQNRVRY	KVDQNRVRY
VTDGAILGKLY	VTDGAILGK
KTLLDQHGQY	KTLLQHGQY
SLHTLFGDK	SLHTLFGDK
ITDVSWRLEY	ITDVWRLEY
NAPLVHATL	NAPLVHATL
IVDGDVVHGFY	DGDVVHGFY
RLDFNPDRY	RLDFNPDRY
KTDMVEKALLY	KTDMKALLY
TTDFIYQLY	TTDFIYQLY
RTEDNLQIY	RTEDNLQIY
RSAEEAPLY	RSAEEAPLY
MSDSYLPSYY	MSDSLPSYY
VLNTNIDGR	VLNTNIDGR
NTDFYQTSY	NTDFYQTSY
GTDLSIFKY	GTDLSIFKY
KTEEYVLDFY	KTEEVLDFY
KQDSNPLYK	KQDSNPLYK
STDPSVLGKY	STDPVLGKY
LYSEFLGK	LYSE-FLGK
STELNHLGY	STELNHLGY
RADITDVMDAY	ITDV-MDAY
RLDTPLYFSY	RLDTLYFSY
ASEAEMRLFY	ASEAMRLFY
LTEITKGWLY	LTEIKGWLY
YTDKIDRY	YTDK-IDRY
GTDSASGMDY	GTDSSGMDY
RTDVAVLRY	RTDVAVLRY
YYTLEEIQK	YYTLEEIQK
ALDSHILDYY	ALDSHILDY
TEAELLQLEK	EAELLQLEK
AATGATPIAGR	ATGAPIAGR
RTEESSAVQY	RTEESAVQY
MDSTEPPYSQK	STEPPYSQK
KTEESSELGNY	KTEEELGNY
HIDSANALY	HIDSANALY
RTDHPALY	RTDH-PALY
FLQPGSQR	FLQP-GSQR
RSDLQSLGY	RSDLQSLGY
HTMSSSHLFY	HTMSSHLFY
RTTSHLLRY	RTTSHLLRY
ATEKEKVWY	ATEKEKVWY
VLLLEAGPK	VLLLEAGPK
LNPNFLVDFGK	LVDF---GK
KLDLLEQEY	KLDLLEQEY
RVDHSMMLKY	RVDHMMLKY
ATEESDLAQQY	ESDL-AQQY
LLLPGELAK	LLLPGELAK
HLDHAQKTLY	HLDHQKTLY
RTAQNLHNSY	RTAQLHNSY
KTSARDAALAY	TSARAALAY
RFQLVDSR	RFQL-VDSR
GIGTVPVGR	GIGTVPVGR
VSEGTKAVTKY	VSEGKAVTK
QTDRANRFEY	QTDRNRFEY
KIDSIEDRY	KIDSIEDRY
TAGAQVLLR	TAGAQVLLR
RLDAPVDYFY	RLDAVDYFY
TSDKPGSPY	TSDKPGSPY
KTERSDLEY	KTERSDLEY
ITDLPDHLLSY	ITDLHLLSY
SSDTADFRDLY	DTADFRDLY
KMDIAVSY	KMDI-AVSY
ESYSVYVYK	ESYSVYVYK
RSTVAQLVK	RSTVAQLVK
RSAKASLVY	RSAKASLVY
TTSHLMGMFY	TTSHMGMFY
ISSSPTHSLY	ISSSTHSLY
TTDNANIL	TTDN-ANIL
VIDPVAPRY	VIDPVAPRY
RADGITGLY	RADGITGLY
RTFGMAEEY	RTFGMAEEY
KTELQFSDYY	KTELQFSDY
MSDPYMPSYY	MSDPMPSYY
KLDPLRGHY	KLDPLRGHY
RSEKMTLSY	RSEKMTLSY
LIINSLYK	LIIN-SLYK
NLNHVSYGR	NLNHVSYGR
SSDANPVRY	SSDANPVRY
GSDVVDWLY	GSDVVDWLY
RADKSAVGFDY	RADKSAVGF
RVDASSMWLY	RVDASMWLY
HTDIDAAKVY	HTDIAAKVY
RADNSVFGLY	RADNVFGLY
RTAQEVETY	RTAQEVETY
YADPYRQLQY	YADPRQLQY
TMDNPTTTQY	TMDNTTTQY
ISDHSSVKQEY	ISDHVKQEY
NYTDNELEK	NYTDNELEK
EFNAEVHRK	EFNAEVHRK
STDVSQPPHVY	STDVPPHVY
QLDRISVYY	QLDRISVYY
ALDVVNLVY	ALDVVNLVY
ISYGPDWKDFY	YGPDWKDFY
SIPEKNRPL	SIPEKNRPL
FSDIHDFEY	FSDIHDFEY
ATQERTDLY	ATQERTDLY
VSERDVYLTY	VSERVYLTY
MTHNLLLNY	MTHNLLLNY
VSDTVVEPY	VSDTVVEPY
GTEFGGSIY	GTEFGGSIY
VSDKTLSFY	VSDKTLSFY
KTDNRVSGKYF	KTDNVSGKY
QTEDNMLFY	QTEDNMLFY
NTDSPLRY	NTDS-PLRY
QTVAWFPLYY	QTVAFPLYY
RMDKSAVGHEY	KSAV-GHEY
LSDSGVTQRY	LSDSVTQRY
IIDHHDNTY	IIDHHDNTY
RSEWTDELNTY	WTDE-LNTY
RTEPINTTY	RTEPINTTY
HLDIEAFTMDR	HLDIEAFTM
VNMVPFPR	VNMV-PFPR
YTDSYTDTY	YTDSYTDTY
LTGLTVAEYFR	LTGLTVAEY
RSFAGNLNTY	RSFANLNTY
KSDPFLVFY	KSDPFLVFY
KIDPKILAY	KIDPKILAY
LSDIASALRY	LSDISALRY
RVEIQNLTY	RVEIQNLTY
DISTNYYASQK	STNYYASQK
ITSPTTLYDRY	ITSP-TTLY
KSSIDLYFY	KSSIDLYFY
RTEELALSHY	RTEEALSHY
KTEAAKGTLTY	KTEAGTLTY
RTDPLENNY	RTDPLENNY
PISQGGIHGR	ISQGGIHGR
ASEPSAQLSY	ASEPAQLSY
KLDEDLHVKY	KLDELHVKY
ISEELVQKY	ISEELVQKY
LEVGTETIIDK	GTET-IIDK
AIDSLSIEK	AIDSLSIEK
TNADTDGMVK	NADTDGMVK
KTDLLLEPY	KTDLLLEPY
SLDPENPTK	SLDPENPTK
RVEEINPEY	RVEEINPEY
RSDSEIIGY	RSDSEIIGY
IIEAQYLRY	IIEAQYLRY
HSEFTTLLY	HSEFTTLLY
KIEEGHIGVYY	KIEEHIGVY
RIDPFVRTFLK	RIDPVRTFL
TSDKFRETS	TSDKFRETS
MAPERVASL	MAPERVASL
KVDNEILDY	KVDNEILDY
ASDHPIASY	ASDHPIASY
KSEPAVVSLEY	KSEPVSLEY
ITAHLVHELRR	ITAHVHELR
HSDQQVFEY	HSDQQVFEY
VIDSAELQAY	VIDSELQAY
NSGKEEGFELY	KEEG-FELY
RVEKHLLVY	RVEKHLLVY
KSDSGKPYY	KSDSGKPYY
EGASILLDGR	GASILLDGR
ATTKVGPNATY	KVGP-NATY
RTEDELSKY	RTEDELSKY
TLADAEGDVFR	LADAGDVFR
RLDSLTTLY	RLDSLTTLY
TSDNGKDGLAY	TSDNDGLAY
KTEIAHSVLY	KTEIHSVLY
KSAPSDSLTY	KSAPDSLTY
RVDTQDQGMY	RVDTDQGMY
KTDVEGTLFVY	KTDVGTLFV
GHQQLYWSHPR	GHQQ---LY
KTDLLEEKV	KTDLLEEKV
KLDPSPQTIY	KLDPPQTIY
KTEEMPQLNF	KTEEPQLNF
VYEGERPLTK	VYEGRPLTK
TTYKLVINGKT	TTYKVINGK
RIDGNLDY	RIDG-NLDY
QTYSTEPNNLK	STEP-NNLK
ITQGTPLKY	ITQGTPLKY
HLDDQMTLLQY	LDDQTLLQY
GSDDTELRY	GSDDTELRY
LTDHTVTFLQY	LTDHTFLQY
NVKVDPEIQ	NVKVDPEIQ
KSEFLNFFY	KSEFLNFFY
TTDVDSLSY	TTDVDSLSY
MSEKLGVMTY	MSEKGVMTY
IVLEDGTK	IVLE-DGTK
KTDGSFIGY	KTDGSFIGY
LFHPSNVEM	LFHPSNVEM
IVDSLTEMY	IVDSLTEMY
RVDGRMLHY	RVDGRMLHY
AIDHEKKAY	AIDHEKKAY
RSDPTSYAGY	RSDPSYAGY
HNFTPLAR	HNFT-PLAR
RSHYLMHNY	RSHYLMHNY
QLDVAGRVMQY	DVAGRVMQY
SLDAPHSTY	SLDAPHSTY
ASNPAMLLY	ASNPAMLLY
RAFDQGADAIY	AFDQADAIY
MGTSPLQIDR	GTSPLQIDR
KSENQVLGQY	KSENVLGQY
IIDNSQGFY	IIDNSQGFY
RTMQEIERY	RTMQEIERY
LFAYPDTHR	LFAYPDTHR
LTDNLKVGSFY	LTDNKVGSF
KTGKPMINLY	KTGKMINLY
ISDAPAPAY	ISDAPAPAY
RLDNGQVGLY	RLDNQVGLY
FIIPNVVK	FIIP-NVVK
DLLSPILY	DLLS-PILY
KLDPPGGQFY	KLDPGGQFY
AVDVNNMLHLY	AVDVNMLHL
LTDTFTAYY	LTDTFTAYY
TTEVHPELY	TTEVHPELY
KSFEGNVFMYY	KSFENVFMY
RVADFTEQY	RVADFTEQY
RADQELLMY	RADQELLMY
MSEGKAETY	MSEGKAETY
RSDELTRHY	RSDELTRHY
TVGVEPAADGK	GVEPAADGK
RLDPFADGFY	RLDPADGFY
KIEFYQDPLLY	KIEFDPLLY
ASLHVEEK	ASLH-VEEK
TIDIGVKY	TIDI-GVKY
FTDVNSILRY	FTDVSILRY
SAVLDELK	SAVL-DELK
GVDLTGPQLY	GVDLGPQLY
IGAEVYHNLK	GAEVYHNLK
TASPAVTPAAD	ASPATPAAD
SSSPTHSLY	SSSPTHSLY
VGVHFLPK	VGVH-FLPK
RSDRREDYY	RSDRREDYY
NMGLYGER	NMGL-YGER
LVSDSALYF	LVSDSALYF
KVADMALHY	KVADMALHY
RSDSTGSSSVY	RSDSSSSVY
KTSDKPLMY	KTSDKPLMY
RTDTGEITSY	RTDTEITSY
IDGKTLKY	IDGK-TLKY
RSDPNSESLY	RSDPSESLY
VIDEVRTGTY	VIDERTGTY
ALAPEYAK	ALAP-EYAK
KTDLHNEGYI	KTDLHNEGY
HTDLAIEY	HTDL-AIEY
RSDTEQEGKYY	RSDTQEGKY
LLEGEESR	LLEG-EESR
ALDRTSQNDAY	RTSQ-NDAY
KLDGTTPVRY	KLDGTPVRY
ISSSSFSR	ISSS-SFSR
EVVSHVIK	EVVS-HVIK
SLDGDLAGRYY	SLDGLAGRY
ASDMLQLEY	ASDMLQLEY
SSDDSKLEY	SSDDSKLEY
ASDKETYELRY	ASDKTYELR
RHYLFDVQR	RHYLFDVQR
KLADQIFAYY	LADQIFAYY
FQIGSPWR	FQIG-SPWR
RTDAILLGHY	RTDALLGHY
ISEKIKEPLYY	ISEKKEPLY
RTQTEELHY	RTQTEELHY
TLDTKPGLY	TLDTKPGLY
LSDLGKLSY	LSDLGKLSY
KTSRDFDRY	KTSRDFDRY
SRNDQVVTDLR	RNDQVTDLR
TKAVDAETAE	AVDA-ETAE
SSDNIMVQY	SSDNIMVQY
KIMDSGELDFY	IMDSELDFY
KMDPVAYRV	KMDPVAYRV
RLTDADAMK	RLTDADAMK
SAPVGVTAL	SAPVGVTAL
ATDYTFAMY	ATDYTFAMY
KIDQWLEQY	KIDQWLEQY
ASDKGNLPKY	ASDKNLPKY
RVDPAKGLFYF	RVDPKGLFY
RVETQNHWFTY	ETQNHWFTY
RTMSVSDFNY	RTMSSDFNY
RTEMGLYYSY	RTEMLYYSY
KVDNQAMLHY	KVDNAMLHY
WEVDSGRR	WEVD-SGRR
KIDSLQARY	KIDSLQARY
VSDSKQFTY	VSDSKQFTY
GSEPASLSY	GSEPASLSY
IIDLAGDTVRY	IIDLGDTVR
ASDRNIVLYDM	ASDRNIVLY
HTDSLHLLI	HTDSLHLLI
KSDQGWRRY	KSDQGWRRY
KSSPDMLYQY	KSSP-DMLY
ISDLAQHY	ISDL-AQHY
KTDEMHTAL	KTDEMHTAL
KTLPADVQNYY	KTLPDVQNY
GSDPVFRFY	GSDPVFRFY
SLDNSYKMDY	SLDNYKMDY
VVDLLAPYAK	VVDLAPYAK
VTDTGALYLY	VTDTALYLY
LLLQVQHASK	LLQVQHASK
YSKYYKTID	YSKYYKTID
TLSDYNIQK	TLSDYNIQK
LHVDPENFR	LHVDPENFR
HLDEAQRLLY	HLDEQRLLY
YFGIYDTAK	YFGIYDTAK
LVDDPLEY	LVDD-PLEY
NSTFSEIFK	NSTFSEIFK
IAVEQLAY	IAVE-QLAY
DHGSVPII	DHGS-VPII
RVDGRMLQY	RVDGRMLQY
HLDFNLDKTLY	HLDF-NLDK
VMDKMQLTY	VMDKMQLTY
QTETGTPYMLY	ETGTPYMLY
SMDAHPSRY	SMDAHPSRY
KSESFMQKY	KSESFMQKY
LSEVNRTGTQY	EVNRTGTQY
DYPLIPVGK	DYPLIPVGK
SSKASNSKQDY	KASNSKQDY
GTEIANTLY	GTEIANTLY
RTDGILALY	RTDGILALY
KSEMEMAHLY	KSEMMAHLY
LSEAFHEEY	LSEAFHEEY
VTLELGGK	VTLE-LGGK
REDIFYTSK	REDIFYTSK
RTIATALEY	RTIATALEY
LSDHSIRSF	LSDHSIRSF
KTSHYNILY	KTSHYNILY
RSDPNSESLYF	RSDPSESLY
LITLEQGK	LITL-EQGK
RSDGKSVDLKY	RSDGSVDLK
RSEFASGNTY	RSEFSGNTY
AMLSTGFK	AMLS-TGFK
ATDFDVLSY	ATDFDVLSY
TEVHPAKY	TEVH-PAKY
LTEQRALLY	LTEQRALLY
KTDYDTREY	KTDYDTREY
EYQELMNVK	EYQELMNVK
KVDSDDQWGEY	DSDDQWGEY
NAPWAVTSL	NAPWAVTSL
RTPDFHDKY	RTPDFHDKY
ALEAQTSRY	ALEAQTSRY
ASEDSVLLY	ASEDSVLLY
KTSILEQLLY	KTSIEQLLY
GSDRIKDGY	GSDRIKDGY
AVDFAERHGY	AVDFERHGY
EGGTVVYGGK	GTVV-YGGK
RLDKVLDEY	RLDKVLDEY
LVADFMAK	LVAD-FMAK
RSNILTLMY	RSNILTLMY
AMVASGSELGK	MVASSELGK
HSEAHTLLY	HSEAHTLLY
KTDGSFLVH	KTDGSFLVH
ILDQKASGVKY	ILDQASGVK
ATMYNLLAY	ATMYNLLAY
ATDLVVLDRY	ATDLVLDRY
KLDSSAQFGYY	KLDSAQFGY
TDTYKLILNGK	DTYKILNGK
KSGAHVDFY	KSGAHVDFY
VSSSDDKDAFY	SSDDKDAFY
KLDETGNSLK	KLDEGNSLK
KTDVTMLLY	KTDVTMLLY
SSDPQAQKY	SSDPQAQKY
NTDPHSQEY	NTDPHSQEY
ITAHLVHELR	ITAHVHELR
KTDDLITRF	KTDDLITRF
KSVENQMRY	KSVENQMRY
KTDPGTVFVM	KTDPGTVFV
IIDYLTDHY	IIDYLTDHY
ALDQFQEKY	ALDQFQEKY
KSDVEINY	KSDV-EINY
LSDIGLEY	LSDI-GLEY
ATENKLRLHY	ATENLRLHY
KTDESLTKY	KTDESLTKY
LLDPKYGMFRY	LLDPYGMFR
HTDAVWGLAY	HTDAWGLAY
MIEPRTLQY	MIEPRTLQY
RSEEGRLYY	RSEEGRLYY
KTDDPQLK	KTDD-PQLK
RLDLQPDLY	RLDLQPDLY
KLDSLLLFY	KLDSLLLFY
KVDDYEHAAKY	KVDDEHAAK
RAEDAMRLYY	RAEDMRLYY
AVDPGLLGY	AVDPGLLGY
KTEDDKAYAY	KTEDKAYAY
LSDIGSGIRY	LSDISGIRY
GSAITGPVAK	GSAIGPVAK
STDPRPASY	STDPRPASY
RLDHKFDLMY	RLDHFDLMY
RTDGKVFQF	RTDGKVFQF
ITDTMKFFLY	ITDTKFFLY
YQVAALPK	YQVA-ALPK
STGDVNVE	STGD-VNVE
SMDAHPNRY	SMDAHPNRY
KTEMAVPGTLY	KTEMPGTLY
RMDTLAHVLYY	RMDTAHVLY
SSDPYHSGY	SSDPYHSGY
ITESNMKSRY	ITESMKSRY
AGLQFPVGR	AGLQFPVGR
KMDQIISKY	KMDQIISKY
KSGYRIDFY	KSGYRIDFY
LTDFIREEY	LTDFIREEY
KSEILDETDLY	ILDE-TDLY
VGVNGFGR	VGVN-GFGR
QILVGVNK	QILV-GVNK
KTDRVARYFEY	KTDR-VARY
ATDLAQHLY	ATDLAQHLY
QTDIQGALSAY	QTDIALSAY
STDVSDLLHQY	VSDL-LHQY
QNLIAEVSTK	LIAE-VSTK
RTPDLPEEEY	RTPDPEEEY
RLDLEDVKNMY	RLDL-EDVK
KTDSDSDLQLY	DSDSDLQLY
RSDPGGGGLAY	RSDPGGLAY
MSSRSWLSY	MSSRSWLSY
HSDPMFSSY	HSDPMFSSY
HSDLLEDSKY	HSDLEDSKY
ATDPVTGDLY	ATDPTGDLY
RIDTRNELESY	RIDTELESY
KTDREYQEY	KTDREYQEY
KTEDPDLPAFY	TEDPLPAFY
FFEEVNDPAK	FEEVNDPAK
MTDRVGKAFKY	MTDRGKAFK
RTFGHLLRY	RTFGHLLRY
KTHIDVIHY	KTHIDVIHY
EVGVYEALK	EVGVYEALK
KIDVPWAGQY	KIDVWAGQY
ITDQGIEFY	ITDQGIEFY
LLDSSQKNLY	LLDSQKNLY
SSDSVGGFRY	SSDSGGFRY
NEEILNSLK	NEEILNSLK
RLDEDLAAY	RLDEDLAAY
HVDEQVFLY	HVDEQVFLY
RSADEGQTVFY	SADEQTVFY
RSDQLLFDQY	RSDQLFDQY
RVDSPMAY	RVDS-PMAY
VSDRYRFLY	VSDRYRFLY
ISEAGKDLLY	ISEAKDLLY
LIDAANGAIR	LIDANGAIR
HADVSNQLY	HADVSNQLY
LADSFRHLY	LADSFRHLY
KTDVLRLVLY	KTDVRLVLY
KTDVVVNSV	KTDVVVNSV
KTDPVRLTQLY	KTDPLTQLY
QSDYYASYY	QSDYYASYY
RVASVMQEY	RVASVMQEY
QLAPIWDK	QLAP-IWDK
KVEQHVELY	KVEQHVELY
ASEASRLAHY	ASEARLAHY
RLDDKKFLY	RLDDKKFLY
ITDTTRDVY	ITDTTRDVY
YTDENQHQY	YTDENQHQY
RSSNVSYKY	RSSNVSYKY
LTDIHGNVLQY	LTDINVLQY
VSDKGNLMY	VSDKGNLMY
RLDSNNHLY	RLDSNNHLY
RAAASTDYY	RAAASTDYY
TIDKATGILLY	KATG-ILLY
KSIDLKDKY	KSIDLKDKY
RTAPRFGLYRY	RTAPRFGLY
DPHGFISY	DPHG-FISY
VSSSDVGHDEY	SSDVGHDEY
ASDAAPLQY	ASDAAPLQY
VIDTSLLY	VIDT-SLLY
TYDDATKTFTV	YDDAKTFTV
KTSMFPSLKY	KTSMPSLKY
RLEDPDGKVLY	LEDPGKVLY
RLEKLQLEY	RLEKLQLEY
RSDDGQIFAKY	RSDDQIFAK
RTAHVILRY	RTAHVILRY
RASAALLDKLY	ASAALDKLY
KTENTKFVLRY	KTENKFVLR
IMDDPAGNSY	IMDDAGNSY
KSDEMELLY	KSDEMELLY
GSDKINYTY	GSDKINYTY
EENLLDFVRF	EENLLDFVR
MSQNFHTSY	MSQNFHTSY
DTNADKQLSF	NADK-QLSF
IIEANSQHY	IIEANSQHY
YTVGLGQTR	YTVGLGQTR
TVERIHVGKKY	TVERIHVGK
HTDWLLDLY	HTDWLLDLY
RIAIQNLLY	RIAIQNLLY
ISENKFLKY	ISENKFLKY
GTELGNELFY	GTELNELFY
ISDRLIGIY	ISDRLIGIY
KTDDLTMVLY	KTDDTMVLY
SKDYTFSWYK	SKDYTFSWY
NSLESYAFNMK	SLESAFNMK
RLETELDGLRY	ETELDGLRY
VLDSGAPIK	VLDSGAPIK
RSEGTPEKPLY	RSEGEKPLY
RLDASRLLLY	RLDARLLLY
RTDFHGSGY	RTDFHGSGY
NEHEVGEAIR	EHEVGEAIR
TLDAGKFQIY	TLDAKFQIY
ATDYHVRVY	ATDYHVRVY
AVLLGPPGAGK	LLGPPGAGK
KSSESEFTQY	SSESEFTQY
IDRHVSRY	IDRH-VSRY
VFGFSLITNK	VFGFLITNK
SVPEAQSAL	SVPEAQSAL
VWQLYIGDTR	QLYI-GDTR
FSGRFEDVY	FSGRFEDVY
ITAADILDR	ITAADILDR
RSGGHLMNLKY	RSGGLMNLK
SVDSVFVLY	SVDSVFVLY
RVDPNGFFLY	RVDPGFFLY
ATDTASGTGLY	ATDTGTGLY
IIDAGPKGNY	IIDAPKGNY
RTDGTVEIY	RTDGTVEIY
VGEFSGANK	VGEFSGANK
LSDGVAVLK	LSDGVAVLK
KSTAISLFY	KSTAISLFY
GTDSQYNAY	GTDSQYNAY
RAAPFSLEY	RAAPFSLEY
RMDYYNALNLY	RMDYNALNL
HLPETKFSEL	HLPEKFSEL
ILPSVSHK	ILPS-VSHK
ITGKEDAANNY	KEDA-ANNY
DVDPGEHYILK	DVDP-GEHY
GMDNDFHHY	GMDNDFHHY
QTDINLPY	QTDI-NLPY
LVDGDTLSY	LVDGDTLSY
KSEDFSLPAY	KSEDSLPAY
RVDDIFSDLY	RVDDFSDLY
SQEHPVVLTK	SQEHVVLTK
GSENNSLYLYY	GSENSLYLY
ATDFVVPGPGK	ATDFVVPGP
RTEELAQAY	RTEELAQAY
ATDDITELY	ATDDITELY
GQVYILGR	GQVY-ILGR
LTDLVDDNYFY	LTDLVDDNY
VTEKDLLLY	VTEKDLLLY
RVDPNGSRY	RVDPNGSRY
SSDPEEESVLY	SSDPESVLY
RTDKAEVVNGY	RTDKVVNGY
TQLVSNLK	TQLV-SNLK
ASDYFDQLY	ASDYFDQLY
GYLLQIFTK	GYLLQIFTK
HADSPVLMVY	HADSVLMVY
LTSRGSQQY	LTSRGSQQY
SMESFPPLAY	SMESPPLAY
VIFLENYR	VIFL-ENYR
KTDIEGTLFVY	KTDIGTLFV
SVPLAATSM	SVPLAATSM
EDQTEYLEER	QTEY-LEER
VTDSSLEY	VTDS-SLEY
DHENIVIAK	DHENIVIAK
INFDDNAEFR	NFDDNAEFR
LQAEIEGLK	LQAEIEGLK
RADREVAIY	RADREVAIY
EQVANSAFVER	QVANAFVER
RSDYEDPAFY	RSDYDPAFY
LSDHLINQGY	LSDHINQGY
KAEDSARTLLY	AEDSRTLLY
ASETAGSGFLY	ETAGSGFLY
KTDSFVPRNSY	KTDS-FVPR
KIDELYEAY	KIDELYEAY
RSAVYPLLY	RSAVYPLLY
LLDLDEELRY	LLDLEELRY
RTELPQFVSY	RTELQFVSY
KSETELKDTY	KSETLKDTY
LSDKNIEQY	LSDKNIEQY
TSSEITTKDLK	SSEITKDLK
ITDRGGGSQHY	ITDRGSQHY
LVDPSVYGY	LVDPSVYGY
KADKSLSY	KADK-SLSY
KTDSEATNIY	KTDSATNIY
SFGGSYGGSF	SFGGYGGSF
RLDTDHLRY	RLDTDHLRY
IWHHTFYNELR	HTFY-NELR
VSQEHPVVLTK	SQEHVVLTK
IEEELGSK	IEEE-LGSK
KSSATRLLY	KSSATRLLY
KSDEGHPFRAY	KSDEGHPFR
KMDLDNNFY	KMDLDNNFY
LVSLEMGK	LVSL-EMGK
DIVEAHYR	DIVE-AHYR
KTTSAEIRSLY	TSAEIRSLY
RLDQPQMY	RLDQ-PQMY
KVDAGKLHY	KVDAGKLHY
ASDASGFSPGY	ASDAFSPGY
ATDRFRSLY	ATDRFRSLY
LLEIDPYLK	LLEIDPYLK
EEEVNNLVK	EEEVNNLVK
RVESSEFGTYY	RVESEFGTY
WLPNGTLK	WLPN-GTLK
RVEKNLLVY	RVEKNLLVY
KSWKPNHKDYY	KSWKNHKDY
TILDELVQR	TILDELVQR
KADVDAIHEY	KADVAIHEY
PTDPKVVVY	PTDPKVVVY
EDALKILQY	EDALKILQY
LSDDHGASWRY	SDDHASWRY
KMEQAFARY	KMEQAFARY
KTEQEALEY	KTEQEALEY
VMEKSFLEY	VMEKSFLEY
ILDIPNQLYY	ILDINQLYY
RTMNSLKQLY	RTMNLKQLY
ATDLDVANFY	ATDLVANFY
KADSAVSSFY	KADSVSSFY
YTDHQNSSSYY	YTDHNSSSY
LRPSDPEAK	LRPSDPEAK
LTDDLHKQY	LTDDLHKQY
KTDPKMLSK	KTDPKMLSK
RSDIHTEAV	RSDIHTEAV
KSDKHLYEEY	KSDKLYEEY
GTEHPNTIQEY	GTEHTIQEY
GVQDVLEILK	VQDVLEILK
TSDSTVYDY	TSDSTVYDY
VTDEPLLK	VTDE-PLLK
KVENFFTLY	KVENFFTLY
LTDDGNKWLY	LTDDNKWLY
RTTFFHHEY	RTTFFHHEY
HLDTLTEHY	HLDTLTEHY
KIDVPANRY	KIDVPANRY
ASDPYQVHV	ASDPYQVHV
AFEPATGR	AFEP-ATGR
KTDPKDPANY	KTDPDPANY
KTAVIDHHNY	KTAVDHHNY
LSDPGSGLY	LSDPGSGLY
KTEIMSPLY	KTEIMSPLY
FVEIKGSV	FVEI-KGSV
WLNENAVEK	WLNENAVEK
LTDTFYYRL	LTDTFYYRL
YSTDVSVDEVK	STDVVDEVK
SSDGKPFEY	SSDGKPFEY
KTDDSLEKYLY	KTDDSLEKY
HTNYTMEHIR	HTNYMEHIR
KLDVDAPRLLK	DVDAPRLLK
ATEDPVLERY	ATEDVLERY
TISSNVASKA	TISSNVASK
ATEQVSWGHY	ATEQSWGHY
KVDTDGNGY	KVDTDGNGY
KTQQQHMLY	KTQQQHMLY
TMDPKPLAY	TMDPKPLAY
VTDALNATR	VTDALNATR
RSDAEKQLLY	RSDAKQLLY
VVPEMTEILK	VVPETEILK
VADRLGSLMQY	RLGS-LMQY
KTADGKTYYY	KTADGKTYY
KTEGGKVLY	KTEGGKVLY
KTDMEKLTFY	KTDMKLTFY
MVEGFFDR	MVEG-FFDR
KSELTNLAGLY	KSELLAGLY
LTDQAIFY	LTDQ-AIFY
ASQEHGLKY	ASQEHGLKY
LDPTQTSFLK	LDPTTSFLK
TSETPDYLLKY	TSETDYLLK
ITDKDDLVK	ITDKDDLVK
ALDENGNLWY	ALDEGNLWY
TMEGGTLKY	TMEGGTLKY
RADTQTYQPY	RADTTYQPY
VVDPFSKKDWY	VVDP-FSKK
KIDDLFSGKLY	KIDDLFSGK
RLDHKFDLM	RLDHKFDLM
KLDDLHTLY	KLDDLHTLY
LVFLGLDNAGK	FLGLDNAGK
RLEGQVLRY	RLEGQVLRY
ATDISRQNEY	ATDIRQNEY
THILLFLPK	THILLFLPK
LSDMPLKSFY	LSDMLKSFY
RSDELARHY	RSDELARHY
RVDFQGMEY	RVDFQGMEY
TTYKLVINGK	TTYKVINGK
AADLVEALY	AADLVEALY
IQEAGTEVVK	IQEATEVVK
GSDPYVRMY	GSDPYVRMY
SSDAHTSYY	SSDAHTSYY
RADPEAGLLLY	RADPGLLLY
KTAEGDVGDY	KTAEDVGDY
QVAQNLDR	QVAQ-NLDR
QVHPDTGISSK	HPDTGISSK
MMDPNSTQRY	MMDPSTQRY
GSSFIQHYY	GSSFIQHYY
SSDNATLTHY	SSDNTLTHY
KLDRTFHLSY	KLDRFHLSY
KSEDGRLIY	KSEDGRLIY
IIDGKTLKY	IIDGKTLKY
ASSPTPPHGY	ASSPPPHGY
KTDFEVLTK	KTDFEVLTK
ISDLIRDSY	ISDLIRDSY
IIDSAGPLYY	IIDSGPLYY
RVADTFQDY	RVADTFQDY
VTDTNVILS	VTDTNVILS
RLDINTNTY	RLDINTNTY
GSDKINYTYM	GSDKINYTY
RTSVDFKDTDY	SVDFKDTDY
KSDNAVLNQRY	KSDNVLNQR
RADAENAMRY	RADANAMRY
LTDYFLKDEY	LTDYLKDEY
ATQEAFMK	ATQE-AFMK
GSDSRFAGY	GSDSRFAGY
RLDPQSGALY	RLDPSGALY
ITEDKTELY	ITEDKTELY
ARDFILKLY	ARDFILKLY
VADKVHLMY	VADKVHLMY
RSEAVIAQFY	RSEAIAQFY
LVMAAANR	LVMA-AANR
KSELRAAIDRY	KSELAAIDR
RLEPNAQAQMY	RLEPQAQMY
EEQLQQIRAE	EEQL-QQIR
YIDQEELNK	YIDQEELNK
GEYLPLLQGK	EYLPLLQGK
RTEEWYGTQY	RTEEYGTQY
KMDKTGASFKY	KMDKGASFK
QTDPVTLQY	QTDPVTLQY
LTDEGLLY	LTDE-GLLY
KVDGEIILHLY	KVDGIILHL
LVDAFVEHRY	LVDAVEHRY
SDKETYELRY	KETY-ELRY
QEDPDYGIR	QEDPDYGIR
HIDVGGHMY	HIDVGGHMY
KSDLFQDDLY	KSDLQDDLY
