Data	Data aligned
SLYWLSTQK	SLYWLSTQK
SAFEYGGQK	SAFEYGGQK
IVAGSLITK	IVAGSLITK
AVGPASILK	AVGPASILK
VVDYPNSAK	VVDYPNSAK
EIIDLVLDR	EIIDLVLDR
ATNGAKFLK	ATNGAKFLK
AVSTFAMVK	AVSTFAMVK
SVIVQPFSK	SVIVQPFSK
ASLGLKFNK	ASLGLKFNK
SAVGTIVKK	SAVGTIVKK
RVYNWDVKR	RVYNWDVKR
LDQVLKEAK	LDQVLKEAK
SLVNLGGSK	SLVNLGGSK
ATGDVALLR	ATGDVALLR
AVADAVIEK	AVADAVIEK
QIFSEFLLK	QIFSEFLLK
KVAVVLIQK	KVAVVLIQK
GSLRPFVQK	GSLRPFVQK
EGGPILPKK	EGGPILPKK
SLGQVVITK	SLGQVVITK
GSFGKVFLV	GSFGKVFLV
GTSSVIVSR	GTSSVIVSR
TITPVVGKK	TITPVVGKK
ATKIKNYYK	ATKIKNYYK
KLNEVIVNK	KLNEVIVNK
SILSHIHKR	SILSHIHKR
GVNPYILKK	GVNPYILKK
RVMQDIVYK	RVMQDIVYK
IVFSLTFFK	IVFSLTFFK
VILIDPFHK	VILIDPFHK
RLFHLHSQK	RLFHLHSQK
KSSDFAVLK	KSSDFAVLK
STSEPLSSK	STSEPLSSK
KTLGPILKK	KTLGPILKK
RVLSKAFSR	RVLSKAFSR
VTIIFIYEK	VTIIFIYEK
KLFNGTFLK	KLFNGTFLK
VGVYRPPPK	VGVYRPPPK
STMAIIVNK	STMAIIVNK
QTASFALKK	QTASFALKK
FTAPDPGLK	FTAPDPGLK
KIIGPFSKK	KIIGPFSKK
TVNSPAIYK	TVNSPAIYK
AVLHTVLLH	AVLHTVLLH
AVFEETLEK	AVFEETLEK
ATFLDPRYK	ATFLDPRYK
LVFEWTIVK	LVFEWTIVK
VVMLESPPK	VVMLESPPK
LDIEIATYR	LDIEIATYR
SSLNHIVEK	SSLNHIVEK
FVMQEEFSR	FVMQEEFSR
RVEEAILEK	RVEEAILEK
GVAPQPPLK	GVAPQPPLK
TTITSHFAK	TTITSHFAK
PLDTVTFYK	PLDTVTFYK
QASEPAVSL	QASEPAVSL
SVIRPILKR	SVIRPILKR
KVTTSITSK	KVTTSITSK
AQYEDIAQK	AQYEDIAQK
SSMSVSELK	SSMSVSELK
GQNIAVVGK	GQNIAVVGK
ATNYITRNK	ATNYITRNK
GSLASVYHK	GSLASVYHK
SSNLPVNNK	SSNLPVNNK
AAMEPLTAR	AAMEPLTAR
SNDGATILK	SNDGATILK
SVLNLVIVK	SVLNLVIVK
VVAPPGAPK	VVAPPGAPK
KLAETLGRK	KLAETLGRK
SSSSVLINK	SSSSVLINK
AVTKYTSAK	AVTKYTSAK
GTFALNLLK	GTFALNLLK
TSALPIIQK	TSALPIIQK
SVFVATFLR	SVFVATFLR
RVLPEFKKK	RVLPEFKKK
LGSSKVLAK	LGSSKVLAK
ASEVLKHLK	ASEVLKHLK
STFRESFKK	STFRESFKK
AVFEWHITK	AVFEWHITK
GTMPVSLLK	GTMPVSLLK
RLFLFQIQK	RLFLFQIQK
STVEKIAMK	STVEKIAMK
STNNWVLIK	STNNWVLIK
SVVGELMYK	SVVGELMYK
MVMDKKHFK	MVMDKKHFK
QVFEFTEPK	QVFEFTEPK
KTTTTIIPK	KTTTTIIPK
QVFEKSPLR	QVFEKSPLR
RILGPGLNK	RILGPGLNK
STITVDQMK	STITVDQMK
VSPLATSAL	VSPLATSAL
ASSYIAHLR	ASSYIAHLR
AVLKHIENK	AVLKHIENK
GSIGGTFAK	GSIGGTFAK
ASLGASVHK	ASLGASVHK
SVFDFFLEK	SVFDFFLEK
SGFEGMFTK	SGFEGMFTK
RTLKEILRY	RTLKEILRY
IVVEHIIMK	IVVEHIIMK
ATANQIILK	ATANQIILK
RALDIPLVK	RALDIPLVK
SVASPFTSK	SVASPFTSK
SVAKIAQYK	SVAKIAQYK
IPTLLLPPK	IPTLLLPPK
KTGEVLDTK	KTGEVLDTK
AVDGEPLGR	AVDGEPLGR
STYKEAFRK	STYKEAFRK
ATLWGGLLR	ATLWGGLLR
TTLGHAVLK	TTLGHAVLK
TTVDIFHKK	TTVDIFHKK
SAFVERVRK	SAFVERVRK
RSFSLGVPR	RSFSLGVPR
SALSVAPSK	SALSVAPSK
KILGPFHKR	KILGPFHKR
GTVSPLFQK	GTVSPLFQK
ELMPPPPPK	ELMPPPPPK
KVIDRILYK	KVIDRILYK
RVQGFQVEY	RVQGFQVEY
GTMDMSITR	GTMDMSITR
SVAAPITVR	SVAAPITVR
GTSDEFIEK	GTSDEFIEK
VLKVLSSLK	VLKVLSSLK
STARHLYLR	STARHLYLR
AVLNPTPIK	AVLNPTPIK
LTMPGGVAK	LTMPGGVAK
AAVGYIMEK	AAVGYIMEK
TTGQVVAMK	TTGQVVAMK
KSFGELVHK	KSFGELVHK
ATLTNILEH	ATLTNILEH
TIAASLAFK	TIAASLAFK
ATYPMPTAK	ATYPMPTAK
QVVSPGVYK	QVVSPGVYK
ATLQNVLRK	ATLQNVLRK
ASIRTFVPK	ASIRTFVPK
STVNKWTLK	STVNKWTLK
LVIITAGAR	LVIITAGAR
ETQPPVALK	ETQPPVALK
ATLLIFANK	ATLLIFANK
IFDGRVVAK	IFDGRVVAK
SSSAEFLEK	SSSAEFLEK
ALLDITVTK	ALLDITVTK
GTIGDMMQK	GTIGDMMQK
GTTYEGIFK	GTTYEGIFK
SMNANTITK	SMNANTITK
AIIQHMIKK	AIIQHMIKK
KLLDAYLLY	KLLDAYLLY
RLVQGSILK	RLVQGSILK
SSPQPGSAL	SSPQPGSAL
VVGPVGAGK	VVGPVGAGK
VVMRDPASK	VVMRDPASK
GTLNPGLTK	GTLNPGLTK
SISAVVMEK	SISAVVMEK
GVLDWLIQK	GVLDWLIQK
SSYGNQEFK	SSYGNQEFK
HSQPFAWKK	HSQPFAWKK
SIAPPVPLK	SIAPPVPLK
FTQKPGFPK	FTQKPGFPK
ATMYNLLAY	ATMYNLLAY
QGEYIAPEK	QGEYIAPEK
VASTPISQR	VASTPISQR
HAIPIIKEK	HAIPIIKEK
ISGPISTSK	ISGPISTSK
RSVSIPAPA	RSVSIPAPA
AVAIKAMAK	AVAIKAMAK
FLYDEVHPK	FLYDEVHPK
STSNSFNLK	STSNSFNLK
LVFDWNTPK	LVFDWNTPK
SSNVAPVKT	SSNVAPVKT
ALMEKFKKK	ALMEKFKKK
TVVDFQIGK	TVVDFQIGK
AAVTSLFAK	AAVTSLFAK
ILYDHAHVK	ILYDHAHVK
SLNQAVVSK	SLNQAVVSK
RSMHEFSAK	RSMHEFSAK
SVQEYFVRK	SVQEYFVRK
TTSVITIVK	TTSVITIVK
QIGPAPPLK	QIGPAPPLK
SVPSTPIAH	SVPSTPIAH
ALFSRIFGK	ALFSRIFGK
SVLEQSFLR	SVLEQSFLR
DTPGFIVNR	DTPGFIVNR
TVAKSIDLK	TVAKSIDLK
RVYHYFQWR	RVYHYFQWR
STIDDTISK	STIDDTISK
VSSWLPLAK	VSSWLPLAK
RTQEKFALK	RTQEKFALK
ASFQSTSVK	ASFQSTSVK
SILKESKYK	SILKESKYK
IVVPPLPEK	IVVPPLPEK
VTDSPRILK	VTDSPRILK
GVSSVIHPK	GVSSVIHPK
LFAYPDTHR	LFAYPDTHR
ATLEIVTDK	ATLEIVTDK
GVDPNQYTK	GVDPNQYTK
GVMVYGIKK	GVMVYGIKK
ATLQDIIRR	ATLQDIIRR
QIYGVFDEK	QIYGVFDEK
VSLGIAVSK	VSLGIAVSK
RIQQIIEGK	RIQQIIEGK
TVMVPSLLR	TVMVPSLLR
GTQNRPLLR	GTQNRPLLR
RLFVGSIPK	RLFVGSIPK
NVEIDPEIQ	NVEIDPEIQ
AIIDTVINY	AIIDTVINY
RTFQEVLAY	RTFQEVLAY
SSPKSHIIK	SSPKSHIIK
AVAVTMGPK	AVAVTMGPK
QTQPIYLAK	QTQPIYLAK
ATHTAFVAK	ATHTAFVAK
GAFYKGFVK	GAFYKGFVK
SVFKELLGK	SVFKELLGK
ATMPPAVER	ATMPPAVER
AVIGNVQEK	AVIGNVQEK
VVLTYIYFK	VVLTYIYFK
LTQTVAHLK	LTQTVAHLK
AIFKPVMSK	AIFKPVMSK
IVSDFTIGR	IVSDFTIGR
KLFNKFIGK	KLFNKFIGK
ATSPIIIHR	ATSPIIIHR
STLMSLPTK	STLMSLPTK
RILPKPTRK	RILPKPTRK
VAAEKSFNK	VAAEKSFNK
IATQVVVEK	IATQVVVEK
QTYVGITEK	QTYVGITEK
SVLIIAWKF	SVLIIAWKF
AQIFEPLHK	AQIFEPLHK
SASASLPTK	SASASLPTK
SAPVSQESL	SAPVSQESL
SVQGFFLNH	SVQGFFLNH
GSMEPAFHR	GSMEPAFHR
ATFTVMGLK	ATFTVMGLK
SVGQTVITK	SVGQTVITK
QVADVVVSR	QVADVVVSR
SSFLIKRNK	SSFLIKRNK
VASTLPSRQ	VASTLPSRQ
GTFLEGVAK	GTFLEGVAK
SSNSYAIKK	SSNSYAIKK
TAMPPGTAR	TAMPPGTAR
STIRLPHVK	STIRLPHVK
STLGYTISR	STLGYTISR
VSGSIQVLK	VSGSIQVLK
ATTTVMNPK	ATTTVMNPK
LIQQATTVK	LIQQATTVK
TVFPNHTVK	TVFPNHTVK
QLYWSHPRK	QLYWSHPRK
NAPLVHATL	NAPLVHATL
LQNEPIPER	LQNEPIPER
SVITQVLNK	SVITQVLNK
QVEEIFNLK	QVEEIFNLK
NIPEKTTAL	NIPEKTTAL
KTAEISLLK	KTAEISLLK
AILSKFLYY	AILSKFLYY
SLQRWEHLK	SLQRWEHLK
EVEMDAVGK	EVEMDAVGK
HVYRERFPK	HVYRERFPK
SVQRPGLAR	SVQRPGLAR
RTIFPLFMK	RTIFPLFMK
SVLDVRSLK	SVLDVRSLK
SVFQTTDTK	SVFQTTDTK
AVYERHFLR	AVYERHFLR
TYKLILNGK	TYKLILNGK
KSIIPTVGK	KSIIPTVGK
GTDELRLLY	GTDELRLLY
TVTSYVFLK	TVTSYVFLK
TQATIYVHK	TQATIYVHK
GIAPYSYAG	GIAPYSYAG
SVSAVNLPK	SVSAVNLPK
AIASTLVHK	AIASTLVHK
ASTPPLPRR	ASTPPLPRR
AVALPLQTK	AVALPLQTK
VNKVPLTGK	VNKVPLTGK
GSSKIAIQK	GSSKIAIQK
RTQNVLGEK	RTQNVLGEK
AQAESLRYK	AQAESLRYK
TALDPSVLD	TALDPSVLD
RVFHPAFTK	RVFHPAFTK
IQIISTILK	IQIISTILK
RITTHFELK	RITTHFELK
ILFNNAVKK	ILFNNAVKK
VISQVFEIK	VISQVFEIK
STAAVGVLK	STAAVGVLK
SSNFYITEK	SSNFYITEK
STLSTVISK	STLSTVISK
GTGDVKLLK	GTGDVKLLK
KLMTVRIVK	KLMTVRIVK
AQGNVYHLK	AQGNVYHLK
ASFNDTFVH	ASFNDTFVH
STIKFQMKK	STIKFQMKK
ASGSTTFTK	ASGSTTFTK
SQISLLIGK	SQISLLIGK
VIFTGGVGK	VIFTGGVGK
RTASFAVRK	RTASFAVRK
GVSSIFIYH	GVSSIFIYH
AAYAHELPK	AAYAHELPK
KSIDFPLTK	KSIDFPLTK
SSYDTAWKK	SSYDTAWKK
KIFESRFEK	KIFESRFEK
AVLYDIILK	AVLYDIILK
SVLLFVTKK	SVLLFVTKK
KTYGEIFEK	KTYGEIFEK
SSAHWPIFK	SSAHWPIFK
GSWASLVQK	GSWASLVQK
RGYYRYYNK	RGYYRYYNK
VPSLAQLVK	VPSLAQLVK
KVGEVIVTK	KVGEVIVTK
ATGFLEQLK	ATGFLEQLK
VILESIFLK	VILESIFLK
TVQEKTFNK	TVQEKTFNK
SIHRPLAYK	SIHRPLAYK
SVAKTILKR	SVAKTILKR
HQDFQSYPK	HQDFQSYPK
SGSPATPLK	SGSPATPLK
ITGPTGVGK	ITGPTGVGK
HIGYDDSAK	HIGYDDSAK
AVMKNQVAR	AVMKNQVAR
TIKEGSQLK	TIKEGSQLK
GTFPRAFKK	GTFPRAFKK
SALHIAIEK	SALHIAIEK
IVFDGVPSK	IVFDGVPSK
RAISWTMKK	RAISWTMKK
SLLNVSTPK	SLLNVSTPK
IWKIKKLIK	IWKIKKLIK
TVSDAILRY	TVSDAILRY
KTMNIYFPK	KTMNIYFPK
IINSSITTK	IINSSITTK
SIPTFYFPR	SIPTFYFPR
VAIGDVYFK	VAIGDVYFK
IVLQIDNAR	IVLQIDNAR
AAISLAFSK	AAISLAFSK
RIYSYVVSR	RIYSYVVSR
STSLVVPEK	STSLVVPEK
TVSPFAVQK	TVSPFAVQK
VVSEIPVLK	VVSEIPVLK
STMEKFFEH	STMEKFFEH
FPSLLTNPK	FPSLLTNPK
GAFYKGFIK	GAFYKGFIK
NVYEVVNPK	NVYEVVNPK
SAQGNVYVK	SAQGNVYVK
SVGMYLISK	SVGMYLISK
AELNEFLTR	AELNEFLTR
SVSISSAVK	SVSISSAVK
AVIDVGINR	AVIDVGINR
ALASVVIHK	ALASVVIHK
VIYFPPLQK	VIYFPPLQK
SVLDSFLKY	SVLDSFLKY
ITLPAGTEK	ITLPAGTEK
ASVFVKLQK	ASVFVKLQK
GTNPGIITK	GTNPGIITK
GTTRFAHLK	GTTRFAHLK
IVFNIYHSK	IVFNIYHSK
FLTLTKTIA	FLTLTKTIA
RVISSIEQK	RVISSIEQK
LTIPEIPPK	LTIPEIPPK
GQYGNPLNK	GQYGNPLNK
TSETPQPPR	TSETPQPPR
RTISETIER	RTISETIER
ATLDVAVRR	ATLDVAVRR
KTIIFVETK	KTIIFVETK
ISASPLTSK	ISASPLTSK
FEDENFILK	FEDENFILK
SVHWFPVQK	SVHWFPVQK
SAVRPVIEK	SAVRPVIEK
SSGVPNPPK	SSGVPNPPK
AVQEFGLAR	AVQEFGLAR
HVYRNFFNK	HVYRNFFNK
SAPYGRITL	SAPYGRITL
KIQPALQEK	KIQPALQEK
ITGPNMGGK	ITGPNMGGK
KVSQVIMEK	KVSQVIMEK
GTGKTTFVK	GTGKTTFVK
SISEFLLTH	SISEFLLTH
LSYLHLPKK	LSYLHLPKK
RILFFNTPK	RILFFNTPK
RIHGVGFKK	RIHGVGFKK
LVSPEQPPK	LVSPEQPPK
KIIEPIQSR	KIIEPIQSR
SVMGPQEKK	SVMGPQEKK
IVSSVRRPM	IVSSVRRPM
AIIDEFEQK	AIIDEFEQK
GTHLLKILK	GTHLLKILK
ATVTPSPVK	ATVTPSPVK
LRDADPILR	LRDADPILR
ATFMEVLTK	ATFMEVLTK
AVNMVPFPR	AVNMVPFPR
ATGSVFTGK	ATGSVFTGK
AMYPDYFAK	AMYPDYFAK
SGSNVKIVK	SGSNVKIVK
VAVETTTPK	VAVETTTPK
ASTRTIFKK	ASTRTIFKK
GVASLFAGR	GVASLFAGR
GSLGGQINK	GSLGGQINK
SVMKSFIKR	SVMKSFIKR
YSKYYKTID	YSKYYKTID
SVLDIETRK	SVLDIETRK
VVAVPLPLH	VVAVPLPLH
MMFSATFPK	MMFSATFPK
SSYPKQILR	SSYPKQILR
KVYDKAINR	KVYDKAINR
KIADRFLLY	KIADRFLLY
AVLEADFAK	AVLEADFAK
STQPENFLK	STQPENFLK
SVSDIIRLR	SVSDIIRLR
QTFQRIFTK	QTFQRIFTK
AVSTLGISK	AVSTLGISK
SVEMPLTGK	SVEMPLTGK
AVAELWLQH	AVAELWLQH
GTAKSQFLK	GTAKSQFLK
LLQDFFNGK	LLQDFFNGK
ATIEETYSK	ATIEETYSK
ISTEPLPGR	ISTEPLPGR
TIFEERHLK	TIFEERHLK
RSSFVFVRK	RSSFVFVRK
AIFDKSTGK	AIFDKSTGK
ATSPGRLFR	ATSPGRLFR
SVVEYLLQH	SVVEYLLQH
IIGTIFIIK	IIGTIFIIK
ASIPHVIAR	ASIPHVIAR
SVANPAFLK	SVANPAFLK
LTGEVVALK	LTGEVVALK
SVIKPFEEK	SVIKPFEEK
NFFASPMLK	NFFASPMLK
FTAPPVLGK	FTAPPVLGK
SSLQEVYHK	SSLQEVYHK
ASQGFRFLR	ASQGFRFLR
AQNEKSFFK	AQNEKSFFK
STLTPKIQK	STLTPKIQK
KIYKKFLKK	KIYKKFLKK
SVSNVVITK	SVSNVVITK
QIQDSIVTK	QIQDSIVTK
AVPRPIPEK	AVPRPIPEK
KTLDHVLTH	KTLDHVLTH
VTVSGGTPK	VTVSGGTPK
AAMLMPHQK	AAMLMPHQK
SVNSHIYQR	SVNSHIYQR
ATIIGEWVK	ATIIGEWVK
ATATMSLGK	ATATMSLGK
GIFPLSFVK	GIFPLSFVK
AIQDTNNLK	AIQDTNNLK
PSSHLPPPK	PSSHLPPPK
RAPEPLPPK	RAPEPLPPK
LVIPFAVRK	LVIPFAVRK
RSLDNFFAK	RSLDNFFAK
QSIFPTIPK	QSIFPTIPK
RLFPGLAIK	RLFPGLAIK
QQLYWSHPR	QQLYWSHPR
IIYDRDFSY	IIYDRDFSY
SVHFPLRSK	SVHFPLRSK
RTFTWLVGK	RTFTWLVGK
ASIPTILTH	ASIPTILTH
AAPEGKRSL	AAPEGKRSL
GSFDVVHVK	GSFDVVHVK
SVQDGSVLK	SVQDGSVLK
RLFIGGIPK	RLFIGGIPK
MVGVNLPQK	MVGVNLPQK
RVIAPPLIK	RVIAPPLIK
VVLPYLVPK	VVLPYLVPK
STIPKVLQY	STIPKVLQY
GVSAATFLK	GVSAATFLK
ATLKGLVQK	ATLKGLVQK
GSMGSFSEK	GSMGSFSEK
ATSPALFNR	ATSPALFNR
ASQPEFPSR	ASQPEFPSR
GTSSMIVPK	GTSSMIVPK
EIMPPPPKP	EIMPPPPKP
AQNPSLFVK	AQNPSLFVK
RTFPGVASR	RTFPGVASR
ASFPKVFIK	ASFPKVFIK
SVQAALKLK	SVQAALKLK
ASVLNPYVK	ASVLNPYVK
LVLEGAGLR	LVLEGAGLR
ATVLYIVKK	ATVLYIVKK
HVIETLIGK	HVIETLIGK
ATTALAIYH	ATTALAIYH
YLPDGTASL	YLPDGTASL
RTFSYIKNK	RTFSYIKNK
GTIDVKELK	GTIDVKELK
GSLLWGLVK	GSLLWGLVK
SVQENIQQK	SVQENIQQK
GIFSAEFLK	GIFSAEFLK
ATYREFVHR	ATYREFVHR
ISPSRTEAL	ISPSRTEAL
SSEAPLVQK	SSEAPLVQK
SVIAKYPHK	SVIAKYPHK
RVYPESIPR	RVYPESIPR
AAMPGFIAK	AAMPGFIAK
ATNSSMFLK	ATNSSMFLK
LVLSRTKLT	LVLSRTKLT
VSAPNIAMK	VSAPNIAMK
SVLDKSLTK	SVLDKSLTK
IVIETGPLK	IVIETGPLK
VVIGTPTLK	VVIGTPTLK
LVAIPVYVK	LVAIPVYVK
ATGQWTRFK	ATGQWTRFK
RSNPYYIVK	RSNPYYIVK
ITAADILDR	ITAADILDR
AVFLGLARK	AVFLGLARK
STHGTFLNK	STHGTFLNK
KTSPPVFSK	KTSPPVFSK
AVDTAYVAK	AVDTAYVAK
KTISEAWIK	KTISEAWIK
STLPPVKSK	STLPPVKSK
RVLEDRALK	RVLEDRALK
ATFTYFYKK	ATFTYFYKK
EVNSGFFYK	EVNSGFFYK
STNPFRPQK	STNPFRPQK
LAAPPALEK	LAAPPALEK
GVIDLIFEK	GVIDLIFEK
IVNDFAYMK	IVNDFAYMK
SSRGPLPVK	SSRGPLPVK
AVYEDQVGK	AVYEDQVGK
VIYEKTIRK	VIYEKTIRK
TVHPKFHYK	TVHPKFHYK
SVQEGIKFK	SVQEGIKFK
GTMRGIIAK	GTMRGIIAK
ITQSNAILR	ITQSNAILR
STISEVLGR	STISEVLGR
AQLLESQQK	AQLLESQQK
IPEKQLVEK	IPEKQLVEK
IIALDGDTK	IIALDGDTK
VTFGHSLSK	VTFGHSLSK
SALDFLHNK	SALDFLHNK
SVFEKYFQF	SVFEKYFQF
SITGFFQRK	SITGFFQRK
GSNGDTFLK	GSNGDTFLK
SSIQGQWPK	SSIQGQWPK
GTIPQIFGK	GTIPQIFGK
INSSIITKK	INSSIITKK
SIPEKNRPL	SIPEKNRPL
FEPAKGGEK	FEPAKGGEK
EIFDGIQPK	EIFDGIQPK
SIFRTPISK	SIFRTPISK
GINKPGFYK	GINKPGFYK
AQFRQPLKK	AQFRQPLKK
SVNELIYKR	SVNELIYKR
KVFGGTVHK	KVFGGTVHK
DHENIVIAK	DHENIVIAK
STLESIYQR	STLESIYQR
LTNHFSFEK	LTNHFSFEK
KALEALVAK	KALEALVAK
GTIEKVFVK	GTIEKVFVK
SIPILASAL	SIPILASAL
ATYILEAGK	ATYILEAGK
VVSEKQFSK	VVSEKQFSK
ATFSTGERK	ATFSTGERK
ATLIRPHNR	ATLIRPHNR
HTFGGPLLK	HTFGGPLLK
AVNNMFVSK	AVNNMFVSK
RIAEFAFEY	RIAEFAFEY
SVTEFSEEK	SVTEFSEEK
KVTDPSVAK	KVTDPSVAK
RIIEPLTSR	RIIEPLTSR
SSFQFSIQK	SSFQFSIQK
STSDSVRLK	STSDSVRLK
ATINYPFEK	ATINYPFEK
SVYGYGVQK	SVYGYGVQK
TTQDPLSNK	TTQDPLSNK
SVITIVKSK	SVITIVKSK
SLSVPSVSK	SLSVPSVSK
GTKLPGLLK	GTKLPGLLK
SVLDYFSER	SVLDYFSER
GVFEPTIVK	GVFEPTIVK
GTLAEFIQK	GTLAEFIQK
GLGIETVSK	GLGIETVSK
GTQSFVFQR	GTQSFVFQR
GVFEYFNAK	GVFEYFNAK
RYDDPEVQK	RYDDPEVQK
GTIPVPKGK	GTIPVPKGK
VSLDYAISK	VSLDYAISK
DIGLAAWGR	DIGLAAWGR
AVLTKQLLH	AVLTKQLLH
QTNPTYLAK	QTNPTYLAK
SQNPRFYHK	SQNPRFYHK
HTMGFWLTK	HTMGFWLTK
KTDLFYERK	KTDLFYERK
KIMSSPLSK	KIMSSPLSK
SQSDPTFGK	SQSDPTFGK
FGAYGGLLK	FGAYGGLLK
GTSITVPQK	GTSITVPQK
YENEVALRQ	YENEVALRQ
AQWQKVLPR	AQWQKVLPR
ASATVAIPK	ASATVAIPK
GAMEHFHMK	GAMEHFHMK
SVAKNFFTK	SVAKNFFTK
GTQSVTLTH	GTQSVTLTH
VTTEKRFLK	VTTEKRFLK
AVLSWKLAK	AVLSWKLAK
SQLGIFISK	SQLGIFISK
SVFELTFKR	SVFELTFKR
SAFGVIIEK	SAFGVIIEK
SQPGLVHPK	SQPGLVHPK
AVFEDLSLK	AVFEDLSLK
STGPITKPK	STGPITKPK
GTAKVDFLK	GTAKVDFLK
TVLQYVVGR	TVLQYVVGR
ATIRKWLTK	ATIRKWLTK
GTMEWIMIK	GTMEWIMIK
ATLRLIIRH	ATLRLIIRH
LTYNDFINK	LTYNDFINK
EQGVLSFWR	EQGVLSFWR
ATQTSVVVK	ATQTSVVVK
ATSVITIVK	ATSVITIVK
ATVKVPFLK	ATVKVPFLK
GTTEWFHLK	GTTEWFHLK
NLNHVSYGR	NLNHVSYGR
NTNTAIELK	NTNTAIELK
STLPKPVQK	STLPKPVQK
ALQEIYNQK	ALQEIYNQK
GVANALAHR	GVANALAHR
SVVGLFLRH	SVVGLFLRH
GLAPNTPGK	GLAPNTPGK
SIAAAVAPK	SIAAAVAPK
SSGPASPPR	SSGPASPPR
LQIPIHFPK	LQIPIHFPK
SGVSLAALK	SGVSLAALK
RTAHVILRY	RTAHVILRY
VTMKEILLK	VTMKEILLK
GSNGYILNK	GSNGYILNK
KLFDFVNAK	KLFDFVNAK
AMIEVNINK	AMIEVNINK
LAPTDVKEL	LAPTDVKEL
SVFTSVRQK	SVFTSVRQK
AIYAKPANK	AIYAKPANK
SVIEQILHY	SVIEQILHY
ASSIFVAPR	ASSIFVAPR
STIHGKLQE	STIHGKLQE
AVISTILKY	AVISTILKY
RVMKALVNR	RVMKALVNR
VLLLEAGPK	VLLLEAGPK
HYFIEVNSR	HYFIEVNSR
AVFGVPASK	AVFGVPASK
RTFGHLLRY	RTFGHLLRY
RTAVYSLHK	RTAVYSLHK
ASSELFSQK	ASSELFSQK
VLPERYSSL	VLPERYSSL
STPSFSSPK	STPSFSSPK
SFEDAKEAL	SFEDAKEAL
RAMEWITAK	RAMEWITAK
AGNFYINDK	AGNFYINDK
TLFYSEIPK	TLFYSEIPK
NVKVDPEIQ	NVKVDPEIQ
RSTVAQLVK	RSTVAQLVK
TVTAQILLK	TVTAQILLK
SSVPYSTAK	SSVPYSTAK
SVLENFVGR	SVLENFVGR
SVIDSVTKK	SVIDSVTKK
GTYGFWYPK	GTYGFWYPK
ASLFSVLVR	ASLFSVLVR
TVFGTALNY	TVFGTALNY
SILNNPIVK	SILNNPIVK
SQGPISKPK	SQGPISKPK
SLFSNVVTK	SLFSNVVTK
HTIDWVREK	HTIDWVREK
RLTDADAMK	RLTDADAMK
STSQLVLRR	STSQLVLRR
SLYAHGYLK	SLYAHGYLK
LTAPAGPAR	LTAPAGPAR
VIFINTRRK	VIFINTRRK
SIFSKFTSK	SIFSKFTSK
ATQDPAALR	ATQDPAALR
SIGTPLDPK	SIGTPLDPK
VTTEPSSLK	VTTEPSSLK
LGFTDYPKL	LGFTDYPKL
VSYSHIQSK	VSYSHIQSK
ASLPSILQY	ASLPSILQY
SIMSFFHPK	SIMSFFHPK
LLNYAPLEK	LLNYAPLEK
SLLGYFPNK	SLLGYFPNK
SLAPVNIFK	SLAPVNIFK
QVIDGFFVK	QVIDGFFVK
FTGPPTFPK	FTGPPTFPK
FAPYNKPSL	FAPYNKPSL
ATLNVSTTR	ATLNVSTTR
STQQLQEVK	STQQLQEVK
AAITLAFSK	AAITLAFSK
ASSHVPIQK	ASSHVPIQK
STTTTQITK	STTTTQITK
GVMPSHFSR	GVMPSHFSR
SGMDYWIVK	SGMDYWIVK
ATAQFKINK	ATAQFKINK
VTNNVIRLK	VTNNVIRLK
VTDALNATR	VTDALNATR
GTPEKPLYH	GTPEKPLYH
AQGKPLALK	AQGKPLALK
SGYFKQFQK	SGYFKQFQK
SVFAFGENK	SVFAFGENK
ATFPDPNVK	ATFPDPNVK
ASVQPPPRP	ASVQPPPRP
SAFQHFWNR	SAFQHFWNR
LSDGVAVLK	LSDGVAVLK
LTGPPGVGK	LTGPPGVGK
SVSLPVRKK	SVSLPVRKK
GSSDVIIHR	GSSDVIIHR
ATDPNILGR	ATDPNILGR
ASLATTLTK	ASLATTLTK
SSAPQNIPK	SSAPQNIPK
AVNSDFYRR	AVNSDFYRR
STANIDDLK	STANIDDLK
GTYTDVTPR	GTYTDVTPR
KVQDIKEVK	KVQDIKEVK
VLDSGAPIK	VLDSGAPIK
RFYDRRFLK	RFYDRRFLK
SGYLLPDTK	SGYLLPDTK
GSSAINILK	GSSAINILK
GVTRVTIRK	GVTRVTIRK
STAAATVLK	STAAATVLK
QEFGLARFK	QEFGLARFK
GSSTIRNLK	GSSTIRNLK
YIVPPAPEK	YIVPPAPEK
IVALILSTK	IVALILSTK
VIIAKVTAK	VIIAKVTAK
SVSDLFNTK	SVSDLFNTK
RVNKPPYPK	RVNKPPYPK
SVNGKVLSK	SVNGKVLSK
SSLPGVFKK	SSLPGVFKK
ASFEPFSNK	ASFEPFSNK
RTLQEQLEK	RTLQEQLEK
AVPRFVQQK	AVPRFVQQK
SLSPVILIK	SLSPVILIK
AVLDFVKQK	AVLDFVKQK
SAGPHLPLK	SAGPHLPLK
SVINKVTEK	SVINKVTEK
GIMSPLAKK	GIMSPLAKK
GTYVSSVPR	GTYVSSVPR
AIYEPKTFK	AIYEPKTFK
MSQDFGWNK	MSQDFGWNK
ATLQYIVGR	ATLQYIVGR
SVLHGMVFK	SVLHGMVFK
GTGPNVPPR	GTGPNVPPR
GSIDIQHLK	GSIDIQHLK
SIYYVDVQK	SIYYVDVQK
AVMGNPVTR	AVMGNPVTR
ATYYGSLFK	ATYYGSLFK
ASQGFDFNK	ASQGFDFNK
RVIAKALEK	RVIAKALEK
TVQVYIITK	TVQVYIITK
SVLPFQIYY	SVLPFQIYY
RVMDVQYNK	RVMDVQYNK
ATVLTTERK	ATVLTTERK
SVPEAQSAL	SVPEAQSAL
AVLPYLLDK	AVLPYLLDK
ATGNWGDQK	ATGNWGDQK
GTMTGMLYK	GTMTGMLYK
KSINEFWNK	KSINEFWNK
QINLWKIYK	QINLWKIYK
TAGAQVLLR	TAGAQVLLR
SLLRDLTPK	SLLRDLTPK
NSLIFLKPN	NSLIFLKPN
YSFSYKHLK	YSFSYKHLK
SVIPEHPKK	SVIPEHPKK
QTAQIFFTK	QTAQIFFTK
KVFNQPKAK	KVFNQPKAK
AVFPSIVGR	AVFPSIVGR
SVPLAATSM	SVPLAATSM
IQEEFQHLK	IQEEFQHLK
SSSPVNVKK	SSSPVNVKK
SATTSPFFK	SATTSPFFK
AVVAATALK	AVVAATALK
NTMQQFLQK	NTMQQFLQK
RISSNPVAK	RISSNPVAK
IVSAPVPKK	IVSAPVPKK
STTRLYLRK	STTRLYLRK
MAPERVASL	MAPERVASL
STMGYMMAK	STMGYMMAK
RVTPFILKK	RVTPFILKK
VVAAVIWRK	VVAAVIWRK
ATDPNILSL	ATDPNILSL
RVADFTEQY	RVADFTEQY
ATLFFILRK	ATLFFILRK
FTNERFPLR	FTNERFPLR
SAVDPVQMK	SAVDPVQMK
ASGIYYVPK	ASGIYYVPK
FVQGIFVEK	FVQGIFVEK
VILLPQPPK	VILLPQPPK
SSLQQGFLK	SSLQQGFLK
TTHQVYVLK	TTHQVYVLK
ILGPNLGDK	ILGPNLGDK
STFSEIFKK	STFSEIFKK
SIVSVGDPK	SIVSVGDPK
ASLPVRNAK	ASLPVRNAK
SVNGIIFVH	SVNGIIFVH
AVYSGISLK	AVYSGISLK
AVVEVVRRK	AVVEVVRRK
SVSTHLITK	SVSTHLITK
AGISFSVKK	AGISFSVKK
IIFSPVAPK	IIFSPVAPK
TLAFITKTI	TLAFITKTI
ATSAVTVTR	ATSAVTVTR
SVEEFQVFK	SVEEFQVFK
LLIYTEFGK	LLIYTEFGK
SILPAIFQK	SILPAIFQK
SSNTFSIKK	SSNTFSIKK
SSVSLPLAK	SSVSLPLAK
AVLLQWHEK	AVLLQWHEK
VAVPLPLHR	VAVPLPLHR
AVLNVSNNR	AVLNVSNNR
SVSEVVVNR	SVSEVVVNR
AVASAAKLG	AVASAAKLG
KSYETEYPK	KSYETEYPK
RSYSDPPLK	RSYSDPPLK
REDIFYTSK	REDIFYTSK
RAAIPIAKR	RAAIPIAKR
ATDKSFVEK	ATDKSFVEK
GTLKDLIYK	GTLKDLIYK
KQDSNPLYK	KQDSNPLYK
ASVGYAVTK	ASVGYAVTK
VVVPPLPGK	VVVPPLPGK
STVGWASQK	STVGWASQK
AVAAFQVEK	AVAAFQVEK
SSLDVNVLK	SSLDVNVLK
ASTTVLALK	ASTTVLALK
SSNIFTVAK	SSNIFTVAK
RTYYSPVYR	RTYYSPVYR
ASSPPAIPK	ASSPPAIPK
TVISLLVYK	TVISLLVYK
VSLWLPVSK	VSLWLPVSK
SGTSEFLNK	SGTSEFLNK
GVIDLVFEK	GVIDLVFEK
VFRDPYRFK	VFRDPYRFK
VGLNVFLEK	VGLNVFLEK
ATSLVFKQK	ATSLVFKQK
SVSGYIYHK	SVSGYIYHK
AAFVPLLLK	AAFVPLLLK
TVFEHTFHV	TVFEHTFHV
VIFEGFFAH	VIFEGFFAH
STVSRFFLY	STVSRFFLY
ASVPAQAPK	ASVPAQAPK
SSFEHEFKK	SSFEHEFKK
ALGAGFSDK	ALGAGFSDK
RSDTPLIYK	RSDTPLIYK
SLFSRLFGK	SLFSRLFGK
ATLNSIVAK	ATLNSIVAK
SVDPNQYYK	SVDPNQYYK
ATEVAPLYK	ATEVAPLYK
GQSDIAITK	GQSDIAITK
RAQDLPLKK	RAQDLPLKK
ATPSSSLPK	ATPSSSLPK
ATATVYFKR	ATATVYFKR
NTMNQFVNK	NTMNQFVNK
AIVNFVNQK	AIVNFVNQK
AVQHFSLLY	AVQHFSLLY
ATFHTPFSH	ATFHTPFSH
AVMEMMSQK	AVMEMMSQK
SSLYIILKK	SSLYIILKK
KTLKWLEKK	KTLKWLEKK
RVSYQKLLK	RVSYQKLLK
ATSPLQENR	ATSPLQENR
VTAPPARNR	VTAPPARNR
SSVGSVITK	SSVGSVITK
GSSASLVLK	GSSASLVLK
VTNDFVMLK	VTNDFVMLK
FPSIVGRPR	FPSIVGRPR
GALPWFLQK	GALPWFLQK
AGPEPLPPK	AGPEPLPPK
TTVPHVFSK	TTVPHVFSK
LRVDPVNFK	LRVDPVNFK
LTMDKLWRK	LTMDKLWRK
AVEDAIARK	AVEDAIARK
YDHQGIFKR	YDHQGIFKR
GVLDFFFQK	GVLDFFFQK
SVSPVVHVR	SVSPVVHVR
MAADRSLKK	MAADRSLKK
SVLNIPMAK	SVLNIPMAK
SALDYNEAK	SALDYNEAK
GTLSSWNLK	GTLSSWNLK
LVIPFTIKK	LVIPFTIKK
SSLPRAFQK	SSLPRAFQK
LVFDVELLK	LVFDVELLK
SIYFPYVLK	SIYFPYVLK
SLLSVLIPK	SLLSVLIPK
VSSPKLAPK	VSSPKLAPK
KVADMALHY	KVADMALHY
ATSIPAILK	ATSIPAILK
AVYKPPGLK	AVYKPPGLK
SAPASQASL	SAPASQASL
ATSEIFASK	ATSEIFASK
SLHTLFGDK	SLHTLFGDK
RVVDLLVIK	RVVDLLVIK
AFAAGADIK	AFAAGADIK
ATASPIVAR	ATASPIVAR
AVELSRVAK	AVELSRVAK
TSIQPGAPK	TSIQPGAPK
SSLPKSFKR	SSLPKSFKR
RIIPRHLQL	RIIPRHLQL
FTAPSTVGK	FTAPSTVGK
FTSPPSLFK	FTSPPSLFK
TTTGHLIYK	TTTGHLIYK
GTLTSAINR	GTLTSAINR
KIYTDFIEK	KIYTDFIEK
GIFPGTPLK	GIFPGTPLK
ISAPVVRPK	ISAPVVRPK
SSFSGLLRK	SSFSGLLRK
SVQAVLVGK	SVQAVLVGK
VVDQPLPVR	VVDQPLPVR
SQNTKPYLK	SQNTKPYLK
SVSKLSTPK	SVSKLSTPK
KTIVFVETK	KTIVFVETK
SQISTSIQK	SQISTSIQK
LVYDVSNPK	LVYDVSNPK
RAVPFNAPK	RAVPFNAPK
AVMNFVVRY	AVMNFVVRY
VSFSDVFFK	VSFSDVFFK
IVSQVKVPK	IVSQVKVPK
PISDIIAIK	PISDIIAIK
SSLNPILFR	SSLNPILFR
ALSTPVVEK	ALSTPVVEK
AVAALDGAK	AVAALDGAK
AAAPVTPLR	AAAPVTPLR
AALDWVTKK	AALDWVTKK
VLGPTPVQK	VLGPTPVQK
RIFDLGRKK	RIFDLGRKK
ATTGKILEK	ATTGKILEK
ASIDFRFGK	ASIDFRFGK
QISEVVVVK	QISEVVVVK
RVLPYPFTH	RVLPYPFTH
LLLAPAVSK	LLLAPAVSK
ASLQSIIHK	ASLQSIIHK
TVIDYNGER	TVIDYNGER
ATLDLNAVK	ATLDLNAVK
QQQSEMFPK	QQQSEMFPK
AGAAVLPVK	AGAAVLPVK
ATQILSVPK	ATQILSVPK
SVSDLAPPR	SVSDLAPPR
SAQSFFENK	SAQSFFENK
GTAEVELKK	GTAEVELKK
VLAPVIDLK	VLAPVIDLK
SATQAVFQK	SATQAVFQK
KAFNVVFEK	KAFNVVFEK
TVNSFTIPK	TVNSFTIPK
GTVYFKEGK	GTVYFKEGK
TTTEPLPEK	TTTEPLPEK
ITQGNMQLK	ITQGNMQLK
KVVKVTIMK	KVVKVTIMK
VGEFSGANK	VGEFSGANK
AALAKAIEK	AALAKAIEK
SVSLPSVKK	SVSLPSVKK
STAKSQFLK	STAKSQFLK
KTFPNTIEH	KTFPNTIEH
AIITPPPAK	AIITPPPAK
ASLTDTVNK	ASLTDTVNK
RLFLLTVHK	RLFLLTVHK
SVIRPPFKK	SVIRPPFKK
AQQKVTLPK	AQQKVTLPK
SLADFQIEK	SLADFQIEK
SVWHGTLSK	SVWHGTLSK
ATTQTIMQK	ATTQTIMQK
VVGAVVFQK	VVGAVVFQK
SILSGGTPK	SILSGGTPK
AIFEISYFK	AIFEISYFK
GISETRIEK	GISETRIEK
RIATGSFLK	RIATGSFLK
TVQEHLIEK	TVQEHLIEK
TVFLSTWNK	TVFLSTWNK
AAAKVILKK	AAAKVILKK
ASSASMPYK	ASSASMPYK
ATLTKDVPK	ATLTKDVPK
VTEGSFVYK	VTEGSFVYK
RVLEHDFPK	RVLEHDFPK
RTQGLMIMK	RTQGLMIMK
ITITNDQNR	ITITNDQNR
ASYEKNLPK	ASYEKNLPK
RVYNIYIRR	RVYNIYIRR
NTMNITISK	NTMNITISK
ASFAFEFPK	ASFAFEFPK
SLSSPLNPK	SLSSPLNPK
GVGEVLHVK	GVGEVLHVK
KIMEYYEKK	KIMEYYEKK
GVSAAFAVK	GVSAAFAVK
DYPLIPVGK	DYPLIPVGK
SIMKWNRER	SIMKWNRER
ATSLGHFTK	ATSLGHFTK
VTVAGLAGK	VTVAGLAGK
EAMEWVIHK	EAMEWVIHK
SVATVVYLR	SVATVVYLR
TTFTKIVNK	TTFTKIVNK
STDNVSITK	STDNVSITK
GSIPRNIPK	GSIPRNIPK
GTPLETIQK	GTPLETIQK
GVAGGSILK	GVAGGSILK
SQQKAFFAK	SQQKAFFAK
SIDEHFQPK	SIDEHFQPK
GTYRDANIK	GTYRDANIK
AVGNIKVTK	AVGNIKVTK
VVVVNPQTK	VVVVNPQTK
KVYNGILEK	KVYNGILEK
TLLGFFLAK	TLLGFFLAK
TIFLMGPVK	TIFLMGPVK
DAHSTLLSK	DAHSTLLSK
RITDPTIDK	RITDPTIDK
VVNSYPLAH	VVNSYPLAH
SVFESLIAK	SVFESLIAK
SVQKPKFPK	SVQKPKFPK
GSVIIFVDK	GSVIIFVDK
SIGDIFLKY	SIGDIFLKY
RTVEDVFLR	RTVEDVFLR
QVMFPVNSK	QVMFPVNSK
QIFLGGVDK	QIFLGGVDK
VVLYPLVAK	VVLYPLVAK
GVADALLYR	GVADALLYR
STYFRVHEK	STYFRVHEK
ISQEPFVPK	ISQEPFVPK
LSLDSYLLK	LSLDSYLLK
IQNDRQLQY	IQNDRQLQY
ATIQGAYAR	ATIQGAYAR
SVAGIFNYY	SVAGIFNYY
QSLEHSWIK	QSLEHSWIK
TSPIIIHRL	TSPIIIHRL
TYDDATKTF	TYDDATKTF
GTGKTLIGK	GTGKTLIGK
AALDKYAKK	AALDKYAKK
LVGPVPAGR	LVGPVPAGR
ATAAGDVIK	ATAAGDVIK
STFNQVVLK	STFNQVVLK
ASIDWLAQR	ASIDWLAQR
AIPGFTINR	AIPGFTINR
ILGATGTGK	ILGATGTGK
TVIQDGIKK	TVIQDGIKK
KTFWQSVSK	KTFWQSVSK
ATVITTEKR	ATVITTEKR
LVMEGHLFK	LVMEGHLFK
FVYEPKEQK	FVYEPKEQK
SVLGQAMEK	SVLGQAMEK
AVIEFLLDK	AVIEFLLDK
ATMEDTVEY	ATMEDTVEY
KVFKQIFSK	KVFKQIFSK
GSLPWQGLK	GSLPWQGLK
QDGITLITK	QDGITLITK
AILDKNFRK	AILDKNFRK
ASLPLAVTK	ASLPLAVTK
AVTFPLKSK	AVTFPLKSK
ADSWKSLGK	ADSWKSLGK
IVGTVLIIK	IVGTVLIIK
SAQNTKFFK	SAQNTKFFK
ATDIPSSQK	ATDIPSSQK
SVLTPLLLR	SVLTPLLLR
VSLGTPIMK	VSLGTPIMK
ASYPEALAK	ASYPEALAK
GTFGKALRR	GTFGKALRR
GTLPVSQPK	GTLPVSQPK
GTFGGLGSK	GTFGGLGSK
AVYTKMMTK	AVYTKMMTK
GSLGFTVTK	GSLGFTVTK
SISSPQPGK	SISSPQPGK
IVAGTLTNK	IVAGTLTNK
SSLFSGILK	SSLFSGILK
GIYAYGFEK	GIYAYGFEK
MAAAAFAEK	MAAAAFAEK
KVQPPGPVK	KVQPPGPVK
LTGPVMPVR	LTGPVMPVR
GVLTSIFKH	GVLTSIFKH
TIDGSVNPK	TIDGSVNPK
SVNNPILRK	SVNNPILRK
IGADSVTLK	IGADSVTLK
AVSSLIRNK	AVSSLIRNK
SGATIRIFK	SGATIRIFK
SQFSLPVQK	SQFSLPVQK
QTMSDTTFK	QTMSDTTFK
QTQSIYIPR	QTQSIYIPR
KTVIEPLKK	KTVIEPLKK
GSYSKAFAR	GSYSKAFAR
GTAQLTLLH	GTAQLTLLH
STFFYPKLK	STFFYPKLK
KTLYPIIGK	KTLYPIIGK
SSVVPSVYK	SSVVPSVYK
VTFVPGLYK	VTFVPGLYK
ATATELTTK	ATATELTTK
STSPEIFRK	STSPEIFRK
RIIGVDINK	RIIGVDINK
GTADVHFER	GTADVHFER
RALDLVAAK	RALDLVAAK
GILTVRHLK	GILTVRHLK
KAGEVFIHK	KAGEVFIHK
GVMTVLIKR	GVMTVLIKR
STLPVTVKK	STLPVTVKK
TAFLLDALK	TAFLLDALK
ATTLPIRNK	ATTLPIRNK
SLFNTGFLK	SLFNTGFLK
SVILPILKK	SVILPILKK
NVGPLIIKK	NVGPLIIKK
ASAPVTVKR	ASAPVTVKR
ATSSVSALK	ATSSVSALK
ASNFKSPVK	ASNFKSPVK
GSYFVKDPK	GSYFVKDPK
IYFMAGSSR	IYFMAGSSR
SIYVYKVLK	SIYVYKVLK
VTWGFPNLK	VTWGFPNLK
HIFMKVFPK	HIFMKVFPK
SSITDPLIK	SSITDPLIK
GTTSDQFLR	GTTSDQFLR
HSMDFVAYR	HSMDFVAYR
RVTDLFIGK	RVTDLFIGK
FVDLYGAQK	FVDLYGAQK
ESYSVYVYK	ESYSVYVYK
ATQERTDLY	ATQERTDLY
AVDQIAFQK	AVDQIAFQK
SIIGVTEPR	SIIGVTEPR
AIMDPLPLR	AIMDPLPLR
ATAPPAPAY	ATAPPAPAY
SSLDVSLQK	SSLDVSLQK
RVGDVYIPR	RVGDVYIPR
YEYGIFNQK	YEYGIFNQK
GTFASGPPK	GTFASGPPK
AVDAEPVLK	AVDAEPVLK
ATSYLWFKK	ATSYLWFKK
AGLQFPVGR	AGLQFPVGR
SVLWPWINR	SVLWPWINR
SVVNSFIEK	SVVNSFIEK
LRPSDPEAK	LRPSDPEAK
QVDPNFYSK	QVDPNFYSK
RIFEPPPPK	RIFEPPPPK
DHDASVYLR	DHDASVYLR
GTNDVGALK	GTNDVGALK
ATLYLGWNR	ATLYLGWNR
ATSRTYLYR	ATSRTYLYR
TVAVPLVGK	TVAVPLVGK
VSMDYAISK	VSMDYAISK
SLMHSFILK	SLMHSFILK
AINDKSIVK	AINDKSIVK
AAYNVPLPK	AAYNVPLPK
GSVLLFVTK	GSVLLFVTK
TTSNFTFSK	TTSNFTFSK
TILEKFKEK	TILEKFKEK
RAYPHVFTK	RAYPHVFTK
AQATISFPK	AQATISFPK
ATIALMIQR	ATIALMIQR
SSAGPGLLK	SSAGPGLLK
ATLHHVIDK	ATLHHVIDK
SLFNTIQAL	SLFNTIQAL
SVLEVVSEK	SVLEVVSEK
KTYKENFLK	KTYKENFLK
LTYEFVKQK	LTYEFVKQK
SVMAQVRQK	SVMAQVRQK
VSQEPFPNK	VSQEPFPNK
ASMAIKNPK	ASMAIKNPK
RLQEIFTEK	RLQEIFTEK
TISPPLQPK	TISPPLQPK
ASAYSIAQK	ASAYSIAQK
KTSNLLLSH	KTSNLLLSH
QTAADAFYK	QTAADAFYK
KVLHFFNVK	KVLHFFNVK
SAFYVPFAK	SAFYVPFAK
AVGPKVALK	AVGPKVALK
GSTHVLTPK	GSTHVLTPK
VTGPNMGGK	VTGPNMGGK
ATFPLSVQK	ATFPLSVQK
IISTVEVLK	IISTVEVLK
SVMELARLK	SVMELARLK
STVPPSLRK	STVPPSLRK
SVAQLLLSK	SVAQLLLSK
STFSATWNR	STFSATWNR
STDPSVLGK	STDPSVLGK
ATTSLSLRR	ATTSLSLRR
NSMGLFLQK	NSMGLFLQK
SIFKQPVTK	SIFKQPVTK
SVELPIVGK	SVELPIVGK
GSQFFITTK	GSQFFITTK
AVFASEVKK	AVFASEVKK
AAPATRAAL	AAPATRAAL
RTDFTPHWK	RTDFTPHWK
RIIDLVLQK	RIIDLVLQK
TSLPPLPFK	TSLPPLPFK
SAVLFTITK	SAVLFTITK
ASHYIHIVK	ASHYIHIVK
GTIKDIVTR	GTIKDIVTR
ATSGVVAVR	ATSGVVAVR
RLVRWLLKK	RLVRWLLKK
SAFGQAFSK	SAFGQAFSK
AAYAWPFYK	AAYAWPFYK
SVMRLTISY	SVMRLTISY
KITDFLQTK	KITDFLQTK
ATGPPNTSY	ATGPPNTSY
SVLNFATNR	SVLNFATNR
SVLESVKEK	SVLESVKEK
FDDFSHYEK	FDDFSHYEK
RQFWTRTKK	RQFWTRTKK
ASYVSPVLK	ASYVSPVLK
AVIESFVNH	AVIESFVNH
AVLDLSWNK	AVLDLSWNK
VGPPGRSSL	VGPPGRSSL
AVDVSPLRR	AVDVSPLRR
VSLGLVVSK	VSLGLVVSK
ATVAALQEK	ATVAALQEK
GTYHGMTLK	GTYHGMTLK
ATDYPLIAR	ATDYPLIAR
GAIKVFVNK	GAIKVFVNK
GVLAWVKEK	GVLAWVKEK
STLHHVLQR	STLHHVLQR
VTISHAIGR	VTISHAIGR
ATADVVILY	ATADVVILY
EQGYDVIAY	EQGYDVIAY
MIFRNQVPK	MIFRNQVPK
LHVDPENFR	LHVDPENFR
GTWSTGLPK	GTWSTGLPK
GQHTVLLVK	GQHTVLLVK
HVYKERFPK	HVYKERFPK
KSIGDIFLK	KSIGDIFLK
ATVNEIVLK	ATVNEIVLK
TSLDKFYRK	TSLDKFYRK
RSLDTHVTK	RSLDTHVTK
GQSPFQQRK	GQSPFQQRK
KVMDLSIVR	KVMDLSIVR
STFDTQITK	STFDTQITK
VGGLDIHKK	VGGLDIHKK
LQAEIEGLK	LQAEIEGLK
ATQQDVFQH	ATQQDVFQH
ASDPHIIIK	ASDPHIIIK
KTIQVPQQK	KTIQVPQQK
LVSPITGEK	LVSPITGEK
VLVLHSLPL	VLVLHSLPL
SVSSVSTLK	SVSSVSTLK
RIQDLSLLY	RIQDLSLLY
TSGAAVIKQ	TSGAAVIKQ
IIIKPLPGY	IIIKPLPGY
STNWSDVGK	STNWSDVGK
AVLPTPVTK	AVLPTPVTK
IAQPQLPPK	IAQPQLPPK
TVTEVLLKY	TVTEVLLKY
GVAPALAPK	GVAPALAPK
TAFENAYLK	TAFENAYLK
STLAVTSQK	STLAVTSQK
GSVYITLKK	GSVYITLKK
WLNENAVEK	WLNENAVEK
KVVNPLFEK	KVVNPLFEK
GVTSQFVSK	GVTSQFVSK
IVTPATILK	IVTPATILK
ATPNEIFLK	ATPNEIFLK
GVVPFSQRK	GVVPFSQRK
AVAPPAGPR	AVAPPAGPR
GVMSPPLSR	GVMSPPLSR
DYSVTANSK	DYSVTANSK
VTISSIEKK	VTISSIEKK
SIFPYVTTK	SIFPYVTTK
VTISSVEKK	VTISSVEKK
AIFEIVLNR	AIFEIVLNR
VTMPATETK	VTMPATETK
RTNWPNTGK	RTNWPNTGK
AVQVPVKGR	AVQVPVKGR
LLPELSVLA	LLPELSVLA
LPPLSPYFK	LPPLSPYFK
VIFKDFVNK	VIFKDFVNK
KVQEYPTLK	KVQEYPTLK
ASNPATFQR	ASNPATFQR
RVFNIMREK	RVFNIMREK
GTFSRLFQK	GTFSRLFQK
SSLKGGLLK	SSLKGGLLK
KTSPLNFKK	KTSPLNFKK
KVIDPVTGK	KVIDPVTGK
GTLDSVLRY	GTLDSVLRY
AVNLADPYR	AVNLADPYR
YDRPGASPK	YDRPGASPK
AVFQIILRR	AVFQIILRR
FVHDNYVIR	FVHDNYVIR
VTYEHLITK	VTYEHLITK
ELSEPSSTR	ELSEPSSTR
ATLHSFDVK	ATLHSFDVK
VSMLNVYLK	VSMLNVYLK
AVAHALTEK	AVAHALTEK
STMPGLPTR	STMPGLPTR
MVFGAPVPK	MVFGAPVPK
GTYQDRLTK	GTYQDRLTK
GVFEGHTSK	GVFEGHTSK
ATQLLKLAH	ATQLLKLAH
SSFSSPHMK	SSFSSPHMK
VVGPVSLPR	VVGPVSLPR
ATITKVLQK	ATITKVLQK
GLGPLVPGK	GLGPLVPGK
SVGSVITKK	SVGSVITKK
TVFENLINK	TVFENLINK
GTLIDNQFK	GTLIDNQFK
RIQDVLFLY	RIQDVLFLY
SIWDYFIAK	SIWDYFIAK
STAAFFLLR	STAAFFLLR
TVSADPVVK	TVSADPVVK
TASPPPPPK	TASPPPPPK
AALKVLPPT	AALKVLPPT
ITVAYTIPK	ITVAYTIPK
GTYDILVTK	GTYDILVTK
GVAFIFNQK	GVAFIFNQK
STLTGVWKK	STLTGVWKK
QTYGQQLQK	QTYGQQLQK
STIFYYVQK	STIFYYVQK
AIFTKAYQR	AIFTKAYQR
AAATPAIKK	AAATPAIKK
ATAGFTIGR	ATAGFTIGR
QTFLLQTTK	QTFLLQTTK
VVGLPNVGK	VVGLPNVGK
SDQFPLPLK	SDQFPLPLK
VAYHQPTLK	VAYHQPTLK
GVVRIYHRK	GVVRIYHRK
RTLEPLAKK	RTLEPLAKK
TQMGPVAAK	TQMGPVAAK
ATLDRQLNH	ATLDRQLNH
SAAAALVLK	SAAAALVLK
AVQEIMQEK	AVQEIMQEK
GSLFLQTPK	GSLFLQTPK
ASMPVDIAK	ASMPVDIAK
STNSFALNK	STNSFALNK
KIIAPLVTR	KIIAPLVTR
SVINVFVGR	SVINVFVGR
TVLRPSLGK	TVLRPSLGK
STIEYVIQR	STIEYVIQR
SLMSVLIPK	SLMSVLIPK
SITSEVFNK	SITSEVFNK
SVDPKNYPK	SVDPKNYPK
SVLEPGTAK	SVLEPGTAK
STLRDLIFK	STLRDLIFK
SAPSRATAL	SAPSRATAL
SSAPPLTGK	SSAPPLTGK
TAAGTLIAK	TAAGTLIAK
ATFPVAPRY	ATFPVAPRY
SVYVYKVLK	SVYVYKVLK
SVVPSVILK	SVVPSVILK
ATFQFTVER	ATFQFTVER
GVADKILKK	GVADKILKK
NAPWAVTSL	NAPWAVTSL
KVIDLSVNK	KVIDLSVNK
GTINIVHPK	GTINIVHPK
RVFPWFSVK	RVFPWFSVK
SVFSKYFER	SVFSKYFER
VAVDVAVPK	VAVDVAVPK
AVQRTLLEK	AVQRTLLEK
ATYTPQAPK	ATYTPQAPK
GTQPYFFNK	GTQPYFFNK
GAYDGKFEK	GAYDGKFEK
GSLFLRTPK	GSLFLRTPK
ATSQTLLAK	ATSQTLLAK
GFLPPASEK	GFLPPASEK
SITSVFITK	SITSVFITK
IVFMPVIGK	IVFMPVIGK
LLADQAEAR	LLADQAEAR
AVIWPQYVK	AVIWPQYVK
RTIAPIIGR	RTIAPIIGR
GTNFTKLEK	GTNFTKLEK
SILNWVKFK	SILNWVKFK
RVFLRAINK	RVFLRAINK
AVTAFVTFR	AVTAFVTFR
TVDLPKSPK	TVDLPKSPK
SVESIISPK	SVESIISPK
AVYDFFIGR	AVYDFFIGR
AAATSVLKT	AAATSVLKT
VVADISVAK	VVADISVAK
LLLEGVENK	LLLEGVENK
ASAIPAYSK	ASAIPAYSK
ATSAFQTQK	ATSAFQTQK
TSSQPVIAK	TSSQPVIAK
GSGKVTFPK	GSGKVTFPK
ATIVDLVER	ATIVDLVER
RVMGIRVLR	RVMGIRVLR
SVLPWIILH	SVLPWIILH
STSENITQK	STSENITQK
TILDELVQR	TILDELVQR
KAFVGAFKK	KAFVGAFKK
SSFGNMIYK	SSFGNMIYK
ATSKVALVY	ATSKVALVY
ATLGAILNR	ATLGAILNR
ASLIRLVPK	ASLIRLVPK
ATNIDEIYK	ATNIDEIYK
STEKIYIRK	STEKIYIRK
IINNKNFHK	IINNKNFHK
ASYTKIVVK	ASYTKIVVK
RAAPFSLEY	RAAPFSLEY
STLLNPIPK	STLLNPIPK
AVLPPQPLK	AVLPPQPLK
SLMPWFHGK	SLMPWFHGK
KVLFPLLTK	KVLFPLLTK
AVYLLPVPK	AVYLLPVPK
GVIVHIIEK	GVIVHIIEK
KQFSKRYLK	KQFSKRYLK
AIDQLHLEY	AIDQLHLEY
LVVYPWTQR	LVVYPWTQR
GTYSKIMNH	GTYSKIMNH
LLIFGALLK	LLIFGALLK
RQIPYTMMK	RQIPYTMMK
SVDRPIIDR	SVDRPIIDR
KIYNANYLK	KIYNANYLK
ESTLHLVLR	ESTLHLVLR
HTLEPLIPR	HTLEPLIPR
KVSGDIFSR	KVSGDIFSR
ATFLIQLER	ATFLIQLER
SQGTTKQLP	SQGTTKQLP
AVVEKIHAK	AVVEKIHAK
VVFEKAIQR	VVFEKAIQR
ALFDGVVSK	ALFDGVVSK
AIFPRAFPK	AIFPRAFPK
AIVKLFLKK	AIVKLFLKK
SVFNHAIRH	SVFNHAIRH
AISEYIATK	AISEYIATK
ALASLMTYK	ALASLMTYK
AQYEEIANR	AQYEEIANR
LVEIAQVPK	LVEIAQVPK
ATYPYQVVR	ATYPYQVVR
SVMGVTVSR	SVMGVTVSR
GSIGSSFPR	GSIGSSFPR
SVDKIVIQK	SVDKIVIQK
AVGDTPIMK	AVGDTPIMK
ETAEAYLGK	ETAEAYLGK
RVTYPAKAK	RVTYPAKAK
GTVTKVIPK	GTVTKVIPK
ASLQSVVHK	ASLQSVVHK
KTFPYQHRY	KTFPYQHRY
VVFVTKFLY	VVFVTKFLY
VTSTSLTIK	VTSTSLTIK
ASLGNLFAR	ASLGNLFAR
GTQSKAFYK	GTQSKAFYK
VVQEVLSIK	VVQEVLSIK
VVSEVDIAK	VVSEVDIAK
GVFPDNFVK	GVFPDNFVK
KTIDASVSK	KTIDASVSK
GTLEQWIEK	GTLEQWIEK
GYLLQIFTK	GYLLQIFTK
QVADAFLSK	QVADAFLSK
RVNVTGIYR	RVNVTGIYR
STYFKKLFK	STYFKKLFK
ATIEELTEK	ATIEELTEK
SSHLPPPPK	SSHLPPPPK
TTFSPSISK	TTFSPSISK
ITPTGTHPL	ITPTGTHPL
ALAVSDLNR	ALAVSDLNR
ATPPFTHSK	ATPPFTHSK
DLEGSYYLR	DLEGSYYLR
SVISSPLLK	SVISSPLLK
GVLEKPLEK	GVLEKPLEK
LGLTEAQTR	LGLTEAQTR
ATLNSFIHV	ATLNSFIHV
VVPEPGQPL	VVPEPGQPL
ASVYQPLKK	ASVYQPLKK
KVVDSLYNK	KVVDSLYNK
ASQLVGIEK	ASQLVGIEK
TSLPWQGLK	TSLPWQGLK
RIQLPVVSK	RIQLPVVSK
TVNTMNLPK	TVNTMNLPK
AVADSVLTK	AVADSVLTK
AVVVNPSVK	AVVVNPSVK
ASSEDTLLK	ASSEDTLLK
ISEQPLPNK	ISEQPLPNK
VTSTFIIEK	VTSTFIIEK
LNLQEYQSK	LNLQEYQSK
TIFGKIIRK	TIFGKIIRK
QAADILLYK	QAADILLYK
NAIKWNFTK	NAIKWNFTK
MPKDIQLAR	MPKDIQLAR
TVGDVLEAK	TVGDVLEAK
TTFPESHLR	TTFPESHLR
SSLQPLPPR	SSLQPLPPR
RTYDMIQYY	RTYDMIQYY
SILDEVIFK	SILDEVIFK
RIYDIFRSK	RIYDIFRSK
GTLNQPLTK	GTLNQPLTK
SVQGIIIYR	SVQGIIIYR
MGDAPDYDR	MGDAPDYDR
DPNVSKKLK	DPNVSKKLK
VTLTTQHVK	VTLTTQHVK
SIQHPLIKK	SIQHPLIKK
SVNNSIFYR	SVNNSIFYR
KVYTPSISK	KVYTPSISK
AVSSFVFLR	AVSSFVFLR
ATLETILRH	ATLETILRH
FLSAVFFAK	FLSAVFFAK
ATIIDILEY	ATIIDILEY
GTLPKALTK	GTLPKALTK
TTQQQLPQK	TTQQQLPQK
SVLDLSVHK	SVLDLSVHK
PEFPLSPPK	PEFPLSPPK
LVMTHLILK	LVMTHLILK
RVYGGLTTK	RVYGGLTTK
RVITALVER	RVITALVER
TTGEPATPK	TTGEPATPK
AAPNGAEPL	AAPNGAEPL
SLPYPPKTL	SLPYPPKTL
YFAERVTSL	YFAERVTSL
SNYNLPMHK	SNYNLPMHK
TVIHFNNPK	TVIHFNNPK
KTLPYPLKK	KTLPYPLKK
SVLQGLLKK	SVLQGLLKK
NTITPVVGK	NTITPVVGK
IVYPPPPAK	IVYPPPPAK
RTSEIYVHR	RTSEIYVHR
ELMQTPNFR	ELMQTPNFR
VAGTPAPPK	VAGTPAPPK
VVMRDPQTK	VVMRDPQTK
ATIGAALGR	ATIGAALGR
STPETPLTK	STPETPLTK
QTVAVGVIK	QTVAVGVIK
GILKPLPKK	GILKPLPKK
LVSTPVRTK	LVSTPVRTK
SSLPTQLFK	SSLPTQLFK
SAIRERFPK	SAIRERFPK
YILSPLSYK	YILSPLSYK
ASVETGFAK	ASVETGFAK
KTQEPFSVR	KTQEPFSVR
QTAGNVFLK	QTAGNVFLK
KVLDHFRRK	KVLDHFRRK
KVQTAVTMK	KVQTAVTMK
AQADPLVRR	AQADPLVRR
RVPDVVLIK	RVPDVVLIK
VVAQEPLHR	VVAQEPLHR
DGLTDVYNK	DGLTDVYNK
LLLPGELAK	LLLPGELAK
AVNLHPIRK	AVNLHPIRK
SIIETLRQK	SIIETLRQK
AILDYLITK	AILDYLITK
GIYSVIQKK	GIYSVIQKK
GTSPPLTPR	GTSPPLTPR
GIADFVLKY	GIADFVLKY
LAGQGELNR	LAGQGELNR
TVPRRLGPK	TVPRRLGPK
ATIVYHLAR	ATIVYHLAR
STIPPELVK	STIPPELVK
RLADSLIGK	RLADSLIGK
VVGPAAEAK	VVGPAAEAK
STSVPENPK	STSVPENPK
VVMRDPNTK	VVMRDPNTK
ATVKEQIVK	ATVKEQIVK
STFVLDEFK	STFVLDEFK
FTFFIHNPK	FTFFIHNPK
ALFEIALRK	ALFEIALRK
SVIKNVSTK	SVIKNVSTK
ASFDKAKLK	ASFDKAKLK
LALEGSLQK	LALEGSLQK
STLPKSLLK	STLPKSLLK
IVIPPATEK	IVIPPATEK
TVLSKLTRK	TVLSKLTRK
ATSPVVYTR	ATSPVVYTR
SVMDHHFRK	SVMDHHFRK
KTMPTTFNR	KTMPTTFNR
VTQAPISAR	VTQAPISAR
ASFFGVHPK	ASFFGVHPK
EEEVNNLVK	EEEVNNLVK
SVQVMALKK	SVQVMALKK
VIQDPMGQK	VIQDPMGQK
ATFFGEVVK	ATFFGEVVK
QAQEVFFLK	QAQEVFFLK
STLSPIAPR	STLSPIAPR
SAPVGVTAL	SAPVGVTAL
ATVDIVQKK	ATVDIVQKK
VAPLPRSAL	VAPLPRSAL
SSLFSLLSK	SSLFSLLSK
ATVLTSVKK	ATVLTSVKK
RTIDRSVFK	RTIDRSVFK
HTYYKFDYK	HTYYKFDYK
STMDLVKSK	STMDLVKSK
KSHFIVALK	KSHFIVALK
AVLPAVIPK	AVLPAVIPK
ATVYLIYLK	ATVYLIYLK
ATSAPLVSR	ATSAPLVSR
SSGPSTPLK	SSGPSTPLK
SAFSTSISK	SAFSTSISK
STFSAPLNK	STFSAPLNK
YFGIYDTAK	YFGIYDTAK
SSYREAVFK	SSYREAVFK
KTETNVYFK	KTETNVYFK
GVLGPIINK	GVLGPIINK
GSSTPLIPK	GSSTPLIPK
VISPPTVPK	VISPPTVPK
ATQSFSTFR	ATQSFSTFR
STAAYQPIK	STAAYQPIK
AVIEDTWHY	AVIEDTWHY
KVSDLTIPK	KVSDLTIPK
ASNPAMLLY	ASNPAMLLY
GTSGLILKR	GTSGLILKR
RIIDEVVNK	RIIDEVVNK
AVSAVVHEY	AVSAVVHEY
SVNLKVSPK	SVNLKVSPK
ASDPTVFHK	ASDPTVFHK
TVSEPAVIK	TVSEPAVIK
RTLPVLLLY	RTLPVLLLY
QAFAQVFNK	QAFAQVFNK
YLYITKVLK	YLYITKVLK
GSLQLPPPR	GSLQLPPPR
ATISFPKRK	ATISFPKRK
VTLDQVLLR	VTLDQVLLR
FSPFHASVL	FSPFHASVL
STMEGGTLK	STMEGGTLK
SSSGISISK	SSSGISISK
TVATFILQK	TVATFILQK
ATNRSVYFK	ATNRSVYFK
GTDEPIFGK	GTDEPIFGK
ATLQEALAH	ATLQEALAH
AMLDTVVFK	AMLDTVVFK
AGMALGIQK	AGMALGIQK
ATLAAVLQR	ATLAAVLQR
ATATLIIEH	ATATLIIEH
SVSEVIEGY	SVSEVIEGY
AVYVPFWQK	AVYVPFWQK
LTEAPLNPK	LTEAPLNPK
KSLEAFFLY	KSLEAFFLY
GIDIERALK	GIDIERALK
GTLERGILK	GTLERGILK
TFRPPYYHR	TFRPPYYHR
SIPGGYNAL	SIPGGYNAL
AQMEGFLNR	AQMEGFLNR
ALLVKQPPP	ALLVKQPPP
SSSSPTFPK	SSSSPTFPK
GIATTFINK	GIATTFINK
KTLNIFLTK	KTLNIFLTK
VVYQYWNTK	VVYQYWNTK
VSFPIGIYK	VSFPIGIYK
KIADMGHLK	KIADMGHLK
TLLDKYWTK	TLLDKYWTK
EFAEEQLRA	EFAEEQLRA
VVAAVMWRK	VVAAVMWRK
AVAAAAYYR	AVAAAAYYR
STITKAWKK	STITKAWKK
ATYGLNVER	ATYGLNVER
SIISVLPWK	SIISVLPWK
LGSGGLRLA	LGSGGLRLA
STASELSPK	STASELSPK
SVVSDILFK	SVVSDILFK
DLGFFGIYK	DLGFFGIYK
RAFDSAVAK	RAFDSAVAK
ASQELWLNH	ASQELWLNH
GLQTSQDAR	GLQTSQDAR
SVYVLVRQK	SVYVLVRQK
IPPELVKQK	IPPELVKQK
KVIDPVAPR	KVIDPVAPR
ILAGDVKVK	ILAGDVKVK
VTSEVPFSK	VTSEVPFSK
VGIDIFTGK	VGIDIFTGK
PLSDALLNK	PLSDALLNK
KSIQSGPLK	KSIQSGPLK
GTVLFEIKK	GTVLFEIKK
TLSDYNIQK	TLSDYNIQK
TVEDVFLRK	TVEDVFLRK
KVIGIAIMK	KVIGIAIMK
AAGPPGPFR	AAGPPGPFR
GTTKVDALK	GTTKVDALK
QEDPDYGIR	QEDPDYGIR
KAPSAARSL	KAPSAARSL
SSVPLLNSK	SSVPLLNSK
ATIKMTVER	ATIKMTVER
GDGLIELRK	GDGLIELRK
VIMNSLITK	VIMNSLITK
LIIYDDLSK	LIIYDDLSK
GSMEPGFAK	GSMEPGFAK
TVYEEMMAK	TVYEEMMAK
SGIQVRYLK	SGIQVRYLK
AVGPHLTAK	AVGPHLTAK
GVYDVVELK	GVYDVVELK
ATTPSVTVK	ATTPSVTVK
SIWDETLYK	SIWDETLYK
RTSIPVHSK	RTSIPVHSK
AILLPQPLK	AILLPQPLK
TLFYLGKRK	TLFYLGKRK
VVAPRLNSR	VVAPRLNSR
VTAVPTLLK	VTAVPTLLK
AVAAFVLYK	AVAAFVLYK
KVYGPGVAK	KVYGPGVAK
ATIEDILFK	ATIEDILFK
SLFGSPVAK	SLFGSPVAK
ETFSGVYKK	ETFSGVYKK
AVVDIYHSR	AVVDIYHSR
SSLSLFFRK	SSLSLFFRK
GSLKQFLKK	GSLKQFLKK
STEPPYSQK	STEPPYSQK
STSQTFIYK	STSQTFIYK
AVMETLLQR	AVMETLLQR
AVIENLPKK	AVIENLPKK
HVFELVLPK	HVFELVLPK
VVINYSIVK	VVINYSIVK
SAAPSKPAL	SAAPSKPAL
RVHSIFVLR	RVHSIFVLR
GTQVYSPEK	GTQVYSPEK
GAQPPSILK	GAQPPSILK
SSQSLSFPK	SSQSLSFPK
RIGNFIVKK	RIGNFIVKK
GTQFFEIRK	GTQFFEIRK
RVIDILRGK	RVIDILRGK
GTLDYILQR	GTLDYILQR
SVQKPLDYY	SVQKPLDYY
SSIFVAPRK	SSIFVAPRK
ISYPLHHPK	ISYPLHHPK
KMYEEFLSK	KMYEEFLSK
ATIMGVRFK	ATIMGVRFK
TSQPFQVLK	TSQPFQVLK
SVSTPLIIK	SVSTPLIIK
ASVILPILK	ASVILPILK
ASSTPTPIR	ASSTPTPIR
KIFSGVFVK	KIFSGVFVK
YIIKEHFEK	YIIKEHFEK
SVLAETIKK	SVLAETIKK
SVFGTMPLK	SVFGTMPLK
SAMESFIEK	SAMESFIEK
AVYDVVRNR	AVYDVVRNR
AGISFIIKR	AGISFIIKR
RILLPIVQK	RILLPIVQK
LVYNGVYQY	LVYNGVYQY
AQNEPLTQK	AQNEPLTQK
RQVIPIIGK	RQVIPIIGK
STLNVGVNK	STLNVGVNK
SSVKAVILK	SSVKAVILK
SILQERVKK	SILQERVKK
NYTDNELEK	NYTDNELEK
FNPFVTSDR	FNPFVTSDR
GLMGFIVYK	GLMGFIVYK
GVFGFPLGR	GVFGFPLGR
NEEILNSLK	NEEILNSLK
QVIPASEPK	QVIPASEPK
GTSTGIISK	GTSTGIISK
STAPAQLGK	STAPAQLGK
SVPLPISHK	SVPLPISHK
AVAIPSWGK	AVAIPSWGK
SIFHLTEKK	SIFHLTEKK
RVQVVGTYR	RVQVVGTYR
KAPAPRPSL	KAPAPRPSL
ATFTNVFGK	ATFTNVFGK
AVLSFSLYR	AVLSFSLYR
ATLEETLVK	ATLEETLVK
AQFIPKFFK	AQFIPKFFK
SSMFGTLPR	SSMFGTLPR
SVTNVSVAK	SVTNVSVAK
STVLPLYAK	STVLPLYAK
AVLLPQPPK	AVLLPQPPK
QVQAAQFAK	QVQAAQFAK
ATIQNETPK	ATIQNETPK
ATQFENWYK	ATQFENWYK
GTSSLFIYK	GTSSLFIYK
LPALKQTPK	LPALKQTPK
ATGESIAVK	ATGESIAVK
AVATKFVNK	AVATKFVNK
RLQEETLTK	RLQEETLTK
SVLRELFKK	SVLRELFKK
ASLTNPFGK	ASLTNPFGK
SSSPPILTK	SSSPPILTK
VVTEHLINK	VVTEHLINK
KTFNSPNLK	KTFNSPNLK
STDSDSFVK	STDSDSFVK
AVMVHQLSK	AVMVHQLSK
AVLLVFANK	AVLLVFANK
SLTPVTPQK	SLTPVTPQK
VTISFRIYK	VTISFRIYK
TTNDIVISK	TTNDIVISK
VTFEKQWFY	VTFEKQWFY
ATVAGVHVK	ATVAGVHVK
KTETPIVSK	KTETPIVSK
AGISKRWPK	AGISKRWPK
ASATALVSR	ASATALVSR
FLYAFIGVK	FLYAFIGVK
AVLPSVLNK	AVLPSVLNK
LYETPTGWK	LYETPTGWK
AVEGTPLPK	AVEGTPLPK
SSPQAGSSL	SSPQAGSSL
AIMPYGVYK	AIMPYGVYK
RLNHYVLYK	RLNHYVLYK
SVQVFGRKK	SVQVFGRKK
ETMNIFLEK	ETMNIFLEK
VSQLPLTER	VSQLPLTER
LEETLVKKK	LEETLVKKK
RVLSLIGLK	RVLSLIGLK
AVTDAIMSR	AVTDAIMSR
TVYRGLVQK	TVYRGLVQK
AVISRTMNR	AVISRTMNR
ASLADIMAK	ASLADIMAK
GKATRKNQK	GKATRKNQK
ATALEYVYK	ATALEYVYK
ATFTGILGK	ATFTGILGK
KQQTIPLKK	KQQTIPLKK
SSYPNPVAH	SSYPNPVAH
SVQAPEVAK	SVQAPEVAK
VNFAMNVGK	VNFAMNVGK
ATSDMDIGK	ATSDMDIGK
KILEVHIDK	KILEVHIDK
RVKLPSGSK	RVKLPSGSK
KAVDITTPK	KAVDITTPK
VVYEFSTTK	VVYEFSTTK
EYQELMNVK	EYQELMNVK
AVMPDGQFK	AVMPDGQFK
STVEAFFKK	STVEAFFKK
RVAELILHH	RVAELILHH
RDVLPFTLK	RDVLPFTLK
RVTLELGGK	RVTLELGGK
GTGNLGFPK	GTGNLGFPK
GLGEPLALK	GLGEPLALK
ITVGDIGPK	ITVGDIGPK
ATFSSSHRY	ATFSSSHRY
EDAANNYAR	EDAANNYAR
KTNLTSVTK	KTNLTSVTK
LVQGSILKK	LVQGSILKK
VTNQPVTPK	VTNQPVTPK
KNMEKPGLK	KNMEKPGLK
GTTHNFLYK	GTTHNFLYK
SSFGTILRK	SSFGTILRK
SLQELFLAH	SLQELFLAH
STSRVRLFY	STSRVRLFY
ATQAHSLSY	ATQAHSLSY
QPLVVIPPK	QPLVVIPPK
ATQTQFFHV	ATQTQFFHV
VVEGSFVYK	VVEGSFVYK
SVVSSVTTK	SVVSSVTTK
RSFEEAFQK	RSFEEAFQK
VTLELAVYK	VTLELAVYK
ASIDATYAK	ASIDATYAK
ADEAYLIGR	ADEAYLIGR
SIMDFNSEK	SIMDFNSEK
AAIATIKTK	AAIATIKTK
TVLGYFIGR	TVLGYFIGR
QVFQKSLPK	QVFQKSLPK
QIFNGTFVK	QIFNGTFVK
SIVEKIQAK	SIVEKIQAK
GTLPAKLLK	GTLPAKLLK
LYDASFETK	LYDASFETK
SLAEILLKK	SLAEILLKK
IEANEALVK	IEANEALVK
LINAFHTPK	LINAFHTPK
GVDDKFYSK	GVDDKFYSK
HAVPPLVPK	HAVPPLVPK
SVLSYTSVR	SVLSYTSVR
VVDPVVREK	VVDPVVREK
GANIPVTEK	GANIPVTEK
GSLDQVLKK	GSLDQVLKK
SLQPSISQK	SLQPSISQK
SVSDQFYRY	SVSDQFYRY
AVLDYVMTR	AVLDYVMTR
GSMLGSVEK	GSMLGSVEK
KKKPQLPPK	KKKPQLPPK
AVNNIRLIK	AVNNIRLIK
QLFYLPAKK	QLFYLPAKK
SIINPPIAK	SIINPPIAK
VVDPHSFPR	VVDPHSFPR
AQIKEHLLK	AQIKEHLLK
ATEQPLTAK	ATEQPLTAK
YIDQEELNK	YIDQEELNK
SSGDIFLEK	SSGDIFLEK
ATQAVFQKR	ATQAVFQKR
GTSQLYVYR	GTSQLYVYR
MVANLLYEK	MVANLLYEK
QITLPTVQK	QITLPTVQK
ANTFVAELK	ANTFVAELK
SVDLPKHAK	SVDLPKHAK
SVLSPLLNK	SVLSPLLNK
GTTAYISLK	GTTAYISLK
GTPETSFNK	GTPETSFNK
GTLASVYHK	GTLASVYHK
SSSNPIPTK	SSSNPIPTK
RVYIHPFHL	RVYIHPFHL
DIFQEIYDK	DIFQEIYDK
ATAELIMSR	ATAELIMSR
AQATVLHLK	AQATVLHLK
VTSQVSNLK	VTSQVSNLK
AQINSVFNK	AQINSVFNK
THILLFLPK	THILLFLPK
TIAPALVSK	TIAPALVSK
ASLGFLVAK	ASLGFLVAK
LGIPLPEIK	LGIPLPEIK
YRPSKNLDK	YRPSKNLDK
RLMEIYQEK	RLMEIYQEK
SSIRHMIRK	SSIRHMIRK
TSLSVSTPK	TSLSVSTPK
ITSPVVTQK	ITSPVVTQK
AVIEHLKQK	AVIEHLKQK
TVILPIKKK	TVILPIKKK
KTVEPLEYY	KTVEPLEYY
GAIEKTFTK	GAIEKTFTK
RVLEAIQKK	RVLEAIQKK
QVYIPTYTK	QVYIPTYTK
AILLPQPPK	AILLPQPPK
IVFVTGNAK	IVFVTGNAK
ATYSVGMQK	ATYSVGMQK
KIADFGLAR	KIADFGLAR
VVDIPIVEK	VVDIPIVEK
RIIEKVIHR	RIIEKVIHR
VVINFDFPK	VVINFDFPK
VVPEPGTSL	VVPEPGTSL
LTTAVITNK	LTTAVITNK
ATGKLFAVK	ATGKLFAVK
ATYRDWISK	ATYRDWISK
AILTSLIEK	AILTSLIEK
SIMSSHVMK	SIMSSHVMK
AVTRFIEEK	AVTRFIEEK
ATFPGMWER	ATFPGMWER
SAGPPSLRK	SAGPPSLRK
KVLDKLLLY	KVLDKLLLY
SSSNVRVIK	SSSNVRVIK
SQGTPISLK	SQGTPISLK
KVVNLPFEK	KVVNLPFEK
MNLGVGAYR	MNLGVGAYR
QIYTYFVYK	QIYTYFVYK
AVDSQILPK	AVDSQILPK
VSYVGYFTK	VSYVGYFTK
GTFEYIRHK	GTFEYIRHK
AIVAYGLYK	AIVAYGLYK
SALNFPFAR	SALNFPFAR
KVFAGYYTK	KVFAGYYTK
HIAEPNYGK	HIAEPNYGK
GLVPAAPPK	GLVPAAPPK
AAFGGTFKK	AAFGGTFKK
QTLSPQMWK	QTLSPQMWK
ATFYGPVKK	ATFYGPVKK
ATATQLLQH	ATATQLLQH
ASWGGTIEK	ASWGGTIEK
ATESGMLYH	ATESGMLYH
TTMQALAEK	TTMQALAEK
AVYEINVLR	AVYEINVLR
ASVKAIFSK	ASVKAIFSK
ATINYSLLR	ATINYSLLR
STSPYFLEH	STSPYFLEH
KQFENPIIK	KQFENPIIK
KTLQDIVYK	KTLQDIVYK
GTDPRTILK	GTDPRTILK
GTSSAVSLK	GTSSAVSLK
