Data	Data aligned
LSLSNLDFR	LSLSNLDFR
ALKLSWFKK	ALKLSWFKK
TFQLLNMIK	TFQLLNMIK
GFPFFIMPK	GFPFFIMPK
RLNAILLLY	RLNAILLLY
MTLVPVLEK	MTLVPVLEK
KQIRSAAKK	KQIRSAAKK
YYQLCQHLK	YYQLCQHLK
YSSMTSDSK	YSSMTSDSK
GTQCALTRR	GTQCALTRR
RVYANLGER	RVYANLGER
KLITPNYMK	KLITPNYMK
TSTGNYNYK	TSTGNYNYK
KMLTFDVFR	KMLTFDVFR
MTMRRRLFK	MTMRRRLFK
AVDLSHFLK	AVDLSHFLK
VTNPAVLRK	VTNPAVLRK
NSINNQLMY	NSINNQLMY
RANNNRLPK	RANNNRLPK
IINFTISMR	IINFTISMR
SVDIETAIR	SVDIETAIR
RVLSLIGLK	RVLSLIGLK
IILECVYCK	IILECVYCK
RTEILGLVK	RTEILGLVK
LIFCHSKKK	LIFCHSKKK
ATISYRIKL	ATISYRIKL
KSLLLLNTR	KSLLLLNTR
AQYKCVTIK	AQYKCVTIK
VALSSLVSK	VALSSLVSK
STGPLHGCK	STGPLHGCK
YLLVKWYRK	YLLVKWYRK
TLYVKALTK	TLYVKALTK
VSFLLLAGR	VSFLLLAGR
VVMQVKVPK	VVMQVKVPK
ALGGSIAVK	ALGGSIAVK
TYLGPQFCK	TYLGPQFCK
ASNASSAAK	ASNASSAAK
TTINFTRQR	TTINFTRQR
RLGVRATRK	RLGVRATRK
DLLFNEKLK	DLLFNEKLK
LLMHLVSLY	LLMHLVSLY
RVYEALYYV	RVYEALYYV
IIYERDFSY	IIYERDFSY
SIQKNTIFK	SIQKNTIFK
KTFVDLMRR	KTFVDLMRR
KVVDTFISY	KVVDTFISY
KVIQPRVEK	KVIQPRVEK
SIYAGNTPK	SIYAGNTPK
RTHTLRDAK	RTHTLRDAK
ISYDPKFEK	ISYDPKFEK
LVENNFFTK	LVENNFFTK
AIFQSSMTY	AIFQSSMTY
TFVNFNSVK	TFVNFNSVK
KTQFNYFKK	KTQFNYFKK
RVFNNYMPY	RVFNNYMPY
AIMQVFFGY	AIMQVFFGY
MVASDVCKK	MVASDVCKK
LLARFGLEK	LLARFGLEK
ATSLDVINY	ATSLDVINY
ASSSNYNTY	ASSSNYNTY
TLNEYKQLY	TLNEYKQLY
EQLSKYVEK	EQLSKYVEK
KTSSVARLR	KTSSVARLR
VAGALVAFK	VAGALVAFK
AQALNTLVK	AQALNTLVK
ATNNVFRLK	ATNNVFRLK
ISDNKKEYK	ISDNKKEYK
ISEYRHYCY	ISEYRHYCY
VMLFFLSGK	VMLFFLSGK
SIIIPFIAY	SIIIPFIAY
SFIMRNFLR	SFIMRNFLR
TVKPGNFNK	TVKPGNFNK
NQVKFYFNK	NQVKFYFNK
TLNHVLALK	TLNHVLALK
WFFNNYLRK	WFFNNYLRK
SINKVYGRY	SINKVYGRY
TIQRFSSLR	TIQRFSSLR
IINNAVYTK	IINNAVYTK
GSTAEQLSK	GSTAEQLSK
LVFNSISAR	LVFNSISAR
KLPRMFLPK	KLPRMFLPK
KSYSLIRPK	KSYSLIRPK
ALDGTFQRK	ALDGTFQRK
RSTAIKVTK	RSTAIKVTK
KTMVAFIRK	KTMVAFIRK
FSYDLRLNK	FSYDLRLNK
EVFGSTGDY	EVFGSTGDY
KTDFKVVKK	KTDFKVVKK
AVARKHHTK	AVARKHHTK
VVYRGTTTY	VVYRGTTTY
KTPWDRFCK	KTPWDRFCK
ETITEKTFK	ETITEKTFK
KVYKTYFEK	KVYKTYFEK
KVLAARLKR	KVLAARLKR
RVIYPANQK	RVIYPANQK
IISTNTLGK	IISTNTLGK
SLYDEHIKK	SLYDEHIKK
VTMMKYCSY	VTMMKYCSY
SSIIRSLPK	SSIIRSLPK
MTKILEPFR	MTKILEPFR
KTHESHLVR	KTHESHLVR
WILDRLFFK	WILDRLFFK
KVFVLGGCR	KVFVLGGCR
QIFNEDTSY	QIFNEDTSY
AVFPRYHPR	AVFPRYHPR
YTYDRVDIY	YTYDRVDIY
RVMPVFAFK	RVMPVFAFK
RLNFFTPTK	RLNFFTPTK
TVNPIVTEK	TVNPIVTEK
FTSTNDKIK	FTSTNDKIK
VVNARLRAK	VVNARLRAK
SLLRSTSQK	SLLRSTSQK
TIHLATAPK	TIHLATAPK
AIPYFYKGK	AIPYFYKGK
HLMGWDYPK	HLMGWDYPK
LIWAYLSKK	LIWAYLSKK
ATAKAAAAY	ATAKAAAAY
SVMEVYDGR	SVMEVYDGR
AIFQCSMTK	AIFQCSMTK
ASLPTTIAK	ASLPTTIAK
ILARRPTPK	ILARRPTPK
AVFDSFVER	AVFDSFVER
RTFNEDLFR	RTFNEDLFR
KTSERSQPR	KTSERSQPR
SLLGSALLK	SLLGSALLK
AVMDIISRK	AVMDIISRK
TLDTMDDMK	TLDTMDDMK
KTFDTEYQK	KTFDTEYQK
KSMREEYRK	KSMREEYRK
AVMFFPFWF	AVMFFPFWF
VFKDSFLRK	VFKDSFLRK
TYLGPLNCK	TYLGPLNCK
GTFKSVAVK	GTFKSVAVK
KLQARNIQK	KLQARNIQK
TLLSLTFIK	TLLSLTFIK
TQMRTPLHK	TQMRTPLHK
RVLFSIFYK	RVLFSIFYK
SDDQLRLLK	SDDQLRLLK
FISFYLINK	FISFYLINK
GTDDEVIER	GTDDEVIER
GQLKLNWFK	GQLKLNWFK
GINDRNFWR	GINDRNFWR
ATAHSELAK	ATAHSELAK
KLYSYGIGY	KLYSYGIGY
LLSGHNLAK	LLSGHNLAK
AVDPAKAYK	AVDPAKAYK
GFTATICLK	GFTATICLK
MTSCCSCLK	MTSCCSCLK
KSNRIPFLY	KSNRIPFLY
DILSIIDAK	DILSIIDAK
VGHMMVIFR	VGHMMVIFR
YQHLHTAPK	YQHLHTAPK
SLYMAISPK	SLYMAISPK
IVLFQRFLR	IVLFQRFLR
TVLDVGDAY	TVLDVGDAY
TVAPPAPVY	TVAPPAPVY
YFFVKWIGK	YFFVKWIGK
MTSWLDFSH	MTSWLDFSH
RTLASGLIY	RTLASGLIY
LIVSLCPTK	LIVSLCPTK
RTYTILNRK	RTYTILNRK
VVSTGYHFR	VVSTGYHFR
MLINRFTMK	MLINRFTMK
DAYGFHNYK	DAYGFHNYK
GIPYCNYSK	GIPYCNYSK
AVAVHDFFK	AVAVHDFFK
SSKMFNYFK	SSKMFNYFK
MQKFTILEY	MQKFTILEY
TTRAWFDKK	TTRAWFDKK
VSVDAMIHK	VSVDAMIHK
EISSNDNAK	EISSNDNAK
VSTGSQLAK	VSTGSQLAK
RSIAMLKSK	RSIAMLKSK
YVKSPKFSK	YVKSPKFSK
MSYYCKSHK	MSYYCKSHK
RLYDYFTRV	RLYDYFTRV
MVHQAISPR	MVHQAISPR
KSINKVYGR	KSINKVYGR
ATFSVPMEK	ATFSVPMEK
LGFGAYMSK	LGFGAYMSK
LMHLVSLYK	LMHLVSLYK
YVLGIFLRK	YVLGIFLRK
RQLESRLGY	RQLESRLGY
RQDLLVTFK	RQDLLVTFK
AVSEIQNNK	AVSEIQNNK
KLMALELFK	KLMALELFK
MTNRQFHQK	MTNRQFHQK
GIPHPAGLK	GIPHPAGLK
SQLAKRFSK	SQLAKRFSK
AVLYYHMMK	AVLYYHMMK
AIFQASMTK	AIFQASMTK
RAGAGVMPK	RAGAGVMPK
KLIDIALSK	KLIDIALSK
LTYRHKVVK	LTYRHKVVK
MVLLQMENK	MVLLQMENK
ETLTSVFQK	ETLTSVFQK
RVLGRVLPY	RVLGRVLPY
STMPLSWMY	STMPLSWMY
ATSTRHPSK	ATSTRHPSK
TINAVASRK	TINAVASRK
AVVADLSAR	AVVADLSAR
KSPLPSLEY	KSPLPSLEY
TISSESLVY	TISSESLVY
KLNGAMVEY	KLNGAMVEY
AVSLIAIIK	AVSLIAIIK
RSFKDLLKK	RSFKDLLKK
ALAAAAAAK	ALAAAAAAK
SAGFSLWIY	SAGFSLWIY
KGNVSALVK	KGNVSALVK
SSADLSLEK	SSADLSLEK
ATVVIGTSK	ATVVIGTSK
AITTSNCAK	AITTSNCAK
TLNVLAWLY	TLNVLAWLY
TSKTTILSK	TSKTTILSK
AMLTAFFLR	AMLTAFFLR
RTAKVRAFH	RTAKVRAFH
QTVDFTDCR	QTVDFTDCR
ALILAYSNK	ALILAYSNK
IVFNLPVSK	IVFNLPVSK
YTYDLAEYR	YTYDLAEYR
VVNYDNSTK	VVNYDNSTK
KVFEHVGSR	KVFEHVGSR
STGNYNYKY	STGNYNYKY
KSEFQIYKK	KSEFQIYKK
KVFDKSLLY	KVFDKSLLY
TTIFFRADK	TTIFFRADK
TTFVTPMLR	TTFVTPMLR
RSADLELER	RSADLELER
AVYSSSMVK	AVYSSSMVK
TQMGGWFQK	TQMGGWFQK
STHKLSLTK	STHKLSLTK
RLADEGLNR	RLADEGLNR
IISEEYLSK	IISEEYLSK
SIILANERY	SIILANERY
AVCTRGVAK	AVCTRGVAK
SSTCMMCYK	SSTCMMCYK
SVQLSNNKY	SVQLSNNKY
GTATLRLVK	GTATLRLVK
ATFRLECPY	ATFRLECPY
QTPTKLMNK	QTPTKLMNK
VSTVSQLAK	VSTVSQLAK
SSNVANYQK	SSNVANYQK
STTDAEACY	STTDAEACY
CLNTFVLKK	CLNTFVLKK
IMPARFYPK	IMPARFYPK
YIFWIRTPR	YIFWIRTPR
VTGILQLPR	VTGILQLPR
GTMYILLKK	GTMYILLKK
FIFSALDEK	FIFSALDEK
SITPNNLNK	SITPNNLNK
VVCSMEYKK	VVCSMEYKK
MLMFITSSH	MLMFITSSH
LITLILSNK	LITLILSNK
SLFRAVITK	SLFRAVITK
GLFVYLIRY	GLFVYLIRY
SVMSTFFWE	SVMSTFFWE
LTSRATWAK	LTSRATWAK
RAFDIYNEK	RAFDIYNEK
VLRENTSPK	VLRENTSPK
KLMEEYLRR	KLMEEYLRR
ALFFIIFNK	ALFFIIFNK
TISKDNLER	TISKDNLER
MVMCGGSLY	MVMCGGSLY
SFIVPEFAK	SFIVPEFAK
TMYDKILSY	TMYDKILSY
CTGKFKIVK	CTGKFKIVK
TVMDIISRK	TVMDIISRK
TANPVVTKK	TANPVVTKK
TIKIGGQLK	TIKIGGQLK
SQFGGGSQY	SQFGGGSQY
NVAYNVVNK	NVAYNVVNK
ATREGKHGK	ATREGKHGK
NVQFVDINR	NVQFVDINR
TYIGSLPGK	TYIGSLPGK
AINSVPWSK	AINSVPWSK
AIFGQTGPK	AIFGQTGPK
MTFPLHFRS	MTFPLHFRS
VMANNVKKK	VMANNVKKK
VLWDTPSPK	VLWDTPSPK
MVLASTTAK	MVLASTTAK
KKNHWFILK	KKNHWFILK
MGFGHRIYK	MGFGHRIYK
GSTHVSWPK	GSTHVSWPK
ILMKTANNY	ILMKTANNY
YSISNDLLY	YSISNDLLY
AQGLVASIK	AQGLVASIK
LACAGLAYK	LACAGLAYK
IALLIIPPK	IALLIIPPK
HLFGYSWYK	HLFGYSWYK
RVYVAQKRK	RVYVAQKRK
HSNLTETFR	HSNLTETFR
ALTLHWFRK	ALTLHWFRK
VTFQGKFKK	VTFQGKFKK
KSISKSNAK	KSISKSNAK
RQIQVEGLK	RQIQVEGLK
KIVDHIVMY	KIVDHIVMY
ATVKNVVLR	ATVKNVVLR
MVDELVTRK	MVDELVTRK
DLTTMPTYK	DLTTMPTYK
KTLTSVFQK	KTLTSVFQK
ATFEVFLAK	ATFEVFLAK
AANTVIWDY	AANTVIWDY
RVYNNTARY	RVYNNTARY
SSLDQTHIK	SSLDQTHIK
STFTRGAQK	STFTRGAQK
AIFQSSMTA	AIFQSSMTA
QSYKETVHK	QSYKETVHK
VLGLGLSLK	VLGLGLSLK
ATSRTLSYY	ATSRTLSYY
VSAQNISFK	VSAQNISFK
TTLSRTSKK	TTLSRTSKK
ITFLRPVLK	ITFLRPVLK
TVSLAGSYR	TVSLAGSYR
FVSLVKKNK	FVSLVKKNK
KTTLFHTFK	KTTLFHTFK
FISIYSRPK	FISIYSRPK
AIFTYTGGY	AIFTYTGGY
SMNYPNSYK	SMNYPNSYK
TLSERISSK	TLSERISSK
MQFKLGIPK	MQFKLGIPK
LALGMMVLK	LALGMMVLK
GTLSYDNLK	GTLSYDNLK
SSMVNGVVR	SSMVNGVVR
VTFLLLCGR	VTFLLLCGR
GLSLQDYCY	GLSLQDYCY
ESSIYVILK	ESSIYVILK
AVFIHNFKR	AVFIHNFKR
NWDWGVFFK	NWDWGVFFK
ASQIYAGIK	ASQIYAGIK
LVKSPNHVK	LVKSPNHVK
ATYGTAVNK	ATYGTAVNK
KVNSTLEQY	KVNSTLEQY
DIFVSLVKK	DIFVSLVKK
IVTDFSVIK	IVTDFSVIK
MMVIFRLMR	MMVIFRLMR
SSMVNGVVK	SSMVNGVVK
PSILPSLIK	PSILPSLIK
AIFQSSMAK	AIFQSSMAK
QIFEVYWYL	QIFEVYWYL
SFIISTLNK	SFIISTLNK
RSNNKFTLK	RSNNKFTLK
LILSNKLLY	LILSNKLLY
VTSSGTIYK	VTSSGTIYK
EVMPVSMAK	EVMPVSMAK
GSCVTTMAK	GSCVTTMAK
REFEAQNVP	REFEAQNVP
KVMALPIPH	KVMALPIPH
LVKMINHLK	LVKMINHLK
TTAFFNTCK	TTAFFNTCK
AVAKCNLNH	AVAKCNLNH
VSIILANER	VSIILANER
STAEQLSKY	STAEQLSKY
GALDTTSYR	GALDTTSYR
SQIRRFNLR	SQIRRFNLR
QTMLFTMLR	QTMLFTMLR
ASLKNTISK	ASLKNTISK
RFYITTRYK	RFYITTRYK
TVNVILRPK	TVNVILRPK
YLAWVPAHK	YLAWVPAHK
ATQPVHWFL	ATQPVHWFL
TGHPWITFK	TGHPWITFK
TVAYFNMVY	TVAYFNMVY
GIHHPSNSK	GIHHPSNSK
ASNAPSAAK	ASNAPSAAK
ATYGWNLVK	ATYGWNLVK
SSSLTSLLK	SSSLTSLLK
RLFYTFFSY	RLFYTFFSY
RQFVSNNGK	RQFVSNNGK
AISSRVDRY	AISSRVDRY
MTIREFPRK	MTIREFPRK
AINSEMFLR	AINSEMFLR
SMMVILPDK	SMMVILPDK
LAMGIMMLK	LAMGIMMLK
GIGTFLHYK	GIGTFLHYK
RQFHQKLLK	RQFHQKLLK
AVSMANIFR	AVSMANIFR
MTMPLSCTK	MTMPLSCTK
APDGFYPFK	APDGFYPFK
TSGSPIIDK	TSGSPIIDK
KLFAAETLK	KLFAAETLK
VFFKQWFEK	VFFKQWFEK
VTFFCVMTY	VTFFCVMTY
AANEIRISK	AANEIRISK
SLYKYLLLR	SLYKYLLLR
LTYQNKVVK	LTYQNKVVK
GLYRLNFRR	GLYRLNFRR
NVAFELWAK	NVAFELWAK
KVMVICYAY	KVMVICYAY
SLLSTNLPY	SLLSTNLPY
KILAKAIFK	KILAKAIFK
ISYPPLHER	ISYPPLHER
CTGSFKLEK	CTGSFKLEK
WVSRFGERK	WVSRFGERK
ILNFLDWIK	ILNFLDWIK
LSPAHLINK	LSPAHLINK
VSLKKTNDK	VSLKKTNDK
IVIWGKTPK	IVIWGKTPK
AIAQSSMTK	AIAQSSMTK
QSYEFLGLK	QSYEFLGLK
QAFYTRVLK	QAFYTRVLK
VTLFFLSGK	VTLFFLSGK
RSLQTIASK	RSLQTIASK
LVHFLLLKY	LVHFLLLKY
STDDCFANK	STDDCFANK
STIFDIVSK	STIFDIVSK
SISGKYDIK	SISGKYDIK
CALPFTSAR	CALPFTSAR
RVYKNYDPR	RVYKNYDPR
KLGDQFGRK	KLGDQFGRK
KITDFGIAK	KITDFGIAK
KVGVYKMHK	KVGVYKMHK
IVNNQESNK	IVNNQESNK
STCYVFGLY	STCYVFGLY
VQTAPGTFK	VQTAPGTFK
QLLRLMADK	QLLRLMADK
AVNNLVELK	AVNNLVELK
IAARILSEK	IAARILSEK
KLYPNVDFY	KLYPNVDFY
AIFQSSMTK	AIFQSSMTK
MTLDDLAIK	MTLDDLAIK
VLSHNSYEK	VLSHNSYEK
SQIGAGVYK	SQIGAGVYK
SVANRSKQK	SVANRSKQK
TTIEDILPK	TTIEDILPK
IVYRDGNPY	IVYRDGNPY
QVIFKCVPK	QVIFKCVPK
LVCFPSTQR	LVCFPSTQR
LSARNKLFK	LSARNKLFK
ISARALKAY	ISARALKAY
RTFGKLPYR	RTFGKLPYR
STFWPCLLR	STFWPCLLR
QQQGQTVTK	QQQGQTVTK
KVFGYDIDR	KVFGYDIDR
ASLTPKAQR	ASLTPKAQR
YTNEIIGYK	YTNEIIGYK
ISIRPRVTK	ISIRPRVTK
KALKLSWFK	KALKLSWFK
TTIITPMMR	TTIITPMMR
IICEDAMYY	IICEDAMYY
NTTYDFLAR	NTTYDFLAR
AITAASLPK	AITAASLPK
ITSTKTIEY	ITSTKTIEY
LSTNLPYGK	LSTNLPYGK
SVTKSSSWK	SVTKSSSWK
HLNIPIGFK	HLNIPIGFK
ATKIIALNK	ATKIIALNK
VTTIMFLAR	VTTIMFLAR
TQSVLCVKK	TQSVLCVKK
RIYCQENPY	RIYCQENPY
ITYTDVLRY	ITYTDVLRY
HLYLQYIRK	HLYLQYIRK
NISFKSINK	NISFKSINK
VTFKNAHAK	VTFKNAHAK
RVYINVVVK	RVYINVVVK
QTVNICIFY	QTVNICIFY
ASFDKAKLK	ASFDKAKLK
VVFGILIKR	VVFGILIKR
SIIQEKLGY	SIIQEKLGY
ISKIYTLIY	ISKIYTLIY
AAYYFMKFR	AAYYFMKFR
RVQFIPGQR	RVQFIPGQR
TMFLITENK	TMFLITENK
AVHGYYIGY	AVHGYYIGY
ALFMYYAKR	ALFMYYAKR
AVLQSGFRK	AVLQSGFRK
TMFLIAENK	TMFLIAENK
RVWRGEQGK	RVWRGEQGK
YVYFYDLSY	YVYFYDLSY
VVYDAKFEK	VVYDAKFEK
VVMAYVGIK	VVMAYVGIK
TTKDYFSFK	TTKDYFSFK
VIYDSKFEK	VIYDSKFEK
RVYLQGHGY	RVYLQGHGY
SQIQLSLLK	SQIQLSLLK
GVIRSIFAR	GVIRSIFAR
CVNDGGLFY	CVNDGGLFY
ASYQFQLPY	ASYQFQLPY
SIPISELSR	SIPISELSR
ALLSTDGNK	ALLSTDGNK
YTFAISYCR	YTFAISYCR
TTDLEAYFK	TTDLEAYFK
KTFPPTEPK	KTFPPTEPK
DISKLTNFK	DISKLTNFK
MMFINSTCY	MMFINSTCY
SVYAWERKK	SVYAWERKK
GQFDSMLAK	GQFDSMLAK
PVLTSLFNK	PVLTSLFNK
KASMLEKYK	KASMLEKYK
RMMGKNIFY	RMMGKNIFY
TVLEFILQK	TVLEFILQK
KTFDTEYPK	KTFDTEYPK
ALMRWRHPR	ALMRWRHPR
IVSLCPTKK	IVSLCPTKK
SVMPAWQEK	SVMPAWQEK
ALYRRIQRR	ALYRRIQRR
QQFANVISK	QQFANVISK
PVVCSMEYK	PVVCSMEYK
WSFYRVVVK	WSFYRVVVK
GVYTGSIGY	GVYTGSIGY
NVSIPWTHK	NVSIPWTHK
LTSMKYFVK	LTSMKYFVK
YLINPNILY	YLINPNILY
VLMHPDFCK	VLMHPDFCK
GVNKQTAMK	GVNKQTAMK
ITYKCPLLR	ITYKCPLLR
AGLAFSLMK	AGLAFSLMK
ASCDAIMTR	ASCDAIMTR
SVFKGFSDK	SVFKGFSDK
IASKINNNR	IASKINNNR
LLSINSSFY	LLSINSSFY
CTLPPLRFK	CTLPPLRFK
SSMNSDAAY	SSMNSDAAY
SFYVNRGFK	SFYVNRGFK
KAALSSLAK	KAALSSLAK
LLFASMGFK	LLFASMGFK
MIYMGLWLK	MIYMGLWLK
GVIDTMRIY	GVIDTMRIY
KQYDSTDFK	KQYDSTDFK
FSFKKCLVY	FSFKKCLVY
YMSALNHTK	YMSALNHTK
ATVLMGLGK	ATVLMGLGK
TAGPWHLGK	TAGPWHLGK
EVFCVQPEK	EVFCVQPEK
AVYLLDGLR	AVYLLDGLR
TTFDAEYCR	TTFDAEYCR
IALGLMALK	IALGLMALK
VLKAMHDKK	VLKAMHDKK
ALERLLSLK	ALERLLSLK
ISLNSMYTR	ISLNSMYTR
KMQRMLLEK	KMQRMLLEK
KSNILMWNK	KSNILMWNK
MSAPPAEYK	MSAPPAEYK
KTFDSEYVK	KTFDSEYVK
TILLSDKGK	TILLSDKGK
AAMQRKLEK	AAMQRKLEK
YVYPDNLPR	YVYPDNLPR
RIAQGVLQR	RIAQGVLQR
TTNIWLKLK	TTNIWLKLK
FVDINRNNK	FVDINRNNK
FLRSIAMLK	FLRSIAMLK
SIIPSGPLK	SIIPSGPLK
KVMFVIRFK	KVMFVIRFK
SMNVAVIDK	SMNVAVIDK
SAICSVVRR	SAICSVVRR
KLLNRVIGY	KLLNRVIGY
KTAVNMLTH	KTAVNMLTH
MFLTSVINR	MFLTSVINR
AALFMYYAK	AALFMYYAK
THLGPQFCK	THLGPQFCK
GTHVLLPFY	GTHVLLPFY
QVKDNIISR	QVKDNIISR
STSAADIKR	STSAADIKR
VMYNLWKMK	VMYNLWKMK
QMMNVNLQK	QMMNVNLQK
LVQEKYLEY	LVQEKYLEY
VFKAMETFK	VFKAMETFK
QLFTFSPRR	QLFTFSPRR
VLDCRTAFK	VLDCRTAFK
AVYKTYGQY	AVYKTYGQY
ITCVVIPSK	ITCVVIPSK
TVAHQVCPY	TVAHQVCPY
MSSAMSMMH	MSSAMSMMH
KTLDISSFY	KTLDISSFY
VSIRGSHHK	VSIRGSHHK
ATGFPFFDR	ATGFPFFDR
YVFSGDPLK	YVFSGDPLK
TMLFTMLRK	TMLFTMLRK
ITAKETLYR	ITAKETLYR
SGCYIHFFR	SGCYIHFFR
SILSLETVK	SILSLETVK
VSDTTVLLH	VSDTTVLLH
TTHSKGATK	TTHSKGATK
TILDDNLYK	TILDDNLYK
ITDNGPMPY	ITDNGPMPY
YLFNQHIKK	YLFNQHIKK
GTGLWTHDK	GTGLWTHDK
LLLNTRQLK	LLLNTRQLK
LIKKSDAKR	LIKKSDAKR
AATIQTPTK	AATIQTPTK
TVMDVISRR	TVMDVISRR
KILSVFFLA	KILSVFFLA
AACAMLLVK	AACAMLLVK
VMNFIPIIY	VMNFIPIIY
LTIKDSSNK	LTIKDSSNK
KIGEVIGPK	KIGEVIGPK
ITFFQEVPH	ITFFQEVPH
KIVNGVLSR	KIVNGVLSR
GIFQSSMTK	GIFQSSMTK
GSWATSSFR	GSWATSSFR
PISASDMQK	PISASDMQK
SQNPLAELK	SQNPLAELK
YTKVVHYRK	YTKVVHYRK
SVQWFRLPR	SVQWFRLPR
SSEQTFMYY	SSEQTFMYY
ISLGLILLK	ISLGLILLK
SQMLLIVLK	SQMLLIVLK
STCSAVTDR	STCSAVTDR
SIFQSSMTK	SIFQSSMTK
ATFLWWIPL	ATFLWWIPL
ASTTENAAY	ASTTENAAY
HAGAKSFYK	HAGAKSFYK
VLARWGTFK	VLARWGTFK
SSMINGVVK	SSMINGVVK
RMYWGVNPK	RMYWGVNPK
SVKERGPAY	SVKERGPAY
SFGAGTLAK	SFGAGTLAK
AAYFVGYLK	AAYFVGYLK
AIKCVDIVK	AIKCVDIVK
TTINYTLWR	TTINYTLWR
TTVNTLSER	TTVNTLSER
GIAPLQLGK	GIAPLQLGK
YSGLTPEQK	YSGLTPEQK
KMGAFMYTK	KMGAFMYTK
RIYSHIAPY	RIYSHIAPY
MVSRLLLNR	MVSRLLLNR
DLTQIFEVY	DLTQIFEVY
ALKISQLQK	ALKISQLQK
RTGDIGCFK	RTGDIGCFK
IMEIVSHLR	IMEIVSHLR
VSNRCPICK	VSNRCPICK
CVDIFTEGK	CVDIFTEGK
KIRLGFHWK	KIRLGFHWK
RVVDLYIGR	RVVDLYIGR
STYYVHENK	STYYVHENK
SLQTIASKK	SLQTIASKK
GTDSGFAAY	GTDSGFAAY
RVFDKADGK	RVFDKADGK
KLVKSLVDK	KLVKSLVDK
MLYILGLFK	MLYILGLFK
ALFDRPAFK	ALFDRPAFK
TSRTLSYYK	TSRTLSYYK
STSPTRTWK	STSPTRTWK
SMDVLAEKK	SMDVLAEKK
MALFQPANK	MALFQPANK
YQVLVMVPK	YQVLVMVPK
TVMDIISRR	TVMDIISRR
AMFQDPQER	AMFQDPQER
FLKSGAVVK	FLKSGAVVK
VIGFLALAK	VIGFLALAK
STQSVLCVK	STQSVLCVK
TVWFVPSIK	TVWFVPSIK
NAFNCTFEY	NAFNCTFEY
GVSENIFLK	GVSENIFLK
SLYPPCLFK	SLYPPCLFK
ATMLDVDLR	ATMLDVDLR
TSLAIKNYY	TSLAIKNYY
KVKYLYFIK	KVKYLYFIK
YIFFASFYY	YIFFASFYY
TQDLFLPFY	TQDLFLPFY
KSIENKHQR	KSIENKHQR
KLFKKTDFK	KLFKKTDFK
STCFKLMLK	STCFKLMLK
SSIVRQLFK	SSIVRQLFK
ALYSYASAK	ALYSYASAK
QTQTYNIGK	QTQTYNIGK
STHMENILK	STHMENILK
MLRLFDFNK	MLRLFDFNK
MSYTMCSGK	MSYTMCSGK
ITMVNSLTY	ITMVNSLTY
RTKLMSNIK	RTKLMSNIK
AVYGNIKHK	AVYGNIKHK
NTGIKSTVK	NTGIKSTVK
TVWNRLIAR	TVWNRLIAR
SLCFLLTQK	SLCFLLTQK
SILASSLLR	SILASSLLR
AIIDYIAYM	AIIDYIAYM
GTIAGGVCY	GTIAGGVCY
WSYYMATLK	WSYYMATLK
LLDSYFVVK	LLDSYFVVK
SICSTMTNR	SICSTMTNR
TTYMDTFFR	TTYMDTFFR
MSYSMCTGK	MSYSMCTGK
IIGLLKIFR	IIGLLKIFR
LAMGIMILK	LAMGIMILK
YSYATHHDK	YSYATHHDK
TVYVYSRVK	TVYVYSRVK
RSADGSPPY	RSADGSPPY
KSLYDEHIK	KSLYDEHIK
GLCAHILLY	GLCAHILLY
SSAYVFSVK	SSAYVFSVK
ANFQSSMTK	ANFQSSMTK
TVIRFWHAM	TVIRFWHAM
SAGAGVLDK	SAGAGVLDK
ITYGSVSWR	ITYGSVSWR
TVDHMAIIK	TVDHMAIIK
VLHDIGNPK	VLHDIGNPK
FLCPTFTLK	FLCPTFTLK
ASILSRMAY	ASILSRMAY
ATADLELAY	ATADLELAY
KTFVELMRR	KTFVELMRR
VSTGPQLAK	VSTGPQLAK
RMIESRMSK	RMIESRMSK
LFDKDTFFK	LFDKDTFFK
QVIEYLKPY	QVIEYLKPY
VTSMEELAR	VTSMEELAR
SSGVFHSYK	SSGVFHSYK
FSTSAADIK	FSTSAADIK
RLKFSLSYK	RLKFSLSYK
TSYVKVLEY	TSYVKVLEY
TTAEFTVPK	TTAEFTVPK
KVFFVNWFR	KVFFVNWFR
LTTLSRTSK	LTTLSRTSK
ELYDTSPTK	ELYDTSPTK
GVYSVFYLY	GVYSVFYLY
VFSFWLLCK	VFSFWLLCK
TQIFEVYWY	TQIFEVYWY
VQSKMSDVK	VQSKMSDVK
WIQYDKHCY	WIQYDKHCY
IVFMWAIHH	IVFMWAIHH
KVSDSNLHK	KVSDSNLHK
IIGPMFSGK	IIGPMFSGK
SSLPSYAAY	SSLPSYAAY
IVNEHDIKY	IVNEHDIKY
RSFAERLDR	RSFAERLDR
SVPAEILRK	SVPAEILRK
RGDNFAVEK	RGDNFAVEK
AIDAYPLTK	AIDAYPLTK
RLASYGLYY	RLASYGLYY
CLFDRYFKY	CLFDRYFKY
IMVASDVCK	IMVASDVCK
FTNDSIISH	FTNDSIISH
GVIADYNYK	GVIADYNYK
AIGTSITQK	AIGTSITQK
AIILHQQQK	AIILHQQQK
TSCAPMMQK	TSCAPMMQK
WIYDPRNQK	WIYDPRNQK
FIFQSSMTK	FIFQSSMTK
TTILTPMLR	TTILTPMLR
IQVTISSYK	IQVTISSYK
AVFKDSFLR	AVFKDSFLR
LINDQLIMK	LINDQLIMK
STYGWNLVR	STYGWNLVR
GQRCHFIKK	GQRCHFIKK
VTLDFTKFH	VTLDFTKFH
LLNKEMYLK	LLNKEMYLK
AVAPSMTMR	AVAPSMTMR
TIMAAILAY	TIMAAILAY
PVYLMTLMK	PVYLMTLMK
ATGFKQSSK	ATGFKQSSK
TVFKGFVNK	TVFKGFVNK
ALLAVGATK	ALLAVGATK
KIMDYGKYK	KIMDYGKYK
STHNTPVYK	STHNTPVYK
MSLSEQLRK	MSLSEQLRK
RVYLNGIGK	RVYLNGIGK
LSYIYSEIK	LSYIYSEIK
TTLEQQYNK	TTLEQQYNK
AVILQNAWK	AVILQNAWK
KQSSKALQR	KQSSKALQR
KSDPIMLLK	KSDPIMLLK
IIVAGFSGK	IIVAGFSGK
ATNDGLIKK	ATNDGLIKK
ATQLATLRK	ATQLATLRK
STCMMCYKR	STCMMCYKR
RAIMATIQR	RAIMATIQR
HINTLIQYR	HINTLIQYR
YSHYSHNPK	YSHYSHNPK
LTFLDCLYY	LTFLDCLYY
KLCKNHAEK	KLCKNHAEK
ASYRLCLYR	ASYRLCLYR
SVLNLVIVK	SVLNLVIVK
AIMATIQRK	AIMATIQRK
IMDKEQLLK	IMDKEQLLK
MLNNSFYYM	MLNNSFYYM
ASSWAPTQK	ASSWAPTQK
PVTIGECPK	PVTIGECPK
KVVNRWLFR	KVVNRWLFR
MVSDTIMKR	MVSDTIMKR
SVKGLTPSK	SVKGLTPSK
AIFQSSATK	AIFQSSATK
KIIAVFDSK	KIIAVFDSK
LLYILFLVK	LLYILFLVK
AVHECFVKR	AVHECFVKR
AVHDFFKFR	AVHDFFKFR
KSAGFPFNK	KSAGFPFNK
VQTKPGLFK	VQTKPGLFK
PVDTEFINK	PVDTEFINK
VVDFSQFSR	VVDFSQFSR
SVFPFDGTR	SVFPFDGTR
RTRFFCIPK	RTRFFCIPK
SVKSFEIDK	SVKSFEIDK
TTSKMLLNR	TTSKMLLNR
ILSFPYLFK	ILSFPYLFK
LVKSSFVKK	LVKSSFVKK
MVGVGSLVK	MVGVGSLVK
VVYRAFDIY	VVYRAFDIY
PSIFLIITK	PSIFLIITK
LSDENYLLK	LSDENYLLK
GSFCTQLNR	GSFCTQLNR
YTFFSYLMK	YTFFSYLMK
VVPDYGTYK	VVPDYGTYK
ATAAAAAAK	ATAAAAAAK
IAEYIAGLK	IAEYIAGLK
KTALTGAMR	KTALTGAMR
ATDALMTGY	ATDALMTGY
GVAMPNLYK	GVAMPNLYK
FAYVMNIER	FAYVMNIER
ASGNLLLDK	ASGNLLLDK
NFEALEATK	NFEALEATK
TFIDVHIPK	TFIDVHIPK
LMWNKQFIK	LMWNKQFIK
VLAYMLFTK	VLAYMLFTK
RVAVNKSNK	RVAVNKSNK
ALCTFLLNK	ALCTFLLNK
QTNFKSLLR	QTNFKSLLR
DVSLIIEYK	DVSLIIEYK
YQNFQNADK	YQNFQNADK
NAKVGDDVK	NAKVGDDVK
SQLSLSMAR	SQLSLSMAR
NSPVFNYNK	NSPVFNYNK
RVMANNVKK	RVMANNVKK
TIDKSSPLY	TIDKSSPLY
GTLTKGVFK	GTLTKGVFK
SSPPIPMSR	SSPPIPMSR
YTFCRLNVK	YTFCRLNVK
KIFEYGFTF	KIFEYGFTF
RTEAKSALK	RTEAKSALK
RQTVSRFKK	RQTVSRFKK
CVFKFIVAK	CVFKFIVAK
SSLRREHIK	SSLRREHIK
RTQNVLGEK	RTQNVLGEK
FMRFFQLLR	FMRFFQLLR
FIMLEGETK	FIMLEGETK
GLACYRFVK	GLACYRFVK
YQNEVTPEY	YQNEVTPEY
SVIDHIHYM	SVIDHIHYM
ATSTGNYNY	ATSTGNYNY
AQCFKMFYK	AQCFKMFYK
SNIQFNISK	SNIQFNISK
ELYVSSSYK	ELYVSSSYK
RLVEEFFNR	RLVEEFFNR
NATFFIFNK	NATFFIFNK
PVNRPIDWK	PVNRPIDWK
AADFPGIAR	AADFPGIAR
PAGRPNYVK	PAGRPNYVK
TVYDDAARR	TVYDDAARR
RTTWSIHAK	RTTWSIHAK
YVLGVFLRK	YVLGVFLRK
RVFGFRTAK	RVFGFRTAK
GITGGHIPK	GITGGHIPK
AYSPFAFKK	AYSPFAFKK
KVLCPYMPK	KVLCPYMPK
TTIKPVSYK	TTIKPVSYK
FASADNHPK	FASADNHPK
IAQSKGLYR	IAQSKGLYR
YVIRHVDGK	YVIRHVDGK
GTHPFSRIR	GTHPFSRIR
NVISSKISY	NVISSKISY
TVDSLSPLK	TVDSLSPLK
EIYFSSIHR	EIYFSSIHR
ISSVLTILY	ISSVLTILY
KSFKDILPK	KSFKDILPK
VTAASPMLY	VTAASPMLY
RTLNLFRYK	RTLNLFRYK
MFKNFPFFK	MFKNFPFFK
VTSSGAIYK	VTSSGAIYK
KSISSMTIR	KSISSMTIR
IMLEYPHFK	IMLEYPHFK
MLVYCFLGY	MLVYCFLGY
TTIFAGHLK	TTIFAGHLK
KLLISCWQR	KLLISCWQR
SSMLNIMNR	SSMLNIMNR
KSCICYGSY	KSCICYGSY
TSEVHWNYK	TSEVHWNYK
SQGAGWSLK	SQGAGWSLK
GTAPPPLTR	GTAPPPLTR
VADLSARNK	VADLSARNK
RSTPFNMLK	RSTPFNMLK
ALAYYNNSK	ALAYYNNSK
KVVNPLFEK	KVVNPLFEK
RTFSILNRK	RTFSILNRK
LTQDLVQEK	LTQDLVQEK
GTSNWTGNY	GTSNWTGNY
GMLVGRLGK	GMLVGRLGK
FTYLCGFIK	FTYLCGFIK
STDHIPILY	STDHIPILY
LALGFFLRK	LALGFFLRK
AIFQSSMTR	AIFQSSMTR
STYGWNIVK	STYGWNIVK
QVYFESFVR	QVYFESFVR
SSQRDTILK	SSQRDTILK
MSMGDIITY	MSMGDIITY
ASANLAATK	ASANLAATK
LIGANYLGK	LIGANYLGK
AVLDDGIYR	AVLDDGIYR
AIYKNTIAY	AIYKNTIAY
GTGAGVPSK	GTGAGVPSK
KTNDINVRR	KTNDINVRR
LSDIISAEK	LSDIISAEK
KVCRSPAQK	KVCRSPAQK
STELIRRVR	STELIRRVR
AIITPVVFY	AIITPVVFY
QMLTSGEYK	QMLTSGEYK
MVLLTMKEK	MVLLTMKEK
FSNTIQSYK	FSNTIQSYK
RMGERQLQK	RMGERQLQK
VTFRERYSY	VTFRERYSY
SMFWDGMDY	SMFWDGMDY
DAEACYIYK	DAEACYIYK
HIIDSFNIR	HIIDSFNIR
TIKYSNDNR	TIKYSNDNR
TVWEVQGYK	TVWEVQGYK
VSWSGRELK	VSWSGRELK
NTPVFAIKK	NTPVFAIKK
NIVTSLAIK	NIVTSLAIK
AIYESNIGY	AIYESNIGY
TTFGRIGVK	TTFGRIGVK
CMLTEFLHY	CMLTEFLHY
VSFDQNLDY	VSFDQNLDY
IIFLKLFKK	IIFLKLFKK
ILARWGSFK	ILARWGSFK
CVDIPGIPK	CVDIPGIPK
SILDRIDTR	SILDRIDTR
AKIALAVYK	AKIALAVYK
TLVPVLEKK	TLVPVLEKK
YLLVKWIRK	YLLVKWIRK
MVFQNYALY	MVFQNYALY
KVASAGISY	KVASAGISY
ASTISWMMK	ASTISWMMK
ATSIYTIER	ATSIYTIER
CILGELFTK	CILGELFTK
TSADLTVEK	TSADLTVEK
ILARWSSFK	ILARWSSFK
TTYDFLARK	TTYDFLARK
CTDESRDRK	CTDESRDRK
HTAAPWGSY	HTAAPWGSY
PLSRLFYPK	PLSRLFYPK
VSMTYLYNK	VSMTYLYNK
VTDLENRLK	VTDLENRLK
KQIANQFNK	KQIANQFNK
SIHLTKTDK	SIHLTKTDK
CAGVIEYAK	CAGVIEYAK
TVGPWHLGK	TVGPWHLGK
LISFYADPK	LISFYADPK
SSVQLSNNK	SSVQLSNNK
YVMCTGSFK	YVMCTGSFK
FSFEIALLK	FSFEIALLK
KQMYRKFSR	KQMYRKFSR
LTIPTIMGR	LTIPTIMGR
RSYMSFWCK	RSYMSFWCK
TAHLKRLWK	TAHLKRLWK
ILMNFHQKK	ILMNFHQKK
SNMLSIINK	SNMLSIINK
GICSCGAFK	GICSCGAFK
ELCGAFLFY	ELCGAFLFY
VVENPTIQK	VVENPTIQK
QSFLFWFLK	QSFLFWFLK
SLVLGVNEK	SLVLGVNEK
KNYPASLHK	KNYPASLHK
ISIISIRPR	ISIISIRPR
ILSKIPYLR	ILSKIPYLR
TSIFAGHLK	TSIFAGHLK
RQILDNAAK	RQILDNAAK
AMLFLISGK	AMLFLISGK
RTMEVFTMY	RTMEVFTMY
TIERIFNAK	TIERIFNAK
KALMQLTTK	KALMQLTTK
YTSDYFISY	YTSDYFISY
AILQSSMTR	AILQSSMTR
GTIKESLLK	GTIKESLLK
KSSSIDVDK	KSSSIDVDK
SVNEYHMLK	SVNEYHMLK
LTFLHTLYK	LTFLHTLYK
SVANIDRIK	SVANIDRIK
FTNPLFYHK	FTNPLFYHK
SFASLFLPK	SFASLFLPK
AVIFTPIYY	AVIFTPIYY
VSSHKGWAK	VSSHKGWAK
EQQQSFMPK	EQQQSFMPK
AVYSTFLHR	AVYSTFLHR
KMSTDNAVY	KMSTDNAVY
TSFGPLVRK	TSFGPLVRK
ILAALFMYY	ILAALFMYY
LSSRATWAK	LSSRATWAK
FFTASLFLH	FFTASLFLH
SLLKETIQK	SLLKETIQK
MLIYSMWGK	MLIYSMWGK
RVDGLELKK	RVDGLELKK
AVFEIFFRK	AVFEIFFRK
SVFHEHIFK	SVFHEHIFK
LLIWAYLSK	LLIWAYLSK
AMSFDGFIR	AMSFDGFIR
SVLRAVLPR	SVLRAVLPR
RAKWNNTLK	RAKWNNTLK
QLCYCPASK	QLCYCPASK
MQNCLLRLK	MQNCLLRLK
VQTKPGIFK	VQTKPGIFK
KILMNFHQK	KILMNFHQK
STDVNKQNK	STDVNKQNK
FASFYYIWK	FASFYYIWK
VTLFYCDER	VTLFYCDER
SYMLQGLRK	SYMLQGLRK
YTQLRFPKK	YTQLRFPKK
CTNTFVLKK	CTNTFVLKK
ALKAYFTAK	ALKAYFTAK
NTFPNITLK	NTFPNITLK
KSNAKCIEY	KSNAKCIEY
VVYMDMGVR	VVYMDMGVR
MTYLDGHPV	MTYLDGHPV
RVHSFFIQY	RVHSFFIQY
AAMVLLLRK	AAMVLLLRK
RAFKYPFIK	RAFKYPFIK
FTTSLSLHK	FTTSLSLHK
ASFKAGKLR	ASFKAGKLR
RVISDGYFK	RVISDGYFK
SIDVDKRTK	SIDVDKRTK
VTMFEALPH	VTMFEALPH
RLISMMGFK	RLISMMGFK
NTYLFNILY	NTYLFNILY
ISYCRAFIY	ISYCRAFIY
VSMMSMYGK	VSMMSMYGK
KAMLYIIRR	KAMLYIIRR
LIVTFRERY	LIVTFRERY
VVTLIPLCR	VVTLIPLCR
MISRMLINR	MISRMLINR
VTFKNPHAK	VTFKNPHAK
LQYNTFLQY	LQYNTFLQY
AVMLVHTYY	AVMLVHTYY
NSSAVVDNK	NSSAVVDNK
CSDDGFWSK	CSDDGFWSK
FMVSVSDFR	FMVSVSDFR
VLWDIPTPK	VLWDIPTPK
IMQRGLFGK	IMQRGLFGK
ASAFFGMSR	ASAFFGMSR
MSAAIKDQK	MSAAIKDQK
TYLGPLSCK	TYLGPLSCK
SADASTFLK	SADASTFLK
GTSWFITQR	GTSWFITQR
NLFSKNILK	NLFSKNILK
VSYEVFDDY	VSYEVFDDY
TVKMGAFMY	TVKMGAFMY
PLFDFVNEK	PLFDFVNEK
KVFFGPIYY	KVFFGPIYY
IMASLVLAR	IMASLVLAR
CLYPWAIFH	CLYPWAIFH
SVLDIISSK	SVLDIISSK
KSYETEYPK	KSYETEYPK
VVYIILAPK	VVYIILAPK
ITANPVVTK	ITANPVVTK
LLGPGRPYK	LLGPGRPYK
VMAFIAFLR	VMAFIAFLR
LVTRKCPQK	LVTRKCPQK
MQSSFFMNR	MQSSFFMNR
VIENGILKK	VIENGILKK
MLFTSTNDK	MLFTSTNDK
LTQRRTTPR	LTQRRTTPR
KVMDFGIAR	KVMDFGIAR
TIAGGVCYY	TIAGGVCYY
KLYKMRIPR	KLYKMRIPR
SLPRIALVR	SLPRIALVR
LVYIFEPEK	LVYIFEPEK
VMHINSPFK	VMHINSPFK
QINELHHSK	QINELHHSK
AIKEVVMAY	AIKEVVMAY
AVNHYFKTR	AVNHYFKTR
NMVSDTIMK	NMVSDTIMK
TAVCMKCFK	TAVCMKCFK
KLDDVEKEK	KLDDVEKEK
RLCYGGPWK	RLCYGGPWK
SVLEVFEGR	SVLEVFEGR
KAFNHASVK	KAFNHASVK
RTGTRLLGR	RTGTRLLGR
STYSDICSK	STYSDICSK
STFATVLEY	STFATVLEY
VFMDNAFKK	VFMDNAFKK
AALDGTFQR	AALDGTFQR
NIQFTAVGK	NIQFTAVGK
AIFQSAMTK	AIFQSAMTK
STLNFNNLR	STLNFNNLR
TTFITPMLR	TTFITPMLR
STLLMWHMH	STLLMWHMH
MSHVKSVTK	MSHVKSVTK
NSISARALK	NSISARALK
RVFPGDHFY	RVFPGDHFY
TLLESFLFY	TLLESFLFY
SVLCVKKFY	SVLCVKKFY
LFFPFGLFK	LFFPFGLFK
RINEEKHEK	RINEEKHEK
SSWNSAHEK	SSWNSAHEK
LTDTIESAK	LTDTIESAK
LFQLCTFTK	LFQLCTFTK
KALKINWYK	KALKINWYK
RVPVSCAVY	RVPVSCAVY
GQSTSRHKK	GQSTSRHKK
MSLQRQFLR	MSLQRQFLR
VTYDYIIPK	VTYDYIIPK
EVGSIRCVK	EVGSIRCVK
AIDRQVSVK	AIDRQVSVK
LARRPTPKK	LARRPTPKK
YTFEPHYFY	YTFEPHYFY
AQHAPDAAK	AQHAPDAAK
QLFKPLTKK	QLFKPLTKK
LMQGSTLPR	LMQGSTLPR
LTLKGTSYK	LTLKGTSYK
LLFADINGK	LLFADINGK
RAFLLRHYY	RAFLLRHYY
ALNTITNLK	ALNTITNLK
TVKTNLYMK	TVKTNLYMK
AVSTANIFR	AVSTANIFR
TNAMVTLRK	TNAMVTLRK
NFDYPFFRK	NFDYPFFRK
HTYHLENDK	HTYHLENDK
TLMKTSCSK	TLMKTSCSK
MLQGRGPLK	MLQGRGPLK
IFAFIDFSK	IFAFIDFSK
SSRVDRYSK	SSRVDRYSK
TFRERYSYK	TFRERYSYK
LSVETITEK	LSVETITEK
LMYALEPRK	LMYALEPRK
SVAPGTDFR	SVAPGTDFR
HAFDAPTLY	HAFDAPTLY
KVGNFTGLY	KVGNFTGLY
NSSIISLFY	NSSIISLFY
HGFRFEVKK	HGFRFEVKK
AIFASSMTK	AIFASSMTK
MVIENGILK	MVIENGILK
MAVEVGSIR	MAVEVGSIR
RVNKGTGVK	RVNKGTGVK
YIASIFMPR	YIASIFMPR
SLLSLREVK	SLLSLREVK
IQFMMSRRR	IQFMMSRRR
VTRKCPQKK	VTRKCPQKK
SQDLSVISK	SQDLSVISK
LFDFVNFVK	LFDFVNFVK
ISNQIWLFR	ISNQIWLFR
KSSSILARR	KSSSILARR
KAPNVISSK	KAPNVISSK
TTHSWIPKR	TTHSWIPKR
ILFILFFAY	ILFILFFAY
GTGSGVSSK	GTGSGVSSK
MTLMKGASK	MTLMKGASK
LSSSVPSQK	LSSSVPSQK
AGLAFSIMK	AGLAFSIMK
KILSMINYY	KILSMINYY
SVLNDILSR	SVLNDILSR
KSISSIFGY	KSISSIFGY
KMFTFWYMR	KMFTFWYMR
IITPIVFYR	IITPIVFYR
IIYYQLAGY	IIYYQLAGY
KTNTKHCPK	KTNTKHCPK
ATQIPSYKK	ATQIPSYKK
SAAAYFVGY	SAAAYFVGY
NFIPIIYSK	NFIPIIYSK
ILCGWHLLK	ILCGWHLLK
VVYCNGQRK	VVYCNGQRK
GVVRVWDVK	GVVRVWDVK
HSGVDVFYK	HSGVDVFYK
IINAHRIPK	IINAHRIPK
KAFKNNLSR	KAFKNNLSR
GVYPSFMSR	GVYPSFMSR
LAIKNYYRK	LAIKNYYRK
SAVIDALPR	SAVIDALPR
GTSTDVVYR	GTSTDVVYR
TLADAGFMK	TLADAGFMK
VASAGISYK	VASAGISYK
RVHGATVFK	RVHGATVFK
TVGYMYIMK	TVGYMYIMK
VIEDITFLR	VIEDITFLR
SILASSLLK	SILASSLLK
LMYPTTLLK	LMYPTTLLK
ALEYLSELK	ALEYLSELK
KINSNFLLK	KINSNFLLK
GTKVVPRGK	GTKVVPRGK
YLYNKYSFK	YLYNKYSFK
GSYFSGFYK	GSYFSGFYK
IISDMYDPR	IISDMYDPR
ATMLEYVRY	ATMLEYVRY
VQMLSDTLK	VQMLSDTLK
GTEMFRHGY	GTEMFRHGY
AVTAALHRK	AVTAALHRK
FISNTVFRK	FISNTVFRK
KATTQIAPK	KATTQIAPK
AIFLTTLSR	AIFLTTLSR
EIIFLKLFK	EIIFLKLFK
SSLVKNVNK	SSLVKNVNK
SAEDNYLAK	SAEDNYLAK
KVIDIDLER	KVIDIDLER
AAFQSSMTK	AAFQSSMTK
MAVFIHNFK	MAVFIHNFK
TIANSNIIK	TIANSNIIK
KMLKRGSRK	KMLKRGSRK
NTMCTEETK	NTMCTEETK
IITPVVFYR	IITPVVFYR
YTDDYPMYK	YTDDYPMYK
SMASLKSLY	SMASLKSLY
LIDLAFLIK	LIDLAFLIK
DSMDVLAEK	DSMDVLAEK
VLFMVAWGK	VLFMVAWGK
RIDGAHLTK	RIDGAHLTK
QIGEYTFEK	QIGEYTFEK
IVFVCVEYY	IVFVCVEYY
TTTSTALGK	TTTSTALGK
ISAVYFKAK	ISAVYFKAK
SILLSSLLK	SILLSSLLK
ATFEAVLAK	ATFEAVLAK
AIFQRSMTR	AIFQRSMTR
TTLLNETAK	TTLLNETAK
KTNSTVDVR	KTNSTVDVR
AISRLRTQK	AISRLRTQK
LIKFISDNK	LIKFISDNK
DLVKSSFVK	DLVKSSFVK
ALAETSYVK	ALAETSYVK
SMMGFKMNY	SMMGFKMNY
VTYTEIEPK	VTYTEIEPK
YLLVKWYKK	YLLVKWYKK
QTCAGVIEY	QTCAGVIEY
LQGPPGTGK	LQGPPGTGK
RLYYDSMSY	RLYYDSMSY
TLFCASDAK	TLFCASDAK
ATYTGVFDK	ATYTGVFDK
SIATNLEYK	SIATNLEYK
TLISLNSMY	TLISLNSMY
MTSRMLLNR	MTSRMLLNR
FVAAFDHFY	FVAAFDHFY
MLIFNVKSK	MLIFNVKSK
LSAGVEFLK	LSAGVEFLK
TLARSICEK	TLARSICEK
VLPHLCLDY	VLPHLCLDY
STLLTWHMH	STLLTWHMH
RSADLELEK	RSADLELEK
RIGGVLIFR	RIGGVLIFR
VTFKVPHAK	VTFKVPHAK
MSQMPPHPY	MSQMPPHPY
VTFKTAHAK	VTFKTAHAK
GALHLYFDK	GALHLYFDK
ETKITFALK	ETKITFALK
ALNFPGSQK	ALNFPGSQK
QTSAGHFPR	QTSAGHFPR
GTFGPVHFR	GTFGPVHFR
SIFEQWLRR	SIFEQWLRR
AISDYDYYR	AISDYDYYR
TTSDFFVNY	TTSDFFVNY
MATMLEYVR	MATMLEYVR
ILGSLGLRK	ILGSLGLRK
ALLATSIFK	ALLATSIFK
RQLANAIFK	RQLANAIFK
TFMIITSTK	TFMIITSTK
KLVGIELPK	KLVGIELPK
LVFTRAICK	LVFTRAICK
LSIVVDINK	LSIVVDINK
YSDIPRLKK	YSDIPRLKK
IAYRNVLLR	IAYRNVLLR
KSMLKELIK	KSMLKELIK
HTCMSECVR	HTCMSECVR
VTSLAIKNY	VTSLAIKNY
IILAALFMY	IILAALFMY
LLPRVVGGK	LLPRVVGGK
VLCVKKFYK	VLCVKKFYK
GLIVLPFYK	GLIVLPFYK
AVFDGCVVY	AVFDGCVVY
KTMNNYMIK	KTMNNYMIK
EINEWLSSK	EINEWLSSK
VVFEDGLPR	VVFEDGLPR
GNFSWFPHK	GNFSWFPHK
DVKASMLEK	DVKASMLEK
SQIFNIISY	SQIFNIISY
LLNSNALLR	LLNSNALLR
GLHATFMPK	GLHATFMPK
KVQEWYLSY	KVQEWYLSY
IVYKNCVLR	IVYKNCVLR
IQKITVFNK	IQKITVFNK
KSGAIKVLK	KSGAIKVLK
LAISAVYFK	LAISAVYFK
ASLPYGANK	ASLPYGANK
VVKWKRDEH	VVKWKRDEH
RVFNGDDVK	RVFNGDDVK
GSSPIIEVK	GSSPIIEVK
SSVLTILYY	SSVLTILYY
LLMPLKAPK	LLMPLKAPK
NATDFWRLY	NATDFWRLY
KIYRRQIFK	KIYRRQIFK
FLLRHYYNK	FLLRHYYNK
KLYGLSQGY	KLYGLSQGY
SIYSRPKIK	SIYSRPKIK
CILGKLFTK	CILGKLFTK
TVYPKTHYV	TVYPKTHYV
FTFGDTALY	FTFGDTALY
KIKLILANK	KIKLILANK
VVLASLIYR	VVLASLIYR
SYYCAGLKK	SYYCAGLKK
ATIEAVLAK	ATIEAVLAK
ILGGVLHTK	ILGGVLHTK
LILCFTIKR	LILCFTIKR
LFVKKMLPK	LFVKKMLPK
SSKGLACYR	SSKGLACYR
VLDMCAALK	VLDMCAALK
KPIPHRTVL	KPIPHRTVL
RTMFLFVFR	RTMFLFVFR
QLQLLMPLK	QLQLLMPLK
IMSMMNITR	IMSMMNITR
RVIWMDAYK	RVIWMDAYK
SHLGPQFCK	SHLGPQFCK
MGKTITDVK	MGKTITDVK
AISKLGINY	AISKLGINY
