Data	Data aligned
RRWLPAGDALL	RRWLAGDAL
GRLPQGIVREL	GRLPQGIVR
IRFYFPNWF	IRFYFPNWF
RRKEIDLLL	RRKEIDLLL
GRFKDVLVLL	GRFKVLVLL
ARFDAYFHQK	ARFDYFHQK
VRLLLNNDNL	VRLLNNDNL
GRIYLEPPTM	GRIYEPPTM
WQWNPSDRPSF	QWNPDRPSF
GRFDSEKMAY	GRFDEKMAY
ARFRYLMGERL	FRYLMGERL
VRNGYGFINR	VRNGGFINR
GRCVVMVGM	GRCVVMVGM
GRIQVPFPTQR	GRIQVPFPT
RRLPSDVVTGY	RRLPVVTGY
YRNWALKESF	YRNWLKESF
QRFSHQGVQL	QRFSQGVQL
QRTFVLEVM	QRTFVLEVM
GRLNSHPIF	GRLNSHPIF
GRFSQLYPER	GRFSLYPER
NRLSFFFDF	NRLSFFFDF
GRWQYPLIY	GRWQYPLIY
ARYSGSYNDY	ARYSSYNDY
SRLIFTYGL	SRLIFTYGL
RRDNYVPEV	RRDNYVPEV
RRYVFKLGV	RRYVFKLGV
SRTSVTDVKF	SRTSTDVKF
KRFDMAVMFM	KRFDMAVMF
GRLGLVTSR	GRLGLVTSR
ARLFGIRAK	ARLFGIRAK
SRFTGSIFIGR	SRFTGSIFI
SRLAIRNEF	SRLAIRNEF
RRVDFYLAS	RRVDFYLAS
TRVFSLVGK	TRVFSLVGK
IRQNLQICV	IRQNLQICV
SRVLFALSRL	SRVLFALSR
KRIKPRPERF	KRIKRPERF
TRFTITLNY	TRFTITLNY
IRFDSSFSRL	IRFDSFSRL
ARFAVGTAGL	ARFAGTAGL
IRENPVYEK	IRENPVYEK
YRVTIHKTF	YRVTIHKTF
GRIGQAIAR	GRIGQAIAR
RRFSQKPNLTR	RRFSQKPNL
RRDFNHINV	RRDFNHINV
RRMQEMIARM	RRMQEMIAR
ARAGLNGLQL	ARAGNGLQL
GRFDVKIEV	GRFDVKIEV
KRFEELGVKF	KRFELGVKF
KRIVEGILK	KRIVEGILK
GRAIITKSF	GRAIITKSF
ARLTDYVAF	ARLTDYVAF
GRLLWEQEL	GRLLWEQEL
RRNMLQFNL	RRNMLQFNL
RRSPFLQVF	RRSPFLQVF
KRFDDKYTL	KRFDDKYTL
GRSTGEAFVQF	GRSTGEAFV
KRIDIMVGM	KRIDIMVGM
GRQEIFLQR	GRQEIFLQR
RRFQTIPLYYI	RRFQTIPLY
GRVVTLVTF	GRVVTLVTF
RRFVIFPIEY	RRFVFPIEY
RRKDWIGIFR	RRKDIGIFR
ARFTGIKTAI	ARFTIKTAI
GRVGIFPISY	GRVGFPISY
FRKDGVPIGY	FRKDVPIGY
SRAGPLSGKKF	SRAGPLSGK
LRYPMAVGL	LRYPMAVGL
RRLVGEIVR	RRLVGEIVR
KRLKTVLELQY	KRLKTVLEL
GRWDQQYVIQL	GRWDQQYVI
SRLRYPINGF	SRLRPINGF
SRFQQQQGL	SRFQQQQGL
HRFYPDKIDY	HRFYDKIDY
ARLNFIWKGF	ARLNIWKGF
GRWKDILTH	GRWKDILTH
KRYKSIVKY	KRYKSIVKY
RRLEPPSSSHY	RRLEPSSSH
SRFWLWATL	SRFWLWATL
LRHEIELRM	LRHEIELRM
RRYQKSTEL	RRYQKSTEL
GRFFWIVRV	GRFFWIVRV
VRFLLGLRF	VRFLLGLRF
SRNAYMLVY	SRNAYMLVY
VRAVLHLLL	VRAVLHLLL
GRLSWPVLFL	GRLSWPVLF
SRVMNVHKM	SRVMNVHKM
IRWIGQPPGL	IRWIQPPGL
LRFPGQLNA	LRFPGQLNA
RRDQKEALLRF	RRDQKEALL
RRFLRGYEQF	RRFLGYEQF
SRNALLFNLGF	SRNALLFNL
RRIKEIVKKH	RRIKEIVKK
KRASVFVKL	KRASVFVKL
RRFLAARTL	RRFLAARTL
ARLLQTSNITK	ARLLQTSNI
SRWLGLLSV	SRWLGLLSV
LRLEAGLNR	LRLEAGLNR
TRLSLLNMTF	TRLSLNMTF
FRQYAKDIGF	FRQYKDIGF
ARANARLFGI	ARANRLFGI
IRFFGTTNF	IRFFGTTNF
ARYENGHYSY	ARYEGHYSY
GRVGFFPRSY	GRVGFPRSY
SRFPHLLAH	SRFPHLLAH
RRYDFFVSRF	RRYDFFVSR
GRLGSFHEL	GRLGSFHEL
RRLENVENLLR	RRLENVENL
QRNLFILAY	QRNLFILAY
TRTFIVGAQM	TRTFVGAQM
SRFSNVYHL	SRFSNVYHL
GRFEGTSTK	GRFEGTSTK
QRAFPLPMSF	QRAFLPMSF
RRYQDAIRV	RRYQDAIRV
GRLLGIITK	GRLLGIITK
GRDIPIVHR	GRDIPIVHR
RRIDITAKL	RRIDITAKL
IRWGFIPLVI	IRWGFIPLV
GRTELAIKL	GRTELAIKL
ARILIQERY	ARILIQERY
GRLSDVLKR	GRLSDVLKR
RRFVNVVPTFG	RRFVVVPTF
SRFGKYFEI	SRFGKYFEI
MRYIPPIPVHR	MRYIPPIPV
IRYPDPLIK	IRYPDPLIK
SRVLQNVAF	SRVLQNVAF
RRAQLQYVQR	RRAQQYVQR
NLPINGNGKQ	NLPINGNGK
SRLNITYPMLF	SRLNTYPML
RRYQDAIRVF	RRYQAIRVF
FRLILIESR	FRLILIESR
RRFDLLKRIL	RRFDLLKRI
FRLRYLVGGL	FRLRLVGGL
TRMAIVLRF	TRMAIVLRF
GRAFVTIGK	GRAFVTIGK
GRIYLDMLNVY	GRIYDMLNV
KRAAILTKL	KRAAILTKL
SRLGLRYNRL	SRLGLRYNR
SRAGLQFPVGR	SRAGLQFPV
SRFPEALRL	SRFPEALRL
RRILDGSLGF	RRILGSLGF
KRYAVPSAGL	KRYAPSAGL
GRLPSSWAL	GRLPSSWAL
QRFQLPGNIGF	QRFQLPGNI
ARIAIEIYL	ARIAIEIYL
LRSNVLLSF	LRSNVLLSF
GRIKAIQLEY	GRIKIQLEY
GRFHMYEGY	GRFHMYEGY
SRFVDGLTF	SRFVDGLTF
KRFEELTNLI	KRFEELTNL
RRFWNSIVM	RRFWNSIVM
GRLHLGHTF	GRLHLGHTF
ARNLVANAH	ARNLVANAH
ERMNLKVPIYF	ERMNKVPIY
IRKQINNIFY	IRKQINNIF
SRLQDEIQR	SRLQDEIQR
VRLLILILK	VRLLILILK
RRYQKSTELLI	RRYQKSTEL
GRFGPLASVK	GRFGLASVK
KRVQVDVKM	KRVQVDVKM
KRLVVFDAR	KRLVVFDAR
LRALVVIPII	LRALVVIPI
KRISVIKSVF	KRISIKSVF
GRVGVFPSL	GRVGVFPSL
RRIEVNVEL	RRIEVNVEL
GRSGYNYFF	GRSGYNYFF
QRCGVEVTSM	QRCGEVTSM
GRVKESITR	GRVKESITR
TRNDYVMMY	TRNDYVMMY
FRFENVNGY	FRFENVNGY
KRQAIKTAF	KRQAIKTAF
GRIYLYLTK	GRIYLYLTK
ARKILDFKL	ARKILDFKL
ARARFALGL	ARARFALGL
GRFTAAELLSF	GRFTAAELL
ARWWAVVVL	ARWWAVVVL
GRFPYPQIQK	GRFPPQIQK
NRFAGFGIGLA	NRFAFGIGL
RRFNIKLWKTF	RRFNIKLWK
SRYFALVER	SRYFALVER
GRFNGQFKTY	GRFNQFKTY
TRVYLILEY	TRVYLILEY
ARFVNVLGY	ARFVNVLGY
SRLKSILKL	SRLKSILKL
MRHTIVDILTM	MRHTIVDIL
RRSSIPITV	RRSSIPITV
QRYPNPYSK	QRYPNPYSK
RRLEPPFRPK	RRLEPFRPK
KRLDIQEALKR	KRLDIQEAL
VRWSPVRPLVF	VRWSVRPLV
SRVKLILEY	SRVKLILEY
SRWGPLIGL	SRWGPLIGL
LSSDPIALGV	SSDPIALGV
MRLKIGFILR	MRLKGFILR
IRYEPPHIKK	IRYEPHIKK
GRLDAVLQR	GRLDAVLQR
NRLDLLITY	NRLDLLITY
GRLVKDMKI	GRLVKDMKI
GRVGLLGNTY	GRVGLGNTY
GRSDLIPTI	GRSDLIPTI
RRFIPTSIFVK	RRFIPTSIF
HRNELQMQL	HRNELQMQL
ARWFHILGM	ARWFHILGM
RRVYEILRL	RRVYEILRL
SRFGGPEMYGY	SRFGGPEMY
RRILMGSTLR	RRILMGSTL
GRSSTASLVKR	GRSSTASLV
SRHRLLLLL	SRHRLLLLL
ARNLFPSNL	ARNLFPSNL
GRVLLQNTSF	GRVLQNTSF
RRYNIIPVL	RRYNIIPVL
ARLGGIPVGV	ARLGIPVGV
TRYMFSRPF	TRYMFSRPF
SRWEEYISK	SRWEEYISK
SRNKVFVFF	SRNKVFVFF
GRLSPVPVPR	GRLSVPVPR
ARARLLTEI	ARARLLTEI
YRANVIANI	YRANVIANI
RRLDLPIER	RRLDLPIER
GRIGVFPSV	GRIGVFPSV
ARSNLIWNF	ARSNLIWNF
QRSLVLFSV	QRSLVLFSV
ARIAGKVPGL	ARIAKVPGL
ERWEVVLHF	ERWEVVLHF
KRREIPLK	KRRE-IPLK
SIPGGYNAL	SIPGGYNAL
KRFSLDFNL	KRFSLDFNL
IQRTPKIQVY	QRTPKIQVY
KRIEEFLAQF	KRIEFLAQF
ARADLGQQVQF	ARADLGQQV
RRIEYIEARVT	RRIEYIEAR
ARFLPSPVVIK	ARFLSPVVI
ARLKDALVRM	ARLKALVRM
MRLLPRLLL	MRLLPRLLL
RRMGPPVGGH	RRMGPVGGH
IRLPAHLRL	IRLPAHLRL
WRVSLDVNH	WRVSLDVNH
IRTPVKVNF	IRTPVKVNF
ARFSPDGQYL	ARFSDGQYL
TRNNFAVGY	TRNNFAVGY
SRLQETGLLSK	SRLQETGLL
ARTLLWTEL	ARTLLWTEL
RRFGSVPHGGF	RRFGVPHGG
RRMAEEFRL	RRMAEEFRL
SRIQQIIEGK	SRIQIIEGK
ERLEKFFHR	ERLEKFFHR
RRMGNPALSVR	RRMGPALSV
LRNHMAVAF	LRNHMAVAF
GRAPISNPGM	GRAPSNPGM
RRFGDKLNFR	RRFGDKLNF
TRLGIQLDF	TRLGIQLDF
RRKQYPISL	RRKQYPISL
GRLFGISLSY	GRLFISLSY
GRLRSVIQR	GRLRSVIQR
QRQDIAFAY	QRQDIAFAY
QRIGPLAFL	QRIGPLAFL
FRLLWIDTK	FRLLWIDTK
SRMLSGGFGY	SRMLGGFGY
RRFVEVGRVAY	RRFVEVGRV
RRKGAEDLLRF	RRKGEDLLR
ARHFQPFARL	ARHFPFARL
FRYKMRSVY	FRYKMRSVY
GRFEGQVRQK	GRFEQVRQK
GRFSSTTGLFY	GRFSSTTGL
TRYQGVNLY	TRYQGVNLY
HRLIIKPYLR	HRLIIKPYL
GRTIKLWVL	GRTIKLWVL
LRQSLSQAL	LRQSLSQAL
LRYLNFFTK	LRYLNFFTK
GRLFIISTK	GRLFIISTK
SRYTGINQF	SRYTGINQF
GRLRVGLRL	GRLRVGLRL
RRYFGGTEDRL	RRYFGTEDR
RRMGTSLLFQL	RRMGTSLLF
ARLQLQGLDL	ARLQQGLDL
ARMKIDPEAF	ARMKDPEAF
RRLNVAITR	RRLNVAITR
SRFDMIFIVK	SRFDIFIVK
RRGEFIQEI	RRGEFIQEI
SRYQGVNLY	SRYQGVNLY
GRMKFTRPLF	GRMKTRPLF
RRAEVLALPFK	RRAELALPF
RRMGPPVGGHR	RRMGPVGGH
HRFYMFHSF	HRFYMFHSF
RRARSLSAERY	ARSLSAERY
ARKETEFLRL	ARKEEFLRL
KRFMWRDSF	KRFMWRDSF
IRFILIQNR	IRFILIQNR
ARAIYAYAL	ARAIYAYAL
IRIPRTVGQEK	IRIPRTVGQ
GRLKSLEALIR	GRLKSLEAL
SRNSFMVIPK	SRNSMVIPK
TRLFAPWKR	TRLFAPWKR
QRYDSVINRL	QRYDVINRL
RRYSPPIQR	RRYSPPIQR
SRNQQIFLR	SRNQQIFLR
RRMEVYNEF	RRMEVYNEF
ARKDNVIRL	ARKDNVIRL
TRLFAVLRF	TRLFAVLRF
ARLGVVTGL	ARLGVVTGL
HRYGDGGSTF	HRYGGGSTF
KRFEGLTQR	KRFEGLTQR
GRFDEAYIYM	GRFDEAYIY
LRVDPVNFK	LRVDPVNFK
SRAPVFLQF	SRAPVFLQF
RRSKEITVR	RRSKEITVR
RRLENLENLL	RRLELENLL
HRHALYLIIRM	HRHAYLIIR
KRFGLNIDR	KRFGLNIDR
ARALFIRPFM	ARALFIRPF
GRIKVNGIDY	GRIKNGIDY
GRFEITVGPK	GRFETVGPK
GRVALADIAF	GRVAADIAF
SRLQPFLQR	SRLQPFLQR
RRYNIKLWKT	RRYNIKLWK
VRFVTGNKILR	VRFVTGNKI
RRLLEEEIIAF	RRLLEIIAF
GRWPKKSAEF	GRWPKSAEF
GRHGVFLEL	GRHGVFLEL
KRIPFGFKH	KRIPFGFKH
GRFKIDLGIFR	GRFKIDLGI
KRYEDQELTGK	KRYEDQELT
ARFPQLDSTSF	ARFPDSTSF
RRLQAQRNEL	RRLQQRNEL
SRFGTLVNL	SRFGTLVNL
HRIDGKTYVIK	HRIDGKTYV
RRYLENGKETL	RRYLGKETL
RRWEQELNAK	RRWEELNAK
RRSSEMLVKKL	RRSSMLVKK
GRTVLVIAH	GRTVLVIAH
ARTPVTSTY	ARTPVTSTY
LRNPLIAGK	LRNPLIAGK
RRLPIFSRL	RRLPIFSRL
ARWQQVWLL	ARWQQVWLL
ARMAQPIVAF	ARMAPIVAF
ARAKFIPLI	ARAKFIPLI
RRLKSLLIDFF	RRLKLLIDF
GRYTDVSTRYK	GRYTVSTRY
IRFSNISAAK	IRFSISAAK
GRTFLLQGL	GRTFLLQGL
TRFFGEALEF	TRFFEALEF
GRWRGWYTY	GRWRGWYTY
YRGDFETFIK	YRGDFETFI
ARTSASIILR	ARTSSIILR
SRFLKSDLFLK	SRFLKSDLF
GRLPLFGLGR	GRLPFGLGR
KRFSGTVRL	KRFSGTVRL
KRVYIAYSTF	KRVYAYSTF
RRLDLLHQQL	RRLDLHQQL
QRLKFRLNL	QRLKFRLNL
LRFSEIPMKL	LRFSIPMKL
ARAELEMRL	ARAELEMRL
RRNPEPLRF	RRNPEPLRF
ARNIYQEFL	ARNIYQEFL
KRIHGVGFKK	KRIHVGFKK
ARTSLLLLR	ARTSLLLLR
YRLDLEGNEY	YRLDEGNEY
GRWEEHRSLL	GRWEHRSLL
TRYIASLKQRY	TRYISLKQR
LRHPGIVNL	LRHPGIVNL
KRADWLARL	KRADWLARL
MRTAALPTF	MRTAALPTF
VRWSPKGTYL	VRWSKGTYL
YRVTLNPPGTF	YRVTNPPGT
ARWLPLGLGLN	ARWLLGLGL
RRASLSEIGF	RRASSEIGF
HRWVNYESM	HRWVNYESM
LRVTPFILK	LRVTPFILK
SRFNRYYSL	SRFNRYYSL
ARLKTVLKY	ARLKTVLKY
RRIEIAHTL	RRIEIAHTL
GRWRDILSH	GRWRDILSH
HRVDLGTLR	HRVDLGTLR
GRFGFNGLSRG	GRFGNGLSR
QRLSFLLEK	QRLSFLLEK
TRLGFFTTY	TRLGFFTTY
GRIVAFFSF	GRIVAFFSF
SRNVFLFKL	SRNVFLFKL
GRFHGGNLF	GRFHGGNLF
SRFQGTLYL	SRFQGTLYL
MRMSVGLSL	MRMSVGLSL
SRHSGPFFTF	SRHSPFFTF
RRYNIKLWKTF	RRYNIKLWK
QRMSTRVLL	QRMSTRVLL
RRSINQPVAF	RRSIQPVAF
GRAPGGLSL	GRAPGGLSL
ARLKMQEEL	ARLKMQEEL
TRHFLKLVF	TRHFLKLVF
YRKPKWNHL	YRKPKWNHL
KRFSRKTVL	KRFSRKTVL
GRIVTIFAF	GRIVTIFAF
VRFSPDGNRF	VRFSDGNRF
GRLSWPVLF	GRLSWPVLF
RRLIDLGVGL	RRLILGVGL
HRVAQAWEL	HRVAQAWEL
ARANLRLTL	ARANLRLTL
SRLLKPGGMML	SRLLKPGGM
GRIDQVNQL	GRIDQVNQL
RRIDFVLVY	RRIDFVLVY
GRINVSGLTTK	GRIN-VSGL
RRLEELLRQM	RRLELLRQM
GRYDLLIPQF	GRYDLIPQF
GRFGQDFSTF	GRFGDFSTF
ARLQLQLAY	ARLQLQLAY
ARAKIPLGF	ARAKIPLGF
ARNNVVWAL	ARNNVVWAL
HRLEELYTK	HRLEELYTK
GRYLRRELL	GRYLRRELL
SRWEKVVQR	SRWEKVVQR
RRDLAQALINR	RRDLAQALI
RRFREQPLL	RRFREQPLL
TRADLIFTV	TRADLIFTV
ARLAQLLEGY	ARLALLEGY
SRAKVKFNV	SRAKVKFNV
RRFNYVVKL	RRFNYVVKL
ARLTPIPFGL	ARLTIPFGL
RRFTRPEH	RRFT-RPEH
MMAVAVFL	MMAV-AVFL
FRFDGVTSM	FRFDGVTSM
GRWQEPFQL	GRWQEPFQL
RRKDGVFLYF	RRKDGVFLY
QRTVITEEF	QRTVITEEF
KRMLEKLGV	KRMLEKLGV
MRLGSIFGLGL	MRLGSIFGL
GRFTGLESIFR	GRFTLESIF
KRFQTLISKM	KRFQTLISK
RRFQFLQKA	RRFQFLQKA
SRTPYHVNL	SRTPYHVNL
KRLDVTVQSF	KRLDTVQSF
GRWEAAEGLL	GRWEAAEGL
GRWEQAHKL	GRWEQAHKL
ARRTAQEVETY	RRTAEVETY
RRMWPLAF	RRMW-PLAF
SLVNLGGSK	SLVNLGGSK
SRFNFDNKY	SRFNFDNKY
VRMPSVTQR	VRMPSVTQR
RRIQFPIEM	RRIQFPIEM
IRFPLMTIEEF	IRFPTIEEF
TRFGIAAKY	TRFGIAAKY
SRIAIGPLRL	SRIAGPLRL
SRLPSLGAGF	SRLPLGAGF
KRFNADNKLL	KRFNADNKL
HRAGKIVVNL	HRAGIVVNL
RRFFPYYVY	RRFFPYYVY
VRVIISNSAY	VRVISNSAY
ARHGEKLLLF	ARHGKLLLF
RRWEQSLRAL	RRWESLRAL
RRHSIPTGL	RRHSIPTGL
GRFFLSSGL	GRFFLSSGL
HRNGGLITL	HRNGGLITL
ARDALIARL	ARDALIARL
VRAQIRLQF	VRAQIRLQF
KRWQAIYKQF	KRWQIYKQF
IRAAPPPLF	IRAAPPPLF
RRVLLLAGRL	RRVLLLAGR
FRFDPQFALTN	FRFDPQFAL
GRVYPQAVYF	GRVYQAVYF
MRSPGGILL	MRSPGGILL
SRDDNMFQI	SRDDNMFQI
GRIQIALKR	GRIQIALKR
RRHALIVQGF	RRHAIVQGF
RRVFIAGLGL	RRVFAGLGL
ARIAKLEKAK	ARIALEKAK
ARKQIVINL	ARKQIVINL
VRNLSTILK	VRNLSTILK
LRFLFENKL	LRFLFENKL
ARYGKSPYLY	ARYGKSPYL
RRYQMESFSK	RRYQESFSK
FIVEETLPL	FIVEETLPL
HRAQVIYTR	HRAQVIYTR
ARTTLLPGL	ARTTLLPGL
ARWLGTLDKKL	ARWLGTLDK
IRHPNIITL	IRHPNIITL
KRFEIIKEAY	KRFEIKEAY
GRLAAIVAKQV	GRLAAIVAK
KRYDNVTILF	KRYDVTILF
HPGRVLLQNL	GRVL-LQNL
HRFPFSRPEL	HRFPSRPEL
ARYFPLLAK	ARYFPLLAK
KRFKEANNF	KRFKEANNF
RRLEDLIQGL	RRLELIQGL
RRLAEDEAFQR	RRLAEDEAF
ARGFLPYVGM	ARGFPYVGM
RRLLDTTITF	RRLLTTITF
TRFSSQSNVY	TRFSSQSNV
ARLRLLYHF	ARLRLLYHF
RRFDTAFFL	RRFDTAFFL
LRHPNILRL	LRHPNILRL
RRFGDKLNF	RRFGDKLNF
TRMAVQFEL	TRMAVQFEL
ARNLIYFGF	ARNLIYFGF
WRFSGQIERV	WRFSGQIER
KRADLQSTF	KRADLQSTF
KRYDREFLL	KRYDREFLL
SRIRKLFNL	SRIRKLFNL
IRWGFIPLV	IRWGFIPLV
ARLQTALLV	ARLQTALLV
ARLKEVLEY	ARLKEVLEY
RRYDRKQSGY	RRYDKQSGY
QRLDVLSALVL	QRLDVLSAL
NRLTFIPGF	NRLTFIPGF
HRLPPVTSF	HRLPPVTSF
ARGPVPEQM	ARGPVPEQM
GRYSGRKAV	GRYSGRKAV
QRAAIILGY	QRAAIILGY
FRIEGLAPK	FRIEGLAPK
ARIPLPAGY	ARIPLPAGY
TRLSAYVSY	TRLSAYVSY
GRWKWLLHY	GRWKWLLHY
VRWPGVKLL	VRWPGVKLL
VRAQELHTF	VRAQELHTF
ARKDIVARL	ARKDIVARL
KRFGKAYNL	KRFGKAYNL
RRVKEVVKK	RRVKEVVKK
RRWDDDVVF	RRWDDDVVF
ARADLIEVVM	ARADLIEVV
ARIEIGLHY	ARIEIGLHY
GRMPFPVNH	GRMPFPVNH
QRVLLILGL	QRVLLILGL
QRVPINESF	QRVPINESF
RRLDLVHTAAL	RRLDLVHTA
LRKAILVVF	LRKAILVVF
SRVILAGNLL	SRVIAGNLL
RRHFVQVQV	RRHFVQVQV
TRSPVKVTL	TRSPVKVTL
GRIGQVGKF	GRIGQVGKF
RRSDVEILGY	RRSDEILGY
GRIDQVNQLL	GRIDQVNQL
NRYDGIYKV	NRYDGIYKV
VGRKGVITVK	GRKGVITVK
SRLDWPVRTL	SRLDPVRTL
ARLQDQHMF	ARLQDQHMF
KRLNFITEY	KRLNFITEY
YRYLPTEQEVR	YRYLTEQEV
SRFPQGAQLR	SRFPQGAQL
HRYTPKEQLK	HRYTPKEQL
ARLDHKFDL	ARLDHKFDL
SRIGLLTRI	SRIGLLTRI
LRSGVIVRL	LRSGVIVRL
TRFSYAEYF	TRFSYAEYF
FRLDTPLYFSY	FRLDTPLYF
QRLGFTPSV	QRLGFTPSV
GRFKDVLVL	GRFKDVLVL
GRWPGSSLY	GRWPGSSLY
VRFLRAEGY	VRFLRAEGY
TRIEGLLAAF	TRIELLAAF
KRYWTKTIEK	KRYWKTIEK
LRFGLILE	LRFG-LILE
GRLGSFPVR	GRLGSFPVR
RRFPDLNRL	RRFPDLNRL
SRLKIHFTK	SRLKIHFTK
NRFTMEVPK	NRFTMEVPK
ARVWSLMRF	ARVWSLMRF
DRVYIHPFHL	DRVYHPFHL
GRYPDHSVDRR	GRYPHSVDR
QRQQVQILL	QRQQVQILL
SRFGKFIRI	SRFGKFIRI
SRVNGAWQY	SRVNGAWQY
RRAKFKFPGR	RRAKKFPGR
RRLPTVLLKL	RRLPVLLKL
NRLNIEELLK	NRLNIEELL
KRFEAAEQSY	KRFEAEQSY
QRMDILDVLTL	QRMDILDVL
NRSIVLLLK	NRSIVLLLK
YRIESYWTY	YRIESYWTY
GRNKFGQLGL	GRNKGQLGL
RRNYIIQNI	RRNYIIQNI
ARQINIHNL	ARQINIHNL
GRLSGIEERY	GRLSGIEER
HRFYMIQSF	HRFYMIQSF
ARVKVFSKF	ARVKVFSKF
KRWIILGLNK	KRWILGLNK
TRFYLVFEKL	TRFYVFEKL
SRFVDGLTFK	SRFVDGLTF
KRVVINKDT	KRVVINKDT
ARSLPPPKL	ARSLPPPKL
ARLSLTYERL	ARLSTYERL
ARFKGQDLKL	ARFKQDLKL
SRFLNKQPY	SRFLNKQPY
RKGGNNKLIK	RKGGNKLIK
QRFFYTKSF	QRFFYTKSF
YRWHINFTTF	YRWHNFTTF
GRAPVLVAL	GRAPVLVAL
RRLQIEDFEA	RRLQEDFEA
MRKVGLWGF	MRKVGLWGF
RRSWASLVLA	RRSWASLVL
RRFHFSQSL	RRFHFSQSL
RRFVGHTKDVL	RRFVHTKDV
GRIPGIYGR	GRIPGIYGR
GRFSGLLGR	GRFSGLLGR
KRNLPLKLL	KRNLPLKLL
MRWRTILLQY	MRWRILLQY
YRTEIRMARM	YRTEIRMAR
LRNQSVFNF	LRNQSVFNF
LTLPETASL	LTLPETASL
RRFDQQVEKY	RRFDQQVEK
RRFLIDNGVSL	RRFLIDNGV
RRSNVLTGL	RRSNVLTGL
SRLDPVIGR	SRLDPVIGR
SRVAVVNQI	SRVAVVNQI
YRFLQTAEM	YRFLQTAEM
RRFGQTIQSF	RRFGTIQSF
GRFPQVQAF	GRFPQVQAF
IRITLTSRNVK	IRITTSRNV
ARLGYKIKF	ARLGYKIKF
KRFSVPVQHF	KRFSPVQHF
RRMWATQGLA	RRMWATQGL
GRLQLFGQDF	GRLQFGQDF
ARLYPVLLV	ARLYPVLLV
SRMYFTQTL	SRMYFTQTL
RRLDSIVGPQL	RRLDSIVGP
GRVNLNVLR	GRVNLNVLR
ESVTISVAVGL	VTISVAVGL
ARFFKLHER	ARFFKLHER
YRYGIKPEWM	YRYGKPEWM
ARVFVILSV	ARVFVILSV
ARFGSVNEL	ARFGSVNEL
RRFTTSVVRR	RRFTSVVRR
VRFIGELTKF	VRFIELTKF
SRIDVMVHF	SRIDVMVHF
ARSENLIYTY	ARSELIYTY
QRNLYIAGF	QRNLYIAGF
ARALLLPLL	ARALLLPLL
FRKAQIQGL	FRKAQIQGL
ARLALSPVPSH	ARLASPVPS
IRNIPIPTL	IRNIPIPTL
GRIASYYYL	GRIASYYYL
YRKAFESRL	YRKAFESRL
VRAIPVDIGF	VRAIVDIGF
MRQMKRGI	MRQM-KRGI
KRWWSAGGGLL	KRWWAGGGL
SRFGNAFLNRF	SRFGAFLNR
MRLPSGKVGF	MRLPGKVGF
KRFQVAVNL	KRFQVAVNL
ERLKDLFGKF	ERLKDLFGK
AFPVNMVVFV	AFPVNMVVF
GRFAPQFSGY	GRFAQFSGY
ARAAQVFFL	ARAAQVFFL
HRFFTEILR	HRFFTEILR
SRFPNQNQTR	SRFPQNQTR
QRGPVRVGF	QRGPVRVGF
HRFYGKNSSY	HRFYKNSSY
MRYVASYLL	MRYVASYLL
IRLPSQYNF	IRLPSQYNF
GRLYAIAGY	GRLYAIAGY
NRTIVITSH	NRTIVITSH
HRFPSPLAPR	HRFPPLAPR
SRVSKKNIFL	SRVSKNIFL
RRQYKPLSL	RRQYKPLSL
HRMWGRLVGL	HRMWRLVGL
SRFSLENNFL	SRFSLENNF
ARFSPDGQYLV	ARFSDGQYL
SRYQGVNLYIK	SRYQGVNLY
ARLSALYKL	ARLSALYKL
SRMDGEGQLTL	SRMDGEGQL
TRSAIILHL	TRSAIILHL
RRADLTYAEF	RRADTYAEF
RRSGVSPLHL	RRSGSPLHL
ARVEVERNDL	ARVEERNDL
ARLNYLLRV	ARLNYLLRV
IRTITVVQR	IRTITVVQR
GRTQLIDAVL	GRTQIDAVL
IRYFPTQAL	IRYFPTQAL
KRINVRIEHI	KRINVRIEH
VRHSLKDILMK	VRHSKDILM
MRQKAVSLFL	MRQKAVSLF
GRWRSEWKF	GRWRSEWKF
ARIPLNPVL	ARIPLNPVL
GRTLIGFLR	GRTLIGFLR
KRAKVHIKKL	KRAKVHIKK
GRIAHIPLYF	GRIAHIPLY
GRYGAISGFGL	GRYGAISGF
NRFLFPEGI	NRFLFPEGI
SRLPSYFVR	SRLPSYFVR
GRGAFGEATLY	GRGAGEATL
RRLNFLESKF	RRLNLESKF
GRYDGLVGMF	GRYDGLVGM
ARMWKTLTFF	ARMWKTLTF
QRKDVYVQL	QRKDVYVQL
GRLKLVLLEL	GRLKVLLEL
YRIQLKPEQF	YRIQKPEQF
QRNEVVVEL	QRNEVVVEL
GRVGTVIGSNK	GRVGTVIGS
GRVADVYRY	GRVADVYRY
RRLSELLRY	RRLSELLRY
ARLSAIYGGTY	ARLSAIYGG
GRSLPRFQV	GRSLPRFQV
GRIPSAVGY	GRIPSAVGY
GRLQQVLTGL	GRLQVLTGL
VRCSVQRIE	VRCSVQRIE
GRLSPIENF	GRLSPIENF
YRLPPPSDPQY	YRLPSDPQY
FRYNGLIHR	FRYNGLIHR
SRLFSASEF	SRLFSASEF
YRYYNKYINVK	YRYYKYINV
GRLAAIVAK	GRLAAIVAK
QRIGLSSQELF	QRIGSSQEL
GRITKVLNM	GRITKVLNM
RRLALFPGVA	RRLALFPGV
SRLDQPFIPR	SRLDPFIPR
HRFEQAFYTY	HRFEAFYTY
ERAIQESLL	ERAIQESLL
RRNAVLEADF	RRNALEADF
ARYGLHVRF	ARYGLHVRF
GRYLGKKVQF	GRYLKKVQF
MRANITAIRR	MRANTAIRR
RRRIFDAVGF	RRIFDAVGF
YRYIGKTMDY	YRYIKTMDY
VRAWVVFKL	VRAWVVFKL
VRWAPNENKF	VRWANENKF
ARLQYGLLIF	ARLQYGLLI
GRWVQKKFQK	GRWVKKFQK
ARLFGLAQR	ARLFGLAQR
GRVLIGVGK	GRVLIGVGK
SRAVTIFIR	SRAVTIFIR
RRIEYIEAR	RRIEYIEAR
GRVFIIKSY	GRVFIIKSY
KRFILNLPTF	KRFINLPTF
RRLKAELGI	RRLKAELGI
HRVGPIEATSF	HRVGPIEAT
GRQFLTQLM	GRQFLTQLM
IRYPDSHQLF	IRYPSHQLF
SRLDLIAQQM	SRLDIAQQM
LRNKVIIEY	LRNKVIIEY
ARQDLSKILR	ARQDSKILR
WRKKQSDVMRF	WRKKSDVMR
KRILKFLKLF	KRILKFLKL
GRIYLEPPTMR	GRIYEPPTM
GRAYVITGM	GRAYVITGM
GRWDQQYVI	GRWDQQYVI
SRAQFFLHL	SRAQFFLHL
ARLGITMKA	ARLGITMKA
TRIKIGLNSK	TRIKGLNSK
GRGVIPSTLAF	GRGVIPSTL
QRVPLSVQL	QRVPLSVQL
ARVTGVPLSY	ARVTVPLSY
MRLSALLAL	MRLSALLAL
VRGGVAVPLR	VRGGVAVPL
ARHSLLQTL	ARHSLLQTL
QRSSVQEFMTF	QRSSVQEFM
RRVEPTVTI	RRVEPTVTI
ARYLVNEGF	ARYLVNEGF
SRIPFNQALVF	SRIPFNQAL
ARMWKTLTF	ARMWKTLTF
KRFDEWKELK	KRFDEWKEL
LRVDPVNFKLL	LRVDVNFKL
RRMPPPANL	RRMPPPANL
SRLATLNEK	SRLATLNEK
SRIWPLYLRF	SRIWLYLRF
ARLDWELEQRK	ARLDELEQR
LRYPMAVGLNK	LRYPMAVGL
SRVQVQKAF	SRVQVQKAF
LRWIGDKEATY	LRWIGDKEA
RRLDIVRSL	RRLDIVRSL
RRFDLRFVVI	RRFDLRFVV
SRIHLKLHF	SRIHLKLHF
RRYGLPYVVR	RRYGPYVVR
GRLVTRAAF	GRLVTRAAF
RRYPDAVYL	RRYPDAVYL
GRFDITIGPK	GRFDTIGPK
SRFEDNEELRY	SRFEDNEEL
FRNFKIIYR	FRNFKIIYR
TRFDQVMKF	TRFDQVMKF
SRMLKLLAL	SRMLKLLAL
RRLAVLPYELR	RRLALPYEL
RRATVFLAM	RRATVFLAM
GRLRFWIHM	GRLRFWIHM
QRFESYYNY	QRFESYYNY
KRLESLGALTH	KRLESLGAL
RRVLQALEGLK	RRVLALEGL
GRSDLIPTIKF	GRSDLIPTI
GRLLVATTF	GRLLVATTF
SRIVFPFTF	SRIVFPFTF
VRLNIISNL	VRLNIISNL
TRYDLYHTF	TRYDLYHTF
GRNMYLTGL	GRNMYLTGL
GRLKELCEQY	GRLKLCEQY
TRLPLISGFYK	TRLPLISGF
NAPLVHATL	NAPLVHATL
RRWKAGLYGL	RRWKGLYGL
YRFEVPTAKF	YRFEVPTAK
SRVPLFPVF	SRVPLFPVF
ARKLPEKTQTF	ARKLEKTQT
GRSLIKLNF	GRSLIKLNF
ARFTGVGVSK	ARFTVGVSK
LRARVRPLF	LRARVRPLF
SRLDFTVEH	SRLDFTVEH
HRFFTEILRM	HRFFTEILR
YRFVKKLEH	YRFVKKLEH
RRVEKHWRL	RRVEKHWRL
LRDNIQGITK	LRDNQGITK
GRLLWEQELY	GRLLWEQEL
LRVKELEVRK	LRVKLEVRK
YRFGEMQLDF	YRFGMQLDF
ARYLMLLVF	ARYLMLLVF
HRTEMDWVLK	HRTEMDWVL
SRFGNAFLNR	SRFGAFLNR
YRFATDRNDF	YRFADRNDF
FRIHLRNEF	FRIHLRNEF
ARLEALDYLQK	ARLEALDYL
FRFQQENLK	FRFQQENLK
MRLELDALRSK	MRLELDALR
YRYYNKYINV	YRYYKYINV
KRFDMAVMF	KRFDMAVMF
KRISEQFTAMF	KRISQFTAM
KRKMILQQF	KRKMILQQF
TRLEFQQQL	TRLEFQQQL
ARNLTVVNY	ARNLTVVNY
HRLEELYTKKL	HRLEELYTK
QRTDVLTGL	QRTDVLTGL
QRTDVLTGLSI	QRTDVLTGL
RRFEEALQTIF	RRFEALQTI
ARIGIPSTKY	ARIGIPSTK
GRYTIKVLF	GRYTIKVLF
RRFQYEEEV	RRFQYEEEV
NRMEPLWTGF	NRMELWTGF
YRINLQMRL	YRINLQMRL
GRLRVIVGR	GRLRVIVGR
HRFHPEPYGL	HRFHEPYGL
RRYLSPKYIK	RRYLSPKYI
RRYIGIVKQ	RRYIGIVKQ
SRWLAQPYY	SRWLAQPYY
HRIEIPFKF	HRIEIPFKF
QRHDGAFLI	QRHDGAFLI
ARSLFNRMDF	ARSLNRMDF
ARVIFITEY	ARVIFITEY
SRFSLENNF	SRFSLENNF
VRGEKALLV	VRGEKALLV
GRLGSAMIGGF	GRLGMIGGF
SRYTPYHVNL	SRYTYHVNL
SRVNVSVGY	SRVNVSVGY
GRLWISVAR	GRLWISVAR
RRKDFVSEAY	RRKDVSEAY
GRILSGVVTK	GRILGVVTK
ARLLLIFDY	ARLLLIFDY
GRMKIETNRL	GRMKETNRL
SRAIIRENEF	SRAIRENEF
RRIYDLIEL	RRIYDLIEL
GRNKYLINGV	GRNKLINGV
RRVWVSENF	RRVWVSENF
RRIKQFLQSRY	RRIKFLQSR
ARTPHWALF	ARTPHWALF
QRTNLDVNL	QRTNLDVNL
GRTSLTNLL	GRTSLTNLL
RRSNMEFLF	RRSNMEFLF
VRLLLPGELAK	VRLLLPGEL
GRFLGKGGFAK	GRFLGKGGF
TRTIYQFHY	TRTIYQFHY
SRLPRQLFL	SRLPRQLFL
IRAGLIPKF	IRAGLIPKF
GRIFIGTFK	GRIFIGTFK
SRLRNQSVF	SRLRNQSVF
ARIWDVRTK	ARIWDVRTK
ARGGFVQILTK	ARGGFVQIL
RRIDQLNREL	RRIDLNREL
KRALKFIKK	KRALKFIKK
SRFQAEIPLMR	SRFQEIPLM
RRIKEIVKK	RRIKEIVKK
QRLFIINFI	QRLFIINFI
GRADLIPLLLK	GRADIPLLL
ARIQILEGWKK	ARIQILEGW
RQVIPIIGK	RQVIPIIGK
LRYVFGFEL	LRYVFGFEL
GRLDVFLRF	GRLDVFLRF
NRFAGFGIGL	NRFAFGIGL
KRFEETGQEL	KRFETGQEL
SRIKDLAHQF	SRIKLAHQF
RRVVSEIPVLK	RRVVEIPVL
RRFKLLEQAL	RRFKLEQAL
GRWGPTFPSSY	GRWGTFPSS
MRANITAIR	MRANITAIR
HRVDLDILTF	HRVDDILTF
GRLLGIITKK	GRLLGIITK
SRFDMIFIV	SRFDMIFIV
RRIFQEPTEPK	RRIFQEPTE
ARFYIGEMVL	ARFYGEMVL
RRITSDFRIGF	RRITSDFRI
RRISGVDRYY	RRISGVDRY
TRLPPTPLLLF	TRLPTPLLL
KRFGPNVPAL	KRFGNVPAL
RRFDAMPFTL	RRFDMPFTL
ARHDVIKGLL	ARHDVIKGL
ARKFVFFNI	ARKFVFFNI
SRWPAFPAF	SRWPAFPAF
TRYHFLILL	TRYHFLILL
GRFDREFLF	GRFDREFLF
YRYPIVLGY	YRYPIVLGY
GRNFWVSGL	GRNFWVSGL
KRIQDIVGILR	KRIQDIVGI
RRILLAEVPTM	RRILAEVPT
ERNPAVYNF	ERNPAVYNF
SRLWPKIQGL	SRLWKIQGL
GRFSHRIYV	GRFSHRIYV
ARHMVMQKL	ARHMVMQKL
HRFWAGVVFL	HRFWGVVFL
LRLDPNFLLK	LRLDPNFLL
LRAAPVTGGM	LRAAVTGGM
LRFEVVPSKF	LRFEVVPSK
RRFPEQVRV	RRFPEQVRV
ARLDNLKAHL	ARLDLKAHL
GRHIQQYHM	GRHIQQYHM
RRMWPLAFGSG	RRMW-PLAF
LRVDPVNFKL	LRVDVNFKL
SRSVALAVLAL	SRSVALAVL
LRLQVVLEHM	LRLQVVLEH
RRIQDPLIEF	RRIQPLIEF
QRLPSETIQTY	QRLPETIQT
RRFDGVQDPRI	RRFDVQDPR
YRIKFKESF	YRIKFKESF
TRYLIKLLL	TRYLIKLLL
MRMATPLLM	MRMATPLLM
VRIGGISGIFK	VRIGGISGI
KRFNADNKLLL	KRFNADNKL
MRFSYPDIHF	MRFSPDIHF
ARHDLLPHL	ARHDLLPHL
RRGDLPFVVPR	RRGDLPFVV
NRIAIYELLF	NRIAIYELL
ARLPLVNSY	ARLPLVNSY
RRKSSGGKGGS	RRKSGGKGG
HRFDPKASSSF	HRFDPKASS
RRVLVQVSY	RRVLVQVSY
KRIDIIHNL	KRIDIIHNL
ARFGPGGQLIK	ARFGPGGQL
RRFKEPWFL	RRFKEPWFL
TRIKGFIACF	TRIKFIACF
ARKHFVLLL	ARKHFVLLL
FRFGQDQLLL	FRFGDQLLL
HRIYGKFLGL	HRIYKFLGL
KRYDREFLLGF	KRYDREFLL
GRAPPPLSF	GRAPPPLSF
ARIQIFLTF	ARIQIFLTF
FRMKLRNLF	FRMKLRNLF
RRGGIPVLR	RRGGIPVLR
HRWEVCLTM	HRWEVCLTM
GRTYPVQEY	GRTYPVQEY
ARLDPKFLVNL	ARLDPKFLV
LPINGNGKQ	LPINGNGKQ
KRWFWSIVEKM	KRWFSIVEK
SRFQTYITY	SRFQTYITY
GRSSLDNIEM	GRSSDNIEM
SRMFPVPSSQV	SRMFVPSSQ
RRSSIPITVR	RRSSIPITV
GRKTGQAPGY	GRKTQAPGY
HRLPVEVAY	HRLPVEVAY
GRYQVSWSL	GRYQVSWSL
RRLSFLVSYI	RRLSFLVSY
TRDSNIIRL	TRDSNIIRL
LRTISVILF	LRTISVILF
ARWTYPVLL	ARWTYPVLL
YLNENPLRAL	YLNEPLRAL
FRLFPVPGSGL	RLFPPGSGL
ARKLLLDNL	ARKLLLDNL
GRNIILTTM	GRNIILTTM
RRDVQKVVGF	RRDVKVVGF
KRNEFLGELQK	KRNEFLGEL
KRTFPVLLR	KRTFPVLLR
RRLNFVRLL	RRLNFVRLL
QRKKAYADF	QRKKAYADF
ARVPGPPAR	ARVPGPPAR
ARIVAEEFLK	ARIVAEEFL
GRFGPSLVR	GRFGPSLVR
QRLGTQPYFF	QRLGTQPYF
KRKELITVF	KRKELITVF
RRGDFIHVM	RRGDFIHVM
KRFHITENSY	KRFHTENSY
RRHVFIWISF	RRHVIWISF
RRLSFRSTI	RRLSFRSTI
ARSMVSTIMKF	ARSMVSTIM
GRKPMLYSF	GRKPMLYSF
SRMDVTSCISY	SRMDVTSCI
ARNQLRMYL	ARNQLRMYL
ARDLYDAGVKR	ARDLYDAGV
SRFIFNYVY	SRFIFNYVY
VRSTVRIGL	VRSTVRIGL
SRLLLIWQH	SRLLLIWQH
TRYQTFVNF	TRYQTFVNF
ARLPWAGQL	ARLPWAGQL
ARFKERVGY	ARFKERVGY
IRQSISKAL	IRQSISKAL
SRWQQGNVF	SRWQQGNVF
GRFVWRVNL	GRFVWRVNL
SRFAQIVQK	SRFAQIVQK
VRSYSDPPLK	VRSYDPPLK
ERHGYIKGIVK	ERHGYIKGI
ARFTGAPLKV	ARFTAPLKV
RRLVPDSDVRF	RRLVDSDVR
ARAFIILSV	ARAFIILSV
GRWQYPLIYGL	GRWQYPLIY
SRWLAQPYYL	SRWLQPYYL
RRFSDIQIRRL	RRFSIQIRR
SRQGGLLVNF	SRQGLLVNF
RRYYKPGLLMM	RRYYKPGLL
ARFSPKVSL	ARFSPKVSL
FRFSGLLLGY	FRFSLLLGY
QRLLLVTVF	QRLLLVTVF
ARVIIEKYY	ARVIIEKYY
GRKVAIDASM	GRKVIDASM
YRFVQGKDWGF	YRFVKDWGF
GRLSHILEM	GRLSHILEM
RRWEQALTF	RRWEQALTF
GRYPGVSNY	GRYPGVSNY
QRFGTPASL	QRFGTPASL
GRFHGEEVAVK	GRFHEEVAV
SRLSIPTYGL	SRLSPTYGL
GRISDFHETY	GRISFHETY
RRFLTQPQV	RRFLTQPQV
QRYSGSTYL	QRYSGSTYL
QRLSELKR	QRLS-ELKR
ARWVEVLGF	ARWVEVLGF
NRLLKLFTR	NRLLKLFTR
VRVKLVSAGF	VRVKVSAGF
KRTLIAEGY	KRTLIAEGY
ARFEQLISRR	ARFEQLISR
SRYFGVLQR	SRYFGVLQR
KRHDLVKLGF	KRHDVKLGF
ARLDLLYRL	ARLDLLYRL
HRRIPILFF	HRRIPILFF
SRIWPLYLR	SRIWPLYLR
GRDVGVFTF	GRDVGVFTF
GRVNYVLAR	GRVNYVLAR
SRDPVQLNL	SRDPVQLNL
GRHYWEVEV	GRHYWEVEV
YRTDMIQAL	YRTDMIQAL
GRIFIGTFKAF	GRIFIGTFK
IRLGLALNF	IRLGLALNF
ARAALQELLSK	ARAALQELL
SRFDASFFGV	SRFDSFFGV
GRFQKDISQGL	GRFQKDISQ
RRFFPYYV	RRFF-PYYV
SRIKGWWVF	SRIKGWWVF
IRKPVDFKK	IRKPVDFKK
HRAQLQIRI	HRAQLQIRI
HRLEELYTKK	HRLEELYTK
ARIKINEEF	ARIKINEEF
RRNVFFPKRR	RRNVFFPKR
RRSIISPNF	RRSIISPNF
KRLGTLVVTY	KRLGLVVTY
KRFQAFVKK	KRFQAFVKK
GRYTILIKY	GRYTILIKY
IWHHTFYNELR	HHTFYNELR
TRILFFNTPK	TRILFNTPK
GRNIRQLSL	GRNIRQLSL
SRFWYDFTL	SRFWYDFTL
GRLQVDSAEY	GRLQDSAEY
FRYQGHVGA	FRYQGHVGA
RRAIYQATY	RRAIYQATY
ARNPSLKQQLF	ARNPLKQQL
WRLGSSDILNY	WRLGSSDIL
ARLDETPFGKM	ARLDTPFGK
SRYWAIRTR	SRYWAIRTR
GRLGISLTR	GRLGISLTR
TRLPRIALF	TRLPRIALF
GRFLIDFSY	GRFLIDFSY
RRLPILPTLL	RRLPLPTLL
SRAGLQFPV	SRAGLQFPV
GRIPTCFTL	GRIPTCFTL
GRHFIHIRH	GRHFIHIRH
ARWLTQEEF	ARWLTQEEF
GRIRDIDLKR	GRIRIDLKR
ARLGVISKV	ARLGVISKV
GRSAFIGIGF	GRSAIGIGF
HQILPKEQWTK	QILPEQWTK
SRLYLIFEF	SRLYLIFEF
ARLSIRPGL	ARLSIRPGL
RGLKTSAPR	RGLKTSAPR
ARVTKVLGR	ARVTKVLGR
ARLQIEIGKL	ARLQIEIGK
ARLEKAIAF	ARLEKAIAF
RRILVATNL	RRILVATNL
GRFADSHEL	GRFADSHEL
GRSNINVGL	GRSNINVGL
YRPGTVAL	YRPG-TVAL
GRIGQAIARR	GRIGQAIAR
ARCFYGFQI	ARCFYGFQI
KRYQDIIHSI	KRYQIIHSI
SRVLWLSGL	SRVLWLSGL
GRQKVSFSF	GRQKVSFSF
RRLGLAQKL	RRLGLAQKL
ARFDGAEGSWF	ARFDGAEGS
KRVYLGALKY	KRVYGALKY
GRSEVIYNY	GRSEVIYNY
KRLGLLAGF	KRLGLLAGF
KRKDFGIMF	KRKDFGIMF
RRLENLENLLR	RRLELENLL
RRIEVNVELR	RRIEVNVEL
KRLEFLYDKL	KRLELYDKL
RRHLNIAKEGF	RRHLAKEGF
ARWLPLGLGL	ARWLLGLGL
QRTPVQMMY	QRTPVQMMY
KRFKVSDEVGF	KRFKVSDEV
GRIGVWNAV	GRIGVWNAV
YRIQTYAEY	YRIQTYAEY
RRSSIGLRV	RRSSIGLRV
RRFKEFLRQY	RRFKFLRQY
RRHWGGNVL	RRHWGGNVL
HRFWKTELF	HRFWKTELF
FRVPFIYGHKY	FRVPFIYGH
SRVNIPKVLR	SRVNPKVLR
ARVLQDFYL	ARVLQDFYL
ERFQSLGVAF	ERFQLGVAF
GRFEDVYQL	GRFEDVYQL
RRLEELITIF	RRLELITIF
ARIFQFQNF	ARIFQFQNF
RRMWPLAFG	RRMWPLAFG
RRLSAIFLRL	RRLSIFLRL
ARNSFRYNGL	ARNSRYNGL
GRYDMAQLRF	GRYDAQLRF
TRIGVMSLIRK	TRIGVMSLI
GRAEKVTFQF	GRAEVTFQF
ARARLSNLAL	ARARSNLAL
RRYYKPGLLM	RRYYKPGLL
ARFEQLISR	ARFEQLISR
GRLQPSPLF	GRLQPSPLF
GRFLVHESF	GRFLVHESF
YRFHEHWRF	YRFHEHWRF
QRNVNIFKF	QRNVNIFKF
RQASVIIQRF	RQASIIQRF
SRVWWDSSF	SRVWWDSSF
ARILFLLQL	ARILFLLQL
RRKEIMLGL	RRKEIMLGL
RRWLPAGDAL	RRWLAGDAL
RRMQSINAGF	RRMQINAGF
HRFVSVSKLKY	HRFVSVSKL
ARHSNVNLTIF	ARHSVNLTI
VRFSPDGELY	VRFSDGELY
GRLIYTGNMAR	GRLIYTGNM
TRFNKQFLY	TRFNKQFLY
SRLKALNATF	SRLKLNATF
LRSALQILF	LRSALQILF
ARFEGSLNM	ARFEGSLNM
VRSPVTNIAR	VRSPTNIAR
SRFDIPLGL	SRFDIPLGL
SRFGKFIQL	SRFGKFIQL
SRSVIRPPF	SRSVIRPPF
QRAGLQFPVGR	QRAGLQFPV
RRTEIIEDL	RRTEIIEDL
RLFGIRAK	RLFG-IRAK
NRLFVGSIPK	NRLFGSIPK
GRMHGKFSL	GRMHGKFSL
GRTGLALYV	GRTGLALYV
GRTQMTLTF	GRTQMTLTF
QRMKIDREF	QRMKIDREF
HRFFYSKSF	HRFFYSKSF
HRLLLIQAF	HRLLLIQAF
GSLRVLVLR	GSLRVLVLR
ARYRSDGALLL	YRSDGALLL
ARLYYYWER	ARLYYYWER
RRNDDIINFF	RRNDDIINF
ARVKLVTEL	ARVKLVTEL
ARHFQPFAR	ARHFQPFAR
SRIYVALGY	SRIYVALGY
MRLGSPGLLF	MRLGPGLLF
RRYPQVVTR	RRYPQVVTR
WRSDLELQF	WRSDLELQF
RRINVAVTR	RRINVAVTR
SRLGVAGQWRF	SRLGAGQWR
ARVHIGQVIM	ARVHIGQVI
GRVRPGETL	GRVRPGETL
RRGLFTGLTPR	RRGL-FTGL
RRKEVVVYL	RRKEVVVYL
HRYRPGTVALR	HRYRGTVAL
HRLPHVLLL	HRLPHVLLL
KRFDFDYTTM	KRFDDYTTM
PKIVKWDRDM	KIVKWDRDM
QRNELNAKV	QRNELNAKV
NRFKGVKYF	NRFKGVKYF
GRFDMQVTV	GRFDMQVTV
ALEEQLQQIR	ALEEQLQQI
WRWPEFSKF	WRWPEFSKF
LRFDGALNV	LRFDGALNV
YRLGNVDAF	YRLGNVDAF
ARTTIINEIQY	ARTTIINEI
GRLELVNSRF	GRLELVNSR
GRYGAICGFGL	GRYGAICGF
IIPRGKGLGY	IPRGKGLGY
HRLLLLLLR	HRLLLLLLR
FRVLVVSAK	FRVLVVSAK
ARFYLPILV	ARFYLPILV
ARAALQELL	ARAALQELL
RRYLRVVVL	RRYLRVVVL
KRTLILTHF	KRTLILTHF
SRFIVIADF	SRFIVIADF
NRIVYLYTK	NRIVYLYTK
GRIKLQKALL	GRIKQKALL
ARFSPKVSLPK	ARFSPKVSL
ARFLLEGQVF	ARFLEGQVF
GRIPEQILGK	GRIPQILGK
SRNLFVLGF	SRNLFVLGF
RRISPPVDLEY	RRISPPVDL
GRTFLRVLL	GRTFLRVLL
GRLFAVVHF	GRLFAVVHF
SRYQDILVF	SRYQDILVF
HRFEKLMEYF	HRFEKLMEY
RRFFLEYDRL	RRFFEYDRL
RRLPDQFSKL	RRLPQFSKL
ARTGGVLGI	ARTGGVLGI
GRNDMTYNY	GRNDMTYNY
LRHYGYLRF	LRHYGYLRF
VRFYIESISY	VRFYESISY
HRWLKGGVVL	HRWLGGVVL
YRFLPQKIIYL	YRFLQKIIY
SRIQSLHLLF	SRIQLHLLF
QRYHFIMAY	QRYHFIMAY
TRFFQSHYF	TRFFQSHYF
ARGMFVFGY	ARGMFVFGY
SRFFMTPPRL	SRFFTPPRL
ARLLEVPVM	ARLLEVPVM
YRLGAPFTV	YRLGAPFTV
SRSWLSYSY	SRSWLSYSY
SRFEKEFSF	SRFEKEFSF
LRVDQIIMAK	LRVDIIMAK
RRFFPYYVYN	RRFFPYYVY
KRFSFKKSF	KRFSFKKSF
GRTLSDYNI	GRTLSDYNI
HRQGFSYDY	HRQGFSYDY
RRMETIVFL	RRMETIVFL
RRFGIQAQM	RRFGIQAQM
QRFRQFILL	QRFRQFILL
YRDARSYNRF	YRDASYNRF
IRTGLVRLL	IRTGLVRLL
ARLPKPKAK	ARLPKPKAK
KRIEAIVKNY	KRIEIVKNY
PDEVHAILR	PDEVHAILR
GRYGEVMPVY	GRYGVMPVY
ARFRNISRI	ARFRNISRI
MRLGSIFGL	MRLGSIFGL
RRREFVMQV	RRREFVMQV
ARSELLTTV	ARSELLTTV
FYPHVEVVLTI	YPHVVVLTI
IRSAVSVHL	IRSAVSVHL
GRSCIILEF	GRSCIILEF
RRNLILNLGL	RRNLLNLGL
WRFKPIEQL	WRFKPIEQL
ARLEKVHSLF	ARLEKVHSL
ARSELYLRF	ARSELYLRF
KRFHWTAYL	KRFHWTAYL
ERLELLLQK	ERLELLLQK
VRAGVFLGL	VRAGVFLGL
RRILMGSTLRK	RRILMGSTL
GRFGGNPGGF	GRFGNPGGF
RRLLLLPLLL	RRLLLPLLL
HLRDEGLR	HLRD-EGLR
ERFSGTYHF	ERFSGTYHF
QRMAIQVDKF	QRMAQVDKF
QRILSQPTF	QRILSQPTF
RRFVNVVPTF	RRFVVVPTF
KRWAASPKSF	KRWASPKSF
ARAFPMPGF	ARAFPMPGF
RRLPADHVSGY	RRLPHVSGY
KRFGLNIDRW	KRFGLNIDR
GRYGGETKV	GRYGGETKV
SRFLKSDLFL	SRFLKSDLF
GRTYPVQEYF	GRTYPVQEY
ARFFKQPTF	ARFFKQPTF
LRWLGANAF	LRWLGANAF
GRVLFPATGY	GRVLPATGY
ARLVLLKKL	ARLVLLKKL
MRFDGLLGF	MRFDGLLGF
VRSRVLQLF	VRSRVLQLF
IRAPPPIAY	IRAPPPIAY
GRVPYPRIPL	GRVPPRIPL
ARFDVNTPL	ARFDVNTPL
GRIDKPILK	GRIDKPILK
HRLGLIPLI	HRLGLIPLI
SRVPKYIFR	SRVPKYIFR
SRLSTAVNIGK	SRLSTAVNI
FRVDYILSV	FRVDYILSV
QRSLINSNVGF	QRSLINSNV
GRLAHEVGWKY	GRLAHEVGW
RRNSINFERL	RRNSNFERL
SRFLIINAM	SRFLIINAM
ARAANMFKM	ARAANMFKM
SRVKFSPSL	SRVKFSPSL
GRVDFAYKFK	GRVDFAYKF
SVPVSLQTL	SVPVSLQTL
GRTVILYKV	GRTVILYKV
ARIFLEESL	ARIFLEESL
RRAQLPKYQR	RRAQPKYQR
ARFEGDFKLF	ARFEGDFKL
KRHNLAIDLM	KRHNLAIDL
FRYPQDYQF	FRYPQDYQF
RRIQFPIEMS	RRIQFPIEM
HRVLLFCQM	HRVLLFCQM
SRFEKRLIF	SRFEKRLIF
HRITIKKRF	HRITIKKRF
KRMGMSFGL	KRMGMSFGL
QRLKAAITI	QRLKAAITI
MRTSVKISY	MRTSVKISY
KRMEHFYLNF	KRMEFYLNF
RRAASLLRF	RRAASLLRF
IRYFVSEGF	IRYFVSEGF
GRIGRLVTR	GRIGRLVTR
RRYLSPKYIKM	RRYLSPKYI
ARSELLTTVSL	ARSELLTTV
RRNMERLTL	RRNMERLTL
RRKDLVLKY	RRKDLVLKY
KRYSPDELRYL	KRYSDELRY
GRLDAVLQRI	GRLDAVLQR
LRDEINAILQK	LRDEINAIL
GRSSVILLTY	GRSSILLTY
HRISVFRPGL	HRISFRPGL
RDYVVPILII	RDYVVPILI
GRLDRKIEF	GRLDRKIEF
LRIYISNTF	LRIYISNTF
RRGLPRLAV	RRGLPRLAV
GRAALITSF	GRAALITSF
GRVYVGFTV	GRVYVGFTV
YRVLLRYEGF	YRVLRYEGF
RRWLPAGDA	RRWLPAGDA
IRWGFIPLVIY	IRWGFIPLV
LRVTSVVTGF	LRVTVVTGF
IRAPTIEQM	IRAPTIEQM
ARFMPGTIWSF	ARFMTIWSF
RRNQLLLEF	RRNQLLLEF
SRNAGAFGF	SRNAGAFGF
QRVNVQPEL	QRVNVQPEL
GRADKVGFFVK	GRADKVGFF
GRDGRLRVGL	GRDGLRVGL
QRVQLHIAMF	QRVQLHIAM
GRVDVAVNC	GRVDVAVNC
ARFDSKDEILL	ARFDKDEIL
ARFNDLRFVGR	ARFNDLRFV
TRYPTILQL	TRYPTILQL
RRLGLALGLL	RRLGLALGL
ARLQQMSERF	ARLQMSERF
ARLQTALL	ARLQ-TALL
RRFDLQNPSRM	RRFDQNPSR
GRANHFFTV	GRANHFFTV
ARVVPVPLL	ARVVPVPLL
ARFSGNLLVSL	ARFSGNLLV
QRWDEAFRKF	QRWDEAFRK
ARTDGKVFQF	ARTDKVFQF
SRFDTNINF	SRFDTNINF
RRFTEIYEF	RRFTEIYEF
SRFKPRVPVIK	SRFKPRVPV
YRFLPQKIIY	YRFLQKIIY
KRNDYVHAL	KRNDYVHAL
GRMGSQVIIPY	GRMGSQVII
GRYMIGVTY	GRYMIGVTY
KRHRPIGIGV	KRHRIGIGV
IRHTVNKITF	IRHTNKITF
KRALLEIVI	KRALLEIVI
RRLQIEDFEAR	RRLQEDFEA
KRIIRPFFL	KRIIRPFFL
RRIGDYKVKY	RRIGYKVKY
RRLRVLSGHLL	RRLRVLSGH
ARHEHQVML	ARHEHQVML
SRIHPVSTMVK	SRIHPVSTM
ARLPYLRTWF	ARLPLRTWF
YRFLIQNVL	YRFLIQNVL
ARYVPSTPWFL	ARYVSTPWF
RRFNIKLWKT	RRFNIKLWK
ARAGALFQL	ARAGALFQL
LRMDPLEAIQL	LRMDPLEAI
GRSQVSTPRF	GRSQSTPRF
RRAGIKVTVA	RRAGIKVTV
GRIGVITNR	GRIGVITNR
RRISGVDRY	RRISGVDRY
GRIDRKIEF	GRIDRKIEF
GRLEDTKLIK	GRLETKLIK
ARFGEAVVAR	ARFGAVVAR
VRFRGEQQLR	VRFRGEQQL
GRKDVVEHLL	GRKDVVEHL
RRFDLLKRI	RRFDLLKRI
SRLGSVFPF	SRLGSVFPF
HRAPPIIGY	HRAPPIIGY
RRLGPVPPGL	RRLGVPPGL
SRKNNIPANF	SRKNIPANF
SRLYLNVLNR	SRLYNVLNR
GRLVIPAYTY	GRLVPAYTY
FRFGESTTGF	FRFGSTTGF
SRLKYPPFAK	SRLKPPFAK
SRNSNTVVFVK	SRNSNTVVF
GRKLSVQGF	GRKLSVQGF
KRWEGGYERTW	KRWEGGYER
SRSNLFVLR	SRSNLFVLR
QRWQSLLNF	QRWQSLLNF
GRIVAFFEF	GRIVAFFEF
ARLASLMNL	ARLASLMNL
GRLSKEDIERM	GRLSEDIER
HRNLIEIGY	HRNLIEIGY
IETKSASVAPF	TKSASVAPF
KRWEGGYER	KRWEGGYER
QRFGLNVSSIS	QRFGNVSSI
VRFGKMGVLR	VRFGMGVLR
GRFGPLASV	GRFGPLASV
VRVSIAISRM	VRVSIAISR
ARSSVVTAVKF	ARSSVVTAV
HRIVEAFRF	HRIVEAFRF
RRWDDSQKYL	RRWDDSQKY
MLMLLTLLV	MLMLLTLLV
HFSVEGQLEFR	FSVEGQLEF
HRADLFPILMR	HRADFPILM
YRFQAIITTF	YRFQIITTF
IRDAFLTRL	IRDAFLTRL
ARSVPRTLL	ARSVPRTLL
ERFLGPEIFF	ERFLPEIFF
ARFSPDDKYSR	ARFSPDDKY
LLSRSLLLRL	SRSL-LLRL
SRMSASILLSK	SRMSASILL
ARWLALGSLF	ARWLLGSLF
SRANSLFAF	SRANSLFAF
SRFRHPNIVDF	FRHPNIVDF
RRFLKLLRF	RRFLKLLRF
YRFFLGNQF	YRFFLGNQF
RRYFTQIVGF	RRYFQIVGF
KRFQQAGFNLR	KRFQAGFNL
GRMVQVHEL	GRMVQVHEL
KRNAVIGLNLY	KRNAIGLNL
KRWESERVLSF	KRWESERVL
KRVTWIVEF	KRVTWIVEF
RRWFIQQEM	RRWFIQQEM
FRGDTVLLK	FRGDTVLLK
RRNGPLPLKY	RRNGLPLKY
RRIKLLGILM	RRIKLGILM
YRFEGEGDIQR	YRFEGEGDI
QRYQTFLQLLY	QRYQTFLQL
KRVFPKWTY	KRVFPKWTY
FRWPMLLNM	FRWPMLLNM
VRNNVIIVM	VRNNVIIVM
GRIGVWNAVTK	GRIGVWNAV
ARHGHVDTLKF	ARHGHVDTL
NRIKFVIKR	NRIKFVIKR
ARHLKLFGY	ARHLKLFGY
GRVDFAYKF	GRVDFAYKF
SRMIRKMKL	SRMIRKMKL
YRWAVSSVMTR	YRWAVSSVM
ARIFLMEADL	ARIFMEADL
QRMDLVEAF	QRMDLVEAF
GRFGNTPFLF	GRFGTPFLF
YRYRDIVVR	YRYRDIVVR
ARLQIVLGH	ARLQIVLGH
IRVISKLSK	IRVISKLSK
RRDIRILVL	RRDIRILVL
GRFGYLEGQEY	GRFGYLEGQ
LRSLLEGLLQR	LRSLLEGLL
RRFLNGQVVF	RRFLGQVVF
GRYSQEPIKTF	GRYSQEPIK
KRWPIVGVRL	KRWPVGVRL
RMFLSFPTTK	RMFLFPTTK
MRLSLPLLLL	MRLSLPLLL
YRWFPSGKVVF	YRWFPSGKV
SRLQPFLQRY	SRLQPFLQR
SRIDLIPSL	SRIDLIPSL
YRNVMLENY	YRNVMLENY
ARFEGDFKL	ARFEGDFKL
LRYDLPASY	LRYDLPASY
RRLHLVFEY	RRLHLVFEY
MRFLAATFL	MRFLAATFL
GRVAPRSGL	GRVAPRSGL
SRFGKFIRINF	SRFGKFIRI
KRQLILFGGF	KRQLLFGGF
RRASYEFMR	RRASYEFMR
ARHYYFLGR	ARHYYFLGR
ARYQLSAIFKK	ARYQLSAIF
FRAEINILL	FRAEINILL
HRYPNQVYY	HRYPNQVYY
QRAFILTVK	QRAFILTVK
FRYNGLIHRK	FRYNLIHRK
QRLKIMEYY	QRLKIMEYY
GRYGISGELAM	GRYGISGEL
ARLPLRLFL	ARLPLRLFL
MRVLLPVLL	MRVLLPVLL
GRYEITVKL	GRYEITVKL
RRWGDSVLLVD	RRWGDSVLL
HRQEVYFRF	HRQEVYFRF
RRIDEINKEL	RRIDINKEL
SRWSGSHQF	SRWSGSHQF
RRALLHYLDF	RRALHYLDF
GRWPGSSLYY	GRWPGSSLY
KRFSLFGKKK	KRFSLFGKK
ARFGESIVNL	ARFGSIVNL
RQTGIVLNR	RQTGIVLNR
ARLNPQYPMFR	ARLNQYPMF
TRWNKIVLK	TRWNKIVLK
VRNNIAYGL	VRNNIAYGL
SRWSASFTVTK	SRWSASFTV
ARFALTVVRH	ARFALTVVR
YRHFLQITL	YRHFLQITL
GRLPDPPSL	GRLPDPPSL
LRLDFHAHGRH	LRLDHAHGR
RRLVKLVVNF	RRLVLVVNF
NRYYPQILTNK	NRYYPQILT
ARVSVEVRF	ARVSVEVRF
ARFGLIQSM	ARFGLIQSM
ARVSIVNQY	ARVSIVNQY
HAPLTNIPL	HAPLTNIPL
IRYLVEKPK	IRYLVEKPK
QRDLWNIFK	QRDLWNIFK
MRILHVNGF	MRILHVNGF
RRLDTSSLKL	RRLDSSLKL
ARGPGRPAV	ARGPGRPAV
RRSFIIQNI	RRSFIIQNI
GRLQLVNKL	GRLQLVNKL
YRWFPSGKVV	YRWFPSGKV
ARLDHKFDLM	ARLDHKFDL
RRLDLVHTA	RRLDLVHTA
LRLDIINSL	LRLDIINSL
GRAELLEGKM	GRAELLEGK
ARIWLFVGF	ARIWLFVGF
ARSNIMTLLF	ARSNMTLLF
IRSSLLLGF	IRSSLLLGF
LRAVIFITK	LRAVIFITK
RRFSRSPIRR	RRFSSPIRR
VRFKHRYLL	VRFKHRYLL
ARFQAGRELLR	ARFQGRELL
QRLFLPLIL	QRLFLPLIL
ARLALPAIYAF	ARLALPAIY
TRFLVRVSY	TRFLVRVSY
RRLQVQERL	RRLQVQERL
GRFKDWMVSM	GRFKWMVSM
SRIALKSGYGK	SRIALKSGY
ARFPETPAF	ARFPETPAF
KRFEQKGFRL	KRFEKGFRL
SRFWYFVSQLK	SRFWFVSQL
GRFSHRIYVAY	GRFSHRIYV
RRYHGYIFGF	RRYHYIFGF
RRLNSPIGR	RRLNSPIGR
MRWKALIEMEK	MRWKALIEM
SRFDLLWLI	SRFDLLWLI
RRMTVVGRL	RRMTVVGRL
IRIVLFLQK	IRIVLFLQK
GRLSNISHL	GRLSNISHL
QRNLYIAG	QRNL-YIAG
RRFPFVRER	RRFPFVRER
SRFKDRIVSM	SRFKRIVSM
GRLTVMTDL	GRLTVMTDL
QRANYVPAL	QRANYVPAL
GRIGPNIRL	GRIGPNIRL
GRFSSTTGL	GRFSSTTGL
QRVSIFFDY	QRVSIFFDY
GRLVRSDVAM	GRLVSDVAM
IQRTPKIQV	IQRTPKIQV
FRLDTPLYF	FRLDTPLYF
SRDAAWYQL	SRDAAWYQL
GRYPEAQSV	GRYPEAQSV
ARVFLQNLL	ARVFLQNLL
RRYGDFFIR	RRYGDFFIR
NAPLVNVTL	NAPLVNVTL
LRIPSQNQ	LRIP-SQNQ
TRVDTILEF	TRVDTILEF
SRTQVTYLAF	SRTQTYLAF
GRLPVGLSL	GRLPVGLSL
KRASYILRL	KRASYILRL
RRFLSQLIQKF	RRFLQLIQK
ARFPSTFSI	ARFPSTFSI
GRNILLARL	GRNILLARL
YENEVALRQ	YENEVALRQ
VRFNVLKVTK	VRFNLKVTK
GRTEVSFTL	GRTEVSFTL
CRTFHTIGF	CRTFHTIGF
SRFIKFQEM	SRFIKFQEM
KRWGPNYNL	KRWGPNYNL
KRLDYITAEI	KRLDITAEI
QRVSPTNMQGF	QRVS-PTNM
SRFLPRPVFSK	SRFLPRPVF
KRLSVERIY	KRLSVERIY
MRVTAPRTLLL	MRVTPRTLL
SRIGTSTSF	SRIGTSTSF
KRWQNEKLGL	KRWQEKLGL
GRWFPEGPTHM	GRWFEGPTH
QRVQDLMAQM	QRVQLMAQM
ARIKLGDYHF	ARIKGDYHF
RRLDIEAERL	RRLDEAERL
LRFGPNGGLVF	LRFGPNGGL
HRVALSVQL	HRVALSVQL
RRSWKILLF	RRSWKILLF
SRFLKSDLF	SRFLKSDLF
IRNSFQPLI	IRNSFQPLI
KRFEELTNL	KRFEELTNL
YRGVLNSPV	YRGVLNSPV
SRFEALNLSF	SRFELNLSF
FRMDSSATQF	FRMDSATQF
TRAFLPLLK	TRAFLPLLK
RRFAPDISSY	RRFADISSY
ARMLELPTIYR	ARMLELPTI
RRLNHYVLYK	RRLNHYVLY
SRIFVKIFF	SRIFVKIFF
MFNPMYALF	MFNPMYALF
HRLDHLVEIDF	HRLDHLVEI
FRLINIIHV	FRLINIIHV
QQLYWSHPR	QQLYWSHPR
SRWHTKKLPR	SRWHKKLPR
RRMYPPPLI	RRMYPPPLI
YRHLGRYLF	YRHLGRYLF
SRIVLVVVY	SRIVLVVVY
VRKDLQNF	VRKD-LQNF
GRAFIFPSY	GRAFIFPSY
IRFEDNGIYF	IRFENGIYF
QRHSFQISL	QRHSFQISL
RRFKEGGRGGK	RRFK-EGGR
ARFKLWYTL	ARFKLWYTL
GRTIIRSAY	GRTIIRSAY
KRFEGLTAR	KRFEGLTAR
RRTGPPMGSRF	RRTGPMGSR
IRLPSAQTPN	IRLPSAQTP
TRWDYLTQV	TRWDYLTQV
ARLLLPVAEY	ARLLPVAEY
HRIDLKTKI	HRIDLKTKI
QRLEQLVEAK	QRLELVEAK
QRQSILILK	QRQSILILK
VRLPPITKF	VRLPPITKF
SRIHVCLYF	SRIHVCLYF
QRVGQAVNL	QRVGQAVNL
GRYEVAVPL	GRYEVAVPL
SRTPYHVNLL	SRTPYHVNL
ARLLLPVAEYF	ARLLPVAEY
GRSVFDIGF	GRSVFDIGF
QRRKEAQVL	QRRKEAQVL
MRLSQLKQLLK	MRLSLKQLL
ARTSLLLLRL	ARTSLLLRL
TRLKAQPWLF	TRLKQPWLF
RRWYPEEYEF	RRWYEEYEF
GRYDPSVKPPF	GRYDPSVKP
TRLKLQGAKF	TRLKQGAKF
RRHGLLFLHL	RRHGLFLHL
TRMDHMVSSF	TRMDMVSSF
TRSGAIFTK	TRSGAIFTK
ARNALQVDL	ARNALQVDL
GRFDVRWIF	GRFDVRWIF
ARVEVKATF	ARVEVKATF
QRQQLPVTF	QRQQLPVTF
ARLKFPRLLQI	ARLKFPRLL
KRFEQEINAKK	KRFEEINAK
YRALTVPEL	YRALTVPEL
MRFPPKSYNK	MRFPKSYNK
GRTETTVTR	GRTETTVTR
KRYQEALHL	KRYQEALHL
HRYLLFMKL	HRYLLFMKL
SRSLLAAALLY	SRSLLAAAL
SRLNITYPML	SRLNTYPML
RRSSLWPMTF	RRSSWPMTF
GRLIYTGNM	GRLIYTGNM
ARFQEQSQL	ARFQEQSQL
GRNFRNPLAK	GRNFNPLAK
RRQDILDLWI	RRQD-ILDL
YRLPLRVVKHF	YRLPLRVVK
RRKALYEAL	RRKALYEAL
IRIQLPVVSK	IRIQPVVSK
ARLDILKIHSR	ARLDILKIH
RRMLKGRK	RRML-KGRK
ARIALLPLL	ARIALLPLL
ARLAQRIDF	ARLAQRIDF
ARFETQVRL	ARFETQVRL
SRIALKSGY	SRIALKSGY
GRDGYMGIGL	GRDGMGIGL
ARKQIVINLM	ARKQIVINL
ARMLITEENLM	ARMLTEENL
QRYSLLPFWY	QRYSLPFWY
ARGRAEVLI	ARGRAEVLI
SRWDETPASQM	SRWDTPASQ
VRHQFKIAFF	VRHQFKIAF
ARILLDNDHY	ARILDNDHY
KRFDFEQVTVK	KRFDEQVTV
HRSTIITLY	HRSTIITLY
ERIRFVIKK	ERIRFVIKK
ARLLQDHPWLL	ARLLDHPWL
SRFLPRPVF	SRFLPRPVF
SRLRVSTELRY	SRLRVSTEL
ARLPVEPHIGK	ARLPVEPHI
NRSLKELMF	NRSLKELMF
FSPVGSVL	FSPV-GSVL
RRAALGLLPLL	RRAAGLLPL
GRKGVAINF	GRKGVAINF
ARVGQALEL	ARVGQALEL
KRPHSHGF	KRPH-SHGF
ARLDHKFDLMY	ARLDHKFDL
GRVIQIVLM	GRVIQIVLM
ARMQAQMQM	ARMQAQMQM
ARLDWELEQR	ARLDELEQR
HLPETKFSEL	HLPEKFSEL
GRWLITLNK	GRWLITLNK
RRFFMGNQVL	RRFFGNQVL
ARFLITSNL	ARFLITSNL
ARLKLSEEL	ARLKLSEEL
VRFDGVYISK	VRFDVYISK
SRVLIFSQM	SRVLIFSQM
GRLTKHTKF	GRLTKHTKF
GRLLEIALGF	GRLLIALGF
NRLPLVVSF	NRLPLVVSF
RRVVYPLEKLL	RRVVYPLEK
SRFLWVTLL	SRFLWVTLL
SRNIPTLVK	SRNIPTLVK
GRMSIKAYV	GRMSIKAYV
IRWEKNITL	IRWEKNITL
RRLDLPSNL	RRLDLPSNL
YRKFFETKL	YRKFFETKL
ARSLQKLGF	ARSLQKLGF
KRTTVVAQL	KRTTVVAQL
GRVRTKTVK	GRVRTKTVK
ARHGEKLLL	ARHGEKLLL
RRIKLYAVEK	RRIKYAVEK
GRFDSSIIRI	GRFDSIIRI
TRYLKQFHL	TRYLKQFHL
SRRKNEKY	SRRK-NEKY
RRSSINILL	RRSSINILL
GRIDNVDAFM	GRIDNVDAF
VNLPINGNGKQ	VNLPNGNGK
RRALSKTPIR	RRALKTPIR
RRLPTVLLK	RRLPTVLLK
KRNELVIRV	KRNELVIRV
SRKLVSFTL	SRKLVSFTL
ARFSGNLLV	ARFSGNLLV
SRIKLAIKY	SRIKLAIKY
HRLFPKLQF	HRLFPKLQF
SRIKLGLKSL	SRIKGLKSL
RRYIDPSGFVK	RRYIDPSGF
TRMRHVISY	TRMRHVISY
RRFQSMPVR	RRFQSMPVR
GRVKGVTIVK	GRVKVTIVK
HRWNFDDLLEK	HRWNFDDLL
LFMFALML	LFMF-ALML
SRIPVSSGF	SRIPVSSGF
RRQGVQVQV	RRQGVQVQV
RRMSPATTGTF	RRMSATTGT
GRLAPRLGL	GRLAPRLGL
ARHNLIINI	ARHNLIINI
KRLERVIIGY	KRLEVIIGY
TRMDSNFGL	TRMDSNFGL
KRLVQSPNSY	KRLVSPNSY
ARVVQKLGF	ARVVQKLGF
GRFGSGMNM	GRFGSGMNM
LRFQSSAVMAL	LRFQSSAVM
TRMVLVNAVY	TRMVLVNAV
HRNEVTVEL	HRNEVTVEL
GRSLIINHL	GRSLIINHL
QRNKAAALLRL	QRNKAAALL
VRWFDPKSSF	VRWFPKSSF
RRIATGSFL	RRIATGSFL
RRLGVQQSL	RRLGVQQSL
ARAALQTAY	ARAALQTAY
KRIDIMVGMGY	KRIDIMVGM
RRSSLVITTK	RRSSVITTK
MRAENFFILR	MRAEFFILR
SRNSSMLTL	SRNSSMLTL
QRLIFAGKQL	QRLIAGKQL
ERLDLQWSL	ERLDLQWSL
SRLMGDYLL	SRLMGDYLL
SRQDLYPAL	SRQDLYPAL
IRSGISPNL	IRSGISPNL
KRLKTVLEL	KRLKTVLEL
KRFTYKFNF	KRFTYKFNF
VRFLGNLVL	VRFLGNLVL
LRLWLPKSL	LRLWLPKSL
GRVKLSDFGF	GRVKSDFGF
RRLVGLASLR	RRLVGLASL
VRFDVHDVTL	VRFDHDVTL
HRLQVSYEEY	HRLQSYEEY
KRLASSVLR	KRLASSVLR
RRAHIFPMA	RRAHIFPMA
GRVNVVEAL	GRVNVVEAL
RRFESFNLF	RRFESFNLF
KRATFDEVLE	KRATFDEVL
GRNVYRMLF	GRNVYRMLF
MRYFYTAMSR	MRYFTAMSR
RRLLLLLGF	RRLLLLLGF
GRVSIYDSK	GRVSIYDSK
KRVYNIPVRF	KRVYIPVRF
RRKDHSFLGF	RRKDSFLGF
QRFASIVAK	QRFASIVAK
SRISLADIAQK	SRISADIAQ
ERMFLSFPTTK	RMFLFPTTK
IRTVIQIHM	IRTVIQIHM
RRYHILGNEM	RRYHLGNEM
SRLGNSLLLK	SRLGNSLLL
ARLNWILHF	ARLNWILHF
RRWREPGVGA	RRWRPGVGA
YRNEFTAWYR	YRNETAWYR
RRLDIVRSLYE	RRLDIVRSL
SRLTTPVFGK	SRLTPVFGK
VRSGIVEYL	VRSGIVEYL
SRTNRPPLSL	SRTNPPLSL
IRAQLKREY	IRAQLKREY
QRFLVDQGYSF	QRFLVDQGY
NRLKQIKEFHR	NRLKQIKEF
RRFLAARAL	RRFLAARAL
HRALQIIAR	HRALQIIAR
FRNIPGITL	FRNIPGITL
RRISIVGFGL	RRISVGFGL
RRLDIAGRDI	RRLD-IAGR
HRFLLTPKVNM	HRFLLTPKV
LKRFYTIDTGQ	KRFYIDTGQ
FRGPLVINR	FRGPLVINR
IRAFPNKQGY	IRAFNKQGY
RRNVGRVLL	RRNVGRVLL
ARVLLISKL	ARVLLISKL
SRSPVVITI	SRSPVVITI
SRDAPLPPR	SRDAPLPPR
GRLRPGDGLLR	GRLRPGDGL
SRLPLAFAY	SRLPLAFAY
RRSGYITIGY	RRSGITIGY
RRAGIKVTV	RRAGIKVTV
GRLTQIKGLF	GRLTQIKGL
ARWELPLTV	ARWELPLTV
QRFGPPVSR	QRFGPPVSR
SRLADFAKER	SRLAFAKER
GRTDLLRLR	GRTDLLRLR
MRFNEVAAQY	MRFNVAAQY
GRFHGGNLFF	GRFHGGNLF
GRTNLIVNY	GRTNLIVNY
YRYYQQLKL	YRYYQQLKL
ARQLILPAL	ARQLILPAL
GTLDKKLER	GTLDKKLER
GRFNERFIL	GRFNERFIL
ARNSVLMSGF	ARNSLMSGF
ARLLMPSQL	ARLLMPSQL
QRVGGVDVSF	QRVGVDVSF
GRMESVFNH	GRMESVFNH
RRMLVQTHL	RRMLVQTHL
ARRSSLWPMTF	RRSSWPMTF
SRAGITMESY	SRAGTMESY
SRIIGVDINK	SRIIVDINK
GRVDLKEYVGY	GRVDLKEYV
SRIHPVSTM	SRIHPVSTM
IRFVYTPAM	IRFVYTPAM
TRQGGSPAK	TRQGGSPAK
KRDGTVLRL	KRDGTVLRL
HRFAFTPIY	HRFAFTPIY
GRWSGTLNL	GRWSGTLNL
KRNGVIIAGY	KRNGIIAGY
ARAVVTGLLAL	ARAVVTGLL
RRFTTSVVR	RRFTTSVVR
SRLFLFVAL	SRLFLFVAL
ARNPPGFAF	ARNPPGFAF
KRIDMVPELL	KRIDMVPEL
SRTPVLMNFM	SRTPVLMNF
ERLQYVFGY	ERLQYVFGY
KRFEQEINAK	KRFEEINAK
ARFYGNVSRF	ARFYNVSRF
RRYGELTKLIR	RRYGELTKL
RRLFPYSQY	RRLFPYSQY
QRIQLAEKF	QRIQLAEKF
MRVDFNVPM	MRVDFNVPM
ARFLFTTGF	ARFLFTTGF
NRDNVGLVL	NRDNVGLVL
IRKLIKDGL	IRKLIKDGL
ARLGGAVLSF	ARLGAVLSF
GRVVALFYF	GRVVALFYF
GRVGDVYIPR	GRVGVYIPR
YRVYQPVRY	YRVYQPVRY
QRMNFLVTL	QRMNFLVTL
YRFDTVIARI	YRFDTVIAR
RRLSLFLNV	RRLSLFLNV
SRIRAAWTR	SRIRAAWTR
GRADGISSTF	GRADISSTF
ERVKLQEAL	ERVKLQEAL
SRSGRGGNFGF	SRSGRGGNF
RRYWIFPSI	RRYWIFPSI
QRDPPHNNF	QRDPPHNNF
GRTFIQPNM	GRTFIQPNM
RRLVFDNQL	RRLVFDNQL
GRVLLVLMF	GRVLLVLMF
ARWLDEVRL	ARWLDEVRL
RRYLSPKYI	RRYLSPKYI
VRWEKIQPR	VRWEKIQPR
YRIPSTPDSF	YRIPTPDSF
RRLSADIRL	RRLSADIRL
YRLPLRVVK	YRLPLRVVK
RRMWPLAFGS	RRMW-PLAF
LRFPEILQK	LRFPEILQK
AGFAGDDAPR	AGFADDAPR
GRVKIIVGH	GRVKIIVGH
SRLKNTGLLLL	SRLKTGLLL
HRQSIVVSF	HRQSIVVSF
GRFLTGPLNL	GRFLGPLNL
IRGAIILAK	IRGAIILAK
GRHDIAFVEF	GRHDAFVEF
GRLPGTIWSY	GRLPTIWSY
GRYQIINGL	GRYQIINGL
KRFWYIEGI	KRFWYIEGI
RRNVNLLEKL	RRNVLLEKL
RREFQTSVVSR	RREFQTSVV
YRQPPVPQY	YRQPPVPQY
VRNDIYITL	VRNDIYITL
ARLVQGSILKK	ARLVGSILK
ARIPPVAVRL	ARIPVAVRL
RRKDAKSVKI	RRKDKSVKI
ARITDVDNGY	ARITVDNGY
VRFNVAKSLQK	VRFNVAKSL
TRYPILAGH	TRYPILAGH
ATPAGDIMEL	TPAGDIMEL
QRLPVGAAF	QRLPVGAAF
NRFEDILSLF	NRFEDILSL
GRWTDILSH	GRWTDILSH
GRHLLTVLL	GRHLLTVLL
SRMHVLLGM	SRMHVLLGM
ASFGERIKNTF	ERIK--NTF
ARLDLERKV	ARLDLERKV
SRFFLQGIQL	SRFFQGIQL
SSWKCIVR	SSWK-CIVR
WRYYEKNRSF	WRYYKNRSF
IRFSELPTQM	IRFSLPTQM
GRNALEIVM	GRNALEIVM
SRSLLQTTF	SRSLLQTTF
GRSLPVLGL	GRSLPVLGL
ARISMADVKF	ARISADVKF
SRFLSGIINF	SRFLGIINF
SRNALLFNL	SRNALLFNL
LRSSIREFL	LRSSIREFL
RRSANTQVVR	RRSATQVVR
SRLALHKQF	SRLALHKQF
YRQILKHPC	YRQILKHPC
RRFQSMPVRL	RRFQMPVRL
GRVESVKILPK	GRVESVKIL
ARIKQIKPLLS	ARIKIKPLL
GRLPNNSSR	GRLPNNSSR
RRLRNHMAVAF	LRNHMAVAF
HRSPLVLAY	HRSPLVLAY
RRTGSPLAAR	RRTGPLAAR
RRTASALFAGF	RRTASALFA
ARIRLDQDRL	ARIRDQDRL
RRSKESEV	RRSK-ESEV
QRFDARQKIGL	QRFDARQKI
RRFIVVEGL	RRFIVVEGL
ARHVVKVEY	ARHVVKVEY
FRNKSMLFK	FRNKSMLFK
ERINLILQM	ERINLILQM
GRIGNFIVKK	GRIGFIVKK
ARLVFVPLL	ARLVFVPLL
QRTGLSPLKF	QRTGSPLKF
GRAAEFIR	GRAA-EFIR
RRMEIQVKDL	RRMEQVKDL
NRMLKQMLF	NRMLKQMLF
GRYPDPNF	GRYP-DPNF
SRFLIINAML	SRFLIINAM
LAPLTYISL	LAPLTYISL
KRTVAAPSV	KRTVAAPSV
SRYEQVDLVGK	SRYEQVDLV
RRLLVDSKVSL	RRLLVDSKV
YRDTFSYNF	YRDTFSYNF
SRLKNLVLTY	SRLKLVLTY
SRTPVLMNF	SRTPVLMNF
TRLSNIFVIGK	TRLSNIFVI
ARLPSLNKL	ARLPSLNKL
CRFQIVQVLK	CRFQIVQVL
TRLELEENQM	TRLEEENQM
YRFNGQYSSL	YRFNQYSSL
VRLKNYYEV	VRLKNYYEV
KRFYEFSIRL	KRFYFSIRL
SRIMNLYQF	SRIMNLYQF
RRAVLSETF	RRAVLSETF
ARYPKKIHY	ARYPKKIHY
GRMGFVHNF	GRMGFVHNF
KRIRVSQPLTR	IRVSQPLTR
QRFEEYEYLGY	QRFEEYEYL
RRAALERYLQR	RRAALERYL
NRLTKIEGL	NRLTKIEGL
KRWQSPVTK	KRWQSPVTK
RRFDAMPFTLR	RRFDMPFTL
KRLDLDLTQF	KRLDDLTQF
RRLILQGNRI	RRLILQGNR
ARIFKAWAV	ARIFKAWAV
KIIRVTLSK	KIIRVTLSK
TRDPLVIEL	TRDPLVIEL
RRNGTLPWLR	RRNGLPWLR
QRFQLSSAF	QRFQLSSAF
SRWEKVVQRL	SRWEKVVQR
RRFMQTFVL	RRFMQTFVL
ARDEIEAMIKR	ARDEIEAMI
RRATPATEAGF	RRATPATEA
KRYLNSQQQYF	KRYLSQQQY
RRLGLALGL	RRLGLALGL
YRNQLLNIF	YRNQLLNIF
LRYDLPASYK	LRYDLPASY
ARAKFIPLITV	ARAKFIPLI
GRIDIKQLIAK	GRIDIKQLI
KRFSVPVQH	KRFSVPVQH
QDHRGAFLI	QDHRGAFLI
HRWTMQPRL	HRWTMQPRL
ARTLLAILRL	ARTLAILRL
ARAEIRAR	ARAE-IRAR
RRILDSAEFIK	RRILDSAEF
QRFKFLFNL	QRFKFLFNL
ERMPRWYFL	ERMPRWYFL
RRKIATEKDFL	RRKITEKDF
GRISTKFEF	GRISTKFEF
RRFWNSIVMQR	RRFWNSIVM
MRQKAVSLF	MRQKAVSLF
QRAEIYALNR	QRAEYALNR
ARFDPYGKNKF	ARFDYGKNK
GRLGGIAVAYF	GRLGIAVAY
KRLLPVFAQTF	KRLLPVFAQ
KRLGASLAF	KRLGASLAF
RRIGLENFLLR	RRIGENFLL
RRHMKVAFF	RRHMKVAFF
VRLPLLDPWYF	VRLPLDPWY
ARLKQQTIPLK	ARLKQTIPL
LRFNGRVLF	LRFNGRVLF
SRLSVASDMRF	SRLSVASDM
QRLLVTELM	QRLLVTELM
LRFFQPWGL	LRFFQPWGL
QRNVNVFKF	QRNVNVFKF
QRIMFDIRL	QRIMFDIRL
GRIGNFIVK	GRIGNFIVK
KRYGALPERY	KRYGLPERY
GRWFGGRQI	GRWFGGRQI
ARIYQPKRY	ARIYQPKRY
ARDLTEVSAK	ARDLEVSAK
RRWLRPELL	RRWLRPELL
RRWEQALTFR	RRWEQALTF
KRILMEHIHKL	KRILEHIHK
SRLFQPVQY	SRLFQPVQY
SRNEALIALL	SRNELIALL
GRLWSKAIF	GRLWSKAIF
GRLAAIVAKQ	GRLAAIVAK
VRVSIAISR	VRVSIAISR
RRFDPKLFL	RRFDPKLFL
HRALQLALR	HRALQLALR
NRIKGIPKL	NRIKGIPKL
ERIEKLWKR	ERIEKLWKR
GRMGIEILSF	GRMGEILSF
SRTVVYITY	SRTVVYITY
TRTGLFLRF	TRTGLFLRF
TPVTVSAVKPA	TPVTVSAVK
LRIQINPQNK	LRIQNPQNK
GRVKDLESLF	GRVKLESLF
RRLYPLAIQI	RRLYLAIQI
SRDFLVVNK	SRDFLVVNK
SRLRNQSVFNF	LRNQSVFNF
RRLKPFGVQRF	RRLKFGVQR
RRNPDTQWITK	RRNPDTQWI
KRFADAASLLL	KRFAAASLL
IRNDGVLLL	IRNDGVLLL
ERFPYPFQV	ERFPYPFQV
RRLLLLPLL	RRLLLLPLL
RRGDITIKL	RRGDITIKL
ARFYAVQKL	ARFYAVQKL
RRINREAERF	RRINEAERF
QRTSLIVHV	QRTSLIVHV
GRVGATAAVY	GRVGTAAVY
YRVEVYKNR	YRVEVYKNR
TRFVMKTLM	TRFVMKTLM
YRWTEYGLTF	YRWTYGLTF
KRLDAFIDGF	KRLDFIDGF
VRALAAFLK	VRALAAFLK
RRSDPGHYSF	RRSDGHYSF
KRMSGMIRL	KRMSGMIRL
NRYLVVLYY	NRYLVVLYY
HRLFPNTMLF	HRLFNTMLF
SRFGKFIQV	SRFGKFIQV
FRFAGSENL	FRFAGSENL
RRFEFQADAF	RRFEQADAF
FRFSGRILGL	FRFSRILGL
RRFAFPLSL	RRFAFPLSL
RRFDPKLFLVF	RRFDPKLFL
GRLPFSIRV	GRLPFSIRV
QRLSFSVSR	QRLSFSVSR
HRYPTSIASL	HRYPSIASL
QRKEFFAKL	QRKEFFAKL
ARLDFVVRY	ARLDFVVRY
LRFEVVPSK	LRFEVVPSK
ARVFFVHEGY	ARVFVHEGY
KRFGNAVILLY	KRFGAVILL
GRLQDPQKVAR	GRLQDPQKV
ERIKLEGIITR	ERIKGIITR
GRLAMEEIYQK	GRLAMEEIY
ARRFLADLT	ARRFLADLT
HRNLAIFDL	HRNLAIFDL
GRLPLSVAH	GRLPLSVAH
RRFEYKYSF	RRFEYKYSF
RRLSAVNSIFL	RRLSAVNSI
RRWDEKAVDKL	RRWDKAVDK
YRVKIHFKV	YRVKIHFKV
GRLNLHYAV	GRLNLHYAV
TRLKKLFLV	TRLKKLFLV
KRINWRTVL	KRINWRTVL
RRVSVTAVAAL	RRVSTAVAA
VRAAKFWK	VRAA-KFWK
RRIANLIKEL	RRIALIKEL
RPPGFSPFR	RPPGFSPFR
GRILSGVVTKM	GRILGVVTK
IRDQLSAVASK	IRDQLSAVA
LRFQSSAVM	LRFQSSAVM
ARHEYTFSI	ARHEYTFSI
ARNLISPRM	ARNLISPRM
QRYGPPPSY	QRYGPPPSY
TRISIFGLGY	TRISFGLGY
TRIFIPTSF	TRIFIPTSF
KRVETNQDWSL	KRVEQDWSL
RRAPFDLFENK	RRAPFDLFE
RRLQDLATQL	RRLQLATQL
VRFSGADKSF	VRFSADKSF
KRAYIPRTL	KRAYIPRTL
ARIPPVAVR	ARIPPVAVR
VRNIVQQQF	VRNIVQQQF
ARIKAINTF	ARIKAINTF
ARIQPMPYF	ARIQPMPYF
ARNDYLLTL	ARNDYLLTL
KRFEQKGFRLV	KRFEKGFRL
GRLAWAQQL	GRLAWAQQL
MRYAVNVAL	MRYAVNVAL
QRFIPELINF	QRFIELINF
RRLGVQPSKY	RRLGVQPSK
RRWTLGGMVNR	RRWTLGGMV
HRLNFFVEV	HRLNFFVEV
GRKGTDDSMTL	GRKGTDDSM
KRYPSLWRRL	KRYPSLWRR
KRIGKVLDNAI	KRIGVLDNA
MRVPAQLLGL	MRVPQLLGL
IRHIALLGF	IRHIALLGF
RRFSVTLRL	RRFSVTLRL
LYPNGVPFKVI	YPNGVPFKV
KRNKIFMEF	KRNKIFMEF
GRIKLLQGY	GRIKLLQGY
SRLERLEI	SRLE-RLEI
KRLEEIMKRT	KRLEEIMKR
RRILVATNLF	RRILVATNL
GRVEMTVSKF	GRVEMTVSK
RRAFIITINSF	RRAFTINSF
MRVTAPRTLL	MRVTPRTLL
ARVKMQVTM	ARVKMQVTM
SRFRPISVF	SRFRPISVF
ERHKLYLVF	ERHKLYLVF
RRFGDKLNFRQ	RRFGDKLNF
ARTSVFLVR	ARTSVFLVR
ARLKILETL	ARLKILETL
KRFGLNIDRWL	KRFGLNIDR
SRTSVQPTF	SRTSVQPTF
SRLGLILLL	SRLGLILLL
VRIQTQPGY	VRIQTQPGY
KRALVILAK	KRALVILAK
RRAGADIIITY	RRAGIIITY
YRFLEDVART	YRFLEDVAR
ARIAKGLRL	ARIAKGLRL
RRAPVVVRL	RRAPVVVRL
KRFQQAGFNL	KRFQAGFNL
KRVTEILGF	KRVTEILGF
GRLQSMKLDY	GRLQMKLDY
KRFDDKYTLKL	KRFDDKYTL
RRMFPFLSF	RRMFPFLSF
RQLSVLFRKL	RQLSVLFRK
SRSGTDFTL	SRSGTDFTL
TRLYPVFFL	TRLYPVFFL
LRYLEVEPVSR	LRYLEVEPV
ARIKAINTFF	ARIKAINTF
YRIPLNPYL	YRIPLNPYL
GRFLEIGKF	GRFLEIGKF
ARYQLSAIFK	ARYQLSAIF
RRIKLLGILMM	RRIKLGILM
AQFGGKILR	AQFGGKILR
YRFEVPTAK	YRFEVPTAK
FRSFVVSKF	FRSFVVSKF
HRLGLFYQL	HRLGLFYQL
QRFVFPVQF	QRFVFPVQF
RRFTPPSPAF	RRFTPSPAF
ARHGIIKIF	ARHGIIKIF
GRLEGWEVF	GRLEGWEVF
MRDPIRILV	MRDPIRILV
RRIIRILNL	RRIIRILNL
RRVEIAHAL	RRVEIAHAL
IRAKFFEVF	IRAKFFEVF
HRIYVPLML	HRIYVPLML
ARNQLTFLL	ARNQLTFLL
GRKVFVEIPK	GRKVVEIPK
ARNEYLLNL	ARNEYLLNL
GRYGDVVLR	GRYGDVVLR
SRVDSLIPWIK	SRVDLIPWI
RRIAQEVQRF	RRIAEVQRF
GQYGNPLNKY	GQYGNPLNK
LRIADLISSF	LRIALISSF
RRIYLILEY	RRIYLILEY
SRLFAVIRF	SRLFAVIRF
GRLLLTLPLL	GRLLTLPLL
GRFKLTETL	GRFKLTETL
RRYLPKLKAF	RRYLKLKAF
GRFITVMKF	GRFITVMKF
MRKKLILFF	MRKKLILFF
ARNPSLKQQL	ARNPLKQQL
RRKEFETNL	RRKEFETNL
VRMNVLADALK	VRMNLADAL
LRFFWDNKF	LRFFWDNKF
KRLGILVVF	KRLGILVVF
QRLEMNLGL	QRLEMNLGL
GRLPRTYRL	GRLPRTYRL
LRWDDQQKVK	LRWDDQQKV
KRFDDPGLML	KRFDPGLML
ARLREFWMR	ARLREFWMR
WRVSLDVNHF	WRVSDVNHF
ARLIAIFFY	ARLIAIFFY
RRVQPRVNV	RRVQPRVNV
RRFRGDVTL	RRFRGDVTL
VRLPYPLQM	VRLPYPLQM
GRFFSENSSL	GRFFENSSL
MRLILPVGLI	MRLILPVGL
VRNPFTVTV	VRNPFTVTV
RRSELVFWRW	RRSELVFWR
KRQGRTLYGF	KRQGTLYGF
ARDETEFYL	ARDETEFYL
KRNPGVKEGY	KRNPVKEGY
KRLDINTNTY	KRLDNTNTY
GRIKEIFCPK	GRIKIFCPK
LRLWQTVVGK	LRLWTVVGK
SRLDRTEIITF	SRLDRTEII
KRVAFNVSKM	KRVAFNVSK
KRFYLPGTSR	KRFYPGTSR
FRLQNIIGR	FRLQNIIGR
SRFAGYVTSI	SRFAYVTSI
SRIPFNQAL	SRIPFNQAL
ARFRNISRIM	ARFRNISRI
VRIDPFVRTFL	VRIDFVRTF
QRVASVMQEY	QRVAVMQEY
RRINREAERFF	RRINEAERF
RRYYKPGLL	RRYYKPGLL
ARFALTVVR	ARFALTVVR
MRKKLILYF	MRKKLILYF
VRTPYTMSY	VRTPYTMSY
YRNFMIDTY	YRNFMIDTY
SRWPELYLY	SRWPELYLY
SRLDSVLLL	SRLDSVLLL
ARLDLPYELLF	ARLDLPYEL
WRFPGLLLA	WRFPGLLLA
TRLPLISGF	TRLPLISGF
SRLYIAYQF	SRLYIAYQF
GRLWQVQSR	GRLWQVQSR
ARYDFSHEILR	ARYDFSHEI
KRLPPFETF	KRLPPFETF
IRLRPGGKK	IRLRPGGKK
YRLLKSKLYL	YRLLSKLYL
SRFGNAFHL	SRFGNAFHL
ARLAALVQR	ARLAALVQR
SRYSFIQAL	SRYSFIQAL
KRVAVILNEF	KRVAILNEF
RRFLYIVNL	RRFLYIVNL
ARALLSAVTR	ARALSAVTR
ARFYAVQKLAR	ARFYAVQKL
KRQEAIFEL	KRQEAIFEL
QRIHLRFMF	QRIHLRFMF
RRVFIIETM	RRVFIIETM
TRNALPALLIY	TRNALPALL
SRKFGQLRL	SRKFGQLRL
IRKFLEGNSM	IRKFEGNSM
IRFGSDPATY	IRFGDPATY
GRYDKTQLRF	GRYDTQLRF
HRVLIFTQM	HRVLIFTQM
YRADIKEMGL	YRADKEMGL
GRMFPISR	GRMF-PISR
SRFYDLSSK	SRFYDLSSK
NAPWAVTSL	NAPWAVTSL
RRYSNLILNLF	RRYSLILNL
KRFQAIISRM	KRFQAIISR
VRTHIRVGV	VRTHIRVGV
GRSLIQISI	GRSLIQISI
RRLLSIKEAF	RRLLIKEAF
GRFGVERDRM	GRFGVERDR
FRVIFTGGVGK	FRVIFTGGV
QRWQFTLPMM	QRWQFTLPM
VRIPNSYEV	VRIPNSYEV
DRLISVFM	DRLI-SVFM
GRASVVFVDR	GRASVFVDR
SRFSGGFGA	SRFSGGFGA
SRGFGFILFK	SRGFGFILF
WRYMGGFAK	WRYMGGFAK
GRVQLFEISL	GRVQFEISL
ARMQLSEIMER	ARMQLSEIM
KRAFIITGQTY	KRAFIITGQ
SRISLPLPNF	SRISPLPNF
RRSQPLISL	RRSQPLISL
HRNSMKVFL	HRNSMKVFL
KRLGYVVRRF	KRLGYVVRR
GRLAYLPVGR	GRLALPVGR
SRFGSKLGL	SRFGSKLGL
RRLLPLPLT	RRLLPLPLT
RRLSPAGAAL	RRLSAGAAL
GRWQGNDIVVK	GRWQNDIVV
KRIHGVGFK	KRIHGVGFK
RRLRDLLTRR	RRLRDLLTR
RRHEGLPGL	RRHEGLPGL
GRYGAISGF	GRYGAISGF
IRLQILTGL	IRLQILTGL
KRYSFNVAL	KRYSFNVAL
KRLGSLVDEF	KRLGLVDEF
GRKLFYVHY	GRKLFYVHY
IRNYLSVSL	IRNYLSVSL
HRFPFSSAL	HRFPFSSAL
RRSWLIIQRY	RRSWLIIQR
YRVKEIGSTM	YRVKIGSTM
GRLGGIAVAY	GRLGIAVAY
ARVYLNGDGM	ARVYNGDGM
KRFGPNVPALL	KRFGNVPAL
IRYPDSHQL	IRYPDSHQL
NRIFTVNPK	NRIFTVNPK
TRLFLILNI	TRLFLILNI
WRSDVLVEY	WRSDVLVEY
SRILLPIVQK	SRILPIVQK
KRHNVFGLDL	KRHNFGLDL
HRFWAGVVF	HRFWAGVVF
GRSPAQILL	GRSPAQILL
LRTALIFGGF	LRTAIFGGF
GRHFNLRM	GRHF-NLRM
YRSEGWWTL	YRSEGWWTL
SRILKLTLF	SRILKLTLF
MRFDGRLGF	MRFDGRLGF
IRQNLQLCV	IRQNLQLCV
SRLGIPDAVSY	SRLGIPDAV
RRLDFDYKKK	RRLDFDYKK
RRADRVPISF	RRADVPISF
SRFLMPEAY	SRFLMPEAY
RRSVPFQML	RRSVPFQML
IRVKTNLPIFK	IRVKNLPIF
RRDPLGRDFL	RRDPLGRDF
KRWEGLVHI	KRWEGLVHI
FRLKDGVLAY	FRLKGVLAY
HRIPTQPPSY	HRIPQPPSY
KRMNLSPAKQF	KRMNLSPAK
GRVLFPVNL	GRVLFPVNL
ARSEQFINL	ARSEQFINL
RRFSRSPIR	RRFSRSPIR
ERVNLTIAR	ERVNLTIAR
RRNDKIIVF	RRNDKIIVF
HRLLQRSLVLF	HRLLRSLVL
KRYPGFMRV	KRYPGFMRV
QRVFPHAEF	QRVFPHAEF
RRMPEVPGL	RRMPEVPGL
GRYFQVEVEK	GRYFVEVEK
ARHPSFFLY	ARHPSFFLY
QRIEHLIGKKL	QRIEHLIGK
RRLDPIPQL	RRLDPIPQL
RRIDLNLDI	RRIDLNLDI
GRHEGVPTL	GRHEGVPTL
QRDPNSPLYSV	QRDPNSPLY
ERINVIVHL	ERINVIVHL
VVPPFLQPE	VVPPFLQPE
YRLESTLNY	YRLESTLNY
KPINTTGTLKP	KPINTTGTL
GRMALEFNRL	GRMAEFNRL
SRAGIATQF	SRAGIATQF
KRKAYEPKL	KRKAYEPKL
IRYYNKVPVEK	IRYYNKVPV
IRNDVLDSL	IRNDVLDSL
MAPERVASL	MAPERVASL
QRTHVMRFF	QRTHVMRFF
RRIPAEGRVAL	RRIPAEGRV
DRIRFTVNR	DRIRFTVNR
SRYFPTAKR	SRYFPTAKR
RRFQDAVRL	RRFQDAVRL
YRERITILR	YRERITILR
YRPGTVALR	YRPGTVALR
MRWAAATLRGK	MRWAAATLR
SRYKFHLAL	SRYKFHLAL
YRESIFELL	YRESIFELL
ARTLLAILR	ARTLLAILR
LRYGEPTLR	LRYGEPTLR
GRIDNVDAF	GRIDNVDAF
SRILTKYTL	SRILTKYTL
MRDHTITLL	MRDHTITLL
SRIGHIAHL	SRIGHIAHL
ARIYHTIAY	ARIYHTIAY
RRLALFPGVAL	RRLALFPGV
ERNVLIFDL	ERNVLIFDL
ARLPLVVEDF	ARLPVVEDF
HRVAGIFPRL	HRVAIFPRL
VRFPIPDLR	VRFPIPDLR
RRFDPARGMEY	RRFDPARGM
VRIGAMLAY	VRIGAMLAY
ARVSLKDLAL	ARVSKDLAL
GRVKIADMGF	GRVKADMGF
RRINLLVKSF	RRINLVKSF
ARWDLISNL	ARWDLISNL
KRVLLVELPAF	KRVL-LVEL
MRLSLPLLL	MRLSLPLLL
RRNSVFQQGM	RRNSFQQGM
GRSAVVEML	GRSAVVEML
IRMPSLPSY	IRMPSLPSY
ARNKEIVHTF	ARNKIVHTF
SRFPYYNSL	SRFPYYNSL
IRAFTTTLNL	IRAFTTLNL
SRLLKPGGMVL	SRLLKPGGM
HRAFSVFLF	HRAFSVFLF
MRNAVCIFY	MRNAVCIFY
FRHPHIIKL	FRHPHIIKL
GRFEGFIQTR	GRFEFIQTR
ARYMPQNPHII	ARYMQNPHI
SRYLNEKAVSY	SRYLNEKAV
SRFYGDLMEK	SRFYDLMEK
ERADLIAYL	ERADLIAYL
KRVSIEPNF	KRVSIEPNF
GRLKDILAI	GRLKDILAI
QRVEPEWYI	QRVEPEWYI
SRADLIKQY	SRADLIKQY
KRFAGKVTTA	KRFAKVTTA
KRAMDQAREL	KRAMQAREL
RVYIHPFHL	RVYIHPFHL
RRIQVVHAF	RRIQVVHAF
GRFYAFGRVF	GRFYFGRVF
TRFLAEEGFYK	TRFLAEEGF
ARAGALFQLL	ARAGLFQLL
QRTSILQTL	QRTSILQTL
QRFPLSFGF	QRFPLSFGF
RRAEVELEY	RRAEVELEY
SRLKESFLV	SRLKESFLV
FRNIPGITLL	FRNIGITLL
IRWIGSDLSNF	IRWIDLSNF
SRFTHTFPPR	SRFTTFPPR
RRLTVLPFAGL	RRLTPFAGL
LRWFRALFK	LRWFRALFK
LRYKLSLEF	LRYKLSLEF
RRTYVGSMPGR	RRTYSMPGR
RRWGDSVLLV	RRWGDSVLL
KRFDDKYTLK	KRFDDKYTL
ARYSGSYNDYL	ARYSSYNDY
SRAVQEFGL	SRAVQEFGL
SRNAQTFGF	SRNAQTFGF
IRNDEELNK	IRNDEELNK
WRLRLGGAAL	WRLRGGAAL
GRLDKIIYI	GRLDKIIYI
SRLPNYFVR	SRLPNYFVR
RRLQYLSSKF	RRLQLSSKF
RRLFEQNVQR	RRLFQNVQR
LRFGVLTGL	LRFGVLTGL
RRVNQAIWLL	RRVNAIWLL
IMQYKYLL	IMQY-KYLL
FRRNLILNL	FRRNLILNL
HRYEVVTEL	HRYEVVTEL
TRYKATGLHF	TRYKTGLHF
SRFAGASIKI	SRFAASIKI
ARWLVRPKEK	ARWLRPKEK
SRIFILAHF	SRIFILAHF
SRFEGLSPLQR	SRFEGLSPL
ARFDSDVEVY	ARFDDVEVY
GRFLGKGGF	GRFLGKGGF
FRFDPQFALT	FRFDPQFAL
RRWKGLERV	RRWKGLERV
RRLLPSLIGR	RRLLSLIGR
GRTKIFIRF	GRTKIFIRF
TRLKYAVKV	TRLKYAVKV
FRVPFIYGH	FRVPFIYGH
ARMRVLSKAF	ARMRLSKAF
RRGFFFSHV	RRGFFFSHV
ARFWSLESL	ARFWSLESL
GRYLDNVVNK	GRYLNVVNK
LRAGLVLGF	LRAGLVLGF
ARIPFYGSY	ARIPFYGSY
GRFSEPHAR	GRFSEPHAR
RRLGELVKKL	RRLGLVKKL
KRTQIVTEI	KRTQIVTEI
ARFRNISRIMR	ARFRNISRI
GRKQDKGGFGF	GRKQDKGGF
KRWGPNYNLM	KRWGPNYNL
IRFLILPDMLK	IRFLILPDM
IRYWFHYTL	IRYWFHYTL
QRLLFRIGY	QRLLFRIGY
ARLEINVLK	ARLEINVLK
RRFLVTLRI	RRFLVTLRI
VSSNLAIAIKK	SSNLIAIKK
PIRLLAAAA	PIRLLAAAA
QRLGSQKFFF	QRLGQKFFF
GRLQLQVTV	GRLQLQVTV
RRRWRRLTV	RRRWRRLTV
QRVPFGALF	QRVPFGALF
GRNSFEVRV	GRNSFEVRV
TRIQNPSAYAK	TRIQNPSAY
SRLKAAFVK	SRLKAAFVK
TRFLAEEGF	TRFLAEEGF
GRIGVITNRER	GRIGVITNR
RRIEVNVELRK	RRIEVNVEL
GRLDLQYAKL	GRLDQYAKL
GRFKFLDLWNK	GRFK-FLDL
ARSGEKITV	ARSGEKITV
RRLEPAIQKF	RRLEAIQKF
IRSKIITYI	IRSKIITYI
MRLPGGPTLTF	MRLPGGPTL
GRFSLPGATCL	GRFSLPGAT
GRGSFMLGL	GRGSFMLGL
WRLILDWVPY	WRLIDWVPY
ARIKQIKPLL	ARIKIKPLL
KRLGLLAGFAF	KRLGLLAGF
GRNRYQLEI	GRNRYQLEI
GRIVTLISF	GRIVTLISF
SRLDQELKL	SRLDQELKL
GRLPWARLF	GRLPWARLF
RRLEIEAENHY	RRLEEAENH
SRLQYYVPR	SRLQYYVPR
GRMFKQFNKL	GRMFKQFNK
GRTFLRVLI	GRTFLRVLI
ARYFIDSTNLK	ARYFDSTNL
QRLDLQIKL	QRLDLQIKL
NRVGLNLLY	NRVGLNLLY
GRFEGDTGL	GRFEGDTGL
ARFYAVQKLA	ARFYAVQKL
SRIGKLLGF	SRIGKLLGF
RRFMPYYVY	RRFMPYYVY
SRLESFWAL	SRLESFWAL
ARNEYLLSL	ARNEYLLSL
RRYEIAVNL	RRYEIAVNL
RRFKWAIEL	RRFKWAIEL
KRGILTLKY	KRGILTLKY
FRYLMGERL	FRYLMGERL
KRILGLLENF	KRILLLENF
VRVIFPFMK	VRVIFPFMK
MAPLKMLAL	MAPLKMLAL
FRALLFVPR	FRALLFVPR
VRFKYPKLISY	VRFKYPKLI
KRFKEANNFL	KRFKEANNF
GRFALDFGL	GRFALDFGL
GRAKYWVER	GRAKYWVER
TRMGPLINR	TRMGPLINR
YRLPEVIQK	YRLPEVIQK
KRMPWGWDY	KRMPWGWDY
LSPSSLFSAL	SPSSLFSAL
TRLEPMFSM	TRLEPMFSM
QRIYNFAHRF	QRIYFAHRF
SRSLVNIVK	SRSLVNIVK
ARALFIRPFML	ARALFIRPF
RRIYPFLL	RRIY-PFLL
KRLSFHDMNL	KRLSHDMNL
ARLWFHSNF	ARLWFHSNF
YRLGPLLGK	YRLGPLLGK
RRLLLEDLVKK	RRLLEDLVK
SRLQIDPVM	SRLQIDPVM
GRLTSQLLR	GRLTSQLLR
KRLNLQPLAY	KRLNQPLAY
GRLQKLLKM	GRLQKLLKM
QRTITVGVY	QRTITVGVY
KRFWYIEGIMY	KRFWYIEGI
KRNYIRLSF	KRNYIRLSF
RRHIVAAGF	RRHIVAAGF
RRFLTQPQVVA	RRFLTQPQV
ARTYLERHM	ARTYLERHM
KRLNVTPLAR	KRLNTPLAR
VRMPPFTQAF	VRMPFTQAF
RRHNINIGI	RRHNINIGI
QRWPQSLNM	QRWPQSLNM
ARFIWLSAF	ARFIWLSAF
RRLENVENLL	RRLENVENL
ARLAGKELRF	ARLAKELRF
GRHSLYKMLGY	GRHSLYKML
MRLSLPLLLLL	MRLSLPLLL
GRLDDFFKV	GRLDDFFKV
IMVMGAMLL	IMVMGAMLL
KRLEIYLEPLK	KRLEYLEPL
ARTLFNQVM	ARTLFNQVM
ARHVVAVVL	ARHVVAVVL
RRLPQAFRP	RRLPQAFRP
SRFLPKPLYTR	SRFLPKPLY
SRYLYTLVI	SRYLYTLVI
SRFLQESNVLY	SRFLESNVL
SRYRLPVATR	SRYRPVATR
GRFPDGTNGL	GRFPGTNGL
TRLSNIFVI	TRLSNIFVI
NVKVDPEIQ	NVKVDPEIQ
KRTFLRQAL	KRTFLRQAL
GRCQLAGYGF	GRCQAGYGF
KRFHATVSF	KRFHATVSF
FRNSGITVGK	FRNSITVGK
QRFDRPLVTF	QRFDPLVTF
SRGKQDFLK	SRGKQDFLK
KRYDPDILLGY	KRYDPDILL
QRFPKILVL	QRFPKILVL
GRVPLILNL	GRVPLILNL
